Account,Posted dt.,Doc dt.,Doc,Memo/Description,Department,JNL,Debit,Credit,Balance
1001,1001 - Bank of America- Checking -Acct. 6488 (Balance forward As of 07/01/2020) ,,,,,,,,624904.4
1001,7/1/2020,7/1/2020,BCBS -July,BCBS- July - BCBS Health Insurance-July -BCBS Health Insurance,,HJ,,143.49,624760.91
1001,7/1/2020,7/1/2020,BCBS -July,BCBS- July - BCBS Health Insurance-July -BCBS Health Insurance,,HJ,,143.49,624617.42
1001,7/1/2020,7/1/2020,BCBS -July,BCBS- July - BCBS Health Insurance-July -BCBS Health Insurance,,HJ,,191.32,624426.1
1001,7/1/2020,7/1/2020,BCBS -July,BCBS- July - BCBS Health Insurance-July -BCBS Health Insurance,,HJ,,239.15,624186.95
1001,7/1/2020,7/1/2020,BCBS -July,BCBS- July - BCBS Health Insurance-July -BCBS Health Insurance,,HJ,,388.9,623798.05
1001,7/1/2020,7/1/2020,BCBS -July,BCBS- July - BCBS Health Insurance-July -BCBS Health Insurance,,HJ,,721.04,623077.01
1001,7/1/2020,7/1/2020,BCBS -July,BCBS- July - BCBS Health Insurance-July -BCBS Health Insurance,,HJ,,955.49,622121.52
1001,7/1/2020,7/1/2020,BCBS -July,BCBS- July - BCBS Health Insurance-July -BCBS Health Insurance,,HJ,,1294.39,620827.13
1001,7/1/2020,7/1/2020,BCBS -July,BCBS- July - BCBS Health Insurance-July -BCBS Health Insurance,,HJ,,2081.72,618745.41
1001,7/1/2020,7/1/2020,BCBS -July,BCBS- July - BCBS Health Insurance-July -BCBS Health Insurance,,HJ,,2108.99,616636.42
1001,7/1/2020,7/1/2020,BCBS -July,BCBS- July - BCBS Health Insurance-July -BCBS Health Insurance,,HJ,,2136.26,614500.16
1001,7/1/2020,7/1/2020,BCBS -July,BCBS- July - BCBS Health Insurance-July -BCBS Health Insurance,,HJ,,2136.26,612363.9
1001,7/1/2020,7/1/2020,BCBS -July,BCBS- July - BCBS Health Insurance-July -BCBS Health Insurance,,HJ,,3670.28,608693.62
1001,7/1/2020,7/1/2020,BCBS -July,BCBS- July - BCBS Health Insurance-July -BCBS Health Insurance,,HJ,,5595.47,603098.15
1001,7/1/2020,7/1/2020,BCBS -July,BCBS- July - BCBS Health Insurance-July -BCBS Health Insurance,,HJ,,10970.14,592128.01
1001,7/1/2020,7/1/2020,BCBS -July,BCBS- July - BCBS Health Insurance-July -BCBS Health Insurance,,HJ,,14617.64,577510.37
1001,7/1/2020,7/1/2020,Eversource,Bill.Com Import--,,HJ,,0.66,577509.71
1001,7/2/2020,7/2/2020,1.94E+12,Blue 20/20 Vision Insurance -July Invoice-Blue 20/20 Vision Insurance -July Invoice,,HJ,,26.88,577482.83
1001,7/2/2020,7/2/2020,1.94E+12,Blue 20/20 Vision Insurance -July Invoice-Blue 20/20 Vision Insurance -July Invoice,,HJ,,55.67,577427.16
1001,7/2/2020,7/2/2020,1.94E+12,Blue 20/20 Vision Insurance -July Invoice-Blue 20/20 Vision Insurance -July Invoice,,HJ,,109.42,577317.74
1001,7/2/2020,7/2/2020,1.94E+12,Blue 20/20 Vision Insurance -July Invoice-Blue 20/20 Vision Insurance -July Invoice,,HJ,,296.94,577020.8
1001,7/2/2020,7/2/2020,Impact Catalysts,Bill.Com Import--,,HJ,,10000,567020.8
1001,7/2/2020,7/2/2020,Media Cause,Bill.Com Import--,,HJ,,19949,547071.8
1001,7/2/2020,7/2/2020,TASC,TASC withholding-TASC withholding,,HJ,,787.98,546283.82
1001,7/6/2020,7/6/2020,7062020,BofA CC Transaction June Payment-BofA CC Transaction June Payment,,HJ,,29.99,546253.83
1001,7/6/2020,7/6/2020,7062020,BofA CC Transaction June Payment-BofA CC Transaction June Payment,,HJ,,1009.49,545244.34
1001,7/6/2020,7/6/2020,7062020,BofA CC Transaction June Payment-BofA CC Transaction June Payment,,HJ,,1249.47,543994.87
1001,7/6/2020,7/6/2020,7062020,BofA CC Transaction June Payment-BofA CC Transaction June Payment,,HJ,,4131.52,539863.35
1001,7/6/2020,7/6/2020,7062020,BofA CC Transaction June Payment-BofA CC Transaction June Payment,,HJ,,4226.99,535636.36
1001,7/6/2020,7/6/2020,7062020,BofA CC Transaction June Payment-BofA CC Transaction June Payment,,HJ,,6292.59,529343.77
1001,7/6/2020,7/6/2020,7062020,BofA CC Transaction June Payment-BofA CC Transaction June Payment,,HJ,,7964.24,521379.53
1001,7/6/2020,7/6/2020,7062020,BofA CC Transaction June Payment-BofA CC Transaction June Payment,,HJ,,15666.99,505712.54
1001,7/6/2020,7/6/2020,Comcast,Comcast July internet expenses-Comcast July internet expenses,,HJ,,139.55,505572.99
1001,7/6/2020,7/6/2020,HRKnowledge,To record HR Outsourcing Admin fee-To record HR Outsourcing Admin fee for fellows,,HJ,,129.8,505443.19
1001,7/6/2020,7/6/2020,HRKnowledge,To record HR Outsourcing Admin fee-To record HR Outsourcing Admin fee for fellows,,HJ,,200.6,505242.59
1001,7/6/2020,7/6/2020,HRKnowledge,To record HR Outsourcing Admin fee-To record HR Outsourcing Admin fee for fellows,,HJ,,200.6,505041.99
1001,7/6/2020,7/6/2020,HRKnowledge,To record HR Outsourcing Admin fee-To record HR Outsourcing Admin fee for fellows,,HJ,,649,504392.99
1001,7/6/2020,7/6/2020,HRKnowledge,HR Outsourcing admin fee for staff PD6/30-HR Outsourcing admin fee for staff PD6/30,,HJ,,520,503872.99
1001,7/6/2020,7/6/2020,TAG Resources LLC,To record 401K payment-To record 401K payment,,HJ,,2778.91,501094.08
1001,7/8/2020,7/8/2020,Catherine M Tierney,Bill.Com Import--,,HJ,,350,500744.08
1001,7/8/2020,7/8/2020,Eversource,July electricity expenses-July electricity expenses,,HJ,,32.46,500711.62
1001,7/8/2020,7/8/2020,Julie Balfour,Bill.Com Import--,,HJ,,3333.33,497378.29
1001,7/8/2020,7/8/2020,Verizon,Mifi devices for College Board-Mifi devices for College Board,,HJ,,450.8,496927.49
1001,7/8/2020,7/8/2020,Verizon,Mifi devices for College Board-Mifi devices for College Board,,HJ,,1337.45,495590.04
1001,7/9/2020,7/9/2020,Inspire Business Cen,July rent and June credit for Jackson Center-July rent and June credit for Jackson Center,,HJ,,25,495565.04
1001,7/10/2020,7/10/2020,ADP,To record PR expenses for staff and fellows-To record PR expenses for staff and fellows,,HJ,,60.39,495504.65
1001,7/10/2020,7/10/2020,ADP,To record PR expenses for staff and fellows-To record PR expenses for staff and fellows,,HJ,,93.34,495411.31
1001,7/10/2020,7/10/2020,ADP,To record PR expenses for staff and fellows-To record PR expenses for staff and fellows,,HJ,,93.34,495317.97
1001,7/10/2020,7/10/2020,ADP,To record PR expenses for staff and fellows-To record PR expenses for staff and fellows,,HJ,,301.98,495015.99
1001,7/10/2020,7/10/2020,ADP,To record PR expenses for staff and fellows-To record PR expenses for staff and fellows,,HJ,,2948.15,492067.84
1001,7/13/2020,7/13/2020,Feinberg Hanson,Bill.Com Import--,,HJ,,608.1,491459.74
1001,7/13/2020,7/13/2020,Media Cause,Bill.Com Import--,,HJ,,23223,468236.74
1001,7/13/2020,7/13/2020,Ohio Indemnity,Bill.Com Import--,,HJ,,3821.17,464415.57
1001,7/13/2020,7/13/2020,Stryder,Bill.Com Import--,,HJ,,30000,434415.57
1001,7/15/2020,7/15/2020,71520,82L-PRPD-071520 -Import Payroll (PPP)-Import Payroll,,HJ,,17318.82,417096.75
1001,7/15/2020,7/15/2020,71520,82L-PRPD-071520 -Import Payroll (GENERL)-Import Payroll,,HJ,,3.5,417093.25
1001,7/15/2020,7/15/2020,71520,82L-PRPD-071520 -Import Payroll (GENERL)-Import Payroll,,HJ,,646.56,416446.69
1001,7/15/2020,7/15/2020,71520,82L-PRPD-071520 -Import Payroll (GENERL)-Import Payroll,,HJ,,699.08,415747.61
1001,7/15/2020,7/15/2020,71520,82L-PRPD-071520 -Import Payroll (GENERL)-Import Payroll,,HJ,,709.49,415038.12
1001,7/15/2020,7/15/2020,71520,82L-PRPD-071520 -Import Payroll (GENERL)-Import Payroll,,HJ,,914.2,414123.92
1001,7/15/2020,7/15/2020,71520,82L-PRPD-071520 -Import Payroll (GENERL)-Import Payroll,,HJ,,1319.35,412804.57
1001,7/15/2020,7/15/2020,71520,82L-PRPD-071520 -Import Payroll (GENERL)-Import Payroll,,HJ,,1734.33,411070.24
1001,7/15/2020,7/15/2020,71520,82L-PRPD-071520 -Import Payroll (GENERL)-Import Payroll,,HJ,,1987.73,409082.51
1001,7/15/2020,7/15/2020,71520,82L-PRPD-071520 -Import Payroll (GENERL)-Import Payroll,,HJ,,1987.74,407094.77
1001,7/15/2020,7/15/2020,71520,82L-PRPD-071520 -Import Payroll (GENERL)-Import Payroll,,HJ,1987.74,,409082.51
1001,7/15/2020,7/15/2020,71520,82L-PRPD-071520 -Import Payroll (GENERL)-Import Payroll,,HJ,,2063.4,407019.11
1001,7/15/2020,7/15/2020,71520,82L-PRPD-071520 -Import Payroll (GENERL)-Import Payroll,,HJ,,2119.29,404899.82
1001,7/15/2020,7/15/2020,71520,82L-PRPD-071520 -Import Payroll (GENERL)-Import Payroll,,HJ,,2336.38,402563.44
1001,7/15/2020,7/15/2020,71520,82L-PRPD-071520 -Import Payroll (GENERL)-Import Payroll,,HJ,,3086.33,399477.11
1001,7/15/2020,7/15/2020,71520,82L-PRPD-071520 -Import Payroll (GENERL)-Import Payroll,,HJ,,4064.67,395412.44
1001,7/15/2020,7/15/2020,71520,82L-PRPD-071520 -Import Payroll (GENERL)-Import Payroll,,HJ,,4963.38,390449.06
1001,7/15/2020,7/15/2020,71520,82L-PRPD-071520 -Import Payroll (GENERL)-Import Payroll,,HJ,,6398.64,384050.42
1001,7/15/2020,7/15/2020,71520,82L-PRPD-071520 -Import Payroll (GENERL)-Import Payroll,,HJ,,7807.62,376242.8
1001,7/15/2020,7/15/2020,71520,82L-PRPD-071520 -Import Payroll (GENERL)-Import Payroll,,HJ,,8036.11,368206.69
1001,7/15/2020,7/15/2020,71520,82L-PRPD-071520 -Import Payroll (GENERL)-Import Payroll,,HJ,,14647.05,353559.64
1001,7/15/2020,7/15/2020,71520,82L-PRPD-071520 -Import Payroll (GENERL)-Import Payroll,,HJ,,16079.16,337480.48
1001,7/15/2020,7/15/2020,71520,82L-PRPD-071520 -Import Payroll (GENERL)-Import Payroll,,HJ,,20643.07,316837.41
1001,7/15/2020,7/15/2020,71520,82L-PRPD-071520 -Import Payroll (GENERL)-Import Payroll,,HJ,,21940.82,294896.59
1001,7/15/2020,7/15/2020,71520,82L-PRPD-071520 -Import Payroll (GENERL)-Import Payroll,,HJ,,35878.53,259018.06
1001,7/15/2020,7/15/2020,71520,82L-PRPD-071520 -Import Payroll (GENERL)-Import Payroll,,HJ,,54444.5,204573.56
1001,7/15/2020,7/15/2020,20200715,To record the individual donations for 7/1-7/15/2020-To record the individual donations for 7/1-7/15/2020 QGiv,,HJ,18.16,,204591.72
1001,7/15/2020,7/15/2020,20200715,Fund transfer from #8984-Fund transfer from #8984,,HJ,401000,,605591.72
1001,7/16/2020,7/16/2020,Bank of America VISA,Concur Payment- Bambora-Concur Payment- Bambora,,HJ,,390.46,605201.26
1001,7/17/2020,7/17/2020,T-Mobile,Phone expenses for July-Phone expenses for July,,HJ,,61.78,605139.48
1001,7/17/2020,7/17/2020,T-Mobile,Phone expenses for July-Phone expenses for July,,HJ,,95.47,605044.01
1001,7/17/2020,7/17/2020,T-Mobile,Phone expenses for July-Phone expenses for July,,HJ,,95.47,604948.54
1001,7/17/2020,7/17/2020,T-Mobile,Phone expenses for July-Phone expenses for July,,HJ,,308.88,604639.66
1001,7/17/2020,7/17/2020,TASC,TASC Withdraw-TASC Withdraw,,HJ,,887.88,603751.78
1001,7/17/2020,7/17/2020,The Hanover Ins,Hanover Ins. Partial Payment of Invoice FY21-Hanover Ins. Partial Payment of Invoice FY21,,HJ,,1423,602328.78
1001,7/20/2020,7/20/2020,TAG Resources LLC,Employees'401K payment-Employees'401K payment,,HJ,,3641.8,598686.98
1001,7/22/2020,7/22/2020,20200722,To record individual donations-To record individual donations,,HJ,,85.82,598601.16
1001,7/22/2020,7/22/2020,Board Member Connect,Bill.Com Import--,,HJ,,2000,596601.16
1001,7/22/2020,7/22/2020,Whiteboard,Bill.Com Import--,,HJ,,7500,589101.16
1001,7/23/2020,7/23/2020,Mighty Good Agency,Bill.Com Import--,,HJ,,1750,587351.16
1001,7/23/2020,7/23/2020,Salesforce.org,Bill.Com Import--,,HJ,,1718.64,585632.52
1001,7/23/2020,7/23/2020,Salesforce.org,Bill.Com Import--,,HJ,,2656.08,582976.44
1001,7/23/2020,7/23/2020,Salesforce.org,Bill.Com Import--,,HJ,,2656.08,580320.36
1001,7/23/2020,7/23/2020,Salesforce.org,Bill.Com Import--,,HJ,,8593.2,571727.16
1001,7/24/2020,7/24/2020,HRKnowledge,HR Outsourcing Admin fee-HR Outsourcing Admin fee for staff,,HJ,,780,570947.16
1001,7/24/2020,7/24/2020,The Hanover Ins,Bill.Com Import--,,HJ,,5858.25,565088.91
1001,7/24/2020,7/24/2020,VIANT US LLC,Bill.Com Import--,,HJ,,3194.39,561894.52
1001,7/24/2020,7/24/2020,Walnut Street Realty,Bill.Com Import--,,HJ,,2178.87,559715.65
1001,7/24/2020,7/24/2020,Woot Math Inc,Bill.Com Import--,,HJ,,24858.59,534857.06
1001,7/27/2020,7/27/2020,Leslie Wade LLC,Bill.Com Import--,,HJ,,7744,527113.06
1001,7/27/2020,7/27/2020,Monivett Acevedo,Concur Payment Bambora-Concur Payment Bambora,,HJ,,7.32,527105.74
1001,7/27/2020,7/27/2020,Monivett Acevedo,Concur Payment Bambora-Concur Payment Bambora,,HJ,,25.3,527080.44
1001,7/27/2020,7/27/2020,Monivett Acevedo,Concur Payment Bambora-Concur Payment Bambora,,HJ,,40.66,527039.78
1001,7/27/2020,7/27/2020,Monivett Acevedo,Concur Payment Bambora-Concur Payment Bambora,,HJ,,43.6,526996.18
1001,7/27/2020,7/27/2020,Registration Section,Registration Section - Div of Corporations-Check 2019 - Registration Section - Div of Corporations,,HJ,,70,526926.18
1001,7/27/2020,7/27/2020,Registration Section,Registration Section - Div of Corporations-Check 2020 Registration Section - Div of Corporations,,HJ,,8.75,526917.43
1001,7/28/2020,7/28/2020,20200728,Americorps AR and Reimbursement for June-Americorps Reimbursement for June -Reimbursement Payment,,HJ,38793.06,,565710.49
1001,7/30/2020,7/30/2020,Abila,Bill.Com Import--,,HJ,,250,565460.49
1001,7/30/2020,7/30/2020,C & L Printing,Bill.Com Import--,,HJ,,650.47,564810.02
1001,7/30/2020,7/30/2020,Exponent Partners,Bill.Com Import--,,HJ,,875,563935.02
1001,7/30/2020,7/30/2020,Fred C. Church,Bill.Com Import--,,HJ,,9401.6,554533.42
1001,7/30/2020,7/30/2020,Kika Enterprises LL,Bill.Com Import--,,HJ,,97.99,554435.43
1001,7/30/2020,7/30/2020,Kika Enterprises LL,Bill.Com Import--,,HJ,97.99,,554533.42
1001,7/30/2020,7/30/2020,Voices for National,Bill.Com Import--,,HJ,,1500,553033.42
1001,7/31/2020,7/31/2020,73120,82L-PRPD-073120 -Import Payroll-Import Payroll,,HJ,,699.09,552334.33
1001,7/31/2020,7/31/2020,73120,82L-PRPD-073120 -Import Payroll-Import Payroll,,HJ,,709.49,551624.84
1001,7/31/2020,7/31/2020,73120,82L-PRPD-073120 -Import Payroll-Import Payroll,,HJ,,1734.33,549890.51
1001,7/31/2020,7/31/2020,73120,82L-PRPD-073120 -Import Payroll-Import Payroll,,HJ,,2119.28,547771.23
1001,7/31/2020,7/31/2020,73120,82L-PRPD-073120 -Import Payroll-Import Payroll,,HJ,,3086.33,544684.9
1001,7/31/2020,7/31/2020,73120,82L-PRPD-073120 -Import Payroll-Import Payroll,,HJ,,3306.63,541378.27
1001,7/31/2020,7/31/2020,73120,82L-PRPD-073120 -Import Payroll-Import Payroll,,HJ,,4064.65,537313.62
1001,7/31/2020,7/31/2020,73120,82L-PRPD-073120 -Import Payroll-Import Payroll,,HJ,,4870.21,532443.41
1001,7/31/2020,7/31/2020,73120,82L-PRPD-073120 -Import Payroll-Import Payroll,,HJ,,4963.38,527480.03
1001,7/31/2020,7/31/2020,73120,82L-PRPD-073120 -Import Payroll-Import Payroll,,HJ,,8036.13,519443.9
1001,7/31/2020,7/31/2020,73120,82L-PRPD-073120 -Import Payroll-Import Payroll,,HJ,,8760.15,510683.75
1001,7/31/2020,7/31/2020,73120,82L-PRPD-073120 -Import Payroll-Import Payroll,,HJ,,10286.57,500397.18
1001,7/31/2020,7/31/2020,73120,82L-PRPD-073120 -Import Payroll-Import Payroll,,HJ,,11375.62,489021.56
1001,7/31/2020,7/31/2020,73120,82L-PRPD-073120 -Import Payroll-Import Payroll,,HJ,,17055.67,471965.89
1001,7/31/2020,7/31/2020,73120,82L-PRPD-073120 -Import Payroll-Import Payroll,,HJ,,19888.18,452077.71
1001,7/31/2020,7/31/2020,73120,82L-PRPD-073120 -Import Payroll-Import Payroll,,HJ,,23709.01,428368.7
1001,7/31/2020,7/31/2020,73120,82L-PRPD-073120 -Import Payroll-Import Payroll,,HJ,,51455.94,376912.76
1001,7/31/2020,7/31/2020,73120,82L-PRPD-073120 -Import Payroll-Import Payroll,,HJ,,58340,318572.76
1001,7/31/2020,7/31/2020,73120,82L-PRPD-073120 -Import Payroll-DUPUIS CHRISTOPHER M,D108,HJ,,640.02,317932.74
1001,7/31/2020,7/31/2020,Abila,Bill.Com Import--,,HJ,,110,317822.74
1001,7/31/2020,7/31/2020,Stryder,Bill.Com Import--,,HJ,,962.5,316860.24
1001,7/31/2020,7/31/2020,Stryder,Bill.Com Import--,,HJ,,1487.5,315372.74
1001,7/31/2020,7/31/2020,Stryder,Bill.Com Import--,,HJ,,1487.5,313885.24
1001,7/31/2020,7/31/2020,Stryder,Bill.Com Import--,,HJ,,4812.5,309072.74
1001,8/3/2020,8/3/2020,BCBS -August,BCBS - August Health Insurance-August -BCBS Health Insurance,,HJ,,47.83,309024.91
1001,8/3/2020,8/3/2020,BCBS -August,BCBS - August Health Insurance-August -BCBS Health Insurance,,HJ,,191.32,308833.59
1001,8/3/2020,8/3/2020,BCBS -August,BCBS - August Health Insurance-August -BCBS Health Insurance,,HJ,,413.36,308420.23
1001,8/3/2020,8/3/2020,BCBS -August,BCBS - August Health Insurance-August -BCBS Health Insurance,,HJ,,441.95,307978.28
1001,8/3/2020,8/3/2020,BCBS -August,BCBS - August Health Insurance-August -BCBS Health Insurance,,HJ,,1030.98,306947.3
1001,8/3/2020,8/3/2020,BCBS -August,BCBS - August Health Insurance-August -BCBS Health Insurance,,HJ,,1040.86,305906.44
1001,8/3/2020,8/3/2020,BCBS -August,BCBS - August Health Insurance-August -BCBS Health Insurance,,HJ,,1064.78,304841.66
1001,8/3/2020,8/3/2020,BCBS -August,BCBS - August Health Insurance-August -BCBS Health Insurance,,HJ,,1139.62,303702.04
1001,8/3/2020,8/3/2020,BCBS -August,BCBS - August Health Insurance-August -BCBS Health Insurance,,HJ,,2108.99,301593.05
1001,8/3/2020,8/3/2020,BCBS -August,BCBS - August Health Insurance-August -BCBS Health Insurance,,HJ,,2629.42,298963.63
1001,8/3/2020,8/3/2020,BCBS -August,BCBS - August Health Insurance-August -BCBS Health Insurance,,HJ,,4272.52,294691.11
1001,8/3/2020,8/3/2020,BCBS -August,BCBS - August Health Insurance-August -BCBS Health Insurance,,HJ,,8671.71,286019.4
1001,8/3/2020,8/3/2020,BCBS -August,BCBS - August Health Insurance-August -BCBS Health Insurance,,HJ,,10408.6,275610.8
1001,8/3/2020,8/3/2020,BCBS -August,BCBS - August Health Insurance-August -BCBS Health Insurance,,HJ,,11588.7,264022.1
1001,8/3/2020,8/3/2020,Catherine M Tierney,Bill.Com Import--,,HJ,,62.5,263959.6
1001,8/3/2020,8/3/2020,City Colleges of Chi,Bill.Com Import--,,HJ,,3845,260114.6
1001,8/3/2020,8/3/2020,City Colleges of Chi,Bill.Com Import--,,HJ,3845,,263959.6
1001,8/4/2020,8/4/2020,Bank of America VISA,BofA CC Transaction July Payment-BofA CC Transaction July Payment,,HJ,,1400.64,262558.96
1001,8/4/2020,8/4/2020,Bank of America VISA,BofA CC Transaction July Payment-BofA CC Transaction July Payment,,HJ,,8936.48,253622.48
1001,8/4/2020,8/4/2020,Bank of America VISA,BofA CC Transaction July Payment-BofA CC Transaction July Payment,,HJ,,14947.66,238674.82
1001,8/4/2020,8/4/2020,Bank of America VISA,BofA CC Transaction July Payment-BofA CC Transaction July Payment,,HJ,,17964.49,220710.33
1001,8/4/2020,8/4/2020,Bank of America VISA,BofA CC Transaction July Payment-BofA CC Transaction July Payment,,HJ,,31179.64,189530.69
1001,8/4/2020,8/4/2020,Bank of America VISA,BofA CC Transaction July Payment-BofA CC Transaction July Payment,,HJ,,40118.07,149412.62
1001,8/4/2020,8/4/2020,BET-CH,Received A Better Chicago payment-Received A Better Chicago payment,,HJ,75000,,224412.62
1001,8/4/2020,8/4/2020,Department of Labor,Bill.Com Import--,,HJ,,35,224377.62
1001,8/4/2020,8/4/2020,Impact Catalysts,Bill.Com Import--,,HJ,,10000,214377.62
1001,8/4/2020,8/4/2020,Jorge Ramirez,Bill.Com Import--,,HJ,,635,213742.62
1001,8/4/2020,8/4/2020,Julie Balfour,Bill.Com Import--,,HJ,,3333.33,210409.29
1001,8/4/2020,8/4/2020,TAG Resources LLC,401K Payment for PD7/31/2020-401K Payment for PD7/31/2020,,HJ,,2762.28,207647.01
1001,8/4/2020,8/4/2020,Woot Math Inc,Bill.Com Import--,,HJ,,29347.25,178299.76
1001,8/4/2020,8/4/2020,Woot Math Inc,Bill.Com Import--,,HJ,,29347.25,148952.51
1001,8/4/2020,8/4/2020,Woot Math Inc,Bill.Com Import--,,HJ,,58694.5,90258.01
1001,8/5/2020,8/5/2020,20200805,Received CME Chicago grant-Received CME Chicago grant,,HJ,50000,,140258.01
1001,8/5/2020,8/5/2020,20200805,Bank fees for individual donation-Bank fees for individual donation,,HJ,,31.38,140226.63
1001,8/5/2020,8/5/2020,Comcast,August Internet expense-August Internet expense,,HJ,,139.55,140087.08
1001,8/7/2020,8/7/2020,ADP,State and Local Jurisdiction fees-State and Local Jurisdiction fees,,HJ,,62.65,140024.43
1001,8/7/2020,8/7/2020,ADP,PR Process fee for staff ADP-PR Process fee for staff ADP,,HJ,,3544.7,136479.73
1001,8/7/2020,8/7/2020,HRKnowledge,New training and development software Zyware-New training and development software Zyware,,HJ,,4000,132479.73
1001,8/7/2020,8/7/2020,HRKnowledge,HR Outsourcing Admin fee-HR Outsourcing Admin fee for staff PD7/31,,HJ,,850,131629.73
1001,8/7/2020,8/7/2020,Verizon,August Mifi devices for fellows-August Mifi devices for fellows,,HJ,,450.8,131178.93
1001,8/7/2020,8/7/2020,Verizon,August Mifi devices for fellows-August Mifi devices for fellows,,HJ,,2339.55,128839.38
1001,8/10/2020,8/10/2020,Camelot Education,Received funds from Camelot Education-Received funds from Camelot Education,,HJ,20615,,149454.38
1001,8/10/2020,8/10/2020,City Colleges of Chi,Bill.Com Import--,,HJ,3845,,153299.38
1001,8/10/2020,8/10/2020,Inspire Business Cen,August Jackson Center rent-August Jackson Center rent,,HJ,,500,152799.38
1001,8/10/2020,8/10/2020,JE-21-0011,Blue 20/20 Vision Insurance - August Invoice-Blue 20/20 Vision Insurance -August Invoice,,HJ,,13.29,152786.09
1001,8/10/2020,8/10/2020,JE-21-0011,Blue 20/20 Vision Insurance - August Invoice-Blue 20/20 Vision Insurance -August Invoice,,HJ,,20.55,152765.54
1001,8/10/2020,8/10/2020,JE-21-0011,Blue 20/20 Vision Insurance - August Invoice-Blue 20/20 Vision Insurance -August Invoice,,HJ,,20.55,152744.99
1001,8/10/2020,8/10/2020,JE-21-0011,Blue 20/20 Vision Insurance - August Invoice-Blue 20/20 Vision Insurance -August Invoice,,HJ,,66.48,152678.51
1001,8/11/2020,8/11/2020,Eversource,August electricity expense-August electricity expense,,HJ,,30.34,152648.17
1001,8/12/2020,8/12/2020,20200812,Transfer from #8984 to #6488-Transfer from #8984 to #6488,,HJ,452000,,604648.17
1001,8/14/2020,8/14/2020,82L-PRPD-081520,82L-PRPD-081520 -IMPORT PAYROLL-Import Payroll,,HJ,,699.08,603949.09
1001,8/14/2020,8/14/2020,82L-PRPD-081520,82L-PRPD-081520 -IMPORT PAYROLL-Import Payroll,,HJ,,709.48,603239.61
1001,8/14/2020,8/14/2020,82L-PRPD-081520,82L-PRPD-081520 -IMPORT PAYROLL-Import Payroll,,HJ,,1734.34,601505.27
1001,8/14/2020,8/14/2020,82L-PRPD-081520,82L-PRPD-081520 -IMPORT PAYROLL-Import Payroll,,HJ,,2119.29,599385.98
1001,8/14/2020,8/14/2020,82L-PRPD-081520,82L-PRPD-081520 -IMPORT PAYROLL-Import Payroll,,HJ,,3086.31,596299.67
1001,8/14/2020,8/14/2020,82L-PRPD-081520,82L-PRPD-081520 -IMPORT PAYROLL-Import Payroll,,HJ,,3642.78,592656.89
1001,8/14/2020,8/14/2020,82L-PRPD-081520,82L-PRPD-081520 -IMPORT PAYROLL-Import Payroll,,HJ,,4064.67,588592.22
1001,8/14/2020,8/14/2020,82L-PRPD-081520,82L-PRPD-081520 -IMPORT PAYROLL-Import Payroll,,HJ,,4710.84,583881.38
1001,8/14/2020,8/14/2020,82L-PRPD-081520,82L-PRPD-081520 -IMPORT PAYROLL-Import Payroll,,HJ,,4963.4,578917.98
1001,8/14/2020,8/14/2020,82L-PRPD-081520,82L-PRPD-081520 -IMPORT PAYROLL-Import Payroll,,HJ,,8036.11,570881.87
1001,8/14/2020,8/14/2020,82L-PRPD-081520,82L-PRPD-081520 -IMPORT PAYROLL-Import Payroll,,HJ,,8391.79,562490.08
1001,8/14/2020,8/14/2020,82L-PRPD-081520,82L-PRPD-081520 -IMPORT PAYROLL-Import Payroll,,HJ,,10687.45,551802.63
1001,8/14/2020,8/14/2020,82L-PRPD-081520,82L-PRPD-081520 -IMPORT PAYROLL-Import Payroll,,HJ,,10982.13,540820.5
1001,8/14/2020,8/14/2020,82L-PRPD-081520,82L-PRPD-081520 -IMPORT PAYROLL-Import Payroll,,HJ,,16021.18,524799.32
1001,8/14/2020,8/14/2020,82L-PRPD-081520,82L-PRPD-081520 -IMPORT PAYROLL-Import Payroll,,HJ,,16887.51,507911.81
1001,8/14/2020,8/14/2020,82L-PRPD-081520,82L-PRPD-081520 -IMPORT PAYROLL-Import Payroll,,HJ,,30822.74,477089.07
1001,8/14/2020,8/14/2020,82L-PRPD-081520,82L-PRPD-081520 -IMPORT PAYROLL-Import Payroll,,HJ,,43299.08,433789.99
1001,8/14/2020,8/14/2020,82L-PRPD-081520,82L-PRPD-081520 -IMPORT PAYROLL-Import Payroll,,HJ,,83757.1,350032.89
1001,8/14/2020,8/14/2020,82L-PRPD-081520,82L-PRPD-081520 -IMPORT PAYROLL-Wage Pay Credit of 2.8K and 966,,HJ,4057.61,,354090.5
1001,8/14/2020,8/14/2020,82L-PRPD-081520,82L-PRPD-081520 -IMPORT PAYROLL-Workers Comp,,HJ,,632.27,353458.23
1001,8/14/2020,8/14/2020,AAFCPAS,Bill.Com Import--,,HJ,,4000,349458.23
1001,8/14/2020,8/14/2020,City Colleges of Chi,Bill.Com Import--,,HJ,,3845,345613.23
1001,8/14/2020,8/14/2020,Feinberg Hanson,Bill.Com Import--,,HJ,,13077.72,332535.51
1001,8/14/2020,8/14/2020,Media Cause,Bill.Com Import--,,HJ,,26200,306335.51
1001,8/15/2020,8/15/2020,LUX-PRPD-081520,LUX-IMPORT PAYROLL-Import Payroll,,HJ,,2647.29,303688.22
1001,8/15/2020,8/15/2020,LUX-PRPD-081520,LUX-IMPORT PAYROLL-Import Payroll,,HJ,,9272.74,294415.48
1001,8/15/2020,8/15/2020,LUX-PRPD-081520,LUX-IMPORT PAYROLL-Workers Comp,,HJ,,21.08,294394.4
1001,8/15/2020,8/15/2020,TASC,To record August FSA-TASC withholding-To record August FSA-TASC withholding,,HJ,,2249.81,292144.59
1001,8/17/2020,8/17/2020,1.94E+12,Blue 20/20 Vision Insurance -August Invoice-Blue 20/20 Vision Insurance -August Invoice (Dup?),,HJ,,13.29,292131.3
1001,8/17/2020,8/17/2020,1.94E+12,Blue 20/20 Vision Insurance -August Invoice-Blue 20/20 Vision Insurance -August Invoice (Dup?),,HJ,,20.55,292110.75
1001,8/17/2020,8/17/2020,1.94E+12,Blue 20/20 Vision Insurance -August Invoice-Blue 20/20 Vision Insurance -August Invoice (Dup?),,HJ,,20.55,292090.2
1001,8/17/2020,8/17/2020,1.94E+12,Blue 20/20 Vision Insurance -August Invoice-Blue 20/20 Vision Insurance -August Invoice (Dup?),,HJ,,73.59,292016.61
1001,8/17/2020,8/17/2020,T-Mobile,August T-mobile phone expenses-August T-mobile phone expenses,,HJ,,561.6,291455.01
1001,8/18/2020,8/18/2020,Confianza,Bill.Com Import--,,HJ,,200,291255.01
1001,8/18/2020,8/18/2020,HRKnowledge,HR Outsourcing admin fee-HR Outsourcing admin fee,,HJ,,117.7,291137.31
1001,8/18/2020,8/18/2020,HRKnowledge,HR Outsourcing admin fee-HR Outsourcing admin fee,,HJ,,181.9,290955.41
1001,8/18/2020,8/18/2020,HRKnowledge,HR Outsourcing admin fee-HR Outsourcing admin fee,,HJ,,181.9,290773.51
1001,8/18/2020,8/18/2020,HRKnowledge,HR Outsourcing admin fee-HR Outsourcing admin fee,,HJ,,588.5,290185.01
1001,8/18/2020,8/18/2020,HRKnowledge,HRK Admin fee PD8/14-HRK Admin fee PD8/14,,HJ,,17.6,290167.41
1001,8/18/2020,8/18/2020,HRKnowledge,HRK Admin fee PD8/14-HRK Admin fee PD8/14,,HJ,,27.2,290140.21
1001,8/18/2020,8/18/2020,HRKnowledge,HRK Admin fee PD8/14-HRK Admin fee PD8/14,,HJ,,27.2,290113.01
1001,8/18/2020,8/18/2020,HRKnowledge,HRK Admin fee PD8/14-HRK Admin fee PD8/14,,HJ,,88,290025.01
1001,8/18/2020,8/18/2020,TAG Resources LLC,Employee 401K withholding-Employee 401K withholding,,HJ,,2762.28,287262.73
1001,8/18/2020,8/18/2020,The Hartford,NY State disability insurance-NY State disability insurance,,HJ,,583.46,286679.27
1001,8/19/2020,8/19/2020,Catherine M Tierney,Bill.Com Import--,,HJ,,37.5,286641.77
1001,8/19/2020,8/19/2020,Catherine M Tierney,Bill.Com Import--,,HJ,,87.5,286554.27
1001,8/20/2020,8/20/2020,Bank of America VISA,Concur Payment Bambora-Concur Payment Bambora,,HJ,,2349.41,284204.86
1001,8/21/2020,8/21/2020,ACCURATE BIOMETRICS,Bill.Com Import--,,HJ,,1566.5,282638.36
1001,8/21/2020,8/21/2020,Appcast Inc.,Bill.Com Import--,,HJ,,804.95,281833.41
1001,8/21/2020,8/21/2020,Monivett Acevedo,Imported from reimbursements-home office chair,,HJ,,74.88,281758.53
1001,8/21/2020,8/21/2020,Monivett Acevedo,Imported from reimbursements-home office desk,,HJ,,124.99,281633.54
1001,8/21/2020,8/21/2020,Whiteboard,Bill.Com Import--,,HJ,,7500,274133.54
1001,8/26/2020,8/26/2020,20200826,Online banking transfer from #8984 to #6488-Online banking transfer from #8984 to #6488,,HJ,551000,,825133.54
1001,8/26/2020,8/26/2020,2020-07 Relocation,Bill.Com Import--,,HJ,,875,824258.54
1001,8/26/2020,8/26/2020,Appcast Inc.,Bill.Com Import--,,HJ,,2108,822150.54
1001,8/26/2020,8/26/2020,Eversource,Bill.Com Import-Bill.Com Import,,HJ,,0.66,822149.88
1001,8/26/2020,8/26/2020,Leslie Wade LLC,Bill.Com Import--,,HJ,,6448,815701.88
1001,8/26/2020,8/26/2020,Walnut Street Realty,Bill.Com Import--,,HJ,,2178.87,813523.01
1001,8/27/2020,8/27/2020,City Colleges of Chi,Bill.Com Import--,,HJ,3845,,817368.01
1001,8/27/2020,8/27/2020,Salesforce.org,Bill.Com Import--,,HJ,,43.05,817324.96
1001,8/27/2020,8/27/2020,Salesforce.org,Bill.Com Import--,,HJ,,66.52,817258.44
1001,8/27/2020,8/27/2020,Salesforce.org,Bill.Com Import--,,HJ,,66.52,817191.92
1001,8/27/2020,8/27/2020,Salesforce.org,Bill.Com Import--,,HJ,,215.23,816976.69
1001,8/28/2020,8/28/2020,Abila,Bill.Com Import--,,HJ,,250,816726.69
1001,8/28/2020,8/28/2020,Culture Amp,Bill.Com Import--,,HJ,,9185.31,807541.38
1001,8/28/2020,8/28/2020,Eversource,Bill.Com Import--,,HJ,0.66,,807542.04
1001,8/29/2020,8/29/2020,HRKnowledge,Setup of onboarding expenses for fellows and staffs-Setup of onboarding expenses for fellows,,HJ,,1097.25,806444.79
1001,8/29/2020,8/29/2020,HRKnowledge,Setup of onboarding expenses for fellows and staffs-Setup of onboarding expenses for fellows,,HJ,,1695.75,804749.04
1001,8/29/2020,8/29/2020,HRKnowledge,Setup of onboarding expenses for fellows and staffs-Setup of onboarding expenses for fellows,,HJ,,1695.75,803053.29
1001,8/29/2020,8/29/2020,HRKnowledge,Setup of onboarding expenses for fellows and staffs-Setup of onboarding expenses for fellows,,HJ,,5486.25,797567.04
1001,8/29/2020,8/29/2020,HRKnowledge,Setup of onboarding expenses for fellows and staffs-Setup of onboarding expenses for fellows and staffs,,HJ,,3325,794242.04
1001,8/29/2020,8/29/2020,HRKnowledge,Setup of onboarding expenses for fellows and staffs-Setup of onboarding expenses for fellows and staffs,,HJ,,3325,790917.04
1001,8/29/2020,8/29/2020,HRKnowledge,Setup of onboarding expenses for fellows and staffs-Setup of onboarding expenses for fellows and staffs,,HJ,,3325,787592.04
1001,8/31/2020,8/31/2020,82L-PRPD-083120,82L-PRPD-083120 -IMPORT PAYROLL-Import Payroll,,HJ,,699.08,786892.96
1001,8/31/2020,8/31/2020,82L-PRPD-083120,82L-PRPD-083120 -IMPORT PAYROLL-Import Payroll,,HJ,,709.48,786183.48
1001,8/31/2020,8/31/2020,82L-PRPD-083120,82L-PRPD-083120 -IMPORT PAYROLL-Import Payroll,,HJ,,1734.34,784449.14
1001,8/31/2020,8/31/2020,82L-PRPD-083120,82L-PRPD-083120 -IMPORT PAYROLL-Import Payroll,,HJ,,2119.29,782329.85
1001,8/31/2020,8/31/2020,82L-PRPD-083120,82L-PRPD-083120 -IMPORT PAYROLL-Import Payroll,,HJ,,3086.31,779243.54
1001,8/31/2020,8/31/2020,82L-PRPD-083120,82L-PRPD-083120 -IMPORT PAYROLL-Import Payroll,,HJ,,3642.78,775600.76
1001,8/31/2020,8/31/2020,82L-PRPD-083120,82L-PRPD-083120 -IMPORT PAYROLL-Import Payroll,,HJ,,4064.67,771536.09
1001,8/31/2020,8/31/2020,82L-PRPD-083120,82L-PRPD-083120 -IMPORT PAYROLL-Import Payroll,,HJ,,4710.84,766825.25
1001,8/31/2020,8/31/2020,82L-PRPD-083120,82L-PRPD-083120 -IMPORT PAYROLL-Import Payroll,,HJ,,4963.4,761861.85
1001,8/31/2020,8/31/2020,82L-PRPD-083120,82L-PRPD-083120 -IMPORT PAYROLL-Import Payroll,,HJ,,8036.11,753825.74
1001,8/31/2020,8/31/2020,82L-PRPD-083120,82L-PRPD-083120 -IMPORT PAYROLL-Import Payroll,,HJ,,8391.79,745433.95
1001,8/31/2020,8/31/2020,82L-PRPD-083120,82L-PRPD-083120 -IMPORT PAYROLL-Import Payroll,,HJ,,10687.45,734746.5
1001,8/31/2020,8/31/2020,82L-PRPD-083120,82L-PRPD-083120 -IMPORT PAYROLL-Import Payroll,,HJ,,10982.13,723764.37
1001,8/31/2020,8/31/2020,82L-PRPD-083120,82L-PRPD-083120 -IMPORT PAYROLL-Import Payroll,,HJ,,16021.18,707743.19
1001,8/31/2020,8/31/2020,82L-PRPD-083120,82L-PRPD-083120 -IMPORT PAYROLL-Import Payroll,,HJ,,16887.51,690855.68
1001,8/31/2020,8/31/2020,82L-PRPD-083120,82L-PRPD-083120 -IMPORT PAYROLL-Import Payroll,,HJ,,30822.74,660032.94
1001,8/31/2020,8/31/2020,82L-PRPD-083120,82L-PRPD-083120 -IMPORT PAYROLL-Import Payroll,,HJ,,43299.08,616733.86
1001,8/31/2020,8/31/2020,82L-PRPD-083120,82L-PRPD-083120 -IMPORT PAYROLL-Import Payroll,,HJ,,83757.1,532976.76
1001,8/31/2020,8/31/2020,82L-PRPD-083120,82L-PRPD-083120 -IMPORT PAYROLL-Wage Pay increase place holder,,HJ,,53000.33,479976.43
1001,8/31/2020,8/31/2020,82L-PRPD-083120,82L-PRPD-083120 -IMPORT PAYROLL-Workers Comp,,HJ,,758.84,479217.59
1001,8/31/2020,8/31/2020,Abila,Bill.Com Import--,,HJ,,110,479107.59
1001,8/31/2020,8/31/2020,LUX-PRPD-083120,LUX-PRPD-083120 -Payroll-Net Pay & Taxes,,HJ,,1159.14,477948.45
1001,8/31/2020,8/31/2020,LUX-PRPD-083120,LUX-PRPD-083120 -Payroll-Net Pay & Taxes,,HJ,,5888.26,472060.19
1001,8/31/2020,8/31/2020,LUX-PRPD-083120,LUX-PRPD-083120 -Payroll-Net Pay & Taxes,,HJ,,19700.72,452359.47
1001,8/31/2020,8/31/2020,LUX-PRPD-083120,LUX-PRPD-083120 -Payroll-Net Pay & Taxes Net Pay & Taxes,,HJ,,102161.65,350197.82
1001,8/31/2020,8/31/2020,LUX-PRPD-083120,LUX-PRPD-083120 -Payroll-Workers Comp Exp: Pay-by-pay,,HJ,,211.04,349986.78
1001,8/31/2020,8/31/2020,Tiffany Cardona,Bill.Com Import--,,HJ,,2499.6,347487.18
1001,8/31/2020,8/31/2020,VIGOROUS INT.,Bill.Com Import--,,HJ,,7062,340425.18
1001,9/1/2020,9/1/2020,BCBS,BCBS - September 82L Invoices-BCBS - September 82L Invoices,,HJ,0.46,,340425.64
1001,9/1/2020,9/1/2020,BCBS,BCBS - September 82L Invoices-BCBS - September 82L Invoices,,HJ,,81.81,340343.83
1001,9/1/2020,9/1/2020,BCBS,BCBS - September 82L Invoices-BCBS - September 82L Invoices,,HJ,,112.88,340230.95
1001,9/1/2020,9/1/2020,BCBS,BCBS - September 82L Invoices-BCBS - September 82L Invoices,,HJ,,306.35,339924.6
1001,9/1/2020,9/1/2020,BCBS,BCBS - September 82L Invoices-BCBS - September 82L Invoices,,HJ,,330.83,339593.77
1001,9/1/2020,9/1/2020,BCBS,BCBS - September 82L Invoices-BCBS - September 82L Invoices,,HJ,615.53,,340209.3
1001,9/1/2020,9/1/2020,BCBS,BCBS - September 82L Invoices-BCBS - September 82L Invoices,,HJ,,798.11,339411.19
1001,9/1/2020,9/1/2020,BCBS,BCBS - September 82L Invoices-BCBS - September 82L Invoices,,HJ,,1253.75,338157.44
1001,9/1/2020,9/1/2020,BCBS,BCBS - September 82L Invoices-BCBS - September 82L Invoices,,HJ,,1473.68,336683.76
1001,9/1/2020,9/1/2020,BCBS,BCBS - September 82L Invoices-BCBS - September 82L Invoices,,HJ,,3580.26,333103.5
1001,9/1/2020,9/1/2020,BCBS,BCBS - September 82L Invoices-BCBS - September 82L Invoices,,HJ,,8009.16,325094.34
1001,9/1/2020,9/1/2020,BCBS,BCBS - September 82L Invoices-BCBS - September 82L Invoices,,HJ,,9714.34,315380
1001,9/1/2020,9/1/2020,BCBS,BCBS - September 82L Invoices-BCBS - September 82L Invoices,,HJ,10333.22,,325713.22
1001,9/1/2020,9/1/2020,BCBS,BCBS - September 82L Invoices-BCBS - September 82L Invoices,,HJ,,13204.53,312508.69
1001,9/1/2020,9/1/2020,TASC,Employee TASC withdrawn-Employee TASC withdrawn,,HJ,,1360.41,311148.28
1001,9/2/2020,9/2/2020,20200902,Direct Deposit returns for Milford Chavous & Joshua Lewis Cassidy-Direct Deposit returns for Milford Chavous & Joshua Lewis Cassidy,,HJ,2691.45,,313839.73
1001,9/2/2020,9/2/2020,HRKnowledge,HR Outsourcing admin fee-HR Outsourcing admin fee for fellows-pd 8/31,,HJ,,137.5,313702.23
1001,9/2/2020,9/2/2020,HRKnowledge,HR Outsourcing admin fee-HR Outsourcing admin fee for fellows-pd 8/31,,HJ,,212.5,313489.73
1001,9/2/2020,9/2/2020,HRKnowledge,HR Outsourcing admin fee-HR Outsourcing admin fee for fellows-pd 8/31,,HJ,,212.5,313277.23
1001,9/2/2020,9/2/2020,HRKnowledge,HR Outsourcing admin fee-HR Outsourcing admin fee for fellows-pd 8/31,,HJ,,687.5,312589.73
1001,9/2/2020,9/2/2020,HRKnowledge,HRK Admin fee and 401K loss earnings-HRK Admin fee and 401K loss earnings for staffs,,HJ,,1643.83,310945.9
1001,9/2/2020,9/2/2020,JE-21-0031,Blue 20/20 Vision Insurance - September Inv-Blue 20/20 Vision Insurance -September Invoice,,HJ,,7.11,310938.79
1001,9/2/2020,9/2/2020,JE-21-0031,Blue 20/20 Vision Insurance - September Inv-Blue 20/20 Vision Insurance -September Invoice,,HJ,,7.11,310931.68
1001,9/2/2020,9/2/2020,JE-21-0031,Blue 20/20 Vision Insurance - September Inv-Blue 20/20 Vision Insurance -September Invoice,,HJ,,28.44,310903.24
1001,9/2/2020,9/2/2020,JE-21-0031,Blue 20/20 Vision Insurance - September Inv-Blue 20/20 Vision Insurance -September Invoice,,HJ,,28.44,310874.8
1001,9/2/2020,9/2/2020,JE-21-0031,Blue 20/20 Vision Insurance - September Inv-Blue 20/20 Vision Insurance -September Invoice,,HJ,,35.55,310839.25
1001,9/2/2020,9/2/2020,JE-21-0031,Blue 20/20 Vision Insurance - September Inv-Blue 20/20 Vision Insurance -September Invoice,,HJ,,35.55,310803.7
1001,9/2/2020,9/2/2020,JE-21-0031,Blue 20/20 Vision Insurance - September Inv-Blue 20/20 Vision Insurance -September Invoice,,HJ,,35.55,310768.15
1001,9/2/2020,9/2/2020,JE-21-0031,Blue 20/20 Vision Insurance - September Inv-Blue 20/20 Vision Insurance -September Invoice,,HJ,,69.68,310698.47
1001,9/2/2020,9/2/2020,TAG Resources LLC,Employee 401K withholding-Employee 401K withholding,,HJ,,2762.28,307936.19
1001,9/2/2020,9/2/2020,Whiteboard,Bill.Com Import--,,HJ,,10000,297936.19
1001,9/3/2020,9/3/2020,Julie Balfour,Bill.Com Import--,,HJ,,3333.33,294602.86
1001,9/4/2020,9/4/2020,20200904,Cash Received from Facebook-Cash Received from Facebook,,HJ,140,,294742.86
1001,9/4/2020,9/4/2020,Bank of America VISA,BofA CC Transactions August Payments-BofA CC Transaction August Payment,,HJ,,264.99,294477.87
1001,9/4/2020,9/4/2020,Bank of America VISA,BofA CC Transactions August Payments-BofA CC Transaction August Payment,,HJ,,719.26,293758.61
1001,9/4/2020,9/4/2020,Bank of America VISA,BofA CC Transactions August Payments-BofA CC Transaction August Payment,,HJ,,2624,291134.61
1001,9/4/2020,9/4/2020,Bank of America VISA,BofA CC Transactions August Payments-BofA CC Transaction August Payment,,HJ,,3395.14,287739.47
1001,9/4/2020,9/4/2020,Bank of America VISA,BofA CC Transactions August Payments-BofA CC Transaction August Payment,,HJ,,9193.8,278545.67
1001,9/4/2020,9/4/2020,Bank of America VISA,BofA CC Transactions August Payments-BofA CC Transaction August Payment,,HJ,,11186.79,267358.88
1001,9/4/2020,9/4/2020,Bank of America VISA,BofA CC Transactions August Payments-BofA CC Transaction August Payment,,HJ,,15240.51,252118.37
1001,9/4/2020,9/4/2020,Bank of America VISA,BofA CC Transactions August Payments-BofA CC Transaction August Payment,,HJ,,37961.17,214157.2
1001,9/4/2020,9/4/2020,WALTON,Received Walton Family Foundation Payment-Received Walton Family Foundation Payment,,HJ,200000,,414157.2
1001,9/8/2020,9/8/2020,20200908,Called back Kai English the Direct Deposit for a mistake PR-Called back Kai English the Direct Deposit for a mistake PR,,HJ,874.75,,415031.95
1001,9/8/2020,9/8/2020,Comcast,September Internet expenses-Comcast-September Internet expenses-Comcast,,HJ,,139.55,414892.4
1001,9/8/2020,9/8/2020,Eversource,September electricity expense-September electricity expense,,HJ,,38.74,414853.66
1001,9/9/2020,9/9/2020,Hannah Gibbs,Bill.Com Import--,,HJ,,51.63,414802.03
1001,9/9/2020,9/9/2020,Inspire Business Cen,Jackson Center September rent-Jackson Center September rent,,HJ,,500,414302.03
1001,9/9/2020,9/9/2020,Kalli Ann Hale,Bill.Com Import--,,HJ,,45.52,414256.51
1001,9/9/2020,9/9/2020,MCGRAW HILL,Bill.Com Import--,,HJ,,2885.05,411371.46
1001,9/9/2020,9/9/2020,MCGRAW HILL,Bill.Com Import--,,HJ,,4458.65,406912.81
1001,9/9/2020,9/9/2020,MCGRAW HILL,Bill.Com Import--,,HJ,,4458.65,402454.16
1001,9/9/2020,9/9/2020,MCGRAW HILL,Bill.Com Import--,,HJ,,14425.09,388029.07
1001,9/9/2020,9/9/2020,Michael Westphal,Bill.Com Import--,,HJ,,46.6,387982.47
1001,9/9/2020,9/9/2020,Nafepa,Bill.Com Import--,,HJ,,2000,385982.47
1001,9/9/2020,9/9/2020,TASC,Bill.Com Import--,,HJ,,1250.94,384731.53
1001,9/10/2020,9/10/2020,20200910,Transfer from #8984 to #6488-Transfer from #8984 to #6488,,HJ,250000,,634731.53
1001,9/10/2020,9/10/2020,BCBS,BCBS - September LUX Invoices-BCBS - September LUX Invoices,,HJ,,143.49,634588.04
1001,9/10/2020,9/10/2020,BCBS,BCBS - September LUX Invoices-BCBS - September LUX Invoices,,HJ,,485.94,634102.1
1001,9/10/2020,9/10/2020,BCBS,BCBS - September LUX Invoices-BCBS - September LUX Invoices,,HJ,,1434.9,632667.2
1001,9/10/2020,9/10/2020,BCBS,BCBS - September LUX Invoices-BCBS - September LUX Invoices,,HJ,,1561.29,631105.91
1001,9/10/2020,9/10/2020,BCBS,BCBS - September LUX Invoices-BCBS - September LUX Invoices,,HJ,,1561.29,629544.62
1001,9/10/2020,9/10/2020,BCBS,BCBS - September LUX Invoices-BCBS - September LUX Invoices,,HJ,,14005.58,615539.04
1001,9/10/2020,9/10/2020,HRKnowledge,Virtual HR: Essentials Q4-Oct-Dec 2020-Virtual HR: Essentials Q4-Oct-Dec 2020,,HJ,,3000,612539.04
1001,9/10/2020,9/10/2020,Monivett Acevedo,Imported from reimbursements-Gates meeting with Director of Grants for EOY report,,HJ,,505.07,612033.97
1001,9/10/2020,9/10/2020,Verizon,September Mifi devices for fellows-September Mifi devices for fellows,,HJ,,450.8,611583.17
1001,9/11/2020,9/11/2020,ADP,ADP PR process fees for fellows-ADP PR process fees for fellows,,HJ,,55.54,611527.63
1001,9/11/2020,9/11/2020,ADP,ADP PR process fees for fellows-ADP PR process fees for fellows,,HJ,,85.84,611441.79
1001,9/11/2020,9/11/2020,ADP,ADP PR process fees for fellows-ADP PR process fees for fellows,,HJ,,85.84,611355.95
1001,9/11/2020,9/11/2020,ADP,ADP PR process fees for fellows-ADP PR process fees for fellows,,HJ,,277.73,611078.22
1001,9/11/2020,9/11/2020,ADP,ADP PR time and attendance fees-ADP PR time and attendance fees,,HJ,,3327.07,607751.15
1001,9/14/2020,9/14/2020,HRKnowledge,ACH for Jeanette Croen's salary-ACH for Jeanette Croen's salary,,HJ,,837.68,606913.47
1001,9/15/2020,9/15/2020,91520,82L-IMPORT PAYROLL-IMPORT PAYROLL -ADP WAGE PAY DES:WAGE PAY ID:25005811449882L on 9.16.20,,HJ,,3333.21,603580.26
1001,9/15/2020,9/15/2020,91520,82L-IMPORT PAYROLL-Import Payroll,,HJ,,326.04,603254.22
1001,9/15/2020,9/15/2020,91520,82L-IMPORT PAYROLL-Import Payroll,,HJ,,735.21,602519.01
1001,9/15/2020,9/15/2020,91520,82L-IMPORT PAYROLL-Import Payroll,,HJ,,3799.46,598719.55
1001,9/15/2020,9/15/2020,91520,82L-IMPORT PAYROLL-Import Payroll,,HJ,,5843.9,592875.65
1001,9/15/2020,9/15/2020,91520,82L-IMPORT PAYROLL-Import Payroll,,HJ,,6588.36,586287.29
1001,9/15/2020,9/15/2020,91520,82L-IMPORT PAYROLL-Import Payroll,,HJ,,9751.44,576535.85
1001,9/15/2020,9/15/2020,91520,82L-IMPORT PAYROLL-Import Payroll,,HJ,,16268.69,560267.16
1001,9/15/2020,9/15/2020,91520,82L-IMPORT PAYROLL-Import Payroll,,HJ,,18167.13,542100.03
1001,9/15/2020,9/15/2020,91520,82L-IMPORT PAYROLL-Import Payroll,,HJ,,55457.18,486642.85
1001,9/15/2020,9/15/2020,91520,82L-IMPORT PAYROLL-Import Payroll,,HJ,,88121.02,398521.83
1001,9/15/2020,9/15/2020,91520,82L-IMPORT PAYROLL-Import Payroll,,HJ,,98839.02,299682.81
1001,9/15/2020,9/15/2020,20200915,Transfer from #8984 to #6488-Transfer from #8984 to #6488,,HJ,99000,,398682.81
1001,9/15/2020,9/15/2020,Confianza,Bill.Com Import--,,HJ,,200,398482.81
1001,9/15/2020,9/15/2020,Feinberg Hanson,Bill.Com Import--,,HJ,,9136.77,389346.04
1001,9/15/2020,9/15/2020,Impact Catalysts,Bill.Com Import--,,HJ,,5000,384346.04
1001,9/15/2020,9/15/2020,LUX-PRPD-091520,LUX-PRPD-091520-LUX-PRPD-091520 -Payroll,,HJ,,210.36,384135.68
1001,9/15/2020,9/15/2020,LUX-PRPD-091520,LUX-PRPD-091520-LUX-PRPD-091520 -Payroll,,HJ,,4907.13,379228.55
1001,9/15/2020,9/15/2020,LUX-PRPD-091520,LUX-PRPD-091520-LUX-PRPD-091520 -Payroll,,HJ,,19210.86,360017.69
1001,9/15/2020,9/15/2020,LUX-PRPD-091520,LUX-PRPD-091520-LUX-PRPD-091520 -Payroll,,HJ,,100657.74,259359.95
1001,9/16/2020,9/16/2020,20200916,Transfer from #8984 to #6488-Transfer from #8984 to #6488,,HJ,250000,,509359.95
1001,9/16/2020,9/16/2020,TAG Resources LLC,Employee 401K withholding-Employee 401K withholding,,HJ,,3025.73,506334.22
1001,9/16/2020,9/16/2020,TASC,Employee TASC withdrawn 9-15-Employee TASC withdrawn 9-15,,HJ,,1635.75,504698.47
1001,9/17/2020,9/17/2020,T-Mobile,August phone expenses for fellows-August phone expenses for fellows,,HJ,,61.78,504636.69
1001,9/17/2020,9/17/2020,T-Mobile,August phone expenses for fellows-August phone expenses for fellows,,HJ,,95.47,504541.22
1001,9/17/2020,9/17/2020,T-Mobile,August phone expenses for fellows-August phone expenses for fellows,,HJ,,95.47,504445.75
1001,9/17/2020,9/17/2020,T-Mobile,August phone expenses for fellows-August phone expenses for fellows,,HJ,,308.88,504136.87
1001,9/21/2020,9/21/2020,Appcast Inc.,Bill.Com Import--,,HJ,,7373.75,496763.12
1001,9/22/2020,9/22/2020,ACCURATE BIOMETRICS,Bill.Com Import--,,HJ,,3253.5,493509.62
1001,9/22/2020,9/22/2020,HRKnowledge,Setup of ADP pre-hire onboarding-Setup of ADP pre-hire onboarding,,HJ,,412.76,493096.86
1001,9/22/2020,9/22/2020,HRKnowledge,Setup of ADP pre-hire onboarding-Setup of ADP pre-hire onboarding,,HJ,,637.93,492458.93
1001,9/22/2020,9/22/2020,HRKnowledge,Setup of ADP pre-hire onboarding-Setup of ADP pre-hire onboarding,,HJ,,637.93,491821
1001,9/22/2020,9/22/2020,HRKnowledge,Setup of ADP pre-hire onboarding-Setup of ADP pre-hire onboarding,,HJ,,2063.88,489757.12
1001,9/22/2020,9/22/2020,HRKnowledge,HRK admin fee for fellows-HRK admin fee for fellows,,HJ,,135.3,489621.82
1001,9/22/2020,9/22/2020,HRKnowledge,HRK admin fee for fellows-HRK admin fee for fellows,,HJ,,209.1,489412.72
1001,9/22/2020,9/22/2020,HRKnowledge,HRK admin fee for fellows-HRK admin fee for fellows,,HJ,,209.1,489203.62
1001,9/22/2020,9/22/2020,HRKnowledge,HRK admin fee for fellows-HRK admin fee for fellows,,HJ,,676.5,488527.12
1001,9/22/2020,9/22/2020,Salesforce.org,Bill.Com Import--,,HJ,,85.8,488441.32
1001,9/22/2020,9/22/2020,Salesforce.org,Bill.Com Import--,,HJ,,132.6,488308.72
1001,9/22/2020,9/22/2020,Salesforce.org,Bill.Com Import--,,HJ,,132.6,488176.12
1001,9/22/2020,9/22/2020,Salesforce.org,Bill.Com Import--,,HJ,,429,487747.12
1001,9/22/2020,9/22/2020,Whiteboard,Bill.Com Import--,,HJ,,8191.65,479555.47
1001,9/22/2020,9/22/2020,Woot Math Inc,Bill.Com Import--,,HJ,,52437.74,427117.73
1001,9/22/2020,9/22/2020,Woot Math Inc,Bill.Com Import--,,HJ,,85324.32,341793.41
1001,9/23/2020,9/23/2020,HRKnowledge,HR Outsourcing admin fee for staff PD9/15-HR Outsourcing admin fee for staff PD9/15,,HJ,,1420,340373.41
1001,9/23/2020,9/23/2020,iaklestad,Imported from reimbursements-Recruitment Call,,HJ,,89.64,340283.77
1001,9/23/2020,9/23/2020,The Hanover Ins,Bill.Com Import--,,HJ,,5864.25,334419.52
1001,9/24/2020,9/24/2020,20200924,Called back Kai English the Direct Deposit for a mistake PR-Called back Kai English the Direct Deposit for a mistake PR,,HJ,,874.75,333544.77
1001,9/24/2020,9/24/2020,Catherine M Tierney,Bill.Com Import--,,HJ,,40,333504.77
1001,9/25/2020,9/25/2020,Alexander Randolph,Bill.Com Import--,,HJ,,55.35,333449.42
1001,9/25/2020,9/25/2020,Dstillery Inc.,Bill.Com Import--,,HJ,,1830.86,331618.56
1001,9/25/2020,9/25/2020,Enabler Design,Bill.Com Import--,,HJ,,540,331078.56
1001,9/25/2020,9/25/2020,Leslie Wade LLC,Bill.Com Import--,,HJ,,6432,324646.56
1001,9/25/2020,9/25/2020,Media Cause,Bill.Com Import--,,HJ,,13884,310762.56
1001,9/25/2020,9/25/2020,Walnut Street Realty,Bill.Com Import--,,HJ,,2178.87,308583.69
1001,9/28/2020,9/28/2020,20200928,Transfer from #8984 to #6488-Transfer from #8984 to #6488,,HJ,351000,,659583.69
1001,9/28/2020,9/28/2020,LLOYDFRY,Received payment from Fry Foundation-Received payment from Fry Foundation,,HJ,40000,,699583.69
1001,9/29/2020,9/29/2020,Harper Kerkhoff,Imported from reimbursements-FIngerprinting,,HJ,,609.5,698974.19
1001,9/29/2020,9/29/2020,Harper Kerkhoff,Imported from reimbursements-Fingerprinting,,HJ,,118,698856.19
1001,9/30/2020,9/30/2020,93020,82L-IMPORT PAYROLL-Import Payroll,,HJ,,4401,694455.19
1001,9/30/2020,9/30/2020,93020,82L-IMPORT PAYROLL-Import Payroll,,HJ,,5843.88,688611.31
1001,9/30/2020,9/30/2020,93020,82L-IMPORT PAYROLL-Import Payroll,,HJ,,6588.34,682022.97
1001,9/30/2020,9/30/2020,93020,82L-IMPORT PAYROLL-Import Payroll,,HJ,,9931.21,672091.76
1001,9/30/2020,9/30/2020,93020,82L-IMPORT PAYROLL-Import Payroll,,HJ,,16198.58,655893.18
1001,9/30/2020,9/30/2020,93020,82L-IMPORT PAYROLL-Import Payroll,,HJ,,18819.96,637073.22
1001,9/30/2020,9/30/2020,93020,82L-IMPORT PAYROLL-Import Payroll,,HJ,,56468.35,580604.87
1001,9/30/2020,9/30/2020,93020,82L-IMPORT PAYROLL-Import Payroll,,HJ,,82848.84,497756.03
1001,9/30/2020,9/30/2020,93020,82L-IMPORT PAYROLL-Import Payroll,,HJ,,101574.28,396181.75
1001,9/30/2020,9/30/2020,Abila,Bill.Com Import--,,HJ,,110,396071.75
1001,9/30/2020,9/30/2020,Abila,Bill.Com Import--,,HJ,,250,395821.75
1001,9/30/2020,9/30/2020,LUX-PRPD-093020,LUX-PRPD-093020-Payroll,,HJ,,209.16,395612.59
1001,9/30/2020,9/30/2020,LUX-PRPD-093020,LUX-PRPD-093020-Payroll,,HJ,,4750.88,390861.71
1001,9/30/2020,9/30/2020,LUX-PRPD-093020,LUX-PRPD-093020-Payroll,,HJ,,19200.5,371661.21
1001,9/30/2020,9/30/2020,LUX-PRPD-093020,LUX-PRPD-093020-Payroll,,HJ,,101274.35,270386.86
1001,10/1/2020,10/1/2020,BCBS,October BCBS Payment-BCBS - October BCBS,,HJ,143.49,,270530.35
1001,10/1/2020,10/1/2020,BCBS,October BCBS Payment-BCBS - October BCBS,,HJ,,242.58,270287.77
1001,10/1/2020,10/1/2020,BCBS,October BCBS Payment-BCBS - October BCBS,,HJ,,358.29,269929.48
1001,10/1/2020,10/1/2020,BCBS,October BCBS Payment-BCBS - October BCBS,,HJ,788.11,,270717.59
1001,10/1/2020,10/1/2020,BCBS,October BCBS Payment-BCBS - October BCBS,,HJ,856.46,,271574.05
1001,10/1/2020,10/1/2020,BCBS,October BCBS Payment-BCBS - October BCBS,,HJ,1561.29,,273135.34
1001,10/1/2020,10/1/2020,BCBS,October BCBS Payment-BCBS - October BCBS,,HJ,,1647.87,271487.47
1001,10/1/2020,10/1/2020,BCBS,October BCBS Payment-BCBS - October BCBS,,HJ,,1717.96,269769.51
1001,10/1/2020,10/1/2020,BCBS,October BCBS Payment-BCBS - October BCBS,,HJ,,3646.74,266122.77
1001,10/1/2020,10/1/2020,BCBS,October BCBS Payment-BCBS - October BCBS,,HJ,,7420.09,258702.68
1001,10/1/2020,10/1/2020,BCBS,October BCBS Payment-BCBS - October BCBS,,HJ,,9452.89,249249.79
1001,10/1/2020,10/1/2020,BCBS,October BCBS Payment-BCBS - October BCBS,,HJ,11986.2,,261235.99
1001,10/1/2020,10/1/2020,BCBS,October BCBS Payment-BCBS - October BCBS,,HJ,,12140.84,249095.15
1001,10/1/2020,10/1/2020,BCBS,October BCBS Payment-BCBS - October BCBS,,HJ,,15477.45,233617.7
1001,10/1/2020,10/1/2020,Catherine M Tierney,Bill.Com Import--,,HJ,,40,233577.7
1001,10/1/2020,10/1/2020,Littler Mendelson,Bill.Com Import--,,HJ,,570,233007.7
1001,10/1/2020,10/1/2020,Monivett Acevedo,Imported from reimbursements-lunch with Finance team,,HJ,,52.84,232954.86
1001,10/1/2020,10/1/2020,Monivett Acevedo,Imported from reimbursements-register for TSA pre check,,HJ,,85,232869.86
1001,10/2/2020,10/2/2020,JE-21-0072,BLue 20/020 Vision Insurance-Blue 20/20 Vision Insurance October Invoice,,HJ,,14.22,232855.64
1001,10/2/2020,10/2/2020,JE-21-0072,BLue 20/020 Vision Insurance-Blue 20/20 Vision Insurance October Invoice,,HJ,,27.73,232827.91
1001,10/2/2020,10/2/2020,JE-21-0072,BLue 20/020 Vision Insurance-Blue 20/20 Vision Insurance October Invoice,,HJ,,42.66,232785.25
1001,10/2/2020,10/2/2020,JE-21-0072,BLue 20/020 Vision Insurance-Blue 20/20 Vision Insurance October Invoice,,HJ,,68.97,232716.28
1001,10/2/2020,10/2/2020,JE-21-0072,BLue 20/020 Vision Insurance-Blue 20/20 Vision Insurance October Invoice,,HJ,,92.43,232623.85
1001,10/2/2020,10/2/2020,JE-21-0072,BLue 20/020 Vision Insurance-Blue 20/20 Vision Insurance October Invoice,,HJ,,168.51,232455.34
1001,10/2/2020,10/2/2020,JE-21-0073,Blue 20/20 Vision Insurance-Blue 20/20 Vision Insurance -October Invoice,,HJ,,21.33,232434.01
1001,10/2/2020,10/2/2020,JE-21-0073,Blue 20/20 Vision Insurance-Blue 20/20 Vision Insurance -October Invoice,,HJ,,191.97,232242.04
1001,10/2/2020,10/2/2020,JE-21-0073,Blue 20/20 Vision Insurance-Credit,,HJ,21.33,,232263.37
1001,10/2/2020,10/2/2020,TAG Resources LLC,Employee 401K withholding pd9/30-Employee 401K withholding pd9/30,,HJ,,3180.73,229082.64
1001,10/2/2020,10/2/2020,TASC,Employee TASC payment-Employee TASC payment,,HJ,,377.66,228704.98
1001,10/5/2020,10/5/2020,Bank of America VISA,BofA CC Transactions September Payment-BofA CC September Statement Payment,,HJ,,979.85,227725.13
1001,10/5/2020,10/5/2020,Bank of America VISA,BofA CC Transactions September Payment-BofA CC September Statement Payment,,HJ,,2394.33,225330.8
1001,10/5/2020,10/5/2020,Bank of America VISA,BofA CC Transactions September Payment-BofA CC September Statement Payment,,HJ,,3452.23,221878.57
1001,10/5/2020,10/5/2020,Bank of America VISA,BofA CC Transactions September Payment-BofA CC September Statement Payment,,HJ,,7167.12,214711.45
1001,10/5/2020,10/5/2020,Bank of America VISA,BofA CC Transactions September Payment-BofA CC September Statement Payment,,HJ,,7191.95,207519.5
1001,10/5/2020,10/5/2020,Bank of America VISA,BofA CC Transactions September Payment-BofA CC September Statement Payment,,HJ,,8352.07,199167.43
1001,10/5/2020,10/5/2020,Bank of America VISA,BofA CC Transactions September Payment-BofA CC September Statement Payment,,HJ,,10036.21,189131.22
1001,10/5/2020,10/5/2020,Comcast,October Comcast payment-October Comcast payment for office,,HJ,,139.55,188991.67
1001,10/5/2020,10/5/2020,HRKnowledge,HR outsourcing admin fee for staff pd 9-30-HR outsourcing admin fee for staff pd 9-30,,HJ,,1430,187561.67
1001,10/5/2020,10/5/2020,HRKnowledge,HR Outsourcing admin fee for fellows-HR Outsourcing admin fee for fellows PD9/30,,HJ,,134.2,187427.47
1001,10/5/2020,10/5/2020,HRKnowledge,HR Outsourcing admin fee for fellows-HR Outsourcing admin fee for fellows PD9/30,,HJ,,207.4,187220.07
1001,10/5/2020,10/5/2020,HRKnowledge,HR Outsourcing admin fee for fellows-HR Outsourcing admin fee for fellows PD9/30,,HJ,,207.4,187012.67
1001,10/5/2020,10/5/2020,HRKnowledge,HR Outsourcing admin fee for fellows-HR Outsourcing admin fee for fellows PD9/30,,HJ,,671,186341.67
1001,10/5/2020,10/5/2020,YCCS,Received payment from Youth Connection Charter School-Received payment from Youth Connection Charter School,,HJ,20615,,206956.67
1001,10/6/2020,10/6/2020,Stran Promotional,Bill.Com Import--,,HJ,,5200.77,201755.9
1001,10/7/2020,10/7/2020,9113,Alan Safran pay back for his personal charges-Alan Safran pay back for his personal charges,,HJ,53.22,,201809.12
1001,10/7/2020,10/7/2020,claice Jackson,Imported from reimbursements-X Co.  Swag Dropoff,,HJ,,11.5,201797.62
1001,10/7/2020,10/7/2020,Eversource,October Eversource payment-October Eversource payment,,HJ,,31.93,201765.69
1001,10/7/2020,10/7/2020,Julie Balfour,Bill.Com Import--,,HJ,,3333.33,198432.36
1001,10/7/2020,10/7/2020,Mahaliah Sejour,Imported from reimbursements-home office chair,,HJ,,157.77,198274.59
1001,10/7/2020,10/7/2020,Mahaliah Sejour,Imported from reimbursements-usps shipping labels,,HJ,,71.96,198202.63
1001,10/7/2020,10/7/2020,Odalis Polanco,Imported from reimbursements-Meals Team Meetings,,HJ,,33,198169.63
1001,10/7/2020,10/7/2020,Verizon,October Mifi devices for fellow-October Mifi devices for fellow,,HJ,,49.58,198120.05
1001,10/7/2020,10/7/2020,Verizon,October Mifi devices for fellow-October Mifi devices for fellow,,HJ,,76.64,198043.41
1001,10/7/2020,10/7/2020,Verizon,October Mifi devices for fellow-October Mifi devices for fellow,,HJ,,76.64,197966.77
1001,10/7/2020,10/7/2020,Verizon,October Mifi devices for fellow-October Mifi devices for fellow,,HJ,,247.63,197719.14
1001,10/7/2020,10/7/2020,Verizon,October Mifi devices for fellow-October Mifi devices for fellow,,HJ,,292.68,197426.46
1001,10/7/2020,10/7/2020,Verizon,October Mifi devices for fellow-October Mifi devices for fellow,,HJ,,452.33,196974.13
1001,10/7/2020,10/7/2020,Verizon,October Mifi devices for fellow-October Mifi devices for fellow,,HJ,,452.33,196521.8
1001,10/7/2020,10/7/2020,Verizon,October Mifi devices for fellow-October Mifi devices for fellow,,HJ,,1463.41,195058.39
1001,10/8/2020,10/8/2020,X Co. NFAMILY,Received X Co. n's FY21 payment-Received X Co. n's year 2 payment of 3 year pledge,,HJ,25000,,220058.39
1001,10/9/2020,10/9/2020,ADP,ADP payroll services fee for fellows-ADP payroll services fee for fellows,,HJ,,78.3,219980.09
1001,10/9/2020,10/9/2020,ADP,ADP payroll services fee for fellows-ADP payroll services fee for fellows,,HJ,,121.01,219859.08
1001,10/9/2020,10/9/2020,ADP,ADP payroll services fee for fellows-ADP payroll services fee for fellows,,HJ,,121.01,219738.07
1001,10/9/2020,10/9/2020,ADP,ADP payroll services fee for fellows-ADP payroll services fee for fellows,,HJ,,391.53,219346.54
1001,10/9/2020,10/9/2020,ADP,ADP payroll services for staffs-ADP payroll services for staffs,,HJ,,5708.2,213638.34
1001,10/9/2020,10/9/2020,Banner Life Ins,Bill.Com Import--,,HJ,,479.99,213158.35
1001,10/9/2020,10/9/2020,Inspire Business Cen,Jackson Center October rent-Jackson Center October rent,,HJ,,500,212658.35
1001,10/9/2020,10/9/2020,Monivett Acevedo,Imported from reimbursements-Overnight parking while staying in Boston,,HJ,,75.95,212582.4
1001,10/15/2020,10/15/2020,101520,82L-IMPORT PAYROLL-Import Payroll,,HJ,,579.58,212002.82
1001,10/15/2020,10/15/2020,101520,82L-IMPORT PAYROLL-Import Payroll,,HJ,,4401.02,207601.8
1001,10/15/2020,10/15/2020,101520,82L-IMPORT PAYROLL-Import Payroll,,HJ,,5843.9,201757.9
1001,10/15/2020,10/15/2020,101520,82L-IMPORT PAYROLL-Import Payroll,,HJ,,6588.36,195169.54
1001,10/15/2020,10/15/2020,101520,82L-IMPORT PAYROLL-Import Payroll,,HJ,,9442.6,185726.94
1001,10/15/2020,10/15/2020,101520,82L-IMPORT PAYROLL-Import Payroll,,HJ,,15677.1,170049.84
1001,10/15/2020,10/15/2020,101520,82L-IMPORT PAYROLL-Import Payroll,,HJ,,18753.85,151295.99
1001,10/15/2020,10/15/2020,101520,82L-IMPORT PAYROLL-Import Payroll,,HJ,,63769.19,87526.8
1001,10/15/2020,10/15/2020,101520,82L-IMPORT PAYROLL-Import Payroll,,HJ,,90316.09,-2789.29
1001,10/15/2020,10/15/2020,101520,82L-IMPORT PAYROLL-Import Payroll,,HJ,,104200.78,-106990.07
1001,10/15/2020,10/15/2020,Antonio Gutierrez,Imported from reimbursements-Website Domain Purchase,,HJ,,63.51,-107053.58
1001,10/15/2020,10/15/2020,Catherine M Tierney,Bill.Com Import--,,HJ,,100,-107153.58
1001,10/15/2020,10/15/2020,JE-21-0061,LUX-PRPD-101520-LUX-PRPD-101520,,HJ,,207.19,-107360.77
1001,10/15/2020,10/15/2020,JE-21-0061,LUX-PRPD-101520-LUX-PRPD-101520,,HJ,,4701.73,-112062.5
1001,10/15/2020,10/15/2020,JE-21-0061,LUX-PRPD-101520-LUX-PRPD-101520,,HJ,,19225.81,-131288.31
1001,10/15/2020,10/15/2020,JE-21-0061,LUX-PRPD-101520-LUX-PRPD-101520,,HJ,,100295.67,-231583.98
1001,10/16/2020,10/16/2020,Alexander Kiley,Bill.Com Import--,,HJ,,62.31,-231646.29
1001,10/16/2020,10/16/2020,Dstillery Inc.,Bill.Com Import--,,HJ,,779.16,-232425.45
1001,10/16/2020,10/16/2020,Dstillery Inc.,Bill.Com Import--,,HJ,,1204.14,-233629.59
1001,10/16/2020,10/16/2020,Dstillery Inc.,Bill.Com Import--,,HJ,,1204.14,-234833.73
1001,10/16/2020,10/16/2020,Dstillery Inc.,Bill.Com Import--,,HJ,,3895.76,-238729.49
1001,10/16/2020,10/16/2020,TAG Resources LLC,TASC payment for October-TASC payment for October,,HJ,,3186.97,-241916.46
1001,10/19/2020,10/19/2020,20201019,Transfer from #8984 to #6488-Transfer from #8984 to #6488,,HJ,701000,,459083.54
1001,10/19/2020,10/19/2020,T-Mobile,September T-mobile mi-fi expenses for fellow-September T-mobile mi-fi expenses for fellow,,HJ,,61.78,459021.76
1001,10/19/2020,10/19/2020,T-Mobile,September T-mobile mi-fi expenses for fellow-September T-mobile mi-fi expenses for fellow,,HJ,,95.47,458926.29
1001,10/19/2020,10/19/2020,T-Mobile,September T-mobile mi-fi expenses for fellow-September T-mobile mi-fi expenses for fellow,,HJ,,95.47,458830.82
1001,10/19/2020,10/19/2020,T-Mobile,September T-mobile mi-fi expenses for fellow-September T-mobile mi-fi expenses for fellow,,HJ,,308.88,458521.94
1001,10/19/2020,10/19/2020,TAG Resources LLC,Employee 401K for PD10/15-Employee 401K for PD10/15,,HJ,,3264.59,455257.35
1001,10/20/2020,10/20/2020,New Profit Inc.,Received payment from New Profit-Received payment from New Profit,,HJ,250000,,705257.35
1001,10/21/2020,10/21/2020,1,Tiffani Bibb Reimbursement to X Co. -Tiffani Bibb Reimbursement to X Co. ,D104,HJ,43.19,,705300.54
1001,10/21/2020,10/21/2020,Citadel Foundation,Received payment from CITADE-Received payment from CITADE,,HJ,2500000,,3205300.54
1001,10/21/2020,10/21/2020,Feinberg Hanson,Bill.Com Import--,,HJ,,14193.33,3191107.21
1001,10/21/2020,10/21/2020,Harvard University,Bill.Com Import--,,HJ,,24500,3166607.21
1001,10/21/2020,10/21/2020,Leslie Wade LLC,Bill.Com Import--,,HJ,,7520,3159087.21
1001,10/21/2020,10/21/2020,The Hartford,NY Employee PFL insurance-NY Employee PFL insurance,,HJ,,723.39,3158363.82
1001,10/22/2020,10/22/2020,20201022,Transfer from #6488 to #8984-Transfer from #6488 to #8984,,HJ,,2400000,758363.82
1001,10/22/2020,10/22/2020,ACCURATE BIOMETRICS,Bill.Com Import--,,HJ,,903.75,757460.07
1001,10/22/2020,10/22/2020,Appcast Inc.,Bill.Com Import--,,HJ,,1202.98,756257.09
1001,10/22/2020,10/22/2020,Media Cause,Bill.Com Import--,,HJ,,14314,741943.09
1001,10/22/2020,10/22/2020,Whiteboard,Bill.Com Import--,,HJ,,7500,734443.09
1001,10/23/2020,10/23/2020,Monivett Acevedo,Imported from reimbursements-Carry on bag,,HJ,,65,734378.09
1001,10/23/2020,10/23/2020,Monivett Acevedo,Imported from reimbursements-Seat adjustment,,HJ,,44,734334.09
1001,10/23/2020,10/23/2020,Monivett Acevedo,Imported from reimbursements-Week in Boston to complete AC SC MD and other meetings,,HJ,,1210.79,733123.3
1001,10/26/2020,10/26/2020,HRKnowledge,HR outsourcing admin fee for fellows PD10/15-HR outsourcing admin fee for fellows PD10/15,,HJ,,133.1,732990.2
1001,10/26/2020,10/26/2020,HRKnowledge,HR outsourcing admin fee for fellows PD10/15-HR outsourcing admin fee for fellows PD10/15,,HJ,,205.7,732784.5
1001,10/26/2020,10/26/2020,HRKnowledge,HR outsourcing admin fee for fellows PD10/15-HR outsourcing admin fee for fellows PD10/15,,HJ,,205.7,732578.8
1001,10/26/2020,10/26/2020,HRKnowledge,HR outsourcing admin fee for fellows PD10/15-HR outsourcing admin fee for fellows PD10/15,,HJ,,665.5,731913.3
1001,10/26/2020,10/26/2020,HRKnowledge,HR Outsourcing admin fee staff PD 10/15-HR Outsourcing admin fee,,HJ,,1460,730453.3
1001,10/27/2020,10/27/2020,20201027,Americorp Reimbursement for August & September-Americorps Reimbursement for September -Reimbursement Payment,,HJ,236773.22,,967226.52
1001,10/27/2020,10/27/2020,Grubhub,Bill.Com Import--,,HJ,,111.3,967115.22
1001,10/27/2020,10/27/2020,Grubhub,Bill.Com Import--,,HJ,,253.45,966861.77
1001,10/27/2020,10/27/2020,Grubhub,Bill.Com Import--,,HJ,,302.49,966559.28
1001,10/27/2020,10/27/2020,Kennaisiya Miller,Bill.Com Import--,,HJ,,10.99,966548.29
1001,10/27/2020,10/27/2020,Walnut Street Realty,Bill.Com Import--,,HJ,,2178.87,964369.42
1001,10/28/2020,10/28/2020,Abila,Bill.Com Import--,,HJ,,5936.51,958432.91
1001,10/30/2020,10/30/2020,103120,82L-IMPORT PAYROLL-Import Payroll,,HJ,,4345.02,954087.89
1001,10/30/2020,10/30/2020,103120,82L-IMPORT PAYROLL-Import Payroll,,HJ,,6010.66,948077.23
1001,10/30/2020,10/30/2020,103120,82L-IMPORT PAYROLL-Import Payroll,,HJ,,6755.11,941322.12
1001,10/30/2020,10/30/2020,103120,82L-IMPORT PAYROLL-Import Payroll,,HJ,,9403.89,931918.23
1001,10/30/2020,10/30/2020,103120,82L-IMPORT PAYROLL-Import Payroll,,HJ,,15815.66,916102.57
1001,10/30/2020,10/30/2020,103120,82L-IMPORT PAYROLL-Import Payroll,,HJ,,19035,897067.57
1001,10/30/2020,10/30/2020,103120,82L-IMPORT PAYROLL-Import Payroll,,HJ,,22950.99,874116.58
1001,10/30/2020,10/30/2020,103120,82L-IMPORT PAYROLL-Import Payroll,,HJ,,63083.23,811033.35
1001,10/30/2020,10/30/2020,103120,82L-IMPORT PAYROLL-Import Payroll,,HJ,,66486.69,744546.66
1001,10/30/2020,10/30/2020,103120,82L-IMPORT PAYROLL-Import Payroll,,HJ,,86434.47,658112.19
1001,10/30/2020,10/30/2020,103120,82L-IMPORT PAYROLL-Import Payroll,,HJ,,98414.69,559697.5
1001,10/30/2020,10/30/2020,Abila,Bill.Com Import--,,HJ,,110,559587.5
1001,10/30/2020,10/30/2020,Catherine M Tierney,Bill.Com Import--,,HJ,,40,559547.5
1001,10/30/2020,10/30/2020,Economic Research,Bill.Com Import--,,HJ,,3489,556058.5
1001,10/31/2020,10/31/2020,JE-21-0062,LUX-PRPD-103120-LUX-PRPD-103120,,HJ,,207.89,555850.61
1001,10/31/2020,10/31/2020,JE-21-0062,LUX-PRPD-103120-LUX-PRPD-103120,,HJ,,5315.1,550535.51
1001,10/31/2020,10/31/2020,JE-21-0062,LUX-PRPD-103120-LUX-PRPD-103120,,HJ,,19225.81,531309.7
1001,10/31/2020,10/31/2020,JE-21-0062,LUX-PRPD-103120-LUX-PRPD-103120,,HJ,,105980.39,425329.31
1001,11/2/2020,11/2/2020,BCBS,November BCBS Payment for October Americorp Portion-BCBS - November Payment,,HJ,,114.15,425215.16
1001,11/2/2020,11/2/2020,BCBS,November BCBS Payment for October Americorp Portion-BCBS - November Payment,,HJ,,126.77,425088.39
1001,11/2/2020,11/2/2020,BCBS,November BCBS Payment for October Americorp Portion-BCBS - November Payment,,HJ,,144.63,424943.76
1001,11/2/2020,11/2/2020,BCBS,November BCBS Payment for October Americorp Portion-BCBS - November Payment,,HJ,,185.7,424758.06
1001,11/2/2020,11/2/2020,BCBS,November BCBS Payment for October Americorp Portion-BCBS - November Payment,,HJ,,520.43,424237.63
1001,11/2/2020,11/2/2020,BCBS,November BCBS Payment for October Americorp Portion-BCBS - November Payment,,HJ,,1163.79,423073.84
1001,11/2/2020,11/2/2020,BCBS,November BCBS Payment for October Americorp Portion-BCBS - November Payment,,HJ,,3245.54,419828.3
1001,11/2/2020,11/2/2020,BCBS,November BCBS Payment for October Americorp Portion-BCBS - November Payment,,HJ,,4650.73,415177.57
1001,11/2/2020,11/2/2020,BCBS,November BCBS Payment for October Americorp Portion-BCBS - November Payment,,HJ,,11752.04,403425.53
1001,11/2/2020,11/2/2020,TAG Resources LLC,Employee 401K payment-Employee 401K payment,,HJ,,3175.35,400250.18
1001,11/3/2020,11/3/2020,Bank of America VISA,Boaf CC October's transactions payment-BofA CC transactions October Payment,,HJ,,787.72,399462.46
1001,11/3/2020,11/3/2020,Bank of America VISA,Boaf CC October's transactions payment-BofA CC transactions October Payment,,HJ,,2007.1,397455.36
1001,11/3/2020,11/3/2020,Bank of America VISA,Boaf CC October's transactions payment-BofA CC transactions October Payment,,HJ,,2053.07,395402.29
1001,11/3/2020,11/3/2020,Bank of America VISA,Boaf CC October's transactions payment-BofA CC transactions October Payment,,HJ,,4105.89,391296.4
1001,11/3/2020,11/3/2020,Bank of America VISA,Boaf CC October's transactions payment-BofA CC transactions October Payment,,HJ,,4833.88,386462.52
1001,11/3/2020,11/3/2020,Bank of America VISA,Boaf CC October's transactions payment-BofA CC transactions October Payment,,HJ,,6507.51,379955.01
1001,11/3/2020,11/3/2020,Bank of America VISA,Boaf CC October's transactions payment-BofA CC transactions October Payment,,HJ,,11878.45,368076.56
1001,11/3/2020,11/3/2020,Bank of America VISA,Boaf CC October's transactions payment-BofA CC transactions October Payment,,HJ,,16676.07,351400.49
1001,11/3/2020,11/3/2020,JE-21-0085,Blue 20/20 Vision Insurance November Inv 82L-Blue 20/20 Vision Insurance November Inv 82L,,HJ,,7.11,351393.38
1001,11/3/2020,11/3/2020,JE-21-0085,Blue 20/20 Vision Insurance November Inv 82L-Blue 20/20 Vision Insurance November Inv 82L,,HJ,,7.11,351386.27
1001,11/3/2020,11/3/2020,JE-21-0085,Blue 20/20 Vision Insurance November Inv 82L-Blue 20/20 Vision Insurance November Inv 82L,,HJ,,7.82,351378.45
1001,11/3/2020,11/3/2020,JE-21-0085,Blue 20/20 Vision Insurance November Inv 82L-Blue 20/20 Vision Insurance November Inv 82L,,HJ,,21.33,351357.12
1001,11/3/2020,11/3/2020,JE-21-0085,Blue 20/20 Vision Insurance November Inv 82L-Blue 20/20 Vision Insurance November Inv 82L,,HJ,,27.73,351329.39
1001,11/3/2020,11/3/2020,JE-21-0085,Blue 20/20 Vision Insurance November Inv 82L-Blue 20/20 Vision Insurance November Inv 82L,,HJ,,35.55,351293.84
1001,11/3/2020,11/3/2020,JE-21-0085,Blue 20/20 Vision Insurance November Inv 82L-Blue 20/20 Vision Insurance November Inv 82L,,HJ,,71.1,351222.74
1001,11/3/2020,11/3/2020,JE-21-0085,Blue 20/20 Vision Insurance November Inv 82L-Blue 20/20 Vision Insurance November Inv 82L,,HJ,,105.94,351116.8
1001,11/3/2020,11/3/2020,JE-21-0086,Blue 20/20 Vision Insurance November Inv LUX-Blue 20/20 Vision Insurance -November Inv LUX,,HJ,,7.11,351109.69
1001,11/3/2020,11/3/2020,JE-21-0086,Blue 20/20 Vision Insurance November Inv LUX-Blue 20/20 Vision Insurance -November Inv LUX,,HJ,14.22,,351123.91
1001,11/3/2020,11/3/2020,JE-21-0086,Blue 20/20 Vision Insurance November Inv LUX-Blue 20/20 Vision Insurance -November Inv LUX,,HJ,,28.44,351095.47
1001,11/3/2020,11/3/2020,JE-21-0086,Blue 20/20 Vision Insurance November Inv LUX-Blue 20/20 Vision Insurance -November Inv LUX,,HJ,,213.3,350882.17
1001,11/4/2020,11/4/2020,EDUCATION WEEK,Bill.Com Import--,,HJ,,416.75,350465.42
1001,11/4/2020,11/4/2020,Kelly Silver,Bill.Com Import--,,HJ,,73.5,350391.92
1001,11/5/2020,11/5/2020,BCBS,November BCBS Payments-BCBS - November Invoices,,HJ,57.22,,350449.14
1001,11/5/2020,11/5/2020,BCBS,November BCBS Payments-BCBS - November Invoices,,HJ,,402.28,350046.86
1001,11/5/2020,11/5/2020,BCBS,November BCBS Payments-BCBS - November Invoices,,HJ,,456.48,349590.38
1001,11/5/2020,11/5/2020,BCBS,November BCBS Payments-BCBS - November Invoices,,HJ,,1024.1,348566.28
1001,11/5/2020,11/5/2020,BCBS,November BCBS Payments-BCBS - November Invoices,,HJ,,1335.35,347230.93
1001,11/5/2020,11/5/2020,BCBS,November BCBS Payments-BCBS - November Invoices,,HJ,,1400.5,345830.43
1001,11/5/2020,11/5/2020,BCBS,November BCBS Payments-BCBS - November Invoices,,HJ,,2326.61,343503.82
1001,11/5/2020,11/5/2020,BCBS,November BCBS Payments-BCBS - November Invoices,,HJ,,3564.54,339939.28
1001,11/5/2020,11/5/2020,BCBS,November BCBS Payments-BCBS - November Invoices,,HJ,,5157.04,334782.24
1001,11/5/2020,11/5/2020,BCBS,November BCBS Payments-BCBS - November Invoices,,HJ,,9575.57,325206.67
1001,11/5/2020,11/5/2020,BCBS,November BCBS Payments-BCBS - November Invoices,,HJ,,12870.63,312336.04
1001,11/5/2020,11/5/2020,BCBS,November BCBS Payments-BCBS - November Invoices,,HJ,,15371.53,296964.51
1001,11/5/2020,11/5/2020,BCBS,November BCBS Payments-BCBS - November Invoices,,HJ,,31992.87,264971.64
1001,11/5/2020,11/5/2020,Comcast,November Comcast payment-November Comcast payment,,HJ,,139.55,264832.09
1001,11/5/2020,11/5/2020,HRKnowledge,Affirmative Action plan-Date Range TBD-Affirmative Action plan-Date Range TBD,,HJ,,5500,259332.09
1001,11/6/2020,11/6/2020,ADP,ADP PR process fees for fellows-ADP PR process fees for fellows,,HJ,,95.19,259236.9
1001,11/6/2020,11/6/2020,ADP,ADP PR process fees for fellows-ADP PR process fees for fellows,,HJ,,147.13,259089.77
1001,11/6/2020,11/6/2020,ADP,ADP PR process fees for fellows-ADP PR process fees for fellows,,HJ,,147.13,258942.64
1001,11/6/2020,11/6/2020,ADP,ADP PR process fees for fellows-ADP PR process fees for fellows,,HJ,,476,258466.64
1001,11/6/2020,11/6/2020,ADP,ADP PR services fee for staff-ADP PR services fee for staff,,HJ,,5881.5,252585.14
1001,11/8/2020,11/8/2020,Inspire Business Cen,Jackson center part of the rent for November-Jackson center part of the rent for November,,HJ,,500,252085.14
1001,11/9/2020,11/9/2020,HRKnowledge,HR admin fee for fellows PD10-30-HR admin fee for fellows PD10-30,,HJ,,139.7,251945.44
1001,11/9/2020,11/9/2020,HRKnowledge,HR admin fee for fellows PD10-30-HR admin fee for fellows PD10-30,,HJ,,215.9,251729.54
1001,11/9/2020,11/9/2020,HRKnowledge,HR admin fee for fellows PD10-30-HR admin fee for fellows PD10-30,,HJ,,215.9,251513.64
1001,11/9/2020,11/9/2020,HRKnowledge,HR admin fee for fellows PD10-30-HR admin fee for fellows PD10-30,,HJ,,698.5,250815.14
1001,11/9/2020,11/9/2020,HRKnowledge,HRK Admin fee for staff PD10/30-HRK Admin fee for staff PD10/30,,HJ,,1560,249255.14
1001,11/9/2020,11/9/2020,Salesforce.org,Bill.Com Import--,,HJ,,38.81,249216.33
1001,11/9/2020,11/9/2020,Salesforce.org,Bill.Com Import--,,HJ,,59.98,249156.35
1001,11/9/2020,11/9/2020,Salesforce.org,Bill.Com Import--,,HJ,,59.98,249096.37
1001,11/9/2020,11/9/2020,Salesforce.org,Bill.Com Import--,,HJ,,194.04,248902.33
1001,11/9/2020,11/9/2020,Verizon,Mifi devices for fellows for November-Mifi devices for fellows for November,,HJ,,49.58,248852.75
1001,11/9/2020,11/9/2020,Verizon,Mifi devices for fellows for November-Mifi devices for fellows for November,,HJ,,76.64,248776.11
1001,11/9/2020,11/9/2020,Verizon,Mifi devices for fellows for November-Mifi devices for fellows for November,,HJ,,76.64,248699.47
1001,11/9/2020,11/9/2020,Verizon,Mifi devices for fellows for November-Mifi devices for fellows for November,,HJ,,247.94,248451.53
1001,11/9/2020,11/9/2020,Verizon,Mifi devices for fellows for November-Mifi devices for fellows for November,,HJ,,425.14,248026.39
1001,11/9/2020,11/9/2020,Verizon,Mifi devices for fellows for November-Mifi devices for fellows for November,,HJ,,657.03,247369.36
1001,11/9/2020,11/9/2020,Verizon,Mifi devices for fellows for November-Mifi devices for fellows for November,,HJ,,657.03,246712.33
1001,11/9/2020,11/9/2020,Verizon,Mifi devices for fellows for November-Mifi devices for fellows for November,,HJ,,2125.71,244586.62
1001,11/10/2020,11/10/2020,Catherine M Tierney,Bill.Com Import--,,HJ,,20,244566.62
1001,11/10/2020,11/10/2020,Eversource,November electricity expense-November electricity expense,,HJ,,37.71,244528.91
1001,11/10/2020,11/10/2020,hliporace,Imported from reimbursements-Shipping label to send Documents to Colorado Department of Reven,,HJ,,24.3,244504.61
1001,11/10/2020,11/10/2020,Julie Balfour,Bill.Com Import--,,HJ,,3333.33,241171.28
1001,11/12/2020,11/12/2020,20201112,Individual donation through AmazonSmil-Individual donation through AmazonSmil,,HJ,8.18,,241179.46
1001,11/12/2020,11/12/2020,Funmilayo Ikunika,Bill.Com Import--,,HJ,,73.5,241105.96
1001,11/12/2020,11/12/2020,JE-21-0089,LUX-PRPD-111520-LUX-PRPD-101520,,HJ,,211.81,240894.15
1001,11/12/2020,11/12/2020,JE-21-0089,LUX-PRPD-111520-LUX-PRPD-101520,,HJ,,5238.1,235656.05
1001,11/12/2020,11/12/2020,JE-21-0089,LUX-PRPD-111520-LUX-PRPD-101520,,HJ,,19225.81,216430.24
1001,11/12/2020,11/12/2020,JE-21-0089,LUX-PRPD-111520-LUX-PRPD-101520,,HJ,,104551.71,111878.53
1001,11/12/2020,11/12/2020,Stran Promotional,Bill.Com Import--,,HJ,,222.58,111655.95
1001,11/13/2020,11/13/2020,111320,82L-IMPORT PAYROLL-Import Payroll,,HJ,,349.86,111306.09
1001,11/13/2020,11/13/2020,111320,82L-IMPORT PAYROLL-Import Payroll,,HJ,,4330.6,106975.49
1001,11/13/2020,11/13/2020,111320,82L-IMPORT PAYROLL-Import Payroll,,HJ,,5844.9,101130.59
1001,11/13/2020,11/13/2020,111320,82L-IMPORT PAYROLL-Import Payroll,,HJ,,6588.36,94542.23
1001,11/13/2020,11/13/2020,111320,82L-IMPORT PAYROLL-Import Payroll,,HJ,,11430.03,83112.2
1001,11/13/2020,11/13/2020,111320,82L-IMPORT PAYROLL-Import Payroll,,HJ,,15026.79,68085.41
1001,11/13/2020,11/13/2020,111320,82L-IMPORT PAYROLL-Import Payroll,,HJ,,15655.66,52429.75
1001,11/13/2020,11/13/2020,111320,82L-IMPORT PAYROLL-Import Payroll,,HJ,,49434.13,2995.62
1001,11/13/2020,11/13/2020,111320,82L-IMPORT PAYROLL-Import Payroll,,HJ,,62098.33,-59102.71
1001,11/13/2020,11/13/2020,111320,82L-IMPORT PAYROLL-Import Payroll,,HJ,,88034.88,-147137.59
1001,11/13/2020,11/13/2020,111320,82L-IMPORT PAYROLL-Import Payroll,,HJ,,96664,-243801.59
1001,11/16/2020,11/16/2020,TAG Resources LLC,Employee 401K payment for PD 11/15-Employee 401K payment for PD 11/15,,HJ,,3072.92,-246874.51
1001,11/16/2020,11/16/2020,TASC,TASC payment for staff PD 10/30 & PD11/13-TASC payment for staff PD 10/30 & PD11/13,,HJ,,4103.73,-250978.24
1001,11/16/2020,11/16/2020,Woot Math Acquisiti,Deposited check paid to Woot/Simbulus-Deposited check paid to Woot/Simbulus,,HJ,1512.42,,-249465.82
1001,11/17/2020,11/17/2020,20201117,Settlement of Q Philogene small claims case-Settlement of Q Philogene small claims case,,HJ,,1400,-250865.82
1001,11/17/2020,11/17/2020,Stryder,Bill.Com Import--,,HJ,,8750,-259615.82
1001,11/17/2020,11/17/2020,T-Mobile,November phone expenses for fellows-November phone expenses for fellows,,HJ,,61.78,-259677.6
1001,11/17/2020,11/17/2020,T-Mobile,November phone expenses for fellows-November phone expenses for fellows,,HJ,,95.47,-259773.07
1001,11/17/2020,11/17/2020,T-Mobile,November phone expenses for fellows-November phone expenses for fellows,,HJ,,95.47,-259868.54
1001,11/17/2020,11/17/2020,T-Mobile,November phone expenses for fellows-November phone expenses for fellows,,HJ,,308.88,-260177.42
1001,11/18/2020,11/18/2020,AAFCPAS,Bill.Com Import--,,HJ,,12000,-272177.42
1001,11/18/2020,11/18/2020,Apollon & Partners,Bill.Com Import--,,HJ,,10000,-282177.42
1001,11/18/2020,11/18/2020,HRKnowledge,HR Outsourcing admin fee-HR Outsourcing admin fee for fellows PD11/15,,HJ,,137.5,-282314.92
1001,11/18/2020,11/18/2020,HRKnowledge,HR Outsourcing admin fee-HR Outsourcing admin fee for fellows PD11/15,,HJ,,212.5,-282527.42
1001,11/18/2020,11/18/2020,HRKnowledge,HR Outsourcing admin fee-HR Outsourcing admin fee for fellows PD11/15,,HJ,,212.5,-282739.92
1001,11/18/2020,11/18/2020,HRKnowledge,HR Outsourcing admin fee-HR Outsourcing admin fee for fellows PD11/15,,HJ,,687.5,-283427.42
1001,11/18/2020,11/18/2020,HRKnowledge,HR Outsourcing admin fee-HR Outsourcing admin fee for staff PD11/15,,HJ,,1550,-284977.42
1001,11/19/2020,11/19/2020,ACCURATE BIOMETRICS,Bill.Com Import--,,HJ,,241,-285218.42
1001,11/19/2020,11/19/2020,IMCCHI,Received IMC payment-Received IMC payment,,HJ,100000,,-185218.42
1001,11/19/2020,11/19/2020,Media Cause,Bill.Com Import--,,HJ,,9598,-194816.42
1001,11/19/2020,11/19/2020,VIGOROUS INT.,Bill.Com Import--,,HJ,,7062,-201878.42
1001,11/19/2020,11/19/2020,Whiteboard,Bill.Com Import--,,HJ,,8640.03,-210518.45
1001,11/20/2020,11/20/2020,2023,EPTL filing fee-EPTL filing fee,,HJ,,250,-210768.45
1001,11/20/2020,11/20/2020,claice Jackson,Imported from reimbursements-Staff Appreciation,,HJ,,6.9,-210775.35
1001,11/20/2020,11/20/2020,claice Jackson,Imported from reimbursements-Staff Appreciation,,HJ,,10.93,-210786.28
1001,11/20/2020,11/20/2020,claice Jackson,Imported from reimbursements-Staff Appreciation,,HJ,,34.5,-210820.78
1001,11/20/2020,11/20/2020,Feinberg Hanson,Bill.Com Import--,,HJ,,3173,-213993.78
1001,11/20/2020,11/20/2020,Hutchinson Black,Bill.Com Import--,,HJ,,928,-214921.78
1001,11/23/2020,11/23/2020,20201123,Americorp Reimbursement for October-Americorps Reimbursement for October -Reimbursement Payment,,HJ,225122.55,,10200.77
1001,11/23/2020,11/23/2020,Inspire Business Cen,Make up Jackson center September to November rent-Make up Jackson center September to November rent,,HJ,,1425,8775.77
1001,11/24/2020,11/24/2020,Crawford Maunu PLLC,Bill.Com Import--,,HJ,,515,8260.77
1001,11/24/2020,11/24/2020,Emptech,Bill.Com Import--,,HJ,,1596,6664.77
1001,11/24/2020,11/24/2020,Grubhub,Bill.Com Import--,,HJ,,15.9,6648.87
1001,11/24/2020,11/24/2020,Grubhub,Bill.Com Import--,,HJ,,80.96,6567.91
1001,11/24/2020,11/24/2020,Grubhub,Bill.Com Import--,,HJ,,145.77,6422.14
1001,11/24/2020,11/24/2020,Grubhub,Bill.Com Import--,,HJ,,501.79,5920.35
1001,11/24/2020,11/24/2020,Grubhub,Bill.Com Import--,,HJ,,862.51,5057.84
1001,11/24/2020,11/24/2020,MCGRAW HILL,Bill.Com Import--,,HJ,,9990,-4932.16
1001,11/24/2020,11/24/2020,Stephen Lipscomb,Bill.Com Import--,,HJ,,73.5,-5005.66
1001,11/25/2020,11/25/2020,20201125,Transfer from #8984 account to #6488 account-Transfer from #8984 account to #6488 account,,HJ,883000,,877994.34
1001,11/25/2020,11/25/2020,Amazon Business,Bill.Com Import--,,HJ,,33.97,877960.37
1001,11/25/2020,11/25/2020,Tiffany Cardona,Bill.Com Import--,,HJ,,4700.4,873259.97
1001,11/27/2020,11/27/2020,Emptech,Bill.Com Import--,,HJ,,1596,871663.97
1001,11/27/2020,11/27/2020,JE-21-0091,LUX-PRPD-113020-LUX-PRPD-113020,,HJ,,209.85,871454.12
1001,11/27/2020,11/27/2020,JE-21-0091,LUX-PRPD-113020-LUX-PRPD-113020,,HJ,,5333.54,866120.58
1001,11/27/2020,11/27/2020,JE-21-0091,LUX-PRPD-113020-LUX-PRPD-113020,,HJ,,19225.81,846894.77
1001,11/27/2020,11/27/2020,JE-21-0091,LUX-PRPD-113020-LUX-PRPD-113020,,HJ,,104551.71,742343.06
1001,11/30/2020,11/30/2020,113020,82L-IMPORT PAYROLL-Import Payroll,,HJ,,349.12,741993.94
1001,11/30/2020,11/30/2020,113020,82L-IMPORT PAYROLL-Import Payroll,,HJ,,4330.6,737663.34
1001,11/30/2020,11/30/2020,113020,82L-IMPORT PAYROLL-Import Payroll,,HJ,,6588.36,731074.98
1001,11/30/2020,11/30/2020,113020,82L-IMPORT PAYROLL-Import Payroll,,HJ,,11430.03,719644.95
1001,11/30/2020,11/30/2020,113020,82L-IMPORT PAYROLL-Import Payroll,,HJ,,15883.97,703760.98
1001,11/30/2020,11/30/2020,113020,82L-IMPORT PAYROLL-Import Payroll,,HJ,,18669.58,685091.4
1001,11/30/2020,11/30/2020,113020,82L-IMPORT PAYROLL-Import Payroll,,HJ,,50350.75,634740.65
1001,11/30/2020,11/30/2020,113020,82L-IMPORT PAYROLL-Import Payroll,,HJ,,61649.8,573090.85
1001,11/30/2020,11/30/2020,113020,82L-IMPORT PAYROLL-Import Payroll,,HJ,,88042.68,485048.17
1001,11/30/2020,11/30/2020,113020,82L-IMPORT PAYROLL-Import Payroll,,HJ,,93252.81,391795.36
1001,12/1/2020,12/1/2020,Abila,Bill.Com Import--,,HJ,,110,391685.36
1001,12/1/2020,12/1/2020,Abila,Bill.Com Import--,,HJ,,250,391435.36
1001,12/1/2020,12/1/2020,BCBS,December BCBS Payment-BCBS - December BCBS,,HJ,,95.66,391339.7
1001,12/1/2020,12/1/2020,BCBS,December BCBS Payment-BCBS - December BCBS,,HJ,,855.24,390484.46
1001,12/1/2020,12/1/2020,BCBS,December BCBS Payment-BCBS - December BCBS,,HJ,,1063,389421.46
1001,12/1/2020,12/1/2020,BCBS,December BCBS Payment-BCBS - December BCBS,,HJ,,1159.82,388261.64
1001,12/1/2020,12/1/2020,BCBS,December BCBS Payment-BCBS - December BCBS,,HJ,,1263.37,386998.27
1001,12/1/2020,12/1/2020,BCBS,December BCBS Payment-BCBS - December BCBS,,HJ,,2326.61,384671.66
1001,12/1/2020,12/1/2020,BCBS,December BCBS Payment-BCBS - December BCBS,,HJ,,2844.67,381826.99
1001,12/1/2020,12/1/2020,BCBS,December BCBS Payment-BCBS - December BCBS,,HJ,,4813.57,377013.42
1001,12/1/2020,12/1/2020,BCBS,December BCBS Payment-BCBS - December BCBS,,HJ,,7608.99,369404.43
1001,12/1/2020,12/1/2020,BCBS,December BCBS Payment-BCBS - December BCBS,,HJ,,7771.29,361633.14
1001,12/1/2020,12/1/2020,BCBS,December BCBS Payment-BCBS - December BCBS,,HJ,,8545.47,353087.67
1001,12/1/2020,12/1/2020,BCBS,December BCBS Payment-BCBS - December BCBS,,HJ,,14091.24,338996.43
1001,12/1/2020,12/1/2020,BCBS,December BCBS Payment-BCBS - December BCBS,,HJ,,14989.69,324006.74
1001,12/1/2020,12/1/2020,Grubhub,Bill.Com Import--,,HJ,,609.5,323397.24
1001,12/1/2020,12/1/2020,Quinn Result Coach,Bill.Com Import--,,HJ,,1275,322122.24
1001,12/1/2020,12/1/2020,TAG Resources LLC,To record employee 401k payment-To record employee 401k payment,,HJ,,3471.99,318650.25
1001,12/1/2020,12/1/2020,TAG Resources LLC,To record employee 401k payment-To record employee 401k payment,,HJ,,3815.83,314834.42
1001,12/1/2020,12/1/2020,TASC,Payment for TASC for PD 11/30/2020-Payment for TASC for PD 11/30/2020,,HJ,,1670.45,313163.97
1001,12/1/2020,12/1/2020,Walnut Street Realty,Bill.Com Import--,,HJ,,2261.13,310902.84
1001,12/2/2020,12/2/2020,20201202,To correct the cash account for AR entry-To correct the cash account for AR entry-CPS October payment,,HJ,,282000,28902.84
1001,12/2/2020,12/2/2020,CPS,Received CPS October payment-Received CPS October payment,,HJ,282000,,310902.84
1001,12/3/2020,12/3/2020,JE-21-0110,Blue 20/20 Vision Insurance - December Inv Lux-Blue 20/20 Vision Insurance -December Inv LUX,,HJ,,7.11,310895.73
1001,12/3/2020,12/3/2020,JE-21-0110,Blue 20/20 Vision Insurance - December Inv Lux-Blue 20/20 Vision Insurance -December Inv LUX,,HJ,,21.33,310874.4
1001,12/3/2020,12/3/2020,JE-21-0110,Blue 20/20 Vision Insurance - December Inv Lux-Blue 20/20 Vision Insurance -December Inv LUX,,HJ,,362.61,310511.79
1001,12/3/2020,12/3/2020,JE-21-0111,Blue 20/20 Vision Insurance - December Inv 82L-Blue 20/20 Vision Insurance December Inv 82L,,HJ,,7.11,310504.68
1001,12/3/2020,12/3/2020,JE-21-0111,Blue 20/20 Vision Insurance - December Inv 82L-Blue 20/20 Vision Insurance December Inv 82L,,HJ,,21.33,310483.35
1001,12/3/2020,12/3/2020,JE-21-0111,Blue 20/20 Vision Insurance - December Inv 82L-Blue 20/20 Vision Insurance December Inv 82L,,HJ,,48.93,310434.42
1001,12/3/2020,12/3/2020,JE-21-0111,Blue 20/20 Vision Insurance - December Inv 82L-Blue 20/20 Vision Insurance December Inv 82L,,HJ,,56.04,310378.38
1001,12/3/2020,12/3/2020,JE-21-0111,Blue 20/20 Vision Insurance - December Inv 82L-Blue 20/20 Vision Insurance December Inv 82L,,HJ,,63.99,310314.39
1001,12/3/2020,12/3/2020,JE-21-0111,Blue 20/20 Vision Insurance - December Inv 82L-Blue 20/20 Vision Insurance December Inv 82L,,HJ,,84.61,310229.78
1001,12/3/2020,12/3/2020,JE-21-0111,Blue 20/20 Vision Insurance - December Inv 82L-Blue 20/20 Vision Insurance December Inv 82L,,HJ,,127.27,310102.51
1001,12/3/2020,12/3/2020,JE-21-0111,Blue 20/20 Vision Insurance - December Inv 82L-Blue 20/20 Vision Insurance December Inv 82L,,HJ,,127.98,309974.53
1001,12/4/2020,12/4/2020,Bank of America VISA,BoaF CC November's transactions payment-BofA CC November's transaction Payment,,HJ,,316.75,309657.78
1001,12/4/2020,12/4/2020,Bank of America VISA,BoaF CC November's transactions payment-BofA CC November's transaction Payment,,HJ,,514.42,309143.36
1001,12/4/2020,12/4/2020,Bank of America VISA,BoaF CC November's transactions payment-BofA CC November's transaction Payment,,HJ,,1240,307903.36
1001,12/4/2020,12/4/2020,Bank of America VISA,BoaF CC November's transactions payment-BofA CC November's transaction Payment,,HJ,,1297.58,306605.78
1001,12/4/2020,12/4/2020,Bank of America VISA,BoaF CC November's transactions payment-BofA CC November's transaction Payment,,HJ,,3619.71,302986.07
1001,12/4/2020,12/4/2020,Bank of America VISA,BoaF CC November's transactions payment-BofA CC November's transaction Payment,,HJ,,4663.5,298322.57
1001,12/4/2020,12/4/2020,Bank of America VISA,BoaF CC November's transactions payment-BofA CC November's transaction Payment,,HJ,,5412.61,292909.96
1001,12/4/2020,12/4/2020,Bank of America VISA,BoaF CC November's transactions payment-BofA CC November's transaction Payment,,HJ,,7857.17,285052.79
1001,12/7/2020,12/7/2020,Comcast,December Comcast payment-December Comcast payment,,HJ,,139.55,284913.24
1001,12/7/2020,12/7/2020,HRKnowledge,To record HR admin fee for fellows PD11/30-To record HR admin fee for fellows PD11/30,,HJ,,137.5,284775.74
1001,12/7/2020,12/7/2020,HRKnowledge,To record HR admin fee for fellows PD11/30-To record HR admin fee for fellows PD11/30,,HJ,,212.5,284563.24
1001,12/7/2020,12/7/2020,HRKnowledge,To record HR admin fee for fellows PD11/30-To record HR admin fee for fellows PD11/30,,HJ,,212.5,284350.74
1001,12/7/2020,12/7/2020,HRKnowledge,To record HR admin fee for fellows PD11/30-To record HR admin fee for fellows PD11/30,,HJ,,687.5,283663.24
1001,12/7/2020,12/7/2020,HRKnowledge,To record HR admin fee for staff PD11/30-To record HR admin fee for staff PD11/30,,HJ,,1540,282123.24
1001,12/8/2020,12/8/2020,Eversource,December Eversource payment-December Eversource payment,,HJ,,35.76,282087.48
1001,12/8/2020,12/8/2020,Julie Balfour,Bill.Com Import--,,HJ,,3333.34,278754.14
1001,12/9/2020,12/9/2020,20201209,Transfer from #8984 to #6488-Transfer from #8984 to #6488,,HJ,532000,,810754.14
1001,12/9/2020,12/9/2020,Inspire Business Cen,Jackson center December rent payment-Jackson center December rent payment,,HJ,,988.3,809765.84
1001,12/9/2020,12/9/2020,Verizon,Mifi devices for fellows for December-Mifi devices for fellows for December,,HJ,,49.58,809716.26
1001,12/9/2020,12/9/2020,Verizon,Mifi devices for fellows for December-Mifi devices for fellows for December,,HJ,,76.64,809639.62
1001,12/9/2020,12/9/2020,Verizon,Mifi devices for fellows for December-Mifi devices for fellows for December,,HJ,,76.64,809562.98
1001,12/9/2020,12/9/2020,Verizon,Mifi devices for fellows for December-Mifi devices for fellows for December,,HJ,,247.94,809315.04
1001,12/9/2020,12/9/2020,Verizon,Mifi devices for fellows for December-Mifi devices for fellows for December,,HJ,,359.66,808955.38
1001,12/9/2020,12/9/2020,Verizon,Mifi devices for fellows for December-Mifi devices for fellows for December,,HJ,,555.85,808399.53
1001,12/9/2020,12/9/2020,Verizon,Mifi devices for fellows for December-Mifi devices for fellows for December,,HJ,,555.85,807843.68
1001,12/9/2020,12/9/2020,Verizon,Mifi devices for fellows for December-Mifi devices for fellows for December,,HJ,,1798.34,806045.34
1001,12/10/2020,12/10/2020,Emptech,Bill.Com Import--,,HJ,,1596,804449.34
1001,12/10/2020,12/10/2020,Feinberg Hanson,Bill.Com Import--,,HJ,,6555.94,797893.4
1001,12/10/2020,12/10/2020,Leslie Wade LLC,Bill.Com Import--,,HJ,,8352,789541.4
1001,12/11/2020,12/11/2020,ADP,ADP invoices for December-ADP invoices for staff for December,,HJ,,76.34,789465.06
1001,12/11/2020,12/11/2020,ADP,ADP invoices for December-ADP invoices for staff for December,,HJ,,117.99,789347.07
1001,12/11/2020,12/11/2020,ADP,ADP invoices for December-ADP invoices for staff for December,,HJ,,117.99,789229.08
1001,12/11/2020,12/11/2020,ADP,ADP invoices for December-ADP invoices for staff for December,,HJ,,381.73,788847.35
1001,12/11/2020,12/11/2020,ADP,ADP invoices for December-ADP invoices for staff for December,,HJ,,6094.77,782752.58
1001,12/11/2020,12/11/2020,Mighty Good Agency,Bill.Com Import--,,HJ,,5000,777752.58
1001,12/14/2020,12/14/2020,Eversource,Bill.Com Import--,,HJ,,0.66,777751.92
1001,12/14/2020,12/14/2020,Eversource,Bill.Com Import--,,HJ,0.66,,777752.58
1001,12/14/2020,12/14/2020,HRKnowledge,Fed&State labor law poster update service-Fed&State labor law poster update service,,HJ,,125,777627.58
1001,12/15/2020,12/15/2020,121520,82L-IMPORT PAYROLL-Import Payroll,,HJ,,645.39,776982.19
1001,12/15/2020,12/15/2020,121520,82L-IMPORT PAYROLL-Import Payroll,,HJ,,2701.23,774280.96
1001,12/15/2020,12/15/2020,121520,82L-IMPORT PAYROLL-Import Payroll,,HJ,,6588.36,767692.6
1001,12/15/2020,12/15/2020,121520,82L-IMPORT PAYROLL-Import Payroll,,HJ,,12692.95,754999.65
1001,12/15/2020,12/15/2020,121520,82L-IMPORT PAYROLL-Import Payroll,,HJ,,15532.4,739467.25
1001,12/15/2020,12/15/2020,121520,82L-IMPORT PAYROLL-Import Payroll,,HJ,,18746.51,720720.74
1001,12/15/2020,12/15/2020,121520,82L-IMPORT PAYROLL-Import Payroll,,HJ,,50514.66,670206.08
1001,12/15/2020,12/15/2020,121520,82L-IMPORT PAYROLL-Import Payroll,,HJ,,65202.86,605003.22
1001,12/15/2020,12/15/2020,121520,82L-IMPORT PAYROLL-Import Payroll,,HJ,,93469.48,511533.74
1001,12/15/2020,12/15/2020,121520,82L-IMPORT PAYROLL-Import Payroll,,HJ,,113365.74,398168
1001,12/15/2020,12/15/2020,20201215,Received revenue from Woot Math-Received revenue from Woot Math,,HJ,491.1,,398659.1
1001,12/15/2020,12/15/2020,20201215,Received one cent from Paul M Angell-Received one cent from Paul M Angell,,HJ,0.01,,398659.11
1001,12/15/2020,12/15/2020,JE-21-0112,LUX-PRPD-121520-LUX-PRPD-121520,,HJ,,215.87,398443.24
1001,12/15/2020,12/15/2020,JE-21-0112,LUX-PRPD-121520-LUX-PRPD-121520,,HJ,,5188.67,393254.57
1001,12/15/2020,12/15/2020,JE-21-0112,LUX-PRPD-121520-LUX-PRPD-121520,,HJ,,19251.61,374002.96
1001,12/15/2020,12/15/2020,JE-21-0112,LUX-PRPD-121520-LUX-PRPD-121520,,HJ,,103108.03,270894.93
1001,12/16/2020,12/16/2020,20201027,Americorps Reimbursement for November-Americorps Reimbursement for November -Reimbursement Payment,,HJ,233374.62,,504269.55
1001,12/16/2020,12/16/2020,20201216,Received reimb from Nancy Nwakanma-Received reimb from Nancy Nwakanma,,HJ,46.95,,504316.5
1001,12/16/2020,12/16/2020,TASC,Payment for TASC for PD 12/15/20-Payment for TASC for PD 12/15/20,,HJ,,2018.77,502297.73
1001,12/16/2020,12/16/2020,Unorthodox Philanthr,Received payment from Unorthodox Phil and Woot Math-Received payment from Unorthodox Phil,,HJ,350000,,852297.73
1001,12/16/2020,12/16/2020,Woot Math Acquisiti,Received payment from Unorthodox Phil and Woot Math-Received payment for Woot Math,,HJ,887.3,,853185.03
1001,12/17/2020,12/17/2020,T-Mobile,November Phone Expenses for Fellows-December Phone Expenses for Fellows,,HJ,,61.78,853123.25
1001,12/17/2020,12/17/2020,T-Mobile,November Phone Expenses for Fellows-December Phone Expenses for Fellows,,HJ,,95.47,853027.78
1001,12/17/2020,12/17/2020,T-Mobile,November Phone Expenses for Fellows-December Phone Expenses for Fellows,,HJ,,95.47,852932.31
1001,12/17/2020,12/17/2020,T-Mobile,November Phone Expenses for Fellows-December Phone Expenses for Fellows,,HJ,,308.88,852623.43
1001,12/18/2020,12/18/2020,HRKnowledge,Virtual HR: Essentials (Q1Jan-Mar 2021)-Virtual HR: Essentials (Q1Jan-Mar 2021),,HJ,,3000,849623.43
1001,12/18/2020,12/18/2020,HRKnowledge,HR Outsourcing admin fee for staff and fellows-HR Outsourcing admin fee for fellows PD12/15,,HJ,,137.5,849485.93
1001,12/18/2020,12/18/2020,HRKnowledge,HR Outsourcing admin fee for staff and fellows-HR Outsourcing admin fee for fellows PD12/15,,HJ,,212.5,849273.43
1001,12/18/2020,12/18/2020,HRKnowledge,HR Outsourcing admin fee for staff and fellows-HR Outsourcing admin fee for fellows PD12/15,,HJ,,212.5,849060.93
1001,12/18/2020,12/18/2020,HRKnowledge,HR Outsourcing admin fee for staff and fellows-HR Outsourcing admin fee for fellows PD12/15,,HJ,,687.5,848373.43
1001,12/18/2020,12/18/2020,HRKnowledge,HR Outsourcing admin fee for staff and fellows-HR Outsourcing admin fee for staff PD12/15,,HJ,,1540,846833.43
1001,12/21/2020,12/21/2020,ANGELLFAMILY,Received payment from Paul M Angell-Received payment from Paul M Angell,,HJ,100000,,946833.43
1001,12/21/2020,12/21/2020,Enabler Design,Bill.Com Import--,,HJ,,585,946248.43
1001,12/21/2020,12/21/2020,Grubhub,Bill.Com Import--,,HJ,,31.8,946216.63
1001,12/21/2020,12/21/2020,Grubhub,Bill.Com Import--,,HJ,,66.78,946149.85
1001,12/21/2020,12/21/2020,Grubhub,Bill.Com Import--,,HJ,,73.77,946076.08
1001,12/21/2020,12/21/2020,Grubhub,Bill.Com Import--,,HJ,,75.95,946000.13
1001,12/21/2020,12/21/2020,Grubhub,Bill.Com Import--,,HJ,,96.21,945903.92
1001,12/21/2020,12/21/2020,Grubhub,Bill.Com Import--,,HJ,,221.58,945682.34
1001,12/21/2020,12/21/2020,Grubhub,Bill.Com Import--,,HJ,,642.18,945040.16
1001,12/21/2020,12/21/2020,Grubhub,Bill.Com Import--,,HJ,,991.37,944048.79
1001,12/21/2020,12/21/2020,Hutchinson Black,Bill.Com Import--,,HJ,,145,943903.79
1001,12/21/2020,12/21/2020,Michael Goldstein,Bill.Com Import--,,HJ,,15000,928903.79
1001,12/21/2020,12/21/2020,Stephen Lipscomb,Bill.Com Import--,,HJ,,499.69,928404.1
1001,12/21/2020,12/21/2020,Tess Brownson,Bill.Com Import--,,HJ,,1500,926904.1
1001,12/21/2020,12/21/2020,Whiteboard,Bill.Com Import--,,HJ,,7500,919404.1
1001,12/22/2020,12/22/2020,20201222,Received individual donations through QGiv-Received individual donations through QGiv,,HJ,252.07,,919656.17
1001,12/22/2020,12/22/2020,Media Cause,Bill.Com Import--,,HJ,,12674,906982.17
1001,12/24/2020,12/24/2020,20201224,Cash received from The Learning Age via Plooto-on behalf of Krista-Cash received from The Learning Age via Plooto-on behalf of Krista,,HJ,500,,907482.17
1001,12/24/2020,12/24/2020,Walnut Street Realty,Bill.Com Import--,,HJ,,2192.58,905289.59
1001,12/29/2020,12/29/2020,Abila,Bill.Com Import--,,HJ,,250,905039.59
1001,12/29/2020,12/29/2020,Emptech,Bill.Com Import--,,HJ,,1596,903443.59
1001,12/30/2020,12/30/2020,Abila,Bill.Com Import--,,HJ,,110,903333.59
1001,12/30/2020,12/30/2020,Mighty Good Agency,Bill.Com Import--,,HJ,,4000,899333.59
1001,12/31/2020,12/31/2020,123120,82L-IMPORT PAYROLL-Import Payroll,,HJ,,687.37,898646.22
1001,12/31/2020,12/31/2020,123120,82L-IMPORT PAYROLL-Import Payroll,,HJ,,2982.32,895663.9
1001,12/31/2020,12/31/2020,123120,82L-IMPORT PAYROLL-Import Payroll,,HJ,,6330.1,889333.8
1001,12/31/2020,12/31/2020,123120,82L-IMPORT PAYROLL-Import Payroll,,HJ,,12476.03,876857.77
1001,12/31/2020,12/31/2020,123120,82L-IMPORT PAYROLL-Import Payroll,,HJ,,15898.24,860959.53
1001,12/31/2020,12/31/2020,123120,82L-IMPORT PAYROLL-Import Payroll,,HJ,,18746.51,842213.02
1001,12/31/2020,12/31/2020,123120,82L-IMPORT PAYROLL-Import Payroll,,HJ,,50270.33,791942.69
1001,12/31/2020,12/31/2020,123120,82L-IMPORT PAYROLL-Import Payroll,,HJ,,62381.41,729561.28
1001,12/31/2020,12/31/2020,123120,82L-IMPORT PAYROLL-Import Payroll,,HJ,,92768.94,636792.34
1001,12/31/2020,12/31/2020,123120,82L-IMPORT PAYROLL-Import Payroll,,HJ,,98027.57,538764.77
1001,12/31/2020,12/31/2020,COLLEGEBOARD,Received CB Payment-Received CB Payment,,HJ,72419.35,,611184.12
1001,12/31/2020,12/31/2020,Eversource,Fixing Pay-by-Pay amount and Eversource-Fixing Pay-by-Pay amount and Eversource,,HJ,1.66,,611185.78
1001,12/31/2020,12/31/2020,JE-21-0113,LUX-PRPD-123120-LUX-PRPD-123120,,HJ,,215.45,610970.33
1001,12/31/2020,12/31/2020,JE-21-0113,LUX-PRPD-123120-LUX-PRPD-123120,,HJ,,5314.37,605655.96
1001,12/31/2020,12/31/2020,JE-21-0113,LUX-PRPD-123120-LUX-PRPD-123120,,HJ,,19251.61,586404.35
1001,12/31/2020,12/31/2020,JE-21-0113,LUX-PRPD-123120-LUX-PRPD-123120,,HJ,,103138.03,483266.32
1001,1/4/2021,1/4/2021,BCBS,January 2021 BCBS Payment-BCBS - January 2021 BCBS,,HJ,125.96,,483392.28
1001,1/4/2021,1/4/2021,BCBS,January 2021 BCBS Payment-BCBS - January 2021 BCBS,,HJ,,433.3,482958.98
1001,1/4/2021,1/4/2021,BCBS,January 2021 BCBS Payment-BCBS - January 2021 BCBS,,HJ,,855.24,482103.74
1001,1/4/2021,1/4/2021,BCBS,January 2021 BCBS Payment-BCBS - January 2021 BCBS,,HJ,,1159.82,480943.92
1001,1/4/2021,1/4/2021,BCBS,January 2021 BCBS Payment-BCBS - January 2021 BCBS,,HJ,1495.97,,482439.89
1001,1/4/2021,1/4/2021,BCBS,January 2021 BCBS Payment-BCBS - January 2021 BCBS,,HJ,,2326.61,480113.28
1001,1/4/2021,1/4/2021,BCBS,January 2021 BCBS Payment-BCBS - January 2021 BCBS,,HJ,,5409.12,474704.16
1001,1/4/2021,1/4/2021,BCBS,January 2021 BCBS Payment-BCBS - January 2021 BCBS,,HJ,,7608.99,467095.17
1001,1/4/2021,1/4/2021,BCBS,January 2021 BCBS Payment-BCBS - January 2021 BCBS,,HJ,,8545.47,458549.7
1001,1/4/2021,1/4/2021,BCBS,January 2021 BCBS Payment-BCBS - January 2021 BCBS,,HJ,,8793.45,449756.25
1001,1/4/2021,1/4/2021,BCBS,January 2021 BCBS Payment-BCBS - January 2021 BCBS,,HJ,,11054.89,438701.36
1001,1/4/2021,1/4/2021,BCBS,January 2021 BCBS Payment-BCBS - January 2021 BCBS,,HJ,,11876.56,426824.8
1001,1/4/2021,1/4/2021,BCBS,January 2021 BCBS Payment-BCBS - January 2021 BCBS,,HJ,,23879.63,402945.17
1001,1/4/2021,1/4/2021,TAG Resources LLC,Employee 401K Payment-Employee 401K Payment PD 12312020,,HJ,,3993.7,398951.47
1001,1/4/2021,1/4/2021,TASC,Payment for TASC for PD 12/31/20-Payment for TASC for PD 12/31/20,,HJ,,1664.95,397286.52
1001,1/5/2021,1/5/2021,Bank of America VISA,BofA concur payment-BofA CC December's transaction Payment,,HJ,,433.5,396853.02
1001,1/5/2021,1/5/2021,Bank of America VISA,BofA concur payment-BofA CC December's transaction Payment,,HJ,,591.8,396261.22
1001,1/5/2021,1/5/2021,Bank of America VISA,BofA concur payment-BofA CC December's transaction Payment,,HJ,,698.92,395562.3
1001,1/5/2021,1/5/2021,Bank of America VISA,BofA concur payment-BofA CC December's transaction Payment,,HJ,,1248.88,394313.42
1001,1/5/2021,1/5/2021,Bank of America VISA,BofA concur payment-BofA CC December's transaction Payment,,HJ,,1341.76,392971.66
1001,1/5/2021,1/5/2021,Bank of America VISA,BofA concur payment-BofA CC December's transaction Payment,,HJ,,2888.22,390083.44
1001,1/5/2021,1/5/2021,Bank of America VISA,BofA concur payment-BofA CC December's transaction Payment,,HJ,,6137.05,383946.39
1001,1/5/2021,1/5/2021,Bank of America VISA,BofA concur payment-BofA CC December's transaction Payment,,HJ,,6959.14,376987.25
1001,1/5/2021,1/5/2021,Comcast,December Comcast Payment-December Comcast Payment,,HJ,,139.55,376847.7
1001,1/5/2021,1/5/2021,HRKnowledge,To record HR Admin fee for staff PD 12/31-To record HR Admin fee for staff PD 12/31,,HJ,,1540,375307.7
1001,1/5/2021,1/5/2021,HRKnowledge,To Record HR Admin Fee for Fellow PD12/31-To Record HR Admin Fee for Fellow PD12/31,,HJ,,137.5,375170.2
1001,1/5/2021,1/5/2021,HRKnowledge,To Record HR Admin Fee for Fellow PD12/31-To Record HR Admin Fee for Fellow PD12/31,,HJ,,212.5,374957.7
1001,1/5/2021,1/5/2021,HRKnowledge,To Record HR Admin Fee for Fellow PD12/31-To Record HR Admin Fee for Fellow PD12/31,,HJ,,212.5,374745.2
1001,1/5/2021,1/5/2021,HRKnowledge,To Record HR Admin Fee for Fellow PD12/31-To Record HR Admin Fee for Fellow PD12/31,,HJ,,687.5,374057.7
1001,1/5/2021,1/5/2021,JE-21-0146,Blue 20/20 Vision Insurance - January Inv LUX-Blue 20/20 Vision Insurance -January Inv LUX,,HJ,,7.11,374050.59
1001,1/5/2021,1/5/2021,JE-21-0146,Blue 20/20 Vision Insurance - January Inv LUX-Blue 20/20 Vision Insurance -January Inv LUX,,HJ,,28.44,374022.15
1001,1/5/2021,1/5/2021,JE-21-0146,Blue 20/20 Vision Insurance - January Inv LUX-Blue 20/20 Vision Insurance -January Inv LUX,,HJ,,319.95,373702.2
1001,1/5/2021,1/5/2021,JE-21-0147,Blue 20/20 Vision Insurance- January Inv 82L-Blue 20/20 Vision Insurance January Inv 82L,,HJ,,7.11,373695.09
1001,1/5/2021,1/5/2021,JE-21-0147,Blue 20/20 Vision Insurance- January Inv 82L-Blue 20/20 Vision Insurance January Inv 82L,,HJ,,21.33,373673.76
1001,1/5/2021,1/5/2021,JE-21-0147,Blue 20/20 Vision Insurance- January Inv 82L-Blue 20/20 Vision Insurance January Inv 82L,,HJ,,35.13,373638.63
1001,1/5/2021,1/5/2021,JE-21-0147,Blue 20/20 Vision Insurance- January Inv 82L-Blue 20/20 Vision Insurance January Inv 82L,,HJ,,49.77,373588.86
1001,1/5/2021,1/5/2021,JE-21-0147,Blue 20/20 Vision Insurance- January Inv 82L-Blue 20/20 Vision Insurance January Inv 82L,,HJ,,56.04,373532.82
1001,1/5/2021,1/5/2021,JE-21-0147,Blue 20/20 Vision Insurance- January Inv 82L-Blue 20/20 Vision Insurance January Inv 82L,,HJ,,85.32,373447.5
1001,1/5/2021,1/5/2021,JE-21-0147,Blue 20/20 Vision Insurance- January Inv 82L-Blue 20/20 Vision Insurance January Inv 82L,,HJ,,105.94,373341.56
1001,1/5/2021,1/5/2021,JE-21-0147,Blue 20/20 Vision Insurance- January Inv 82L-Blue 20/20 Vision Insurance January Inv 82L,,HJ,,161.56,373180
1001,1/6/2021,1/6/2021,Tiffany Cardona,Bill.Com Import--,,HJ,,3888,369292
1001,1/7/2021,1/7/2021,20210107,Transfer from #8984 to checking #6488 account-Transfer from #8984 to checking #6488 account,,HJ,283000,,652292
1001,1/7/2021,1/7/2021,Abacus Bookkeeping,Bill.Com Import--,,HJ,,125,652167
1001,1/7/2021,1/7/2021,Littler Mendelson,Bill.Com Import--,,HJ,,1881,650286
1001,1/7/2021,1/7/2021,The Hartford,NY Employee PFL Insurance-NY Employee PFL Insurance,,HJ,,723.39,649562.61
1001,1/7/2021,1/7/2021,Verizon,Wifi services pay for Fellows January-Wifi services pay for Fellows January,,HJ,,49.58,649513.03
1001,1/7/2021,1/7/2021,Verizon,Wifi services pay for Fellows January-Wifi services pay for Fellows January,,HJ,,76.64,649436.39
1001,1/7/2021,1/7/2021,Verizon,Wifi services pay for Fellows January-Wifi services pay for Fellows January,,HJ,,76.64,649359.75
1001,1/7/2021,1/7/2021,Verizon,Wifi services pay for Fellows January-Wifi services pay for Fellows January,,HJ,,247.94,649111.81
1001,1/7/2021,1/7/2021,Verizon,Wifi services pay for Fellows January-Wifi services pay for Fellows January,,HJ,,642.66,648469.15
1001,1/7/2021,1/7/2021,Verizon,Wifi services pay for Fellows January-Wifi services pay for Fellows January,,HJ,,993.21,647475.94
1001,1/7/2021,1/7/2021,Verizon,Wifi services pay for Fellows January-Wifi services pay for Fellows January,,HJ,,993.21,646482.73
1001,1/7/2021,1/7/2021,Verizon,Wifi services pay for Fellows January-Wifi services pay for Fellows January,,HJ,,3213.31,643269.42
1001,1/8/2021,1/8/2021,20210108,Donation from Dancing Tides Foundation Inc-Donation from Dancing Tides Foundation Inc,,HJ,10000,,653269.42
1001,1/8/2021,1/8/2021,ADP,ADP invoices for staff and fellows for January-ADP invoices for staff for January,,HJ,,74.18,653195.24
1001,1/8/2021,1/8/2021,ADP,ADP invoices for staff and fellows for January-ADP invoices for staff for January,,HJ,,114.66,653080.58
1001,1/8/2021,1/8/2021,ADP,ADP invoices for staff and fellows for January-ADP invoices for staff for January,,HJ,,114.66,652965.92
1001,1/8/2021,1/8/2021,ADP,ADP invoices for staff and fellows for January-ADP invoices for staff for January,,HJ,,370.95,652594.97
1001,1/8/2021,1/8/2021,ADP,ADP invoices for staff and fellows for January-ADP invoices for staff for January,,HJ,,5894.35,646700.62
1001,1/11/2021,1/11/2021,20210111,Received revenue from Woot Math-Received revenue from Woot Math,,HJ,455.6,,647156.22
1001,1/11/2021,1/11/2021,Eversource,January Eversource Payment-January Eversource Payment,,HJ,,40.97,647115.25
1001,1/11/2021,1/11/2021,Inspire Business Cen,Jackson Center January rent parking Inspire Business Center-Jackson Center January rent parking Inspire Business Center,,HJ,,975,646140.25
1001,1/12/2021,1/12/2021,2147795897,Transfer from Acct #8984 to #6488-Transfer from Acct #8984 to #6488,,HJ,500000,,1146140.25
1001,1/12/2021,1/12/2021,3JB-156 2021,Bill.Com Import--,,HJ,,2188,1143952.25
1001,1/12/2021,1/12/2021,Carnegie Learning,Bill.Com Import--,,HJ,,4500,1139452.25
1001,1/14/2021,1/14/2021,20201213,Americorps Reimbursement for December-Americorps Reimbursement for December -Reimbursement Payment,,HJ,212210.7,,1351662.95
1001,1/14/2021,1/14/2021,Clever Inc.,Bill.Com Import--,,HJ,,12000,1339662.95
1001,1/14/2021,1/14/2021,Emptech,Bill.Com Import--,,HJ,,333,1339329.95
1001,1/14/2021,1/14/2021,FINNEGAN,Received payment from Finnegan-Received payment from Finnegan,,HJ,10000,,1349329.95
1001,1/14/2021,1/14/2021,Internal Revenue Ser,Bill.Com Import--,,HJ,,8750,1340579.95
1001,1/14/2021,1/14/2021,The Hanover Ins,Bill.Com Import--,,HJ,,5864.25,1334715.7
1001,1/15/2021,1/15/2021,11521,82L-IMPORT PAYROLL-Import Payroll,,HJ,,2217.57,1332498.13
1001,1/15/2021,1/15/2021,11521,82L-IMPORT PAYROLL-Import Payroll,,HJ,,2982.32,1329515.81
1001,1/15/2021,1/15/2021,11521,82L-IMPORT PAYROLL-Import Payroll,,HJ,,6853.37,1322662.44
1001,1/15/2021,1/15/2021,11521,82L-IMPORT PAYROLL-Import Payroll,,HJ,,15281.01,1307381.43
1001,1/15/2021,1/15/2021,11521,82L-IMPORT PAYROLL-Import Payroll,,HJ,,19095.03,1288286.4
1001,1/15/2021,1/15/2021,11521,82L-IMPORT PAYROLL-Import Payroll,,HJ,,25000,1263286.4
1001,1/15/2021,1/15/2021,11521,82L-IMPORT PAYROLL-Import Payroll,,HJ,,50000,1213286.4
1001,1/15/2021,1/15/2021,11521,82L-IMPORT PAYROLL-Import Payroll,,HJ,,50612.6,1162673.8
1001,1/15/2021,1/15/2021,11521,82L-IMPORT PAYROLL-Import Payroll,,HJ,,88182.21,1074491.59
1001,1/15/2021,1/15/2021,11521,82L-IMPORT PAYROLL-Import Payroll,,HJ,,95913.95,978577.64
1001,1/15/2021,1/15/2021,JE-21-0145,LUX PayrollLUX-PRPPD-01152021-LUX-PRPD-01152021,,HJ,,278.46,978299.18
1001,1/15/2021,1/15/2021,JE-21-0145,LUX PayrollLUX-PRPPD-01152021-LUX-PRPD-01152021,,HJ,,5327.54,972971.64
1001,1/15/2021,1/15/2021,JE-21-0145,LUX PayrollLUX-PRPPD-01152021-LUX-PRPD-01152021,,HJ,,18457.12,954514.52
1001,1/15/2021,1/15/2021,JE-21-0145,LUX PayrollLUX-PRPPD-01152021-LUX-PRPD-01152021,,HJ,,100115.21,854399.31
1001,1/19/2021,1/19/2021,20210119,Receiving individual donations QGiv-Receiving individual donations QGiv,,HJ,133.14,,854532.45
1001,1/19/2021,1/19/2021,Julie Balfour,Bill.Com Import--,,HJ,,3333.33,851199.12
1001,1/19/2021,1/19/2021,T-Mobile,January Phone Expenses for Fellows-January Phone Expenses for Fellows,,HJ,,61.78,851137.34
1001,1/19/2021,1/19/2021,T-Mobile,January Phone Expenses for Fellows-January Phone Expenses for Fellows,,HJ,,95.47,851041.87
1001,1/19/2021,1/19/2021,T-Mobile,January Phone Expenses for Fellows-January Phone Expenses for Fellows,,HJ,,95.47,850946.4
1001,1/19/2021,1/19/2021,T-Mobile,January Phone Expenses for Fellows-January Phone Expenses for Fellows,,HJ,,308.88,850637.52
1001,1/19/2021,1/19/2021,TASC,Payment for TASC for PD 1/15/21-Payment for TASC for PD 1/15/21,,HJ,,2018.77,848618.75
1001,1/20/2021,1/20/2021,Inspire Business Cen,Jackson Center January rent parking Inspire Business Center-Jackson Center January rent parking Inspire Business Center,,HJ,,3,848615.75
1001,1/20/2021,1/20/2021,Leslie Wade LLC,Bill.Com Import--,,HJ,,17104,831511.75
1001,1/20/2021,1/20/2021,TAG Resources LLC,To record employee 401k payment-To record employee 401k payment,,HJ,,3957.92,827553.83
1001,1/20/2021,1/20/2021,Whiteboard,Bill.Com Import--,,HJ,,8576.85,818976.98
1001,1/21/2021,1/21/2021,20201106,Refund from Simbulus Insurance-Refund from Simbulus Insurance,,HJ,384.37,,819361.35
1001,1/21/2021,1/21/2021,AAFCPAS,Bill.Com Import--,,HJ,,1000,818361.35
1001,1/21/2021,1/21/2021,Citadel Foundation,received from Citadel Foundation-received from Citadel Foundation,,HJ,820000,,1638361.35
1001,1/21/2021,1/21/2021,HRKnowledge,HR Outsourcing Admin fee for Staff and Fellows PD1/15-HR Outsourcing Admin fee for Fellows PD1/15,,HJ,,135.3,1638226.05
1001,1/21/2021,1/21/2021,HRKnowledge,HR Outsourcing Admin fee for Staff and Fellows PD1/15-HR Outsourcing Admin fee for Fellows PD1/15,,HJ,,209.1,1638016.95
1001,1/21/2021,1/21/2021,HRKnowledge,HR Outsourcing Admin fee for Staff and Fellows PD1/15-HR Outsourcing Admin fee for Fellows PD1/15,,HJ,,209.1,1637807.85
1001,1/21/2021,1/21/2021,HRKnowledge,HR Outsourcing Admin fee for Staff and Fellows PD1/15-HR Outsourcing Admin fee for Fellows PD1/15,,HJ,,676.5,1637131.35
1001,1/21/2021,1/21/2021,HRKnowledge,HR Outsourcing Admin fee for Staff and Fellows PD1/15-HR Outsourcing Admin fee for Staff PD1/15,,HJ,,1600,1635531.35
1001,1/22/2021,1/22/2021,Feinberg Hanson,Bill.Com Import--,,HJ,,3939,1631592.35
1001,1/22/2021,1/22/2021,Grubhub,Bill.Com Import--,,HJ,,15.9,1631576.45
1001,1/22/2021,1/22/2021,Grubhub,Bill.Com Import--,,HJ,,47.7,1631528.75
1001,1/22/2021,1/22/2021,Grubhub,Bill.Com Import--,,HJ,,58.3,1631470.45
1001,1/22/2021,1/22/2021,Grubhub,Bill.Com Import--,,HJ,,158.78,1631311.67
1001,1/22/2021,1/22/2021,Grubhub,Bill.Com Import--,,HJ,,162.82,1631148.85
1001,1/22/2021,1/22/2021,Grubhub,Bill.Com Import--,,HJ,,286.42,1630862.43
1001,1/22/2021,1/22/2021,Grubhub,Bill.Com Import--,,HJ,,527.03,1630335.4
1001,1/22/2021,1/22/2021,Grubhub,Bill.Com Import--,,HJ,,1135.51,1629199.89
1001,1/22/2021,1/22/2021,Media Cause,Bill.Com Import--,,HJ,,12451,1616748.89
1001,1/22/2021,1/22/2021,Walnut Street Realty,Bill.Com Import--,,HJ,,2192.58,1614556.31
1001,1/25/2021,1/25/2021,ADP,ADP invoices for staff and fellows for January-ADP tax filing invoices for Staff for January,,HJ,,407.41,1614148.9
1001,1/25/2021,1/25/2021,ADP,ADP invoices for staff and fellows for January-ADP tax filing invoices for fellows for January,,HJ,,24.71,1614124.19
1001,1/25/2021,1/25/2021,ADP,ADP invoices for staff and fellows for January-ADP tax filing invoices for fellows for January,,HJ,,38.2,1614085.99
1001,1/25/2021,1/25/2021,ADP,ADP invoices for staff and fellows for January-ADP tax filing invoices for fellows for January,,HJ,,38.2,1614047.79
1001,1/25/2021,1/25/2021,ADP,ADP invoices for staff and fellows for January-ADP tax filing invoices for fellows for January,,HJ,,123.58,1613924.21
1001,1/25/2021,1/25/2021,Brandvia,Bill.Com Import--,,HJ,,34.66,1613889.55
1001,1/25/2021,1/25/2021,Brandvia,Bill.Com Import--,,HJ,,311.9,1613577.65
1001,1/25/2021,1/25/2021,Brandvia,Bill.Com Import--,,HJ,,572.61,1613005.04
1001,1/25/2021,1/25/2021,Brandvia,Bill.Com Import--,,HJ,,808.62,1612196.42
1001,1/25/2021,1/25/2021,Brandvia,Bill.Com Import--,,HJ,,5153.5,1607042.92
1001,1/25/2021,1/25/2021,Brandvia,Bill.Com Import--,,HJ,,13360.92,1593682
1001,1/25/2021,1/25/2021,Emptech,Bill.Com Import--,,HJ,,333,1593349
1001,1/26/2021,1/26/2021,Knowre Americas Inc,Bill.Com Import--,,HJ,,4000,1589349
1001,1/26/2021,1/26/2021,Leslie Wade LLC,Bill.Com Import--,,HJ,,20352,1568997
1001,1/27/2021,1/27/2021,Littler Mendelson,Bill.Com Import--,,HJ,,1462.5,1567534.5
1001,1/27/2021,1/27/2021,Stryder,Bill.Com Import--,,HJ,,962.5,1566572
1001,1/27/2021,1/27/2021,Stryder,Bill.Com Import--,,HJ,,1487.5,1565084.5
1001,1/27/2021,1/27/2021,Stryder,Bill.Com Import--,,HJ,,1487.5,1563597
1001,1/27/2021,1/27/2021,Stryder,Bill.Com Import--,,HJ,,4812.5,1558784.5
1001,1/27/2021,1/27/2021,Woot Math Acquisiti,Received revenue from Woot Math-Received revenue or paid reimb for Woot Math,,HJ,312.34,,1559096.84
1001,1/28/2021,1/28/2021,Amy Smith,Bill.Com Import--,,HJ,,660,1558436.84
1001,1/28/2021,1/28/2021,Emptech,Bill.Com Import--,,HJ,,333,1558103.84
1001,1/29/2021,1/29/2021,12921,82L-IMPORT PAYROLL-Import Payroll,,HJ,,2813.2,1555290.64
1001,1/29/2021,1/29/2021,12921,82L-IMPORT PAYROLL-Import Payroll,,HJ,,6853.37,1548437.27
1001,1/29/2021,1/29/2021,12921,82L-IMPORT PAYROLL-Import Payroll,,HJ,,15236.54,1533200.73
1001,1/29/2021,1/29/2021,12921,82L-IMPORT PAYROLL-Import Payroll,,HJ,,19089.13,1514111.6
1001,1/29/2021,1/29/2021,12921,82L-IMPORT PAYROLL-Import Payroll,,HJ,,39520,1474591.6
1001,1/29/2021,1/29/2021,12921,82L-IMPORT PAYROLL-Import Payroll,,HJ,,40138.42,1434453.18
1001,1/29/2021,1/29/2021,12921,82L-IMPORT PAYROLL-Import Payroll,,HJ,,50573.97,1383879.21
1001,1/29/2021,1/29/2021,12921,82L-IMPORT PAYROLL-Import Payroll,,HJ,,85998.46,1297880.75
1001,1/29/2021,1/29/2021,12921,82L-IMPORT PAYROLL-Import Payroll,,HJ,,97369.44,1200511.31
1001,1/31/2021,1/31/2021,JE-21-0151,LUX PRPD- 013121-LUX-PRPD-013121,,HJ,,578.09,1199933.22
1001,1/31/2021,1/31/2021,JE-21-0151,LUX PRPD- 013121-LUX-PRPD-013121,,HJ,,5145.66,1194787.56
1001,1/31/2021,1/31/2021,JE-21-0151,LUX PRPD- 013121-LUX-PRPD-013121,,HJ,,18257.35,1176530.21
1001,1/31/2021,1/31/2021,JE-21-0151,LUX PRPD- 013121-LUX-PRPD-013121,,HJ,,97873.51,1078656.7
1001,2/1/2021,2/1/2021,Abila,Bill.Com Import--,,HJ,,250,1078406.7
1001,2/1/2021,2/1/2021,Alexander Randolph,Bill.Com Import--,,HJ,,37.87,1078368.83
1001,2/1/2021,2/1/2021,BCBS,BCBS February Payment-BCBS - February 2021 BCBS,,HJ,,47.83,1078321
1001,2/1/2021,2/1/2021,BCBS,BCBS February Payment-BCBS - February 2021 BCBS,,HJ,,667.84,1077653.16
1001,2/1/2021,2/1/2021,BCBS,BCBS February Payment-BCBS - February 2021 BCBS,,HJ,,855.24,1076797.92
1001,2/1/2021,2/1/2021,BCBS,BCBS February Payment-BCBS - February 2021 BCBS,,HJ,,1159.82,1075638.1
1001,2/1/2021,2/1/2021,BCBS,BCBS February Payment-BCBS - February 2021 BCBS,,HJ,,1255.12,1074382.98
1001,2/1/2021,2/1/2021,BCBS,BCBS February Payment-BCBS - February 2021 BCBS,,HJ,,2324.24,1072058.74
1001,2/1/2021,2/1/2021,BCBS,BCBS February Payment-BCBS - February 2021 BCBS,,HJ,,3225.17,1068833.57
1001,2/1/2021,2/1/2021,BCBS,BCBS February Payment-BCBS - February 2021 BCBS,,HJ,,5737.47,1063096.1
1001,2/1/2021,2/1/2021,BCBS,BCBS February Payment-BCBS - February 2021 BCBS,,HJ,,6273.96,1056822.14
1001,2/1/2021,2/1/2021,BCBS,BCBS February Payment-BCBS - February 2021 BCBS,,HJ,,7608.99,1049213.15
1001,2/1/2021,2/1/2021,BCBS,BCBS February Payment-BCBS - February 2021 BCBS,,HJ,,8545.47,1040667.68
1001,2/1/2021,2/1/2021,BCBS,BCBS February Payment-BCBS - February 2021 BCBS,,HJ,,13146.16,1027521.52
1001,2/1/2021,2/1/2021,BCBS,BCBS February Payment-BCBS - February 2021 BCBS,,HJ,,15379.07,1012142.45
1001,2/1/2021,2/1/2021,TAG Resources LLC,Employee 401K Payment PD 01282021-Employee 401K Payment PD 01282021,,HJ,,3948.78,1008193.67
1001,2/1/2021,2/1/2021,TASC,Payment for TASC for PD 1/29/21-Payment for TASC for PD 1/29/21,,HJ,,1596.59,1006597.08
1001,2/2/2021,2/2/2021,20210202,Receiving or refunding individual donations QGiv-Receiving or refunding individual donations QGiv,,HJ,,6.06,1006591.02
1001,2/2/2021,2/2/2021,Abila,Bill.Com Import--,,HJ,,110,1006481.02
1001,2/2/2021,2/2/2021,Bank of America VISA,BofA Concur Payment-BofA CC January's transaction Payment,,HJ,,726.39,1005754.63
1001,2/2/2021,2/2/2021,Bank of America VISA,BofA Concur Payment-BofA CC January's transaction Payment,,HJ,,1015.08,1004739.55
1001,2/2/2021,2/2/2021,Bank of America VISA,BofA Concur Payment-BofA CC January's transaction Payment,,HJ,,1520.01,1003219.54
1001,2/2/2021,2/2/2021,Bank of America VISA,BofA Concur Payment-BofA CC January's transaction Payment,,HJ,,4793.35,998426.19
1001,2/2/2021,2/2/2021,Bank of America VISA,BofA Concur Payment-BofA CC January's transaction Payment,,HJ,,6454.48,991971.71
1001,2/2/2021,2/2/2021,Bank of America VISA,BofA Concur Payment-BofA CC January's transaction Payment,,HJ,,10640.01,981331.7
1001,2/2/2021,2/2/2021,Bank of America VISA,BofA Concur Payment-BofA CC January's transaction Payment,,HJ,,11314.83,970016.87
1001,2/2/2021,2/2/2021,HRKnowledge,HRKnowledge Virtual HR Partner PD.0106-HRKnowledge Virtual HR Partner PD.0106,,HJ,,2000,968016.87
1001,2/2/2021,2/2/2021,JE-21-0165,Blue 20/20 Vision Insurance February Inv 82L-Blue 20/20 Vision Insurance February Inv 82L,,HJ,,7.11,968009.76
1001,2/2/2021,2/2/2021,JE-21-0165,Blue 20/20 Vision Insurance February Inv 82L-Blue 20/20 Vision Insurance February Inv 82L,,HJ,,21.33,967988.43
1001,2/2/2021,2/2/2021,JE-21-0165,Blue 20/20 Vision Insurance February Inv 82L-Blue 20/20 Vision Insurance February Inv 82L,,HJ,,35.13,967953.3
1001,2/2/2021,2/2/2021,JE-21-0165,Blue 20/20 Vision Insurance February Inv 82L-Blue 20/20 Vision Insurance February Inv 82L,,HJ,,42.24,967911.06
1001,2/2/2021,2/2/2021,JE-21-0165,Blue 20/20 Vision Insurance February Inv 82L-Blue 20/20 Vision Insurance February Inv 82L,,HJ,,49.77,967861.29
1001,2/2/2021,2/2/2021,JE-21-0165,Blue 20/20 Vision Insurance February Inv 82L-Blue 20/20 Vision Insurance February Inv 82L,,HJ,,71.1,967790.19
1001,2/2/2021,2/2/2021,JE-21-0165,Blue 20/20 Vision Insurance February Inv 82L-Blue 20/20 Vision Insurance February Inv 82L,,HJ,,98.42,967691.77
1001,2/2/2021,2/2/2021,JE-21-0165,Blue 20/20 Vision Insurance February Inv 82L-Blue 20/20 Vision Insurance February Inv 82L,,HJ,,98.83,967592.94
1001,2/2/2021,2/2/2021,JE-21-0166,Blue 20/20 Vision Insurance - February Inv LUX-Blue 20/20 Vision Insurance -February Inv LUX,,HJ,,7.11,967585.83
1001,2/2/2021,2/2/2021,JE-21-0166,Blue 20/20 Vision Insurance - February Inv LUX-Blue 20/20 Vision Insurance -February Inv LUX,,HJ,,21.33,967564.5
1001,2/2/2021,2/2/2021,JE-21-0166,Blue 20/20 Vision Insurance - February Inv LUX-Blue 20/20 Vision Insurance -February Inv LUX,,HJ,,184.86,967379.64
1001,2/3/2021,2/3/2021,840548000,ADP MA State UHI Adjustment Reimbursement-ADP MA State UHI Adjustment Reimbursement,,HJ,24.41,,967404.05
1001,2/3/2021,2/3/2021,HRKnowledge,To record HR Admin fee for staff PD 1/31-To record HR Admin fee for staff PD 1/31,,HJ,,1560,965844.05
1001,2/3/2021,2/3/2021,HRKnowledge,To Record HR Admin Fee for Fellow PD01/29-To Record HR Admin Fee for Fellow PD01/29,,HJ,,129.8,965714.25
1001,2/3/2021,2/3/2021,HRKnowledge,To Record HR Admin Fee for Fellow PD01/29-To Record HR Admin Fee for Fellow PD01/29,,HJ,,200.6,965513.65
1001,2/3/2021,2/3/2021,HRKnowledge,To Record HR Admin Fee for Fellow PD01/29-To Record HR Admin Fee for Fellow PD01/29,,HJ,,200.6,965313.05
1001,2/3/2021,2/3/2021,HRKnowledge,To Record HR Admin Fee for Fellow PD01/29-To Record HR Admin Fee for Fellow PD01/29,,HJ,,649,964664.05
1001,2/4/2021,2/4/2021,Abacus Bookkeeping,Bill.Com Import--,,HJ,,204.18,964459.87
1001,2/4/2021,2/4/2021,Lisis Alvarez,Bill.Com Import--,,HJ,,1440,963019.87
1001,2/4/2021,2/4/2021,Monivett Acevedo,Imported from reimbursements-Farewell gift for Grace,,HJ,,40.54,962979.33
1001,2/4/2021,2/4/2021,Monivett Acevedo,Imported from reimbursements-Farewell gift for Grace,,HJ,,65.85,962913.48
1001,2/4/2021,2/4/2021,Monivett Acevedo,Imported from reimbursements-Finance Planning,,HJ,,12.99,962900.49
1001,2/4/2021,2/4/2021,Monivett Acevedo,Imported from reimbursements-Sympathy gift for Gillian,,HJ,,36.93,962863.56
1001,2/4/2021,2/4/2021,Monivett Acevedo,Imported from reimbursements-Traveling Laptop,,HJ,,962.99,961900.57
1001,2/5/2021,2/5/2021,ADP,ADP Invoices-ADP invoices for Fellows for February,,HJ,,87.55,961813.02
1001,2/5/2021,2/5/2021,ADP,ADP Invoices-ADP invoices for Fellows for February,,HJ,,135.27,961677.75
1001,2/5/2021,2/5/2021,ADP,ADP Invoices-ADP invoices for Fellows for February,,HJ,,135.27,961542.48
1001,2/5/2021,2/5/2021,ADP,ADP Invoices-ADP invoices for Fellows for February,,HJ,,437.66,961104.82
1001,2/5/2021,2/5/2021,ADP,ADP Invoices-ADP invoices for Staff for February,,HJ,,5679.75,955425.07
1001,2/5/2021,2/5/2021,Comcast,January Comcast Payment-January Comcast Payment,,HJ,,139.55,955285.52
1001,2/5/2021,2/5/2021,DocuSign,Bill.Com Import--,,HJ,,5000,950285.52
1001,2/5/2021,2/5/2021,Julie Balfour,Bill.Com Import--,,HJ,,3333.33,946952.19
1001,2/5/2021,2/5/2021,Kira Graves,Settlement Agreement and general release between Kira Graces and X Co. -Settlement Agreement and general release between Kira Graces and X Co. ,,HJ,,1700,945252.19
1001,2/5/2021,2/5/2021,Woot Math Acquisiti,Received revenue from Woot Math-Received revenue from Woot Math,,HJ,965.25,,946217.44
1001,2/8/2021,2/8/2021,1st half order,HP Chromebooks Purchase-HP Chromebooks Purchase: 165 units on the 1st purchase,,HJ,,118388.03,827829.41
1001,2/8/2021,2/8/2021,1st half order,Reverseal of Chromebooks Temp Entry-HP Chromebooks Purchase,,HJ,118388.03,,946217.44
1001,2/8/2021,2/8/2021,CLARK,Received from CLARK-Received from CLARK,,HJ,500000,,1446217.44
1001,2/8/2021,2/8/2021,HRKnowledge,HRK ePostersService January 2021 PD01.28-HRK ePostersService January 2021 PD01.28,,HJ,,336,1445881.44
1001,2/9/2021,2/9/2021,Eversource,February Eversource Payment-February Eversource Payment,,HJ,,128.8,1445752.64
1001,2/9/2021,2/9/2021,HRKnowledge,HRKnowledge EEO.1 Reporting 2019.20 PD.0203-HRKnowledge EEO.1 Reporting 2019.20 PD.0203,,HJ,,3000,1442752.64
1001,2/9/2021,2/9/2021,HRKnowledge,HRKnowledge Virtual HR Partner Mar 2021 PD02.03-HRKnowledge Virtual HR Partner Mar 2021 PD02.03,,HJ,,2500,1440252.64
1001,2/9/2021,2/9/2021,Inspire Business Cen,Jackson Center February Rent parking Inspire Business Center-Jackson Center February Rent parking Inspire Business Center,,HJ,,975,1439277.64
1001,2/9/2021,2/9/2021,Verizon,Wifi services pay for fellows February-Wifi services pay for fellows February,,HJ,,49.58,1439228.06
1001,2/9/2021,2/9/2021,Verizon,Wifi services pay for fellows February-Wifi services pay for fellows February,,HJ,,76.64,1439151.42
1001,2/9/2021,2/9/2021,Verizon,Wifi services pay for fellows February-Wifi services pay for fellows February,,HJ,,76.64,1439074.78
1001,2/9/2021,2/9/2021,Verizon,Wifi services pay for fellows February-Wifi services pay for fellows February,,HJ,,247.94,1438826.84
1001,2/9/2021,2/9/2021,Verizon,Wifi services pay for fellows February-Wifi services pay for fellows February,,HJ,,569.47,1438257.37
1001,2/9/2021,2/9/2021,Verizon,Wifi services pay for fellows February-Wifi services pay for fellows February,,HJ,,880.11,1437377.26
1001,2/9/2021,2/9/2021,Verizon,Wifi services pay for fellows February-Wifi services pay for fellows February,,HJ,,880.11,1436497.15
1001,2/9/2021,2/9/2021,Verizon,Wifi services pay for fellows February-Wifi services pay for fellows February,,HJ,,2847.41,1433649.74
1001,2/10/2021,2/10/2021,InCorp Services Inc,Bill.Com Import--,,HJ,,99,1433550.74
1001,2/11/2021,2/11/2021,HRKnowledge,HRKnowledge ePoster Service PD01.20-HRKnowledge ePoster Service PD01.20,,HJ,,1000,1432550.74
1001,2/11/2021,2/11/2021,HRKnowledge,HRK ePosters Service February 2021-HRK ePosters Service February 2021,,HJ,,336,1432214.74
1001,2/11/2021,2/11/2021,JE-21-0160,Americorps Reimbursement for January-Americorps Reimbursement for January,,HJ,203784.24,,1635998.98
1001,2/11/2021,2/11/2021,Mighty Good Agency,Bill.Com Import--,,HJ,,13000,1622998.98
1001,2/11/2021,2/11/2021,Odalis Polanco,Imported from reimbursements-Home Office desk,,HJ,,213.99,1622784.99
1001,2/11/2021,2/11/2021,Odalis Polanco,Imported from reimbursements-Welcome Lunch with Manuel Pires,,HJ,,42.8,1622742.19
1001,2/11/2021,2/11/2021,Odalis Polanco,Imported from reimbursements-new laptop charger,,HJ,,33.95,1622708.24
1001,2/12/2021,2/12/2021,21221,82L-IMPORT PAYROLL-Import Payroll,,HJ,,2813.2,1619895.04
1001,2/12/2021,2/12/2021,21221,82L-IMPORT PAYROLL-Import Payroll,,HJ,,6692.25,1613202.79
1001,2/12/2021,2/12/2021,21221,82L-IMPORT PAYROLL-Import Payroll,,HJ,,15804.39,1597398.4
1001,2/12/2021,2/12/2021,21221,82L-IMPORT PAYROLL-Import Payroll,,HJ,,19118.46,1578279.94
1001,2/12/2021,2/12/2021,21221,82L-IMPORT PAYROLL-Import Payroll,,HJ,,50174.77,1528105.17
1001,2/12/2021,2/12/2021,21221,82L-IMPORT PAYROLL-Import Payroll,,HJ,,79435.56,1448669.61
1001,2/12/2021,2/12/2021,21221,82L-IMPORT PAYROLL-Import Payroll,,HJ,,85513.17,1363156.44
1001,2/12/2021,2/12/2021,21221,82L-IMPORT PAYROLL-Import Payroll,,HJ,,95505.35,1267651.09
1001,2/15/2021,2/15/2021,JE-21-0169,LUX PRPD- 021521-LUX-PRPD-02152021,,HJ,,276.39,1267374.7
1001,2/15/2021,2/15/2021,JE-21-0169,LUX PRPD- 021521-LUX-PRPD-02152021,,HJ,,5035.36,1262339.34
1001,2/15/2021,2/15/2021,JE-21-0169,LUX PRPD- 021521-LUX-PRPD-02152021,,HJ,,18257.35,1244081.99
1001,2/15/2021,2/15/2021,JE-21-0169,LUX PRPD- 021521-LUX-PRPD-02152021,,HJ,,99349.09,1144732.9
1001,2/16/2021,2/16/2021,Leslie Wade LLC,Bill.Com Import--,,HJ,,10400,1134332.9
1001,2/16/2021,2/16/2021,TAG Resources LLC,Employee 401K Payment PD 02.12-Employee 401K Payment PD 02.12,,HJ,,4075.9,1130257
1001,2/17/2021,2/17/2021,523596,Donation from The Benevity Community Impact Fund-Donation from The Benevity Community Impact Fund,,HJ,136.65,,1130393.65
1001,2/17/2021,2/17/2021,Feinberg Hanson,Bill.Com Import--,,HJ,,7839,1122554.65
1001,2/17/2021,2/17/2021,Littler Mendelson,Bill.Com Import--,,HJ,,178.5,1122376.15
1001,2/17/2021,2/17/2021,T-Mobile,February Phone Expenses for Fellows-February Phone Expenses for Fellows,,HJ,,61.78,1122314.37
1001,2/17/2021,2/17/2021,T-Mobile,February Phone Expenses for Fellows-February Phone Expenses for Fellows,,HJ,,95.47,1122218.9
1001,2/17/2021,2/17/2021,T-Mobile,February Phone Expenses for Fellows-February Phone Expenses for Fellows,,HJ,,95.47,1122123.43
1001,2/17/2021,2/17/2021,T-Mobile,February Phone Expenses for Fellows-February Phone Expenses for Fellows,,HJ,,308.88,1121814.55
1001,2/17/2021,2/17/2021,TASC,Payment for TASC for PD 2/15/21-Payment for TASC for PD 2/15/21,,HJ,,1929.83,1119884.72
1001,2/18/2021,2/18/2021,AAFCPAS,Bill.Com Import--,,HJ,,1875,1118009.72
1001,2/18/2021,2/18/2021,HRKnowledge,To Record HR Admin Fee for Fellow PD02/12-To Record HR Admin Fee for Fellow PD02/12,,HJ,,134.2,1117875.52
1001,2/18/2021,2/18/2021,HRKnowledge,To Record HR Admin Fee for Fellow PD02/12-To Record HR Admin Fee for Fellow PD02/12,,HJ,,207.4,1117668.12
1001,2/18/2021,2/18/2021,HRKnowledge,To Record HR Admin Fee for Fellow PD02/12-To Record HR Admin Fee for Fellow PD02/12,,HJ,,207.4,1117460.72
1001,2/18/2021,2/18/2021,HRKnowledge,To Record HR Admin Fee for Fellow PD02/12-To Record HR Admin Fee for Fellow PD02/12,,HJ,,671,1116789.72
1001,2/18/2021,2/18/2021,Leslie Wade LLC,Bill.Com Import--,,HJ,,10400,1106389.72
1001,2/18/2021,2/18/2021,Ohio Indemnity,Bill.Com Import--,,HJ,,24299.12,1082090.6
1001,2/18/2021,2/18/2021,Ohio Indemnity,Bill.Com Import--,,HJ,,35593.41,1046497.19
1001,2/18/2021,2/18/2021,Tiffany Cardona,Bill.Com Import--,,HJ,,1390.8,1045106.39
1001,2/19/2021,2/19/2021,Brandvia,Bill.Com Import--,,HJ,,197.61,1044908.78
1001,2/19/2021,2/19/2021,Brandvia,Bill.Com Import--,,HJ,,305.38,1044603.4
1001,2/19/2021,2/19/2021,Brandvia,Bill.Com Import--,,HJ,,305.38,1044298.02
1001,2/19/2021,2/19/2021,Brandvia,Bill.Com Import--,,HJ,,988,1043310.02
1001,2/19/2021,2/19/2021,HRKnowledge,To record HR Admin fee for staff PD 02/12-To record HR Admin fee for staff PD 02/12,,HJ,,1570,1041740.02
1001,2/19/2021,2/19/2021,VIGOROUS INT.,Bill.Com Import--,,HJ,,7061,1034679.02
1001,2/22/2021,2/22/2021,ACCURATE BIOMETRICS,Bill.Com Import--,,HJ,,120.5,1034558.52
1001,2/22/2021,2/22/2021,ADP,ADP tax filling invoices for Staff for February-ADP tax filling invoices for Staff for February,,HJ,,964.48,1033594.04
1001,2/22/2021,2/22/2021,Grubhub,Bill.Com Import--,,HJ,,21.2,1033572.84
1001,2/22/2021,2/22/2021,Grubhub,Bill.Com Import--,,HJ,,105.52,1033467.32
1001,2/22/2021,2/22/2021,Grubhub,Bill.Com Import--,,HJ,,126.52,1033340.8
1001,2/22/2021,2/22/2021,Grubhub,Bill.Com Import--,,HJ,,151.72,1033189.08
1001,2/22/2021,2/22/2021,Grubhub,Bill.Com Import--,,HJ,,186.24,1033002.84
1001,2/22/2021,2/22/2021,Grubhub,Bill.Com Import--,,HJ,,282.29,1032720.55
1001,2/22/2021,2/22/2021,Grubhub,Bill.Com Import--,,HJ,,332.73,1032387.82
1001,2/22/2021,2/22/2021,IL Secretary of Stat,X Co.  IL Secretary of State Filing Fee-X Co.  IL Secretary of State Filing Fee,,HJ,,10,1032377.82
1001,2/22/2021,2/22/2021,Media Cause,Bill.Com Import--,,HJ,,16739,1015638.82
1001,2/23/2021,2/23/2021,Confianza,Bill.Com Import--,,HJ,,2500,1013138.82
1001,2/23/2021,2/23/2021,Providence PSD,received from Providencce Rhode island-received from Providence Rhode island,,HJ,18000,,1031138.82
1001,2/23/2021,2/23/2021,Tiffany Cardona,Bill.Com Import--,,HJ,,3844.8,1027294.02
1001,2/23/2021,2/23/2021,Walnut Street Realty,Bill.Com Import--,,HJ,,2192.58,1025101.44
1001,2/24/2021,2/24/2021,ADP,ADP Invoices-ADP tax filing invoices for Staff for February,,HJ,,2045.09,1023056.35
1001,2/24/2021,2/24/2021,ADP,ADP Invoices-ADP tax filing invoices for fellows for February,,HJ,,11.44,1023044.91
1001,2/24/2021,2/24/2021,ADP,ADP Invoices-ADP tax filing invoices for fellows for February,,HJ,,17.68,1023027.23
1001,2/24/2021,2/24/2021,ADP,ADP Invoices-ADP tax filing invoices for fellows for February,,HJ,,17.68,1023009.55
1001,2/24/2021,2/24/2021,ADP,ADP Invoices-ADP tax filing invoices for fellows for February,,HJ,,57.21,1022952.34
1001,2/24/2021,2/24/2021,Apollon & Partners,Bill.Com Import--,,HJ,,7000,1015952.34
1001,2/25/2021,2/25/2021,ADP,ADP invoices for staff and fellows for February-ADP invoices for fellows for February 2021,,HJ,,232.69,1015719.65
1001,2/25/2021,2/25/2021,ADP,ADP invoices for staff and fellows for February-ADP invoices for fellows for February 2021,,HJ,,359.64,1015360.01
1001,2/25/2021,2/25/2021,ADP,ADP invoices for staff and fellows for February-ADP invoices for fellows for February 2021,,HJ,,359.64,1015000.37
1001,2/25/2021,2/25/2021,ADP,ADP invoices for staff and fellows for February-ADP invoices for fellows for February 2021,,HJ,,1163.53,1013836.84
1001,2/25/2021,2/25/2021,ADP,ADP invoices for staff and fellows for February-ADP invoices for staff for February,,HJ,,1835.8,1012001.04
1001,2/25/2021,2/25/2021,MA Attorney General,Filing for the MA Form PC for FY20-Filing for the MA Form PC for FY20,,HJ,,1000,1011001.04
1001,2/26/2021,2/26/2021,22621,82L-IMPORT PAYROLL-Import Payroll,,HJ,,2791.46,1008209.58
1001,2/26/2021,2/26/2021,22621,82L-IMPORT PAYROLL-Import Payroll,,HJ,,6588.36,1001621.22
1001,2/26/2021,2/26/2021,22621,82L-IMPORT PAYROLL-Import Payroll,,HJ,,15203.64,986417.58
1001,2/26/2021,2/26/2021,22621,82L-IMPORT PAYROLL-Import Payroll,,HJ,,18021.46,968396.12
1001,2/26/2021,2/26/2021,22621,82L-IMPORT PAYROLL-Import Payroll,,HJ,,48248,920148.12
1001,2/26/2021,2/26/2021,22621,82L-IMPORT PAYROLL-Import Payroll,,HJ,,80366.1,839782.02
1001,2/26/2021,2/26/2021,22621,82L-IMPORT PAYROLL-Import Payroll,,HJ,,84282.21,755499.81
1001,2/26/2021,2/26/2021,22621,82L-IMPORT PAYROLL-Import Payroll,,HJ,,96549.61,658950.2
1001,2/28/2021,2/28/2021,JE-21-0175,LUX PRPD -02282021-LUX-PRPD-022821,,HJ,,279.1,658671.1
1001,2/28/2021,2/28/2021,JE-21-0175,LUX PRPD -02282021-LUX-PRPD-022821,,HJ,,5201.59,653469.51
1001,2/28/2021,2/28/2021,JE-21-0175,LUX PRPD -02282021-LUX-PRPD-022821,,HJ,,18257.35,635212.16
1001,2/28/2021,2/28/2021,JE-21-0175,LUX PRPD -02282021-LUX-PRPD-022821,,HJ,,100024.98,535187.18
1001,3/1/2021,3/1/2021,"TAG Resources, LLC",Employee 401K Payment PD02.25,,HJ,,7327.92,527859.26
1001,3/1/2021,3/1/2021,Woot Math Acquisiti,Received revenue from Woot Math,,HJ,752.5,,528611.76
1001,3/2/2021,3/2/2021,20210302,Transfer from #8984 to checking #6488 account,,HJ,469000,,997611.76
1001,3/2/2021,3/2/2021,ACCURATE BIOMETRICS,Bill.Com Import,,HJ,,180.75,997431.01
1001,3/2/2021,3/2/2021,Bank of America VISA,BofA Concur Payment,,HJ,,1439.63,995991.38
1001,3/2/2021,3/2/2021,Bank of America VISA,BofA Concur Payment,,HJ,,6357.58,989633.8
1001,3/2/2021,3/2/2021,Bank of America VISA,BofA Concur Payment,,HJ,,9497.08,980136.72
1001,3/2/2021,3/2/2021,Bank of America VISA,BofA Concur Payment,,HJ,,11176.52,968960.2
1001,3/2/2021,3/2/2021,Bank of America VISA,BofA Concur Payment,,HJ,,19297.52,949662.68
1001,3/2/2021,3/2/2021,Bank of America VISA,BofA Concur Payment,,HJ,,25040.89,924621.79
1001,3/2/2021,3/2/2021,Bank of America VISA,BofA Concur Payment,,HJ,,63157.97,861463.82
1001,3/2/2021,3/2/2021,Brandvia,Bill.Com Import,,HJ,,618.03,860845.79
1001,3/2/2021,3/2/2021,Brandvia,Bill.Com Import,,HJ,,618.04,860227.75
1001,3/2/2021,3/2/2021,Grubhub,Bill.Com Import,,HJ,,215.81,860011.94
1001,3/2/2021,3/2/2021,HRKnowledge,HR Outsourcing Admin fee for Staff and Fellows PD02/26,,HJ,,132,859879.94
1001,3/2/2021,3/2/2021,HRKnowledge,HR Outsourcing Admin fee for Staff and Fellows PD02/26,,HJ,,204,859675.94
1001,3/2/2021,3/2/2021,HRKnowledge,HR Outsourcing Admin fee for Staff and Fellows PD02/26,,HJ,,204,859471.94
1001,3/2/2021,3/2/2021,HRKnowledge,HR Outsourcing Admin fee for Staff and Fellows PD02/26,,HJ,,660,858811.94
1001,3/2/2021,3/2/2021,HRKnowledge,HR Outsourcing Admin fee for Staff and Fellows PD02/26,,HJ,,4410,854401.94
1001,3/2/2021,3/2/2021,TASC,Bill.Com Import,,HJ,,1174.59,853227.35
1001,3/2/2021,3/2/2021,TASC,Bill.Com Import,,HJ,,1174.59,852052.76
1001,3/3/2021,3/3/2021,BCBS,March 2021 BCBS payment,,HJ,,47.83,852004.93
1001,3/3/2021,3/3/2021,BCBS,March 2021 BCBS payment,,HJ,,667.84,851337.09
1001,3/3/2021,3/3/2021,BCBS,March 2021 BCBS payment,,HJ,,855.24,850481.85
1001,3/3/2021,3/3/2021,BCBS,March 2021 BCBS payment,,HJ,,1159.82,849322.03
1001,3/3/2021,3/3/2021,BCBS,March 2021 BCBS payment,,HJ,,1752.61,847569.42
1001,3/3/2021,3/3/2021,BCBS,March 2021 BCBS payment,,HJ,,2324.24,845245.18
1001,3/3/2021,3/3/2021,BCBS,March 2021 BCBS payment,,HJ,,6028.84,839216.34
1001,3/3/2021,3/3/2021,BCBS,March 2021 BCBS payment,,HJ,,6326.01,832890.33
1001,3/3/2021,3/3/2021,BCBS,March 2021 BCBS payment,,HJ,,7608.99,825281.34
1001,3/3/2021,3/3/2021,BCBS,March 2021 BCBS payment,,HJ,,8545.47,816735.87
1001,3/3/2021,3/3/2021,BCBS,March 2021 BCBS payment,,HJ,,8911.07,807824.8
1001,3/3/2021,3/3/2021,BCBS,March 2021 BCBS payment,,HJ,,11606.65,796218.15
1001,3/3/2021,3/3/2021,BCBS,March 2021 BCBS payment,,HJ,,17257.15,778961
1001,3/3/2021,3/3/2021,JE-21-0185,Blue 20/20 Vision Insurance - February 82L,,HJ,,7.11,778953.89
1001,3/3/2021,3/3/2021,JE-21-0185,Blue 20/20 Vision Insurance - February 82L,,HJ,,21.33,778932.56
1001,3/3/2021,3/3/2021,JE-21-0185,Blue 20/20 Vision Insurance - February 82L,,HJ,,41.95,778890.61
1001,3/3/2021,3/3/2021,JE-21-0185,Blue 20/20 Vision Insurance - February 82L,,HJ,,49.35,778841.26
1001,3/3/2021,3/3/2021,JE-21-0185,Blue 20/20 Vision Insurance - February 82L,,HJ,,49.77,778791.49
1001,3/3/2021,3/3/2021,JE-21-0185,Blue 20/20 Vision Insurance - February 82L,,HJ,,55.62,778735.87
1001,3/3/2021,3/3/2021,JE-21-0185,Blue 20/20 Vision Insurance - February 82L,,HJ,55.62,,778791.49
1001,3/3/2021,3/3/2021,JE-21-0185,Blue 20/20 Vision Insurance - February 82L,,HJ,,71.1,778720.39
1001,3/3/2021,3/3/2021,JE-21-0185,Blue 20/20 Vision Insurance - February 82L,,HJ,,113.21,778607.18
1001,3/3/2021,3/3/2021,JE-21-0185,Blue 20/20 Vision Insurance - February 82L,D109,HJ,0.42,,778607.6
1001,3/3/2021,3/3/2021,JE-21-0186,Blue 20/20 Vision Ins - March Payment LUX,,HJ,,7.11,778600.49
1001,3/3/2021,3/3/2021,JE-21-0186,Blue 20/20 Vision Ins - March Payment LUX,,HJ,,21.33,778579.16
1001,3/3/2021,3/3/2021,JE-21-0186,Blue 20/20 Vision Ins - March Payment LUX,,HJ,,191.97,778387.19
1001,3/3/2021,3/3/2021,Mathspace,Bill.Com Import,,HJ,,4500,773887.19
1001,3/5/2021,3/5/2021,Comcast,March Comcast Payment,,HJ,,139.55,773747.64
1001,3/5/2021,3/5/2021,Enabler Design,Bill.Com Import,,HJ,,195,773552.64
1001,3/5/2021,3/5/2021,Julie Balfour,Bill.Com Import,,HJ,,3333.34,770219.3
1001,3/9/2021,3/9/2021,20210126,Reimbursement for TASC 01.26.2021,,HJ,3162.35,,773381.65
1001,3/9/2021,3/9/2021,Inspire Business Cen,"Jackson Center March Rent, parking, Inspire Business Center",,HJ,,975,772406.65
1001,3/9/2021,3/9/2021,TASC,Payment for TASC in March 2021,,HJ,,22.5,772384.15
1001,3/9/2021,3/9/2021,TASC,Payment for TASC in March 2021,,HJ,,3876.93,768507.22
1001,3/9/2021,3/9/2021,Verizon,Wifi services pay for Fellows March,,HJ,,49.58,768457.64
1001,3/9/2021,3/9/2021,Verizon,Wifi services pay for Fellows March,,HJ,,76.64,768381
1001,3/9/2021,3/9/2021,Verizon,Wifi services pay for Fellows March,,HJ,,76.64,768304.36
1001,3/9/2021,3/9/2021,Verizon,Wifi services pay for Fellows March,,HJ,,247.94,768056.42
1001,3/9/2021,3/9/2021,Verizon,Wifi services pay for Fellows March,,HJ,,663.47,767392.95
1001,3/9/2021,3/9/2021,Verizon,Wifi services pay for Fellows March,,HJ,,1025.38,766367.57
1001,3/9/2021,3/9/2021,Verizon,Wifi services pay for Fellows March,,HJ,,1025.38,765342.19
1001,3/9/2021,3/9/2021,Verizon,Wifi services pay for Fellows March,,HJ,,3317.4,762024.79
1001,3/10/2021,3/10/2021,Eversource,March Eversource Payment,,HJ,,116.49,761908.3
1001,3/12/2021,3/12/2021,ADP,ADP invoices for fellows for due date 3.12.21,,HJ,,49.87,761858.43
1001,3/12/2021,3/12/2021,ADP,ADP invoices for fellows for due date 3.12.21,,HJ,,77.1,761781.33
1001,3/12/2021,3/12/2021,ADP,ADP invoices for fellows for due date 3.12.21,,HJ,,77.1,761704.23
1001,3/12/2021,3/12/2021,ADP,ADP invoices for fellows for due date 3.12.21,,HJ,,249.43,761454.8
1001,3/12/2021,3/12/2021,ADP,ADP Payroll fees,,HJ,,4536.19,756918.61
1001,3/12/2021,3/12/2021,JE-21-0187,LUX Payroll -PRPD 031521,,HJ,,275.35,756643.26
1001,3/12/2021,3/12/2021,JE-21-0187,LUX Payroll -PRPD 031521,,HJ,,4938.92,751704.34
1001,3/12/2021,3/12/2021,JE-21-0187,LUX Payroll -PRPD 031521,,HJ,,18257.35,733446.99
1001,3/12/2021,3/12/2021,JE-21-0187,LUX Payroll -PRPD 031521,,HJ,,98686.53,634760.46
1001,3/13/2021,3/13/2021,ADP,Payroll processing fee,,HJ,,27.05,634733.41
1001,3/13/2021,3/13/2021,ADP,Payroll processing fee,,HJ,,41.8,634691.61
1001,3/13/2021,3/13/2021,ADP,Payroll processing fee,,HJ,,41.8,634649.81
1001,3/13/2021,3/13/2021,ADP,Payroll processing fee,,HJ,,135.25,634514.56
1001,3/13/2021,3/13/2021,ADP,Payroll processing fee,,HJ,,856.1,633658.46
1001,3/15/2021,3/15/2021,31521,82L-IMPORT PAYROLL,,HJ,,2749.35,630909.11
1001,3/15/2021,3/15/2021,31521,82L-IMPORT PAYROLL,,HJ,,6588.36,624320.75
1001,3/15/2021,3/15/2021,31521,82L-IMPORT PAYROLL,,HJ,,15044.48,609276.27
1001,3/15/2021,3/15/2021,31521,82L-IMPORT PAYROLL,,HJ,,17976.52,591299.75
1001,3/15/2021,3/15/2021,31521,82L-IMPORT PAYROLL,,HJ,,48364.25,542935.5
1001,3/15/2021,3/15/2021,31521,82L-IMPORT PAYROLL,,HJ,,84627.81,458307.69
1001,3/15/2021,3/15/2021,31521,82L-IMPORT PAYROLL,,HJ,,84829.93,373477.76
1001,3/15/2021,3/15/2021,31521,82L-IMPORT PAYROLL,,HJ,,98007.84,275469.92
1001,3/15/2021,3/15/2021,20210315,Transfer from #8984 to checking #6488 account,,HJ,322000,,597469.92
1001,3/15/2021,3/15/2021,"TAG Resources, LLC",Employee 401K Payment PD03.12,,HJ,,7424.44,590045.48
1001,3/16/2021,3/16/2021,27861,Americorp Reimbursement for February,,HJ,204978.73,,795024.21
1001,3/16/2021,3/16/2021,HRKnowledge,HRKnowledge Virtual HR Partner PD03.09,,HJ,,2500,792524.21
1001,3/16/2021,3/16/2021,TASC,Payment for TASC in March 2021,,HJ,,2694.81,789829.4
1001,3/17/2021,3/17/2021,Feinberg Hanson,Bill.Com Import,,HJ,,4026,785803.4
1001,3/17/2021,3/17/2021,Hutchinson Black,Bill.Com Import,,HJ,,289,785514.4
1001,3/17/2021,3/17/2021,Leslie Wade LLC,Bill.Com Import,,HJ,,10400,775114.4
1001,3/17/2021,3/17/2021,T-Mobile,March Phone Expenses for Fellows,,HJ,,61.78,775052.62
1001,3/17/2021,3/17/2021,T-Mobile,March Phone Expenses for Fellows,,HJ,,95.47,774957.15
1001,3/17/2021,3/17/2021,T-Mobile,March Phone Expenses for Fellows,,HJ,,95.47,774861.68
1001,3/17/2021,3/17/2021,T-Mobile,March Phone Expenses for Fellows,,HJ,,308.88,774552.8
1001,3/18/2021,3/18/2021,ADP,ADP tax filing invoices or Staff in March,,HJ,,196.26,774356.54
1001,3/18/2021,3/18/2021,HRKnowledge,HR Outsourcing Admin fee for Staff and Fellows PD03/15,,HJ,,129.8,774226.74
1001,3/18/2021,3/18/2021,HRKnowledge,HR Outsourcing Admin fee for Staff and Fellows PD03/15,,HJ,,200.6,774026.14
1001,3/18/2021,3/18/2021,HRKnowledge,HR Outsourcing Admin fee for Staff and Fellows PD03/15,,HJ,,200.6,773825.54
1001,3/18/2021,3/18/2021,HRKnowledge,HR Outsourcing Admin fee for Staff and Fellows PD03/15,,HJ,,649,773176.54
1001,3/18/2021,3/18/2021,HRKnowledge,HR Outsourcing Admin fee for Staff and Fellows PD03/15,,HJ,,1600,771576.54
1001,3/18/2021,3/18/2021,Wipfli LLP,Bill.Com Import,,HJ,,6000,765576.54
1001,3/19/2021,3/19/2021,Brandvia,Bill.Com Import,,HJ,,1932.46,763644.08
1001,3/19/2021,3/19/2021,Sage Intacct,Bill.Com Import,,HJ,,39718.1,723925.98
1001,3/19/2021,3/19/2021,Whiteboard,Bill.Com Import,,HJ,,17500,706425.98
1001,3/22/2021,3/22/2021,Fullerton School Dis,Receipt from Fullerton,,HJ,353.7,,706779.68
1001,3/22/2021,3/22/2021,Grubhub,Bill.Com Import,,HJ,,42.4,706737.28
1001,3/22/2021,3/22/2021,Grubhub,Bill.Com Import,,HJ,,47.7,706689.58
1001,3/22/2021,3/22/2021,Grubhub,Bill.Com Import,,HJ,,95.09,706594.49
1001,3/22/2021,3/22/2021,Grubhub,Bill.Com Import,,HJ,,147.3,706447.19
1001,3/22/2021,3/22/2021,Grubhub,Bill.Com Import,,HJ,,200.46,706246.73
1001,3/22/2021,3/22/2021,Grubhub,Bill.Com Import,,HJ,,708.08,705538.65
1001,3/22/2021,3/22/2021,Media Cause,Bill.Com Import,,HJ,,14457,691081.65
1001,3/22/2021,3/22/2021,Woot Math Acquisiti,Receipt from Pennsylvania Dept of Education,,HJ,58.95,,691140.6
1001,3/22/2021,3/22/2021,Woot Math Acquisiti,Receipt from Pennsylvania Dept of Education,,HJ,517.05,,691657.65
1001,3/24/2021,3/24/2021,20210324,Transfer from #8984 to checking #6488 account,,HJ,500000,,1191657.65
1001,3/24/2021,3/24/2021,Abila,Bill.Com Import,,HJ,,110,1191547.65
1001,3/24/2021,3/24/2021,Abila,Bill.Com Import,,HJ,,250,1191297.65
1001,3/24/2021,3/24/2021,Appcast Inc.,Bill.Com Import,,HJ,,1088,1190209.65
1001,3/24/2021,3/24/2021,Emptech,Bill.Com Import,,HJ,,333,1189876.65
1001,3/24/2021,3/24/2021,HP Inc.,Bill.Com Import,,HJ,,18609.88,1171266.77
1001,3/24/2021,3/24/2021,The Hanover Ins,Bill.Com Import,,HJ,,5864.25,1165402.52
1001,3/24/2021,3/24/2021,Walnut Street Realty,Bill.Com Import,,HJ,,2192.58,1163209.94
1001,3/31/2021,3/31/2021,33121,82L-IMPORT PAYROLL,,HJ,,2749.35,1160460.59
1001,3/31/2021,3/31/2021,33121,82L-IMPORT PAYROLL,,HJ,,6588.33,1153872.26
1001,3/31/2021,3/31/2021,33121,82L-IMPORT PAYROLL,,HJ,,13320.82,1140551.44
1001,3/31/2021,3/31/2021,33121,82L-IMPORT PAYROLL,,HJ,,18492.35,1122059.09
1001,3/31/2021,3/31/2021,33121,82L-IMPORT PAYROLL,,HJ,,48819.47,1073239.62
1001,3/31/2021,3/31/2021,33121,82L-IMPORT PAYROLL,,HJ,,91587.09,981652.53
1001,3/31/2021,3/31/2021,33121,82L-IMPORT PAYROLL,,HJ,,102329.82,879322.71
1001,3/31/2021,3/31/2021,33121,82L-IMPORT PAYROLL,,HJ,,109075.07,770247.64
1001,3/31/2021,3/31/2021,3312021,($56.46) To Reconcile the month of March,,HJ,,56.46,770191.18
1001,3/31/2021,3/31/2021,Abacus Bookkeeping,Bill.Com Import,,HJ,,37.5,770153.68
1001,3/31/2021,3/31/2021,ESI Group,Bill.Com Import,,HJ,,8225.7,761927.98
1001,3/31/2021,3/31/2021,JE-21-0188,LUX Payroll- PRPD 03312021,,HJ,,272.51,761655.47
1001,3/31/2021,3/31/2021,JE-21-0188,LUX Payroll- PRPD 03312021,,HJ,,5035.53,756619.94
1001,3/31/2021,3/31/2021,JE-21-0188,LUX Payroll- PRPD 03312021,,HJ,,17578.68,739041.26
1001,3/31/2021,3/31/2021,JE-21-0188,LUX Payroll- PRPD 03312021,,HJ,,98686.53,640354.73
1001,4/1/2021,4/1/2021,Grubhub,Bill.Com Import,,HJ,,807.46,639547.27
1001,4/1/2021,4/1/2021,"TAG Resources, LLC",Employee 401K Payment PD03.31,,HJ,,7735,631812.27
1001,4/1/2021,4/1/2021,TASC,Payment for TASC for PD03.31.2021,,HJ,,2157.23,629655.04
1001,4/1/2021,4/1/2021,Transamerica,Bill.Com Import,,HJ,,135,629520.04
1001,4/1/2021,4/1/2021,"Twilio, Inc.",Bill.Com Import,,HJ,,3174.09,626345.95
1001,4/1/2021,4/1/2021,"Twilio, Inc.",Bill.Com Import,,HJ,,3192.49,623153.46
1001,4/2/2021,4/2/2021,BCBS,April 2021 BCBS Payment,,HJ,,47.83,623105.63
1001,4/2/2021,4/2/2021,BCBS,April 2021 BCBS Payment,,HJ,,657.56,622448.07
1001,4/2/2021,4/2/2021,BCBS,April 2021 BCBS Payment,,HJ,,855.24,621592.83
1001,4/2/2021,4/2/2021,BCBS,April 2021 BCBS Payment,,HJ,,1016.06,620576.77
1001,4/2/2021,4/2/2021,BCBS,April 2021 BCBS Payment,,HJ,,1068.13,619508.64
1001,4/2/2021,4/2/2021,BCBS,April 2021 BCBS Payment,,HJ,,1215.54,618293.1
1001,4/2/2021,4/2/2021,BCBS,April 2021 BCBS Payment,,HJ,,1752.61,616540.49
1001,4/2/2021,4/2/2021,BCBS,April 2021 BCBS Payment,,HJ,,7061.29,609479.2
1001,4/2/2021,4/2/2021,BCBS,April 2021 BCBS Payment,,HJ,,7234.03,602245.17
1001,4/2/2021,4/2/2021,BCBS,April 2021 BCBS Payment,,HJ,,8545.47,593699.7
1001,4/2/2021,4/2/2021,BCBS,April 2021 BCBS Payment,,HJ,,10067.4,583632.3
1001,4/2/2021,4/2/2021,BCBS,April 2021 BCBS Payment,,HJ,,18348.19,565284.11
1001,4/2/2021,4/2/2021,BCBS,April 2021 BCBS Payment,,HJ,,24783.69,540500.42
1001,4/2/2021,4/2/2021,HRKnowledge,HR Outsourcing Admin fee for Staff and Fellows PD03.31,,HJ,,129.8,540370.62
1001,4/2/2021,4/2/2021,HRKnowledge,HR Outsourcing Admin fee for Staff and Fellows PD03.31,,HJ,,200.6,540170.02
1001,4/2/2021,4/2/2021,HRKnowledge,HR Outsourcing Admin fee for Staff and Fellows PD03.31,,HJ,,200.6,539969.42
1001,4/2/2021,4/2/2021,HRKnowledge,HR Outsourcing Admin fee for Staff and Fellows PD03.31,,HJ,,649,539320.42
1001,4/2/2021,4/2/2021,HRKnowledge,HR Outsourcing Admin fee for Staff and Fellows PD03.31,,HJ,,1960,537360.42
1001,4/2/2021,4/2/2021,JE-21-0202,Blue 20/20 Vision Ins - April Inv LUX,,HJ,,7.11,537353.31
1001,4/2/2021,4/2/2021,JE-21-0202,Blue 20/20 Vision Ins - April Inv LUX,,HJ,,21.33,537331.98
1001,4/2/2021,4/2/2021,JE-21-0202,Blue 20/20 Vision Ins - April Inv LUX,,HJ,,270.18,537061.8
1001,4/2/2021,4/2/2021,JE-21-0203,Blue 20/20 April Inv Payment 82L,,HJ,21.33,,537083.13
1001,4/2/2021,4/2/2021,JE-21-0203,Blue 20/20 April Inv Payment 82L,,HJ,,56.46,537026.67
1001,4/2/2021,4/2/2021,JE-21-0203,Blue 20/20 April Inv Payment 82L,,HJ,,71.1,536955.57
1001,4/2/2021,4/2/2021,JE-21-0203,Blue 20/20 April Inv Payment 82L,,HJ,,156,536799.57
1001,4/2/2021,4/2/2021,JE-21-0203,Blue 20/20 April Inv Payment 82L,,HJ,,170.64,536628.93
1001,4/2/2021,4/2/2021,JE-21-0203,Blue 20/20 April Inv Payment 82L,,HJ,,195.72,536433.21
1001,4/2/2021,4/2/2021,JE-21-0203,Blue 20/20 April Inv Payment 82L,,HJ,,205.48,536227.73
1001,4/2/2021,4/2/2021,JE-21-0203,Blue 20/20 April Inv Payment 82L,,HJ,,440.4,535787.33
1001,4/2/2021,4/2/2021,JE-21-0203,Blue 20/20 April Inv Payment 82L,,HJ,,719.34,535067.99
1001,4/5/2021,4/5/2021,20210405,82L Special Check Payroll,,HJ,2785.96,,537853.95
1001,4/5/2021,4/5/2021,ADP,ADP state UI filings and penalties April 2021,,HJ,,29.17,537824.78
1001,4/5/2021,4/5/2021,Bank of America VISA,BofA Concur Payment,,HJ,,405.04,537419.74
1001,4/5/2021,4/5/2021,Bank of America VISA,BofA Concur Payment,,HJ,,1570.32,535849.42
1001,4/5/2021,4/5/2021,Bank of America VISA,BofA Concur Payment,,HJ,,2058.86,533790.56
1001,4/5/2021,4/5/2021,Bank of America VISA,BofA Concur Payment,,HJ,,3292.13,530498.43
1001,4/5/2021,4/5/2021,Bank of America VISA,BofA Concur Payment,,HJ,,3561.09,526937.34
1001,4/5/2021,4/5/2021,Bank of America VISA,BofA Concur Payment,,HJ,,4007.11,522930.23
1001,4/5/2021,4/5/2021,Bank of America VISA,BofA Concur Payment,,HJ,,13957.63,508972.6
1001,4/5/2021,4/5/2021,Bank of America VISA,BofA Concur Payment,,HJ,,13963.61,495008.99
1001,4/5/2021,4/5/2021,Bank of America VISA,BofA Concur Payment,,HJ,,19201.3,475807.69
1001,4/5/2021,4/5/2021,Comcast,April Comcast Payment,,HJ,,139.55,475668.14
1001,4/5/2021,4/5/2021,Wipfli LLP,Bill.Com Import,,HJ,,13999,461669.14
1001,4/7/2021,4/7/2021,ADP,ADP state UI filings and penalties April 2021,,HJ,,1162.19,460506.95
1001,4/7/2021,4/7/2021,Eversource,March Eversource Bill,,HJ,,38.33,460468.62
1001,4/7/2021,4/7/2021,Julie Balfour,Bill.Com Import,,HJ,,3333.33,457135.29
1001,4/7/2021,4/7/2021,Karl W. Reid,Bill.Com Import,,HJ,,330,456805.29
1001,4/7/2021,4/7/2021,Verizon,Wifi services pay for fellows April Payment,,HJ,,49.58,456755.71
1001,4/7/2021,4/7/2021,Verizon,Wifi services pay for fellows April Payment,,HJ,,76.64,456679.07
1001,4/7/2021,4/7/2021,Verizon,Wifi services pay for fellows April Payment,,HJ,,76.64,456602.43
1001,4/7/2021,4/7/2021,Verizon,Wifi services pay for fellows April Payment,,HJ,,247.94,456354.49
1001,4/7/2021,4/7/2021,Verizon,Wifi services pay for fellows April Payment,,HJ,,680.4,455674.09
1001,4/7/2021,4/7/2021,Verizon,Wifi services pay for fellows April Payment,,HJ,,1051.54,454622.55
1001,4/7/2021,4/7/2021,Verizon,Wifi services pay for fellows April Payment,,HJ,,1051.54,453571.01
1001,4/7/2021,4/7/2021,Verizon,Wifi services pay for fellows April Payment,,HJ,,3402.04,450168.97
1001,4/7/2021,4/7/2021,Whiteboard,Bill.Com Import,,HJ,,7500,442668.97
1001,4/9/2021,4/9/2021,ADP,ADP Invoice April 2021,,HJ,,74.96,442594.01
1001,4/9/2021,4/9/2021,ADP,ADP Invoice April 2021,,HJ,,115.86,442478.15
1001,4/9/2021,4/9/2021,ADP,ADP Invoice April 2021,,HJ,,115.86,442362.29
1001,4/9/2021,4/9/2021,ADP,ADP Invoice April 2021,,HJ,,374.82,441987.47
1001,4/9/2021,4/9/2021,ADP,ADP Invoice April 2021,,HJ,,5548.5,436438.97
1001,4/9/2021,4/9/2021,Inspire Business Cen,"Jackson Center April Rent, Parking, Inspire Business Center",,HJ,,975.2,435463.77
1001,4/12/2021,4/12/2021,20210412,Transfer from #8984 to Checking #6488 account,,HJ,623000,,1058463.77
1001,4/12/2021,4/12/2021,ADP,ADP state UI filings and penalties April 2021,,HJ,,30.71,1058433.06
1001,4/12/2021,4/12/2021,ADP,ADP state UI filings and penalties April 2021,,HJ,,45.04,1058388.02
1001,4/12/2021,4/12/2021,ADP,ADP state UI filings and penalties April 2021,,HJ,,69.62,1058318.4
1001,4/12/2021,4/12/2021,ADP,ADP state UI filings and penalties April 2021,,HJ,,69.62,1058248.78
1001,4/12/2021,4/12/2021,ADP,ADP state UI filings and penalties April 2021,,HJ,,225.24,1058023.54
1001,4/12/2021,4/12/2021,ADP,ADP state UI filings and penalties April 2021,,HJ,,1396.31,1056627.23
1001,4/13/2021,4/13/2021,Emptech,Bill.Com Import,,HJ,,593.38,1056033.85
1001,4/13/2021,4/13/2021,Franklin Covey,Bill.Com Import,,HJ,,22473,1033560.85
1001,4/13/2021,4/13/2021,Maryellen Leneghan,Imported from reimbursements,,HJ,,129.98,1033430.87
1001,4/15/2021,4/15/2021,41521,82L-IMPORT PAYROLL,,HJ,,338.06,1033092.81
1001,4/15/2021,4/15/2021,41521,82L-IMPORT PAYROLL,,HJ,,2749.35,1030343.46
1001,4/15/2021,4/15/2021,41521,82L-IMPORT PAYROLL,,HJ,,6588.36,1023755.1
1001,4/15/2021,4/15/2021,41521,82L-IMPORT PAYROLL,,HJ,,13413.46,1010341.64
1001,4/15/2021,4/15/2021,41521,82L-IMPORT PAYROLL,,HJ,,18484.27,991857.37
1001,4/15/2021,4/15/2021,41521,82L-IMPORT PAYROLL,,HJ,,48717.04,943140.33
1001,4/15/2021,4/15/2021,41521,82L-IMPORT PAYROLL,,HJ,,83428.39,859711.94
1001,4/15/2021,4/15/2021,41521,82L-IMPORT PAYROLL,,HJ,,85712.96,773998.98
1001,4/15/2021,4/15/2021,41521,82L-IMPORT PAYROLL,,HJ,,103711.78,670287.2
1001,4/15/2021,4/15/2021,ADP,ADP state UI filings and penalties April 2021,,HJ,,8.5,670278.7
1001,4/15/2021,4/15/2021,CD-21-0241,Americorps reimbursement for March,,HJ,202871.76,,873150.46
1001,4/15/2021,4/15/2021,HRKnowledge,HRK Outsourcing Fee,,HJ,,1580,871570.46
1001,4/15/2021,4/15/2021,HRKnowledge,HRK Outsourcing Fee Fellows,,HJ,,128.7,871441.76
1001,4/15/2021,4/15/2021,HRKnowledge,HRK Outsourcing Fee Fellows,,HJ,,198.9,871242.86
1001,4/15/2021,4/15/2021,HRKnowledge,HRK Outsourcing Fee Fellows,,HJ,,198.9,871043.96
1001,4/15/2021,4/15/2021,HRKnowledge,HRK Outsourcing Fee Fellows,,HJ,,643.5,870400.46
1001,4/15/2021,4/15/2021,JE-21-0200,LUX PRPD -041521,,HJ,,268.15,870132.31
1001,4/15/2021,4/15/2021,JE-21-0200,LUX PRPD -041521,,HJ,,4774.96,865357.35
1001,4/15/2021,4/15/2021,JE-21-0200,LUX PRPD -041521,,HJ,,17174.65,848182.7
1001,4/15/2021,4/15/2021,JE-21-0200,LUX PRPD -041521,,HJ,,98506.07,749676.63
1001,4/15/2021,4/15/2021,JE-21-0200,LUX PR 20210415 REV &CORR,,HJ,225.86,,749902.49
1001,4/15/2021,4/15/2021,JE-21-0200,LUX PR 20210415 REV &CORR,,HJ,,268.15,749634.34
1001,4/15/2021,4/15/2021,JE-21-0200,LUX PR 20210415 REV &CORR,,HJ,268.15,,749902.49
1001,4/15/2021,4/15/2021,JE-21-0200,LUX PR 20210415 REV &CORR,,HJ,2529.5,,752431.99
1001,4/15/2021,4/15/2021,JE-21-0200,LUX PR 20210415 REV &CORR,,HJ,4774.96,,757206.95
1001,4/15/2021,4/15/2021,JE-21-0200,LUX PR 20210415 REV &CORR,,HJ,17174.65,,774381.6
1001,4/15/2021,4/15/2021,JE-21-0200,LUX PR 20210415 REV &CORR,,HJ,98506.07,,872887.67
1001,4/15/2021,4/15/2021,JE-21-0200,LUX PR 20210415 REV &CORR,,HJ,,123211.04,749676.63
1001,4/15/2021,4/15/2021,JumpCloud Inc,Bill.Com Import,,HJ,,3442.5,746234.13
1001,4/15/2021,4/15/2021,Tiffani Bibb,Imported from reimbursements,,HJ,,92.9,746141.23
1001,4/15/2021,4/15/2021,Tiffani Bibb,Imported from reimbursements,,HJ,,649,745492.23
1001,4/15/2021,4/15/2021,Tiffani Bibb,Imported from reimbursements,,HJ,,2395,743097.23
1001,4/16/2021,4/16/2021,HRKnowledge,HRKnowledge Virtual HR Partner PD04.06,,HJ,,2500,740597.23
1001,4/16/2021,4/16/2021,SERGEY BRIN FAMILY F,Received from Sergey Brin Family foundation,,HJ,3000000,,3740597.23
1001,4/16/2021,4/16/2021,"TAG Resources, LLC",Employee 401K Payment PD04.15,,HJ,,7404.12,3733193.11
1001,4/16/2021,4/16/2021,TASC,Payment for TASC for PD04.15.21,,HJ,,2428.98,3730764.13
1001,4/19/2021,4/19/2021,20210419,82L Special Payroll 2021-04-20,,HJ,,2280.15,3728483.98
1001,4/19/2021,4/19/2021,T-Mobile,T-Mobile Bill,,HJ,,61.78,3728422.2
1001,4/19/2021,4/19/2021,T-Mobile,T-Mobile Bill,,HJ,,95.47,3728326.73
1001,4/19/2021,4/19/2021,T-Mobile,T-Mobile Bill,,HJ,,95.47,3728231.26
1001,4/19/2021,4/19/2021,T-Mobile,T-Mobile Bill,,HJ,,308.88,3727922.38
1001,4/21/2021,4/21/2021,ADP,ADP state UI filings and penalties April 2021,,HJ,,9458.19,3718464.19
1001,4/21/2021,4/21/2021,Appcast Inc.,Bill.Com Import,,HJ,,586.5,3717877.69
1001,4/21/2021,4/21/2021,Brandvia,Bill.Com Import,,HJ,,5443.68,3712434.01
1001,4/21/2021,4/21/2021,Feinberg Hanson,Bill.Com Import,,HJ,,702,3711732.01
1001,4/21/2021,4/21/2021,Grubhub,Bill.Com Import,,HJ,,90.29,3711641.72
1001,4/21/2021,4/21/2021,Grubhub,Bill.Com Import,,HJ,,167.48,3711474.24
1001,4/21/2021,4/21/2021,Grubhub,Bill.Com Import,,HJ,,168.25,3711305.99
1001,4/21/2021,4/21/2021,Grubhub,Bill.Com Import,,HJ,,183.1,3711122.89
1001,4/21/2021,4/21/2021,Grubhub,Bill.Com Import,,HJ,,243.67,3710879.22
1001,4/21/2021,4/21/2021,Media Cause,Bill.Com Import,,HJ,,3458.75,3707420.47
1001,4/21/2021,4/21/2021,Media Cause,Bill.Com Import,,HJ,,13478,3693942.47
1001,4/21/2021,4/21/2021,Walnut Street Realty,Bill.Com Import,,HJ,,2192.58,3691749.89
1001,4/22/2021,4/22/2021,AFLAC,Aflac Insurance Payment April,,HJ,,51.36,3691698.53
1001,4/22/2021,4/22/2021,AFLAC,Aflac Insurance Payment April,,HJ,,66.14,3691632.39
1001,4/22/2021,4/22/2021,AFLAC,Aflac Insurance Payment April,,HJ,,89.64,3691542.75
1001,4/22/2021,4/22/2021,Leslie Wade LLC,Bill.Com Import,,HJ,,10400,3681142.75
1001,4/22/2021,4/22/2021,Whiteboard,Bill.Com Import,,HJ,,17725,3663417.75
1001,4/23/2021,4/23/2021,20210423,82L Special Payroll 2021-04-23,,HJ,,959.34,3662458.41
1001,4/23/2021,4/23/2021,ADP,ADP state UI filings and penalties April 2021,,HJ,,18.6,3662439.81
1001,4/23/2021,4/23/2021,ADP,ADP state UI filings and penalties April 2021,,HJ,,21.35,3662418.46
1001,4/23/2021,4/23/2021,ADP,ADP state UI filings and penalties April 2021,,HJ,,25.96,3662392.5
1001,4/23/2021,4/23/2021,ADP,ADP state UI filings and penalties April 2021,,HJ,,33,3662359.5
1001,4/23/2021,4/23/2021,ADP,ADP state UI filings and penalties April 2021,,HJ,,33,3662326.5
1001,4/23/2021,4/23/2021,ADP,ADP state UI filings and penalties April 2021,,HJ,,80.19,3662246.31
1001,4/23/2021,4/23/2021,ADP,ADP state UI filings and penalties April 2021,,HJ,,106.77,3662139.54
1001,4/23/2021,4/23/2021,ADP,ADP state UI filings and penalties April 2021,,HJ,,106.92,3662032.62
1001,4/23/2021,4/23/2021,ADP,ADP state UI filings and penalties April 2021,,HJ,,119.98,3661912.64
1001,4/23/2021,4/23/2021,ADP,ADP state UI filings and penalties April 2021,,HJ,,123.93,3661788.71
1001,4/23/2021,4/23/2021,ADP,ADP state UI filings and penalties April 2021,,HJ,,123.93,3661664.78
1001,4/23/2021,4/23/2021,ADP,ADP state UI filings and penalties April 2021,,HJ,,139.03,3661525.75
1001,4/23/2021,4/23/2021,ADP,ADP state UI filings and penalties April 2021,,HJ,,165.24,3661360.51
1001,4/23/2021,4/23/2021,ADP,ADP state UI filings and penalties April 2021,,HJ,,165.24,3661195.27
1001,4/23/2021,4/23/2021,ADP,ADP state UI filings and penalties April 2021,,HJ,,214.86,3660980.41
1001,4/23/2021,4/23/2021,ADP,ADP state UI filings and penalties April 2021,,HJ,,214.86,3660765.55
1001,4/23/2021,4/23/2021,ADP,ADP state UI filings and penalties April 2021,,HJ,,255.21,3660510.34
1001,4/23/2021,4/23/2021,ADP,ADP state UI filings and penalties April 2021,,HJ,,400.95,3660109.39
1001,4/23/2021,4/23/2021,ADP,ADP state UI filings and penalties April 2021,,HJ,,534.6,3659574.79
1001,4/23/2021,4/23/2021,ADP,ADP state UI filings and penalties April 2021,,HJ,,634.48,3658940.31
1001,4/23/2021,4/23/2021,ADP,ADP state UI filings and penalties April 2021,,HJ,,695.13,3658245.18
1001,4/23/2021,4/23/2021,ADP,ADP state UI filings and penalties April 2021,,HJ,,4058.64,3654186.54
1001,4/23/2021,4/23/2021,ADP,ADP state UI filings and penalties April 2021,,HJ,,4058.64,3650127.9
1001,4/23/2021,4/23/2021,ADP,ADP state UI filings and penalties April 2021,,HJ,,4058.64,3646069.26
1001,4/23/2021,4/23/2021,ADP,ADP state UI filings and penalties April 2021,,HJ,,4058.64,3642010.62
1001,4/23/2021,4/23/2021,ADP,ADP state UI filings and penalties April 2021,,HJ,,4058.64,3637951.98
1001,4/23/2021,4/23/2021,ADP,ADP state UI filings and penalties April 2021,,HJ,,4144.14,3633807.84
1001,4/23/2021,4/23/2021,ADP,ADP state UI filings and penalties April 2021,,HJ,,3855.72,3629952.12
1001,4/23/2021,4/23/2021,Grubhub,Bill.Com Import,,HJ,,537.45,3629414.67
1001,4/23/2021,4/23/2021,HRKnowledge,HRK Supplemental Payroll Fee PD0423,,HJ,,100,3629314.67
1001,4/23/2021,4/23/2021,Karl W. Reid,Bill.Com Import,,HJ,,930,3628384.67
1001,4/23/2021,4/23/2021,Ohio Indemnity,Bill.Com Import,,HJ,,9727.78,3618656.89
1001,4/23/2021,4/23/2021,Ohio Indemnity,Bill.Com Import,,HJ,,12380.82,3606276.07
1001,4/23/2021,4/23/2021,The Hanover Ins,Bill.Com Import,,HJ,,194,3606082.07
1001,4/23/2021,4/23/2021,WayUp Inc.,Bill.Com Import,,HJ,,1072.5,3605009.57
1001,4/23/2021,4/23/2021,WayUp Inc.,Bill.Com Import,,HJ,,1657.5,3603352.07
1001,4/23/2021,4/23/2021,WayUp Inc.,Bill.Com Import,,HJ,,1657.5,3601694.57
1001,4/23/2021,4/23/2021,WayUp Inc.,Bill.Com Import,,HJ,,5362.5,3596332.07
1001,4/27/2021,4/27/2021,ADP,ADP state UI filings and penalties April 2021,,HJ,,17.38,3596314.69
1001,4/27/2021,4/27/2021,ADP,ADP state UI filings and penalties April 2021,,HJ,,23,3596291.69
1001,4/27/2021,4/27/2021,ADP,ADP state UI filings and penalties April 2021,,HJ,,26.86,3596264.83
1001,4/27/2021,4/27/2021,ADP,ADP state UI filings and penalties April 2021,,HJ,,26.86,3596237.97
1001,4/27/2021,4/27/2021,ADP,ADP state UI filings and penalties April 2021,,HJ,,35.64,3596202.33
1001,4/27/2021,4/27/2021,ADP,ADP state UI filings and penalties April 2021,,HJ,,55.08,3596147.25
1001,4/27/2021,4/27/2021,ADP,ADP state UI filings and penalties April 2021,,HJ,,55.08,3596092.17
1001,4/27/2021,4/27/2021,ADP,ADP state UI filings and penalties April 2021,,HJ,,85,3596007.17
1001,4/27/2021,4/27/2021,ADP,ADP state UI filings and penalties April 2021,,HJ,,86.9,3595920.27
1001,4/27/2021,4/27/2021,ADP,ADP state UI filings and penalties April 2021,,HJ,,159.28,3595760.99
1001,4/27/2021,4/27/2021,ADP,ADP state UI filings and penalties April 2021,,HJ,,178.2,3595582.79
1001,4/27/2021,4/27/2021,Emptech,Bill.Com Import,,HJ,,860,3594722.79
1001,4/27/2021,4/27/2021,Kyra Detone,Imported from reimbursements,,HJ,,411.4,3594311.39
1001,4/27/2021,4/27/2021,Monivett Acevedo,Imported from reimbursements,,HJ,,280.8,3594030.59
1001,4/27/2021,4/27/2021,Stryder,Bill.Com Import,,HJ,,1155,3592875.59
1001,4/27/2021,4/27/2021,Stryder,Bill.Com Import,,HJ,,1785,3591090.59
1001,4/27/2021,4/27/2021,Stryder,Bill.Com Import,,HJ,,1785,3589305.59
1001,4/27/2021,4/27/2021,Stryder,Bill.Com Import,,HJ,,5775,3583530.59
1001,4/28/2021,4/28/2021,ADP,ADP state UI filings and penalties April 2021,,HJ,,103.64,3583426.95
1001,4/29/2021,4/29/2021,WE SUCCEED,Pre-Pilot Payment - We Succeed,,HJ,1000,,3584426.95
1001,4/30/2021,4/30/2021,43021,82L-IMPORT PAYROLL,,HJ,,2749.35,3581677.6
1001,4/30/2021,4/30/2021,43021,82L-IMPORT PAYROLL,,HJ,,6588.36,3575089.24
1001,4/30/2021,4/30/2021,43021,82L-IMPORT PAYROLL,,HJ,,13413.46,3561675.78
1001,4/30/2021,4/30/2021,43021,82L-IMPORT PAYROLL,,HJ,,17680.41,3543995.37
1001,4/30/2021,4/30/2021,43021,82L-IMPORT PAYROLL,,HJ,,19133.89,3524861.48
1001,4/30/2021,4/30/2021,43021,82L-IMPORT PAYROLL,,HJ,,32095.69,3492765.79
1001,4/30/2021,4/30/2021,43021,82L-IMPORT PAYROLL,,HJ,,81177.93,3411587.86
1001,4/30/2021,4/30/2021,43021,82L-IMPORT PAYROLL,,HJ,,83891.94,3327695.92
1001,4/30/2021,4/30/2021,43021,82L-IMPORT PAYROLL,,HJ,,103558.92,3224137
1001,4/30/2021,4/30/2021,202104,Receiving individual donations QGiv,,HJ,49.19,,3224186.19
1001,4/30/2021,4/30/2021,JE-21-0204,LUX Payroll 4-30-2021,,HJ,,265.92,3223920.27
1001,4/30/2021,4/30/2021,JE-21-0204,LUX Payroll 4-30-2021,,HJ,,4892.14,3219028.13
1001,4/30/2021,4/30/2021,JE-21-0204,LUX Payroll 4-30-2021,,HJ,,17174.65,3201853.48
1001,4/30/2021,4/30/2021,JE-21-0204,LUX Payroll 4-30-2021,,HJ,,97709,3104144.48
1001,4/30/2021,4/30/2021,JE-21-0204,PR LUX 20210430,,HJ,225.86,,3104370.34
1001,4/30/2021,4/30/2021,JE-21-0204,PR LUX 20210430,,HJ,,265.92,3104104.42
1001,4/30/2021,4/30/2021,JE-21-0204,PR LUX 20210430,,HJ,265.92,,3104370.34
1001,4/30/2021,4/30/2021,JE-21-0204,PR LUX 20210430,,HJ,2364.01,,3106734.35
1001,4/30/2021,4/30/2021,JE-21-0204,PR LUX 20210430,,HJ,4892.14,,3111626.49
1001,4/30/2021,4/30/2021,JE-21-0204,PR LUX 20210430,,HJ,17174.65,,3128801.14
1001,4/30/2021,4/30/2021,JE-21-0204,PR LUX 20210430,,HJ,97709,,3226510.14
1001,4/30/2021,4/30/2021,JE-21-0204,PR LUX 20210430,,HJ,,122365.66,3104144.48
1001,4/30/2021,4/30/2021,Mary McNicholas,Imported from reimbursements,,HJ,,16.49,3104127.99
1001,4/30/2021,4/30/2021,Woot Math Acquisiti,Received revenue from Woot Math,,HJ,468.27,,3104596.26
1001,5/3/2021,5/3/2021,ADP,ADP state UI filings and penatlies May 2021,,HJ,,39.16,3104557.1
1001,5/3/2021,5/3/2021,ADP,ADP state UI filings and penatlies May 2021,,HJ,,60.52,3104496.58
1001,5/3/2021,5/3/2021,ADP,ADP state UI filings and penatlies May 2021,,HJ,,60.52,3104436.06
1001,5/3/2021,5/3/2021,ADP,ADP state UI filings and penatlies May 2021,,HJ,,195.8,3104240.26
1001,5/3/2021,5/3/2021,BCBS,BCBS MAy 2021 Payment,,HJ,,4124.68,3100115.58
1001,5/3/2021,5/3/2021,BCBS,BCBS MAy 2021 Payment,,HJ,,4660.94,3095454.64
1001,5/3/2021,5/3/2021,BCBS,BCBS MAy 2021 Payment,,HJ,,8654.66,3086799.98
1001,5/3/2021,5/3/2021,BCBS,BCBS MAy 2021 Payment,,HJ,,15352.94,3071447.04
1001,5/3/2021,5/3/2021,BCBS,BCBS MAy 2021 Payment,D104,HJ,,49687.36,3021759.68
1001,5/3/2021,5/3/2021,"TAG Resources, LLC",Employee 401k Payment PD04.29,,HJ,,7622.6,3014137.08
1001,5/3/2021,5/3/2021,TASC,TASC Payment for April,,HJ,,2142.13,3011994.95
1001,5/4/2021,5/4/2021,1,Blue 20/20 Vision Insurance,,HJ,,28.44,3011966.51
1001,5/4/2021,5/4/2021,1,Blue 20/20 Vision Insurance,,HJ,,56.46,3011910.05
1001,5/4/2021,5/4/2021,1,Blue 20/20 Vision Insurance,,HJ,,85.32,3011824.73
1001,5/4/2021,5/4/2021,1,Blue 20/20 Vision Insurance,,HJ,,113.34,3011711.39
1001,5/4/2021,5/4/2021,1,Blue 20/20 Vision Insurance,,HJ,,444.28,3011267.11
1001,5/4/2021,5/4/2021,1,blUE 20/20 Vision payment May,,HJ,,7.11,3011260
1001,5/4/2021,5/4/2021,1,blUE 20/20 Vision payment May,,HJ,,21.33,3011238.67
1001,5/4/2021,5/4/2021,1,blUE 20/20 Vision payment May,,HJ,,176.33,3011062.34
1001,5/4/2021,5/4/2021,Bank of America VISA,BofA Credit Card Payment April,,HJ,,1578.32,3009484.02
1001,5/4/2021,5/4/2021,Bank of America VISA,BofA Credit Card Payment April,,HJ,2271.39,,3011755.41
1001,5/4/2021,5/4/2021,Bank of America VISA,BofA Credit Card Payment April,,HJ,,2300,3009455.41
1001,5/4/2021,5/4/2021,Bank of America VISA,BofA Credit Card Payment April,,HJ,,2823.34,3006632.07
1001,5/4/2021,5/4/2021,Bank of America VISA,BofA Credit Card Payment April,,HJ,,3523.37,3003108.7
1001,5/4/2021,5/4/2021,Bank of America VISA,BofA Credit Card Payment April,,HJ,,3864.2,2999244.5
1001,5/4/2021,5/4/2021,Bank of America VISA,BofA Credit Card Payment April,,HJ,,7471.07,2991773.43
1001,5/4/2021,5/4/2021,Bank of America VISA,BofA Credit Card Payment April,,HJ,,8069.48,2983703.95
1001,5/4/2021,5/4/2021,Bank of America VISA,BofA Credit Card Payment April,,HJ,,12519.92,2971184.03
1001,5/4/2021,5/4/2021,Bank of America VISA,BofA Credit Card Payment April,,HJ,,16675.32,2954508.71
1001,5/4/2021,5/4/2021,Bank of America VISA,BofA Credit Card Payment April,,HJ,,17011.48,2937497.23
1001,5/4/2021,5/4/2021,HP Inc.,Bill.Com Import,,HJ,,115150,2822347.23
1001,5/4/2021,5/4/2021,Mighty Good Agency,Bill.Com Import,,HJ,,17750,2804597.23
1001,5/5/2021,5/5/2021,ADP,ADP state UI filings and penatlies May 2021,,HJ,,693.14,2803904.09
1001,5/5/2021,5/5/2021,ADP,ADP state UI filings and penatlies May 2021,,HJ,3.72,,2803907.81
1001,5/5/2021,5/5/2021,Anthony Onica,Imported from reimbursements,,HJ,,39.4,2803868.41
1001,5/5/2021,5/5/2021,Chillicothe R-II Sch,Reciept of Woot Math Chillicothe School District,,HJ,598.75,,2804467.16
1001,5/5/2021,5/5/2021,Comcast,Comcast Payment May,,HJ,,139.55,2804327.61
1001,5/5/2021,5/5/2021,Evelyn Villegas,Imported from reimbursements,,HJ,,134,2804193.61
1001,5/5/2021,5/5/2021,Exponent Partners,Bill.Com Import,,HJ,,7500,2796693.61
1001,5/5/2021,5/5/2021,Facebook,Facebook Donations,,HJ,360,,2797053.61
1001,5/5/2021,5/5/2021,HRKnowledge,HR Outsourcing Admin fee for Staff and Fellows PD04.30,,HJ,,127.6,2796926.01
1001,5/5/2021,5/5/2021,HRKnowledge,HR Outsourcing Admin fee for Staff and Fellows PD04.30,,HJ,,197.2,2796728.81
1001,5/5/2021,5/5/2021,HRKnowledge,HR Outsourcing Admin fee for Staff and Fellows PD04.30,,HJ,,197.2,2796531.61
1001,5/5/2021,5/5/2021,HRKnowledge,HR Outsourcing Admin fee for Staff and Fellows PD04.30,,HJ,,638,2795893.61
1001,5/5/2021,5/5/2021,HRKnowledge,HR Outsourcing Admin fee for Staff and Fellows PD04.30,,HJ,,1930,2793963.61
1001,5/5/2021,5/5/2021,Transamerica,Life Policy for Monivett Acevedo,,HJ,,135,2793828.61
1001,5/6/2021,5/6/2021,Melissa McElwee,Imported from reimbursements,,HJ,,5.99,2793822.62
1001,5/6/2021,5/6/2021,Melissa McElwee,Imported from reimbursements,,HJ,,18.9,2793803.72
1001,5/6/2021,5/6/2021,Melissa McElwee,Imported from reimbursements,,HJ,,36.96,2793766.76
1001,5/7/2021,5/7/2021,ADP,ADP Payroll fee invoice for Fellows and Staff Period End 4.30.21,,HJ,,78.38,2793688.38
1001,5/7/2021,5/7/2021,ADP,ADP Payroll fee invoice for Fellows and Staff Period End 4.30.21,,HJ,,121.13,2793567.25
1001,5/7/2021,5/7/2021,ADP,ADP Payroll fee invoice for Fellows and Staff Period End 4.30.21,,HJ,,121.13,2793446.12
1001,5/7/2021,5/7/2021,ADP,ADP Payroll fee invoice for Fellows and Staff Period End 4.30.21,,HJ,,391.91,2793054.21
1001,5/7/2021,5/7/2021,ADP,ADP Payroll fee invoice for Fellows and Staff Period End 4.30.21,,HJ,,5821.37,2787232.84
1001,5/7/2021,5/7/2021,Verizon,Verizon May 2021,,HJ,,671.37,2786561.47
1001,5/7/2021,5/7/2021,Verizon,Verizon May 2021,,HJ,,1037.58,2785523.89
1001,5/7/2021,5/7/2021,Verizon,Verizon May 2021,,HJ,,1037.58,2784486.31
1001,5/7/2021,5/7/2021,Verizon,Verizon May 2021,,HJ,,3356.87,2781129.44
1001,5/7/2021,5/7/2021,Verizon,Verizon May 2021,,HJ,,49.58,2781079.86
1001,5/7/2021,5/7/2021,Verizon,Verizon May 2021,,HJ,,76.64,2781003.22
1001,5/7/2021,5/7/2021,Verizon,Verizon May 2021,,HJ,,76.64,2780926.58
1001,5/7/2021,5/7/2021,Verizon,Verizon May 2021,,HJ,,247.94,2780678.64
1001,5/7/2021,5/7/2021,Whiteboard,Bill.Com Import,,HJ,,17500,2763178.64
1001,5/10/2021,5/10/2021,Inspire Business Cen,Jackson Center Payment,,HJ,,984.8,2762193.84
1001,5/10/2021,5/10/2021,Monivett Acevedo,Imported from reimbursements,,HJ,,168.4,2762025.44
1001,5/11/2021,5/11/2021,Emptech,Bill.Com Import,,HJ,,765,2761260.44
1001,5/11/2021,5/11/2021,Enabler Design,Bill.Com Import,,HJ,,150,2761110.44
1001,5/11/2021,5/11/2021,Eversource,Eversource May 2021,,HJ,,32.98,2761077.46
1001,5/11/2021,5/11/2021,Julie Balfour,Bill.Com Import,,HJ,,3333.33,2757744.13
1001,5/11/2021,5/11/2021,Karl W. Reid,Bill.Com Import,,HJ,,240,2757504.13
1001,5/11/2021,5/11/2021,RI DOT,Tax Exemption Request from RI,,HJ,,25,2757479.13
1001,5/12/2021,5/12/2021,ADP,ADP state UI filings and penatlies May 2021,,HJ,,3.12,2757476.01
1001,5/12/2021,5/12/2021,ADP,ADP state UI filings and penatlies May 2021,,HJ,,13.54,2757462.47
1001,5/12/2021,5/12/2021,ADP,ADP state UI filings and penatlies May 2021,,HJ,,28.65,2757433.82
1001,5/12/2021,5/12/2021,ADP,ADP state UI filings and penatlies May 2021,,HJ,,33.84,2757399.98
1001,5/12/2021,5/12/2021,ADP,ADP state UI filings and penatlies May 2021,,HJ,,44.29,2757355.69
1001,5/12/2021,5/12/2021,ADP,ADP state UI filings and penatlies May 2021,,HJ,,44.29,2757311.4
1001,5/12/2021,5/12/2021,ADP,ADP state UI filings and penatlies May 2021,,HJ,,87.48,2757223.92
1001,5/12/2021,5/12/2021,ADP,ADP state UI filings and penatlies May 2021,,HJ,,143.29,2757080.63
1001,5/13/2021,5/13/2021,JE-21-0226,LUX Payroll- PRPD 05152021,,HJ,225.86,,2757306.49
1001,5/13/2021,5/13/2021,JE-21-0226,LUX Payroll- PRPD 05152021,,HJ,,265.92,2757040.57
1001,5/13/2021,5/13/2021,JE-21-0226,LUX Payroll- PRPD 05152021,,HJ,2469.6,,2759510.17
1001,5/13/2021,5/13/2021,JE-21-0226,LUX Payroll- PRPD 05152021,,HJ,,122377.86,2637132.31
1001,5/14/2021,5/14/2021,51421,82L-IMPORT PAYROLL,,HJ,,1543.17,2635589.14
1001,5/14/2021,5/14/2021,51421,82L-IMPORT PAYROLL,,HJ,,2749.35,2632839.79
1001,5/14/2021,5/14/2021,51421,82L-IMPORT PAYROLL,,HJ,,4169.26,2628670.53
1001,5/14/2021,5/14/2021,51421,82L-IMPORT PAYROLL,,HJ,,5151.03,2623519.5
1001,5/14/2021,5/14/2021,51421,82L-IMPORT PAYROLL,,HJ,,18710.34,2604809.16
1001,5/14/2021,5/14/2021,51421,82L-IMPORT PAYROLL,,HJ,,43064.68,2561744.48
1001,5/14/2021,5/14/2021,51421,82L-IMPORT PAYROLL,,HJ,,43110.82,2518633.66
1001,5/14/2021,5/14/2021,51421,82L-IMPORT PAYROLL,,HJ,,58183.87,2460449.79
1001,5/14/2021,5/14/2021,51421,82L-IMPORT PAYROLL,,HJ,,84003.24,2376446.55
1001,5/14/2021,5/14/2021,51421,82L-IMPORT PAYROLL,,HJ,,104480.49,2271966.06
1001,5/14/2021,5/14/2021,ADP,ADP state UI filings and penatlies May 2021,,HJ,,4.3,2271961.76
1001,5/14/2021,5/14/2021,ADP,ADP state UI filings and penatlies May 2021,,HJ,,6.45,2271955.31
1001,5/14/2021,5/14/2021,ADP,ADP state UI filings and penatlies May 2021,,HJ,,18.62,2271936.69
1001,5/14/2021,5/14/2021,ADP,ADP state UI filings and penatlies May 2021,,HJ,,27.93,2271908.76
1001,5/14/2021,5/14/2021,ADP,ADP state UI filings and penatlies May 2021,,HJ,,71.23,2271837.53
1001,5/14/2021,5/14/2021,ADP,ADP state UI filings and penatlies May 2021,,HJ,,120.32,2271717.21
1001,5/14/2021,5/14/2021,ADP,ADP state UI filings and penatlies May 2021,,HJ,,180.48,2271536.73
1001,5/14/2021,5/14/2021,"TAG Resources, LLC",Employee 401K Payment PD05.13,,HJ,,7291.15,2264245.58
1001,5/14/2021,5/14/2021,Tess Brownson,Bill.Com Import,,HJ,,1000,2263245.58
1001,5/17/2021,5/17/2021,T-Mobile,T-Mobile May Bill,,HJ,,61.78,2263183.8
1001,5/17/2021,5/17/2021,T-Mobile,T-Mobile May Bill,,HJ,,95.47,2263088.33
1001,5/17/2021,5/17/2021,T-Mobile,T-Mobile May Bill,,HJ,,95.47,2262992.86
1001,5/17/2021,5/17/2021,T-Mobile,T-Mobile May Bill,,HJ,,308.88,2262683.98
1001,5/17/2021,5/17/2021,TASC,TASC PD05.14,,HJ,,2503.24,2260180.74
1001,5/18/2021,5/18/2021,CD-21-0289,Americorps Reimbursement for April,,HJ,201713.77,,2461894.51
1001,5/18/2021,5/18/2021,HRKnowledge,HRKnowlegde Virtual Partner,,HJ,,2500,2459394.51
1001,5/19/2021,5/19/2021,AFLAC,Aflac Payment,,HJ,,51.36,2459343.15
1001,5/19/2021,5/19/2021,AFLAC,Aflac Payment,,HJ,,66.14,2459277.01
1001,5/19/2021,5/19/2021,AFLAC,Aflac Payment,,HJ,,89.64,2459187.37
1001,5/19/2021,5/19/2021,HRKnowledge,HRKnowlegde Outsourcing Fee,,HJ,,1580,2457607.37
1001,5/19/2021,5/19/2021,HRKnowledge,HRKnowledge Outsourcing Fee Fellows PD0514,,HJ,,127.6,2457479.77
1001,5/19/2021,5/19/2021,HRKnowledge,HRKnowledge Outsourcing Fee Fellows PD0514,,HJ,,197.2,2457282.57
1001,5/19/2021,5/19/2021,HRKnowledge,HRKnowledge Outsourcing Fee Fellows PD0514,,HJ,,197.2,2457085.37
1001,5/19/2021,5/19/2021,HRKnowledge,HRKnowledge Outsourcing Fee Fellows PD0514,,HJ,,638,2456447.37
1001,5/20/2021,5/20/2021,The Hanover Ins,Employee PFL Insurance coverage period 03.03.21,,HJ,,1240.28,2455207.09
1001,5/21/2021,5/21/2021,Appcast Inc.,Bill.Com Import,,HJ,,569.5,2454637.59
1001,5/21/2021,5/21/2021,Attorney's At Law,Deposit 20210521,,HJ,289,,2454926.59
1001,5/21/2021,5/21/2021,Brandvia,Bill.Com Import,,HJ,,300.72,2454625.87
1001,5/21/2021,5/21/2021,Brandvia,Bill.Com Import,,HJ,,1303.11,2453322.76
1001,5/21/2021,5/21/2021,Brandvia,Bill.Com Import,,HJ,,8420.08,2444902.68
1001,5/21/2021,5/21/2021,Grubhub,Bill.Com Import,,HJ,,31.8,2444870.88
1001,5/21/2021,5/21/2021,Grubhub,Bill.Com Import,,HJ,,63.6,2444807.28
1001,5/21/2021,5/21/2021,Grubhub,Bill.Com Import,,HJ,,148.38,2444658.9
1001,5/21/2021,5/21/2021,Grubhub,Bill.Com Import,,HJ,,328.9,2444330
1001,5/21/2021,5/21/2021,Grubhub,Bill.Com Import,,HJ,,398.35,2443931.65
1001,5/21/2021,5/21/2021,Grubhub,Bill.Com Import,,HJ,,633.3,2443298.35
1001,5/21/2021,5/21/2021,Grubhub,Bill.Com Import,,HJ,,820.26,2442478.09
1001,5/21/2021,5/21/2021,Littler Mendelson,Bill.Com Import,,HJ,,152.5,2442325.59
1001,5/21/2021,5/21/2021,Media Cause,Bill.Com Import,,HJ,,2755,2439570.59
1001,5/21/2021,5/21/2021,Media Cause,Bill.Com Import,,HJ,,4717.5,2434853.09
1001,5/21/2021,5/21/2021,Media Cause,Bill.Com Import,,HJ,,22068.75,2412784.34
1001,5/21/2021,5/21/2021,Teads Inc,Bill.Com Import,,HJ,,2839.7,2409944.64
1001,5/21/2021,5/21/2021,Traveler's WC,Deposit 20210521,,HJ,470,,2410414.64
1001,5/21/2021,5/21/2021,Whiteboard,Bill.Com Import,,HJ,,36500,2373914.64
1001,5/24/2021,5/24/2021,Adam Hernan,Imported from reimbursements,,HJ,,4.55,2373910.09
1001,5/24/2021,5/24/2021,Adam Hernan,Imported from reimbursements,,HJ,,12.2,2373897.89
1001,5/24/2021,5/24/2021,Adam Hernan,Imported from reimbursements,,HJ,,35,2373862.89
1001,5/24/2021,5/24/2021,Adam Hernan,Imported from reimbursements,,HJ,,56.21,2373806.68
1001,5/24/2021,5/24/2021,Adam Hernan,Imported from reimbursements,,HJ,,65.99,2373740.69
1001,5/24/2021,5/24/2021,Adam Hernan,Imported from reimbursements,,HJ,,70.99,2373669.7
1001,5/24/2021,5/24/2021,Adam Hernan,Imported from reimbursements,,HJ,,108.4,2373561.3
1001,5/24/2021,5/24/2021,Adam Hernan,Imported from reimbursements,,HJ,,108.4,2373452.9
1001,5/24/2021,5/24/2021,claice Jackson,Imported from reimbursements,,HJ,,14,2373438.9
1001,5/24/2021,5/24/2021,claice Jackson,Imported from reimbursements,,HJ,,15.12,2373423.78
1001,5/24/2021,5/24/2021,claice Jackson,Imported from reimbursements,,HJ,,16.24,2373407.54
1001,5/24/2021,5/24/2021,Leslie Wade LLC,Bill.Com Import,,HJ,,10400,2363007.54
1001,5/24/2021,5/24/2021,Monivett Acevedo,Imported from reimbursements,,HJ,,1,2363006.54
1001,5/24/2021,5/24/2021,Monivett Acevedo,Imported from reimbursements,,HJ,,1.39,2363005.15
1001,5/24/2021,5/24/2021,Monivett Acevedo,Imported from reimbursements,,HJ,,5.75,2362999.4
1001,5/24/2021,5/24/2021,Monivett Acevedo,Imported from reimbursements,,HJ,,5.97,2362993.43
1001,5/24/2021,5/24/2021,Monivett Acevedo,Imported from reimbursements,,HJ,,6.43,2362987
1001,5/24/2021,5/24/2021,Monivett Acevedo,Imported from reimbursements,,HJ,,6.7,2362980.3
1001,5/24/2021,5/24/2021,Monivett Acevedo,Imported from reimbursements,,HJ,,8.41,2362971.89
1001,5/24/2021,5/24/2021,Monivett Acevedo,Imported from reimbursements,,HJ,,10.06,2362961.83
1001,5/24/2021,5/24/2021,Monivett Acevedo,Imported from reimbursements,,HJ,,19.15,2362942.68
1001,5/24/2021,5/24/2021,RobbinsSalomonPatt,Bill.Com Import,,HJ,,2989.5,2359953.18
1001,5/25/2021,5/25/2021,Amazon Business,Amazon Smile Payment 20210525,,HJ,5,,2359958.18
1001,5/25/2021,5/25/2021,X Co. NFAMILY,Receipt from X Co. n,,HJ,100000,,2459958.18
1001,5/25/2021,5/25/2021,X Co. NFAMILY,Receipt from X Co. n,,HJ,150000,,2609958.18
1001,5/26/2021,5/26/2021,ADP,ADP state UI filings and penatlies May 2021,,HJ,,4.17,2609954.01
1001,5/26/2021,5/26/2021,ADP,ADP state UI filings and penatlies May 2021,,HJ,,18.07,2609935.94
1001,5/26/2021,5/26/2021,ADP,ADP state UI filings and penatlies May 2021,,HJ,,54.86,2609881.08
1001,5/26/2021,5/26/2021,ADP,ADP state UI filings and penatlies May 2021,,HJ,,116.76,2609764.32
1001,5/26/2021,5/26/2021,ADP,ADP state UI filings and penatlies May 2021,,HJ,,237.74,2609526.58
1001,5/26/2021,5/26/2021,ADP,ADP state UI filings and penatlies May 2021,,HJ,,254.48,2609272.1
1001,5/26/2021,5/26/2021,ADP,ADP state UI filings and penatlies May 2021,,HJ,,1536.19,2607735.91
1001,5/26/2021,5/26/2021,HubSpot Inc.,Bill.Com Import,,HJ,,5423,2602312.91
1001,5/26/2021,5/26/2021,HubSpot Inc.,Bill.Com Import,,HJ,,27115,2575197.91
1001,5/26/2021,5/26/2021,UnitedHealthcare,Bill.Com Import,,HJ,,50000,2525197.91
1001,5/26/2021,5/26/2021,Walnut Street Realty,Bill.Com Import,,HJ,,2192.58,2523005.33
1001,5/27/2021,5/27/2021,JE-21-0227,LUX PAyroll - PRPD 05312021,,HJ,225.86,,2523231.19
1001,5/27/2021,5/27/2021,JE-21-0227,LUX PAyroll - PRPD 05312021,,HJ,,262.92,2522968.27
1001,5/27/2021,5/27/2021,JE-21-0227,LUX PAyroll - PRPD 05312021,,HJ,2287.05,,2525255.32
1001,5/27/2021,5/27/2021,JE-21-0227,LUX PAyroll - PRPD 05312021,,HJ,,121242.62,2404012.7
1001,5/27/2021,5/27/2021,"Twilio, Inc.",Bill.Com Import,,HJ,,3551.8,2400460.9
1001,5/28/2021,5/28/2021,1,HRK BCBS refund,,HJ,218.36,,2400679.26
1001,5/28/2021,5/28/2021,1,HRK BCBS refund,,HJ,639.24,,2401318.5
1001,5/28/2021,5/28/2021,1,HRK BCBS refund,,HJ,1098.64,,2402417.14
1001,5/28/2021,5/28/2021,52821,82L-IMPORT PAYROLL,,HJ,,2749.35,2399667.79
1001,5/28/2021,5/28/2021,52821,82L-IMPORT PAYROLL,,HJ,,5362.49,2394305.3
1001,5/28/2021,5/28/2021,52821,82L-IMPORT PAYROLL,,HJ,,7300.25,2387005.05
1001,5/28/2021,5/28/2021,52821,82L-IMPORT PAYROLL,,HJ,,19116.35,2367888.7
1001,5/28/2021,5/28/2021,52821,82L-IMPORT PAYROLL,,HJ,,42271.05,2325617.65
1001,5/28/2021,5/28/2021,52821,82L-IMPORT PAYROLL,,HJ,,44079.13,2281538.52
1001,5/28/2021,5/28/2021,52821,82L-IMPORT PAYROLL,,HJ,,64888.71,2216649.81
1001,5/28/2021,5/28/2021,52821,82L-IMPORT PAYROLL,,HJ,,85992.31,2130657.5
1001,5/28/2021,5/28/2021,52821,82L-IMPORT PAYROLL,,HJ,,103927.18,2026730.32
1001,5/28/2021,5/28/2021,Anthony Onica,Imported from reimbursements,,HJ,,80,2026650.32
1001,5/28/2021,5/28/2021,Darnell Melvin,Imported from reimbursements,,HJ,,35,2026615.32
1001,5/28/2021,5/28/2021,Darnell Melvin,Imported from reimbursements,,HJ,,90.4,2026524.92
1001,5/28/2021,5/28/2021,Darnell Melvin,Imported from reimbursements,,HJ,,128.49,2026396.43
1001,5/28/2021,5/28/2021,Darnell Melvin,Imported from reimbursements,,HJ,,162.4,2026234.03
1001,5/28/2021,5/28/2021,Darnell Melvin,Imported from reimbursements,,HJ,,188.53,2026045.5
1001,5/28/2021,5/28/2021,Glendale Unified Sch,Receipt of payment for INV21001 &INV21002,,HJ,55.6,,2026101.1
1001,5/28/2021,5/28/2021,Jeffrey Pernia,Imported from reimbursements,,HJ,,128.49,2025972.61
1001,5/28/2021,5/28/2021,Jeffrey Pernia,Imported from reimbursements,,HJ,,554.8,2025417.81
1001,5/28/2021,5/28/2021,MGSD Online Academy,Receipt of payment for INV21001 &INV21002,,HJ,188.64,,2025606.45
1001,5/30/2021,5/30/2021,Woot Math Acquisiti,Received revenue from Woot Math,,HJ,42.61,,2025649.06
1001,6/1/2021,6/1/2021,BCBS,BCBS June 2021 Payment,,HJ,,2980.29,2022668.77
1001,6/1/2021,6/1/2021,BCBS,BCBS June 2021 Payment,,HJ,,4124.68,2018544.09
1001,6/1/2021,6/1/2021,BCBS,BCBS June 2021 Payment,,HJ,,4660.94,2013883.15
1001,6/1/2021,6/1/2021,BCBS,BCBS June 2021 Payment,,HJ,,10441.25,2003441.9
1001,6/1/2021,6/1/2021,BCBS,BCBS June 2021 Payment,,HJ,,17410.74,1986031.16
1001,6/1/2021,6/1/2021,BCBS,BCBS June 2021 Payment,,HJ,,36299.69,1949731.47
1001,6/1/2021,6/1/2021,"Colegio Anaximenes,","Receipt from INV21007 Colegio Anaximenes, AC",,HJ,844.2,,1950575.67
1001,6/1/2021,6/1/2021,Emptech,Bill.Com Import,,HJ,,255,1950320.67
1001,6/1/2021,6/1/2021,"TAG Resources, LLC",Employee 401K Payment PD05.28,,HJ,,7429.94,1942890.73
1001,6/2/2021,6/2/2021,1,Blue 20/20 Vision Ins LUX,,HJ,,7.11,1942883.62
1001,6/2/2021,6/2/2021,1,Blue 20/20 Vision Ins LUX,,HJ,,21.33,1942862.29
1001,6/2/2021,6/2/2021,1,Blue 20/20 Vision Ins LUX,,HJ,,191.26,1942671.03
1001,6/2/2021,6/2/2021,1,Blue 20/20 Vision Ins 82L June Payment,,HJ,,28.44,1942642.59
1001,6/2/2021,6/2/2021,1,Blue 20/20 Vision Ins 82L June Payment,,HJ,,56.46,1942586.13
1001,6/2/2021,6/2/2021,1,Blue 20/20 Vision Ins 82L June Payment,,HJ,,106.65,1942479.48
1001,6/2/2021,6/2/2021,1,Blue 20/20 Vision Ins 82L June Payment,,HJ,,113.34,1942366.14
1001,6/2/2021,6/2/2021,1,Blue 20/20 Vision Ins 82L June Payment,,HJ,,402.04,1941964.1
1001,6/2/2021,6/2/2021,ADP,ADP state UI filings and penalties June 2021,,HJ,,18.6,1941945.5
1001,6/2/2021,6/2/2021,Appcast Inc.,Bill.Com Import,,HJ,,80.75,1941864.75
1001,6/2/2021,6/2/2021,Great Oaks Legacy,Receipt of Payment Great Oaks Legacy School,,HJ,2487.5,,1944352.25
1001,6/2/2021,6/2/2021,Great Oaks Legacy,Receipt of Payment Great Oaks Legacy School,,HJ,4975,,1949327.25
1001,6/2/2021,6/2/2021,Great Oaks Legacy,Receipt of Funds from Great Oaks prior to Invoicing,,HJ,2487.5,,1951814.75
1001,6/2/2021,6/2/2021,RobbinsSalomonPatt,Bill.Com Import,,HJ,,3416.5,1948398.25
1001,6/2/2021,6/2/2021,TASC,Payment for TASC for PD05.31,,HJ,,2253.79,1946144.46
1001,6/2/2021,6/2/2021,UC Boulder,Bill.Com Import,,HJ,,15042.54,1931101.92
1001,6/2/2021,6/2/2021,UC Boulder,Bill.Com Import,,HJ,,20805.86,1910296.06
1001,6/4/2021,6/4/2021,ADP,ADP state UI filings and penalties June 2021,,HJ,,174.9,1910121.16
1001,6/4/2021,6/4/2021,Bank of America VISA,May B of A Payment,,HJ,,2909.84,1907211.32
1001,6/4/2021,6/4/2021,Bank of America VISA,May B of A Payment,,HJ,,4359.42,1902851.9
1001,6/4/2021,6/4/2021,Bank of America VISA,May B of A Payment,,HJ,,5182.97,1897668.93
1001,6/4/2021,6/4/2021,Bank of America VISA,May B of A Payment,,HJ,,7250.43,1890418.5
1001,6/4/2021,6/4/2021,Bank of America VISA,May B of A Payment,,HJ,,7804.23,1882614.27
1001,6/4/2021,6/4/2021,Bank of America VISA,May B of A Payment,,HJ,,8505.99,1874108.28
1001,6/4/2021,6/4/2021,Bank of America VISA,May B of A Payment,,HJ,,14156.9,1859951.38
1001,6/4/2021,6/4/2021,Bank of America VISA,May B of A Payment,,HJ,,28703.22,1831248.16
1001,6/4/2021,6/4/2021,HRKnowledge,HR Outsourcing Admin fee for Staff and Fellows PD,,HJ,,126.5,1831121.66
1001,6/4/2021,6/4/2021,HRKnowledge,HR Outsourcing Admin fee for Staff and Fellows PD,,HJ,,145.8,1830975.86
1001,6/4/2021,6/4/2021,HRKnowledge,HR Outsourcing Admin fee for Staff and Fellows PD,,HJ,,195.5,1830780.36
1001,6/4/2021,6/4/2021,HRKnowledge,HR Outsourcing Admin fee for Staff and Fellows PD,,HJ,,195.5,1830584.86
1001,6/4/2021,6/4/2021,HRKnowledge,HR Outsourcing Admin fee for Staff and Fellows PD,,HJ,,631.8,1829953.06
1001,6/4/2021,6/4/2021,HRKnowledge,HR Outsourcing Admin fee for Staff and Fellows PD,,HJ,,632.5,1829320.56
1001,6/4/2021,6/4/2021,HRKnowledge,HR Outsourcing Admin fee for Staff and Fellows PD,,HJ,,4082.4,1825238.16
1001,6/4/2021,6/4/2021,Julie Balfour,Bill.Com Import,,HJ,,3333.34,1821904.82
1001,6/4/2021,6/4/2021,West End Investments,Bill.Com Import,,HJ,,1000,1820904.82
1001,6/7/2021,6/7/2021,Comcast,June Comcast Bill,,HJ,,139.55,1820765.27
1001,6/7/2021,6/7/2021,Emptech,Bill.Com Import,,HJ,,592,1820173.27
1001,6/8/2021,6/8/2021,Eversource,Eversource Payment June 2021,,HJ,,31.18,1820142.09
1001,6/8/2021,6/8/2021,West End Investments,Bill.Com Import,,HJ,,700,1819442.09
1001,6/8/2021,6/8/2021,West End Investments,Bill.Com Import,,HJ,,1250,1818192.09
1001,6/9/2021,6/9/2021,Inspire Business Cen,Jackson,,HJ,,985.8,1817206.29
1001,6/9/2021,6/9/2021,Verizon,Verizon Bill June 2021,,HJ,,49.58,1817156.71
1001,6/9/2021,6/9/2021,Verizon,Verizon Bill June 2021,,HJ,,76.64,1817080.07
1001,6/9/2021,6/9/2021,Verizon,Verizon Bill June 2021,,HJ,,76.64,1817003.43
1001,6/9/2021,6/9/2021,Verizon,Verizon Bill June 2021,,HJ,,247.94,1816755.49
1001,6/9/2021,6/9/2021,Verizon,Verizon Bill June 2021,,HJ,,716.17,1816039.32
1001,6/9/2021,6/9/2021,Verizon,Verizon Bill June 2021,,HJ,,1106.82,1814932.5
1001,6/9/2021,6/9/2021,Verizon,Verizon Bill June 2021,,HJ,,1106.82,1813825.68
1001,6/9/2021,6/9/2021,Verizon,Verizon Bill June 2021,,HJ,,3580.89,1810244.79
1001,6/10/2021,6/10/2021,CD-21-0313,Check 2028,,HJ,,25,1810219.79
1001,6/10/2021,6/10/2021,claice Jackson,Imported from reimbursements,,HJ,,14.56,1810205.23
1001,6/10/2021,6/10/2021,Kyra Detone,Imported from reimbursements,,HJ,,258.4,1809946.83
1001,6/10/2021,6/10/2021,Maryellen Leneghan,Imported from reimbursements,,HJ,,189.39,1809757.44
1001,6/10/2021,6/10/2021,Melissa McElwee,Imported from reimbursements,,HJ,,133.1,1809624.34
1001,6/10/2021,6/10/2021,Mighty Good Agency,Bill.Com Import,,HJ,,1500,1808124.34
1001,6/10/2021,6/10/2021,Monivett Acevedo,Imported from reimbursements,,HJ,,4.65,1808119.69
1001,6/10/2021,6/10/2021,Monivett Acevedo,Imported from reimbursements,,HJ,,6.37,1808113.32
1001,6/10/2021,6/10/2021,Monivett Acevedo,Imported from reimbursements,,HJ,,6.53,1808106.79
1001,6/10/2021,6/10/2021,Monivett Acevedo,Imported from reimbursements,,HJ,,11.99,1808094.8
1001,6/10/2021,6/10/2021,Monivett Acevedo,Imported from reimbursements,,HJ,,14.86,1808079.94
1001,6/10/2021,6/10/2021,Monivett Acevedo,Imported from reimbursements,,HJ,,28.94,1808051
1001,6/10/2021,6/10/2021,Monivett Acevedo,Imported from reimbursements,,HJ,,53,1807998
1001,6/11/2021,6/11/2021,ADP,ADP Payroll Fee for PD.0611,,HJ,,208.96,1807789.04
1001,6/11/2021,6/11/2021,ADP,ADP Payroll Fee for PD.0611,,HJ,,269.7,1807519.34
1001,6/11/2021,6/11/2021,ADP,ADP Payroll Fee for PD.0611,,HJ,,416.81,1807102.53
1001,6/11/2021,6/11/2021,ADP,ADP Payroll Fee for PD.0611,,HJ,,416.81,1806685.72
1001,6/11/2021,6/11/2021,ADP,ADP Payroll Fee for PD.0611,,HJ,,905.51,1805780.21
1001,6/11/2021,6/11/2021,ADP,ADP Payroll Fee for PD.0611,,HJ,,1348.53,1804431.68
1001,6/11/2021,6/11/2021,ADP,ADP Payroll Fee for PD.0611,,HJ,,5850.96,1798580.72
1001,6/14/2021,6/14/2021,ADP,ADP state UI filings and penalties June 2021,,HJ,,14.35,1798566.37
1001,6/14/2021,6/14/2021,ADP,ADP state UI filings and penalties June 2021,,HJ,,29.75,1798536.62
1001,6/14/2021,6/14/2021,ADP,ADP state UI filings and penalties June 2021,,HJ,,62.16,1798474.46
1001,6/14/2021,6/14/2021,ADP,ADP state UI filings and penalties June 2021,,HJ,,128.94,1798345.52
1001,6/14/2021,6/14/2021,ADP,ADP state UI filings and penalties June 2021,,HJ,,401.66,1797943.86
1001,6/14/2021,6/14/2021,ADP,ADP state UI filings and penalties June 2021,,HJ,,833.14,1797110.72
1001,6/14/2021,6/14/2021,ADP,ADP state UI filings and penalties June 2021,,HJ,,1447.86,1795662.86
1001,6/14/2021,6/14/2021,ADP,ADP state UI filings and penalties June 2021,,HJ,,1501.21,1794161.65
1001,6/14/2021,6/14/2021,JE-21-0233,Fund Transfer,,HJ,851000,,2645161.65
1001,6/14/2021,6/14/2021,JE-21-0238,PRPD 06152021 LUX,,HJ,225.86,,2645387.51
1001,6/14/2021,6/14/2021,JE-21-0238,PRPD 06152021 LUX,,HJ,,260.44,2645127.07
1001,6/14/2021,6/14/2021,JE-21-0238,PRPD 06152021 LUX,,HJ,2372.02,,2647499.09
1001,6/14/2021,6/14/2021,JE-21-0238,PRPD 06152021 LUX,,HJ,,120279.02,2527220.07
1001,6/14/2021,6/14/2021,Joseph Zarate,Imported from reimbursements,,HJ,,44.07,2527176
1001,6/14/2021,6/14/2021,Joseph Zarate,Imported from reimbursements,,HJ,,156.36,2527019.64
1001,6/14/2021,6/14/2021,Joseph Zarate,Imported from reimbursements,,HJ,,303.96,2526715.68
1001,6/14/2021,6/14/2021,Wipfli LLP,Bill.Com Import,,HJ,,9000,2517715.68
1001,6/15/2021,6/15/2021,61521,82L-IMPORT PAYROLL,,HJ,,2437.5,2515278.18
1001,6/15/2021,6/15/2021,61521,82L-IMPORT PAYROLL,,HJ,,2749.35,2512528.83
1001,6/15/2021,6/15/2021,61521,82L-IMPORT PAYROLL,,HJ,,6675.57,2505853.26
1001,6/15/2021,6/15/2021,61521,82L-IMPORT PAYROLL,,HJ,,9617.88,2496235.38
1001,6/15/2021,6/15/2021,61521,82L-IMPORT PAYROLL,,HJ,,16965.08,2479270.3
1001,6/15/2021,6/15/2021,61521,82L-IMPORT PAYROLL,,HJ,,17662.57,2461607.73
1001,6/15/2021,6/15/2021,61521,82L-IMPORT PAYROLL,,HJ,,21284.8,2440322.93
1001,6/15/2021,6/15/2021,61521,82L-IMPORT PAYROLL,,HJ,,22327.29,2417995.64
1001,6/15/2021,6/15/2021,61521,82L-IMPORT PAYROLL,,HJ,,30586.92,2387408.72
1001,6/15/2021,6/15/2021,61521,82L-IMPORT PAYROLL,,HJ,,43192.59,2344216.13
1001,6/15/2021,6/15/2021,61521,82L-IMPORT PAYROLL,,HJ,,89992.94,2254223.19
1001,6/15/2021,6/15/2021,61521,82L-IMPORT PAYROLL,,HJ,,122684.47,2131538.72
1001,6/15/2021,6/15/2021,ARIF-20210615-1,Americorp Reimbursement for MAy,,HJ,199848.94,,2331387.66
1001,6/15/2021,6/15/2021,Carpenter Bernier Co,Bill.Com Import,,HJ,,8880,2322507.66
1001,6/15/2021,6/15/2021,claice Jackson,Imported from reimbursements,,HJ,,24.64,2322483.02
1001,6/15/2021,6/15/2021,claice Jackson,Imported from reimbursements,,HJ,,33.6,2322449.42
1001,6/15/2021,6/15/2021,Greenhouse Software,Bill.Com Import,,HJ,,9083.1,2313366.32
1001,6/15/2021,6/15/2021,Karl W. Reid,Bill.Com Import,,HJ,,1059.6,2312306.72
1001,6/15/2021,6/15/2021,"TAG Resources, LLC",Employee 401K Payment PD06.14,,HJ,,7439.99,2304866.73
1001,6/15/2021,6/15/2021,TASC,Bill.Com Import,,HJ,,165,2304701.73
1001,6/15/2021,6/15/2021,Unionville- Chadds F,Receipt from Unionville,,HJ,363,,2305064.73
1001,6/16/2021,6/16/2021,Abila,Bill.Com Import,,HJ,,110,2304954.73
1001,6/16/2021,6/16/2021,Abila,Bill.Com Import,,HJ,,250,2304704.73
1001,6/16/2021,6/16/2021,ADP,ADP state UI filings and penalties June 2021,,HJ,,7.68,2304697.05
1001,6/16/2021,6/16/2021,TASC,TASC Payment June 2021,,HJ,,2668.24,2302028.81
1001,6/17/2021,6/17/2021,ADP,ADP state UI filings and penalties June 2021,,HJ,,204.98,2301823.83
1001,6/17/2021,6/17/2021,T-Mobile,T-Mobile June Payment,,HJ,,61.78,2301762.05
1001,6/17/2021,6/17/2021,T-Mobile,T-Mobile June Payment,,HJ,,95.47,2301666.58
1001,6/17/2021,6/17/2021,T-Mobile,T-Mobile June Payment,,HJ,,95.47,2301571.11
1001,6/17/2021,6/17/2021,T-Mobile,T-Mobile June Payment,,HJ,,308.88,2301262.23
1001,6/18/2021,6/18/2021,AFLAC,Aflec Payment June 2021,,HJ,,51.36,2301210.87
1001,6/18/2021,6/18/2021,AFLAC,Aflec Payment June 2021,,HJ,,66.14,2301144.73
1001,6/18/2021,6/18/2021,AFLAC,Aflec Payment June 2021,,HJ,,89.64,2301055.09
1001,6/21/2021,6/21/2021,ACCURATE BIOMETRICS,Bill.Com Import,,HJ,,60.25,2300994.84
1001,6/21/2021,6/21/2021,ACCURATE BIOMETRICS,Bill.Com Import,,HJ,,120.5,2300874.34
1001,6/21/2021,6/21/2021,Grubhub,Bill.Com Import,,HJ,,31.8,2300842.54
1001,6/21/2021,6/21/2021,Grubhub,Bill.Com Import,,HJ,,31.8,2300810.74
1001,6/21/2021,6/21/2021,Grubhub,Bill.Com Import,,HJ,,49.57,2300761.17
1001,6/21/2021,6/21/2021,Grubhub,Bill.Com Import,,HJ,,63.08,2300698.09
1001,6/21/2021,6/21/2021,Grubhub,Bill.Com Import,,HJ,,167.03,2300531.06
1001,6/21/2021,6/21/2021,Grubhub,Bill.Com Import,,HJ,,168.82,2300362.24
1001,6/21/2021,6/21/2021,Grubhub,Bill.Com Import,,HJ,,195.12,2300167.12
1001,6/21/2021,6/21/2021,Grubhub,Bill.Com Import,,HJ,,553.96,2299613.16
1001,6/21/2021,6/21/2021,Grubhub,Bill.Com Import,,HJ,,904.78,2298708.38
1001,6/21/2021,6/21/2021,HRKnowledge,HRKK Virtual Partner Fee June 2021,,HJ,,2500,2296208.38
1001,6/21/2021,6/21/2021,HRKnowledge,HRK Admin Outsourcing Fee,,HJ,,1500,2294708.38
1001,6/21/2021,6/21/2021,HRKnowledge,HRK Admin Outsourcing Fee,,HJ,,1610,2293098.38
1001,6/21/2021,6/21/2021,HRKnowledge,HRKnowledge Outsourcing Fee Fellows,,HJ,,125.4,2292972.98
1001,6/21/2021,6/21/2021,HRKnowledge,HRKnowledge Outsourcing Fee Fellows,,HJ,,165,2292807.98
1001,6/21/2021,6/21/2021,HRKnowledge,HRKnowledge Outsourcing Fee Fellows,,HJ,,193.8,2292614.18
1001,6/21/2021,6/21/2021,HRKnowledge,HRKnowledge Outsourcing Fee Fellows,,HJ,,193.8,2292420.38
1001,6/21/2021,6/21/2021,HRKnowledge,HRKnowledge Outsourcing Fee Fellows,,HJ,,255,2292165.38
1001,6/21/2021,6/21/2021,HRKnowledge,HRKnowledge Outsourcing Fee Fellows,,HJ,,255,2291910.38
1001,6/21/2021,6/21/2021,HRKnowledge,HRKnowledge Outsourcing Fee Fellows,,HJ,,627,2291283.38
1001,6/21/2021,6/21/2021,HRKnowledge,HRKnowledge Outsourcing Fee Fellows,,HJ,,825,2290458.38
1001,6/21/2021,6/21/2021,Leslie Wade LLC,Bill.Com Import,,HJ,,10400,2280058.38
1001,6/21/2021,6/21/2021,Media Cause,Bill.Com Import,,HJ,,5605,2274453.38
1001,6/21/2021,6/21/2021,Media Cause,Bill.Com Import,,HJ,,14301.25,2260152.13
1001,6/21/2021,6/21/2021,Media Cause,Bill.Com Import,,HJ,,16355,2243797.13
1001,6/22/2021,6/22/2021,Anonymous,Anonymous Donation,,HJ,50,,2243847.13
1001,6/22/2021,6/22/2021,Nantahala Schools,Receipt of Payment from Nantahala School – Macon County,,HJ,44.19,,2243891.32
1001,6/22/2021,6/22/2021,Teads Inc,Bill.Com Import,,HJ,,3166.94,2240724.38
1001,6/23/2021,6/23/2021,Leslie Guthrie,Imported from reimbursements,,HJ,,75.04,2240649.34
1001,6/23/2021,6/23/2021,Leslie Guthrie,Imported from reimbursements,,HJ,,254.43,2240394.91
1001,6/23/2021,6/23/2021,Melissa McElwee,Imported from reimbursements,,HJ,,9,2240385.91
1001,6/23/2021,6/23/2021,Melissa McElwee,Imported from reimbursements,,HJ,,136,2240249.91
1001,6/23/2021,6/23/2021,Sharanya Balasubrama,Imported from reimbursements,,HJ,,21.16,2240228.75
1001,6/23/2021,6/23/2021,Sharanya Balasubrama,Imported from reimbursements,,HJ,,23.7,2240205.05
1001,6/23/2021,6/23/2021,Sharanya Balasubrama,Imported from reimbursements,,HJ,,47.4,2240157.65
1001,6/23/2021,6/23/2021,Woot Math Acquisiti,Received revenue from Woot Math. June 2021,,HJ,42.61,,2240200.26
1001,6/24/2021,6/24/2021,ADP,ADP state UI filings and penalties June 2021,,HJ,,4.58,2240195.68
1001,6/28/2021,6/28/2021,Blackbaud GivingFund,Receipt of 25$ Donation,,HJ,25,,2240220.68
1001,6/28/2021,6/28/2021,"Dstillery, Inc.",Bill.Com Import,,HJ,,980.8,2239239.88
1001,6/28/2021,6/28/2021,"Dstillery, Inc.",Bill.Com Import,,HJ,,1188,2238051.88
1001,6/28/2021,6/28/2021,"Dstillery, Inc.",Bill.Com Import,,HJ,,1515.78,2236536.1
1001,6/28/2021,6/28/2021,"Dstillery, Inc.",Bill.Com Import,,HJ,,1515.78,2235020.32
1001,6/28/2021,6/28/2021,"Dstillery, Inc.",Bill.Com Import,,HJ,,1836,2233184.32
1001,6/28/2021,6/28/2021,"Dstillery, Inc.",Bill.Com Import,,HJ,,1836,2231348.32
1001,6/28/2021,6/28/2021,"Dstillery, Inc.",Bill.Com Import,,HJ,,4903.99,2226444.33
1001,6/28/2021,6/28/2021,"Dstillery, Inc.",Bill.Com Import,,HJ,,5940,2220504.33
1001,6/28/2021,6/28/2021,Salesforce.org,Bill.Com Import,,HJ,,25416,2195088.33
1001,6/28/2021,6/28/2021,Walnut Street Realty,Bill.Com Import,,HJ,,2192.58,2192895.75
1001,6/28/2021,6/28/2021,WEINBERG,Receipt of funds from Weinberg,,HJ,150000,,2342895.75
1001,6/28/2021,6/28/2021,West End Investments,Bill.Com Import,,HJ,,1250,2341645.75
1001,6/28/2021,6/28/2021,Whiteboard,Bill.Com Import,,HJ,,5000,2336645.75
1001,6/28/2021,6/28/2021,Whiteboard,Bill.Com Import,,HJ,,10000,2326645.75
1001,6/28/2021,6/28/2021,Whiteboard,Bill.Com Import,,HJ,,17500,2309145.75
1001,6/28/2021,6/28/2021,Whiteboard,Bill.Com Import,,HJ,,19772.76,2289372.99
1001,6/28/2021,6/28/2021,Woot Math Acquisiti,Received revenue from Woot Math. June 2021,,HJ,42.61,,2289415.6
1001,6/30/2021,6/30/2021,63021,82L-IMPORT PAYROLL,,HJ,,1191.67,2288223.93
1001,6/30/2021,6/30/2021,63021,82L-IMPORT PAYROLL,,HJ,,2749.35,2285474.58
1001,6/30/2021,6/30/2021,63021,82L-IMPORT PAYROLL,,HJ,,5134.39,2280340.19
1001,6/30/2021,6/30/2021,63021,82L-IMPORT PAYROLL,,HJ,,14662.94,2265677.25
1001,6/30/2021,6/30/2021,63021,82L-IMPORT PAYROLL,,HJ,,21209.8,2244467.45
1001,6/30/2021,6/30/2021,63021,82L-IMPORT PAYROLL,,HJ,,30860.22,2213607.23
1001,6/30/2021,6/30/2021,63021,82L-IMPORT PAYROLL,,HJ,,83446.07,2130161.16
1001,6/30/2021,6/30/2021,63021,82L-IMPORT PAYROLL,,HJ,,110113.68,2020047.48
1001,6/30/2021,6/30/2021,63021,82L-IMPORT PAYROLL,,HJ,,163761.75,1856285.73
1001,6/30/2021,6/30/2021,JE-21-0245,LUX PR-PD 20210630,,HJ,,121.83,1856163.9
1001,6/30/2021,6/30/2021,JE-21-0245,LUX PR-PD 20210630,,HJ,248.18,,1856412.08
1001,6/30/2021,6/30/2021,JE-21-0245,LUX PR-PD 20210630,,HJ,2135.03,,1858547.11
1001,6/30/2021,6/30/2021,JE-21-0245,LUX PR-PD 20210630,,HJ,,56853.31,1801693.8
1001,6/30/2021,6/30/2021,Woot Math Acquisiti,Received revenue from Woot Math. June 2021,,HJ,42.61,,1801736.41
1001,6/30/2021,6/30/2021,Woot Math Acquisiti,Received revenue from Woot Math. June 2021,,HJ,42.61,,1801779.02
1001, Totals for 1001 - Bank of America- Checking -Acct. 6488,,,,,,19278333.66,18101459.04,1801779.02
1005,1005 - Bank of America- Interest Earning Checking -Acct. 8984 (Balance forward As of 07/01/2020) ,,,,,,,,3000692.64
1005,7/9/2020,7/9/2020,20200709,To Record TASC Credit For Fellows-To record TASC credit for fellows,,HJ,1081.89,,3001774.53
1005,7/9/2020,7/9/2020,GATES,Received fund from GATES-Received fund from GATES,,HJ,2400000,,5401774.53
1005,7/15/2020,7/15/2020,20200715,Fund transfer from #8984-Fund transfer from #8984,,HJ,,401000,5000774.53
1005,7/27/2020,7/27/2020,CPS,Received CPS payment-Received CPS payment,,HJ,251500,,5252274.53
1005,7/31/2020,7/31/2020,20200731,To record analysis fee and interest earned-To record analysis fee and interest earned,,HJ,33.93,,5252308.46
1005,8/7/2020,8/7/2020,20200807,Insurance payment from Sara and Julia-Insurance payment from Sara and Julia,,HJ,1128.69,,5253437.15
1005,8/12/2020,8/12/2020,20200812,Transfer from #8984 to #6488-Transfer from #8984 to #6488,,HJ,,452000,4801437.15
1005,8/17/2020,8/17/2020,20200817,Account analysis fee for #8984-Account analysis fee for #8984,,HJ,,3.4,4801433.75
1005,8/26/2020,8/26/2020,20200826,Online banking transfer from #8984 to #6488-Online banking transfer from #8984 to #6488,,HJ,,551000,4250433.75
1005,8/31/2020,8/31/2020,20200831,Interest earned in August-Interest earned in August,,HJ,2.87,,4250436.62
1005,9/10/2020,9/10/2020,20200910,Transfer from #8984 to #6488-Transfer from #8984 to #6488,,HJ,,250000,4000436.62
1005,9/10/2020,9/10/2020,GATES,Received fund from Gates-Received fund from Gates,,HJ,98318,,4098754.62
1005,9/10/2020,9/10/2020,TASC,Insurance credit for from Sara & Julia-Insurance credit for Sara & Julia,,HJ,1128.69,,4099883.31
1005,9/15/2020,9/15/2020,20200915,Transfer from #8984 to #6488-Transfer from #8984 to #6488,,HJ,,99000,4000883.31
1005,9/16/2020,9/16/2020,20200916,Transfer from #8984 to #6488-Transfer from #8984 to #6488,,HJ,,250000,3750883.31
1005,9/23/2020,9/23/2020,20200923,To record Goodwill credit interest earned-To record goodwill credit for interest earned,,HJ,200.79,,3751084.1
1005,9/28/2020,9/28/2020,20200928,Transfer from #8984 to #6488-Transfer from #8984 to #6488,,HJ,,351000,3400084.1
1005,10/7/2020,10/7/2020,ins-Oct,Insurance credit from Julia Martin-Insurance credit from Julia Martin,,HJ,527.54,,3400611.64
1005,10/15/2020,10/15/2020,20201015,Received the payment from G-SSM-Received the payment from G-SSM,,HJ,1000000,,4400611.64
1005,10/15/2020,10/15/2020,20201015,Business account analysis fee-Business account analysis fee,,HJ,,1.5,4400610.14
1005,10/15/2020,10/15/2020,GATES,Received payment from Gates foundation-Received payment from Gates foundation,,HJ,1000000,,5400610.14
1005,10/15/2020,10/15/2020,GATES,To add back the receivable for the wrong entry-To add back the receivable for the wrong entry,,HJ,,1000000,4400610.14
1005,10/16/2020,10/16/2020,WM,Cash received from Woot Math Acquisition-Cash received from Woot Math Acquisition,,HJ,,5356.31,4395253.83
1005,10/16/2020,10/16/2020,WM,Cash received from Woot Math Acquisition-Cash received from Woot Math Acquisition,,HJ,306618.17,,4701872
1005,10/19/2020,10/19/2020,20201019,Transfer from #8984 to #6488-Transfer from #8984 to #6488,,HJ,,701000,4000872
1005,10/22/2020,10/22/2020,20201022,Transfer from #6488 to #8984-Transfer from #6488 to #8984,,HJ,2400000,,6400872
1005,10/30/2020,10/30/2020,VENTUREFUND,Payment from New Schools -Woot Math Acquisition-Payment from New Schools -Woot Math Acquisition,,HJ,200000,,6600872
1005,11/9/2020,11/9/2020,20201109,Julia Martin insurance repayment-Julia Martin insurance repayment,,HJ,527.54,,6601399.54
1005,11/9/2020,11/9/2020,CPS,Received BPS payment for September-Received BPS payment for September,,HJ,282000,,6883399.54
1005,11/16/2020,11/16/2020,20201116,Account analysis fee for November-Account analysis fee for November,,HJ,,8.7,6883390.84
1005,11/25/2020,11/25/2020,20201125,Transfer from #8984 account to #6488 account-Transfer from #8984 account to #6488 account,,HJ,,883000,6000390.84
1005,12/2/2020,12/2/2020,20201202,To correct the cash account for AR entry-To correct the cash account for AR entry-CPS October payment,,HJ,282000,,6282390.84
1005,12/4/2020,12/4/2020,Comcast,Received payment from Comcast-Received payment from Comcast,,HJ,250000,,6532390.84
1005,12/8/2020,12/8/2020,20201208,Julia Martin insurance repayment-Julia Martin insurance repayment,,HJ,527.54,,6532918.38
1005,12/9/2020,12/9/2020,20201209,Transfer from #8984 to #6488-Transfer from #8984 to #6488,,HJ,,532000,6000918.38
1005,12/31/2020,12/31/2020,CPS,Received CPS November payment-Received CPS November payment,,HJ,282000,,6282918.38
1005,1/7/2021,1/7/2021,20210107,Transfer from #8984 to checking #6488 account-Transfer from #8984 to checking #6488 account,,HJ,,283000,5999918.38
1005,1/7/2021,1/7/2021,20210107,Julia Martin insurance repayment January 2021-Julia Martin insurance repayment January 2021,,HJ,527.54,,6000445.92
1005,1/12/2021,1/12/2021,2147795897,Transfer from Acct #8984 to #6488-Transfer from Acct #8984 to #6488,,HJ,,500000,5500445.92
1005,1/15/2021,1/15/2021,20210115,Acct 8984 Analysis Fee 1005-Acct 8984 Analysis Fee 1005,,HJ,,1.8,5500444.12
1005,1/25/2021,1/25/2021,Haarlem,Received payment from Haarlem-Received payment from Haarlem,,HJ,6362,,5506806.12
1005,2/1/2021,2/1/2021,CPS,Receipt from CPS-Receipt from CPS,,HJ,282000,,5788806.12
1005,2/8/2021,2/8/2021,CPS,Receipt from option schools-Receipt from option schools,,HJ,40310.25,,5829116.37
1005,2/8/2021,2/8/2021,CPS,Receipt from option schools-Receipt from option schools,,HJ,40310.25,,5869426.62
1005,2/16/2021,2/16/2021,20210216,Acct 8984 Analysis Fee 1005 Feb21-Acct 8984 Analysis Fee 1005 Feb21,,HJ,,77.95,5869348.67
1005,2/19/2021,2/19/2021,GATES,Receipt from GATES-Receipt from GATES,,HJ,600000,,6469348.67
1005,3/2/2021,3/2/2021,20210302,Transfer from #8984 to checking #6488 account,,HJ,,469000,6000348.67
1005,3/3/2021,3/3/2021,CPS,CPS and Option School Receipts,,HJ,40310.25,,6040658.92
1005,3/3/2021,3/3/2021,CPS,CPS and Option School Receipts,,HJ,282000,,6322658.92
1005,3/8/2021,3/8/2021,20210308,Acct 8984 Analysis Fee and Refund 1005 Mar21,,HJ,73.65,,6322732.57
1005,3/15/2021,3/15/2021,20210315,Transfer from #8984 to checking #6488 account,,HJ,,322000,6000732.57
1005,3/24/2021,3/24/2021,20210324,Transfer from #8984 to checking #6488 account,,HJ,,500000,5500732.57
1005,3/31/2021,3/31/2021,CPS,CPS and Option School Receipt,,HJ,40310.25,,5541042.82
1005,3/31/2021,3/31/2021,CPS,CPS and Option School Receipt,,HJ,282000,,5823042.82
1005,4/12/2021,4/12/2021,20210412,Transfer from #8984 to Checking #6488 account,,HJ,,623000,5200042.82
1005,4/15/2021,4/15/2021,202103,Acct 8984 Analysis Fee April 2021,,HJ,,75.9,5199966.92
1005,5/3/2021,5/3/2021,CPS,Receipt of CPS27 and CPS-OPSCH005,,HJ,40310.25,,5240277.17
1005,5/3/2021,5/3/2021,CPS,Receipt of CPS27 and CPS-OPSCH005,,HJ,282000,,5522277.17
1005,5/13/2021,5/13/2021,20210321,Acct 8984 Analysis Fee Refund May 2021,,HJ,75.9,,5522353.07
1005,5/26/2021,5/26/2021,JE-21-054,Adjustment for Currency Difference,,HJ,,40,5522313.07
1005,5/26/2021,5/26/2021,ROTTERDAM,Receipt of Payment for Bridge Consulting Netherlands,,HJ,6377,,5528690.07
1005,6/1/2021,6/1/2021,CPS,Receipt of April CPS and Option School Payment,,HJ,40310.25,,5569000.32
1005,6/1/2021,6/1/2021,CPS,Receipt of April CPS and Option School Payment,,HJ,282000,,5851000.32
1005,6/14/2021,6/14/2021,JE-21-0233,Fund Transfer,,HJ,,851000,5000000.32
1005,6/24/2021,6/24/2021,202106,Acct 8984 Analysis Fee June 2021,,HJ,,2.95,4999997.37
1005, Totals for 1005 - Bank of America- Interest Earning Checking -Acct. 8984,,,,,,11022873.24,9023568.51,4999997.37
1008,1008 - Bank of America- Checking II -Acct. 6491 (Balance forward As of 07/01/2020) ,,,,,,,,100
1008, Totals for 1008 - Bank of America- Checking II -Acct. 6491,,,,,,0,0,100
1100,1100 - Restricted Cash-Fund held for other (Balance forward As of 07/01/2020) ,,,,,,,,0
1100,7/24/2020,7/24/2020,1,To reverse the Woot Math entries-Woot Math July Reimb Reclass,,HJ,24858.59,,24858.59
1100,7/24/2020,7/24/2020,1,Woot Math July Reimb Reclass-Woot Math July Reimb Reclass,,HJ,,24858.59,0
1100,9/22/2020,9/22/2020,JE-21-0038,Woot Math July Reimb-Woot Math July Reimb Reclass,,HJ,,52437.74,-52437.74
1100,9/22/2020,9/22/2020,JE-21-0038,To reverse the Woot Math entries-Woot Math July Reimb Reclass,,HJ,52437.74,,0
1100,9/22/2020,9/22/2020,JE-21-0039,Woot Math August Reimb-Woot Math August Reimb Reclass,,HJ,,85324.32,-85324.32
1100,9/22/2020,9/22/2020,JE-21-0039,To reverse the Woot Math entries-Woot Math August Reimb Reclass,,HJ,85324.32,,0
1100, Totals for 1100 - Restricted Cash-Fund held for other,,,,,,162620.65,162620.65,0
1101,1101 - Contra-Restricted cash-Fund held for other (Balance forward As of 07/01/2020) ,,,,,,,,0
1101,7/24/2020,7/24/2020,1,To reverse the Woot Math entries-Woot Math July Reimb Reclass,,HJ,,24858.59,-24858.59
1101,7/24/2020,7/24/2020,1,Woot Math July Reimb Reclass-Woot Math July Reimb Reclass,,HJ,24858.59,,0
1101,9/22/2020,9/22/2020,JE-21-0038,Woot Math July Reimb-Woot Math July Reimb Reclass,,HJ,52437.74,,52437.74
1101,9/22/2020,9/22/2020,JE-21-0038,To reverse the Woot Math entries-Woot Math July Reimb Reclass,,HJ,,52437.74,0
1101,9/22/2020,9/22/2020,JE-21-0039,Woot Math August Reimb-Woot Math August Reimb Reclass,,HJ,85324.32,,85324.32
1101,9/22/2020,9/22/2020,JE-21-0039,To reverse the Woot Math entries-Woot Math August Reimb Reclass,,HJ,,85324.32,0
1101, Totals for 1101 - Contra-Restricted cash-Fund held for other,,,,,,162620.65,162620.65,0
1200,1200 - Grants and Accounts Receivable (Balance forward As of 07/01/2020) ,,,,,,,,1164818
1200,7/1/2020,7/1/2020,CLARK,AR Balance Import 3/31/20-AR Balance Import 3/31/20,,HJ,635000,,1799818
1200,7/1/2020,7/1/2020,CLARK,Reverse and Correct: Clark and Gates-AR Balance Import 3/31/20,,HJ,,635000,1164818
1200,7/7/2020,7/7/2020,,"This is to correct the Gates-NYC Receivable. On 9/23/2021 we thought we corrected the Gates-NYC receivable, however the system did not auto generate a reversal. On 9/23/2021 we moved the funds from Funding Sources Gates-NYC to Gates- Online Model to better reflect the funding sources. This was our first correction to the systems historical data. This entry is taking the 870,000 from Gates- NYC so that the Statement of Activity is correct with June 30, 2021.",D108,GJ,,870000,294818
1200,7/7/2020,7/7/2020,,"This is to correct the Gates-NYC Receivable. On 9/23/2021 we thought we corrected the Gates-NYC receivable, however the system did not auto generate a reversal. On 9/23/2021 we moved the funds from Funding Sources Gates-NYC to Gates- Online Model to better reflect the funding sources. This was our first correction to the systems historical data. This entry is taking the 870,000 from Gates- NYC so that the Statement of Activity is correct with June 30, 2021.",D108,GJ,,870000,-575182
1200,7/7/2020,7/7/2020,AR-000020,Invoice - Gates- Online Model: Moving entry from Gates-NYC to Gates- Online model to better reflect funding sources. Original Entry: Gates NYC 6/30/2021 to 8/30/2022,D108,ARJ,870000,,294818
1200,7/7/2020,7/7/2020,GATES,To record receivable for Gates-NYC-To record receivable for Gates-NYC-12/31/20-6/30/21,,HJ,600000,,894818
1200,7/7/2020,7/7/2020,GATES,To record receivable for Gates-NYC-To record receivable for Gates-NYC-Dec 31 2020,,HJ,2400000,,3294818
1200,7/7/2020,7/7/2020,GATES,To record receivable for Gates-NYC-To record receivable for Gates-NYC6/30/21-8/30/22,,HJ,1870000,,5164818
1200,7/7/2020,7/7/2020,GATES,To correct the source coding-To record receivable for Gates-NYC-12/31/20-6/30/21,,HJ,,600000,4564818
1200,7/7/2020,7/7/2020,GATES,To correct the source coding-To record receivable for Gates-NYC-12/31/20-6/30/21,,HJ,600000,,5164818
1200,7/7/2020,7/7/2020,GATES,To correct the source coding-To record receivable for Gates-NYC-Dec 31 2020,,HJ,,2400000,2764818
1200,7/7/2020,7/7/2020,GATES,To correct the source coding-To record receivable for Gates-NYC-Dec 31 2020,,HJ,2400000,,5164818
1200,7/7/2020,7/7/2020,GATES,To correct the source coding-To record receivable for Gates-NYC6/30/21-8/30/22,,HJ,,1870000,3294818
1200,7/7/2020,7/7/2020,GATES,To correct the source coding-To record receivable for Gates-NYC6/30/21-8/30/22,,HJ,1870000,,5164818
1200,7/8/2020,7/8/2020,Reversed - GJ#140,"Reversed -- This is to correct the Gates-NYC Receivable. On 9/23/2021 we thought we corrected the Gates-NYC receivable, however the system did not auto generate a reversal. On 9/23/2021 we moved the funds from Funding Sources Gates-NYC to Gates- Online Model to better reflect the funding sources. This was our first correction to the systems historical data. This entry is taking the 870,000 from Gates- NYC so that the Statement of Activity is correct with June 30, 2021.",D108,GJ,870000,,6034818
1200,7/9/2020,7/9/2020,GATES,Received fund from GATES-Received fund from GATES,,HJ,,2400000,3634818
1200,7/10/2020,7/10/2020,Citadel Foundation,To record receivable for Citadel Foundation for FY21-To record receivable for Citadel Foundation for FY21,,HJ,3320000,,6954818
1200,7/13/2020,7/13/2020,BET-CH,To record A Better Chicago receivable FY21-To record A Better Chicago receivable FY21,,HJ,75000,,7029818
1200,7/27/2020,7/27/2020,CPS,Received CPS payment-Received CPS payment,,HJ,,251500,6778318
1200,7/30/2020,7/30/2020,Camelot Education,Service income from Camelot Ed-University of CHI EdLabs-Service income from Camelot Ed-University of CHI EdLabs,,HJ,20615,,6798933
1200,7/30/2020,7/30/2020,YCCS,Service income from YCCS-University of Chicago EdLabs-Service income from YCCS-University of Chicago EdLabs,,HJ,20615,,6819548
1200,8/4/2020,8/4/2020,BET-CH,Received A Better Chicago payment-Received A Better Chicago payment,,HJ,,75000,6744548
1200,8/10/2020,8/10/2020,Camelot Education,Received funds from Camelot Education-Received funds from Camelot Education,,HJ,,20615,6723933
1200,8/31/2020,8/31/2020,WALTON,Walton Family Foundation Grant #00103777-Walton Family Foundation Grant #00103777,,HJ,200000,,6923933
1200,8/31/2020,8/31/2020,WALTON,Walnut Move from FY21 to FY22-Walton Family Foundation Grant #00103777,,HJ,,200000,6723933
1200,8/31/2020,8/31/2020,WALTON,Walnut Move from FY21 to FY22-Walton Family Foundation Grant #00103777,,HJ,200000,,6923933
1200,9/4/2020,9/4/2020,WALTON,Received Walton Family Foundation Payment-Received Walton Family Foundation Payment,,HJ,,200000,6723933
1200,9/10/2020,9/10/2020,GATES,Received fund from Gates-Received fund from Gates,,HJ,,98318,6625615
1200,9/28/2020,9/28/2020,LLOYDFRY,Received payment from Fry Foundation-Received payment from Fry Foundation,,HJ,,40000,6585615
1200,9/30/2020,9/30/2020,CPS,CPS September invoicing-CPS September invoicing,,HJ,282000,,6867615
1200,10/5/2020,10/5/2020,YCCS,Received payment from Youth Connection Charter School-Received payment from Youth Connection Charter School,,HJ,,20615,6847000
1200,10/8/2020,10/8/2020,New Profit Inc.,Receivable for the New Profit Inc fund-Receivable for the New Profit Inc fund,,HJ,250000,,7097000
1200,10/8/2020,10/8/2020,New Profit Inc.,To reverse and correct the entry for New Profit-Receivable for the New Profit Inc fund,,HJ,,250000,6847000
1200,10/8/2020,10/8/2020,New Profit Inc.,To reverse and correct the entry for New Profit-To reverse and correct the entry for New Profit,,HJ,1000000,,7847000
1200,10/8/2020,10/8/2020,X Co. NFAMILY,Received X Co. n's FY21 payment-Received X Co. n's year 2 payment of 3 year pledge,,HJ,,25000,7822000
1200,10/9/2020,10/9/2020,GATES,To record G-SSM remaining FY22 receivable-To record G-SSM remaining FY22 receivable,,HJ,202772,,8024772
1200,10/15/2020,10/15/2020,GATES,Received payment from Gates foundation-Received payment from Gates foundation,,HJ,,1000000,7024772
1200,10/15/2020,10/15/2020,GATES,To add back the receivable for the wrong entry-To add back the receivable for the wrong entry,,HJ,1000000,,8024772
1200,10/16/2020,10/16/2020,Woot Math Acquisiti,Receivables from WootMath Acquisition-Receivables from WootMath Acquisition,,HJ,2916.77,,8027688.77
1200,10/20/2020,10/20/2020,New Profit Inc.,Received payment from New Profit-Received payment from New Profit,,HJ,,250000,7777688.77
1200,10/21/2020,10/21/2020,Citadel Foundation,Received payment from CITADE-Received payment from CITADE,,HJ,,2500000,5277688.77
1200,10/29/2020,10/29/2020,VENTUREFUND,To record receivable from EF+MATH-Receivable from new schools-Woot Math Acquisition,,HJ,200000,,5477688.77
1200,10/30/2020,10/30/2020,VENTUREFUND,Payment from New Schools -Woot Math Acquisition-Payment from New Schools -Woot Math Acquisition,,HJ,,200000,5277688.77
1200,10/31/2020,10/31/2020,CPS,Receivable for October service for CPS-Receivable for October service for CPS,,HJ,282000,,5559688.77
1200,11/3/2020,11/3/2020,FINNEGAN,Receivable from Finnegan Family Foundation-Receivable from Finnegan Family Foundation,,HJ,10000,,5569688.77
1200,11/9/2020,11/9/2020,CPS,Received BPS payment for September-Received BPS payment for September,,HJ,,282000,5287688.77
1200,11/13/2020,11/13/2020,IMCCHI,To record receivable for IMC-To record receivable for IMC,,HJ,300000,,5587688.77
1200,11/16/2020,11/16/2020,Woot Math Acquisiti,Deposited check paid to Woot/Simbulus-Deposited check paid to Woot/Simbulus,,HJ,,1512.42,5586176.35
1200,11/18/2020,11/18/2020,ANGELLFAMILY,To record the receivable from Paul M. Agnell foundation-To record the receivable from Paul M. Agnell foundation,,HJ,100000,,5686176.35
1200,11/19/2020,11/19/2020,COLLEGEBOARD,College Board Invoice CB7 - 5/1/2020-8/31/2020-College Board Invoice CB7 - 5/1/2020-8/31/2020,,HJ,72419.35,,5758595.7
1200,11/19/2020,11/19/2020,IMCCHI,Received IMC payment-Received IMC payment,,HJ,,100000,5658595.7
1200,11/23/2020,11/23/2020,Unorthodox Philanthr,Unorthodox Philanthropy (UP) Award receivable-Unorthodox Philanthropy (UP) Award receivable,,HJ,350000,,6008595.7
1200,11/30/2020,11/30/2020,Comcast,To record receivable from Comcast for FY22-To record receivable from Comcast for FY22,,HJ,250000,,6258595.7
1200,11/30/2020,11/30/2020,CPS,Receivable for service provided in November for CPS-Receivable for service provided in November for CPS,,HJ,282000,,6540595.7
1200,11/30/2020,11/30/2020,CPS,Option Schools Invoice-Option Schools Invoice - 201130-CPS-OPSCH001,,HJ,40310.25,,6580905.95
1200,12/2/2020,12/2/2020,CPS,Received CPS October payment-Received CPS October payment,,HJ,,282000,6298905.95
1200,12/4/2020,12/4/2020,Comcast,Received payment from Comcast-Received payment from Comcast,,HJ,,250000,6048905.95
1200,12/16/2020,12/16/2020,Unorthodox Philanthr,Received payment from Unorthodox Phil and Woot Math-Received payment from Unorthodox Phil,,HJ,,350000,5698905.95
1200,12/16/2020,12/16/2020,Woot Math Acquisiti,Received payment from Unorthodox Phil and Woot Math-Received payment for Woot Math,,HJ,,887.3,5698018.65
1200,12/21/2020,12/21/2020,ANGELLFAMILY,Received payment from Paul M Angell-Received payment from Paul M Angell,,HJ,,100000,5598018.65
1200,12/21/2020,12/21/2020,Glendale Unified Sch,WootMath Student License-WootMath Student License,,HJ,55.6,,5598074.25
1200,12/21/2020,12/21/2020,MGSD Online Academy,WootMath Teacher License-WootMath Teacher License,,HJ,188.64,,5598262.89
1200,12/21/2020,12/21/2020,Woot Math Acquisiti,To record receivable for Woot Math Products-To record receivable for Woot Math Products,,HJ,244.24,,5598507.13
1200,12/31/2020,12/31/2020,COLLEGEBOARD,Received CB Payment-Received CB Payment,,HJ,,72419.35,5526087.78
1200,12/31/2020,12/31/2020,CPS,Received CPS November payment-Received CPS November payment,,HJ,,282000,5244087.78
1200,12/31/2020,12/31/2020,CPS,Option school December invoice-Option school December invoice,,HJ,40310.25,,5284398.03
1200,12/31/2020,12/31/2020,CPS,CPS December invoicing-CPS December invoicing,,HJ,282000,,5566398.03
1200,1/14/2021,1/14/2021,FINNEGAN,Received payment from Finnegan-Received payment from Finnegan,,HJ,,10000,5556398.03
1200,1/21/2021,1/21/2021,Citadel Foundation,received from Citadel Foundation-received from Citadel Foundation,,HJ,,820000,4736398.03
1200,1/21/2021,1/21/2021,Great Oaks Legacy,Receivable from great Oaks Legacy Charter School-Receivable from great Oaks Legacy Charter School,,HJ,4975,,4741373.03
1200,1/21/2021,1/21/2021,Haarlem,January receivable for Haarlem-January receivable for Haarlem,,HJ,6362,,4747735.03
1200,1/25/2021,1/25/2021,Haarlem,Received payment from Haarlem-Received payment from Haarlem,,HJ,,6362,4741373.03
1200,1/26/2021,1/26/2021,Providence PSD,Invoicing Providence Public School District for 12/15/20-8/31/2021-Invoicing Providence Public School District for 12/15/20-8/31/2021,,HJ,18000,,4759373.03
1200,1/31/2021,1/31/2021,CPS,Option School January Invoice-Option school January invoice,,HJ,40310.25,,4799683.28
1200,1/31/2021,1/31/2021,CPS,CPS January Invoice-CPS January invoicing,,HJ,282000,,5081683.28
1200,2/1/2021,2/1/2021,CPS,Receipt from CPS-Receipt from CPS,,HJ,,282000,4799683.28
1200,2/8/2021,2/8/2021,CLARK,Received from CLARK-Received from CLARK,,HJ,,500000,4299683.28
1200,2/8/2021,2/8/2021,CPS,Receipt from option schools-Receipt from option schools,,HJ,,40310.25,4259373.03
1200,2/8/2021,2/8/2021,CPS,Receipt from option schools-Receipt from option schools,,HJ,,40310.25,4219062.78
1200,2/16/2021,2/16/2021,San Leandro Unified,Reversed -- WootMath Student License-WootMath Student License,,HJ,,349.22,4218713.56
1200,2/16/2021,2/16/2021,San Leandro Unified,WootMath Student License-WootMath Student License,,HJ,349.22,,4219062.78
1200,2/19/2021,2/19/2021,GATES,Receipt from GATES-Receipt from GATES,,HJ,,600000,3619062.78
1200,2/23/2021,2/23/2021,Providence PSD,received from Providencce Rhode island-received from Providence Rhode island,,HJ,,18000,3601062.78
1200,2/28/2021,2/28/2021,CPS,CPS February Inv CPS26-CPS February invoicing,,HJ,282000,,3883062.78
1200,2/28/2021,2/28/2021,CPS,Option School February Inv-Option school February invoice,,HJ,40310.25,,3923373.03
1200,2/28/2021,2/28/2021,Fullerton School Dis,WootMath School District-WootMath School District,,HJ,353.7,,3923726.73
1200,3/3/2021,3/3/2021,CPS,CPS and Option School Receipts,,HJ,,40310.25,3883416.48
1200,3/3/2021,3/3/2021,CPS,CPS and Option School Receipts,,HJ,,282000,3601416.48
1200,3/8/2021,3/8/2021,Unionville- Chadds F,WoothMath Student License,,HJ,363,,3601779.48
1200,3/9/2021,3/9/2021,"Broward County, FL","Invoice 210309-001 Broward County, FL",,HJ,600000,,4201779.48
1200,3/19/2021,3/19/2021,Chillicothe R-II Sch,Woot Math Student Service,,HJ,598.75,,4202378.23
1200,3/22/2021,3/22/2021,Fullerton School Dis,Receipt from Fullerton,,HJ,,353.7,4202024.53
1200,3/22/2021,3/22/2021,Woot Math Acquisiti,Receipt from Pennsylvania Dept of Education,,HJ,,517.05,4201507.48
1200,3/31/2021,3/31/2021,CPS,CPS and Option School Receipt,,HJ,,40310.25,4161197.23
1200,3/31/2021,3/31/2021,CPS,CPS and Option School Receipt,,HJ,,282000,3879197.23
1200,3/31/2021,3/31/2021,CPS,INV CPS27,,HJ,282000,,4161197.23
1200,3/31/2021,3/31/2021,CPS,Option School Inv 005,,HJ,40310.25,,4201507.48
1200,3/31/2021,3/31/2021,Great Oaks Legacy,Invoice 21004-GO-S2021 Great Oaks Legacy,,HJ,2487.5,,4203994.98
1200,4/30/2021,4/30/2021,CPS,Invoice CPS28,,HJ,282000,,4485994.98
1200,4/30/2021,4/30/2021,CPS,Invoice 20210430-CPS-OPSCH006,,HJ,40310.25,,4526305.23
1200,5/3/2021,5/3/2021,CPS,Receipt of CPS27 and CPS-OPSCH005,,HJ,,40310.25,4485994.98
1200,5/3/2021,5/3/2021,CPS,Receipt of CPS27 and CPS-OPSCH005,,HJ,,282000,4203994.98
1200,5/5/2021,5/5/2021,Chillicothe R-II Sch,Reciept of Woot Math Chillicothe School District,,HJ,,598.75,4203396.23
1200,5/7/2021,5/7/2021,ROTTERDAM,Bridge Consulting Invoice,,HJ,6377,,4209773.23
1200,5/13/2021,5/13/2021,"Colegio Anaximenes,",INV21007 - Colegio Anaximenes AC,,HJ,844.2,,4210617.43
1200,5/25/2021,5/25/2021,X Co. NFAMILY,Receipt from X Co. n,,HJ,,100000,4110617.43
1200,5/25/2021,5/25/2021,X Co. NFAMILY,Receipt from X Co. n,,HJ,,150000,3960617.43
1200,5/26/2021,5/26/2021,ROTTERDAM,Receipt of Payment for Bridge Consulting Netherlands,,HJ,,6377,3954240.43
1200,5/27/2021,5/27/2021,X Co. NFAMILY,Book Receivable from X Co. n,,HJ,400000,,4354240.43
1200,5/28/2021,5/28/2021,Glendale Unified Sch,Receipt of payment for INV21001 &INV21002,,HJ,,55.6,4354184.83
1200,5/28/2021,5/28/2021,MGSD Online Academy,Receipt of payment for INV21001 &INV21002,,HJ,,188.64,4353996.19
1200,5/31/2021,5/31/2021,CPS,INV 210531-CPS-OPSCH007,,HJ,40310.25,,4394306.44
1200,5/31/2021,5/31/2021,CPS,INV CPS29,,HJ,282000,,4676306.44
1200,6/1/2021,6/1/2021,"Colegio Anaximenes,","Receipt from INV21007 Colegio Anaximenes, AC",,HJ,,844.2,4675462.24
1200,6/1/2021,6/1/2021,CPS,Receipt of April CPS and Option School Payment,,HJ,,40310.25,4635151.99
1200,6/1/2021,6/1/2021,CPS,Receipt of April CPS and Option School Payment,,HJ,,282000,4353151.99
1200,6/2/2021,6/2/2021,Great Oaks Legacy,Receipt of Payment Great Oaks Legacy School,,HJ,,2487.5,4350664.49
1200,6/2/2021,6/2/2021,Great Oaks Legacy,Receipt of Payment Great Oaks Legacy School,,HJ,,4975,4345689.49
1200,6/8/2021,6/8/2021,Overton Elementary,INV-21008 Overton Elementary,,HJ,484,,4346173.49
1200,6/10/2021,6/10/2021,Nantahala Schools,INV-21009 Nantahala Schools,,HJ,44.19,,4346217.68
1200,6/15/2021,6/15/2021,Osseo Area Schools,INV-22001,,HJ,16808,,4363025.68
1200,6/15/2021,6/15/2021,Unionville- Chadds F,Receipt from Unionville,,HJ,,363,4362662.68
1200,6/16/2021,6/16/2021,CMEGROUP,Record 2 Year Award from CME,,HJ,100000,,4462662.68
1200,6/16/2021,6/16/2021,Woot Math Acquisiti,Reverse Duplicate Woot Math Entry,,HJ,,244.24,4462418.44
1200,6/22/2021,6/22/2021,Nantahala Schools,Receipt of Payment from Nantahala School – Macon County,,HJ,,44.19,4462374.25
1200,6/28/2021,6/28/2021,CPS,June 2021 CPS Invoice,,HJ,40310.25,,4502684.5
1200,6/28/2021,6/28/2021,CPS,June 2021 CPS Invoice,,HJ,282000,,4784684.5
1200,6/28/2021,6/28/2021,WEINBERG,Receipt of funds from Weinberg,,HJ,,150000,4634684.5
1200, Totals for 1200 - Grants and Accounts Receivable,,,,,,23990355.16,20520488.66,4634684.5
1201,1201 - Acct. Receivable Place holder (Balance forward As of 07/01/2020) ,,,,,,,,0
1201,7/1/2020,7/1/2020,CLARK,AR Balance Import 3/31/20-AR Balance Import 3/31/20,,HJ,,635000,-635000
1201,7/1/2020,7/1/2020,CLARK,Reverse and Correct: Clark and Gates-AR Balance Import 3/31/20,,HJ,635000,,0
1201,7/1/2020,7/1/2020,July 2020 Rent,Rent for Boston office-To record rent for Boston Office,,HJ,,1630.23,-1630.23
1201,7/1/2020,7/1/2020,July 2020 Rent,Rent for Boston office-To record rent for Boston Office,,HJ,1630.23,,0
1201,7/15/2020,7/15/2020,71520,To reverse 82L payroll 0715 JE-21-0008-Reverse payroll entry 07152020 IMPORT PAYROLL,,HJ,3.5,,3.5
1201,7/15/2020,7/15/2020,71520,To reverse 82L payroll 0715 JE-21-0008-Reverse payroll entry 07152020 IMPORT PAYROLL,,HJ,646.56,,650.06
1201,7/15/2020,7/15/2020,71520,To reverse 82L payroll 0715 JE-21-0008-Reverse payroll entry 07152020 IMPORT PAYROLL,,HJ,699.08,,1349.14
1201,7/15/2020,7/15/2020,71520,To reverse 82L payroll 0715 JE-21-0008-Reverse payroll entry 07152020 IMPORT PAYROLL,,HJ,709.49,,2058.63
1201,7/15/2020,7/15/2020,71520,To reverse 82L payroll 0715 JE-21-0008-Reverse payroll entry 07152020 IMPORT PAYROLL,,HJ,914.2,,2972.83
1201,7/15/2020,7/15/2020,71520,To reverse 82L payroll 0715 JE-21-0008-Reverse payroll entry 07152020 IMPORT PAYROLL,,HJ,1319.35,,4292.18
1201,7/15/2020,7/15/2020,71520,To reverse 82L payroll 0715 JE-21-0008-Reverse payroll entry 07152020 IMPORT PAYROLL,,HJ,1734.33,,6026.51
1201,7/15/2020,7/15/2020,71520,To reverse 82L payroll 0715 JE-21-0008-Reverse payroll entry 07152020 IMPORT PAYROLL,,HJ,1987.73,,8014.24
1201,7/15/2020,7/15/2020,71520,To reverse 82L payroll 0715 JE-21-0008-Reverse payroll entry 07152020 IMPORT PAYROLL,,HJ,,1987.74,6026.5
1201,7/15/2020,7/15/2020,71520,To reverse 82L payroll 0715 JE-21-0008-Reverse payroll entry 07152020 IMPORT PAYROLL,,HJ,1987.74,,8014.24
1201,7/15/2020,7/15/2020,71520,To reverse 82L payroll 0715 JE-21-0008-Reverse payroll entry 07152020 IMPORT PAYROLL,,HJ,2063.4,,10077.64
1201,7/15/2020,7/15/2020,71520,To reverse 82L payroll 0715 JE-21-0008-Reverse payroll entry 07152020 IMPORT PAYROLL,,HJ,2119.29,,12196.93
1201,7/15/2020,7/15/2020,71520,To reverse 82L payroll 0715 JE-21-0008-Reverse payroll entry 07152020 IMPORT PAYROLL,,HJ,2336.38,,14533.31
1201,7/15/2020,7/15/2020,71520,To reverse 82L payroll 0715 JE-21-0008-Reverse payroll entry 07152020 IMPORT PAYROLL,,HJ,3086.33,,17619.64
1201,7/15/2020,7/15/2020,71520,To reverse 82L payroll 0715 JE-21-0008-Reverse payroll entry 07152020 IMPORT PAYROLL,,HJ,4064.67,,21684.31
1201,7/15/2020,7/15/2020,71520,To reverse 82L payroll 0715 JE-21-0008-Reverse payroll entry 07152020 IMPORT PAYROLL,,HJ,4963.38,,26647.69
1201,7/15/2020,7/15/2020,71520,To reverse 82L payroll 0715 JE-21-0008-Reverse payroll entry 07152020 IMPORT PAYROLL,,HJ,6398.64,,33046.33
1201,7/15/2020,7/15/2020,71520,To reverse 82L payroll 0715 JE-21-0008-Reverse payroll entry 07152020 IMPORT PAYROLL,,HJ,7807.62,,40853.95
1201,7/15/2020,7/15/2020,71520,To reverse 82L payroll 0715 JE-21-0008-Reverse payroll entry 07152020 IMPORT PAYROLL,,HJ,8036.11,,48890.06
1201,7/15/2020,7/15/2020,71520,To reverse 82L payroll 0715 JE-21-0008-Reverse payroll entry 07152020 IMPORT PAYROLL,,HJ,14647.05,,63537.11
1201,7/15/2020,7/15/2020,71520,To reverse 82L payroll 0715 JE-21-0008-Reverse payroll entry 07152020 IMPORT PAYROLL,,HJ,16079.16,,79616.27
1201,7/15/2020,7/15/2020,71520,To reverse 82L payroll 0715 JE-21-0008-Reverse payroll entry 07152020 IMPORT PAYROLL,,HJ,20643.07,,100259.34
1201,7/15/2020,7/15/2020,71520,To reverse 82L payroll 0715 JE-21-0008-Reverse payroll entry 07152020 IMPORT PAYROLL,,HJ,21940.82,,122200.16
1201,7/15/2020,7/15/2020,71520,To reverse 82L payroll 0715 JE-21-0008-Reverse payroll entry 07152020 IMPORT PAYROLL,,HJ,35878.53,,158078.69
1201,7/15/2020,7/15/2020,71520,To reverse 82L payroll 0715 JE-21-0008-Reverse payroll entry 07152020 IMPORT PAYROLL,,HJ,54444.5,,212523.19
1201,7/15/2020,7/15/2020,71520,82L-IMPORT PAYROLL-Import Payroll,,HJ,,2991.13,209532.06
1201,7/15/2020,7/15/2020,71520,82L-IMPORT PAYROLL-Import Payroll,,HJ,,4187.49,205344.57
1201,7/15/2020,7/15/2020,71520,82L-IMPORT PAYROLL-Import Payroll,,HJ,,8559.24,196785.33
1201,7/15/2020,7/15/2020,71520,82L-IMPORT PAYROLL-Import Payroll,,HJ,,16129.82,180655.51
1201,7/15/2020,7/15/2020,71520,82L-IMPORT PAYROLL-Import Payroll,,HJ,,20877.85,159777.66
1201,7/15/2020,7/15/2020,71520,82L-IMPORT PAYROLL-Import Payroll,,HJ,,40875.83,118901.83
1201,7/15/2020,7/15/2020,71520,82L-IMPORT PAYROLL-Import Payroll,,HJ,,45493.94,73407.89
1201,7/15/2020,7/15/2020,71520,82L-IMPORT PAYROLL-Import Payroll,,HJ,,73407.88,0.01
1201,7/31/2020,7/31/2020,73120,To reverse 82L payroll 73120-To reverse 82L payroll of 73120 JE-21-0003,,HJ,699.09,,699.1
1201,7/31/2020,7/31/2020,73120,To reverse 82L payroll 73120-To reverse 82L payroll of 73120 JE-21-0003,,HJ,709.49,,1408.59
1201,7/31/2020,7/31/2020,73120,To reverse 82L payroll 73120-To reverse 82L payroll of 73120 JE-21-0003,,HJ,1734.33,,3142.92
1201,7/31/2020,7/31/2020,73120,To reverse 82L payroll 73120-To reverse 82L payroll of 73120 JE-21-0003,,HJ,2119.28,,5262.2
1201,7/31/2020,7/31/2020,73120,To reverse 82L payroll 73120-To reverse 82L payroll of 73120 JE-21-0003,,HJ,3086.33,,8348.53
1201,7/31/2020,7/31/2020,73120,To reverse 82L payroll 73120-To reverse 82L payroll of 73120 JE-21-0003,,HJ,3306.63,,11655.16
1201,7/31/2020,7/31/2020,73120,To reverse 82L payroll 73120-To reverse 82L payroll of 73120 JE-21-0003,,HJ,4064.65,,15719.81
1201,7/31/2020,7/31/2020,73120,To reverse 82L payroll 73120-To reverse 82L payroll of 73120 JE-21-0003,,HJ,4870.21,,20590.02
1201,7/31/2020,7/31/2020,73120,To reverse 82L payroll 73120-To reverse 82L payroll of 73120 JE-21-0003,,HJ,4963.38,,25553.4
1201,7/31/2020,7/31/2020,73120,To reverse 82L payroll 73120-To reverse 82L payroll of 73120 JE-21-0003,,HJ,8036.13,,33589.53
1201,7/31/2020,7/31/2020,73120,To reverse 82L payroll 73120-To reverse 82L payroll of 73120 JE-21-0003,,HJ,8760.15,,42349.68
1201,7/31/2020,7/31/2020,73120,To reverse 82L payroll 73120-To reverse 82L payroll of 73120 JE-21-0003,,HJ,10286.57,,52636.25
1201,7/31/2020,7/31/2020,73120,To reverse 82L payroll 73120-To reverse 82L payroll of 73120 JE-21-0003,,HJ,11375.62,,64011.87
1201,7/31/2020,7/31/2020,73120,To reverse 82L payroll 73120-To reverse 82L payroll of 73120 JE-21-0003,,HJ,17055.67,,81067.54
1201,7/31/2020,7/31/2020,73120,To reverse 82L payroll 73120-To reverse 82L payroll of 73120 JE-21-0003,,HJ,19888.18,,100955.72
1201,7/31/2020,7/31/2020,73120,To reverse 82L payroll 73120-To reverse 82L payroll of 73120 JE-21-0003,,HJ,23709.01,,124664.73
1201,7/31/2020,7/31/2020,73120,To reverse 82L payroll 73120-To reverse 82L payroll of 73120 JE-21-0003,,HJ,51455.94,,176120.67
1201,7/31/2020,7/31/2020,73120,To reverse 82L payroll 73120-To reverse 82L payroll of 73120 JE-21-0003,,HJ,58340,,234460.67
1201,7/31/2020,7/31/2020,73120,82L-IMPORT PAYROLL-Import Payroll,,HJ,,2959.48,231501.19
1201,7/31/2020,7/31/2020,73120,82L-IMPORT PAYROLL-Import Payroll,,HJ,,7228.38,224272.81
1201,7/31/2020,7/31/2020,73120,82L-IMPORT PAYROLL-Import Payroll,,HJ,,10775.54,213497.27
1201,7/31/2020,7/31/2020,73120,82L-IMPORT PAYROLL-Import Payroll,,HJ,,16076.34,197420.93
1201,7/31/2020,7/31/2020,73120,82L-IMPORT PAYROLL-Import Payroll,,HJ,,18231.82,179189.11
1201,7/31/2020,7/31/2020,73120,82L-IMPORT PAYROLL-Import Payroll,,HJ,,56164.9,123024.21
1201,7/31/2020,7/31/2020,73120,82L-IMPORT PAYROLL-Import Payroll,,HJ,,57531.7,65492.51
1201,7/31/2020,7/31/2020,73120,82L-IMPORT PAYROLL-Import Payroll,,HJ,,66132.52,-640.01
1201,7/31/2020,7/31/2020,73120,To reverse 82L payroll 73120-To reverse 82L payroll of 73120 JE-21-0003,D108,HJ,640.02,,0.01
1201,7/31/2020,7/31/2020,202007,Adj to reallocate Salaries FICA and benefits from GM3 - ACY2 to G-BL-To reallocate GM3 - ACY2 Expense,,HJ,,10454.48,-10454.47
1201,7/31/2020,7/31/2020,202007,Adj to reallocate Salaries FICA and benefits from GM3 - ACY2 to G-BL-To reallocate GM3 - ACY2 Expense,,HJ,10454.48,,0.01
1201,7/31/2020,7/31/2020,Reallocation to GM3 - ACY2,To reallocate Salaraies to GM3 - ACY2-To reallocate Salaries to GM3 - ACY2 ( Lacey Dequita Stephen Odonell Wallace Amena),,HJ,,17405.09,-17405.08
1201,7/31/2020,7/31/2020,Reallocation to GM3 - ACY2,To reallocate Salaraies to GM3 - ACY2-To reallocate Salaries to GM3 - ACY2 ( Lacey Dequita Stephen Odonell Wallace Amena),,HJ,17405.09,,0.01
1201,7/31/2020,7/31/2020,Reallocation to GM3 - ACY2,To Reverse JE-21-0052-To reallocate Salaries to GM3 - ACY2 ( Lacey Dequita Stephen Odonell Wallace Amena),,HJ,,17405.09,-17405.08
1201,7/31/2020,7/31/2020,Reallocation to GM3 - ACY2,To Reverse JE-21-0052-To reallocate Salaries to GM3 - ACY2 ( Lacey Dequita Stephen Odonell Wallace Amena),,HJ,17405.09,,0.01
1201,8/14/2020,8/14/2020,81420,82L-IMPORT PAYROLL-Import Payroll,,HJ,,2914.63,-2914.62
1201,8/14/2020,8/14/2020,81420,82L-IMPORT PAYROLL-Import Payroll,,HJ,,6588.36,-9502.98
1201,8/14/2020,8/14/2020,81420,82L-IMPORT PAYROLL-Import Payroll,,HJ,,10775.54,-20278.52
1201,8/14/2020,8/14/2020,81420,82L-IMPORT PAYROLL-Import Payroll,,HJ,,16076.34,-36354.86
1201,8/14/2020,8/14/2020,81420,82L-IMPORT PAYROLL-Import Payroll,,HJ,,17505.91,-53860.77
1201,8/14/2020,8/14/2020,81420,82L-IMPORT PAYROLL-Import Payroll,,HJ,,54165.32,-108026.09
1201,8/14/2020,8/14/2020,81420,82L-IMPORT PAYROLL-Import Payroll,,HJ,,56938.52,-164964.61
1201,8/14/2020,8/14/2020,81420,82L-IMPORT PAYROLL-Import Payroll,,HJ,,89650.66,-254615.27
1201,8/14/2020,8/14/2020,81420,82L-IMPORT PAYROLL-Wage Pay Credit of 2.8K and 966,,HJ,4057.61,,-250557.66
1201,8/14/2020,8/14/2020,81420,82L-IMPORT PAYROLL-Workers comp,,HJ,,632.27,-251189.93
1201,8/15/2020,8/15/2020,82L-PRPD-081520,To reverse 82L payroll 0815 JE-21-0020-To reverse 82L Payroll of 8152020,,HJ,632.27,,-250557.66
1201,8/15/2020,8/15/2020,82L-PRPD-081520,To reverse 82L payroll 0815 JE-21-0020-To reverse 82L Payroll of 8152020,,HJ,699.08,,-249858.58
1201,8/15/2020,8/15/2020,82L-PRPD-081520,To reverse 82L payroll 0815 JE-21-0020-To reverse 82L Payroll of 8152020,,HJ,709.48,,-249149.1
1201,8/15/2020,8/15/2020,82L-PRPD-081520,To reverse 82L payroll 0815 JE-21-0020-To reverse 82L Payroll of 8152020,,HJ,1734.34,,-247414.76
1201,8/15/2020,8/15/2020,82L-PRPD-081520,To reverse 82L payroll 0815 JE-21-0020-To reverse 82L Payroll of 8152020,,HJ,2119.29,,-245295.47
1201,8/15/2020,8/15/2020,82L-PRPD-081520,To reverse 82L payroll 0815 JE-21-0020-To reverse 82L Payroll of 8152020,,HJ,3086.31,,-242209.16
1201,8/15/2020,8/15/2020,82L-PRPD-081520,To reverse 82L payroll 0815 JE-21-0020-To reverse 82L Payroll of 8152020,,HJ,3642.78,,-238566.38
1201,8/15/2020,8/15/2020,82L-PRPD-081520,To reverse 82L payroll 0815 JE-21-0020-To reverse 82L Payroll of 8152020,,HJ,,4057.61,-242623.99
1201,8/15/2020,8/15/2020,82L-PRPD-081520,To reverse 82L payroll 0815 JE-21-0020-To reverse 82L Payroll of 8152020,,HJ,4064.67,,-238559.32
1201,8/15/2020,8/15/2020,82L-PRPD-081520,To reverse 82L payroll 0815 JE-21-0020-To reverse 82L Payroll of 8152020,,HJ,4710.84,,-233848.48
1201,8/15/2020,8/15/2020,82L-PRPD-081520,To reverse 82L payroll 0815 JE-21-0020-To reverse 82L Payroll of 8152020,,HJ,4963.4,,-228885.08
1201,8/15/2020,8/15/2020,82L-PRPD-081520,To reverse 82L payroll 0815 JE-21-0020-To reverse 82L Payroll of 8152020,,HJ,8036.11,,-220848.97
1201,8/15/2020,8/15/2020,82L-PRPD-081520,To reverse 82L payroll 0815 JE-21-0020-To reverse 82L Payroll of 8152020,,HJ,8391.79,,-212457.18
1201,8/15/2020,8/15/2020,82L-PRPD-081520,To reverse 82L payroll 0815 JE-21-0020-To reverse 82L Payroll of 8152020,,HJ,10687.45,,-201769.73
1201,8/15/2020,8/15/2020,82L-PRPD-081520,To reverse 82L payroll 0815 JE-21-0020-To reverse 82L Payroll of 8152020,,HJ,10982.13,,-190787.6
1201,8/15/2020,8/15/2020,82L-PRPD-081520,To reverse 82L payroll 0815 JE-21-0020-To reverse 82L Payroll of 8152020,,HJ,16021.18,,-174766.42
1201,8/15/2020,8/15/2020,82L-PRPD-081520,To reverse 82L payroll 0815 JE-21-0020-To reverse 82L Payroll of 8152020,,HJ,16887.51,,-157878.91
1201,8/15/2020,8/15/2020,82L-PRPD-081520,To reverse 82L payroll 0815 JE-21-0020-To reverse 82L Payroll of 8152020,,HJ,30822.74,,-127056.17
1201,8/15/2020,8/15/2020,82L-PRPD-081520,To reverse 82L payroll 0815 JE-21-0020-To reverse 82L Payroll of 8152020,,HJ,43299.08,,-83757.09
1201,8/15/2020,8/15/2020,82L-PRPD-081520,To reverse 82L payroll 0815 JE-21-0020-To reverse 82L Payroll of 8152020,,HJ,83757.1,,0.01
1201,8/31/2020,8/31/2020,83120,82L-IMPORT PAYROLL-Import Payroll,,HJ,,2914.63,-2914.62
1201,8/31/2020,8/31/2020,83120,82L-IMPORT PAYROLL-Import Payroll,,HJ,,6588.36,-9502.98
1201,8/31/2020,8/31/2020,83120,82L-IMPORT PAYROLL-Import Payroll,,HJ,,11309.95,-20812.93
1201,8/31/2020,8/31/2020,83120,82L-IMPORT PAYROLL-Import Payroll,,HJ,,14606.14,-35419.07
1201,8/31/2020,8/31/2020,83120,82L-IMPORT PAYROLL-Import Payroll,,HJ,,17601.17,-53020.24
1201,8/31/2020,8/31/2020,83120,82L-IMPORT PAYROLL-Import Payroll,,HJ,,62001.02,-115021.26
1201,8/31/2020,8/31/2020,83120,82L-IMPORT PAYROLL-Import Payroll,,HJ,,92071.4,-207092.66
1201,8/31/2020,8/31/2020,83120,82L-IMPORT PAYROLL-Import Payroll,,HJ,,101281.78,-308374.44
1201,8/31/2020,8/31/2020,202008,Adj to reallocate Salaries FICA and benefits from GM3 - ACY2 to G-BL-To reallocate GM3 - ACY2 Expense,,HJ,,10454.48,-318828.92
1201,8/31/2020,8/31/2020,202008,Adj to reallocate Salaries FICA and benefits from GM3 - ACY2 to G-BL-To reallocate GM3 - ACY2 Expense,,HJ,10454.48,,-308374.44
1201,8/31/2020,8/31/2020,82L-PRPD-083120,Reverse 82L payroll of 83120 JE-21-0021-IMPORT PAYROLL,,HJ,699.08,,-307675.36
1201,8/31/2020,8/31/2020,82L-PRPD-083120,Reverse 82L payroll of 83120 JE-21-0021-IMPORT PAYROLL,,HJ,709.48,,-306965.88
1201,8/31/2020,8/31/2020,82L-PRPD-083120,Reverse 82L payroll of 83120 JE-21-0021-IMPORT PAYROLL,,HJ,758.84,,-306207.04
1201,8/31/2020,8/31/2020,82L-PRPD-083120,Reverse 82L payroll of 83120 JE-21-0021-IMPORT PAYROLL,,HJ,1734.34,,-304472.7
1201,8/31/2020,8/31/2020,82L-PRPD-083120,Reverse 82L payroll of 83120 JE-21-0021-IMPORT PAYROLL,,HJ,2119.29,,-302353.41
1201,8/31/2020,8/31/2020,82L-PRPD-083120,Reverse 82L payroll of 83120 JE-21-0021-IMPORT PAYROLL,,HJ,3086.31,,-299267.1
1201,8/31/2020,8/31/2020,82L-PRPD-083120,Reverse 82L payroll of 83120 JE-21-0021-IMPORT PAYROLL,,HJ,3642.78,,-295624.32
1201,8/31/2020,8/31/2020,82L-PRPD-083120,Reverse 82L payroll of 83120 JE-21-0021-IMPORT PAYROLL,,HJ,4064.67,,-291559.65
1201,8/31/2020,8/31/2020,82L-PRPD-083120,Reverse 82L payroll of 83120 JE-21-0021-IMPORT PAYROLL,,HJ,4710.84,,-286848.81
1201,8/31/2020,8/31/2020,82L-PRPD-083120,Reverse 82L payroll of 83120 JE-21-0021-IMPORT PAYROLL,,HJ,4963.4,,-281885.41
1201,8/31/2020,8/31/2020,82L-PRPD-083120,Reverse 82L payroll of 83120 JE-21-0021-IMPORT PAYROLL,,HJ,8036.11,,-273849.3
1201,8/31/2020,8/31/2020,82L-PRPD-083120,Reverse 82L payroll of 83120 JE-21-0021-IMPORT PAYROLL,,HJ,8391.79,,-265457.51
1201,8/31/2020,8/31/2020,82L-PRPD-083120,Reverse 82L payroll of 83120 JE-21-0021-IMPORT PAYROLL,,HJ,10687.45,,-254770.06
1201,8/31/2020,8/31/2020,82L-PRPD-083120,Reverse 82L payroll of 83120 JE-21-0021-IMPORT PAYROLL,,HJ,10982.13,,-243787.93
1201,8/31/2020,8/31/2020,82L-PRPD-083120,Reverse 82L payroll of 83120 JE-21-0021-IMPORT PAYROLL,,HJ,16021.18,,-227766.75
1201,8/31/2020,8/31/2020,82L-PRPD-083120,Reverse 82L payroll of 83120 JE-21-0021-IMPORT PAYROLL,,HJ,16887.51,,-210879.24
1201,8/31/2020,8/31/2020,82L-PRPD-083120,Reverse 82L payroll of 83120 JE-21-0021-IMPORT PAYROLL,,HJ,30822.74,,-180056.5
1201,8/31/2020,8/31/2020,82L-PRPD-083120,Reverse 82L payroll of 83120 JE-21-0021-IMPORT PAYROLL,,HJ,43299.08,,-136757.42
1201,8/31/2020,8/31/2020,82L-PRPD-083120,Reverse 82L payroll of 83120 JE-21-0021-IMPORT PAYROLL,,HJ,53000.33,,-83757.09
1201,8/31/2020,8/31/2020,82L-PRPD-083120,Reverse 82L payroll of 83120 JE-21-0021-IMPORT PAYROLL,,HJ,83757.1,,0.01
1201,8/31/2020,8/31/2020,Reallocation to GM3 - ACY2,To reallocate Salaraies to GM3 - ACY2-To reallocate salaries to GM3 - ACY2 ( Wallace Stephen Odonells Lacey Dequita),,HJ,,16283.74,-16283.73
1201,8/31/2020,8/31/2020,Reallocation to GM3 - ACY2,To reallocate Salaraies to GM3 - ACY2-To reallocate salaries to GM3 - ACY2 ( Wallace Stephen Odonells Lacey Dequita),,HJ,16283.74,,0.01
1201,8/31/2020,8/31/2020,Reallocation to GM3 - ACY2,To reverse JE-21-0053-To reverse reallocation of salaries to GM3 - ACY2,,HJ,,16283.74,-16283.73
1201,8/31/2020,8/31/2020,Reallocation to GM3 - ACY2,To reverse JE-21-0053-To reverse reallocation of salaries to GM3 - ACY2,,HJ,16283.74,,0.01
1201,9/30/2020,9/30/2020,202009,Adj to reallocate Salaries FICA and benefits from GM3 - ACY2 to G-BL-To reallocate GM3 - ACY2 Expense,,HJ,,15181.1,-15181.09
1201,9/30/2020,9/30/2020,202009,Adj to reallocate Salaries FICA and benefits from GM3 - ACY2 to G-BL-To reallocate GM3 - ACY2 Expense,,HJ,15181.1,,0.01
1201,9/30/2020,9/30/2020,202009,Adj to reallocate Salaries FICA and benefits from GM3 - ACY2 to G-BL-To reallocate HRsalary from GM3 - ACY2 to G-BL,,HJ,,15181.11,-15181.1
1201,9/30/2020,9/30/2020,202009,Adj to reallocate Salaries FICA and benefits from GM3 - ACY2 to G-BL-To reallocate HRsalary from GM3 - ACY2 to G-BL,,HJ,15181.11,,0.01
1201,9/30/2020,9/30/2020,202009,Adj to reallocate Salaries FICA and benefits from GM3 - ACY2 to G-BL-To reallocate PR 0915 & 0930 Benefits to CPS,,HJ,,1327.72,-1327.71
1201,9/30/2020,9/30/2020,202009,Adj to reallocate Salaries FICA and benefits from GM3 - ACY2 to G-BL-To reallocate PR 0915 & 0930 Benefits to CPS,,HJ,1327.72,,0.01
1201,9/30/2020,9/30/2020,20200930,Adj to Reconcile GM3 - ACY2-Adj to Reconcile GM3 - ACY2,,HJ,,327.71,-327.7
1201,9/30/2020,9/30/2020,20200930,Adj to Reconcile GM3 - ACY2-Adj to Reconcile GM3 - ACY2,,HJ,327.71,,0.01
1201,10/31/2020,10/31/2020,202010,Adj to reallocate Salaries FICA and benefits from GM3 - ACY2 to G-BL-To reallocate GM3 - ACY2 Expense,,HJ,,13017.23,-13017.22
1201,10/31/2020,10/31/2020,202010,Adj to reallocate Salaries FICA and benefits from GM3 - ACY2 to G-BL-To reallocate GM3 - ACY2 Expense,,HJ,13017.23,,0.01
1201,10/31/2020,10/31/2020,202010,Adj to reallocate Salaries FICA and benefits from GM3 - ACY2 to G-BL-To reallocate HRsalary from GM3 - ACY2 to G-BL,,HJ,,13017.23,-13017.22
1201,10/31/2020,10/31/2020,202010,Adj to reallocate Salaries FICA and benefits from GM3 - ACY2 to G-BL-To reallocate HRsalary from GM3 - ACY2 to G-BL,,HJ,13017.23,,0.01
1201,11/30/2020,11/30/2020,1,To reallocate Benefits to CPS-To reallocate PR 1115 & 1130 Benefits to CPS,,HJ,,1411.14,-1411.13
1201,11/30/2020,11/30/2020,1,To reallocate Benefits to CPS-To reallocate PR 1115 & 1130 Benefits to CPS,,HJ,1411.14,,0.01
1201,11/30/2020,11/30/2020,202011,Adj to reallocate Salaries FICA and benefits from GM3 - ACY2 to G-BL-To reallocate GM3 - ACY2 Expense,,HJ,,18441.94,-18441.93
1201,11/30/2020,11/30/2020,202011,Adj to reallocate Salaries FICA and benefits from GM3 - ACY2 to G-BL-To reallocate GM3 - ACY2 Expense,,HJ,18441.94,,0.01
1201,11/30/2020,11/30/2020,202011,Adj to reallocate Salaries FICA and benefits from GM3 - ACY2 to G-BL-To reallocate HRsalary from GM3 - ACY2 to G-BL,,HJ,,18441.94,-18441.93
1201,11/30/2020,11/30/2020,202011,Adj to reallocate Salaries FICA and benefits from GM3 - ACY2 to G-BL-To reallocate HRsalary from GM3 - ACY2 to G-BL,,HJ,18441.94,,0.01
1201,12/1/2020,12/1/2020,20201201,To move revenue and expenses from discontinued grants-To move expenses from NYDOE to G-OM,,HJ,,200.6,-200.59
1201,12/1/2020,12/1/2020,20201201,To move revenue and expenses from discontinued grants-To move expenses from NYDOE to G-OM,,HJ,200.6,,0.01
1201,12/1/2020,12/1/2020,20201201,To move revenue and expenses from discontinued grants-To move revenue and expenses from GATES to G-BL,,HJ,,350,-349.99
1201,12/1/2020,12/1/2020,20201201,To move revenue and expenses from discontinued grants-To move revenue and expenses from GATES to G-BL,,HJ,350,,0.01
1201,12/1/2020,12/1/2020,20201201,To move revenue and expenses from discontinued grants-To move revenue and expenses from GATES to G-BL,,HJ,,250000,-249999.99
1201,12/1/2020,12/1/2020,20201201,To move revenue and expenses from discontinued grants-To move revenue and expenses from GATES to G-BL,,HJ,250000,,0.01
1201,4/30/2021,4/30/2021,1,ADJ to Reclass funding source,,HJ,,16713.08,-16713.07
1201,4/30/2021,4/30/2021,1,ADJ to Reclass funding source,,HJ,16713.08,,0.01
1201,4/30/2021,4/30/2021,1,ADJ to Reclass funding source,,HJ,,10000,-9999.99
1201,4/30/2021,4/30/2021,1,ADJ to Reclass funding source,,HJ,10000,,0.01
1201,4/30/2021,4/30/2021,1,ADJ to Reclass funding source,,HJ,,128767.52,-128767.51
1201,4/30/2021,4/30/2021,1,ADJ to Reclass funding source,,HJ,128767.52,,0.01
1201,5/31/2021,5/31/2021,1,HP Chromebook New Profit reclassification,,HJ,10975.6,,10975.61
1201,5/31/2021,5/31/2021,1,HP Chromebook New Profit reclassification,,HJ,16962.28,,27937.89
1201,5/31/2021,5/31/2021,1,HP Chromebook New Profit reclassification,,HJ,16962.28,,44900.17
1201,5/31/2021,5/31/2021,1,HP Chromebook New Profit reclassification,,HJ,54877.98,,99778.15
1201,5/31/2021,5/31/2021,1,HP Chromebook New Profit reclassification,,HJ,,99778.14,0.01
1201,5/31/2021,5/31/2021,JE-21-0222,ADJ to reclassify funding source,,HJ,,0.01,0
1201,5/31/2021,5/31/2021,JE-21-0222,ADJ to reclassify funding source,,HJ,0.01,,0.01
1201,5/31/2021,5/31/2021,JE-21-0222,ADJ to reclassify funding source,,HJ,1600.9,,1600.91
1201,5/31/2021,5/31/2021,JE-21-0222,ADJ to reclassify funding source,,HJ,3692.62,,5293.53
1201,5/31/2021,5/31/2021,JE-21-0222,ADJ to reclassify funding source,,HJ,5108.08,,10401.61
1201,5/31/2021,5/31/2021,JE-21-0222,ADJ to reclassify funding source,,HJ,10000,,20401.61
1201,5/31/2021,5/31/2021,JE-21-0222,ADJ to reclassify funding source,,HJ,,11438.97,8962.64
1201,5/31/2021,5/31/2021,JE-21-0222,ADJ to reclassify funding source,,HJ,11438.97,,20401.61
1201,5/31/2021,5/31/2021,JE-21-0222,ADJ to reclassify funding source,,HJ,,11600.9,8800.71
1201,5/31/2021,5/31/2021,JE-21-0222,ADJ to reclassify funding source,,HJ,30094.86,,38895.57
1201,5/31/2021,5/31/2021,JE-21-0222,ADJ to reclassify funding source,,HJ,,38895.56,0.01
1201,6/30/2021,6/30/2021,JE-21-0256,Adjust Funding Sources,,HJ,142.26,,142.27
1201,6/30/2021,6/30/2021,JE-21-0256,Adjust Funding Sources,,HJ,,188.21,-45.94
1201,6/30/2021,6/30/2021,JE-21-0256,Adjust Funding Sources,,HJ,,1191.47,-1237.41
1201,6/30/2021,6/30/2021,JE-21-0256,Adjust Funding Sources,,HJ,2306.71,,1069.3
1201,6/30/2021,6/30/2021,JE-21-0256,Adjust Funding Sources,,HJ,2372.17,,3441.47
1201,6/30/2021,6/30/2021,JE-21-0256,Adjust Funding Sources,,HJ,,17118.9,-13677.43
1201,6/30/2021,6/30/2021,JE-21-0256,Adjust Funding Sources,,HJ,17118.9,,3441.47
1201,6/30/2021,6/30/2021,JE-21-0256,Adjust Funding Sources,,HJ,43707.46,,47148.93
1201,6/30/2021,6/30/2021,JE-21-0256,Adjust Funding Sources,,HJ,,47148.92,0.01
1201, Totals for 1201 - Acct. Receivable Place holder,,,,,,2471947.47,2471947.46,0.01
1210,1210 - Miscellaneous Receivable (Employee Related) (Balance forward As of 07/01/2020) ,,,,,,,,12964.23
1210,9/5/2020,9/5/2020,Alan Safran,Imported from Bank of America Visa-Personal expenses. Will be reimbursed,,HJ,48.22,,13012.45
1210,9/7/2020,9/7/2020,Alan Safran,Imported from Bank of America Visa-Personal expenses. Will be reimbursed,,HJ,5,,13017.45
1210,9/29/2020,9/29/2020,Tiffani Bibb,Imported from Bank of America Visa-Mistake-Personal Charge,,HJ,43.19,,13060.64
1210,10/1/2020,10/1/2020,20201001,To write off GL 1210-Old QB GL12002 Richard Hines related-To write off GL 1210-Old QB GL12002 Richard Hines related,,HJ,,12964.23,96.41
1210,10/1/2020,10/1/2020,20201001-rev,To reverse and correct the GL coding-To write off GL 1210-Old QB GL12002 Richard Hines related,,HJ,,12964.23,-12867.82
1210,10/1/2020,10/1/2020,20201001-rev,To reverse and correct the GL coding-To write off GL 1210-Old QB GL12002 Richard Hines related,,HJ,12964.23,,96.41
1210,10/7/2020,10/7/2020,9113,Alan Safran pay back for his personal charges-Alan Safran pay back for his personal charges,,HJ,,53.22,43.19
1210,10/21/2020,10/21/2020,1,Tiffani Bibb Reimbursement to X Co. -Tiffani Bibb Reimbursement to X Co. ,,HJ,,43.19,0
1210,11/17/2020,11/17/2020,Mahaliah Sejour,Imported from Bank of America Visa-accidental card use for personal exense by SD Nancy Morgan,,HJ,46.95,,46.95
1210,11/25/2020,11/25/2020,Alan Safran,Imported from Bank of America Visa-Alan conference-Refunded,,HJ,149,,195.95
1210,11/27/2020,11/27/2020,Alan Safran,Imported from Bank of America Visa-Alan conference-refund,,HJ,,149,46.95
1210,12/16/2020,12/16/2020,20201216,Received reimb from Nancy Nwakanma-Received reimb from Nancy Nwakanma,,HJ,,46.95,0
1210, Totals for 1210 - Miscellaneous Receivable (Employee Related),,,,,,13256.59,26220.82,0
1301,1301 - Unbilled - AC Grants Receivable (Balance forward As of 07/01/2020) ,,,,,,,,38793.06
1301,7/27/2020,7/27/2020,June-2020-(a),Americorps AR and Reimbursement for June-Americorps Reimbursement for June -Reversing Revenue,,HJ,,38793.06,0
1301,9/30/2020,9/30/2020,20-Sep,Americorp Reimbursement for August & September-Americorps Reimbursement for September -Recognizing Revenue,,HJ,236773.22,,236773.22
1301,10/26/2020,10/26/2020,September-2020-(a),Americorp Reimbursement for August & September-Americorps Reimbursement for September -Reversing Revenue,,HJ,,236773.22,0
1301,10/31/2020,10/31/2020,20-Oct,Americorp Reimbursement for October-Americorps Reimbursement for October -Recognizing Revenue,,HJ,225122.55,,225122.55
1301,11/20/2020,11/20/2020,October-2020-(a),Americorp Reimbursement for October-Americorps Reimbursement for October -Reversing Revenue,,HJ,,225122.55,0
1301,11/30/2020,11/30/2020,20-Nov,Americorps Reimbursement for November-Americorps Reimbursement for November -Recognizing Revenue,,HJ,233374.62,,233374.62
1301,12/15/2020,12/15/2020,November-2020 (a),Americorps Reimbursement for November-Americorps Reimbursement for November -Reversing Revenue,,HJ,,233374.62,0
1301,12/31/2020,12/31/2020,JE-21-0120,Americorps Reimbursement for December-Americorps Reimbursement for November -Recognizing Revenue,,HJ,212210.7,,212210.7
1301,1/13/2021,1/13/2021,20201213,Americorps Reimbursement for December-Americorps Reimbursement for December -Reversing Revenue,,HJ,212210.7,,424421.4
1301,1/13/2021,1/13/2021,20201213,Reverse and Correct JE-21-0103-Correct - Americorps Reimbursement for December,,HJ,,212210.7,212210.7
1301,1/13/2021,1/13/2021,20201213,Reverse and Correct JE-21-0103-Reverse - Americorps Reimbursement for December,,HJ,,212210.7,0
1301,1/31/2021,1/31/2021,JE-21-0160-2,Americorps Reimbursement for January-Americorps Reimbursement for January -Recognizing Revenue,,HJ,203784.24,,203784.24
1301,2/10/2021,2/10/2021,JE-21-0160,Americorps Reimbursement for January-Americorps Reimbursement for January,,HJ,,203784.24,0
1301,2/28/2021,2/28/2021,20200228,Americorp Reimbursement for February-Americorps Reimbursement for February,,HJ,204978.73,,204978.73
1301,3/15/2021,3/15/2021,JE-21-0177,Americorp Reimbursement for February,,HJ,,204978.73,0
1301,3/31/2021,3/31/2021,20200331,Americorps reimbursement for March,,HJ,202871.76,,202871.76
1301,4/13/2021,4/13/2021,082476BFD3084543A374,Americorps reimbursement for March,,HJ,,202871.76,0
1301,4/30/2021,4/30/2021,20210430,Americorps Reimbursement for April,,HJ,201713.77,,201713.77
1301,5/17/2021,5/17/2021,CD-21-0293,Americorps Reimbursement for April,,HJ,,201713.77,0
1301,5/31/2021,5/31/2021,20210531,Americorp Reimbursement for MAy,,HJ,199848.94,,199848.94
1301,6/14/2021,6/14/2021,ADP retroactiveJUN,Americorp Reimbursement for MAy,,HJ,,199848.94,0
1301,6/30/2021,6/30/2021,20210630,Americorp Reimb for June,,HJ,281262.9,,281262.9
1301, Totals for 1301 - Unbilled - AC Grants Receivable,,,,,,2414152.13,2171682.29,281262.9
1311,1311 - Billed - AC Grants Receivable (Balance forward As of 07/01/2020) ,,,,,,,,0
1311,7/27/2020,7/27/2020,June-2020-(a),Americorps AR and Reimbursement for June-Americorps Reimbursement for June -Booking Revenue,,HJ,38793.06,,38793.06
1311,7/28/2020,7/28/2020,20200728,Americorps AR and Reimbursement for June-Americorps Reimbursement for June -Reimbursement Payment,,HJ,,38793.06,0
1311,10/26/2020,10/26/2020,September-2020-(a),Americorp Reimbursement for August & September-Americorps Reimbursement for September -Booking Revenue,,HJ,236773.22,,236773.22
1311,10/27/2020,10/27/2020,20201027,Americorp Reimbursement for August & September-Americorps Reimbursement for September -Reimbursement Payment,,HJ,,236773.22,0
1311,11/20/2020,11/20/2020,October-2020-(a),Americorp Reimbursement for October-Americorps Reimbursement for October -Booking Revenue,,HJ,225122.55,,225122.55
1311,11/23/2020,11/23/2020,20201123,Americorp Reimbursement for October-Americorps Reimbursement for October -Reimbursement Payment,,HJ,,225122.55,0
1311,12/15/2020,12/15/2020,November-2020 (a),Americorps Reimbursement for November-Americorps Reimbursement for November -Booking Revenue,,HJ,233374.62,,233374.62
1311,12/16/2020,12/16/2020,20201027,Americorps Reimbursement for November-Americorps Reimbursement for November -Reimbursement Payment,,HJ,,233374.62,0
1311,1/13/2021,1/13/2021,20201213,Americorps Reimbursement for December-Americorps Reimbursement for December -Booking Revenue,,HJ,212210.7,,212210.7
1311,1/14/2021,1/14/2021,20201213,Americorps Reimbursement for December-Americorps Reimbursement for December -Reimbursement Payment,,HJ,,212210.7,0
1311,2/10/2021,2/10/2021,JE-21-0160,Americorps Reimbursement for January-Americorps Reimbursement for January,,HJ,203784.24,,203784.24
1311,2/11/2021,2/11/2021,JE-21-0160,Americorps Reimbursement for January-Americorps Reimbursement for January,,HJ,,203784.24,0
1311,3/15/2021,3/15/2021,JE-21-0177,Americorp Reimbursement for February,,HJ,204978.73,,204978.73
1311,3/16/2021,3/16/2021,27861,Americorp Reimbursement for February,,HJ,,204978.73,0
1311,4/13/2021,4/13/2021,082476BFD3084543A374,Americorps reimbursement for March,,HJ,202871.76,,202871.76
1311,4/15/2021,4/15/2021,CD-21-0241,Americorps reimbursement for March,,HJ,,202871.76,0
1311,5/17/2021,5/17/2021,CD-21-0293,Americorps Reimbursement for April,,HJ,201713.77,,201713.77
1311,5/18/2021,5/18/2021,CD-21-0289,Americorps Reimbursement for April,,HJ,,201713.77,0
1311,6/14/2021,6/14/2021,ADP retroactiveJUN,Americorp Reimbursement for MAy,,HJ,199848.94,,199848.94
1311,6/15/2021,6/15/2021,ARIF-20210615-1,Americorp Reimbursement for MAy,,HJ,,199848.94,0
1311, Totals for 1311 - Billed - AC Grants Receivable,,,,,,1959471.59,1959471.59,0
1400,1400 - Prepaid Insurance (Balance forward As of 07/01/2020) ,,,,,,,,0.01
1400,7/30/2020,7/30/2020,Fred C. Church,Bill.Com Import-Annual premium on X Co.  Cyber Insurance effective from 7.01.2020 to 7.1.2021,,HJ,9401.6,,9401.61
1400,7/31/2020,7/31/2020,Amortization,To expense prepaid X Co.  Cyber Insurance-To expense prepaid X Co.  Cyber insurance,,HJ,,783.47,8618.14
1400,8/31/2020,8/31/2020,Amortization,To expense prepaid X Co.  Cyber Insurance-To expense prepaid X Co.  Cyber insurance,,HJ,,783.47,7834.67
1400,9/23/2020,9/23/2020,The Hanover Ins,Bill.Com Import-Commercial Umbrella and Package Policy,,HJ,5864.25,,13698.92
1400,9/30/2020,9/30/2020,Amortization,To expense prepaid X Co.  Cyber Insurance-To expense prepaid X Co.  Cyber insurance,,HJ,,783.47,12915.45
1400,10/31/2020,10/31/2020,Ins amortization,To expense prepaid X Co.  Cyber & Commercial Umbrella insurance-To expense prepaid X Co.  Commercial Umbrella insurance,,HJ,,1954.75,10960.7
1400,10/31/2020,10/31/2020,Ins amortization,To expense prepaid X Co.  Cyber & Commercial Umbrella insurance-To expense prepaid X Co.  Cyber insurance,,HJ,,783.47,10177.23
1400,11/30/2020,11/30/2020,Ins amortization,To expense prepaid X Co.  Cyber & Commercial Umbrella insurance-To expense prepaid X Co.  Commercial Umbrella insurance,,HJ,,1954.75,8222.48
1400,11/30/2020,11/30/2020,Ins amortization,To expense prepaid X Co.  Cyber & Commercial Umbrella insurance-To expense prepaid X Co.  Cyber insurance,,HJ,,783.47,7439.01
1400,12/31/2020,12/31/2020,Ins amortization,To expense prepaid X Co.  Cyber & Commercial Umbrella insurance-To expense prepaid X Co.  Commercial Umbrella insurance,,HJ,,1954.75,5484.26
1400,12/31/2020,12/31/2020,Ins amortization,To expense prepaid X Co.  Cyber & Commercial Umbrella insurance-To expense prepaid X Co.  Cyber insurance,,HJ,,783.47,4700.79
1400,1/14/2021,1/14/2021,The Hanover Ins,Bill.Com Import-FY21 Commercial Umbrella Policy UHN A512176 & Commercial Package ZDN A512098,,HJ,5864.25,,10565.04
1400,1/31/2021,1/31/2021,3Q Expense,To expense prepaid Commercial Umbrella insurance-To expense prepaid Commercial Umbrella insurance,,HJ,,1954.75,8610.29
1400,1/31/2021,1/31/2021,Ins amortization,To expense prepaid X Co.  Cyber & Commercial Umbrella insurance-To expense prepaid X Co.  Cyber insurance,,HJ,,783.47,7826.82
1400,2/28/2021,2/28/2021,3Q Expense,To expense prepaid Commercial Umbrella insurance-To expense prepaid Commercial Umbrella insurance,,HJ,,1954.75,5872.07
1400,2/28/2021,2/28/2021,Ins amortization,To expense prepaid X Co.  Cyber & Commercial Umbrella insurance-To expense prepaid X Co.  Cyber insurance,,HJ,,783.47,5088.6
1400,3/24/2021,3/24/2021,The Hanover Ins,Bill.Com Import,,HJ,5864.25,,10952.85
1400,3/31/2021,3/31/2021,3Q Expense,To expense prepaid Commercial Umbrella insurance,,HJ,,1954.75,8998.1
1400,3/31/2021,3/31/2021,Ins amortization,To expense prepaid X Co.  Cyber & Commercial Umbrella insurance,,HJ,,783.47,8214.63
1400,4/30/2021,4/30/2021,4Q Expense,To expense prepaid commercial umbrella insurance,,HJ,,1954.75,6259.88
1400,4/30/2021,4/30/2021,CPS-OPSCH006,To expense prepaid X Co.  Cyber & Commercial Umbrella insurance,,HJ,,783.47,5476.41
1400,5/26/2021,5/26/2021,UnitedHealthcare,Bill.Com Import,,HJ,50000,,55476.41
1400,5/31/2021,5/31/2021,20210531,To expense prepaid commercial umbrella insurance,,HJ,,1954.75,53521.66
1400,5/31/2021,5/31/2021,ARIF-20210602,To expense prepaid X Co.  Cyber & Commercial Umbrella insurance,,HJ,,783.47,52738.19
1400,6/30/2021,6/30/2021,63021,To expense prepaid X Co.  Cyber & Commercial Umbrella insurance,,HJ,,783.47,51954.72
1400,6/30/2021,6/30/2021,20210630,To expense prepaid commercial umbrella insurance,,HJ,,1954.75,49999.97
1400, Totals for 1400 - Prepaid Insurance,,,,,,76994.35,26994.39,49999.97
1410,1410 - Prepaid Expenses (not insurance) (Balance forward As of 07/01/2020) ,,,,,,,,10755.8
1410,7/1/2020,7/1/2020,2689,To expense DEIC consulting service-To expense DEIC consulting service,,HJ,,7062,3693.8
1410,9/9/2020,9/9/2020,TASC,Bill.Com Import-COBRA and FSA administration fees and renewal for FY21,,HJ,1250.94,,4944.74
1410,10/1/2020,10/1/2020,20201001,To expense the prepaid expenses-To expense the prepaid expenses,,HJ,,4944.74,0
1410,5/1/2021,5/1/2021,Widespread-HubSpot,Digital marketing plan for X Co.  Widespread.,,HJ,,2711.5,-2711.5
1410,5/26/2021,5/26/2021,HubSpot Inc.,Bill.Com Import,,HJ,5423,,2711.5
1410,5/26/2021,5/26/2021,HubSpot Inc.,Bill.Com Import,,HJ,27115,,29826.5
1410,6/1/2021,6/1/2021,CD-21-0323,Digital marketing plan for X Co.  Widespread.,,HJ,,2711.5,27115
1410,6/28/2021,6/28/2021,Salesforce.org,Bill.Com Import,,HJ,25416,,52531
1410, Totals for 1410 - Prepaid Expenses (not insurance),,,,,,59204.94,17429.74,52531
1600,1600 - LTA Security Deposits (Balance forward As of 07/01/2020) ,,,,,,,,4120.59
1600,6/4/2021,6/4/2021,West End Investments,Bill.Com Import,,HJ,1000,,5120.59
1600,6/8/2021,6/8/2021,West End Investments,Bill.Com Import,,HJ,700,,5820.59
1600, Totals for 1600 - LTA Security Deposits,,,,,,1700,0,5820.59
1800,"1800 - Computer, Furniture, and Equipment (Balance forward As of 07/01/2020) ",,,,,,,,2484.44
1800," Totals for 1800 - Computer, Furniture, and Equipment",,,,,,0,0,2484.44
1810,1810 - Accumulated Depreciation (Balance forward As of 07/01/2020) ,,,,,,,,-2484.44
1810, Totals for 1810 - Accumulated Depreciation,,,,,,0,0,-2484.44
2001,2001 - Accounts Payable - Other (Balance forward As of 07/01/2020) ,,,,,,,,-66046.1
2001,7/1/2020,7/1/2020,AC,To record the Americorps disallowance-To record the Americorps disallowance,,HJ,120692,,54645.9
2001,7/1/2020,7/1/2020,AC-R&C,To reverse and correct the GL coding-Correct: To record the Americorps disallowance -Payment of Disallowance by lowering expense,,HJ,120692,,175337.9
2001,7/1/2020,7/1/2020,AC-R&C,To reverse and correct the GL coding-Reverse: To record the Americorps disallowance,,HJ,,120692,54645.9
2001,6/30/2021,6/30/2021,Adj.01,"To adjust AP other account proper balance June 30, 2021. Adjusting entry requested by the auditors.",D107,GJ,,57215,-2569.1
2001, Totals for 2001 - Accounts Payable - Other,,,,,,241384,177907,-2569.1
2020,2020 - Due To Miscellaneous (Balance forward As of 07/01/2020) ,,,,,,,,0
2020,9/2/2020,9/2/2020,20200902,Direct Deposit returns for Milford Chavous & Joshua Lewis Cassidy-Direct Deposit returns for Joshua Lewis Cassidy,,HJ,,867.47,-867.47
2020,9/2/2020,9/2/2020,20200902,Direct Deposit returns for Milford Chavous & Joshua Lewis Cassidy-Direct Deposit returns for Milford Chavous,,HJ,,1823.98,-2691.45
2020, Totals for 2020 - Due To Miscellaneous,,,,,,0,2691.45,-2691.45
2032,2032 - AP Clearing Acct (Balance forward As of 07/01/2020) ,,,,,,,,-40961.74
2032,7/1/2020,7/1/2020,Alan Safran,Imported from Bank of America Visa-Background checks for fellows,,HJ,,2.15,-40963.89
2032,7/1/2020,7/1/2020,Alan Safran,Imported from Bank of America Visa-Background checks for fellows,,HJ,,3.31,-40967.2
2032,7/1/2020,7/1/2020,Alan Safran,Imported from Bank of America Visa-Background checks for fellows,,HJ,,3.32,-40970.52
2032,7/1/2020,7/1/2020,Alan Safran,Imported from Bank of America Visa-Background checks for fellows,,HJ,,10.72,-40981.24
2032,7/1/2020,7/1/2020,Alan Safran,Imported from Bank of America Visa-Monthly bank fee,,HJ,,15,-40996.24
2032,7/1/2020,7/1/2020,Antonio Gutierrez,Imported from Bank of America Visa-Expense Reporting,,HJ,,1226.42,-42222.66
2032,7/1/2020,7/1/2020,Elizabeth Peinado,Imported from Bank of America Visa-Annual Greenhouse subscription,,HJ,,935,-43157.66
2032,7/1/2020,7/1/2020,Elizabeth Peinado,Imported from Bank of America Visa-Annual Greenhouse subscription,,HJ,,1445,-44602.66
2032,7/1/2020,7/1/2020,Elizabeth Peinado,Imported from Bank of America Visa-Annual Greenhouse subscription,,HJ,,1445,-46047.66
2032,7/1/2020,7/1/2020,Elizabeth Peinado,Imported from Bank of America Visa-Annual Greenhouse subscription,,HJ,,4675,-50722.66
2032,7/1/2020,7/1/2020,Elizabeth Peinado,Imported from Bank of America Visa-Job posting for all regions,,HJ,,82.09,-50804.75
2032,7/1/2020,7/1/2020,Elizabeth Peinado,Imported from Bank of America Visa-Job posting for all regions,,HJ,,126.86,-50931.61
2032,7/1/2020,7/1/2020,Elizabeth Peinado,Imported from Bank of America Visa-Job posting for all regions,,HJ,,126.86,-51058.47
2032,7/1/2020,7/1/2020,Elizabeth Peinado,Imported from Bank of America Visa-Job posting for all regions,,HJ,,410.45,-51468.92
2032,7/1/2020,7/1/2020,Elizabeth Peinado,Imported from Bank of America Visa-Job posting for all regions,,HJ,,500.5,-51969.42
2032,7/1/2020,7/1/2020,Elizabeth Peinado,Imported from Bank of America Visa-Job posting for all regions,,HJ,,550.65,-52520.07
2032,7/1/2020,7/1/2020,Elizabeth Peinado,Imported from Bank of America Visa-Job posting for all regions,,HJ,,773.5,-53293.57
2032,7/1/2020,7/1/2020,Elizabeth Peinado,Imported from Bank of America Visa-Job posting for all regions,,HJ,,773.5,-54067.07
2032,7/1/2020,7/1/2020,Elizabeth Peinado,Imported from Bank of America Visa-Job posting for all regions,,HJ,,851.01,-54918.08
2032,7/1/2020,7/1/2020,Elizabeth Peinado,Imported from Bank of America Visa-Job posting for all regions,,HJ,,851.01,-55769.09
2032,7/1/2020,7/1/2020,Elizabeth Peinado,Imported from Bank of America Visa-Job posting for all regions,,HJ,,2502.5,-58271.59
2032,7/1/2020,7/1/2020,Elizabeth Peinado,Imported from Bank of America Visa-Job posting for all regions,,HJ,,2753.26,-61024.85
2032,7/1/2020,7/1/2020,Halley Bowman,Imported from Bank of America Visa-PD book for MS project for Steve,,HJ,,23.76,-61048.61
2032,7/1/2020,7/1/2020,Halley Bowman,Imported from Bank of America Visa-PD book for Steve on MS project,,HJ,,30.49,-61079.1
2032,7/1/2020,7/1/2020,Halley Bowman,Imported from Bank of America Visa-PD books for MS project for Halley,,HJ,,45.01,-61124.11
2032,7/1/2020,7/1/2020,Halley Bowman,Imported from Bank of America Visa-white board markers,,HJ,,1.39,-61125.5
2032,7/1/2020,7/1/2020,Halley Bowman,Imported from Bank of America Visa-white board markers,,HJ,,2.14,-61127.64
2032,7/1/2020,7/1/2020,Halley Bowman,Imported from Bank of America Visa-white board markers,,HJ,,2.14,-61129.78
2032,7/1/2020,7/1/2020,Halley Bowman,Imported from Bank of America Visa-white board markers,,HJ,,6.93,-61136.71
2032,7/1/2020,7/1/2020,Joseph Zarate,Imported from Bank of America Visa-Equipment,,HJ,,461.99,-61598.7
2032,7/1/2020,7/1/2020,Joseph Zarate,Imported from Bank of America Visa-Equipment,,HJ,,461.99,-62060.69
2032,7/1/2020,7/1/2020,Joseph Zarate,Imported from Bank of America Visa-Equipment for new hire,,HJ,,502.43,-62563.12
2032,7/1/2020,7/1/2020,Joseph Zarate,Imported from Bank of America Visa-For laptop returns,,HJ,,22.8,-62585.92
2032,7/1/2020,7/1/2020,Joseph Zarate,Imported from Bank of America Visa-New hire equipment,,HJ,,468.99,-63054.91
2032,7/1/2020,7/1/2020,Joseph Zarate,Imported from Bank of America Visa-New hire equipment,,HJ,,491.66,-63546.57
2032,7/1/2020,7/1/2020,Joseph Zarate,Imported from Bank of America Visa-Refund,,HJ,39.88,,-63506.69
2032,7/1/2020,7/1/2020,Joseph Zarate,Imported from Bank of America Visa-Return Equipment,,HJ,,49.95,-63556.64
2032,7/1/2020,7/1/2020,Monivett Acevedo,Imported from Bank of America Visa-Laptop table for standing desk,,HJ,,73.59,-63630.23
2032,7/1/2020,7/1/2020,Monivett Acevedo,Imported from Bank of America Visa-Printer,,HJ,,227.89,-63858.12
2032,7/1/2020,7/1/2020,Stephen O'Donnell,Imported from reimbursements-Flight to Dallas,,HJ,,426.81,-64284.93
2032,7/1/2020,7/1/2020,Stephen O'Donnell,Imported from reimbursements-Flight to NYC,,HJ,,784.8,-65069.73
2032,7/1/2020,7/1/2020,Stephen O'Donnell,Imported from reimbursements-Lyft to airport,,HJ,,14.26,-65083.99
2032,7/1/2020,7/1/2020,Stephen O'Donnell,Imported from reimbursements-Lyft to airport,,HJ,,20.65,-65104.64
2032,7/1/2020,7/1/2020,Stephen O'Donnell,Imported from reimbursements-Lyft to airport,,HJ,,21.26,-65125.9
2032,7/1/2020,7/1/2020,Stephen O'Donnell,Imported from reimbursements-Lyft to airport,,HJ,,22.19,-65148.09
2032,7/1/2020,7/1/2020,Stephen O'Donnell,Imported from reimbursements-Lyft to airport,,HJ,,26.84,-65174.93
2032,7/1/2020,7/1/2020,Stephen O'Donnell,Imported from reimbursements-Lyft to airport,,HJ,,27.24,-65202.17
2032,7/1/2020,7/1/2020,Stephen O'Donnell,Imported from reimbursements-Lyft to library to meet with Kyra,,HJ,,11.82,-65213.99
2032,7/1/2020,7/1/2020,Stephen O'Donnell,Imported from reimbursements-Meal Per Diem,,HJ,,4.24,-65218.23
2032,7/1/2020,7/1/2020,Stephen O'Donnell,Imported from reimbursements-Meal Per Diem,,HJ,,8.29,-65226.52
2032,7/1/2020,7/1/2020,Stephen O'Donnell,Imported from reimbursements-Meal Per Diem,,HJ,,9.75,-65236.27
2032,7/1/2020,7/1/2020,Stephen O'Donnell,Imported from reimbursements-Meal Per Diem,,HJ,,10.25,-65246.52
2032,7/1/2020,7/1/2020,Stephen O'Donnell,Imported from reimbursements-Meal Per Diem,,HJ,,10.82,-65257.34
2032,7/1/2020,7/1/2020,Stephen O'Donnell,Imported from reimbursements-Meal Per Diem,,HJ,,13.91,-65271.25
2032,7/1/2020,7/1/2020,Stephen O'Donnell,Imported from reimbursements-Meal Per Diem,,HJ,,14.04,-65285.29
2032,7/1/2020,7/1/2020,Stephen O'Donnell,Imported from reimbursements-NYC public transit card,,HJ,,12,-65297.29
2032,7/1/2020,7/1/2020,Stephen O'Donnell,Imported from reimbursements-Shipping laptops from NYC to Chi,,HJ,,573.48,-65870.77
2032,7/1/2020,7/1/2020,Stephen O'Donnell,Imported from reimbursements-parking for CB pickup,,HJ,,66,-65936.77
2032,7/2/2020,7/2/2020,Angela Mason,Imported from Bank of America Visa-Chicago Storage,,HJ,,149,-66085.77
2032,7/2/2020,7/2/2020,Angela Mason,Imported from Bank of America Visa-Chicago Storage,,HJ,,173,-66258.77
2032,7/2/2020,7/2/2020,Cathryn Cook,Imported from Bank of America Visa-Mouse for staff member with carpal tunnel,,HJ,,4.51,-66263.28
2032,7/2/2020,7/2/2020,Cathryn Cook,Imported from Bank of America Visa-Mouse for staff member with carpal tunnel,,HJ,,6.96,-66270.24
2032,7/2/2020,7/2/2020,Cathryn Cook,Imported from Bank of America Visa-Mouse for staff member with carpal tunnel,,HJ,,6.96,-66277.2
2032,7/2/2020,7/2/2020,Cathryn Cook,Imported from Bank of America Visa-Mouse for staff member with carpal tunnel,,HJ,,22.53,-66299.73
2032,7/2/2020,7/2/2020,Elizabeth Peinado,Imported from Bank of America Visa-New hire packages,,HJ,,4.76,-66304.49
2032,7/2/2020,7/2/2020,Elizabeth Peinado,Imported from Bank of America Visa-New hire packages,,HJ,,7.36,-66311.85
2032,7/2/2020,7/2/2020,Elizabeth Peinado,Imported from Bank of America Visa-New hire packages,,HJ,,7.36,-66319.21
2032,7/2/2020,7/2/2020,Elizabeth Peinado,Imported from Bank of America Visa-New hire packages,,HJ,,23.82,-66343.03
2032,7/2/2020,7/2/2020,Halley Bowman,Imported from Bank of America Visa-white board for office PD book,,HJ,,8.37,-66351.4
2032,7/2/2020,7/2/2020,Halley Bowman,Imported from Bank of America Visa-white board for office PD book,,HJ,,12.93,-66364.33
2032,7/2/2020,7/2/2020,Halley Bowman,Imported from Bank of America Visa-white board for office PD book,,HJ,,12.93,-66377.26
2032,7/2/2020,7/2/2020,Halley Bowman,Imported from Bank of America Visa-white board for office PD book,,HJ,,41.84,-66419.1
2032,7/2/2020,7/2/2020,Joseph Zarate,Imported from Bank of America Visa-Equipment,,HJ,,39.75,-66458.85
2032,7/2/2020,7/2/2020,Joseph Zarate,Imported from Bank of America Visa-Equipment,,HJ,,808.92,-67267.77
2032,7/2/2020,7/2/2020,Joseph Zarate,Imported from Bank of America Visa-Refund,,HJ,,21.19,-67288.96
2032,7/2/2020,7/2/2020,Joseph Zarate,Imported from Bank of America Visa-Return Equipment,,HJ,,22.8,-67311.76
2032,7/2/2020,7/2/2020,Maryellen Leneghan,Imported from Bank of America Visa-Staff appreciation mailing EOY presents to fellows and staff,,HJ,,18.85,-67330.61
2032,7/2/2020,7/2/2020,Miriam Kamya,Imported from Bank of America Visa-Monthly LinkedIn Subscription,,HJ,,59.99,-67390.6
2032,7/2/2020,7/2/2020,Monivett Acevedo,Imported from Bank of America Visa-SAM Registration Renewal,,HJ,,49,-67439.6
2032,7/2/2020,7/2/2020,Odalis Polanco,Imported from reimbursements-Finance retreat in Boston,,HJ,,63.1,-67502.7
2032,7/2/2020,7/2/2020,Uriel Guadarrama,Imported from Bank of America Visa-Zoom host add on for Chris,,HJ,,199.8,-67702.5
2032,7/3/2020,7/3/2020,Alan Safran,Imported from Bank of America Visa-Background checks for fellows,,HJ,,4.02,-67706.52
2032,7/3/2020,7/3/2020,Alan Safran,Imported from Bank of America Visa-Background checks for fellows,,HJ,,5.56,-67712.08
2032,7/3/2020,7/3/2020,Alan Safran,Imported from Bank of America Visa-Background checks for fellows,,HJ,,6.2,-67718.28
2032,7/3/2020,7/3/2020,Alan Safran,Imported from Bank of America Visa-Background checks for fellows,,HJ,,6.21,-67724.49
2032,7/3/2020,7/3/2020,Alan Safran,Imported from Bank of America Visa-Background checks for fellows,,HJ,,8.58,-67733.07
2032,7/3/2020,7/3/2020,Alan Safran,Imported from Bank of America Visa-Background checks for fellows,,HJ,,8.59,-67741.66
2032,7/3/2020,7/3/2020,Alan Safran,Imported from Bank of America Visa-Background checks for fellows,,HJ,,20.07,-67761.73
2032,7/3/2020,7/3/2020,Alan Safran,Imported from Bank of America Visa-Background checks for fellows,,HJ,,27.77,-67789.5
2032,7/3/2020,7/3/2020,Antonio Gutierrez,Imported from Bank of America Visa-Storage Space for google drive,,HJ,,1.99,-67791.49
2032,7/3/2020,7/3/2020,Joseph Zarate,Imported from Bank of America Visa-Overnight equipment,,HJ,,158.48,-67949.97
2032,7/3/2020,7/3/2020,Joseph Zarate,Imported from Bank of America Visa-Shipping work item,,HJ,,10.46,-67960.43
2032,7/3/2020,7/3/2020,Joseph Zarate,Imported from Bank of America Visa-Shipping work item,,HJ,,17.57,-67978
2032,7/3/2020,7/3/2020,Joseph Zarate,Imported from Bank of America Visa-shipping,,HJ,,21.1,-67999.1
2032,7/3/2020,7/3/2020,Maryellen Leneghan,Imported from Bank of America Visa-Staff condolence when family member passed,,HJ,,37.99,-68037.09
2032,7/4/2020,7/4/2020,Alan Safran,Imported from Bank of America Visa-Background checks for fellows,,HJ,,3.16,-68040.25
2032,7/4/2020,7/4/2020,Alan Safran,Imported from Bank of America Visa-Background checks for fellows,,HJ,,4.89,-68045.14
2032,7/4/2020,7/4/2020,Alan Safran,Imported from Bank of America Visa-Background checks for fellows,,HJ,,4.89,-68050.03
2032,7/4/2020,7/4/2020,Alan Safran,Imported from Bank of America Visa-Background checks for fellows,,HJ,,15.81,-68065.84
2032,7/5/2020,7/5/2020,Alan Safran,Imported from Bank of America Visa-Background checks for fellows,,HJ,,5.56,-68071.4
2032,7/5/2020,7/5/2020,Alan Safran,Imported from Bank of America Visa-Background checks for fellows,,HJ,,8.58,-68079.98
2032,7/5/2020,7/5/2020,Alan Safran,Imported from Bank of America Visa-Background checks for fellows,,HJ,,8.59,-68088.57
2032,7/5/2020,7/5/2020,Alan Safran,Imported from Bank of America Visa-Background checks for fellows,,HJ,,27.77,-68116.34
2032,7/5/2020,7/5/2020,Alan Safran,Imported from Bank of America Visa-FL business expenses,,HJ,,47.04,-68163.38
2032,7/5/2020,7/5/2020,Alan Safran,Imported from Bank of America Visa-Monthly google storage for Alan,,HJ,,1.99,-68165.37
2032,7/5/2020,7/5/2020,Joseph Zarate,Imported from Bank of America Visa-Equipment,,HJ,,832.88,-68998.25
2032,7/6/2020,7/6/2020,7062020,BofA CC Transaction June Payment-BofA CC Transaction June Payment,,HJ,29.99,,-68968.26
2032,7/6/2020,7/6/2020,7062020,BofA CC Transaction June Payment-BofA CC Transaction June Payment,,HJ,1009.49,,-67958.77
2032,7/6/2020,7/6/2020,7062020,BofA CC Transaction June Payment-BofA CC Transaction June Payment,,HJ,1249.47,,-66709.3
2032,7/6/2020,7/6/2020,7062020,BofA CC Transaction June Payment-BofA CC Transaction June Payment,,HJ,4131.52,,-62577.78
2032,7/6/2020,7/6/2020,7062020,BofA CC Transaction June Payment-BofA CC Transaction June Payment,,HJ,4226.99,,-58350.79
2032,7/6/2020,7/6/2020,7062020,BofA CC Transaction June Payment-BofA CC Transaction June Payment,,HJ,6292.59,,-52058.2
2032,7/6/2020,7/6/2020,7062020,BofA CC Transaction June Payment-BofA CC Transaction June Payment,,HJ,7964.24,,-44093.96
2032,7/6/2020,7/6/2020,7062020,BofA CC Transaction June Payment-BofA CC Transaction June Payment,,HJ,15666.99,,-28426.97
2032,7/6/2020,7/6/2020,Halley Bowman,Imported from Bank of America Visa-Thank you gift for helping with curriculum,,HJ,,26.84,-28453.81
2032,7/6/2020,7/6/2020,Halley Bowman,Imported from Bank of America Visa-Thank you gift for helping with curriculum,,HJ,,28.61,-28482.42
2032,7/6/2020,7/6/2020,Joseph Zarate,Imported from Bank of America Visa-Equipment,,HJ,,10.79,-28493.21
2032,7/6/2020,7/6/2020,Joseph Zarate,Imported from Bank of America Visa-Equipment,,HJ,,725,-29218.21
2032,7/6/2020,7/6/2020,Joseph Zarate,Imported from Bank of America Visa-shipping,,HJ,,21.1,-29239.31
2032,7/6/2020,7/6/2020,Odalis Polanco,Imported from reimbursements-1st day of new hire Brakfast and lunch,,HJ,,82.87,-29322.18
2032,7/7/2020,7/7/2020,Alan Safran,Imported from Bank of America Visa-Background checks for fellows,,HJ,,3.16,-29325.34
2032,7/7/2020,7/7/2020,Alan Safran,Imported from Bank of America Visa-Background checks for fellows,,HJ,,4.02,-29329.36
2032,7/7/2020,7/7/2020,Alan Safran,Imported from Bank of America Visa-Background checks for fellows,,HJ,,4.02,-29333.38
2032,7/7/2020,7/7/2020,Alan Safran,Imported from Bank of America Visa-Background checks for fellows,,HJ,,4.02,-29337.4
2032,7/7/2020,7/7/2020,Alan Safran,Imported from Bank of America Visa-Background checks for fellows,,HJ,,4.89,-29342.29
2032,7/7/2020,7/7/2020,Alan Safran,Imported from Bank of America Visa-Background checks for fellows,,HJ,,4.89,-29347.18
2032,7/7/2020,7/7/2020,Alan Safran,Imported from Bank of America Visa-Background checks for fellows,,HJ,,6.2,-29353.38
2032,7/7/2020,7/7/2020,Alan Safran,Imported from Bank of America Visa-Background checks for fellows,,HJ,,6.2,-29359.58
2032,7/7/2020,7/7/2020,Alan Safran,Imported from Bank of America Visa-Background checks for fellows,,HJ,,6.2,-29365.78
2032,7/7/2020,7/7/2020,Alan Safran,Imported from Bank of America Visa-Background checks for fellows,,HJ,,6.21,-29371.99
2032,7/7/2020,7/7/2020,Alan Safran,Imported from Bank of America Visa-Background checks for fellows,,HJ,,6.21,-29378.2
2032,7/7/2020,7/7/2020,Alan Safran,Imported from Bank of America Visa-Background checks for fellows,,HJ,,6.21,-29384.41
2032,7/7/2020,7/7/2020,Alan Safran,Imported from Bank of America Visa-Background checks for fellows,,HJ,,13.48,-29397.89
2032,7/7/2020,7/7/2020,Alan Safran,Imported from Bank of America Visa-Background checks for fellows,,HJ,,15.81,-29413.7
2032,7/7/2020,7/7/2020,Alan Safran,Imported from Bank of America Visa-Background checks for fellows,,HJ,,20.07,-29433.77
2032,7/7/2020,7/7/2020,Alan Safran,Imported from Bank of America Visa-Background checks for fellows,,HJ,,20.07,-29453.84
2032,7/7/2020,7/7/2020,Alan Safran,Imported from Bank of America Visa-Background checks for fellows,,HJ,,20.07,-29473.91
2032,7/7/2020,7/7/2020,Alan Safran,Imported from Bank of America Visa-Background checks for fellows,,HJ,,20.82,-29494.73
2032,7/7/2020,7/7/2020,Alan Safran,Imported from Bank of America Visa-Background checks for fellows,,HJ,,20.83,-29515.56
2032,7/7/2020,7/7/2020,Alan Safran,Imported from Bank of America Visa-Background checks for fellows,,HJ,,67.37,-29582.93
2032,7/7/2020,7/7/2020,Antonio Gutierrez,Imported from Bank of America Visa-Fellow Recruitment,,HJ,,900,-30482.93
2032,7/7/2020,7/7/2020,Joseph Zarate,Imported from Bank of America Visa-Equipment,,HJ,,7.48,-30490.41
2032,7/7/2020,7/7/2020,Joseph Zarate,Imported from Bank of America Visa-Equipment,,HJ,,118.79,-30609.2
2032,7/7/2020,7/7/2020,Joseph Zarate,Imported from Bank of America Visa-Equipment,,HJ,,455,-31064.2
2032,7/7/2020,7/7/2020,Joseph Zarate,Imported from Bank of America Visa-Equipment,,HJ,,455,-31519.2
2032,7/7/2020,7/7/2020,Joseph Zarate,Imported from Bank of America Visa-Equipment,,HJ,,455,-31974.2
2032,7/7/2020,7/7/2020,Joseph Zarate,Imported from Bank of America Visa-Equipment,,HJ,,516.06,-32490.26
2032,7/7/2020,7/7/2020,Joseph Zarate,Imported from Bank of America Visa-Equipment,,HJ,,699.95,-33190.21
2032,7/7/2020,7/7/2020,Joseph Zarate,Imported from Bank of America Visa-Equipment,,HJ,,1062.08,-34252.29
2032,7/7/2020,7/7/2020,Joseph Zarate,Imported from Bank of America Visa-cleaning supplies,,HJ,,19.99,-34272.28
2032,7/7/2020,7/7/2020,Joseph Zarate,Imported from Bank of America Visa-shipping,,HJ,,8.4,-34280.68
2032,7/7/2020,7/7/2020,Joseph Zarate,Imported from Bank of America Visa-shipping,,HJ,,15.05,-34295.73
2032,7/7/2020,7/7/2020,Joseph Zarate,Imported from Bank of America Visa-shipping,,HJ,,22.8,-34318.53
2032,7/7/2020,7/7/2020,Myesha Hossain,Imported from Bank of America Visa-Packaging supplies,,HJ,,15.26,-34333.79
2032,7/7/2020,7/7/2020,Myesha Hossain,Imported from Bank of America Visa-Return equipment to Zarate,,HJ,,67.2,-34400.99
2032,7/8/2020,7/8/2020,Alan Safran,Imported from Bank of America Visa-Background checks for fellows,,HJ,,3.16,-34404.15
2032,7/8/2020,7/8/2020,Alan Safran,Imported from Bank of America Visa-Background checks for fellows,,HJ,,3.16,-34407.31
2032,7/8/2020,7/8/2020,Alan Safran,Imported from Bank of America Visa-Background checks for fellows,,HJ,,3.16,-34410.47
2032,7/8/2020,7/8/2020,Alan Safran,Imported from Bank of America Visa-Background checks for fellows,,HJ,,3.16,-34413.63
2032,7/8/2020,7/8/2020,Alan Safran,Imported from Bank of America Visa-Background checks for fellows,,HJ,,3.16,-34416.79
2032,7/8/2020,7/8/2020,Alan Safran,Imported from Bank of America Visa-Background checks for fellows,,HJ,,3.16,-34419.95
2032,7/8/2020,7/8/2020,Alan Safran,Imported from Bank of America Visa-Background checks for fellows,,HJ,,3.16,-34423.11
2032,7/8/2020,7/8/2020,Alan Safran,Imported from Bank of America Visa-Background checks for fellows,,HJ,,3.16,-34426.27
2032,7/8/2020,7/8/2020,Alan Safran,Imported from Bank of America Visa-Background checks for fellows,,HJ,,4.02,-34430.29
2032,7/8/2020,7/8/2020,Alan Safran,Imported from Bank of America Visa-Background checks for fellows,,HJ,,4.02,-34434.31
2032,7/8/2020,7/8/2020,Alan Safran,Imported from Bank of America Visa-Background checks for fellows,,HJ,,4.89,-34439.2
2032,7/8/2020,7/8/2020,Alan Safran,Imported from Bank of America Visa-Background checks for fellows,,HJ,,4.89,-34444.09
2032,7/8/2020,7/8/2020,Alan Safran,Imported from Bank of America Visa-Background checks for fellows,,HJ,,4.89,-34448.98
2032,7/8/2020,7/8/2020,Alan Safran,Imported from Bank of America Visa-Background checks for fellows,,HJ,,4.89,-34453.87
2032,7/8/2020,7/8/2020,Alan Safran,Imported from Bank of America Visa-Background checks for fellows,,HJ,,4.89,-34458.76
2032,7/8/2020,7/8/2020,Alan Safran,Imported from Bank of America Visa-Background checks for fellows,,HJ,,4.89,-34463.65
2032,7/8/2020,7/8/2020,Alan Safran,Imported from Bank of America Visa-Background checks for fellows,,HJ,,4.89,-34468.54
2032,7/8/2020,7/8/2020,Alan Safran,Imported from Bank of America Visa-Background checks for fellows,,HJ,,4.89,-34473.43
2032,7/8/2020,7/8/2020,Alan Safran,Imported from Bank of America Visa-Background checks for fellows,,HJ,,4.89,-34478.32
2032,7/8/2020,7/8/2020,Alan Safran,Imported from Bank of America Visa-Background checks for fellows,,HJ,,4.89,-34483.21
2032,7/8/2020,7/8/2020,Alan Safran,Imported from Bank of America Visa-Background checks for fellows,,HJ,,4.89,-34488.1
2032,7/8/2020,7/8/2020,Alan Safran,Imported from Bank of America Visa-Background checks for fellows,,HJ,,4.89,-34492.99
2032,7/8/2020,7/8/2020,Alan Safran,Imported from Bank of America Visa-Background checks for fellows,,HJ,,4.89,-34497.88
2032,7/8/2020,7/8/2020,Alan Safran,Imported from Bank of America Visa-Background checks for fellows,,HJ,,4.89,-34502.77
2032,7/8/2020,7/8/2020,Alan Safran,Imported from Bank of America Visa-Background checks for fellows,,HJ,,4.89,-34507.66
2032,7/8/2020,7/8/2020,Alan Safran,Imported from Bank of America Visa-Background checks for fellows,,HJ,,4.89,-34512.55
2032,7/8/2020,7/8/2020,Alan Safran,Imported from Bank of America Visa-Background checks for fellows,,HJ,,6.2,-34518.75
2032,7/8/2020,7/8/2020,Alan Safran,Imported from Bank of America Visa-Background checks for fellows,,HJ,,6.2,-34524.95
2032,7/8/2020,7/8/2020,Alan Safran,Imported from Bank of America Visa-Background checks for fellows,,HJ,,6.21,-34531.16
2032,7/8/2020,7/8/2020,Alan Safran,Imported from Bank of America Visa-Background checks for fellows,,HJ,,6.21,-34537.37
2032,7/8/2020,7/8/2020,Alan Safran,Imported from Bank of America Visa-Background checks for fellows,,HJ,,6.93,-34544.3
2032,7/8/2020,7/8/2020,Alan Safran,Imported from Bank of America Visa-Background checks for fellows,,HJ,,10.71,-34555.01
2032,7/8/2020,7/8/2020,Alan Safran,Imported from Bank of America Visa-Background checks for fellows,,HJ,,10.71,-34565.72
2032,7/8/2020,7/8/2020,Alan Safran,Imported from Bank of America Visa-Background checks for fellows,,HJ,,15.81,-34581.53
2032,7/8/2020,7/8/2020,Alan Safran,Imported from Bank of America Visa-Background checks for fellows,,HJ,,15.81,-34597.34
2032,7/8/2020,7/8/2020,Alan Safran,Imported from Bank of America Visa-Background checks for fellows,,HJ,,15.81,-34613.15
2032,7/8/2020,7/8/2020,Alan Safran,Imported from Bank of America Visa-Background checks for fellows,,HJ,,15.81,-34628.96
2032,7/8/2020,7/8/2020,Alan Safran,Imported from Bank of America Visa-Background checks for fellows,,HJ,,15.81,-34644.77
2032,7/8/2020,7/8/2020,Alan Safran,Imported from Bank of America Visa-Background checks for fellows,,HJ,,15.81,-34660.58
2032,7/8/2020,7/8/2020,Alan Safran,Imported from Bank of America Visa-Background checks for fellows,,HJ,,15.81,-34676.39
2032,7/8/2020,7/8/2020,Alan Safran,Imported from Bank of America Visa-Background checks for fellows,,HJ,,15.81,-34692.2
2032,7/8/2020,7/8/2020,Alan Safran,Imported from Bank of America Visa-Background checks for fellows,,HJ,,20.07,-34712.27
2032,7/8/2020,7/8/2020,Alan Safran,Imported from Bank of America Visa-Background checks for fellows,,HJ,,20.07,-34732.34
2032,7/8/2020,7/8/2020,Alan Safran,Imported from Bank of America Visa-Background checks for fellows,,HJ,,34.65,-34766.99
2032,7/8/2020,7/8/2020,Antonio Gutierrez,Imported from Bank of America Visa-X Co.  Website Fellow Recruitment,,HJ,,77.94,-34844.93
2032,7/8/2020,7/8/2020,Elizabeth Peinado,Imported from Bank of America Visa-Job posting for all regions,,HJ,,552.97,-35397.9
2032,7/8/2020,7/8/2020,Elizabeth Peinado,Imported from Bank of America Visa-Job posting for all regions,,HJ,,854.59,-36252.49
2032,7/8/2020,7/8/2020,Elizabeth Peinado,Imported from Bank of America Visa-Job posting for all regions,,HJ,,854.59,-37107.08
2032,7/8/2020,7/8/2020,Elizabeth Peinado,Imported from Bank of America Visa-Job posting for all regions,,HJ,,2764.83,-39871.91
2032,7/8/2020,7/8/2020,Joseph Zarate,Imported from Bank of America Visa-Equipment,,HJ,,12.59,-39884.5
2032,7/8/2020,7/8/2020,Joseph Zarate,Imported from Bank of America Visa-cleaning supplies,,HJ,,29.96,-39914.46
2032,7/8/2020,7/8/2020,Joseph Zarate,Imported from Bank of America Visa-shipping,,HJ,,22.8,-39937.26
2032,7/8/2020,7/8/2020,Mahaliah Sejour,Imported from Bank of America Visa-printer,,HJ,,5.35,-39942.61
2032,7/8/2020,7/8/2020,Monivett Acevedo,Imported from Bank of America Visa-Abila -Financial Training,,HJ,,460,-40402.61
2032,7/8/2020,7/8/2020,Monivett Acevedo,Imported from Bank of America Visa-Adobe Acrobat,,HJ,,14.99,-40417.6
2032,7/8/2020,7/8/2020,Monivett Acevedo,Imported from Bank of America Visa-Bill.com AP,,HJ,,156.6,-40574.2
2032,7/8/2020,7/8/2020,Monivett Acevedo,Imported from Bank of America Visa-Office Monthly printer ink,,HJ,,10.61,-40584.81
2032,7/8/2020,7/8/2020,Nicole Prahin,Imported from Bank of America Visa-Printing,,HJ,,5.35,-40590.16
2032,7/9/2020,7/9/2020,Alan Safran,Imported from Bank of America Visa-Background checks for fellows,,HJ,,3.16,-40593.32
2032,7/9/2020,7/9/2020,Alan Safran,Imported from Bank of America Visa-Background checks for fellows,,HJ,,3.16,-40596.48
2032,7/9/2020,7/9/2020,Alan Safran,Imported from Bank of America Visa-Background checks for fellows,,HJ,,4.02,-40600.5
2032,7/9/2020,7/9/2020,Alan Safran,Imported from Bank of America Visa-Background checks for fellows,,HJ,,4.02,-40604.52
2032,7/9/2020,7/9/2020,Alan Safran,Imported from Bank of America Visa-Background checks for fellows,,HJ,,4.89,-40609.41
2032,7/9/2020,7/9/2020,Alan Safran,Imported from Bank of America Visa-Background checks for fellows,,HJ,,4.89,-40614.3
2032,7/9/2020,7/9/2020,Alan Safran,Imported from Bank of America Visa-Background checks for fellows,,HJ,,4.89,-40619.19
2032,7/9/2020,7/9/2020,Alan Safran,Imported from Bank of America Visa-Background checks for fellows,,HJ,,4.89,-40624.08
2032,7/9/2020,7/9/2020,Alan Safran,Imported from Bank of America Visa-Background checks for fellows,,HJ,,5.06,-40629.14
2032,7/9/2020,7/9/2020,Alan Safran,Imported from Bank of America Visa-Background checks for fellows,,HJ,,5.06,-40634.2
2032,7/9/2020,7/9/2020,Alan Safran,Imported from Bank of America Visa-Background checks for fellows,,HJ,,6.2,-40640.4
2032,7/9/2020,7/9/2020,Alan Safran,Imported from Bank of America Visa-Background checks for fellows,,HJ,,6.2,-40646.6
2032,7/9/2020,7/9/2020,Alan Safran,Imported from Bank of America Visa-Background checks for fellows,,HJ,,6.21,-40652.81
2032,7/9/2020,7/9/2020,Alan Safran,Imported from Bank of America Visa-Background checks for fellows,,HJ,,6.21,-40659.02
2032,7/9/2020,7/9/2020,Alan Safran,Imported from Bank of America Visa-Background checks for fellows,,HJ,,6.38,-40665.4
2032,7/9/2020,7/9/2020,Alan Safran,Imported from Bank of America Visa-Background checks for fellows,,HJ,,7.81,-40673.21
2032,7/9/2020,7/9/2020,Alan Safran,Imported from Bank of America Visa-Background checks for fellows,,HJ,,7.82,-40681.03
2032,7/9/2020,7/9/2020,Alan Safran,Imported from Bank of America Visa-Background checks for fellows,,HJ,,7.82,-40688.85
2032,7/9/2020,7/9/2020,Alan Safran,Imported from Bank of America Visa-Background checks for fellows,,HJ,,7.82,-40696.67
2032,7/9/2020,7/9/2020,Alan Safran,Imported from Bank of America Visa-Background checks for fellows,,HJ,,7.82,-40704.49
2032,7/9/2020,7/9/2020,Alan Safran,Imported from Bank of America Visa-Background checks for fellows,,HJ,,9.86,-40714.35
2032,7/9/2020,7/9/2020,Alan Safran,Imported from Bank of America Visa-Background checks for fellows,,HJ,,9.86,-40724.21
2032,7/9/2020,7/9/2020,Alan Safran,Imported from Bank of America Visa-Background checks for fellows,,HJ,,12.07,-40736.28
2032,7/9/2020,7/9/2020,Alan Safran,Imported from Bank of America Visa-Background checks for fellows,,HJ,,12.07,-40748.35
2032,7/9/2020,7/9/2020,Alan Safran,Imported from Bank of America Visa-Background checks for fellows,,HJ,,15.81,-40764.16
2032,7/9/2020,7/9/2020,Alan Safran,Imported from Bank of America Visa-Background checks for fellows,,HJ,,15.81,-40779.97
2032,7/9/2020,7/9/2020,Alan Safran,Imported from Bank of America Visa-Background checks for fellows,,HJ,,20.07,-40800.04
2032,7/9/2020,7/9/2020,Alan Safran,Imported from Bank of America Visa-Background checks for fellows,,HJ,,20.07,-40820.11
2032,7/9/2020,7/9/2020,Alan Safran,Imported from Bank of America Visa-Background checks for fellows,,HJ,,25.3,-40845.41
2032,7/9/2020,7/9/2020,Alan Safran,Imported from Bank of America Visa-Background checks for fellows,,HJ,,25.3,-40870.71
2032,7/9/2020,7/9/2020,Alan Safran,Imported from Bank of America Visa-Background checks for fellows,,HJ,,31.9,-40902.61
2032,7/9/2020,7/9/2020,Alan Safran,Imported from Bank of America Visa-Background checks for fellows,,HJ,,39.05,-40941.66
2032,7/9/2020,7/9/2020,Antonio Gutierrez,Imported from Bank of America Visa-Fellow Recruitment,,HJ,,900,-41841.66
2032,7/9/2020,7/9/2020,Elizabeth Peinado,Imported from Bank of America Visa-Posting on Ed Week Top School Jobs,,HJ,,32.45,-41874.11
2032,7/9/2020,7/9/2020,Elizabeth Peinado,Imported from Bank of America Visa-Posting on Ed Week Top School Jobs,,HJ,,32.45,-41906.56
2032,7/9/2020,7/9/2020,Elizabeth Peinado,Imported from Bank of America Visa-Posting on Ed Week Top School Jobs,,HJ,,50.15,-41956.71
2032,7/9/2020,7/9/2020,Elizabeth Peinado,Imported from Bank of America Visa-Posting on Ed Week Top School Jobs,,HJ,,50.15,-42006.86
2032,7/9/2020,7/9/2020,Elizabeth Peinado,Imported from Bank of America Visa-Posting on Ed Week Top School Jobs,,HJ,,50.15,-42057.01
2032,7/9/2020,7/9/2020,Elizabeth Peinado,Imported from Bank of America Visa-Posting on Ed Week Top School Jobs,,HJ,,50.15,-42107.16
2032,7/9/2020,7/9/2020,Elizabeth Peinado,Imported from Bank of America Visa-Posting on Ed Week Top School Jobs,,HJ,,121,-42228.16
2032,7/9/2020,7/9/2020,Elizabeth Peinado,Imported from Bank of America Visa-Posting on Ed Week Top School Jobs,,HJ,,132,-42360.16
2032,7/9/2020,7/9/2020,Elizabeth Peinado,Imported from Bank of America Visa-Posting on Ed Week Top School Jobs,,HJ,,162.25,-42522.41
2032,7/9/2020,7/9/2020,Elizabeth Peinado,Imported from Bank of America Visa-Posting on Ed Week Top School Jobs,,HJ,,162.25,-42684.66
2032,7/9/2020,7/9/2020,Elizabeth Peinado,Imported from Bank of America Visa-Posting on Ed Week Top School Jobs,,HJ,,187,-42871.66
2032,7/9/2020,7/9/2020,Elizabeth Peinado,Imported from Bank of America Visa-Posting on Ed Week Top School Jobs,,HJ,,187,-43058.66
2032,7/9/2020,7/9/2020,Elizabeth Peinado,Imported from Bank of America Visa-Posting on Ed Week Top School Jobs,,HJ,,204,-43262.66
2032,7/9/2020,7/9/2020,Elizabeth Peinado,Imported from Bank of America Visa-Posting on Ed Week Top School Jobs,,HJ,,204,-43466.66
2032,7/9/2020,7/9/2020,Elizabeth Peinado,Imported from Bank of America Visa-Posting on Ed Week Top School Jobs,,HJ,,605,-44071.66
2032,7/9/2020,7/9/2020,Elizabeth Peinado,Imported from Bank of America Visa-Posting on Ed Week Top School Jobs,,HJ,,660,-44731.66
2032,7/9/2020,7/9/2020,Halley Bowman,Imported from Bank of America Visa-PD book for Curriculum Writer,,HJ,,1.1,-44732.76
2032,7/9/2020,7/9/2020,Halley Bowman,Imported from Bank of America Visa-PD book for Curriculum Writer,,HJ,,1.7,-44734.46
2032,7/9/2020,7/9/2020,Halley Bowman,Imported from Bank of America Visa-PD book for Curriculum Writer,,HJ,,1.7,-44736.16
2032,7/9/2020,7/9/2020,Halley Bowman,Imported from Bank of America Visa-PD book for Curriculum Writer,,HJ,,5.49,-44741.65
2032,7/9/2020,7/9/2020,Joseph Zarate,Imported from Bank of America Visa-Equipment,,HJ,,455,-45196.65
2032,7/9/2020,7/9/2020,Joseph Zarate,Imported from Bank of America Visa-Equipment,,HJ,,455,-45651.65
2032,7/9/2020,7/9/2020,Joseph Zarate,Imported from Bank of America Visa-Equipment,,HJ,,463.99,-46115.64
2032,7/9/2020,7/9/2020,Joseph Zarate,Imported from Bank of America Visa-Partial refund,,HJ,6.05,,-46109.59
2032,7/9/2020,7/9/2020,Joseph Zarate,Imported from Bank of America Visa-acrobat,,HJ,,118.41,-46228
2032,7/9/2020,7/9/2020,Joseph Zarate,Imported from Bank of America Visa-shipping,,HJ,,21.1,-46249.1
2032,7/10/2020,7/10/2020,Alan Safran,Imported from Bank of America Visa-Background checks for fellows,,HJ,,2.92,-46252.02
2032,7/10/2020,7/10/2020,Alan Safran,Imported from Bank of America Visa-Background checks for fellows,,HJ,,3.16,-46255.18
2032,7/10/2020,7/10/2020,Alan Safran,Imported from Bank of America Visa-Background checks for fellows,,HJ,,3.16,-46258.34
2032,7/10/2020,7/10/2020,Alan Safran,Imported from Bank of America Visa-Background checks for fellows,,HJ,,3.16,-46261.5
2032,7/10/2020,7/10/2020,Alan Safran,Imported from Bank of America Visa-Background checks for fellows,,HJ,,4.5,-46266
2032,7/10/2020,7/10/2020,Alan Safran,Imported from Bank of America Visa-Background checks for fellows,,HJ,,4.51,-46270.51
2032,7/10/2020,7/10/2020,Alan Safran,Imported from Bank of America Visa-Background checks for fellows,,HJ,,4.89,-46275.4
2032,7/10/2020,7/10/2020,Alan Safran,Imported from Bank of America Visa-Background checks for fellows,,HJ,,4.89,-46280.29
2032,7/10/2020,7/10/2020,Alan Safran,Imported from Bank of America Visa-Background checks for fellows,,HJ,,4.89,-46285.18
2032,7/10/2020,7/10/2020,Alan Safran,Imported from Bank of America Visa-Background checks for fellows,,HJ,,4.89,-46290.07
2032,7/10/2020,7/10/2020,Alan Safran,Imported from Bank of America Visa-Background checks for fellows,,HJ,,4.89,-46294.96
2032,7/10/2020,7/10/2020,Alan Safran,Imported from Bank of America Visa-Background checks for fellows,,HJ,,4.89,-46299.85
2032,7/10/2020,7/10/2020,Alan Safran,Imported from Bank of America Visa-Background checks for fellows,,HJ,,6.71,-46306.56
2032,7/10/2020,7/10/2020,Alan Safran,Imported from Bank of America Visa-Background checks for fellows,,HJ,,10.37,-46316.93
2032,7/10/2020,7/10/2020,Alan Safran,Imported from Bank of America Visa-Background checks for fellows,,HJ,,10.37,-46327.3
2032,7/10/2020,7/10/2020,Alan Safran,Imported from Bank of America Visa-Background checks for fellows,,HJ,,14.57,-46341.87
2032,7/10/2020,7/10/2020,Alan Safran,Imported from Bank of America Visa-Background checks for fellows,,HJ,,15.81,-46357.68
2032,7/10/2020,7/10/2020,Alan Safran,Imported from Bank of America Visa-Background checks for fellows,,HJ,,15.81,-46373.49
2032,7/10/2020,7/10/2020,Alan Safran,Imported from Bank of America Visa-Background checks for fellows,,HJ,,15.81,-46389.3
2032,7/10/2020,7/10/2020,Alan Safran,Imported from Bank of America Visa-Background checks for fellows,,HJ,,33.55,-46422.85
2032,7/10/2020,7/10/2020,Joseph Zarate,Imported from Bank of America Visa-Equipment,,HJ,,455,-46877.85
2032,7/10/2020,7/10/2020,Joseph Zarate,Imported from Bank of America Visa-New hire equipment,,HJ,,450,-47327.85
2032,7/10/2020,7/10/2020,Joseph Zarate,Imported from Bank of America Visa-Partial refund,,HJ,6.05,,-47321.8
2032,7/10/2020,7/10/2020,Monivett Acevedo,Imported from Bank of America Visa-Abila,,HJ,460,,-46861.8
2032,7/10/2020,7/10/2020,Monivett Acevedo,Imported from Bank of America Visa-COI for CPS,,HJ,,12,-46873.8
2032,7/10/2020,7/10/2020,Odalis Polanco,Imported from reimbursements-Finance retreat,,HJ,,12,-46885.8
2032,7/10/2020,7/10/2020,Odalis Polanco,Imported from reimbursements-Finance retreat in Boston,,HJ,,26.16,-46911.96
2032,7/10/2020,7/10/2020,Uriel Guadarrama,Imported from Bank of America Visa-Zoom annual license for Claice,,HJ,,291.72,-47203.68
2032,7/11/2020,7/11/2020,Alan Safran,Imported from Bank of America Visa-Background checks for fellows,,HJ,,3.16,-47206.84
2032,7/11/2020,7/11/2020,Alan Safran,Imported from Bank of America Visa-Background checks for fellows,,HJ,,3.16,-47210
2032,7/11/2020,7/11/2020,Alan Safran,Imported from Bank of America Visa-Background checks for fellows,,HJ,,3.16,-47213.16
2032,7/11/2020,7/11/2020,Alan Safran,Imported from Bank of America Visa-Background checks for fellows,,HJ,,4.02,-47217.18
2032,7/11/2020,7/11/2020,Alan Safran,Imported from Bank of America Visa-Background checks for fellows,,HJ,,4.02,-47221.2
2032,7/11/2020,7/11/2020,Alan Safran,Imported from Bank of America Visa-Background checks for fellows,,HJ,,4.89,-47226.09
2032,7/11/2020,7/11/2020,Alan Safran,Imported from Bank of America Visa-Background checks for fellows,,HJ,,4.89,-47230.98
2032,7/11/2020,7/11/2020,Alan Safran,Imported from Bank of America Visa-Background checks for fellows,,HJ,,4.89,-47235.87
2032,7/11/2020,7/11/2020,Alan Safran,Imported from Bank of America Visa-Background checks for fellows,,HJ,,4.89,-47240.76
2032,7/11/2020,7/11/2020,Alan Safran,Imported from Bank of America Visa-Background checks for fellows,,HJ,,4.89,-47245.65
2032,7/11/2020,7/11/2020,Alan Safran,Imported from Bank of America Visa-Background checks for fellows,,HJ,,4.89,-47250.54
2032,7/11/2020,7/11/2020,Alan Safran,Imported from Bank of America Visa-Background checks for fellows,,HJ,,6.2,-47256.74
2032,7/11/2020,7/11/2020,Alan Safran,Imported from Bank of America Visa-Background checks for fellows,,HJ,,6.2,-47262.94
2032,7/11/2020,7/11/2020,Alan Safran,Imported from Bank of America Visa-Background checks for fellows,,HJ,,6.21,-47269.15
2032,7/11/2020,7/11/2020,Alan Safran,Imported from Bank of America Visa-Background checks for fellows,,HJ,,6.21,-47275.36
2032,7/11/2020,7/11/2020,Alan Safran,Imported from Bank of America Visa-Background checks for fellows,,HJ,,15.81,-47291.17
2032,7/11/2020,7/11/2020,Alan Safran,Imported from Bank of America Visa-Background checks for fellows,,HJ,,15.81,-47306.98
2032,7/11/2020,7/11/2020,Alan Safran,Imported from Bank of America Visa-Background checks for fellows,,HJ,,15.81,-47322.79
2032,7/11/2020,7/11/2020,Alan Safran,Imported from Bank of America Visa-Background checks for fellows,,HJ,,20.07,-47342.86
2032,7/11/2020,7/11/2020,Alan Safran,Imported from Bank of America Visa-Background checks for fellows,,HJ,,20.07,-47362.93
2032,7/11/2020,7/11/2020,Antonio Gutierrez,Imported from Bank of America Visa-Fellow Recruitment,,HJ,,900,-48262.93
2032,7/11/2020,7/11/2020,Halley Bowman,Imported from Bank of America Visa-PD book for Curriculum Writer,,HJ,,1.1,-48264.03
2032,7/11/2020,7/11/2020,Halley Bowman,Imported from Bank of America Visa-PD book for Curriculum Writer,,HJ,,1.7,-48265.73
2032,7/11/2020,7/11/2020,Halley Bowman,Imported from Bank of America Visa-PD book for Curriculum Writer,,HJ,,1.7,-48267.43
2032,7/11/2020,7/11/2020,Halley Bowman,Imported from Bank of America Visa-PD book for Curriculum Writer,,HJ,,5.49,-48272.92
2032,7/11/2020,7/11/2020,Joseph Zarate,Imported from Bank of America Visa-New hire equipment,,HJ,,9.12,-48282.04
2032,7/11/2020,7/11/2020,Joseph Zarate,Imported from Bank of America Visa-shipping,,HJ,,15.05,-48297.09
2032,7/12/2020,7/12/2020,Antonio Gutierrez,Imported from Bank of America Visa-Fellow Recruitment,,HJ,,900,-49197.09
2032,7/12/2020,7/12/2020,Antonio Gutierrez,Imported from Bank of America Visa-Phone and Fax System,,HJ,,234.79,-49431.88
2032,7/12/2020,7/12/2020,Joseph Zarate,Imported from Bank of America Visa-shipping,,HJ,,54.02,-49485.9
2032,7/13/2020,7/13/2020,Alan Safran,Imported from Bank of America Visa-Background checks for fellows,,HJ,,4.02,-49489.92
2032,7/13/2020,7/13/2020,Alan Safran,Imported from Bank of America Visa-Background checks for fellows,,HJ,,6.2,-49496.12
2032,7/13/2020,7/13/2020,Alan Safran,Imported from Bank of America Visa-Background checks for fellows,,HJ,,6.21,-49502.33
2032,7/13/2020,7/13/2020,Alan Safran,Imported from Bank of America Visa-Background checks for fellows,,HJ,,14.85,-49517.18
2032,7/13/2020,7/13/2020,Alan Safran,Imported from Bank of America Visa-Background checks for fellows,,HJ,,20.07,-49537.25
2032,7/13/2020,7/13/2020,Alan Safran,Imported from Bank of America Visa-Background checks for fellows,,HJ,,22.95,-49560.2
2032,7/13/2020,7/13/2020,Alan Safran,Imported from Bank of America Visa-Background checks for fellows,,HJ,,22.95,-49583.15
2032,7/13/2020,7/13/2020,Alan Safran,Imported from Bank of America Visa-Background checks for fellows,,HJ,,74.25,-49657.4
2032,7/13/2020,7/13/2020,Antonio Gutierrez,Imported from Bank of America Visa-Fellow Recruitment,,HJ,,531.92,-50189.32
2032,7/13/2020,7/13/2020,Halley Bowman,Imported from Bank of America Visa-wifi booster for Kami,,HJ,,3.3,-50192.62
2032,7/13/2020,7/13/2020,Halley Bowman,Imported from Bank of America Visa-wifi booster for Kami,,HJ,,5.1,-50197.72
2032,7/13/2020,7/13/2020,Halley Bowman,Imported from Bank of America Visa-wifi booster for Kami,,HJ,,5.1,-50202.82
2032,7/13/2020,7/13/2020,Halley Bowman,Imported from Bank of America Visa-wifi booster for Kami,,HJ,,16.49,-50219.31
2032,7/13/2020,7/13/2020,Joseph Zarate,Imported from Bank of America Visa-New hire equipment,,HJ,,106.08,-50325.39
2032,7/13/2020,7/13/2020,Joseph Zarate,Imported from Bank of America Visa-New hire equipment,,HJ,,638.99,-50964.38
2032,7/13/2020,7/13/2020,Joseph Zarate,Imported from Bank of America Visa-New hire equipment,,HJ,,725,-51689.38
2032,7/13/2020,7/13/2020,Joseph Zarate,Imported from Bank of America Visa-shipping,,HJ,,15.05,-51704.43
2032,7/13/2020,7/13/2020,Monivett Acevedo,Imported from Bank of America Visa-book of stamps,,HJ,,11,-51715.43
2032,7/14/2020,7/14/2020,Alan Safran,Imported from Bank of America Visa-Background checks for fellows,,HJ,,3.16,-51718.59
2032,7/14/2020,7/14/2020,Alan Safran,Imported from Bank of America Visa-Background checks for fellows,,HJ,,3.16,-51721.75
2032,7/14/2020,7/14/2020,Alan Safran,Imported from Bank of America Visa-Background checks for fellows,,HJ,,3.16,-51724.91
2032,7/14/2020,7/14/2020,Alan Safran,Imported from Bank of America Visa-Background checks for fellows,,HJ,,3.16,-51728.07
2032,7/14/2020,7/14/2020,Alan Safran,Imported from Bank of America Visa-Background checks for fellows,,HJ,,3.16,-51731.23
2032,7/14/2020,7/14/2020,Alan Safran,Imported from Bank of America Visa-Background checks for fellows,,HJ,,3.16,-51734.39
2032,7/14/2020,7/14/2020,Alan Safran,Imported from Bank of America Visa-Background checks for fellows,,HJ,,3.16,-51737.55
2032,7/14/2020,7/14/2020,Alan Safran,Imported from Bank of America Visa-Background checks for fellows,,HJ,,4.89,-51742.44
2032,7/14/2020,7/14/2020,Alan Safran,Imported from Bank of America Visa-Background checks for fellows,,HJ,,4.89,-51747.33
2032,7/14/2020,7/14/2020,Alan Safran,Imported from Bank of America Visa-Background checks for fellows,,HJ,,4.89,-51752.22
2032,7/14/2020,7/14/2020,Alan Safran,Imported from Bank of America Visa-Background checks for fellows,,HJ,,4.89,-51757.11
2032,7/14/2020,7/14/2020,Alan Safran,Imported from Bank of America Visa-Background checks for fellows,,HJ,,4.89,-51762
2032,7/14/2020,7/14/2020,Alan Safran,Imported from Bank of America Visa-Background checks for fellows,,HJ,,4.89,-51766.89
2032,7/14/2020,7/14/2020,Alan Safran,Imported from Bank of America Visa-Background checks for fellows,,HJ,,4.89,-51771.78
2032,7/14/2020,7/14/2020,Alan Safran,Imported from Bank of America Visa-Background checks for fellows,,HJ,,4.89,-51776.67
2032,7/14/2020,7/14/2020,Alan Safran,Imported from Bank of America Visa-Background checks for fellows,,HJ,,4.89,-51781.56
2032,7/14/2020,7/14/2020,Alan Safran,Imported from Bank of America Visa-Background checks for fellows,,HJ,,4.89,-51786.45
2032,7/14/2020,7/14/2020,Alan Safran,Imported from Bank of America Visa-Background checks for fellows,,HJ,,4.89,-51791.34
2032,7/14/2020,7/14/2020,Alan Safran,Imported from Bank of America Visa-Background checks for fellows,,HJ,,4.89,-51796.23
2032,7/14/2020,7/14/2020,Alan Safran,Imported from Bank of America Visa-Background checks for fellows,,HJ,,4.89,-51801.12
2032,7/14/2020,7/14/2020,Alan Safran,Imported from Bank of America Visa-Background checks for fellows,,HJ,,4.89,-51806.01
2032,7/14/2020,7/14/2020,Alan Safran,Imported from Bank of America Visa-Background checks for fellows,,HJ,,6.16,-51812.17
2032,7/14/2020,7/14/2020,Alan Safran,Imported from Bank of America Visa-Background checks for fellows,,HJ,,7.81,-51819.98
2032,7/14/2020,7/14/2020,Alan Safran,Imported from Bank of America Visa-Background checks for fellows,,HJ,,8.8,-51828.78
2032,7/14/2020,7/14/2020,Alan Safran,Imported from Bank of America Visa-Background checks for fellows,,HJ,,9.52,-51838.3
2032,7/14/2020,7/14/2020,Alan Safran,Imported from Bank of America Visa-Background checks for fellows,,HJ,,9.52,-51847.82
2032,7/14/2020,7/14/2020,Alan Safran,Imported from Bank of America Visa-Background checks for fellows,,HJ,,12.07,-51859.89
2032,7/14/2020,7/14/2020,Alan Safran,Imported from Bank of America Visa-Background checks for fellows,,HJ,,12.07,-51871.96
2032,7/14/2020,7/14/2020,Alan Safran,Imported from Bank of America Visa-Background checks for fellows,,HJ,,13.6,-51885.56
2032,7/14/2020,7/14/2020,Alan Safran,Imported from Bank of America Visa-Background checks for fellows,,HJ,,13.6,-51899.16
2032,7/14/2020,7/14/2020,Alan Safran,Imported from Bank of America Visa-Background checks for fellows,,HJ,,15.81,-51914.97
2032,7/14/2020,7/14/2020,Alan Safran,Imported from Bank of America Visa-Background checks for fellows,,HJ,,15.81,-51930.78
2032,7/14/2020,7/14/2020,Alan Safran,Imported from Bank of America Visa-Background checks for fellows,,HJ,,15.81,-51946.59
2032,7/14/2020,7/14/2020,Alan Safran,Imported from Bank of America Visa-Background checks for fellows,,HJ,,15.81,-51962.4
2032,7/14/2020,7/14/2020,Alan Safran,Imported from Bank of America Visa-Background checks for fellows,,HJ,,15.81,-51978.21
2032,7/14/2020,7/14/2020,Alan Safran,Imported from Bank of America Visa-Background checks for fellows,,HJ,,15.81,-51994.02
2032,7/14/2020,7/14/2020,Alan Safran,Imported from Bank of America Visa-Background checks for fellows,,HJ,,15.81,-52009.83
2032,7/14/2020,7/14/2020,Alan Safran,Imported from Bank of America Visa-Background checks for fellows,,HJ,,30.8,-52040.63
2032,7/14/2020,7/14/2020,Alan Safran,Imported from Bank of America Visa-Background checks for fellows,,HJ,,39.05,-52079.68
2032,7/14/2020,7/14/2020,Alan Safran,Imported from Bank of America Visa-Background checks for fellows,,HJ,,44,-52123.68
2032,7/14/2020,7/14/2020,Alan Safran,Imported from Bank of America Visa-FL business expenses,,HJ,,3.16,-52126.84
2032,7/14/2020,7/14/2020,Alan Safran,Imported from Bank of America Visa-FL business expenses,,HJ,,4.89,-52131.73
2032,7/14/2020,7/14/2020,Alan Safran,Imported from Bank of America Visa-FL business expenses,,HJ,,4.89,-52136.62
2032,7/14/2020,7/14/2020,Alan Safran,Imported from Bank of America Visa-FL business expenses,,HJ,,15.81,-52152.43
2032,7/14/2020,7/14/2020,Antonio Gutierrez,Imported from Bank of America Visa-Fellow Recruitment,,HJ,,900,-53052.43
2032,7/14/2020,7/14/2020,Halley Bowman,Imported from Bank of America Visa-managing and PD materials. HBR subscription,,HJ,,11.65,-53064.08
2032,7/14/2020,7/14/2020,Halley Bowman,Imported from Bank of America Visa-managing and PD materials. HBR subscription,,HJ,,18.01,-53082.09
2032,7/14/2020,7/14/2020,Halley Bowman,Imported from Bank of America Visa-managing and PD materials. HBR subscription,,HJ,,18.01,-53100.1
2032,7/14/2020,7/14/2020,Halley Bowman,Imported from Bank of America Visa-managing and PD materials. HBR subscription,,HJ,,58.26,-53158.36
2032,7/14/2020,7/14/2020,Jennifer Winans,Imported from Bank of America Visa-Indeed; Recruitment Expenses,,HJ,,5001.71,-58160.07
2032,7/14/2020,7/14/2020,Joseph Zarate,Imported from Bank of America Visa-Equipment,,HJ,,1104.99,-59265.06
2032,7/14/2020,7/14/2020,Joseph Zarate,Imported from Bank of America Visa-New hire equipment,,HJ,,19.99,-59285.05
2032,7/14/2020,7/14/2020,Joseph Zarate,Imported from Bank of America Visa-New hire equipment,,HJ,,116.98,-59402.03
2032,7/14/2020,7/14/2020,Monivett Acevedo,Imported from Bank of America Visa-HBR unlimited access for Finance and Grants,,HJ,,180,-59582.03
2032,7/15/2020,7/15/2020,Alan Safran,Imported from Bank of America Visa-Background checks for fellows,,HJ,,2.92,-59584.95
2032,7/15/2020,7/15/2020,Alan Safran,Imported from Bank of America Visa-Background checks for fellows,,HJ,,2.92,-59587.87
2032,7/15/2020,7/15/2020,Alan Safran,Imported from Bank of America Visa-Background checks for fellows,,HJ,,3.16,-59591.03
2032,7/15/2020,7/15/2020,Alan Safran,Imported from Bank of America Visa-Background checks for fellows,,HJ,,3.16,-59594.19
2032,7/15/2020,7/15/2020,Alan Safran,Imported from Bank of America Visa-Background checks for fellows,,HJ,,3.16,-59597.35
2032,7/15/2020,7/15/2020,Alan Safran,Imported from Bank of America Visa-Background checks for fellows,,HJ,,3.16,-59600.51
2032,7/15/2020,7/15/2020,Alan Safran,Imported from Bank of America Visa-Background checks for fellows,,HJ,,4.02,-59604.53
2032,7/15/2020,7/15/2020,Alan Safran,Imported from Bank of America Visa-Background checks for fellows,,HJ,,4.02,-59608.55
2032,7/15/2020,7/15/2020,Alan Safran,Imported from Bank of America Visa-Background checks for fellows,,HJ,,4.02,-59612.57
2032,7/15/2020,7/15/2020,Alan Safran,Imported from Bank of America Visa-Background checks for fellows,,HJ,,4.5,-59617.07
2032,7/15/2020,7/15/2020,Alan Safran,Imported from Bank of America Visa-Background checks for fellows,,HJ,,4.5,-59621.57
2032,7/15/2020,7/15/2020,Alan Safran,Imported from Bank of America Visa-Background checks for fellows,,HJ,,4.51,-59626.08
2032,7/15/2020,7/15/2020,Alan Safran,Imported from Bank of America Visa-Background checks for fellows,,HJ,,4.51,-59630.59
2032,7/15/2020,7/15/2020,Alan Safran,Imported from Bank of America Visa-Background checks for fellows,,HJ,,4.89,-59635.48
2032,7/15/2020,7/15/2020,Alan Safran,Imported from Bank of America Visa-Background checks for fellows,,HJ,,4.89,-59640.37
2032,7/15/2020,7/15/2020,Alan Safran,Imported from Bank of America Visa-Background checks for fellows,,HJ,,4.89,-59645.26
2032,7/15/2020,7/15/2020,Alan Safran,Imported from Bank of America Visa-Background checks for fellows,,HJ,,4.89,-59650.15
2032,7/15/2020,7/15/2020,Alan Safran,Imported from Bank of America Visa-Background checks for fellows,,HJ,,4.89,-59655.04
2032,7/15/2020,7/15/2020,Alan Safran,Imported from Bank of America Visa-Background checks for fellows,,HJ,,4.89,-59659.93
2032,7/15/2020,7/15/2020,Alan Safran,Imported from Bank of America Visa-Background checks for fellows,,HJ,,4.89,-59664.82
2032,7/15/2020,7/15/2020,Alan Safran,Imported from Bank of America Visa-Background checks for fellows,,HJ,,4.89,-59669.71
2032,7/15/2020,7/15/2020,Alan Safran,Imported from Bank of America Visa-Background checks for fellows,,HJ,,6.2,-59675.91
2032,7/15/2020,7/15/2020,Alan Safran,Imported from Bank of America Visa-Background checks for fellows,,HJ,,6.2,-59682.11
2032,7/15/2020,7/15/2020,Alan Safran,Imported from Bank of America Visa-Background checks for fellows,,HJ,,6.2,-59688.31
2032,7/15/2020,7/15/2020,Alan Safran,Imported from Bank of America Visa-Background checks for fellows,,HJ,,6.21,-59694.52
2032,7/15/2020,7/15/2020,Alan Safran,Imported from Bank of America Visa-Background checks for fellows,,HJ,,6.21,-59700.73
2032,7/15/2020,7/15/2020,Alan Safran,Imported from Bank of America Visa-Background checks for fellows,,HJ,,6.21,-59706.94
2032,7/15/2020,7/15/2020,Alan Safran,Imported from Bank of America Visa-Background checks for fellows,,HJ,,14.57,-59721.51
2032,7/15/2020,7/15/2020,Alan Safran,Imported from Bank of America Visa-Background checks for fellows,,HJ,,14.57,-59736.08
2032,7/15/2020,7/15/2020,Alan Safran,Imported from Bank of America Visa-Background checks for fellows,,HJ,,15.81,-59751.89
2032,7/15/2020,7/15/2020,Alan Safran,Imported from Bank of America Visa-Background checks for fellows,,HJ,,15.81,-59767.7
2032,7/15/2020,7/15/2020,Alan Safran,Imported from Bank of America Visa-Background checks for fellows,,HJ,,15.81,-59783.51
2032,7/15/2020,7/15/2020,Alan Safran,Imported from Bank of America Visa-Background checks for fellows,,HJ,,15.81,-59799.32
2032,7/15/2020,7/15/2020,Alan Safran,Imported from Bank of America Visa-Background checks for fellows,,HJ,,20.07,-59819.39
2032,7/15/2020,7/15/2020,Alan Safran,Imported from Bank of America Visa-Background checks for fellows,,HJ,,20.07,-59839.46
2032,7/15/2020,7/15/2020,Alan Safran,Imported from Bank of America Visa-Background checks for fellows,,HJ,,20.07,-59859.53
2032,7/16/2020,7/16/2020,Alan Safran,Imported from Bank of America Visa-Background checks for fellows,,HJ,,4.02,-59863.55
2032,7/16/2020,7/16/2020,Alan Safran,Imported from Bank of America Visa-Background checks for fellows,,HJ,,4.02,-59867.57
2032,7/16/2020,7/16/2020,Alan Safran,Imported from Bank of America Visa-Background checks for fellows,,HJ,,4.02,-59871.59
2032,7/16/2020,7/16/2020,Alan Safran,Imported from Bank of America Visa-Background checks for fellows,,HJ,,4.02,-59875.61
2032,7/16/2020,7/16/2020,Alan Safran,Imported from Bank of America Visa-Background checks for fellows,,HJ,,6.16,-59881.77
2032,7/16/2020,7/16/2020,Alan Safran,Imported from Bank of America Visa-Background checks for fellows,,HJ,,6.2,-59887.97
2032,7/16/2020,7/16/2020,Alan Safran,Imported from Bank of America Visa-Background checks for fellows,,HJ,,6.2,-59894.17
2032,7/16/2020,7/16/2020,Alan Safran,Imported from Bank of America Visa-Background checks for fellows,,HJ,,6.2,-59900.37
2032,7/16/2020,7/16/2020,Alan Safran,Imported from Bank of America Visa-Background checks for fellows,,HJ,,6.2,-59906.57
2032,7/16/2020,7/16/2020,Alan Safran,Imported from Bank of America Visa-Background checks for fellows,,HJ,,6.21,-59912.78
2032,7/16/2020,7/16/2020,Alan Safran,Imported from Bank of America Visa-Background checks for fellows,,HJ,,6.21,-59918.99
2032,7/16/2020,7/16/2020,Alan Safran,Imported from Bank of America Visa-Background checks for fellows,,HJ,,6.21,-59925.2
2032,7/16/2020,7/16/2020,Alan Safran,Imported from Bank of America Visa-Background checks for fellows,,HJ,,6.21,-59931.41
2032,7/16/2020,7/16/2020,Alan Safran,Imported from Bank of America Visa-Background checks for fellows,,HJ,,9.52,-59940.93
2032,7/16/2020,7/16/2020,Alan Safran,Imported from Bank of America Visa-Background checks for fellows,,HJ,,9.52,-59950.45
2032,7/16/2020,7/16/2020,Alan Safran,Imported from Bank of America Visa-Background checks for fellows,,HJ,,13.48,-59963.93
2032,7/16/2020,7/16/2020,Alan Safran,Imported from Bank of America Visa-Background checks for fellows,,HJ,,20.07,-59984
2032,7/16/2020,7/16/2020,Alan Safran,Imported from Bank of America Visa-Background checks for fellows,,HJ,,20.07,-60004.07
2032,7/16/2020,7/16/2020,Alan Safran,Imported from Bank of America Visa-Background checks for fellows,,HJ,,20.07,-60024.14
2032,7/16/2020,7/16/2020,Alan Safran,Imported from Bank of America Visa-Background checks for fellows,,HJ,,20.07,-60044.21
2032,7/16/2020,7/16/2020,Alan Safran,Imported from Bank of America Visa-Background checks for fellows,,HJ,,20.82,-60065.03
2032,7/16/2020,7/16/2020,Alan Safran,Imported from Bank of America Visa-Background checks for fellows,,HJ,,20.83,-60085.86
2032,7/16/2020,7/16/2020,Alan Safran,Imported from Bank of America Visa-Background checks for fellows,,HJ,,30.8,-60116.66
2032,7/16/2020,7/16/2020,Alan Safran,Imported from Bank of America Visa-Background checks for fellows,,HJ,,67.37,-60184.03
2032,7/16/2020,7/16/2020,Antonio Gutierrez,Imported from Bank of America Visa-Fellow Recruitment,,HJ,,900,-61084.03
2032,7/16/2020,7/16/2020,Bank of America VISA,Concur Payment- Bambora-Concur Payment- Bambora,,HJ,390.46,,-60693.57
2032,7/16/2020,7/16/2020,Joseph Zarate,Imported from Bank of America Visa-New hire equipment,,HJ,,746.57,-61440.14
2032,7/16/2020,7/16/2020,Joseph Zarate,Imported from Bank of America Visa-New hire equipment,,HJ,,795,-62235.14
2032,7/16/2020,7/16/2020,Joseph Zarate,Imported from Bank of America Visa-shipping,,HJ,,21.1,-62256.24
2032,7/16/2020,7/16/2020,Mahaliah Sejour,Imported from Bank of America Visa-MS printer,,HJ,,5.35,-62261.59
2032,7/16/2020,7/16/2020,Myesha Hossain,Imported from Bank of America Visa-Acquisition of site,,HJ,,42.64,-62304.23
2032,7/16/2020,7/16/2020,Nicole Prahin,Imported from Bank of America Visa-Google drive storage space,,HJ,,2.13,-62306.36
2032,7/17/2020,7/17/2020,Alan Safran,Imported from Bank of America Visa-Background checks for fellows,,HJ,,5.56,-62311.92
2032,7/17/2020,7/17/2020,Alan Safran,Imported from Bank of America Visa-Background checks for fellows,,HJ,,8.58,-62320.5
2032,7/17/2020,7/17/2020,Alan Safran,Imported from Bank of America Visa-Background checks for fellows,,HJ,,8.59,-62329.09
2032,7/17/2020,7/17/2020,Alan Safran,Imported from Bank of America Visa-Background checks for fellows,,HJ,,27.77,-62356.86
2032,7/17/2020,7/17/2020,Antonio Gutierrez,Imported from Bank of America Visa-Fellow Recruitment,,HJ,,900,-63256.86
2032,7/17/2020,7/17/2020,Joseph Zarate,Imported from Bank of America Visa-shipping,,HJ,,28.85,-63285.71
2032,7/17/2020,7/17/2020,Lativa Holder,Imported from Bank of America Visa-Storage Unit,,HJ,,105.5,-63391.21
2032,7/17/2020,7/17/2020,Monivett Acevedo,Imported from Bank of America Visa-Office Monthly printer ink,,HJ,,5.3,-63396.51
2032,7/17/2020,7/17/2020,Myesha Hossain,Imported from Bank of America Visa-Hardware Laptop and Tech Equipment,,HJ,,84.97,-63481.48
2032,7/17/2020,7/17/2020,Myesha Hossain,Imported from Bank of America Visa-Office Supplies,,HJ,,6.99,-63488.47
2032,7/17/2020,7/17/2020,Myesha Hossain,Imported from Bank of America Visa-Office Supplies,,HJ,,94.95,-63583.42
2032,7/18/2020,7/18/2020,Alan Safran,Imported from Bank of America Visa-Background checks for fellows,,HJ,,2.92,-63586.34
2032,7/18/2020,7/18/2020,Alan Safran,Imported from Bank of America Visa-Background checks for fellows,,HJ,,3.16,-63589.5
2032,7/18/2020,7/18/2020,Alan Safran,Imported from Bank of America Visa-Background checks for fellows,,HJ,,3.16,-63592.66
2032,7/18/2020,7/18/2020,Alan Safran,Imported from Bank of America Visa-Background checks for fellows,,HJ,,4.5,-63597.16
2032,7/18/2020,7/18/2020,Alan Safran,Imported from Bank of America Visa-Background checks for fellows,,HJ,,4.51,-63601.67
2032,7/18/2020,7/18/2020,Alan Safran,Imported from Bank of America Visa-Background checks for fellows,,HJ,,4.89,-63606.56
2032,7/18/2020,7/18/2020,Alan Safran,Imported from Bank of America Visa-Background checks for fellows,,HJ,,4.89,-63611.45
2032,7/18/2020,7/18/2020,Alan Safran,Imported from Bank of America Visa-Background checks for fellows,,HJ,,4.89,-63616.34
2032,7/18/2020,7/18/2020,Alan Safran,Imported from Bank of America Visa-Background checks for fellows,,HJ,,4.89,-63621.23
2032,7/18/2020,7/18/2020,Alan Safran,Imported from Bank of America Visa-Background checks for fellows,,HJ,,13.48,-63634.71
2032,7/18/2020,7/18/2020,Alan Safran,Imported from Bank of America Visa-Background checks for fellows,,HJ,,14.57,-63649.28
2032,7/18/2020,7/18/2020,Alan Safran,Imported from Bank of America Visa-Background checks for fellows,,HJ,,15.81,-63665.09
2032,7/18/2020,7/18/2020,Alan Safran,Imported from Bank of America Visa-Background checks for fellows,,HJ,,15.81,-63680.9
2032,7/18/2020,7/18/2020,Alan Safran,Imported from Bank of America Visa-Background checks for fellows,,HJ,,20.82,-63701.72
2032,7/18/2020,7/18/2020,Alan Safran,Imported from Bank of America Visa-Background checks for fellows,,HJ,,20.83,-63722.55
2032,7/18/2020,7/18/2020,Alan Safran,Imported from Bank of America Visa-Background checks for fellows,,HJ,,67.37,-63789.92
2032,7/18/2020,7/18/2020,Antonio Gutierrez,Imported from Bank of America Visa-Fellow Recruitment,,HJ,,900,-64689.92
2032,7/18/2020,7/18/2020,Elizabeth Peinado,Imported from Bank of America Visa-New hire packages,,HJ,,7.14,-64697.06
2032,7/18/2020,7/18/2020,Elizabeth Peinado,Imported from Bank of America Visa-New hire packages,,HJ,,11.04,-64708.1
2032,7/18/2020,7/18/2020,Elizabeth Peinado,Imported from Bank of America Visa-New hire packages,,HJ,,11.04,-64719.14
2032,7/18/2020,7/18/2020,Elizabeth Peinado,Imported from Bank of America Visa-New hire packages,,HJ,,35.73,-64754.87
2032,7/18/2020,7/18/2020,Gabriel Hallinan,Imported from reimbursements-Fellow personal item retrieval,,HJ,,10.72,-64765.59
2032,7/18/2020,7/18/2020,Gabriel Hallinan,Imported from reimbursements-Fellow personal item retrieval,,HJ,,10.72,-64776.31
2032,7/18/2020,7/18/2020,Gabriel Hallinan,Imported from reimbursements-Fellow personal item retrieval,,HJ,,10.72,-64787.03
2032,7/18/2020,7/18/2020,Gabriel Hallinan,Imported from reimbursements-Fellow personal item retrieval,,HJ,,21.65,-64808.68
2032,7/18/2020,7/18/2020,Gabriel Hallinan,Imported from reimbursements-Fellow personal item retrieval,,HJ,,32.82,-64841.5
2032,7/18/2020,7/18/2020,Joseph Zarate,Imported from Bank of America Visa-Microsoft License monthly charges,,HJ,,30.11,-64871.61
2032,7/18/2020,7/18/2020,Joseph Zarate,Imported from Bank of America Visa-New hire equipment,,HJ,,30.98,-64902.59
2032,7/18/2020,7/18/2020,Myesha Hossain,Imported from Bank of America Visa-Laptop equipment,,HJ,,6.99,-64909.58
2032,7/19/2020,7/19/2020,Alan Safran,Imported from Bank of America Visa-Background checks for fellows,,HJ,,3.16,-64912.74
2032,7/19/2020,7/19/2020,Alan Safran,Imported from Bank of America Visa-Background checks for fellows,,HJ,,3.16,-64915.9
2032,7/19/2020,7/19/2020,Alan Safran,Imported from Bank of America Visa-Background checks for fellows,,HJ,,4.89,-64920.79
2032,7/19/2020,7/19/2020,Alan Safran,Imported from Bank of America Visa-Background checks for fellows,,HJ,,4.89,-64925.68
2032,7/19/2020,7/19/2020,Alan Safran,Imported from Bank of America Visa-Background checks for fellows,,HJ,,4.89,-64930.57
2032,7/19/2020,7/19/2020,Alan Safran,Imported from Bank of America Visa-Background checks for fellows,,HJ,,4.89,-64935.46
2032,7/19/2020,7/19/2020,Alan Safran,Imported from Bank of America Visa-Background checks for fellows,,HJ,,15.81,-64951.27
2032,7/19/2020,7/19/2020,Alan Safran,Imported from Bank of America Visa-Background checks for fellows,,HJ,,15.81,-64967.08
2032,7/19/2020,7/19/2020,Alan Safran,Imported from Bank of America Visa-HP instant Ink for office.,,HJ,,10.61,-64977.69
2032,7/19/2020,7/19/2020,Antonio Gutierrez,Imported from Bank of America Visa-Fellow Recruitment,,HJ,,299,-65276.69
2032,7/19/2020,7/19/2020,Antonio Gutierrez,Imported from Bank of America Visa-Fellow Recruitment,,HJ,,900,-66176.69
2032,7/19/2020,7/19/2020,Joseph Zarate,Imported from Bank of America Visa-New hire equipment,,HJ,,29.99,-66206.68
2032,7/20/2020,7/20/2020,Alan Safran,Imported from Bank of America Visa-Background checks for fellows,,HJ,,3.16,-66209.84
2032,7/20/2020,7/20/2020,Alan Safran,Imported from Bank of America Visa-Background checks for fellows,,HJ,,3.16,-66213
2032,7/20/2020,7/20/2020,Alan Safran,Imported from Bank of America Visa-Background checks for fellows,,HJ,,4.89,-66217.89
2032,7/20/2020,7/20/2020,Alan Safran,Imported from Bank of America Visa-Background checks for fellows,,HJ,,4.89,-66222.78
2032,7/20/2020,7/20/2020,Alan Safran,Imported from Bank of America Visa-Background checks for fellows,,HJ,,4.89,-66227.67
2032,7/20/2020,7/20/2020,Alan Safran,Imported from Bank of America Visa-Background checks for fellows,,HJ,,4.89,-66232.56
2032,7/20/2020,7/20/2020,Alan Safran,Imported from Bank of America Visa-Background checks for fellows,,HJ,,9.13,-66241.69
2032,7/20/2020,7/20/2020,Alan Safran,Imported from Bank of America Visa-Background checks for fellows,,HJ,,14.11,-66255.8
2032,7/20/2020,7/20/2020,Alan Safran,Imported from Bank of America Visa-Background checks for fellows,,HJ,,14.11,-66269.91
2032,7/20/2020,7/20/2020,Alan Safran,Imported from Bank of America Visa-Background checks for fellows,,HJ,,15.81,-66285.72
2032,7/20/2020,7/20/2020,Alan Safran,Imported from Bank of America Visa-Background checks for fellows,,HJ,,15.81,-66301.53
2032,7/20/2020,7/20/2020,Alan Safran,Imported from Bank of America Visa-Background checks for fellows,,HJ,,45.65,-66347.18
2032,7/20/2020,7/20/2020,Antonio Gutierrez,Imported from Bank of America Visa-Fellow Recruitment,,HJ,,900,-67247.18
2032,7/20/2020,7/20/2020,Antonio Gutierrez,Imported from Bank of America Visa-X Co.  Website Fellow Recruitment,,HJ,,300,-67547.18
2032,7/20/2020,7/20/2020,Elizabeth Peinado,Imported from Bank of America Visa-Job posting for all regions,,HJ,,577.5,-68124.68
2032,7/20/2020,7/20/2020,Elizabeth Peinado,Imported from Bank of America Visa-Job posting for all regions,,HJ,,892.5,-69017.18
2032,7/20/2020,7/20/2020,Elizabeth Peinado,Imported from Bank of America Visa-Job posting for all regions,,HJ,,892.5,-69909.68
2032,7/20/2020,7/20/2020,Elizabeth Peinado,Imported from Bank of America Visa-Job posting for all regions,,HJ,,2887.5,-72797.18
2032,7/20/2020,7/20/2020,Joseph Zarate,Imported from Bank of America Visa-New hire equipment,,HJ,,6.99,-72804.17
2032,7/20/2020,7/20/2020,Joseph Zarate,Imported from Bank of America Visa-New hire equipment,,HJ,,11.99,-72816.16
2032,7/20/2020,7/20/2020,Joseph Zarate,Imported from Bank of America Visa-New hire equipment,,HJ,,109.99,-72926.15
2032,7/20/2020,7/20/2020,Joseph Zarate,Imported from Bank of America Visa-New hire equipment,,HJ,,124.67,-73050.82
2032,7/20/2020,7/20/2020,Joseph Zarate,Imported from Bank of America Visa-New hire equipment,,HJ,,638.99,-73689.81
2032,7/20/2020,7/20/2020,Joseph Zarate,Imported from Bank of America Visa-New hire equipment,,HJ,,779,-74468.81
2032,7/20/2020,7/20/2020,Mahaliah Sejour,Imported from Bank of America Visa-harlan printer,,HJ,,5.35,-74474.16
2032,7/21/2020,7/21/2020,Alan Safran,Imported from Bank of America Visa-Background checks for fellows,,HJ,,2.92,-74477.08
2032,7/21/2020,7/21/2020,Alan Safran,Imported from Bank of America Visa-Background checks for fellows,,HJ,,3.16,-74480.24
2032,7/21/2020,7/21/2020,Alan Safran,Imported from Bank of America Visa-Background checks for fellows,,HJ,,3.16,-74483.4
2032,7/21/2020,7/21/2020,Alan Safran,Imported from Bank of America Visa-Background checks for fellows,,HJ,,4.02,-74487.42
2032,7/21/2020,7/21/2020,Alan Safran,Imported from Bank of America Visa-Background checks for fellows,,HJ,,4.02,-74491.44
2032,7/21/2020,7/21/2020,Alan Safran,Imported from Bank of America Visa-Background checks for fellows,,HJ,,4.02,-74495.46
2032,7/21/2020,7/21/2020,Alan Safran,Imported from Bank of America Visa-Background checks for fellows,,HJ,,4.5,-74499.96
2032,7/21/2020,7/21/2020,Alan Safran,Imported from Bank of America Visa-Background checks for fellows,,HJ,,4.51,-74504.47
2032,7/21/2020,7/21/2020,Alan Safran,Imported from Bank of America Visa-Background checks for fellows,,HJ,,4.89,-74509.36
2032,7/21/2020,7/21/2020,Alan Safran,Imported from Bank of America Visa-Background checks for fellows,,HJ,,4.89,-74514.25
2032,7/21/2020,7/21/2020,Alan Safran,Imported from Bank of America Visa-Background checks for fellows,,HJ,,4.89,-74519.14
2032,7/21/2020,7/21/2020,Alan Safran,Imported from Bank of America Visa-Background checks for fellows,,HJ,,4.89,-74524.03
2032,7/21/2020,7/21/2020,Alan Safran,Imported from Bank of America Visa-Background checks for fellows,,HJ,,6.2,-74530.23
2032,7/21/2020,7/21/2020,Alan Safran,Imported from Bank of America Visa-Background checks for fellows,,HJ,,6.2,-74536.43
2032,7/21/2020,7/21/2020,Alan Safran,Imported from Bank of America Visa-Background checks for fellows,,HJ,,6.2,-74542.63
2032,7/21/2020,7/21/2020,Alan Safran,Imported from Bank of America Visa-Background checks for fellows,,HJ,,6.21,-74548.84
2032,7/21/2020,7/21/2020,Alan Safran,Imported from Bank of America Visa-Background checks for fellows,,HJ,,6.21,-74555.05
2032,7/21/2020,7/21/2020,Alan Safran,Imported from Bank of America Visa-Background checks for fellows,,HJ,,6.21,-74561.26
2032,7/21/2020,7/21/2020,Alan Safran,Imported from Bank of America Visa-Background checks for fellows,,HJ,,13.48,-74574.74
2032,7/21/2020,7/21/2020,Alan Safran,Imported from Bank of America Visa-Background checks for fellows,,HJ,,14.57,-74589.31
2032,7/21/2020,7/21/2020,Alan Safran,Imported from Bank of America Visa-Background checks for fellows,,HJ,,15.81,-74605.12
2032,7/21/2020,7/21/2020,Alan Safran,Imported from Bank of America Visa-Background checks for fellows,,HJ,,15.81,-74620.93
2032,7/21/2020,7/21/2020,Alan Safran,Imported from Bank of America Visa-Background checks for fellows,,HJ,,20.07,-74641
2032,7/21/2020,7/21/2020,Alan Safran,Imported from Bank of America Visa-Background checks for fellows,,HJ,,20.07,-74661.07
2032,7/21/2020,7/21/2020,Alan Safran,Imported from Bank of America Visa-Background checks for fellows,,HJ,,20.07,-74681.14
2032,7/21/2020,7/21/2020,Alan Safran,Imported from Bank of America Visa-Background checks for fellows,,HJ,,20.82,-74701.96
2032,7/21/2020,7/21/2020,Alan Safran,Imported from Bank of America Visa-Background checks for fellows,,HJ,,20.83,-74722.79
2032,7/21/2020,7/21/2020,Alan Safran,Imported from Bank of America Visa-Background checks for fellows,,HJ,,67.37,-74790.16
2032,7/21/2020,7/21/2020,Antonio Gutierrez,Imported from Bank of America Visa-Fellow Recruitment,,HJ,,900,-75690.16
2032,7/21/2020,7/21/2020,Elizabeth Peinado,Imported from Bank of America Visa-Position advertisement across all regions,,HJ,,12.18,-75702.34
2032,7/21/2020,7/21/2020,Elizabeth Peinado,Imported from Bank of America Visa-Position advertisement across all regions,,HJ,,18.82,-75721.16
2032,7/21/2020,7/21/2020,Elizabeth Peinado,Imported from Bank of America Visa-Position advertisement across all regions,,HJ,,18.82,-75739.98
2032,7/21/2020,7/21/2020,Elizabeth Peinado,Imported from Bank of America Visa-Position advertisement across all regions,,HJ,,60.91,-75800.89
2032,7/21/2020,7/21/2020,Halley Bowman,Imported from Bank of America Visa-book for Mallory,,HJ,,3.74,-75804.63
2032,7/21/2020,7/21/2020,Halley Bowman,Imported from Bank of America Visa-book for Mallory,,HJ,,5.78,-75810.41
2032,7/21/2020,7/21/2020,Halley Bowman,Imported from Bank of America Visa-book for Mallory,,HJ,,5.78,-75816.19
2032,7/21/2020,7/21/2020,Halley Bowman,Imported from Bank of America Visa-book for Mallory,,HJ,,18.68,-75834.87
2032,7/21/2020,7/21/2020,Joseph Zarate,Imported from Bank of America Visa-New hire equipment,,HJ,,124.67,-75959.54
2032,7/21/2020,7/21/2020,Joseph Zarate,Imported from Bank of America Visa-New hire equipment,,HJ,,229,-76188.54
2032,7/21/2020,7/21/2020,Joseph Zarate,Imported from Bank of America Visa-New hire equipment,,HJ,,463.99,-76652.53
2032,7/21/2020,7/21/2020,Joseph Zarate,Imported from Bank of America Visa-New hire equipment,,HJ,,463.99,-77116.52
2032,7/21/2020,7/21/2020,Monivett Acevedo,Imported from Bank of America Visa-Staff Retreat in Boston,,HJ,,612.66,-77729.18
2032,7/22/2020,7/22/2020,Alan Safran,Imported from Bank of America Visa-Background checks for fellows,,HJ,,3.16,-77732.34
2032,7/22/2020,7/22/2020,Alan Safran,Imported from Bank of America Visa-Background checks for fellows,,HJ,,3.16,-77735.5
2032,7/22/2020,7/22/2020,Alan Safran,Imported from Bank of America Visa-Background checks for fellows,,HJ,,3.16,-77738.66
2032,7/22/2020,7/22/2020,Alan Safran,Imported from Bank of America Visa-Background checks for fellows,,HJ,,4.02,-77742.68
2032,7/22/2020,7/22/2020,Alan Safran,Imported from Bank of America Visa-Background checks for fellows,,HJ,,4.89,-77747.57
2032,7/22/2020,7/22/2020,Alan Safran,Imported from Bank of America Visa-Background checks for fellows,,HJ,,4.89,-77752.46
2032,7/22/2020,7/22/2020,Alan Safran,Imported from Bank of America Visa-Background checks for fellows,,HJ,,4.89,-77757.35
2032,7/22/2020,7/22/2020,Alan Safran,Imported from Bank of America Visa-Background checks for fellows,,HJ,,4.89,-77762.24
2032,7/22/2020,7/22/2020,Alan Safran,Imported from Bank of America Visa-Background checks for fellows,,HJ,,4.89,-77767.13
2032,7/22/2020,7/22/2020,Alan Safran,Imported from Bank of America Visa-Background checks for fellows,,HJ,,4.89,-77772.02
2032,7/22/2020,7/22/2020,Alan Safran,Imported from Bank of America Visa-Background checks for fellows,,HJ,,5.56,-77777.58
2032,7/22/2020,7/22/2020,Alan Safran,Imported from Bank of America Visa-Background checks for fellows,,HJ,,5.56,-77783.14
2032,7/22/2020,7/22/2020,Alan Safran,Imported from Bank of America Visa-Background checks for fellows,,HJ,,5.56,-77788.7
2032,7/22/2020,7/22/2020,Alan Safran,Imported from Bank of America Visa-Background checks for fellows,,HJ,,6.16,-77794.86
2032,7/22/2020,7/22/2020,Alan Safran,Imported from Bank of America Visa-Background checks for fellows,,HJ,,6.2,-77801.06
2032,7/22/2020,7/22/2020,Alan Safran,Imported from Bank of America Visa-Background checks for fellows,,HJ,,6.21,-77807.27
2032,7/22/2020,7/22/2020,Alan Safran,Imported from Bank of America Visa-Background checks for fellows,,HJ,,8.58,-77815.85
2032,7/22/2020,7/22/2020,Alan Safran,Imported from Bank of America Visa-Background checks for fellows,,HJ,,8.58,-77824.43
2032,7/22/2020,7/22/2020,Alan Safran,Imported from Bank of America Visa-Background checks for fellows,,HJ,,8.58,-77833.01
2032,7/22/2020,7/22/2020,Alan Safran,Imported from Bank of America Visa-Background checks for fellows,,HJ,,8.59,-77841.6
2032,7/22/2020,7/22/2020,Alan Safran,Imported from Bank of America Visa-Background checks for fellows,,HJ,,8.59,-77850.19
2032,7/22/2020,7/22/2020,Alan Safran,Imported from Bank of America Visa-Background checks for fellows,,HJ,,8.59,-77858.78
2032,7/22/2020,7/22/2020,Alan Safran,Imported from Bank of America Visa-Background checks for fellows,,HJ,,9.52,-77868.3
2032,7/22/2020,7/22/2020,Alan Safran,Imported from Bank of America Visa-Background checks for fellows,,HJ,,9.52,-77877.82
2032,7/22/2020,7/22/2020,Alan Safran,Imported from Bank of America Visa-Background checks for fellows,,HJ,,15.81,-77893.63
2032,7/22/2020,7/22/2020,Alan Safran,Imported from Bank of America Visa-Background checks for fellows,,HJ,,15.81,-77909.44
2032,7/22/2020,7/22/2020,Alan Safran,Imported from Bank of America Visa-Background checks for fellows,,HJ,,15.81,-77925.25
2032,7/22/2020,7/22/2020,Alan Safran,Imported from Bank of America Visa-Background checks for fellows,,HJ,,16.72,-77941.97
2032,7/22/2020,7/22/2020,Alan Safran,Imported from Bank of America Visa-Background checks for fellows,,HJ,,20.07,-77962.04
2032,7/22/2020,7/22/2020,Alan Safran,Imported from Bank of America Visa-Background checks for fellows,,HJ,,25.84,-77987.88
2032,7/22/2020,7/22/2020,Alan Safran,Imported from Bank of America Visa-Background checks for fellows,,HJ,,25.84,-78013.72
2032,7/22/2020,7/22/2020,Alan Safran,Imported from Bank of America Visa-Background checks for fellows,,HJ,,27.77,-78041.49
2032,7/22/2020,7/22/2020,Alan Safran,Imported from Bank of America Visa-Background checks for fellows,,HJ,,27.77,-78069.26
2032,7/22/2020,7/22/2020,Alan Safran,Imported from Bank of America Visa-Background checks for fellows,,HJ,,27.77,-78097.03
2032,7/22/2020,7/22/2020,Alan Safran,Imported from Bank of America Visa-Background checks for fellows,,HJ,,30.8,-78127.83
2032,7/22/2020,7/22/2020,Alan Safran,Imported from Bank of America Visa-Background checks for fellows,,HJ,,83.6,-78211.43
2032,7/22/2020,7/22/2020,Antonio Gutierrez,Imported from Bank of America Visa-Fellow Recruitment,,HJ,,900,-79111.43
2032,7/22/2020,7/22/2020,Elizabeth Peinado,Imported from Bank of America Visa-Job posting for all regions,,HJ,,550.95,-79662.38
2032,7/22/2020,7/22/2020,Elizabeth Peinado,Imported from Bank of America Visa-Job posting for all regions,,HJ,,851.47,-80513.85
2032,7/22/2020,7/22/2020,Elizabeth Peinado,Imported from Bank of America Visa-Job posting for all regions,,HJ,,851.47,-81365.32
2032,7/22/2020,7/22/2020,Elizabeth Peinado,Imported from Bank of America Visa-Job posting for all regions,,HJ,,2754.74,-84120.06
2032,7/22/2020,7/22/2020,Elizabeth Peinado,Imported from Bank of America Visa-Position advertisement across all regions,,HJ,,11.04,-84131.1
2032,7/22/2020,7/22/2020,Elizabeth Peinado,Imported from Bank of America Visa-Position advertisement across all regions,,HJ,,17.05,-84148.15
2032,7/22/2020,7/22/2020,Elizabeth Peinado,Imported from Bank of America Visa-Position advertisement across all regions,,HJ,,17.05,-84165.2
2032,7/22/2020,7/22/2020,Elizabeth Peinado,Imported from Bank of America Visa-Position advertisement across all regions,,HJ,,55.18,-84220.38
2032,7/22/2020,7/22/2020,Joseph Zarate,Imported from Bank of America Visa-New hire equipment,,HJ,,37.2,-84257.58
2032,7/22/2020,7/22/2020,Joseph Zarate,Imported from Bank of America Visa-New hire equipment,,HJ,,229,-84486.58
2032,7/22/2020,7/22/2020,Joseph Zarate,Imported from Bank of America Visa-New hire equipment,,HJ,,242.74,-84729.32
2032,7/22/2020,7/22/2020,Monivett Acevedo,Imported from Bank of America Visa-Retreat Supplies,,HJ,,103.35,-84832.67
2032,7/22/2020,7/22/2020,Myesha Hossain,Imported from Bank of America Visa-Office Supplies,,HJ,,232.94,-85065.61
2032,7/22/2020,7/22/2020,Myesha Hossain,Imported from Bank of America Visa-PPE gear,,HJ,,42.25,-85107.86
2032,7/22/2020,7/22/2020,Myesha Hossain,Imported from Bank of America Visa-PPE gear,,HJ,,177.31,-85285.17
2032,7/23/2020,7/23/2020,Alan Safran,Imported from Bank of America Visa-Background checks for fellows,,HJ,,3.16,-85288.33
2032,7/23/2020,7/23/2020,Alan Safran,Imported from Bank of America Visa-Background checks for fellows,,HJ,,3.16,-85291.49
2032,7/23/2020,7/23/2020,Alan Safran,Imported from Bank of America Visa-Background checks for fellows,,HJ,,4.89,-85296.38
2032,7/23/2020,7/23/2020,Alan Safran,Imported from Bank of America Visa-Background checks for fellows,,HJ,,4.89,-85301.27
2032,7/23/2020,7/23/2020,Alan Safran,Imported from Bank of America Visa-Background checks for fellows,,HJ,,4.89,-85306.16
2032,7/23/2020,7/23/2020,Alan Safran,Imported from Bank of America Visa-Background checks for fellows,,HJ,,4.89,-85311.05
2032,7/23/2020,7/23/2020,Alan Safran,Imported from Bank of America Visa-Background checks for fellows,,HJ,,5.56,-85316.61
2032,7/23/2020,7/23/2020,Alan Safran,Imported from Bank of America Visa-Background checks for fellows,,HJ,,5.56,-85322.17
2032,7/23/2020,7/23/2020,Alan Safran,Imported from Bank of America Visa-Background checks for fellows,,HJ,,8.58,-85330.75
2032,7/23/2020,7/23/2020,Alan Safran,Imported from Bank of America Visa-Background checks for fellows,,HJ,,8.58,-85339.33
2032,7/23/2020,7/23/2020,Alan Safran,Imported from Bank of America Visa-Background checks for fellows,,HJ,,8.59,-85347.92
2032,7/23/2020,7/23/2020,Alan Safran,Imported from Bank of America Visa-Background checks for fellows,,HJ,,8.59,-85356.51
2032,7/23/2020,7/23/2020,Alan Safran,Imported from Bank of America Visa-Background checks for fellows,,HJ,,13.48,-85369.99
2032,7/23/2020,7/23/2020,Alan Safran,Imported from Bank of America Visa-Background checks for fellows,,HJ,,13.48,-85383.47
2032,7/23/2020,7/23/2020,Alan Safran,Imported from Bank of America Visa-Background checks for fellows,,HJ,,15.81,-85399.28
2032,7/23/2020,7/23/2020,Alan Safran,Imported from Bank of America Visa-Background checks for fellows,,HJ,,15.81,-85415.09
2032,7/23/2020,7/23/2020,Alan Safran,Imported from Bank of America Visa-Background checks for fellows,,HJ,,20.82,-85435.91
2032,7/23/2020,7/23/2020,Alan Safran,Imported from Bank of America Visa-Background checks for fellows,,HJ,,20.82,-85456.73
2032,7/23/2020,7/23/2020,Alan Safran,Imported from Bank of America Visa-Background checks for fellows,,HJ,,20.83,-85477.56
2032,7/23/2020,7/23/2020,Alan Safran,Imported from Bank of America Visa-Background checks for fellows,,HJ,,20.83,-85498.39
2032,7/23/2020,7/23/2020,Alan Safran,Imported from Bank of America Visa-Background checks for fellows,,HJ,,27.77,-85526.16
2032,7/23/2020,7/23/2020,Alan Safran,Imported from Bank of America Visa-Background checks for fellows,,HJ,,27.77,-85553.93
2032,7/23/2020,7/23/2020,Alan Safran,Imported from Bank of America Visa-Background checks for fellows,,HJ,,67.37,-85621.3
2032,7/23/2020,7/23/2020,Alan Safran,Imported from Bank of America Visa-Background checks for fellows,,HJ,,67.37,-85688.67
2032,7/23/2020,7/23/2020,Antonio Gutierrez,Imported from Bank of America Visa-Fellow Recruitment,,HJ,,900,-86588.67
2032,7/23/2020,7/23/2020,Chris D PLACEHOLDER,Imported from Bank of America Visa-Book prize sent to employee,,HJ,,11.16,-86599.83
2032,7/23/2020,7/23/2020,Chris D PLACEHOLDER,Imported from Bank of America Visa-Book prize sent to employee,,HJ,,11.16,-86610.99
2032,7/23/2020,7/23/2020,Chris D PLACEHOLDER,Imported from Bank of America Visa-Book prize sent to employee,,HJ,,11.24,-86622.23
2032,7/23/2020,7/23/2020,Chris D PLACEHOLDER,Imported from Bank of America Visa-Book prize sent to employee,,HJ,,11.93,-86634.16
2032,7/23/2020,7/23/2020,Chris D PLACEHOLDER,Imported from Bank of America Visa-Book prize sent to employee,,HJ,,13.78,-86647.94
2032,7/23/2020,7/23/2020,Elizabeth Peinado,Imported from Bank of America Visa-Math Assessment Subscription,,HJ,,4.39,-86652.33
2032,7/23/2020,7/23/2020,Elizabeth Peinado,Imported from Bank of America Visa-Math Assessment Subscription,,HJ,,6.79,-86659.12
2032,7/23/2020,7/23/2020,Elizabeth Peinado,Imported from Bank of America Visa-Math Assessment Subscription,,HJ,,6.79,-86665.91
2032,7/23/2020,7/23/2020,Elizabeth Peinado,Imported from Bank of America Visa-Math Assessment Subscription,,HJ,,21.98,-86687.89
2032,7/23/2020,7/23/2020,Elizabeth Peinado,Imported from Bank of America Visa-Position advertisement across all regions,,HJ,,11.07,-86698.96
2032,7/23/2020,7/23/2020,Elizabeth Peinado,Imported from Bank of America Visa-Position advertisement across all regions,,HJ,,17.11,-86716.07
2032,7/23/2020,7/23/2020,Elizabeth Peinado,Imported from Bank of America Visa-Position advertisement across all regions,,HJ,,17.11,-86733.18
2032,7/23/2020,7/23/2020,Elizabeth Peinado,Imported from Bank of America Visa-Position advertisement across all regions,,HJ,,55.33,-86788.51
2032,7/23/2020,7/23/2020,Joseph Zarate,Imported from Bank of America Visa-New hire equipment,,HJ,,229,-87017.51
2032,7/23/2020,7/23/2020,Joseph Zarate,Imported from Bank of America Visa-New hire equipment,,HJ,,242.74,-87260.25
2032,7/23/2020,7/23/2020,Maryellen Leneghan,Imported from Bank of America Visa-Supplies for BC DoP,,HJ,,149.48,-87409.73
2032,7/23/2020,7/23/2020,Monivett Acevedo,Imported from Bank of America Visa-Office Monthly printer ink,,HJ,,3.18,-87412.91
2032,7/23/2020,7/23/2020,Monivett Acevedo,Imported from Bank of America Visa-Travel to and from Boston for Staff Retreat,,HJ,,130,-87542.91
2032,7/24/2020,7/24/2020,Alan Safran,Imported from Bank of America Visa-Background checks for fellows,,HJ,,3.16,-87546.07
2032,7/24/2020,7/24/2020,Alan Safran,Imported from Bank of America Visa-Background checks for fellows,,HJ,,4.89,-87550.96
2032,7/24/2020,7/24/2020,Alan Safran,Imported from Bank of America Visa-Background checks for fellows,,HJ,,4.89,-87555.85
2032,7/24/2020,7/24/2020,Alan Safran,Imported from Bank of America Visa-Background checks for fellows,,HJ,,15.81,-87571.66
2032,7/24/2020,7/24/2020,Antonio Gutierrez,Imported from Bank of America Visa-Fellow Recruitment,,HJ,,900,-88471.66
2032,7/24/2020,7/24/2020,Chris D PLACEHOLDER,Imported from Bank of America Visa-Book prize sent to employee,,HJ,,11.34,-88483
2032,7/24/2020,7/24/2020,Chris D PLACEHOLDER,Imported from Bank of America Visa-Book prize sent to employee,,HJ,,11.34,-88494.34
2032,7/24/2020,7/24/2020,Elizabeth Peinado,Imported from Bank of America Visa-International fee for Classmarker,,HJ,,0.09,-88494.43
2032,7/24/2020,7/24/2020,Elizabeth Peinado,Imported from Bank of America Visa-International fee for Classmarker,,HJ,,0.14,-88494.57
2032,7/24/2020,7/24/2020,Elizabeth Peinado,Imported from Bank of America Visa-International fee for Classmarker,,HJ,,0.14,-88494.71
2032,7/24/2020,7/24/2020,Elizabeth Peinado,Imported from Bank of America Visa-International fee for Classmarker,,HJ,,0.43,-88495.14
2032,7/24/2020,7/24/2020,Elizabeth Peinado,Imported from Bank of America Visa-Position advertisement across all regions,,HJ,,28.59,-88523.73
2032,7/24/2020,7/24/2020,Elizabeth Peinado,Imported from Bank of America Visa-Position advertisement across all regions,,HJ,,44.19,-88567.92
2032,7/24/2020,7/24/2020,Elizabeth Peinado,Imported from Bank of America Visa-Position advertisement across all regions,,HJ,,44.19,-88612.11
2032,7/24/2020,7/24/2020,Elizabeth Peinado,Imported from Bank of America Visa-Position advertisement across all regions,,HJ,,142.98,-88755.09
2032,7/24/2020,7/24/2020,Halley Bowman,Imported from Bank of America Visa-Reference book for MS project for Emily,,HJ,,31.63,-88786.72
2032,7/24/2020,7/24/2020,Joseph Zarate,Imported from Bank of America Visa-New hire equipment,,HJ,,468,-89254.72
2032,7/24/2020,7/24/2020,Joseph Zarate,Imported from Bank of America Visa-New hire equipment,,HJ,,468,-89722.72
2032,7/24/2020,7/24/2020,Joseph Zarate,Imported from Bank of America Visa-New hire equipment,,HJ,,468,-90190.72
2032,7/24/2020,7/24/2020,Mahaliah Sejour,Imported from Bank of America Visa-project management,,HJ,,49,-90239.72
2032,7/24/2020,7/24/2020,Maryellen Leneghan,Imported from Bank of America Visa-Montior fo DC DoP,,HJ,,90.07,-90329.79
2032,7/25/2020,7/25/2020,Antonio Gutierrez,Imported from Bank of America Visa-Fellow Recruitment,,HJ,,900,-91229.79
2032,7/25/2020,7/25/2020,Elizabeth Peinado,Imported from Bank of America Visa-Position advertisement across all regions,,HJ,,29.42,-91259.21
2032,7/25/2020,7/25/2020,Elizabeth Peinado,Imported from Bank of America Visa-Position advertisement across all regions,,HJ,,45.47,-91304.68
2032,7/25/2020,7/25/2020,Elizabeth Peinado,Imported from Bank of America Visa-Position advertisement across all regions,,HJ,,45.47,-91350.15
2032,7/25/2020,7/25/2020,Elizabeth Peinado,Imported from Bank of America Visa-Position advertisement across all regions,,HJ,,147.12,-91497.27
2032,7/25/2020,7/25/2020,Halley Bowman,Imported from Bank of America Visa-Reference book for Mallory for PD,,HJ,,3.23,-91500.5
2032,7/25/2020,7/25/2020,Halley Bowman,Imported from Bank of America Visa-Reference book for Mallory for PD,,HJ,,4.99,-91505.49
2032,7/25/2020,7/25/2020,Halley Bowman,Imported from Bank of America Visa-Reference book for Mallory for PD,,HJ,,4.99,-91510.48
2032,7/25/2020,7/25/2020,Halley Bowman,Imported from Bank of America Visa-Reference book for Mallory for PD,,HJ,,16.14,-91526.62
2032,7/25/2020,7/25/2020,Joseph Zarate,Imported from Bank of America Visa-New hire equipment,,HJ,,13.99,-91540.61
2032,7/25/2020,7/25/2020,Joseph Zarate,Imported from Bank of America Visa-New hire equipment,,HJ,,203.64,-91744.25
2032,7/25/2020,7/25/2020,Monivett Acevedo,Imported from Bank of America Visa-Filing fee for Colorado,,HJ,,100,-91844.25
2032,7/26/2020,7/26/2020,Alan Safran,Imported from Bank of America Visa-Background checks for fellows,,HJ,,3.16,-91847.41
2032,7/26/2020,7/26/2020,Alan Safran,Imported from Bank of America Visa-Background checks for fellows,,HJ,,4.89,-91852.3
2032,7/26/2020,7/26/2020,Alan Safran,Imported from Bank of America Visa-Background checks for fellows,,HJ,,4.89,-91857.19
2032,7/26/2020,7/26/2020,Alan Safran,Imported from Bank of America Visa-Background checks for fellows,,HJ,,15.81,-91873
2032,7/26/2020,7/26/2020,Antonio Gutierrez,Imported from Bank of America Visa-Fellow Recruitment,,HJ,,900,-92773
2032,7/26/2020,7/26/2020,Elizabeth Peinado,Imported from Bank of America Visa-Position advertisement across all regions,,HJ,,28.66,-92801.66
2032,7/26/2020,7/26/2020,Elizabeth Peinado,Imported from Bank of America Visa-Position advertisement across all regions,,HJ,,44.29,-92845.95
2032,7/26/2020,7/26/2020,Elizabeth Peinado,Imported from Bank of America Visa-Position advertisement across all regions,,HJ,,44.29,-92890.24
2032,7/26/2020,7/26/2020,Elizabeth Peinado,Imported from Bank of America Visa-Position advertisement across all regions,,HJ,,143.28,-93033.52
2032,7/26/2020,7/26/2020,Joseph Zarate,Imported from Bank of America Visa-New hire equipment,,HJ,,220,-93253.52
2032,7/26/2020,7/26/2020,Joseph Zarate,Imported from Bank of America Visa-New hire equipment,,HJ,,249.99,-93503.51
2032,7/26/2020,7/26/2020,Joseph Zarate,Imported from Bank of America Visa-New hire equipment,,HJ,,257,-93760.51
2032,7/26/2020,7/26/2020,Joseph Zarate,Imported from Bank of America Visa-New hire equipment,,HJ,,267.84,-94028.35
2032,7/26/2020,7/26/2020,Joseph Zarate,Imported from Bank of America Visa-labels,,HJ,,114.32,-94142.67
2032,7/27/2020,7/27/2020,Alan Safran,Imported from Bank of America Visa-Background checks for fellows,,HJ,,3.16,-94145.83
2032,7/27/2020,7/27/2020,Alan Safran,Imported from Bank of America Visa-Background checks for fellows,,HJ,,4.02,-94149.85
2032,7/27/2020,7/27/2020,Alan Safran,Imported from Bank of America Visa-Background checks for fellows,,HJ,,4.02,-94153.87
2032,7/27/2020,7/27/2020,Alan Safran,Imported from Bank of America Visa-Background checks for fellows,,HJ,,4.02,-94157.89
2032,7/27/2020,7/27/2020,Alan Safran,Imported from Bank of America Visa-Background checks for fellows,,HJ,,4.02,-94161.91
2032,7/27/2020,7/27/2020,Alan Safran,Imported from Bank of America Visa-Background checks for fellows,,HJ,,4.02,-94165.93
2032,7/27/2020,7/27/2020,Alan Safran,Imported from Bank of America Visa-Background checks for fellows,,HJ,,4.02,-94169.95
2032,7/27/2020,7/27/2020,Alan Safran,Imported from Bank of America Visa-Background checks for fellows,,HJ,,4.02,-94173.97
2032,7/27/2020,7/27/2020,Alan Safran,Imported from Bank of America Visa-Background checks for fellows,,HJ,,4.02,-94177.99
2032,7/27/2020,7/27/2020,Alan Safran,Imported from Bank of America Visa-Background checks for fellows,,HJ,,4.02,-94182.01
2032,7/27/2020,7/27/2020,Alan Safran,Imported from Bank of America Visa-Background checks for fellows,,HJ,,4.02,-94186.03
2032,7/27/2020,7/27/2020,Alan Safran,Imported from Bank of America Visa-Background checks for fellows,,HJ,,4.89,-94190.92
2032,7/27/2020,7/27/2020,Alan Safran,Imported from Bank of America Visa-Background checks for fellows,,HJ,,4.89,-94195.81
2032,7/27/2020,7/27/2020,Alan Safran,Imported from Bank of America Visa-Background checks for fellows,,HJ,,5.56,-94201.37
2032,7/27/2020,7/27/2020,Alan Safran,Imported from Bank of America Visa-Background checks for fellows,,HJ,,6.2,-94207.57
2032,7/27/2020,7/27/2020,Alan Safran,Imported from Bank of America Visa-Background checks for fellows,,HJ,,6.2,-94213.77
2032,7/27/2020,7/27/2020,Alan Safran,Imported from Bank of America Visa-Background checks for fellows,,HJ,,6.2,-94219.97
2032,7/27/2020,7/27/2020,Alan Safran,Imported from Bank of America Visa-Background checks for fellows,,HJ,,6.2,-94226.17
2032,7/27/2020,7/27/2020,Alan Safran,Imported from Bank of America Visa-Background checks for fellows,,HJ,,6.2,-94232.37
2032,7/27/2020,7/27/2020,Alan Safran,Imported from Bank of America Visa-Background checks for fellows,,HJ,,6.2,-94238.57
2032,7/27/2020,7/27/2020,Alan Safran,Imported from Bank of America Visa-Background checks for fellows,,HJ,,6.2,-94244.77
2032,7/27/2020,7/27/2020,Alan Safran,Imported from Bank of America Visa-Background checks for fellows,,HJ,,6.2,-94250.97
2032,7/27/2020,7/27/2020,Alan Safran,Imported from Bank of America Visa-Background checks for fellows,,HJ,,6.2,-94257.17
2032,7/27/2020,7/27/2020,Alan Safran,Imported from Bank of America Visa-Background checks for fellows,,HJ,,6.2,-94263.37
2032,7/27/2020,7/27/2020,Alan Safran,Imported from Bank of America Visa-Background checks for fellows,,HJ,,6.21,-94269.58
2032,7/27/2020,7/27/2020,Alan Safran,Imported from Bank of America Visa-Background checks for fellows,,HJ,,6.21,-94275.79
2032,7/27/2020,7/27/2020,Alan Safran,Imported from Bank of America Visa-Background checks for fellows,,HJ,,6.21,-94282
2032,7/27/2020,7/27/2020,Alan Safran,Imported from Bank of America Visa-Background checks for fellows,,HJ,,6.21,-94288.21
2032,7/27/2020,7/27/2020,Alan Safran,Imported from Bank of America Visa-Background checks for fellows,,HJ,,6.21,-94294.42
2032,7/27/2020,7/27/2020,Alan Safran,Imported from Bank of America Visa-Background checks for fellows,,HJ,,6.21,-94300.63
2032,7/27/2020,7/27/2020,Alan Safran,Imported from Bank of America Visa-Background checks for fellows,,HJ,,6.21,-94306.84
2032,7/27/2020,7/27/2020,Alan Safran,Imported from Bank of America Visa-Background checks for fellows,,HJ,,6.21,-94313.05
2032,7/27/2020,7/27/2020,Alan Safran,Imported from Bank of America Visa-Background checks for fellows,,HJ,,6.21,-94319.26
2032,7/27/2020,7/27/2020,Alan Safran,Imported from Bank of America Visa-Background checks for fellows,,HJ,,6.21,-94325.47
2032,7/27/2020,7/27/2020,Alan Safran,Imported from Bank of America Visa-Background checks for fellows,,HJ,,7.26,-94332.73
2032,7/27/2020,7/27/2020,Alan Safran,Imported from Bank of America Visa-Background checks for fellows,,HJ,,8.58,-94341.31
2032,7/27/2020,7/27/2020,Alan Safran,Imported from Bank of America Visa-Background checks for fellows,,HJ,,8.59,-94349.9
2032,7/27/2020,7/27/2020,Alan Safran,Imported from Bank of America Visa-Background checks for fellows,,HJ,,11.22,-94361.12
2032,7/27/2020,7/27/2020,Alan Safran,Imported from Bank of America Visa-Background checks for fellows,,HJ,,11.22,-94372.34
2032,7/27/2020,7/27/2020,Alan Safran,Imported from Bank of America Visa-Background checks for fellows,,HJ,,13.48,-94385.82
2032,7/27/2020,7/27/2020,Alan Safran,Imported from Bank of America Visa-Background checks for fellows,,HJ,,13.48,-94399.3
2032,7/27/2020,7/27/2020,Alan Safran,Imported from Bank of America Visa-Background checks for fellows,,HJ,,13.48,-94412.78
2032,7/27/2020,7/27/2020,Alan Safran,Imported from Bank of America Visa-Background checks for fellows,,HJ,,13.48,-94426.26
2032,7/27/2020,7/27/2020,Alan Safran,Imported from Bank of America Visa-Background checks for fellows,,HJ,,15.81,-94442.07
2032,7/27/2020,7/27/2020,Alan Safran,Imported from Bank of America Visa-Background checks for fellows,,HJ,,16.72,-94458.79
2032,7/27/2020,7/27/2020,Alan Safran,Imported from Bank of America Visa-Background checks for fellows,,HJ,,20.07,-94478.86
2032,7/27/2020,7/27/2020,Alan Safran,Imported from Bank of America Visa-Background checks for fellows,,HJ,,20.07,-94498.93
2032,7/27/2020,7/27/2020,Alan Safran,Imported from Bank of America Visa-Background checks for fellows,,HJ,,20.07,-94519
2032,7/27/2020,7/27/2020,Alan Safran,Imported from Bank of America Visa-Background checks for fellows,,HJ,,20.07,-94539.07
2032,7/27/2020,7/27/2020,Alan Safran,Imported from Bank of America Visa-Background checks for fellows,,HJ,,20.07,-94559.14
2032,7/27/2020,7/27/2020,Alan Safran,Imported from Bank of America Visa-Background checks for fellows,,HJ,,20.07,-94579.21
2032,7/27/2020,7/27/2020,Alan Safran,Imported from Bank of America Visa-Background checks for fellows,,HJ,,20.07,-94599.28
2032,7/27/2020,7/27/2020,Alan Safran,Imported from Bank of America Visa-Background checks for fellows,,HJ,,20.07,-94619.35
2032,7/27/2020,7/27/2020,Alan Safran,Imported from Bank of America Visa-Background checks for fellows,,HJ,,20.07,-94639.42
2032,7/27/2020,7/27/2020,Alan Safran,Imported from Bank of America Visa-Background checks for fellows,,HJ,,20.07,-94659.49
2032,7/27/2020,7/27/2020,Alan Safran,Imported from Bank of America Visa-Background checks for fellows,,HJ,,20.82,-94680.31
2032,7/27/2020,7/27/2020,Alan Safran,Imported from Bank of America Visa-Background checks for fellows,,HJ,,20.82,-94701.13
2032,7/27/2020,7/27/2020,Alan Safran,Imported from Bank of America Visa-Background checks for fellows,,HJ,,20.82,-94721.95
2032,7/27/2020,7/27/2020,Alan Safran,Imported from Bank of America Visa-Background checks for fellows,,HJ,,20.82,-94742.77
2032,7/27/2020,7/27/2020,Alan Safran,Imported from Bank of America Visa-Background checks for fellows,,HJ,,20.83,-94763.6
2032,7/27/2020,7/27/2020,Alan Safran,Imported from Bank of America Visa-Background checks for fellows,,HJ,,20.83,-94784.43
2032,7/27/2020,7/27/2020,Alan Safran,Imported from Bank of America Visa-Background checks for fellows,,HJ,,20.83,-94805.26
2032,7/27/2020,7/27/2020,Alan Safran,Imported from Bank of America Visa-Background checks for fellows,,HJ,,20.83,-94826.09
2032,7/27/2020,7/27/2020,Alan Safran,Imported from Bank of America Visa-Background checks for fellows,,HJ,,25.84,-94851.93
2032,7/27/2020,7/27/2020,Alan Safran,Imported from Bank of America Visa-Background checks for fellows,,HJ,,25.84,-94877.77
2032,7/27/2020,7/27/2020,Alan Safran,Imported from Bank of America Visa-Background checks for fellows,,HJ,,27.77,-94905.54
2032,7/27/2020,7/27/2020,Alan Safran,Imported from Bank of America Visa-Background checks for fellows,,HJ,,36.3,-94941.84
2032,7/27/2020,7/27/2020,Alan Safran,Imported from Bank of America Visa-Background checks for fellows,,HJ,,67.37,-95009.21
2032,7/27/2020,7/27/2020,Alan Safran,Imported from Bank of America Visa-Background checks for fellows,,HJ,,67.37,-95076.58
2032,7/27/2020,7/27/2020,Alan Safran,Imported from Bank of America Visa-Background checks for fellows,,HJ,,67.37,-95143.95
2032,7/27/2020,7/27/2020,Alan Safran,Imported from Bank of America Visa-Background checks for fellows,,HJ,,67.37,-95211.32
2032,7/27/2020,7/27/2020,Alan Safran,Imported from Bank of America Visa-Background checks for fellows,,HJ,,83.6,-95294.92
2032,7/27/2020,7/27/2020,Antonio Gutierrez,Imported from Bank of America Visa-Fellow Recruitment,,HJ,,215.96,-95510.88
2032,7/27/2020,7/27/2020,Antonio Gutierrez,Imported from Bank of America Visa-Fellow Recruitment,,HJ,,900,-96410.88
2032,7/27/2020,7/27/2020,Cathryn Cook,Imported from Bank of America Visa-Monitor for Nicole Prahin Chicago SDoP,,HJ,,114.67,-96525.55
2032,7/27/2020,7/27/2020,Elizabeth Peinado,Imported from Bank of America Visa-Job posting for all regions,,HJ,,551.55,-97077.1
2032,7/27/2020,7/27/2020,Elizabeth Peinado,Imported from Bank of America Visa-Job posting for all regions,,HJ,,852.39,-97929.49
2032,7/27/2020,7/27/2020,Elizabeth Peinado,Imported from Bank of America Visa-Job posting for all regions,,HJ,,852.39,-98781.88
2032,7/27/2020,7/27/2020,Elizabeth Peinado,Imported from Bank of America Visa-Job posting for all regions,,HJ,,2757.74,-101539.62
2032,7/27/2020,7/27/2020,Elizabeth Peinado,Imported from Bank of America Visa-Position advertisement across all regions,,HJ,,72.01,-101611.63
2032,7/27/2020,7/27/2020,Elizabeth Peinado,Imported from Bank of America Visa-Position advertisement across all regions,,HJ,,111.29,-101722.92
2032,7/27/2020,7/27/2020,Elizabeth Peinado,Imported from Bank of America Visa-Position advertisement across all regions,,HJ,,111.29,-101834.21
2032,7/27/2020,7/27/2020,Elizabeth Peinado,Imported from Bank of America Visa-Position advertisement across all regions,,HJ,,360.04,-102194.25
2032,7/27/2020,7/27/2020,Halley Bowman,Imported from Bank of America Visa-Reference books for Halley,,HJ,,6.9,-102201.15
2032,7/27/2020,7/27/2020,Halley Bowman,Imported from Bank of America Visa-Reference books for Halley,,HJ,,10.67,-102211.82
2032,7/27/2020,7/27/2020,Halley Bowman,Imported from Bank of America Visa-Reference books for Halley,,HJ,,10.67,-102222.49
2032,7/27/2020,7/27/2020,Halley Bowman,Imported from Bank of America Visa-Reference books for Halley,,HJ,,34.5,-102256.99
2032,7/27/2020,7/27/2020,Joseph Zarate,Imported from Bank of America Visa-New hire equipment,,HJ,,165.98,-102422.97
2032,7/27/2020,7/27/2020,Maryellen Leneghan,Imported from Bank of America Visa-Supplies for BC DoP,,HJ,,7.74,-102430.71
2032,7/28/2020,7/28/2020,Alan Safran,Imported from Bank of America Visa-Background checks for fellows,,HJ,,3.16,-102433.87
2032,7/28/2020,7/28/2020,Alan Safran,Imported from Bank of America Visa-Background checks for fellows,,HJ,,4.02,-102437.89
2032,7/28/2020,7/28/2020,Alan Safran,Imported from Bank of America Visa-Background checks for fellows,,HJ,,4.02,-102441.91
2032,7/28/2020,7/28/2020,Alan Safran,Imported from Bank of America Visa-Background checks for fellows,,HJ,,4.89,-102446.8
2032,7/28/2020,7/28/2020,Alan Safran,Imported from Bank of America Visa-Background checks for fellows,,HJ,,4.89,-102451.69
2032,7/28/2020,7/28/2020,Alan Safran,Imported from Bank of America Visa-Background checks for fellows,,HJ,,5.56,-102457.25
2032,7/28/2020,7/28/2020,Alan Safran,Imported from Bank of America Visa-Background checks for fellows,,HJ,,5.56,-102462.81
2032,7/28/2020,7/28/2020,Alan Safran,Imported from Bank of America Visa-Background checks for fellows,,HJ,,6.2,-102469.01
2032,7/28/2020,7/28/2020,Alan Safran,Imported from Bank of America Visa-Background checks for fellows,,HJ,,6.2,-102475.21
2032,7/28/2020,7/28/2020,Alan Safran,Imported from Bank of America Visa-Background checks for fellows,,HJ,,6.21,-102481.42
2032,7/28/2020,7/28/2020,Alan Safran,Imported from Bank of America Visa-Background checks for fellows,,HJ,,6.21,-102487.63
2032,7/28/2020,7/28/2020,Alan Safran,Imported from Bank of America Visa-Background checks for fellows,,HJ,,8.58,-102496.21
2032,7/28/2020,7/28/2020,Alan Safran,Imported from Bank of America Visa-Background checks for fellows,,HJ,,8.58,-102504.79
2032,7/28/2020,7/28/2020,Alan Safran,Imported from Bank of America Visa-Background checks for fellows,,HJ,,8.59,-102513.38
2032,7/28/2020,7/28/2020,Alan Safran,Imported from Bank of America Visa-Background checks for fellows,,HJ,,8.59,-102521.97
2032,7/28/2020,7/28/2020,Alan Safran,Imported from Bank of America Visa-Background checks for fellows,,HJ,,13.48,-102535.45
2032,7/28/2020,7/28/2020,Alan Safran,Imported from Bank of America Visa-Background checks for fellows,,HJ,,15.81,-102551.26
2032,7/28/2020,7/28/2020,Alan Safran,Imported from Bank of America Visa-Background checks for fellows,,HJ,,20.07,-102571.33
2032,7/28/2020,7/28/2020,Alan Safran,Imported from Bank of America Visa-Background checks for fellows,,HJ,,20.07,-102591.4
2032,7/28/2020,7/28/2020,Alan Safran,Imported from Bank of America Visa-Background checks for fellows,,HJ,,20.82,-102612.22
2032,7/28/2020,7/28/2020,Alan Safran,Imported from Bank of America Visa-Background checks for fellows,,HJ,,20.83,-102633.05
2032,7/28/2020,7/28/2020,Alan Safran,Imported from Bank of America Visa-Background checks for fellows,,HJ,,27.77,-102660.82
2032,7/28/2020,7/28/2020,Alan Safran,Imported from Bank of America Visa-Background checks for fellows,,HJ,,27.77,-102688.59
2032,7/28/2020,7/28/2020,Alan Safran,Imported from Bank of America Visa-Background checks for fellows,,HJ,,67.37,-102755.96
2032,7/28/2020,7/28/2020,Antonio Gutierrez,Imported from Bank of America Visa-Fellow Recruitment,,HJ,,900,-103655.96
2032,7/28/2020,7/28/2020,Antonio Gutierrez,Imported from Bank of America Visa-Fellow Recruitment,,HJ,,900,-104555.96
2032,7/28/2020,7/28/2020,Elizabeth Peinado,Imported from Bank of America Visa-Job posting for all regions,,HJ,,583,-105138.96
2032,7/28/2020,7/28/2020,Elizabeth Peinado,Imported from Bank of America Visa-Job posting for all regions,,HJ,,901,-106039.96
2032,7/28/2020,7/28/2020,Elizabeth Peinado,Imported from Bank of America Visa-Job posting for all regions,,HJ,,901,-106940.96
2032,7/28/2020,7/28/2020,Elizabeth Peinado,Imported from Bank of America Visa-Job posting for all regions,,HJ,,2915,-109855.96
2032,7/28/2020,7/28/2020,Elizabeth Peinado,Imported from Bank of America Visa-Position advertisement across all regions,,HJ,,55.53,-109911.49
2032,7/28/2020,7/28/2020,Elizabeth Peinado,Imported from Bank of America Visa-Position advertisement across all regions,,HJ,,85.81,-109997.3
2032,7/28/2020,7/28/2020,Elizabeth Peinado,Imported from Bank of America Visa-Position advertisement across all regions,,HJ,,85.81,-110083.11
2032,7/28/2020,7/28/2020,Elizabeth Peinado,Imported from Bank of America Visa-Position advertisement across all regions,,HJ,,277.63,-110360.74
2032,7/28/2020,7/28/2020,Joseph Zarate,Imported from Bank of America Visa-Equipment,,HJ,,9.99,-110370.73
2032,7/28/2020,7/28/2020,Joseph Zarate,Imported from Bank of America Visa-Equipment,,HJ,,102.1,-110472.83
2032,7/28/2020,7/28/2020,Joseph Zarate,Imported from Bank of America Visa-New hire equipment,,HJ,,112.09,-110584.92
2032,7/28/2020,7/28/2020,Joseph Zarate,Imported from Bank of America Visa-New hire equipment,,HJ,,229,-110813.92
2032,7/28/2020,7/28/2020,Joseph Zarate,Imported from Bank of America Visa-repairs,,HJ,,64.4,-110878.32
2032,7/28/2020,7/28/2020,Monivett Acevedo,Imported from Bank of America Visa-Office Monthly printer ink,,HJ,,10.61,-110888.93
2032,7/29/2020,7/29/2020,Alan Safran,Imported from Bank of America Visa-Background checks for fellows,,HJ,,4.02,-110892.95
2032,7/29/2020,7/29/2020,Alan Safran,Imported from Bank of America Visa-Background checks for fellows,,HJ,,6.2,-110899.15
2032,7/29/2020,7/29/2020,Alan Safran,Imported from Bank of America Visa-Background checks for fellows,,HJ,,6.21,-110905.36
2032,7/29/2020,7/29/2020,Alan Safran,Imported from Bank of America Visa-Background checks for fellows,,HJ,,20.07,-110925.43
2032,7/29/2020,7/29/2020,Antonio Gutierrez,Imported from Bank of America Visa-Fellow Recruitment,,HJ,,900,-111825.43
2032,7/29/2020,7/29/2020,Elecia D Lacey,Imported from Bank of America Visa-Office Supplies - Printer Ink,,HJ,,14.33,-111839.76
2032,7/29/2020,7/29/2020,Elizabeth Peinado,Imported from Bank of America Visa-Position advertisement across all regions,,HJ,,55.47,-111895.23
2032,7/29/2020,7/29/2020,Elizabeth Peinado,Imported from Bank of America Visa-Position advertisement across all regions,,HJ,,85.73,-111980.96
2032,7/29/2020,7/29/2020,Elizabeth Peinado,Imported from Bank of America Visa-Position advertisement across all regions,,HJ,,85.73,-112066.69
2032,7/29/2020,7/29/2020,Elizabeth Peinado,Imported from Bank of America Visa-Position advertisement across all regions,,HJ,,277.37,-112344.06
2032,7/29/2020,7/29/2020,Myesha Hossain,Imported from Bank of America Visa-Site Clean out,,HJ,,20.76,-112364.82
2032,7/29/2020,7/29/2020,Myesha Hossain,Imported from Bank of America Visa-Storage,,HJ,,56.59,-112421.41
2032,7/30/2020,7/30/2020,Alan Safran,Imported from Bank of America Visa-Background checks for fellows,,HJ,,3.16,-112424.57
2032,7/30/2020,7/30/2020,Alan Safran,Imported from Bank of America Visa-Background checks for fellows,,HJ,,3.16,-112427.73
2032,7/30/2020,7/30/2020,Alan Safran,Imported from Bank of America Visa-Background checks for fellows,,HJ,,4.02,-112431.75
2032,7/30/2020,7/30/2020,Alan Safran,Imported from Bank of America Visa-Background checks for fellows,,HJ,,4.89,-112436.64
2032,7/30/2020,7/30/2020,Alan Safran,Imported from Bank of America Visa-Background checks for fellows,,HJ,,4.89,-112441.53
2032,7/30/2020,7/30/2020,Alan Safran,Imported from Bank of America Visa-Background checks for fellows,,HJ,,4.89,-112446.42
2032,7/30/2020,7/30/2020,Alan Safran,Imported from Bank of America Visa-Background checks for fellows,,HJ,,4.89,-112451.31
2032,7/30/2020,7/30/2020,Alan Safran,Imported from Bank of America Visa-Background checks for fellows,,HJ,,5.56,-112456.87
2032,7/30/2020,7/30/2020,Alan Safran,Imported from Bank of America Visa-Background checks for fellows,,HJ,,6.2,-112463.07
2032,7/30/2020,7/30/2020,Alan Safran,Imported from Bank of America Visa-Background checks for fellows,,HJ,,6.21,-112469.28
2032,7/30/2020,7/30/2020,Alan Safran,Imported from Bank of America Visa-Background checks for fellows,,HJ,,8.58,-112477.86
2032,7/30/2020,7/30/2020,Alan Safran,Imported from Bank of America Visa-Background checks for fellows,,HJ,,8.59,-112486.45
2032,7/30/2020,7/30/2020,Alan Safran,Imported from Bank of America Visa-Background checks for fellows,,HJ,,15.81,-112502.26
2032,7/30/2020,7/30/2020,Alan Safran,Imported from Bank of America Visa-Background checks for fellows,,HJ,,15.81,-112518.07
2032,7/30/2020,7/30/2020,Alan Safran,Imported from Bank of America Visa-Background checks for fellows,,HJ,,20.07,-112538.14
2032,7/30/2020,7/30/2020,Alan Safran,Imported from Bank of America Visa-Background checks for fellows,,HJ,,27.77,-112565.91
2032,7/30/2020,7/30/2020,Antonio Gutierrez,Imported from Bank of America Visa-Fellow Recruitment,,HJ,,900,-113465.91
2032,7/30/2020,7/30/2020,Antonio Gutierrez,Imported from Bank of America Visa-Unknown,,HJ,,1.99,-113467.9
2032,7/30/2020,7/30/2020,Antonio Gutierrez,Imported from Bank of America Visa-Unknown,,HJ,1.99,,-113465.91
2032,7/30/2020,7/30/2020,Elizabeth Peinado,Imported from Bank of America Visa-Position advertisement across all regions,,HJ,,55.44,-113521.35
2032,7/30/2020,7/30/2020,Elizabeth Peinado,Imported from Bank of America Visa-Position advertisement across all regions,,HJ,,85.68,-113607.03
2032,7/30/2020,7/30/2020,Elizabeth Peinado,Imported from Bank of America Visa-Position advertisement across all regions,,HJ,,85.68,-113692.71
2032,7/30/2020,7/30/2020,Elizabeth Peinado,Imported from Bank of America Visa-Position advertisement across all regions,,HJ,,277.19,-113969.9
2032,7/30/2020,7/30/2020,Joseph Zarate,Imported from Bank of America Visa-New hire equipment,,HJ,,800.3,-114770.2
2032,7/30/2020,7/30/2020,Joseph Zarate,Imported from Bank of America Visa-shipping,,HJ,,15.05,-114785.25
2032,7/30/2020,7/30/2020,Mahaliah Sejour,Imported from Bank of America Visa-MS mouse planner,,HJ,,29.19,-114814.44
2032,7/30/2020,7/30/2020,Myesha Hossain,Imported from Bank of America Visa-Site Transportation,,HJ,,47.11,-114861.55
2032,7/30/2020,7/30/2020,Myesha Hossain,Imported from Bank of America Visa-Site Transportation,,HJ,,54.48,-114916.03
2032,7/30/2020,7/30/2020,Myesha Hossain,Imported from Bank of America Visa-Storage,,HJ,,19.59,-114935.62
2032,7/30/2020,7/30/2020,Uriel Guadarrama,Imported from Bank of America Visa-1 more Zoom license for BC SD,,HJ,,14.38,-114950
2032,7/30/2020,7/30/2020,Uriel Guadarrama,Imported from Bank of America Visa-6 monthly licenses for BC SDs NAT staff,,HJ,,13.3,-114963.3
2032,7/30/2020,7/30/2020,Uriel Guadarrama,Imported from Bank of America Visa-6 monthly licenses for BC SDs NAT staff,,HJ,,13.31,-114976.61
2032,7/31/2020,7/31/2020,Alan Safran,Imported from Bank of America Visa-Background checks for fellows,,HJ,,3.16,-114979.77
2032,7/31/2020,7/31/2020,Alan Safran,Imported from Bank of America Visa-Background checks for fellows,,HJ,,3.16,-114982.93
2032,7/31/2020,7/31/2020,Alan Safran,Imported from Bank of America Visa-Background checks for fellows,,HJ,,4.89,-114987.82
2032,7/31/2020,7/31/2020,Alan Safran,Imported from Bank of America Visa-Background checks for fellows,,HJ,,4.89,-114992.71
2032,7/31/2020,7/31/2020,Alan Safran,Imported from Bank of America Visa-Background checks for fellows,,HJ,,4.89,-114997.6
2032,7/31/2020,7/31/2020,Alan Safran,Imported from Bank of America Visa-Background checks for fellows,,HJ,,4.89,-115002.49
2032,7/31/2020,7/31/2020,Alan Safran,Imported from Bank of America Visa-Background checks for fellows,,HJ,,15.81,-115018.3
2032,7/31/2020,7/31/2020,Alan Safran,Imported from Bank of America Visa-Background checks for fellows,,HJ,,15.81,-115034.11
2032,7/31/2020,7/31/2020,Antonio Gutierrez,Imported from Bank of America Visa-Fellow Recruitment,,HJ,,900,-115934.11
2032,7/31/2020,7/31/2020,Elizabeth Peinado,Imported from Bank of America Visa-Position advertisement across all regions,,HJ,,105.85,-116039.96
2032,7/31/2020,7/31/2020,Elizabeth Peinado,Imported from Bank of America Visa-Position advertisement across all regions,,HJ,,163.59,-116203.55
2032,7/31/2020,7/31/2020,Elizabeth Peinado,Imported from Bank of America Visa-Position advertisement across all regions,,HJ,,163.59,-116367.14
2032,7/31/2020,7/31/2020,Elizabeth Peinado,Imported from Bank of America Visa-Position advertisement across all regions,,HJ,,529.25,-116896.39
2032,8/1/2020,8/1/2020,Alan Safran,Imported from Bank of America Visa-Background checks for fellows,,HJ,,3.16,-116899.55
2032,8/1/2020,8/1/2020,Alan Safran,Imported from Bank of America Visa-Background checks for fellows,,HJ,,3.16,-116902.71
2032,8/1/2020,8/1/2020,Alan Safran,Imported from Bank of America Visa-Background checks for fellows,,HJ,,3.16,-116905.87
2032,8/1/2020,8/1/2020,Alan Safran,Imported from Bank of America Visa-Background checks for fellows,,HJ,,4.89,-116910.76
2032,8/1/2020,8/1/2020,Alan Safran,Imported from Bank of America Visa-Background checks for fellows,,HJ,,4.89,-116915.65
2032,8/1/2020,8/1/2020,Alan Safran,Imported from Bank of America Visa-Background checks for fellows,,HJ,,4.89,-116920.54
2032,8/1/2020,8/1/2020,Alan Safran,Imported from Bank of America Visa-Background checks for fellows,,HJ,,4.89,-116925.43
2032,8/1/2020,8/1/2020,Alan Safran,Imported from Bank of America Visa-Background checks for fellows,,HJ,,4.89,-116930.32
2032,8/1/2020,8/1/2020,Alan Safran,Imported from Bank of America Visa-Background checks for fellows,,HJ,,4.89,-116935.21
2032,8/1/2020,8/1/2020,Alan Safran,Imported from Bank of America Visa-Background checks for fellows,,HJ,,5.56,-116940.77
2032,8/1/2020,8/1/2020,Alan Safran,Imported from Bank of America Visa-Background checks for fellows,,HJ,,8.58,-116949.35
2032,8/1/2020,8/1/2020,Alan Safran,Imported from Bank of America Visa-Background checks for fellows,,HJ,,8.59,-116957.94
2032,8/1/2020,8/1/2020,Alan Safran,Imported from Bank of America Visa-Background checks for fellows,,HJ,,13.48,-116971.42
2032,8/1/2020,8/1/2020,Alan Safran,Imported from Bank of America Visa-Background checks for fellows,,HJ,,15.81,-116987.23
2032,8/1/2020,8/1/2020,Alan Safran,Imported from Bank of America Visa-Background checks for fellows,,HJ,,15.81,-117003.04
2032,8/1/2020,8/1/2020,Alan Safran,Imported from Bank of America Visa-Background checks for fellows,,HJ,,15.81,-117018.85
2032,8/1/2020,8/1/2020,Alan Safran,Imported from Bank of America Visa-Background checks for fellows,,HJ,,20.82,-117039.67
2032,8/1/2020,8/1/2020,Alan Safran,Imported from Bank of America Visa-Background checks for fellows,,HJ,,20.83,-117060.5
2032,8/1/2020,8/1/2020,Alan Safran,Imported from Bank of America Visa-Background checks for fellows,,HJ,,27.77,-117088.27
2032,8/1/2020,8/1/2020,Alan Safran,Imported from Bank of America Visa-Background checks for fellows,,HJ,,67.37,-117155.64
2032,8/1/2020,8/1/2020,Antonio Gutierrez,Imported from Bank of America Visa-Expense Reporting,,HJ,,1226.42,-118382.06
2032,8/1/2020,8/1/2020,Antonio Gutierrez,Imported from Bank of America Visa-Fellow Recruitment,,HJ,,900,-119282.06
2032,8/1/2020,8/1/2020,Antonio Gutierrez,Imported from Bank of America Visa-Fellow Recruitment,,HJ,,900,-120182.06
2032,8/1/2020,8/1/2020,Antonio Gutierrez,Imported from Bank of America Visa-Fellow Recruitment,,HJ,,900,-121082.06
2032,8/1/2020,8/1/2020,Antonio Gutierrez,Imported from Bank of America Visa-Fellow Recruitment,,HJ,,900,-121982.06
2032,8/1/2020,8/1/2020,Antonio Gutierrez,Imported from Bank of America Visa-Office Supplies,,HJ,,74.36,-122056.42
2032,8/1/2020,8/1/2020,Elizabeth Peinado,Imported from Bank of America Visa-Fellow Staff advertising Brand Awareness,,HJ,,108.61,-122165.03
2032,8/1/2020,8/1/2020,Elizabeth Peinado,Imported from Bank of America Visa-Fellow Staff advertising Brand Awareness,,HJ,,167.85,-122332.88
2032,8/1/2020,8/1/2020,Elizabeth Peinado,Imported from Bank of America Visa-Fellow Staff advertising Brand Awareness,,HJ,,167.85,-122500.73
2032,8/1/2020,8/1/2020,Elizabeth Peinado,Imported from Bank of America Visa-Fellow Staff advertising Brand Awareness,,HJ,,543.06,-123043.79
2032,8/1/2020,8/1/2020,Elizabeth Peinado,Imported from Bank of America Visa-Fellow job postings all regions,,HJ,,551.16,-123594.95
2032,8/1/2020,8/1/2020,Elizabeth Peinado,Imported from Bank of America Visa-Fellow job postings all regions,,HJ,,851.79,-124446.74
2032,8/1/2020,8/1/2020,Elizabeth Peinado,Imported from Bank of America Visa-Fellow job postings all regions,,HJ,,851.79,-125298.53
2032,8/1/2020,8/1/2020,Elizabeth Peinado,Imported from Bank of America Visa-Fellow job postings all regions,,HJ,,2755.81,-128054.34
2032,8/1/2020,8/1/2020,Elizabeth Peinado,Imported from Bank of America Visa-Fellow job postings . all regions,,HJ,,1.65,-128055.99
2032,8/1/2020,8/1/2020,Elizabeth Peinado,Imported from Bank of America Visa-Fellow job postings . all regions,,HJ,,2.55,-128058.54
2032,8/1/2020,8/1/2020,Elizabeth Peinado,Imported from Bank of America Visa-Fellow job postings . all regions,,HJ,,2.55,-128061.09
2032,8/1/2020,8/1/2020,Elizabeth Peinado,Imported from Bank of America Visa-Fellow job postings . all regions,,HJ,,8.26,-128069.35
2032,8/1/2020,8/1/2020,Halley Bowman,Imported from Bank of America Visa-Thank Ashlee for extra work,,HJ,,3.2,-128072.55
2032,8/1/2020,8/1/2020,Halley Bowman,Imported from Bank of America Visa-Thank Ashlee for extra work,,HJ,,4.94,-128077.49
2032,8/1/2020,8/1/2020,Halley Bowman,Imported from Bank of America Visa-Thank Ashlee for extra work,,HJ,,4.94,-128082.43
2032,8/1/2020,8/1/2020,Halley Bowman,Imported from Bank of America Visa-Thank Ashlee for extra work,,HJ,,16,-128098.43
2032,8/1/2020,8/1/2020,Joseph Zarate,Imported from Bank of America Visa-New hire equipment,,HJ,,169.98,-128268.41
2032,8/1/2020,8/1/2020,Joseph Zarate,Imported from Bank of America Visa-New hire equipment,,HJ,,169.98,-128438.39
2032,8/1/2020,8/1/2020,Joseph Zarate,Imported from Bank of America Visa-New hire equipment,,HJ,,169.98,-128608.37
2032,8/1/2020,8/1/2020,Joseph Zarate,Imported from Bank of America Visa-New hire equipment,,HJ,,169.98,-128778.35
2032,8/1/2020,8/1/2020,Joseph Zarate,Imported from Bank of America Visa-Refund issued,,HJ,468,,-128310.35
2032,8/1/2020,8/1/2020,Mahaliah Sejour,Imported from Bank of America Visa-Fellows gifts,,HJ,,15.96,-128326.31
2032,8/1/2020,8/1/2020,Myesha Hossain,Imported from Bank of America Visa-Clinton cleanout,,HJ,20.76,,-128305.55
2032,8/1/2020,8/1/2020,Myesha Hossain,Imported from Bank of America Visa-Clinton cleanout,,HJ,,22.18,-128327.73
2032,8/1/2020,8/1/2020,Myesha Hossain,Imported from Bank of America Visa-Clinton cleanout,,HJ,,102.09,-128429.82
2032,8/1/2020,8/1/2020,Uriel Guadarrama,Imported from Bank of America Visa-14 monthly licenses for DC NYC SDs,,HJ,,40.78,-128470.6
2032,8/1/2020,8/1/2020,Uriel Guadarrama,Imported from Bank of America Visa-14 monthly licenses for DC NYC SDs,,HJ,,153.43,-128624.03
2032,8/1/2020,8/1/2020,Uriel Guadarrama,Imported from Bank of America Visa-17 monthly licenses for CHI SDs,,HJ,,235.82,-128859.85
2032,8/1/2020,8/1/2020,Uriel Guadarrama,Imported from Bank of America Visa-Upgrade to Business from Pro,,HJ,,3.52,-128863.37
2032,8/1/2020,8/1/2020,Uriel Guadarrama,Imported from Bank of America Visa-Upgrade to Business from Pro,,HJ,,14.07,-128877.44
2032,8/1/2020,8/1/2020,Uriel Guadarrama,Imported from Bank of America Visa-Upgrade to Business from Pro,,HJ,,28.13,-128905.57
2032,8/1/2020,8/1/2020,Uriel Guadarrama,Imported from Bank of America Visa-Upgrade to Business from Pro,,HJ,,50.99,-128956.56
2032,8/1/2020,8/1/2020,Uriel Guadarrama,Imported from Bank of America Visa-Upgrade to Business from Pro,,HJ,,79.11,-129035.67
2032,8/2/2020,8/2/2020,Alan Safran,Imported from Bank of America Visa-Background checks for fellows,,HJ,,3.16,-129038.83
2032,8/2/2020,8/2/2020,Alan Safran,Imported from Bank of America Visa-Background checks for fellows,,HJ,,3.16,-129041.99
2032,8/2/2020,8/2/2020,Alan Safran,Imported from Bank of America Visa-Background checks for fellows,,HJ,,3.16,-129045.15
2032,8/2/2020,8/2/2020,Alan Safran,Imported from Bank of America Visa-Background checks for fellows,,HJ,,4.02,-129049.17
2032,8/2/2020,8/2/2020,Alan Safran,Imported from Bank of America Visa-Background checks for fellows,,HJ,,4.89,-129054.06
2032,8/2/2020,8/2/2020,Alan Safran,Imported from Bank of America Visa-Background checks for fellows,,HJ,,4.89,-129058.95
2032,8/2/2020,8/2/2020,Alan Safran,Imported from Bank of America Visa-Background checks for fellows,,HJ,,4.89,-129063.84
2032,8/2/2020,8/2/2020,Alan Safran,Imported from Bank of America Visa-Background checks for fellows,,HJ,,4.89,-129068.73
2032,8/2/2020,8/2/2020,Alan Safran,Imported from Bank of America Visa-Background checks for fellows,,HJ,,4.89,-129073.62
2032,8/2/2020,8/2/2020,Alan Safran,Imported from Bank of America Visa-Background checks for fellows,,HJ,,4.89,-129078.51
2032,8/2/2020,8/2/2020,Alan Safran,Imported from Bank of America Visa-Background checks for fellows,,HJ,,6.2,-129084.71
2032,8/2/2020,8/2/2020,Alan Safran,Imported from Bank of America Visa-Background checks for fellows,,HJ,,6.21,-129090.92
2032,8/2/2020,8/2/2020,Alan Safran,Imported from Bank of America Visa-Background checks for fellows,,HJ,,15.81,-129106.73
2032,8/2/2020,8/2/2020,Alan Safran,Imported from Bank of America Visa-Background checks for fellows,,HJ,,15.81,-129122.54
2032,8/2/2020,8/2/2020,Alan Safran,Imported from Bank of America Visa-Background checks for fellows,,HJ,,15.81,-129138.35
2032,8/2/2020,8/2/2020,Alan Safran,Imported from Bank of America Visa-Background checks for fellows,,HJ,,20.07,-129158.42
2032,8/2/2020,8/2/2020,Angela Mason,Imported from Bank of America Visa-Storage Unit for Chicago,,HJ,,149,-129307.42
2032,8/2/2020,8/2/2020,Angela Mason,Imported from Bank of America Visa-Storage units for Chicago,,HJ,,173,-129480.42
2032,8/2/2020,8/2/2020,Antonio Gutierrez,Imported from Bank of America Visa-Fellow Recruitment,,HJ,,900,-130380.42
2032,8/2/2020,8/2/2020,Antonio Gutierrez,Imported from Bank of America Visa-Fellow Recruitment,,HJ,,900,-131280.42
2032,8/2/2020,8/2/2020,Elizabeth Peinado,Imported from Bank of America Visa-Fellow Staff advertising. Brand Awareness,,HJ,,63.77,-131344.19
2032,8/2/2020,8/2/2020,Elizabeth Peinado,Imported from Bank of America Visa-Fellow Staff advertising. Brand Awareness,,HJ,,98.56,-131442.75
2032,8/2/2020,8/2/2020,Elizabeth Peinado,Imported from Bank of America Visa-Fellow Staff advertising. Brand Awareness,,HJ,,98.56,-131541.31
2032,8/2/2020,8/2/2020,Elizabeth Peinado,Imported from Bank of America Visa-Fellow Staff advertising. Brand Awareness,,HJ,,318.86,-131860.17
2032,8/2/2020,8/2/2020,Elizabeth Peinado,Imported from Bank of America Visa-Fellow job postings . all regions,,HJ,,495,-132355.17
2032,8/2/2020,8/2/2020,Elizabeth Peinado,Imported from Bank of America Visa-Fellow job postings . all regions,,HJ,,765,-133120.17
2032,8/2/2020,8/2/2020,Elizabeth Peinado,Imported from Bank of America Visa-Fellow job postings . all regions,,HJ,,765,-133885.17
2032,8/2/2020,8/2/2020,Elizabeth Peinado,Imported from Bank of America Visa-Fellow job postings . all regions,,HJ,,2475,-136360.17
2032,8/2/2020,8/2/2020,Mahaliah Sejour,Imported from Bank of America Visa-Fellows gifts,,HJ,,21.09,-136381.26
2032,8/3/2020,8/3/2020,Alan Safran,Imported from Bank of America Visa-Background checks for fellows,,HJ,,2.92,-136384.18
2032,8/3/2020,8/3/2020,Alan Safran,Imported from Bank of America Visa-Background checks for fellows,,HJ,,4.02,-136388.2
2032,8/3/2020,8/3/2020,Alan Safran,Imported from Bank of America Visa-Background checks for fellows,,HJ,,4.02,-136392.22
2032,8/3/2020,8/3/2020,Alan Safran,Imported from Bank of America Visa-Background checks for fellows,,HJ,,4.02,-136396.24
2032,8/3/2020,8/3/2020,Alan Safran,Imported from Bank of America Visa-Background checks for fellows,,HJ,,4.02,-136400.26
2032,8/3/2020,8/3/2020,Alan Safran,Imported from Bank of America Visa-Background checks for fellows,,HJ,,4.02,-136404.28
2032,8/3/2020,8/3/2020,Alan Safran,Imported from Bank of America Visa-Background checks for fellows,,HJ,,4.5,-136408.78
2032,8/3/2020,8/3/2020,Alan Safran,Imported from Bank of America Visa-Background checks for fellows,,HJ,,4.51,-136413.29
2032,8/3/2020,8/3/2020,Alan Safran,Imported from Bank of America Visa-Background checks for fellows,,HJ,,5.56,-136418.85
2032,8/3/2020,8/3/2020,Alan Safran,Imported from Bank of America Visa-Background checks for fellows,,HJ,,5.56,-136424.41
2032,8/3/2020,8/3/2020,Alan Safran,Imported from Bank of America Visa-Background checks for fellows,,HJ,,5.56,-136429.97
2032,8/3/2020,8/3/2020,Alan Safran,Imported from Bank of America Visa-Background checks for fellows,,HJ,,5.56,-136435.53
2032,8/3/2020,8/3/2020,Alan Safran,Imported from Bank of America Visa-Background checks for fellows,,HJ,,5.56,-136441.09
2032,8/3/2020,8/3/2020,Alan Safran,Imported from Bank of America Visa-Background checks for fellows,,HJ,,6.2,-136447.29
2032,8/3/2020,8/3/2020,Alan Safran,Imported from Bank of America Visa-Background checks for fellows,,HJ,,6.2,-136453.49
2032,8/3/2020,8/3/2020,Alan Safran,Imported from Bank of America Visa-Background checks for fellows,,HJ,,6.2,-136459.69
2032,8/3/2020,8/3/2020,Alan Safran,Imported from Bank of America Visa-Background checks for fellows,,HJ,,6.2,-136465.89
2032,8/3/2020,8/3/2020,Alan Safran,Imported from Bank of America Visa-Background checks for fellows,,HJ,,6.2,-136472.09
2032,8/3/2020,8/3/2020,Alan Safran,Imported from Bank of America Visa-Background checks for fellows,,HJ,,6.21,-136478.3
2032,8/3/2020,8/3/2020,Alan Safran,Imported from Bank of America Visa-Background checks for fellows,,HJ,,6.21,-136484.51
2032,8/3/2020,8/3/2020,Alan Safran,Imported from Bank of America Visa-Background checks for fellows,,HJ,,6.21,-136490.72
2032,8/3/2020,8/3/2020,Alan Safran,Imported from Bank of America Visa-Background checks for fellows,,HJ,,6.21,-136496.93
2032,8/3/2020,8/3/2020,Alan Safran,Imported from Bank of America Visa-Background checks for fellows,,HJ,,6.21,-136503.14
2032,8/3/2020,8/3/2020,Alan Safran,Imported from Bank of America Visa-Background checks for fellows,,HJ,,8.58,-136511.72
2032,8/3/2020,8/3/2020,Alan Safran,Imported from Bank of America Visa-Background checks for fellows,,HJ,,8.58,-136520.3
2032,8/3/2020,8/3/2020,Alan Safran,Imported from Bank of America Visa-Background checks for fellows,,HJ,,8.58,-136528.88
2032,8/3/2020,8/3/2020,Alan Safran,Imported from Bank of America Visa-Background checks for fellows,,HJ,,8.58,-136537.46
2032,8/3/2020,8/3/2020,Alan Safran,Imported from Bank of America Visa-Background checks for fellows,,HJ,,8.58,-136546.04
2032,8/3/2020,8/3/2020,Alan Safran,Imported from Bank of America Visa-Background checks for fellows,,HJ,,8.59,-136554.63
2032,8/3/2020,8/3/2020,Alan Safran,Imported from Bank of America Visa-Background checks for fellows,,HJ,,8.59,-136563.22
2032,8/3/2020,8/3/2020,Alan Safran,Imported from Bank of America Visa-Background checks for fellows,,HJ,,8.59,-136571.81
2032,8/3/2020,8/3/2020,Alan Safran,Imported from Bank of America Visa-Background checks for fellows,,HJ,,8.59,-136580.4
2032,8/3/2020,8/3/2020,Alan Safran,Imported from Bank of America Visa-Background checks for fellows,,HJ,,8.59,-136588.99
2032,8/3/2020,8/3/2020,Alan Safran,Imported from Bank of America Visa-Background checks for fellows,,HJ,,13.48,-136602.47
2032,8/3/2020,8/3/2020,Alan Safran,Imported from Bank of America Visa-Background checks for fellows,,HJ,,13.48,-136615.95
2032,8/3/2020,8/3/2020,Alan Safran,Imported from Bank of America Visa-Background checks for fellows,,HJ,,14.57,-136630.52
2032,8/3/2020,8/3/2020,Alan Safran,Imported from Bank of America Visa-Background checks for fellows,,HJ,,15.62,-136646.14
2032,8/3/2020,8/3/2020,Alan Safran,Imported from Bank of America Visa-Background checks for fellows,,HJ,,20.07,-136666.21
2032,8/3/2020,8/3/2020,Alan Safran,Imported from Bank of America Visa-Background checks for fellows,,HJ,,20.07,-136686.28
2032,8/3/2020,8/3/2020,Alan Safran,Imported from Bank of America Visa-Background checks for fellows,,HJ,,20.07,-136706.35
2032,8/3/2020,8/3/2020,Alan Safran,Imported from Bank of America Visa-Background checks for fellows,,HJ,,20.07,-136726.42
2032,8/3/2020,8/3/2020,Alan Safran,Imported from Bank of America Visa-Background checks for fellows,,HJ,,20.07,-136746.49
2032,8/3/2020,8/3/2020,Alan Safran,Imported from Bank of America Visa-Background checks for fellows,,HJ,,20.82,-136767.31
2032,8/3/2020,8/3/2020,Alan Safran,Imported from Bank of America Visa-Background checks for fellows,,HJ,,20.82,-136788.13
2032,8/3/2020,8/3/2020,Alan Safran,Imported from Bank of America Visa-Background checks for fellows,,HJ,,20.83,-136808.96
2032,8/3/2020,8/3/2020,Alan Safran,Imported from Bank of America Visa-Background checks for fellows,,HJ,,20.83,-136829.79
2032,8/3/2020,8/3/2020,Alan Safran,Imported from Bank of America Visa-Background checks for fellows,,HJ,,24.14,-136853.93
2032,8/3/2020,8/3/2020,Alan Safran,Imported from Bank of America Visa-Background checks for fellows,,HJ,,24.14,-136878.07
2032,8/3/2020,8/3/2020,Alan Safran,Imported from Bank of America Visa-Background checks for fellows,,HJ,,27.77,-136905.84
2032,8/3/2020,8/3/2020,Alan Safran,Imported from Bank of America Visa-Background checks for fellows,,HJ,,27.77,-136933.61
2032,8/3/2020,8/3/2020,Alan Safran,Imported from Bank of America Visa-Background checks for fellows,,HJ,,27.77,-136961.38
2032,8/3/2020,8/3/2020,Alan Safran,Imported from Bank of America Visa-Background checks for fellows,,HJ,,27.77,-136989.15
2032,8/3/2020,8/3/2020,Alan Safran,Imported from Bank of America Visa-Background checks for fellows,,HJ,,27.77,-137016.92
2032,8/3/2020,8/3/2020,Alan Safran,Imported from Bank of America Visa-Background checks for fellows,,HJ,,67.37,-137084.29
2032,8/3/2020,8/3/2020,Alan Safran,Imported from Bank of America Visa-Background checks for fellows,,HJ,,67.37,-137151.66
2032,8/3/2020,8/3/2020,Alan Safran,Imported from Bank of America Visa-Background checks for fellows,,HJ,,78.1,-137229.76
2032,8/3/2020,8/3/2020,Alan Safran,Imported from Bank of America Visa-Bank Service Fees and Charges,,HJ,,15,-137244.76
2032,8/3/2020,8/3/2020,Antonio Gutierrez,Imported from Bank of America Visa-Fellow Recruitment,,HJ,,900,-138144.76
2032,8/3/2020,8/3/2020,Antonio Gutierrez,Imported from Bank of America Visa-Fellow Recruitment,,HJ,,900,-139044.76
2032,8/3/2020,8/3/2020,Antonio Gutierrez,Imported from Bank of America Visa-Fellow Recruitment,,HJ,,900,-139944.76
2032,8/3/2020,8/3/2020,Antonio Gutierrez,Imported from Bank of America Visa-Office Supplies,,HJ,,21.99,-139966.75
2032,8/3/2020,8/3/2020,Antonio Gutierrez,Imported from Bank of America Visa-Storage Space,,HJ,,1.99,-139968.74
2032,8/3/2020,8/3/2020,Elizabeth Peinado,Imported from Bank of America Visa-Fellow Staff advertising. Brand Awareness,,HJ,,62.03,-140030.77
2032,8/3/2020,8/3/2020,Elizabeth Peinado,Imported from Bank of America Visa-Fellow Staff advertising. Brand Awareness,,HJ,,95.86,-140126.63
2032,8/3/2020,8/3/2020,Elizabeth Peinado,Imported from Bank of America Visa-Fellow Staff advertising. Brand Awareness,,HJ,,95.86,-140222.49
2032,8/3/2020,8/3/2020,Elizabeth Peinado,Imported from Bank of America Visa-Fellow Staff advertising. Brand Awareness,,HJ,,310.14,-140532.63
2032,8/3/2020,8/3/2020,Joseph Zarate,Imported from Bank of America Visa-Returns,,HJ,,15.05,-140547.68
2032,8/3/2020,8/3/2020,Monivett Acevedo,Imported from Bank of America Visa-keyboard,,HJ,,39.58,-140587.26
2032,8/3/2020,8/3/2020,Nicole Prahin,Imported from Bank of America Visa-Monitor for home work space,,HJ,,139.98,-140727.24
2032,8/4/2020,8/4/2020,Alan Safran,Imported from Bank of America Visa-Background checks for fellows,,HJ,,3.16,-140730.4
2032,8/4/2020,8/4/2020,Alan Safran,Imported from Bank of America Visa-Background checks for fellows,,HJ,,3.16,-140733.56
2032,8/4/2020,8/4/2020,Alan Safran,Imported from Bank of America Visa-Background checks for fellows,,HJ,,3.16,-140736.72
2032,8/4/2020,8/4/2020,Alan Safran,Imported from Bank of America Visa-Background checks for fellows,,HJ,,3.16,-140739.88
2032,8/4/2020,8/4/2020,Alan Safran,Imported from Bank of America Visa-Background checks for fellows,,HJ,,3.16,-140743.04
2032,8/4/2020,8/4/2020,Alan Safran,Imported from Bank of America Visa-Background checks for fellows,,HJ,,3.16,-140746.2
2032,8/4/2020,8/4/2020,Alan Safran,Imported from Bank of America Visa-Background checks for fellows,,HJ,,3.16,-140749.36
2032,8/4/2020,8/4/2020,Alan Safran,Imported from Bank of America Visa-Background checks for fellows,,HJ,,3.16,-140752.52
2032,8/4/2020,8/4/2020,Alan Safran,Imported from Bank of America Visa-Background checks for fellows,,HJ,,4.02,-140756.54
2032,8/4/2020,8/4/2020,Alan Safran,Imported from Bank of America Visa-Background checks for fellows,,HJ,,4.89,-140761.43
2032,8/4/2020,8/4/2020,Alan Safran,Imported from Bank of America Visa-Background checks for fellows,,HJ,,4.89,-140766.32
2032,8/4/2020,8/4/2020,Alan Safran,Imported from Bank of America Visa-Background checks for fellows,,HJ,,4.89,-140771.21
2032,8/4/2020,8/4/2020,Alan Safran,Imported from Bank of America Visa-Background checks for fellows,,HJ,,4.89,-140776.1
2032,8/4/2020,8/4/2020,Alan Safran,Imported from Bank of America Visa-Background checks for fellows,,HJ,,4.89,-140780.99
2032,8/4/2020,8/4/2020,Alan Safran,Imported from Bank of America Visa-Background checks for fellows,,HJ,,4.89,-140785.88
2032,8/4/2020,8/4/2020,Alan Safran,Imported from Bank of America Visa-Background checks for fellows,,HJ,,4.89,-140790.77
2032,8/4/2020,8/4/2020,Alan Safran,Imported from Bank of America Visa-Background checks for fellows,,HJ,,4.89,-140795.66
2032,8/4/2020,8/4/2020,Alan Safran,Imported from Bank of America Visa-Background checks for fellows,,HJ,,4.89,-140800.55
2032,8/4/2020,8/4/2020,Alan Safran,Imported from Bank of America Visa-Background checks for fellows,,HJ,,4.89,-140805.44
2032,8/4/2020,8/4/2020,Alan Safran,Imported from Bank of America Visa-Background checks for fellows,,HJ,,4.89,-140810.33
2032,8/4/2020,8/4/2020,Alan Safran,Imported from Bank of America Visa-Background checks for fellows,,HJ,,4.89,-140815.22
2032,8/4/2020,8/4/2020,Alan Safran,Imported from Bank of America Visa-Background checks for fellows,,HJ,,4.89,-140820.11
2032,8/4/2020,8/4/2020,Alan Safran,Imported from Bank of America Visa-Background checks for fellows,,HJ,,4.89,-140825
2032,8/4/2020,8/4/2020,Alan Safran,Imported from Bank of America Visa-Background checks for fellows,,HJ,,4.89,-140829.89
2032,8/4/2020,8/4/2020,Alan Safran,Imported from Bank of America Visa-Background checks for fellows,,HJ,,4.89,-140834.78
2032,8/4/2020,8/4/2020,Alan Safran,Imported from Bank of America Visa-Background checks for fellows,,HJ,,5.41,-140840.19
2032,8/4/2020,8/4/2020,Alan Safran,Imported from Bank of America Visa-Background checks for fellows,,HJ,,5.56,-140845.75
2032,8/4/2020,8/4/2020,Alan Safran,Imported from Bank of America Visa-Background checks for fellows,,HJ,,5.56,-140851.31
2032,8/4/2020,8/4/2020,Alan Safran,Imported from Bank of America Visa-Background checks for fellows,,HJ,,6.2,-140857.51
2032,8/4/2020,8/4/2020,Alan Safran,Imported from Bank of America Visa-Background checks for fellows,,HJ,,6.21,-140863.72
2032,8/4/2020,8/4/2020,Alan Safran,Imported from Bank of America Visa-Background checks for fellows,,HJ,,8.36,-140872.08
2032,8/4/2020,8/4/2020,Alan Safran,Imported from Bank of America Visa-Background checks for fellows,,HJ,,8.36,-140880.44
2032,8/4/2020,8/4/2020,Alan Safran,Imported from Bank of America Visa-Background checks for fellows,,HJ,,8.58,-140889.02
2032,8/4/2020,8/4/2020,Alan Safran,Imported from Bank of America Visa-Background checks for fellows,,HJ,,8.58,-140897.6
2032,8/4/2020,8/4/2020,Alan Safran,Imported from Bank of America Visa-Background checks for fellows,,HJ,,8.59,-140906.19
2032,8/4/2020,8/4/2020,Alan Safran,Imported from Bank of America Visa-Background checks for fellows,,HJ,,8.59,-140914.78
2032,8/4/2020,8/4/2020,Alan Safran,Imported from Bank of America Visa-Background checks for fellows,,HJ,,13.48,-140928.26
2032,8/4/2020,8/4/2020,Alan Safran,Imported from Bank of America Visa-Background checks for fellows,,HJ,,13.48,-140941.74
2032,8/4/2020,8/4/2020,Alan Safran,Imported from Bank of America Visa-Background checks for fellows,,HJ,,15.81,-140957.55
2032,8/4/2020,8/4/2020,Alan Safran,Imported from Bank of America Visa-Background checks for fellows,,HJ,,15.81,-140973.36
2032,8/4/2020,8/4/2020,Alan Safran,Imported from Bank of America Visa-Background checks for fellows,,HJ,,15.81,-140989.17
2032,8/4/2020,8/4/2020,Alan Safran,Imported from Bank of America Visa-Background checks for fellows,,HJ,,15.81,-141004.98
2032,8/4/2020,8/4/2020,Alan Safran,Imported from Bank of America Visa-Background checks for fellows,,HJ,,15.81,-141020.79
2032,8/4/2020,8/4/2020,Alan Safran,Imported from Bank of America Visa-Background checks for fellows,,HJ,,15.81,-141036.6
2032,8/4/2020,8/4/2020,Alan Safran,Imported from Bank of America Visa-Background checks for fellows,,HJ,,15.81,-141052.41
2032,8/4/2020,8/4/2020,Alan Safran,Imported from Bank of America Visa-Background checks for fellows,,HJ,,15.81,-141068.22
2032,8/4/2020,8/4/2020,Alan Safran,Imported from Bank of America Visa-Background checks for fellows,,HJ,,16.72,-141084.94
2032,8/4/2020,8/4/2020,Alan Safran,Imported from Bank of America Visa-Background checks for fellows,,HJ,,20.07,-141105.01
2032,8/4/2020,8/4/2020,Alan Safran,Imported from Bank of America Visa-Background checks for fellows,,HJ,,20.82,-141125.83
2032,8/4/2020,8/4/2020,Alan Safran,Imported from Bank of America Visa-Background checks for fellows,,HJ,,20.82,-141146.65
2032,8/4/2020,8/4/2020,Alan Safran,Imported from Bank of America Visa-Background checks for fellows,,HJ,,20.83,-141167.48
2032,8/4/2020,8/4/2020,Alan Safran,Imported from Bank of America Visa-Background checks for fellows,,HJ,,20.83,-141188.31
2032,8/4/2020,8/4/2020,Alan Safran,Imported from Bank of America Visa-Background checks for fellows,,HJ,,25.84,-141214.15
2032,8/4/2020,8/4/2020,Alan Safran,Imported from Bank of America Visa-Background checks for fellows,,HJ,,25.84,-141239.99
2032,8/4/2020,8/4/2020,Alan Safran,Imported from Bank of America Visa-Background checks for fellows,,HJ,,27.02,-141267.01
2032,8/4/2020,8/4/2020,Alan Safran,Imported from Bank of America Visa-Background checks for fellows,,HJ,,27.77,-141294.78
2032,8/4/2020,8/4/2020,Alan Safran,Imported from Bank of America Visa-Background checks for fellows,,HJ,,27.77,-141322.55
2032,8/4/2020,8/4/2020,Alan Safran,Imported from Bank of America Visa-Background checks for fellows,,HJ,,67.37,-141389.92
2032,8/4/2020,8/4/2020,Alan Safran,Imported from Bank of America Visa-Background checks for fellows,,HJ,,67.37,-141457.29
2032,8/4/2020,8/4/2020,Alan Safran,Imported from Bank of America Visa-Background checks for fellows,,HJ,,83.6,-141540.89
2032,8/4/2020,8/4/2020,Antonio Gutierrez,Imported from Bank of America Visa-Fellow Recruitment,,HJ,,900,-142440.89
2032,8/4/2020,8/4/2020,Antonio Gutierrez,Imported from Bank of America Visa-Fellow Recruitment,,HJ,,900,-143340.89
2032,8/4/2020,8/4/2020,Bank of America VISA,BofA CC Transaction July Payment-BofA CC Transaction July Payment,,HJ,1400.64,,-141940.25
2032,8/4/2020,8/4/2020,Bank of America VISA,BofA CC Transaction July Payment-BofA CC Transaction July Payment,,HJ,8936.48,,-133003.77
2032,8/4/2020,8/4/2020,Bank of America VISA,BofA CC Transaction July Payment-BofA CC Transaction July Payment,,HJ,14947.66,,-118056.11
2032,8/4/2020,8/4/2020,Bank of America VISA,BofA CC Transaction July Payment-BofA CC Transaction July Payment,,HJ,17964.49,,-100091.62
2032,8/4/2020,8/4/2020,Bank of America VISA,BofA CC Transaction July Payment-BofA CC Transaction July Payment,,HJ,31179.64,,-68911.98
2032,8/4/2020,8/4/2020,Bank of America VISA,BofA CC Transaction July Payment-BofA CC Transaction July Payment,,HJ,40118.07,,-28793.91
2032,8/4/2020,8/4/2020,Chris D PLACEHOLDER,Imported from Bank of America Visa-Office supplies for Nicole Prahin,,HJ,,95.74,-28889.65
2032,8/4/2020,8/4/2020,Elizabeth Peinado,Imported from Bank of America Visa-Fellow Staff advertising. Brand Awareness,,HJ,,56.86,-28946.51
2032,8/4/2020,8/4/2020,Elizabeth Peinado,Imported from Bank of America Visa-Fellow Staff advertising. Brand Awareness,,HJ,,87.88,-29034.39
2032,8/4/2020,8/4/2020,Elizabeth Peinado,Imported from Bank of America Visa-Fellow Staff advertising. Brand Awareness,,HJ,,87.88,-29122.27
2032,8/4/2020,8/4/2020,Elizabeth Peinado,Imported from Bank of America Visa-Fellow Staff advertising. Brand Awareness,,HJ,,284.3,-29406.57
2032,8/4/2020,8/4/2020,Joseph Zarate,Imported from Bank of America Visa-Equipment for new hire,,HJ,,258.99,-29665.56
2032,8/4/2020,8/4/2020,Joseph Zarate,Imported from Bank of America Visa-Equipment for new hire,,HJ,,258.99,-29924.55
2032,8/4/2020,8/4/2020,Joseph Zarate,Imported from Bank of America Visa-Equipment for new hire,,HJ,,258.99,-30183.54
2032,8/4/2020,8/4/2020,Joseph Zarate,Imported from Bank of America Visa-Equipment for new hire,,HJ,,258.99,-30442.53
2032,8/4/2020,8/4/2020,Joseph Zarate,Imported from Bank of America Visa-Equipment for new hire,,HJ,,276.15,-30718.68
2032,8/4/2020,8/4/2020,Joseph Zarate,Imported from Bank of America Visa-New hire equipment,,HJ,,258.99,-30977.67
2032,8/4/2020,8/4/2020,Joseph Zarate,Imported from Bank of America Visa-New hire equipment,,HJ,,258.99,-31236.66
2032,8/4/2020,8/4/2020,Joseph Zarate,Imported from Bank of America Visa-shipping,,HJ,,77.9,-31314.56
2032,8/5/2020,8/5/2020,Alan Safran,Imported from Bank of America Visa-Background checks for fellows,,HJ,,2.92,-31317.48
2032,8/5/2020,8/5/2020,Alan Safran,Imported from Bank of America Visa-Background checks for fellows,,HJ,,3.16,-31320.64
2032,8/5/2020,8/5/2020,Alan Safran,Imported from Bank of America Visa-Background checks for fellows,,HJ,,3.16,-31323.8
2032,8/5/2020,8/5/2020,Alan Safran,Imported from Bank of America Visa-Background checks for fellows,,HJ,,3.16,-31326.96
2032,8/5/2020,8/5/2020,Alan Safran,Imported from Bank of America Visa-Background checks for fellows,,HJ,,3.16,-31330.12
2032,8/5/2020,8/5/2020,Alan Safran,Imported from Bank of America Visa-Background checks for fellows,,HJ,,3.16,-31333.28
2032,8/5/2020,8/5/2020,Alan Safran,Imported from Bank of America Visa-Background checks for fellows,,HJ,,3.16,-31336.44
2032,8/5/2020,8/5/2020,Alan Safran,Imported from Bank of America Visa-Background checks for fellows,,HJ,,4.02,-31340.46
2032,8/5/2020,8/5/2020,Alan Safran,Imported from Bank of America Visa-Background checks for fellows,,HJ,,4.5,-31344.96
2032,8/5/2020,8/5/2020,Alan Safran,Imported from Bank of America Visa-Background checks for fellows,,HJ,,4.51,-31349.47
2032,8/5/2020,8/5/2020,Alan Safran,Imported from Bank of America Visa-Background checks for fellows,,HJ,,4.89,-31354.36
2032,8/5/2020,8/5/2020,Alan Safran,Imported from Bank of America Visa-Background checks for fellows,,HJ,,4.89,-31359.25
2032,8/5/2020,8/5/2020,Alan Safran,Imported from Bank of America Visa-Background checks for fellows,,HJ,,4.89,-31364.14
2032,8/5/2020,8/5/2020,Alan Safran,Imported from Bank of America Visa-Background checks for fellows,,HJ,,4.89,-31369.03
2032,8/5/2020,8/5/2020,Alan Safran,Imported from Bank of America Visa-Background checks for fellows,,HJ,,4.89,-31373.92
2032,8/5/2020,8/5/2020,Alan Safran,Imported from Bank of America Visa-Background checks for fellows,,HJ,,4.89,-31378.81
2032,8/5/2020,8/5/2020,Alan Safran,Imported from Bank of America Visa-Background checks for fellows,,HJ,,4.89,-31383.7
2032,8/5/2020,8/5/2020,Alan Safran,Imported from Bank of America Visa-Background checks for fellows,,HJ,,4.89,-31388.59
2032,8/5/2020,8/5/2020,Alan Safran,Imported from Bank of America Visa-Background checks for fellows,,HJ,,4.89,-31393.48
2032,8/5/2020,8/5/2020,Alan Safran,Imported from Bank of America Visa-Background checks for fellows,,HJ,,4.89,-31398.37
2032,8/5/2020,8/5/2020,Alan Safran,Imported from Bank of America Visa-Background checks for fellows,,HJ,,4.89,-31403.26
2032,8/5/2020,8/5/2020,Alan Safran,Imported from Bank of America Visa-Background checks for fellows,,HJ,,4.89,-31408.15
2032,8/5/2020,8/5/2020,Alan Safran,Imported from Bank of America Visa-Background checks for fellows,,HJ,,6.2,-31414.35
2032,8/5/2020,8/5/2020,Alan Safran,Imported from Bank of America Visa-Background checks for fellows,,HJ,,6.21,-31420.56
2032,8/5/2020,8/5/2020,Alan Safran,Imported from Bank of America Visa-Background checks for fellows,,HJ,,14.57,-31435.13
2032,8/5/2020,8/5/2020,Alan Safran,Imported from Bank of America Visa-Background checks for fellows,,HJ,,15.62,-31450.75
2032,8/5/2020,8/5/2020,Alan Safran,Imported from Bank of America Visa-Background checks for fellows,,HJ,,15.81,-31466.56
2032,8/5/2020,8/5/2020,Alan Safran,Imported from Bank of America Visa-Background checks for fellows,,HJ,,15.81,-31482.37
2032,8/5/2020,8/5/2020,Alan Safran,Imported from Bank of America Visa-Background checks for fellows,,HJ,,15.81,-31498.18
2032,8/5/2020,8/5/2020,Alan Safran,Imported from Bank of America Visa-Background checks for fellows,,HJ,,15.81,-31513.99
2032,8/5/2020,8/5/2020,Alan Safran,Imported from Bank of America Visa-Background checks for fellows,,HJ,,15.81,-31529.8
2032,8/5/2020,8/5/2020,Alan Safran,Imported from Bank of America Visa-Background checks for fellows,,HJ,,15.81,-31545.61
2032,8/5/2020,8/5/2020,Alan Safran,Imported from Bank of America Visa-Background checks for fellows,,HJ,,20.07,-31565.68
2032,8/5/2020,8/5/2020,Alan Safran,Imported from Bank of America Visa-Background checks for fellows,,HJ,,24.14,-31589.82
2032,8/5/2020,8/5/2020,Alan Safran,Imported from Bank of America Visa-Background checks for fellows,,HJ,,24.14,-31613.96
2032,8/5/2020,8/5/2020,Alan Safran,Imported from Bank of America Visa-Background checks for fellows,,HJ,,78.1,-31692.06
2032,8/5/2020,8/5/2020,Alan Safran,Imported from Bank of America Visa-Extra google storage for Alan,,HJ,,1.99,-31694.05
2032,8/5/2020,8/5/2020,Antonio Gutierrez,Imported from Bank of America Visa-Fellow Recruitment,,HJ,,900,-32594.05
2032,8/5/2020,8/5/2020,Elizabeth Peinado,Imported from Bank of America Visa-Fellow Staff advertising. Brand Awareness,,HJ,,21.48,-32615.53
2032,8/5/2020,8/5/2020,Elizabeth Peinado,Imported from Bank of America Visa-Fellow Staff advertising. Brand Awareness,,HJ,,33.19,-32648.72
2032,8/5/2020,8/5/2020,Elizabeth Peinado,Imported from Bank of America Visa-Fellow Staff advertising. Brand Awareness,,HJ,,33.19,-32681.91
2032,8/5/2020,8/5/2020,Elizabeth Peinado,Imported from Bank of America Visa-Fellow Staff advertising. Brand Awareness,,HJ,,107.38,-32789.29
2032,8/5/2020,8/5/2020,Jennifer Winans,Imported from Bank of America Visa-Chicago Fellow Flight,,HJ,,78.1,-32867.39
2032,8/5/2020,8/5/2020,Joseph Zarate,Imported from Bank of America Visa-Equipment,,HJ,,36.99,-32904.38
2032,8/5/2020,8/5/2020,Joseph Zarate,Imported from Bank of America Visa-New hire equipment,,HJ,,174.89,-33079.27
2032,8/5/2020,8/5/2020,Joseph Zarate,Imported from Bank of America Visa-New hire equipment,,HJ,,200.59,-33279.86
2032,8/5/2020,8/5/2020,Joseph Zarate,Imported from Bank of America Visa-New hire equipment,,HJ,,244,-33523.86
2032,8/5/2020,8/5/2020,Joseph Zarate,Imported from Bank of America Visa-New hire equipment,,HJ,,244,-33767.86
2032,8/5/2020,8/5/2020,Joseph Zarate,Imported from Bank of America Visa-New hire equipment,,HJ,,244,-34011.86
2032,8/5/2020,8/5/2020,Joseph Zarate,Imported from Bank of America Visa-New hire equipment,,HJ,,264.99,-34276.85
2032,8/5/2020,8/5/2020,Mahaliah Sejour,Imported from Bank of America Visa-book,,HJ,,11.39,-34288.24
2032,8/5/2020,8/5/2020,Nicole Prahin,Imported from Bank of America Visa-Mailed Melissa & Claice X Co.  swag,,HJ,,32.08,-34320.32
2032,8/6/2020,8/6/2020,Alan Safran,Imported from Bank of America Visa-Background checks for fellows,,HJ,,3.16,-34323.48
2032,8/6/2020,8/6/2020,Alan Safran,Imported from Bank of America Visa-Background checks for fellows,,HJ,,3.16,-34326.64
2032,8/6/2020,8/6/2020,Alan Safran,Imported from Bank of America Visa-Background checks for fellows,,HJ,,4.02,-34330.66
2032,8/6/2020,8/6/2020,Alan Safran,Imported from Bank of America Visa-Background checks for fellows,,HJ,,4.02,-34334.68
2032,8/6/2020,8/6/2020,Alan Safran,Imported from Bank of America Visa-Background checks for fellows,,HJ,,4.89,-34339.57
2032,8/6/2020,8/6/2020,Alan Safran,Imported from Bank of America Visa-Background checks for fellows,,HJ,,4.89,-34344.46
2032,8/6/2020,8/6/2020,Alan Safran,Imported from Bank of America Visa-Background checks for fellows,,HJ,,4.89,-34349.35
2032,8/6/2020,8/6/2020,Alan Safran,Imported from Bank of America Visa-Background checks for fellows,,HJ,,4.89,-34354.24
2032,8/6/2020,8/6/2020,Alan Safran,Imported from Bank of America Visa-Background checks for fellows,,HJ,,5.56,-34359.8
2032,8/6/2020,8/6/2020,Alan Safran,Imported from Bank of America Visa-Background checks for fellows,,HJ,,5.56,-34365.36
2032,8/6/2020,8/6/2020,Alan Safran,Imported from Bank of America Visa-Background checks for fellows,,HJ,,6.2,-34371.56
2032,8/6/2020,8/6/2020,Alan Safran,Imported from Bank of America Visa-Background checks for fellows,,HJ,,6.2,-34377.76
2032,8/6/2020,8/6/2020,Alan Safran,Imported from Bank of America Visa-Background checks for fellows,,HJ,,6.21,-34383.97
2032,8/6/2020,8/6/2020,Alan Safran,Imported from Bank of America Visa-Background checks for fellows,,HJ,,6.21,-34390.18
2032,8/6/2020,8/6/2020,Alan Safran,Imported from Bank of America Visa-Background checks for fellows,,HJ,,7.81,-34397.99
2032,8/6/2020,8/6/2020,Alan Safran,Imported from Bank of America Visa-Background checks for fellows,,HJ,,8.58,-34406.57
2032,8/6/2020,8/6/2020,Alan Safran,Imported from Bank of America Visa-Background checks for fellows,,HJ,,8.58,-34415.15
2032,8/6/2020,8/6/2020,Alan Safran,Imported from Bank of America Visa-Background checks for fellows,,HJ,,8.59,-34423.74
2032,8/6/2020,8/6/2020,Alan Safran,Imported from Bank of America Visa-Background checks for fellows,,HJ,,8.59,-34432.33
2032,8/6/2020,8/6/2020,Alan Safran,Imported from Bank of America Visa-Background checks for fellows,,HJ,,12.07,-34444.4
2032,8/6/2020,8/6/2020,Alan Safran,Imported from Bank of America Visa-Background checks for fellows,,HJ,,12.07,-34456.47
2032,8/6/2020,8/6/2020,Alan Safran,Imported from Bank of America Visa-Background checks for fellows,,HJ,,13.48,-34469.95
2032,8/6/2020,8/6/2020,Alan Safran,Imported from Bank of America Visa-Background checks for fellows,,HJ,,15.81,-34485.76
2032,8/6/2020,8/6/2020,Alan Safran,Imported from Bank of America Visa-Background checks for fellows,,HJ,,15.81,-34501.57
2032,8/6/2020,8/6/2020,Alan Safran,Imported from Bank of America Visa-Background checks for fellows,,HJ,,20.07,-34521.64
2032,8/6/2020,8/6/2020,Alan Safran,Imported from Bank of America Visa-Background checks for fellows,,HJ,,20.07,-34541.71
2032,8/6/2020,8/6/2020,Alan Safran,Imported from Bank of America Visa-Background checks for fellows,,HJ,,20.82,-34562.53
2032,8/6/2020,8/6/2020,Alan Safran,Imported from Bank of America Visa-Background checks for fellows,,HJ,,20.83,-34583.36
2032,8/6/2020,8/6/2020,Alan Safran,Imported from Bank of America Visa-Background checks for fellows,,HJ,,27.77,-34611.13
2032,8/6/2020,8/6/2020,Alan Safran,Imported from Bank of America Visa-Background checks for fellows,,HJ,,27.77,-34638.9
2032,8/6/2020,8/6/2020,Alan Safran,Imported from Bank of America Visa-Background checks for fellows,,HJ,,39.05,-34677.95
2032,8/6/2020,8/6/2020,Alan Safran,Imported from Bank of America Visa-Background checks for fellows,,HJ,,67.37,-34745.32
2032,8/6/2020,8/6/2020,Elizabeth Peinado,Imported from Bank of America Visa-Fellow Staff advertising. Brand Awareness,,HJ,,40.22,-34785.54
2032,8/6/2020,8/6/2020,Elizabeth Peinado,Imported from Bank of America Visa-Fellow Staff advertising. Brand Awareness,,HJ,,62.16,-34847.7
2032,8/6/2020,8/6/2020,Elizabeth Peinado,Imported from Bank of America Visa-Fellow Staff advertising. Brand Awareness,,HJ,,62.16,-34909.86
2032,8/6/2020,8/6/2020,Elizabeth Peinado,Imported from Bank of America Visa-Fellow Staff advertising. Brand Awareness,,HJ,,201.08,-35110.94
2032,8/6/2020,8/6/2020,Jennifer Winans,Imported from Bank of America Visa-Chicago Fellow Uhaul,,HJ,,1000,-36110.94
2032,8/6/2020,8/6/2020,Joseph Zarate,Imported from Bank of America Visa-New hire equipment,,HJ,,75.25,-36186.19
2032,8/6/2020,8/6/2020,Joseph Zarate,Imported from Bank of America Visa-New hire equipment,,HJ,,221.04,-36407.23
2032,8/6/2020,8/6/2020,Joseph Zarate,Imported from Bank of America Visa-New hire equipment,,HJ,,249,-36656.23
2032,8/6/2020,8/6/2020,Joseph Zarate,Imported from Bank of America Visa-New hire equipment,,HJ,,253.73,-36909.96
2032,8/6/2020,8/6/2020,Joseph Zarate,Imported from Bank of America Visa-New hire equipment,,HJ,,255,-37164.96
2032,8/6/2020,8/6/2020,Joseph Zarate,Imported from Bank of America Visa-New hire equipment,,HJ,,266.43,-37431.39
2032,8/6/2020,8/6/2020,Joseph Zarate,Imported from Bank of America Visa-New hire equipment,,HJ,,269.54,-37700.93
2032,8/7/2020,8/7/2020,Alan Safran,Imported from Bank of America Visa-Background checks for fellows,,HJ,,3.16,-37704.09
2032,8/7/2020,8/7/2020,Alan Safran,Imported from Bank of America Visa-Background checks for fellows,,HJ,,3.16,-37707.25
2032,8/7/2020,8/7/2020,Alan Safran,Imported from Bank of America Visa-Background checks for fellows,,HJ,,3.16,-37710.41
2032,8/7/2020,8/7/2020,Alan Safran,Imported from Bank of America Visa-Background checks for fellows,,HJ,,4.02,-37714.43
2032,8/7/2020,8/7/2020,Alan Safran,Imported from Bank of America Visa-Background checks for fellows,,HJ,,4.02,-37718.45
2032,8/7/2020,8/7/2020,Alan Safran,Imported from Bank of America Visa-Background checks for fellows,,HJ,,4.02,-37722.47
2032,8/7/2020,8/7/2020,Alan Safran,Imported from Bank of America Visa-Background checks for fellows,,HJ,,4.02,-37726.49
2032,8/7/2020,8/7/2020,Alan Safran,Imported from Bank of America Visa-Background checks for fellows,,HJ,,4.02,-37730.51
2032,8/7/2020,8/7/2020,Alan Safran,Imported from Bank of America Visa-Background checks for fellows,,HJ,,4.89,-37735.4
2032,8/7/2020,8/7/2020,Alan Safran,Imported from Bank of America Visa-Background checks for fellows,,HJ,,4.89,-37740.29
2032,8/7/2020,8/7/2020,Alan Safran,Imported from Bank of America Visa-Background checks for fellows,,HJ,,4.89,-37745.18
2032,8/7/2020,8/7/2020,Alan Safran,Imported from Bank of America Visa-Background checks for fellows,,HJ,,4.89,-37750.07
2032,8/7/2020,8/7/2020,Alan Safran,Imported from Bank of America Visa-Background checks for fellows,,HJ,,4.89,-37754.96
2032,8/7/2020,8/7/2020,Alan Safran,Imported from Bank of America Visa-Background checks for fellows,,HJ,,4.89,-37759.85
2032,8/7/2020,8/7/2020,Alan Safran,Imported from Bank of America Visa-Background checks for fellows,,HJ,,6.2,-37766.05
2032,8/7/2020,8/7/2020,Alan Safran,Imported from Bank of America Visa-Background checks for fellows,,HJ,,6.2,-37772.25
2032,8/7/2020,8/7/2020,Alan Safran,Imported from Bank of America Visa-Background checks for fellows,,HJ,,6.2,-37778.45
2032,8/7/2020,8/7/2020,Alan Safran,Imported from Bank of America Visa-Background checks for fellows,,HJ,,6.2,-37784.65
2032,8/7/2020,8/7/2020,Alan Safran,Imported from Bank of America Visa-Background checks for fellows,,HJ,,6.2,-37790.85
2032,8/7/2020,8/7/2020,Alan Safran,Imported from Bank of America Visa-Background checks for fellows,,HJ,,6.21,-37797.06
2032,8/7/2020,8/7/2020,Alan Safran,Imported from Bank of America Visa-Background checks for fellows,,HJ,,6.21,-37803.27
2032,8/7/2020,8/7/2020,Alan Safran,Imported from Bank of America Visa-Background checks for fellows,,HJ,,6.21,-37809.48
2032,8/7/2020,8/7/2020,Alan Safran,Imported from Bank of America Visa-Background checks for fellows,,HJ,,6.21,-37815.69
2032,8/7/2020,8/7/2020,Alan Safran,Imported from Bank of America Visa-Background checks for fellows,,HJ,,6.21,-37821.9
2032,8/7/2020,8/7/2020,Alan Safran,Imported from Bank of America Visa-Background checks for fellows,,HJ,,6.38,-37828.28
2032,8/7/2020,8/7/2020,Alan Safran,Imported from Bank of America Visa-Background checks for fellows,,HJ,,9.86,-37838.14
2032,8/7/2020,8/7/2020,Alan Safran,Imported from Bank of America Visa-Background checks for fellows,,HJ,,9.86,-37848
2032,8/7/2020,8/7/2020,Alan Safran,Imported from Bank of America Visa-Background checks for fellows,,HJ,,15.81,-37863.81
2032,8/7/2020,8/7/2020,Alan Safran,Imported from Bank of America Visa-Background checks for fellows,,HJ,,15.81,-37879.62
2032,8/7/2020,8/7/2020,Alan Safran,Imported from Bank of America Visa-Background checks for fellows,,HJ,,15.81,-37895.43
2032,8/7/2020,8/7/2020,Alan Safran,Imported from Bank of America Visa-Background checks for fellows,,HJ,,20.07,-37915.5
2032,8/7/2020,8/7/2020,Alan Safran,Imported from Bank of America Visa-Background checks for fellows,,HJ,,20.07,-37935.57
2032,8/7/2020,8/7/2020,Alan Safran,Imported from Bank of America Visa-Background checks for fellows,,HJ,,20.07,-37955.64
2032,8/7/2020,8/7/2020,Alan Safran,Imported from Bank of America Visa-Background checks for fellows,,HJ,,20.07,-37975.71
2032,8/7/2020,8/7/2020,Alan Safran,Imported from Bank of America Visa-Background checks for fellows,,HJ,,20.07,-37995.78
2032,8/7/2020,8/7/2020,Alan Safran,Imported from Bank of America Visa-Background checks for fellows,,HJ,,31.9,-38027.68
2032,8/7/2020,8/7/2020,Joseph Zarate,Imported from Bank of America Visa-New hire equipment,,HJ,,44.08,-38071.76
2032,8/7/2020,8/7/2020,Joseph Zarate,Imported from Bank of America Visa-New hire equipment,,HJ,,264.99,-38336.75
2032,8/7/2020,8/7/2020,Joseph Zarate,Imported from Bank of America Visa-New hire equipment,,HJ,,289.76,-38626.51
2032,8/7/2020,8/7/2020,Joseph Zarate,Imported from Bank of America Visa-New hire equipment,,HJ,,295.97,-38922.48
2032,8/7/2020,8/7/2020,Monivett Acevedo,Imported from Bank of America Visa-office headsey,,HJ,,26.74,-38949.22
2032,8/7/2020,8/7/2020,Myesha Hossain,Imported from Bank of America Visa-Fellow Belongings,,HJ,,42.29,-38991.51
2032,8/7/2020,8/7/2020,Myesha Hossain,Imported from Bank of America Visa-Mail out Fellow belongings,,HJ,,45.89,-39037.4
2032,8/8/2020,8/8/2020,Alan Safran,Imported from Bank of America Visa-Background checks for fellows,,HJ,,3.16,-39040.56
2032,8/8/2020,8/8/2020,Alan Safran,Imported from Bank of America Visa-Background checks for fellows,,HJ,,3.16,-39043.72
2032,8/8/2020,8/8/2020,Alan Safran,Imported from Bank of America Visa-Background checks for fellows,,HJ,,4.89,-39048.61
2032,8/8/2020,8/8/2020,Alan Safran,Imported from Bank of America Visa-Background checks for fellows,,HJ,,4.89,-39053.5
2032,8/8/2020,8/8/2020,Alan Safran,Imported from Bank of America Visa-Background checks for fellows,,HJ,,4.89,-39058.39
2032,8/8/2020,8/8/2020,Alan Safran,Imported from Bank of America Visa-Background checks for fellows,,HJ,,4.89,-39063.28
2032,8/8/2020,8/8/2020,Alan Safran,Imported from Bank of America Visa-Background checks for fellows,,HJ,,13.48,-39076.76
2032,8/8/2020,8/8/2020,Alan Safran,Imported from Bank of America Visa-Background checks for fellows,,HJ,,15.62,-39092.38
2032,8/8/2020,8/8/2020,Alan Safran,Imported from Bank of America Visa-Background checks for fellows,,HJ,,15.81,-39108.19
2032,8/8/2020,8/8/2020,Alan Safran,Imported from Bank of America Visa-Background checks for fellows,,HJ,,15.81,-39124
2032,8/8/2020,8/8/2020,Alan Safran,Imported from Bank of America Visa-Background checks for fellows,,HJ,,20.82,-39144.82
2032,8/8/2020,8/8/2020,Alan Safran,Imported from Bank of America Visa-Background checks for fellows,,HJ,,20.83,-39165.65
2032,8/8/2020,8/8/2020,Alan Safran,Imported from Bank of America Visa-Background checks for fellows,,HJ,,24.14,-39189.79
2032,8/8/2020,8/8/2020,Alan Safran,Imported from Bank of America Visa-Background checks for fellows,,HJ,,24.14,-39213.93
2032,8/8/2020,8/8/2020,Alan Safran,Imported from Bank of America Visa-Background checks for fellows,,HJ,,67.37,-39281.3
2032,8/8/2020,8/8/2020,Alan Safran,Imported from Bank of America Visa-Background checks for fellows,,HJ,,78.1,-39359.4
2032,8/8/2020,8/8/2020,Chris D PLACEHOLDER,Imported from Bank of America Visa-Book for Team PD,,HJ,,11.68,-39371.08
2032,8/8/2020,8/8/2020,Chris D PLACEHOLDER,Imported from Bank of America Visa-Book prize sent to employee,,HJ,,15.65,-39386.73
2032,8/8/2020,8/8/2020,Elizabeth Peinado,Imported from Bank of America Visa-New hire packages,,HJ,,6.52,-39393.25
2032,8/8/2020,8/8/2020,Elizabeth Peinado,Imported from Bank of America Visa-New hire packages,,HJ,,10.07,-39403.32
2032,8/8/2020,8/8/2020,Elizabeth Peinado,Imported from Bank of America Visa-New hire packages,,HJ,,10.07,-39413.39
2032,8/8/2020,8/8/2020,Elizabeth Peinado,Imported from Bank of America Visa-New hire packages,,HJ,,32.59,-39445.98
2032,8/8/2020,8/8/2020,Joseph Zarate,Imported from Bank of America Visa-New hire equipment,,HJ,,9.89,-39455.87
2032,8/8/2020,8/8/2020,Joseph Zarate,Imported from Bank of America Visa-New hire equipment,,HJ,,10.68,-39466.55
2032,8/8/2020,8/8/2020,Joseph Zarate,Imported from Bank of America Visa-New hire equipment,,HJ,,260,-39726.55
2032,8/8/2020,8/8/2020,Joseph Zarate,Imported from Bank of America Visa-New hire equipment,,HJ,,260,-39986.55
2032,8/8/2020,8/8/2020,Joseph Zarate,Imported from Bank of America Visa-New hire equipment,,HJ,,264.99,-40251.54
2032,8/8/2020,8/8/2020,Joseph Zarate,Imported from Bank of America Visa-New hire equipment,,HJ,,264.99,-40516.53
2032,8/8/2020,8/8/2020,Joseph Zarate,Imported from Bank of America Visa-New hire equipment,,HJ,,264.99,-40781.52
2032,8/8/2020,8/8/2020,Joseph Zarate,Imported from Bank of America Visa-New hire equipment,,HJ,,281.82,-41063.34
2032,8/8/2020,8/8/2020,Joseph Zarate,Imported from Bank of America Visa-New hire equipment,,HJ,,284.07,-41347.41
2032,8/8/2020,8/8/2020,Joseph Zarate,Imported from Bank of America Visa-New hire equipment,,HJ,,295.74,-41643.15
2032,8/8/2020,8/8/2020,Joseph Zarate,Imported from Bank of America Visa-equipment,,HJ,,88.89,-41732.04
2032,8/8/2020,8/8/2020,Joseph Zarate,Imported from Bank of America Visa-returns,,HJ,,22.8,-41754.84
2032,8/8/2020,8/8/2020,Mahaliah Sejour,Imported from Bank of America Visa-Fellows gifts,,HJ,,19.49,-41774.33
2032,8/8/2020,8/8/2020,Mahaliah Sejour,Imported from Bank of America Visa-harlan printer,,HJ,,5.35,-41779.68
2032,8/8/2020,8/8/2020,Monivett Acevedo,Imported from Bank of America Visa-Accounts payable invoice,,HJ,,195.26,-41974.94
2032,8/8/2020,8/8/2020,Monivett Acevedo,Imported from Bank of America Visa-Adobe,,HJ,,14.99,-41989.93
2032,8/8/2020,8/8/2020,Monivett Acevedo,Imported from Bank of America Visa-Office Supplies,,HJ,,10.61,-42000.54
2032,8/8/2020,8/8/2020,Myesha Hossain,Imported from Bank of America Visa-Fellow Training,,HJ,,15.49,-42016.03
2032,8/9/2020,8/9/2020,Alan Safran,Imported from Bank of America Visa-Background checks for fellows,,HJ,,3.16,-42019.19
2032,8/9/2020,8/9/2020,Alan Safran,Imported from Bank of America Visa-Background checks for fellows,,HJ,,3.16,-42022.35
2032,8/9/2020,8/9/2020,Alan Safran,Imported from Bank of America Visa-Background checks for fellows,,HJ,,3.16,-42025.51
2032,8/9/2020,8/9/2020,Alan Safran,Imported from Bank of America Visa-Background checks for fellows,,HJ,,4.89,-42030.4
2032,8/9/2020,8/9/2020,Alan Safran,Imported from Bank of America Visa-Background checks for fellows,,HJ,,4.89,-42035.29
2032,8/9/2020,8/9/2020,Alan Safran,Imported from Bank of America Visa-Background checks for fellows,,HJ,,4.89,-42040.18
2032,8/9/2020,8/9/2020,Alan Safran,Imported from Bank of America Visa-Background checks for fellows,,HJ,,4.89,-42045.07
2032,8/9/2020,8/9/2020,Alan Safran,Imported from Bank of America Visa-Background checks for fellows,,HJ,,4.89,-42049.96
2032,8/9/2020,8/9/2020,Alan Safran,Imported from Bank of America Visa-Background checks for fellows,,HJ,,4.89,-42054.85
2032,8/9/2020,8/9/2020,Alan Safran,Imported from Bank of America Visa-Background checks for fellows,,HJ,,5.56,-42060.41
2032,8/9/2020,8/9/2020,Alan Safran,Imported from Bank of America Visa-Background checks for fellows,,HJ,,8.58,-42068.99
2032,8/9/2020,8/9/2020,Alan Safran,Imported from Bank of America Visa-Background checks for fellows,,HJ,,8.59,-42077.58
2032,8/9/2020,8/9/2020,Alan Safran,Imported from Bank of America Visa-Background checks for fellows,,HJ,,13.48,-42091.06
2032,8/9/2020,8/9/2020,Alan Safran,Imported from Bank of America Visa-Background checks for fellows,,HJ,,15.81,-42106.87
2032,8/9/2020,8/9/2020,Alan Safran,Imported from Bank of America Visa-Background checks for fellows,,HJ,,15.81,-42122.68
2032,8/9/2020,8/9/2020,Alan Safran,Imported from Bank of America Visa-Background checks for fellows,,HJ,,15.81,-42138.49
2032,8/9/2020,8/9/2020,Alan Safran,Imported from Bank of America Visa-Background checks for fellows,,HJ,,20.82,-42159.31
2032,8/9/2020,8/9/2020,Alan Safran,Imported from Bank of America Visa-Background checks for fellows,,HJ,,20.83,-42180.14
2032,8/9/2020,8/9/2020,Alan Safran,Imported from Bank of America Visa-Background checks for fellows,,HJ,,27.77,-42207.91
2032,8/9/2020,8/9/2020,Alan Safran,Imported from Bank of America Visa-Background checks for fellows,,HJ,,67.37,-42275.28
2032,8/9/2020,8/9/2020,Chris D PLACEHOLDER,Imported from Bank of America Visa-Book for team PD,,HJ,,11.68,-42286.96
2032,8/9/2020,8/9/2020,Chris D PLACEHOLDER,Imported from Bank of America Visa-Book prize sent to employee,,HJ,,18.35,-42305.31
2032,8/9/2020,8/9/2020,Chris D PLACEHOLDER,Imported from Bank of America Visa-Book sent for team PD,,HJ,,11.94,-42317.25
2032,8/9/2020,8/9/2020,Chris D PLACEHOLDER,Imported from Bank of America Visa-Printer paper for home printer,,HJ,,22.25,-42339.5
2032,8/9/2020,8/9/2020,Joseph Zarate,Imported from Bank of America Visa-New hire equipment,,HJ,,9.89,-42349.39
2032,8/9/2020,8/9/2020,Joseph Zarate,Imported from Bank of America Visa-New hire equipment,,HJ,,9.89,-42359.28
2032,8/9/2020,8/9/2020,Joseph Zarate,Imported from Bank of America Visa-New hire equipment,,HJ,,9.89,-42369.17
2032,8/9/2020,8/9/2020,Joseph Zarate,Imported from Bank of America Visa-New hire equipment,,HJ,,9.89,-42379.06
2032,8/9/2020,8/9/2020,Joseph Zarate,Imported from Bank of America Visa-New hire equipment,,HJ,,9.89,-42388.95
2032,8/9/2020,8/9/2020,Joseph Zarate,Imported from Bank of America Visa-New hire equipment,,HJ,,10.48,-42399.43
2032,8/9/2020,8/9/2020,Joseph Zarate,Imported from Bank of America Visa-New hire equipment,,HJ,,10.58,-42410.01
2032,8/9/2020,8/9/2020,Joseph Zarate,Imported from Bank of America Visa-New hire equipment,,HJ,,10.68,-42420.69
2032,8/9/2020,8/9/2020,Joseph Zarate,Imported from Bank of America Visa-New hire equipment,,HJ,,10.73,-42431.42
2032,8/9/2020,8/9/2020,Joseph Zarate,Imported from Bank of America Visa-New hire equipment,,HJ,,184.86,-42616.28
2032,8/9/2020,8/9/2020,Joseph Zarate,Imported from Bank of America Visa-New hire equipment,,HJ,,267.99,-42884.27
2032,8/9/2020,8/9/2020,Joseph Zarate,Imported from Bank of America Visa-New hire equipment,,HJ,,267.99,-43152.26
2032,8/9/2020,8/9/2020,Joseph Zarate,Imported from Bank of America Visa-New hire equipment,,HJ,,279,-43431.26
2032,8/9/2020,8/9/2020,Joseph Zarate,Imported from Bank of America Visa-New hire equipment,,HJ,,279,-43710.26
2032,8/9/2020,8/9/2020,Joseph Zarate,Imported from Bank of America Visa-New hire equipment,,HJ,,279,-43989.26
2032,8/9/2020,8/9/2020,Joseph Zarate,Imported from Bank of America Visa-New hire equipment,,HJ,,279,-44268.26
2032,8/9/2020,8/9/2020,Joseph Zarate,Imported from Bank of America Visa-New hire equipment,,HJ,,279,-44547.26
2032,8/9/2020,8/9/2020,Joseph Zarate,Imported from Bank of America Visa-New hire equipment,,HJ,,279,-44826.26
2032,8/9/2020,8/9/2020,Joseph Zarate,Imported from Bank of America Visa-New hire equipment,,HJ,,279,-45105.26
2032,8/9/2020,8/9/2020,Joseph Zarate,Imported from Bank of America Visa-New hire equipment,,HJ,,279,-45384.26
2032,8/9/2020,8/9/2020,Joseph Zarate,Imported from Bank of America Visa-New hire equipment,,HJ,,279,-45663.26
2032,8/9/2020,8/9/2020,Joseph Zarate,Imported from Bank of America Visa-New hire equipment,,HJ,,279,-45942.26
2032,8/9/2020,8/9/2020,Joseph Zarate,Imported from Bank of America Visa-New hire equipment,,HJ,,279,-46221.26
2032,8/9/2020,8/9/2020,Joseph Zarate,Imported from Bank of America Visa-New hire equipment,,HJ,,279,-46500.26
2032,8/9/2020,8/9/2020,Joseph Zarate,Imported from Bank of America Visa-New hire equipment,,HJ,,279,-46779.26
2032,8/9/2020,8/9/2020,Joseph Zarate,Imported from Bank of America Visa-New hire equipment,,HJ,,279,-47058.26
2032,8/9/2020,8/9/2020,Joseph Zarate,Imported from Bank of America Visa-New hire equipment,,HJ,,279,-47337.26
2032,8/9/2020,8/9/2020,Joseph Zarate,Imported from Bank of America Visa-New hire equipment,,HJ,,279,-47616.26
2032,8/9/2020,8/9/2020,Joseph Zarate,Imported from Bank of America Visa-New hire equipment,,HJ,,281.82,-47898.08
2032,8/9/2020,8/9/2020,Joseph Zarate,Imported from Bank of America Visa-New hire equipment,,HJ,,285.74,-48183.82
2032,8/9/2020,8/9/2020,Joseph Zarate,Imported from Bank of America Visa-New hire equipment,,HJ,,286.75,-48470.57
2032,8/9/2020,8/9/2020,Joseph Zarate,Imported from Bank of America Visa-equipment,,HJ,,99.24,-48569.81
2032,8/9/2020,8/9/2020,Maryellen Leneghan,Imported from Bank of America Visa-BC fellow appreciation during training,,HJ,,6.35,-48576.16
2032,8/10/2020,8/10/2020,Alan Safran,Imported from Bank of America Visa-Background checks for fellows,,HJ,,3.16,-48579.32
2032,8/10/2020,8/10/2020,Alan Safran,Imported from Bank of America Visa-Background checks for fellows,,HJ,,3.16,-48582.48
2032,8/10/2020,8/10/2020,Alan Safran,Imported from Bank of America Visa-Background checks for fellows,,HJ,,3.16,-48585.64
2032,8/10/2020,8/10/2020,Alan Safran,Imported from Bank of America Visa-Background checks for fellows,,HJ,,3.16,-48588.8
2032,8/10/2020,8/10/2020,Alan Safran,Imported from Bank of America Visa-Background checks for fellows,,HJ,,4.02,-48592.82
2032,8/10/2020,8/10/2020,Alan Safran,Imported from Bank of America Visa-Background checks for fellows,,HJ,,4.89,-48597.71
2032,8/10/2020,8/10/2020,Alan Safran,Imported from Bank of America Visa-Background checks for fellows,,HJ,,4.89,-48602.6
2032,8/10/2020,8/10/2020,Alan Safran,Imported from Bank of America Visa-Background checks for fellows,,HJ,,4.89,-48607.49
2032,8/10/2020,8/10/2020,Alan Safran,Imported from Bank of America Visa-Background checks for fellows,,HJ,,4.89,-48612.38
2032,8/10/2020,8/10/2020,Alan Safran,Imported from Bank of America Visa-Background checks for fellows,,HJ,,4.89,-48617.27
2032,8/10/2020,8/10/2020,Alan Safran,Imported from Bank of America Visa-Background checks for fellows,,HJ,,4.89,-48622.16
2032,8/10/2020,8/10/2020,Alan Safran,Imported from Bank of America Visa-Background checks for fellows,,HJ,,4.89,-48627.05
2032,8/10/2020,8/10/2020,Alan Safran,Imported from Bank of America Visa-Background checks for fellows,,HJ,,4.89,-48631.94
2032,8/10/2020,8/10/2020,Alan Safran,Imported from Bank of America Visa-Background checks for fellows,,HJ,,5.56,-48637.5
2032,8/10/2020,8/10/2020,Alan Safran,Imported from Bank of America Visa-Background checks for fellows,,HJ,,5.56,-48643.06
2032,8/10/2020,8/10/2020,Alan Safran,Imported from Bank of America Visa-Background checks for fellows,,HJ,,6.2,-48649.26
2032,8/10/2020,8/10/2020,Alan Safran,Imported from Bank of America Visa-Background checks for fellows,,HJ,,6.21,-48655.47
2032,8/10/2020,8/10/2020,Alan Safran,Imported from Bank of America Visa-Background checks for fellows,,HJ,,7.7,-48663.17
2032,8/10/2020,8/10/2020,Alan Safran,Imported from Bank of America Visa-Background checks for fellows,,HJ,,7.92,-48671.09
2032,8/10/2020,8/10/2020,Alan Safran,Imported from Bank of America Visa-Background checks for fellows,,HJ,,8.05,-48679.14
2032,8/10/2020,8/10/2020,Alan Safran,Imported from Bank of America Visa-Background checks for fellows,,HJ,,8.58,-48687.72
2032,8/10/2020,8/10/2020,Alan Safran,Imported from Bank of America Visa-Background checks for fellows,,HJ,,8.58,-48696.3
2032,8/10/2020,8/10/2020,Alan Safran,Imported from Bank of America Visa-Background checks for fellows,,HJ,,8.59,-48704.89
2032,8/10/2020,8/10/2020,Alan Safran,Imported from Bank of America Visa-Background checks for fellows,,HJ,,8.59,-48713.48
2032,8/10/2020,8/10/2020,Alan Safran,Imported from Bank of America Visa-Background checks for fellows,,HJ,,8.8,-48722.28
2032,8/10/2020,8/10/2020,Alan Safran,Imported from Bank of America Visa-Background checks for fellows,,HJ,,11.9,-48734.18
2032,8/10/2020,8/10/2020,Alan Safran,Imported from Bank of America Visa-Background checks for fellows,,HJ,,11.9,-48746.08
2032,8/10/2020,8/10/2020,Alan Safran,Imported from Bank of America Visa-Background checks for fellows,,HJ,,12.24,-48758.32
2032,8/10/2020,8/10/2020,Alan Safran,Imported from Bank of America Visa-Background checks for fellows,,HJ,,12.24,-48770.56
2032,8/10/2020,8/10/2020,Alan Safran,Imported from Bank of America Visa-Background checks for fellows,,HJ,,12.44,-48783
2032,8/10/2020,8/10/2020,Alan Safran,Imported from Bank of America Visa-Background checks for fellows,,HJ,,12.44,-48795.44
2032,8/10/2020,8/10/2020,Alan Safran,Imported from Bank of America Visa-Background checks for fellows,,HJ,,13.48,-48808.92
2032,8/10/2020,8/10/2020,Alan Safran,Imported from Bank of America Visa-Background checks for fellows,,HJ,,13.6,-48822.52
2032,8/10/2020,8/10/2020,Alan Safran,Imported from Bank of America Visa-Background checks for fellows,,HJ,,13.6,-48836.12
2032,8/10/2020,8/10/2020,Alan Safran,Imported from Bank of America Visa-Background checks for fellows,,HJ,,15.81,-48851.93
2032,8/10/2020,8/10/2020,Alan Safran,Imported from Bank of America Visa-Background checks for fellows,,HJ,,15.81,-48867.74
2032,8/10/2020,8/10/2020,Alan Safran,Imported from Bank of America Visa-Background checks for fellows,,HJ,,15.81,-48883.55
2032,8/10/2020,8/10/2020,Alan Safran,Imported from Bank of America Visa-Background checks for fellows,,HJ,,15.81,-48899.36
2032,8/10/2020,8/10/2020,Alan Safran,Imported from Bank of America Visa-Background checks for fellows,,HJ,,16.94,-48916.3
2032,8/10/2020,8/10/2020,Alan Safran,Imported from Bank of America Visa-Background checks for fellows,,HJ,,20.07,-48936.37
2032,8/10/2020,8/10/2020,Alan Safran,Imported from Bank of America Visa-Background checks for fellows,,HJ,,20.82,-48957.19
2032,8/10/2020,8/10/2020,Alan Safran,Imported from Bank of America Visa-Background checks for fellows,,HJ,,20.83,-48978.02
2032,8/10/2020,8/10/2020,Alan Safran,Imported from Bank of America Visa-Background checks for fellows,,HJ,,26.18,-49004.2
2032,8/10/2020,8/10/2020,Alan Safran,Imported from Bank of America Visa-Background checks for fellows,,HJ,,26.18,-49030.38
2032,8/10/2020,8/10/2020,Alan Safran,Imported from Bank of America Visa-Background checks for fellows,,HJ,,27.77,-49058.15
2032,8/10/2020,8/10/2020,Alan Safran,Imported from Bank of America Visa-Background checks for fellows,,HJ,,27.77,-49085.92
2032,8/10/2020,8/10/2020,Alan Safran,Imported from Bank of America Visa-Background checks for fellows,,HJ,,38.5,-49124.42
2032,8/10/2020,8/10/2020,Alan Safran,Imported from Bank of America Visa-Background checks for fellows,,HJ,,39.6,-49164.02
2032,8/10/2020,8/10/2020,Alan Safran,Imported from Bank of America Visa-Background checks for fellows,,HJ,,40.22,-49204.24
2032,8/10/2020,8/10/2020,Alan Safran,Imported from Bank of America Visa-Background checks for fellows,,HJ,,44,-49248.24
2032,8/10/2020,8/10/2020,Alan Safran,Imported from Bank of America Visa-Background checks for fellows,,HJ,,67.37,-49315.61
2032,8/10/2020,8/10/2020,Alan Safran,Imported from Bank of America Visa-Background checks for fellows,,HJ,,84.7,-49400.31
2032,8/10/2020,8/10/2020,Elizabeth Peinado,Imported from Bank of America Visa-New hire packages,,HJ,,7.11,-49407.42
2032,8/10/2020,8/10/2020,Elizabeth Peinado,Imported from Bank of America Visa-New hire packages,,HJ,,10.98,-49418.4
2032,8/10/2020,8/10/2020,Elizabeth Peinado,Imported from Bank of America Visa-New hire packages,,HJ,,10.98,-49429.38
2032,8/10/2020,8/10/2020,Elizabeth Peinado,Imported from Bank of America Visa-New hire packages,,HJ,,35.53,-49464.91
2032,8/10/2020,8/10/2020,Joseph Zarate,Imported from Bank of America Visa-New hire equipment,,HJ,,9.89,-49474.8
2032,8/10/2020,8/10/2020,Joseph Zarate,Imported from Bank of America Visa-New hire equipment,,HJ,,9.89,-49484.69
2032,8/10/2020,8/10/2020,Joseph Zarate,Imported from Bank of America Visa-New hire equipment,,HJ,,9.89,-49494.58
2032,8/10/2020,8/10/2020,Joseph Zarate,Imported from Bank of America Visa-New hire equipment,,HJ,,9.89,-49504.47
2032,8/10/2020,8/10/2020,Joseph Zarate,Imported from Bank of America Visa-New hire equipment,,HJ,,9.89,-49514.36
2032,8/10/2020,8/10/2020,Joseph Zarate,Imported from Bank of America Visa-New hire equipment,,HJ,,9.89,-49524.25
2032,8/10/2020,8/10/2020,Joseph Zarate,Imported from Bank of America Visa-New hire equipment,,HJ,,10.83,-49535.08
2032,8/10/2020,8/10/2020,Joseph Zarate,Imported from Bank of America Visa-New hire equipment,,HJ,,10.99,-49546.07
2032,8/10/2020,8/10/2020,Joseph Zarate,Imported from Bank of America Visa-New hire equipment,,HJ,,15.05,-49561.12
2032,8/10/2020,8/10/2020,Joseph Zarate,Imported from Bank of America Visa-New hire equipment,,HJ,,19.99,-49581.11
2032,8/10/2020,8/10/2020,Joseph Zarate,Imported from Bank of America Visa-New hire equipment,,HJ,,19.99,-49601.1
2032,8/10/2020,8/10/2020,Joseph Zarate,Imported from Bank of America Visa-New hire equipment,,HJ,,19.99,-49621.09
2032,8/10/2020,8/10/2020,Joseph Zarate,Imported from Bank of America Visa-New hire equipment,,HJ,,19.99,-49641.08
2032,8/10/2020,8/10/2020,Joseph Zarate,Imported from Bank of America Visa-New hire equipment,,HJ,,19.99,-49661.07
2032,8/10/2020,8/10/2020,Joseph Zarate,Imported from Bank of America Visa-New hire equipment,,HJ,,19.99,-49681.06
2032,8/10/2020,8/10/2020,Joseph Zarate,Imported from Bank of America Visa-New hire equipment,,HJ,,19.99,-49701.05
2032,8/10/2020,8/10/2020,Joseph Zarate,Imported from Bank of America Visa-New hire equipment,,HJ,,19.99,-49721.04
2032,8/10/2020,8/10/2020,Joseph Zarate,Imported from Bank of America Visa-New hire equipment,,HJ,,19.99,-49741.03
2032,8/10/2020,8/10/2020,Joseph Zarate,Imported from Bank of America Visa-New hire equipment,,HJ,,21.19,-49762.22
2032,8/10/2020,8/10/2020,Joseph Zarate,Imported from Bank of America Visa-New hire equipment,,HJ,,21.26,-49783.48
2032,8/10/2020,8/10/2020,Joseph Zarate,Imported from Bank of America Visa-New hire equipment,,HJ,,21.39,-49804.87
2032,8/10/2020,8/10/2020,Joseph Zarate,Imported from Bank of America Visa-New hire equipment,,HJ,,21.39,-49826.26
2032,8/10/2020,8/10/2020,Joseph Zarate,Imported from Bank of America Visa-New hire equipment,,HJ,,21.39,-49847.65
2032,8/10/2020,8/10/2020,Joseph Zarate,Imported from Bank of America Visa-New hire equipment,,HJ,,21.39,-49869.04
2032,8/10/2020,8/10/2020,Joseph Zarate,Imported from Bank of America Visa-New hire equipment,,HJ,,21.54,-49890.58
2032,8/10/2020,8/10/2020,Joseph Zarate,Imported from Bank of America Visa-New hire equipment,,HJ,,21.59,-49912.17
2032,8/10/2020,8/10/2020,Joseph Zarate,Imported from Bank of America Visa-New hire equipment,,HJ,,21.59,-49933.76
2032,8/10/2020,8/10/2020,Joseph Zarate,Imported from Bank of America Visa-New hire equipment,,HJ,,21.69,-49955.45
2032,8/10/2020,8/10/2020,Joseph Zarate,Imported from Bank of America Visa-New hire equipment,,HJ,,21.69,-49977.14
2032,8/10/2020,8/10/2020,Joseph Zarate,Imported from Bank of America Visa-New hire equipment,,HJ,,21.89,-49999.03
2032,8/10/2020,8/10/2020,Joseph Zarate,Imported from Bank of America Visa-New hire equipment,,HJ,,31.35,-50030.38
2032,8/10/2020,8/10/2020,Joseph Zarate,Imported from Bank of America Visa-New hire equipment,,HJ,,260,-50290.38
2032,8/10/2020,8/10/2020,Joseph Zarate,Imported from Bank of America Visa-New hire equipment,,HJ,,267.99,-50558.37
2032,8/10/2020,8/10/2020,Joseph Zarate,Imported from Bank of America Visa-New hire equipment,,HJ,,290.1,-50848.47
2032,8/10/2020,8/10/2020,Joseph Zarate,Imported from Bank of America Visa-Returns,,HJ,,15.05,-50863.52
2032,8/10/2020,8/10/2020,Joseph Zarate,Imported from Bank of America Visa-equipment,,HJ,,31.35,-50894.87
2032,8/10/2020,8/10/2020,Joseph Zarate,Imported from Bank of America Visa-equipment,,HJ,,31.35,-50926.22
2032,8/10/2020,8/10/2020,Uriel Guadarrama,Imported from Bank of America Visa-Document Studio for Jashive,,HJ,,39,-50965.22
2032,8/11/2020,8/11/2020,Alan Safran,Imported from Bank of America Visa-Background checks for fellows,,HJ,,3.16,-50968.38
2032,8/11/2020,8/11/2020,Alan Safran,Imported from Bank of America Visa-Background checks for fellows,,HJ,,3.16,-50971.54
2032,8/11/2020,8/11/2020,Alan Safran,Imported from Bank of America Visa-Background checks for fellows,,HJ,,3.16,-50974.7
2032,8/11/2020,8/11/2020,Alan Safran,Imported from Bank of America Visa-Background checks for fellows,,HJ,,3.16,-50977.86
2032,8/11/2020,8/11/2020,Alan Safran,Imported from Bank of America Visa-Background checks for fellows,,HJ,,3.16,-50981.02
2032,8/11/2020,8/11/2020,Alan Safran,Imported from Bank of America Visa-Background checks for fellows,,HJ,,3.16,-50984.18
2032,8/11/2020,8/11/2020,Alan Safran,Imported from Bank of America Visa-Background checks for fellows,,HJ,,3.16,-50987.34
2032,8/11/2020,8/11/2020,Alan Safran,Imported from Bank of America Visa-Background checks for fellows,,HJ,,4.02,-50991.36
2032,8/11/2020,8/11/2020,Alan Safran,Imported from Bank of America Visa-Background checks for fellows,,HJ,,4.02,-50995.38
2032,8/11/2020,8/11/2020,Alan Safran,Imported from Bank of America Visa-Background checks for fellows,,HJ,,4.02,-50999.4
2032,8/11/2020,8/11/2020,Alan Safran,Imported from Bank of America Visa-Background checks for fellows,,HJ,,4.02,-51003.42
2032,8/11/2020,8/11/2020,Alan Safran,Imported from Bank of America Visa-Background checks for fellows,,HJ,,4.02,-51007.44
2032,8/11/2020,8/11/2020,Alan Safran,Imported from Bank of America Visa-Background checks for fellows,,HJ,,4.02,-51011.46
2032,8/11/2020,8/11/2020,Alan Safran,Imported from Bank of America Visa-Background checks for fellows,,HJ,,4.02,-51015.48
2032,8/11/2020,8/11/2020,Alan Safran,Imported from Bank of America Visa-Background checks for fellows,,HJ,,4.02,-51019.5
2032,8/11/2020,8/11/2020,Alan Safran,Imported from Bank of America Visa-Background checks for fellows,,HJ,,4.02,-51023.52
2032,8/11/2020,8/11/2020,Alan Safran,Imported from Bank of America Visa-Background checks for fellows,,HJ,,4.02,-51027.54
2032,8/11/2020,8/11/2020,Alan Safran,Imported from Bank of America Visa-Background checks for fellows,,HJ,,4.02,-51031.56
2032,8/11/2020,8/11/2020,Alan Safran,Imported from Bank of America Visa-Background checks for fellows,,HJ,,4.02,-51035.58
2032,8/11/2020,8/11/2020,Alan Safran,Imported from Bank of America Visa-Background checks for fellows,,HJ,,4.89,-51040.47
2032,8/11/2020,8/11/2020,Alan Safran,Imported from Bank of America Visa-Background checks for fellows,,HJ,,4.89,-51045.36
2032,8/11/2020,8/11/2020,Alan Safran,Imported from Bank of America Visa-Background checks for fellows,,HJ,,4.89,-51050.25
2032,8/11/2020,8/11/2020,Alan Safran,Imported from Bank of America Visa-Background checks for fellows,,HJ,,4.89,-51055.14
2032,8/11/2020,8/11/2020,Alan Safran,Imported from Bank of America Visa-Background checks for fellows,,HJ,,4.89,-51060.03
2032,8/11/2020,8/11/2020,Alan Safran,Imported from Bank of America Visa-Background checks for fellows,,HJ,,4.89,-51064.92
2032,8/11/2020,8/11/2020,Alan Safran,Imported from Bank of America Visa-Background checks for fellows,,HJ,,4.89,-51069.81
2032,8/11/2020,8/11/2020,Alan Safran,Imported from Bank of America Visa-Background checks for fellows,,HJ,,4.89,-51074.7
2032,8/11/2020,8/11/2020,Alan Safran,Imported from Bank of America Visa-Background checks for fellows,,HJ,,4.89,-51079.59
2032,8/11/2020,8/11/2020,Alan Safran,Imported from Bank of America Visa-Background checks for fellows,,HJ,,4.89,-51084.48
2032,8/11/2020,8/11/2020,Alan Safran,Imported from Bank of America Visa-Background checks for fellows,,HJ,,4.89,-51089.37
2032,8/11/2020,8/11/2020,Alan Safran,Imported from Bank of America Visa-Background checks for fellows,,HJ,,4.89,-51094.26
2032,8/11/2020,8/11/2020,Alan Safran,Imported from Bank of America Visa-Background checks for fellows,,HJ,,4.89,-51099.15
2032,8/11/2020,8/11/2020,Alan Safran,Imported from Bank of America Visa-Background checks for fellows,,HJ,,4.89,-51104.04
2032,8/11/2020,8/11/2020,Alan Safran,Imported from Bank of America Visa-Background checks for fellows,,HJ,,5.06,-51109.1
2032,8/11/2020,8/11/2020,Alan Safran,Imported from Bank of America Visa-Background checks for fellows,,HJ,,6.2,-51115.3
2032,8/11/2020,8/11/2020,Alan Safran,Imported from Bank of America Visa-Background checks for fellows,,HJ,,6.2,-51121.5
2032,8/11/2020,8/11/2020,Alan Safran,Imported from Bank of America Visa-Background checks for fellows,,HJ,,6.2,-51127.7
2032,8/11/2020,8/11/2020,Alan Safran,Imported from Bank of America Visa-Background checks for fellows,,HJ,,6.2,-51133.9
2032,8/11/2020,8/11/2020,Alan Safran,Imported from Bank of America Visa-Background checks for fellows,,HJ,,6.2,-51140.1
2032,8/11/2020,8/11/2020,Alan Safran,Imported from Bank of America Visa-Background checks for fellows,,HJ,,6.2,-51146.3
2032,8/11/2020,8/11/2020,Alan Safran,Imported from Bank of America Visa-Background checks for fellows,,HJ,,6.2,-51152.5
2032,8/11/2020,8/11/2020,Alan Safran,Imported from Bank of America Visa-Background checks for fellows,,HJ,,6.2,-51158.7
2032,8/11/2020,8/11/2020,Alan Safran,Imported from Bank of America Visa-Background checks for fellows,,HJ,,6.2,-51164.9
2032,8/11/2020,8/11/2020,Alan Safran,Imported from Bank of America Visa-Background checks for fellows,,HJ,,6.2,-51171.1
2032,8/11/2020,8/11/2020,Alan Safran,Imported from Bank of America Visa-Background checks for fellows,,HJ,,6.2,-51177.3
2032,8/11/2020,8/11/2020,Alan Safran,Imported from Bank of America Visa-Background checks for fellows,,HJ,,6.2,-51183.5
2032,8/11/2020,8/11/2020,Alan Safran,Imported from Bank of America Visa-Background checks for fellows,,HJ,,6.21,-51189.71
2032,8/11/2020,8/11/2020,Alan Safran,Imported from Bank of America Visa-Background checks for fellows,,HJ,,6.21,-51195.92
2032,8/11/2020,8/11/2020,Alan Safran,Imported from Bank of America Visa-Background checks for fellows,,HJ,,6.21,-51202.13
2032,8/11/2020,8/11/2020,Alan Safran,Imported from Bank of America Visa-Background checks for fellows,,HJ,,6.21,-51208.34
2032,8/11/2020,8/11/2020,Alan Safran,Imported from Bank of America Visa-Background checks for fellows,,HJ,,6.21,-51214.55
2032,8/11/2020,8/11/2020,Alan Safran,Imported from Bank of America Visa-Background checks for fellows,,HJ,,6.21,-51220.76
2032,8/11/2020,8/11/2020,Alan Safran,Imported from Bank of America Visa-Background checks for fellows,,HJ,,6.21,-51226.97
2032,8/11/2020,8/11/2020,Alan Safran,Imported from Bank of America Visa-Background checks for fellows,,HJ,,6.21,-51233.18
2032,8/11/2020,8/11/2020,Alan Safran,Imported from Bank of America Visa-Background checks for fellows,,HJ,,6.21,-51239.39
2032,8/11/2020,8/11/2020,Alan Safran,Imported from Bank of America Visa-Background checks for fellows,,HJ,,6.21,-51245.6
2032,8/11/2020,8/11/2020,Alan Safran,Imported from Bank of America Visa-Background checks for fellows,,HJ,,6.21,-51251.81
2032,8/11/2020,8/11/2020,Alan Safran,Imported from Bank of America Visa-Background checks for fellows,,HJ,,6.21,-51258.02
2032,8/11/2020,8/11/2020,Alan Safran,Imported from Bank of America Visa-Background checks for fellows,,HJ,,6.51,-51264.53
2032,8/11/2020,8/11/2020,Alan Safran,Imported from Bank of America Visa-Background checks for fellows,,HJ,,7.82,-51272.35
2032,8/11/2020,8/11/2020,Alan Safran,Imported from Bank of America Visa-Background checks for fellows,,HJ,,7.82,-51280.17
2032,8/11/2020,8/11/2020,Alan Safran,Imported from Bank of America Visa-Background checks for fellows,,HJ,,10.06,-51290.23
2032,8/11/2020,8/11/2020,Alan Safran,Imported from Bank of America Visa-Background checks for fellows,,HJ,,10.06,-51300.29
2032,8/11/2020,8/11/2020,Alan Safran,Imported from Bank of America Visa-Background checks for fellows,,HJ,,15.81,-51316.1
2032,8/11/2020,8/11/2020,Alan Safran,Imported from Bank of America Visa-Background checks for fellows,,HJ,,15.81,-51331.91
2032,8/11/2020,8/11/2020,Alan Safran,Imported from Bank of America Visa-Background checks for fellows,,HJ,,15.81,-51347.72
2032,8/11/2020,8/11/2020,Alan Safran,Imported from Bank of America Visa-Background checks for fellows,,HJ,,15.81,-51363.53
2032,8/11/2020,8/11/2020,Alan Safran,Imported from Bank of America Visa-Background checks for fellows,,HJ,,15.81,-51379.34
2032,8/11/2020,8/11/2020,Alan Safran,Imported from Bank of America Visa-Background checks for fellows,,HJ,,15.81,-51395.15
2032,8/11/2020,8/11/2020,Alan Safran,Imported from Bank of America Visa-Background checks for fellows,,HJ,,15.81,-51410.96
2032,8/11/2020,8/11/2020,Alan Safran,Imported from Bank of America Visa-Background checks for fellows,,HJ,,16.72,-51427.68
2032,8/11/2020,8/11/2020,Alan Safran,Imported from Bank of America Visa-Background checks for fellows,,HJ,,20.07,-51447.75
2032,8/11/2020,8/11/2020,Alan Safran,Imported from Bank of America Visa-Background checks for fellows,,HJ,,20.07,-51467.82
2032,8/11/2020,8/11/2020,Alan Safran,Imported from Bank of America Visa-Background checks for fellows,,HJ,,20.07,-51487.89
2032,8/11/2020,8/11/2020,Alan Safran,Imported from Bank of America Visa-Background checks for fellows,,HJ,,20.07,-51507.96
2032,8/11/2020,8/11/2020,Alan Safran,Imported from Bank of America Visa-Background checks for fellows,,HJ,,20.07,-51528.03
2032,8/11/2020,8/11/2020,Alan Safran,Imported from Bank of America Visa-Background checks for fellows,,HJ,,20.07,-51548.1
2032,8/11/2020,8/11/2020,Alan Safran,Imported from Bank of America Visa-Background checks for fellows,,HJ,,20.07,-51568.17
2032,8/11/2020,8/11/2020,Alan Safran,Imported from Bank of America Visa-Background checks for fellows,,HJ,,20.07,-51588.24
2032,8/11/2020,8/11/2020,Alan Safran,Imported from Bank of America Visa-Background checks for fellows,,HJ,,20.07,-51608.31
2032,8/11/2020,8/11/2020,Alan Safran,Imported from Bank of America Visa-Background checks for fellows,,HJ,,20.07,-51628.38
2032,8/11/2020,8/11/2020,Alan Safran,Imported from Bank of America Visa-Background checks for fellows,,HJ,,20.07,-51648.45
2032,8/11/2020,8/11/2020,Alan Safran,Imported from Bank of America Visa-Background checks for fellows,,HJ,,20.07,-51668.52
2032,8/11/2020,8/11/2020,Alan Safran,Imported from Bank of America Visa-Background checks for fellows,,HJ,,25.3,-51693.82
2032,8/11/2020,8/11/2020,Alan Safran,Imported from Bank of America Visa-Background checks for fellows,,HJ,,25.84,-51719.66
2032,8/11/2020,8/11/2020,Alan Safran,Imported from Bank of America Visa-Background checks for fellows,,HJ,,25.84,-51745.5
2032,8/11/2020,8/11/2020,Alan Safran,Imported from Bank of America Visa-Background checks for fellows,,HJ,,32.52,-51778.02
2032,8/11/2020,8/11/2020,Alan Safran,Imported from Bank of America Visa-Background checks for fellows,,HJ,,83.6,-51861.62
2032,8/11/2020,8/11/2020,Chris D PLACEHOLDER,Imported from Bank of America Visa-Book for team PD,,HJ,,11.65,-51873.27
2032,8/11/2020,8/11/2020,Chris D PLACEHOLDER,Imported from Bank of America Visa-Book for team PD,,HJ,,11.68,-51884.95
2032,8/11/2020,8/11/2020,Chris D PLACEHOLDER,Imported from Bank of America Visa-Book prize sent to employee,,HJ,,6.92,-51891.87
2032,8/11/2020,8/11/2020,Elizabeth Peinado,Imported from Bank of America Visa-New hire packages,,HJ,,11.71,-51903.58
2032,8/11/2020,8/11/2020,Elizabeth Peinado,Imported from Bank of America Visa-New hire packages,,HJ,,18.1,-51921.68
2032,8/11/2020,8/11/2020,Elizabeth Peinado,Imported from Bank of America Visa-New hire packages,,HJ,,18.1,-51939.78
2032,8/11/2020,8/11/2020,Elizabeth Peinado,Imported from Bank of America Visa-New hire packages,,HJ,,21.62,-51961.4
2032,8/11/2020,8/11/2020,Elizabeth Peinado,Imported from Bank of America Visa-New hire packages,,HJ,,33.4,-51994.8
2032,8/11/2020,8/11/2020,Elizabeth Peinado,Imported from Bank of America Visa-New hire packages,,HJ,,33.41,-52028.21
2032,8/11/2020,8/11/2020,Elizabeth Peinado,Imported from Bank of America Visa-New hire packages,,HJ,,58.54,-52086.75
2032,8/11/2020,8/11/2020,Elizabeth Peinado,Imported from Bank of America Visa-New hire packages,,HJ,,108.07,-52194.82
2032,8/11/2020,8/11/2020,Elizabeth Peinado,Imported from Bank of America Visa-Paper materials for new hire packages,,HJ,,5.93,-52200.75
2032,8/11/2020,8/11/2020,Elizabeth Peinado,Imported from Bank of America Visa-Paper materials for new hire packages,,HJ,,9.16,-52209.91
2032,8/11/2020,8/11/2020,Elizabeth Peinado,Imported from Bank of America Visa-Paper materials for new hire packages,,HJ,,9.16,-52219.07
2032,8/11/2020,8/11/2020,Elizabeth Peinado,Imported from Bank of America Visa-Paper materials for new hire packages,,HJ,,29.63,-52248.7
2032,8/11/2020,8/11/2020,Joseph Zarate,Imported from Bank of America Visa-New hire equipment,,HJ,,9.89,-52258.59
2032,8/11/2020,8/11/2020,Joseph Zarate,Imported from Bank of America Visa-New hire equipment,,HJ,,9.89,-52268.48
2032,8/11/2020,8/11/2020,Joseph Zarate,Imported from Bank of America Visa-New hire equipment,,HJ,,9.89,-52278.37
2032,8/11/2020,8/11/2020,Joseph Zarate,Imported from Bank of America Visa-New hire equipment,,HJ,,9.89,-52288.26
2032,8/11/2020,8/11/2020,Joseph Zarate,Imported from Bank of America Visa-New hire equipment,,HJ,,9.89,-52298.15
2032,8/11/2020,8/11/2020,Joseph Zarate,Imported from Bank of America Visa-New hire equipment,,HJ,,9.89,-52308.04
2032,8/11/2020,8/11/2020,Joseph Zarate,Imported from Bank of America Visa-New hire equipment,,HJ,,10.48,-52318.52
2032,8/11/2020,8/11/2020,Joseph Zarate,Imported from Bank of America Visa-New hire equipment,,HJ,,10.58,-52329.1
2032,8/11/2020,8/11/2020,Joseph Zarate,Imported from Bank of America Visa-New hire equipment,,HJ,,10.99,-52340.09
2032,8/11/2020,8/11/2020,Joseph Zarate,Imported from Bank of America Visa-New hire equipment,,HJ,,114.35,-52454.44
2032,8/11/2020,8/11/2020,Joseph Zarate,Imported from Bank of America Visa-New hire equipment,,HJ,,114.35,-52568.79
2032,8/11/2020,8/11/2020,Joseph Zarate,Imported from Bank of America Visa-New hire equipment,,HJ,,114.35,-52683.14
2032,8/11/2020,8/11/2020,Joseph Zarate,Imported from Bank of America Visa-New hire equipment,,HJ,,114.35,-52797.49
2032,8/11/2020,8/11/2020,Joseph Zarate,Imported from Bank of America Visa-New hire equipment,,HJ,,260,-53057.49
2032,8/11/2020,8/11/2020,Joseph Zarate,Imported from Bank of America Visa-New hire equipment,,HJ,,267.99,-53325.48
2032,8/11/2020,8/11/2020,Joseph Zarate,Imported from Bank of America Visa-equipment,,HJ,,114.35,-53439.83
2032,8/11/2020,8/11/2020,Joseph Zarate,Imported from Bank of America Visa-equipment,,HJ,,125.34,-53565.17
2032,8/11/2020,8/11/2020,Nicole Prahin,Imported from Bank of America Visa-Ink for at home work use,,HJ,,5.35,-53570.52
2032,8/12/2020,8/12/2020,Alan Safran,Imported from Bank of America Visa-Background checks for fellows,,HJ,,5.56,-53576.08
2032,8/12/2020,8/12/2020,Alan Safran,Imported from Bank of America Visa-Background checks for fellows,,HJ,,5.56,-53581.64
2032,8/12/2020,8/12/2020,Alan Safran,Imported from Bank of America Visa-Background checks for fellows,,HJ,,8.58,-53590.22
2032,8/12/2020,8/12/2020,Alan Safran,Imported from Bank of America Visa-Background checks for fellows,,HJ,,8.58,-53598.8
2032,8/12/2020,8/12/2020,Alan Safran,Imported from Bank of America Visa-Background checks for fellows,,HJ,,8.59,-53607.39
2032,8/12/2020,8/12/2020,Alan Safran,Imported from Bank of America Visa-Background checks for fellows,,HJ,,8.59,-53615.98
2032,8/12/2020,8/12/2020,Alan Safran,Imported from Bank of America Visa-Background checks for fellows,,HJ,,10.12,-53626.1
2032,8/12/2020,8/12/2020,Alan Safran,Imported from Bank of America Visa-Background checks for fellows,,HJ,,15.64,-53641.74
2032,8/12/2020,8/12/2020,Alan Safran,Imported from Bank of America Visa-Background checks for fellows,,HJ,,15.64,-53657.38
2032,8/12/2020,8/12/2020,Alan Safran,Imported from Bank of America Visa-Background checks for fellows,,HJ,,27.77,-53685.15
2032,8/12/2020,8/12/2020,Alan Safran,Imported from Bank of America Visa-Background checks for fellows,,HJ,,27.77,-53712.92
2032,8/12/2020,8/12/2020,Alan Safran,Imported from Bank of America Visa-Background checks for fellows,,HJ,,50.6,-53763.52
2032,8/12/2020,8/12/2020,Antonio Gutierrez,Imported from Bank of America Visa-Agent of record services,,HJ,,299,-54062.52
2032,8/12/2020,8/12/2020,Antonio Gutierrez,Imported from Bank of America Visa-online phone and fax,,HJ,,234.79,-54297.31
2032,8/12/2020,8/12/2020,Chris D PLACEHOLDER,Imported from Bank of America Visa-Book prize sent to AmeriCorps member,,HJ,,12.07,-54309.38
2032,8/12/2020,8/12/2020,Chris D PLACEHOLDER,Imported from Bank of America Visa-Book prize sent to AmeriCorps member,,HJ,,12.07,-54321.45
2032,8/12/2020,8/12/2020,Joseph Zarate,Imported from Bank of America Visa-New hire equipment,,HJ,,1.44,-54322.89
2032,8/12/2020,8/12/2020,Joseph Zarate,Imported from Bank of America Visa-New hire equipment,,HJ,4.15,,-54318.74
2032,8/12/2020,8/12/2020,Joseph Zarate,Imported from Bank of America Visa-New hire equipment,,HJ,,9.89,-54328.63
2032,8/12/2020,8/12/2020,Joseph Zarate,Imported from Bank of America Visa-New hire equipment,,HJ,,15.05,-54343.68
2032,8/12/2020,8/12/2020,Joseph Zarate,Imported from Bank of America Visa-New hire equipment,,HJ,,30.1,-54373.78
2032,8/12/2020,8/12/2020,Joseph Zarate,Imported from Bank of America Visa-New hire equipment,,HJ,,41.69,-54415.47
2032,8/12/2020,8/12/2020,Joseph Zarate,Imported from Bank of America Visa-New hire equipment,,HJ,,45.15,-54460.62
2032,8/12/2020,8/12/2020,Joseph Zarate,Imported from Bank of America Visa-New hire equipment,,HJ,,88.89,-54549.51
2032,8/12/2020,8/12/2020,Joseph Zarate,Imported from Bank of America Visa-New hire equipment,,HJ,,88.89,-54638.4
2032,8/12/2020,8/12/2020,Joseph Zarate,Imported from Bank of America Visa-New hire equipment,,HJ,,88.89,-54727.29
2032,8/12/2020,8/12/2020,Joseph Zarate,Imported from Bank of America Visa-New hire equipment,,HJ,,88.89,-54816.18
2032,8/12/2020,8/12/2020,Joseph Zarate,Imported from Bank of America Visa-New hire equipment,,HJ,,88.89,-54905.07
2032,8/12/2020,8/12/2020,Joseph Zarate,Imported from Bank of America Visa-New hire equipment,,HJ,,88.89,-54993.96
2032,8/12/2020,8/12/2020,Joseph Zarate,Imported from Bank of America Visa-New hire equipment,,HJ,,88.89,-55082.85
2032,8/12/2020,8/12/2020,Joseph Zarate,Imported from Bank of America Visa-New hire equipment,,HJ,,88.89,-55171.74
2032,8/12/2020,8/12/2020,Joseph Zarate,Imported from Bank of America Visa-New hire equipment,,HJ,,88.89,-55260.63
2032,8/12/2020,8/12/2020,Joseph Zarate,Imported from Bank of America Visa-New hire equipment,,HJ,,88.89,-55349.52
2032,8/12/2020,8/12/2020,Joseph Zarate,Imported from Bank of America Visa-New hire equipment,,HJ,,88.89,-55438.41
2032,8/12/2020,8/12/2020,Joseph Zarate,Imported from Bank of America Visa-New hire equipment,,HJ,,88.89,-55527.3
2032,8/12/2020,8/12/2020,Joseph Zarate,Imported from Bank of America Visa-New hire equipment,,HJ,,88.89,-55616.19
2032,8/12/2020,8/12/2020,Joseph Zarate,Imported from Bank of America Visa-New hire equipment,,HJ,,88.89,-55705.08
2032,8/12/2020,8/12/2020,Joseph Zarate,Imported from Bank of America Visa-New hire equipment,,HJ,,88.89,-55793.97
2032,8/12/2020,8/12/2020,Joseph Zarate,Imported from Bank of America Visa-New hire equipment,,HJ,,88.89,-55882.86
2032,8/12/2020,8/12/2020,Joseph Zarate,Imported from Bank of America Visa-New hire equipment,,HJ,,88.89,-55971.75
2032,8/12/2020,8/12/2020,Joseph Zarate,Imported from Bank of America Visa-New hire equipment,,HJ,,88.89,-56060.64
2032,8/12/2020,8/12/2020,Joseph Zarate,Imported from Bank of America Visa-New hire equipment,,HJ,,88.89,-56149.53
2032,8/12/2020,8/12/2020,Joseph Zarate,Imported from Bank of America Visa-New hire equipment,,HJ,,88.89,-56238.42
2032,8/12/2020,8/12/2020,Joseph Zarate,Imported from Bank of America Visa-New hire equipment,,HJ,,88.89,-56327.31
2032,8/12/2020,8/12/2020,Joseph Zarate,Imported from Bank of America Visa-New hire equipment,,HJ,,88.89,-56416.2
2032,8/12/2020,8/12/2020,Joseph Zarate,Imported from Bank of America Visa-New hire equipment,,HJ,,88.89,-56505.09
2032,8/12/2020,8/12/2020,Joseph Zarate,Imported from Bank of America Visa-New hire equipment,,HJ,,88.89,-56593.98
2032,8/12/2020,8/12/2020,Joseph Zarate,Imported from Bank of America Visa-New hire equipment,,HJ,,88.89,-56682.87
2032,8/12/2020,8/12/2020,Joseph Zarate,Imported from Bank of America Visa-New hire equipment,,HJ,,88.89,-56771.76
2032,8/12/2020,8/12/2020,Joseph Zarate,Imported from Bank of America Visa-New hire equipment,,HJ,,88.89,-56860.65
2032,8/12/2020,8/12/2020,Joseph Zarate,Imported from Bank of America Visa-New hire equipment,,HJ,,94.22,-56954.87
2032,8/12/2020,8/12/2020,Joseph Zarate,Imported from Bank of America Visa-New hire equipment,,HJ,,94.53,-57049.4
2032,8/12/2020,8/12/2020,Joseph Zarate,Imported from Bank of America Visa-New hire equipment,,HJ,,95.11,-57144.51
2032,8/12/2020,8/12/2020,Joseph Zarate,Imported from Bank of America Visa-New hire equipment,,HJ,,95.11,-57239.62
2032,8/12/2020,8/12/2020,Joseph Zarate,Imported from Bank of America Visa-New hire equipment,,HJ,,95.11,-57334.73
2032,8/12/2020,8/12/2020,Joseph Zarate,Imported from Bank of America Visa-New hire equipment,,HJ,,96.45,-57431.18
2032,8/12/2020,8/12/2020,Joseph Zarate,Imported from Bank of America Visa-New hire equipment.returns,,HJ,,22.8,-57453.98
2032,8/12/2020,8/12/2020,Joseph Zarate,Imported from Bank of America Visa-New hire equipment.returns,,HJ,,45.15,-57499.13
2032,8/12/2020,8/12/2020,Joseph Zarate,Imported from Bank of America Visa-Return Equipment,,HJ,,21.1,-57520.23
2032,8/12/2020,8/12/2020,Lisa Kapusta,Imported from Bank of America Visa-Staff Challenge PRIZE,,HJ,,16.97,-57537.2
2032,8/12/2020,8/12/2020,Lisa Kapusta,Imported from Bank of America Visa-Staff competition PRIZE,,HJ,,16.97,-57554.17
2032,8/12/2020,8/12/2020,Lisa Kapusta,Imported from Bank of America Visa-Staff competition Prize,,HJ,,16.97,-57571.14
2032,8/12/2020,8/12/2020,Lisa Kapusta,Imported from Bank of America Visa-Staff competition prize,,HJ,,16.97,-57588.11
2032,8/12/2020,8/12/2020,Lisa Kapusta,Imported from Bank of America Visa-Staff competition prize,,HJ,,16.97,-57605.08
2032,8/12/2020,8/12/2020,Mahaliah Sejour,Imported from Bank of America Visa-Adobe video editor,,HJ,,21.24,-57626.32
2032,8/12/2020,8/12/2020,Uriel Guadarrama,Imported from Bank of America Visa-Fee for purchasing Document Studio from an Indian company,,HJ,,0.78,-57627.1
2032,8/13/2020,8/13/2020,Alan Safran,Imported from Bank of America Visa-Background checks for fellows,,HJ,,3.16,-57630.26
2032,8/13/2020,8/13/2020,Alan Safran,Imported from Bank of America Visa-Background checks for fellows,,HJ,,3.16,-57633.42
2032,8/13/2020,8/13/2020,Alan Safran,Imported from Bank of America Visa-Background checks for fellows,,HJ,,3.16,-57636.58
2032,8/13/2020,8/13/2020,Alan Safran,Imported from Bank of America Visa-Background checks for fellows,,HJ,,4.02,-57640.6
2032,8/13/2020,8/13/2020,Alan Safran,Imported from Bank of America Visa-Background checks for fellows,,HJ,,4.89,-57645.49
2032,8/13/2020,8/13/2020,Alan Safran,Imported from Bank of America Visa-Background checks for fellows,,HJ,,4.89,-57650.38
2032,8/13/2020,8/13/2020,Alan Safran,Imported from Bank of America Visa-Background checks for fellows,,HJ,,4.89,-57655.27
2032,8/13/2020,8/13/2020,Alan Safran,Imported from Bank of America Visa-Background checks for fellows,,HJ,,4.89,-57660.16
2032,8/13/2020,8/13/2020,Alan Safran,Imported from Bank of America Visa-Background checks for fellows,,HJ,,4.89,-57665.05
2032,8/13/2020,8/13/2020,Alan Safran,Imported from Bank of America Visa-Background checks for fellows,,HJ,,4.89,-57669.94
2032,8/13/2020,8/13/2020,Alan Safran,Imported from Bank of America Visa-Background checks for fellows,,HJ,,5.56,-57675.5
2032,8/13/2020,8/13/2020,Alan Safran,Imported from Bank of America Visa-Background checks for fellows,,HJ,,6.2,-57681.7
2032,8/13/2020,8/13/2020,Alan Safran,Imported from Bank of America Visa-Background checks for fellows,,HJ,,6.21,-57687.91
2032,8/13/2020,8/13/2020,Alan Safran,Imported from Bank of America Visa-Background checks for fellows,,HJ,,6.71,-57694.62
2032,8/13/2020,8/13/2020,Alan Safran,Imported from Bank of America Visa-Background checks for fellows,,HJ,,7.81,-57702.43
2032,8/13/2020,8/13/2020,Alan Safran,Imported from Bank of America Visa-Background checks for fellows,,HJ,,8.09,-57710.52
2032,8/13/2020,8/13/2020,Alan Safran,Imported from Bank of America Visa-Background checks for fellows,,HJ,,8.58,-57719.1
2032,8/13/2020,8/13/2020,Alan Safran,Imported from Bank of America Visa-Background checks for fellows,,HJ,,8.59,-57727.69
2032,8/13/2020,8/13/2020,Alan Safran,Imported from Bank of America Visa-Background checks for fellows,,HJ,,10.37,-57738.06
2032,8/13/2020,8/13/2020,Alan Safran,Imported from Bank of America Visa-Background checks for fellows,,HJ,,10.37,-57748.43
2032,8/13/2020,8/13/2020,Alan Safran,Imported from Bank of America Visa-Background checks for fellows,,HJ,,12.07,-57760.5
2032,8/13/2020,8/13/2020,Alan Safran,Imported from Bank of America Visa-Background checks for fellows,,HJ,,12.07,-57772.57
2032,8/13/2020,8/13/2020,Alan Safran,Imported from Bank of America Visa-Background checks for fellows,,HJ,,12.49,-57785.06
2032,8/13/2020,8/13/2020,Alan Safran,Imported from Bank of America Visa-Background checks for fellows,,HJ,,12.5,-57797.56
2032,8/13/2020,8/13/2020,Alan Safran,Imported from Bank of America Visa-Background checks for fellows,,HJ,,15.81,-57813.37
2032,8/13/2020,8/13/2020,Alan Safran,Imported from Bank of America Visa-Background checks for fellows,,HJ,,15.81,-57829.18
2032,8/13/2020,8/13/2020,Alan Safran,Imported from Bank of America Visa-Background checks for fellows,,HJ,,15.81,-57844.99
2032,8/13/2020,8/13/2020,Alan Safran,Imported from Bank of America Visa-Background checks for fellows,,HJ,,20.07,-57865.06
2032,8/13/2020,8/13/2020,Alan Safran,Imported from Bank of America Visa-Background checks for fellows,,HJ,,27.77,-57892.83
2032,8/13/2020,8/13/2020,Alan Safran,Imported from Bank of America Visa-Background checks for fellows,,HJ,,33.55,-57926.38
2032,8/13/2020,8/13/2020,Alan Safran,Imported from Bank of America Visa-Background checks for fellows,,HJ,,39.05,-57965.43
2032,8/13/2020,8/13/2020,Alan Safran,Imported from Bank of America Visa-Background checks for fellows,,HJ,,40.42,-58005.85
2032,8/13/2020,8/13/2020,Chris D PLACEHOLDER,Imported from Bank of America Visa-Book prize sent to employee,,HJ,,15.7,-58021.55
2032,8/13/2020,8/13/2020,Joseph Zarate,Imported from Bank of America Visa-New hire equipment,,HJ,,9.98,-58031.53
2032,8/13/2020,8/13/2020,Joseph Zarate,Imported from Bank of America Visa-New hire equipment,,HJ,,9.98,-58041.51
2032,8/13/2020,8/13/2020,Joseph Zarate,Imported from Bank of America Visa-New hire equipment,,HJ,,9.98,-58051.49
2032,8/13/2020,8/13/2020,Joseph Zarate,Imported from Bank of America Visa-New hire equipment,,HJ,,9.98,-58061.47
2032,8/13/2020,8/13/2020,Joseph Zarate,Imported from Bank of America Visa-New hire equipment,,HJ,,9.98,-58071.45
2032,8/13/2020,8/13/2020,Joseph Zarate,Imported from Bank of America Visa-New hire equipment,,HJ,,9.98,-58081.43
2032,8/13/2020,8/13/2020,Joseph Zarate,Imported from Bank of America Visa-New hire equipment,,HJ,,9.98,-58091.41
2032,8/13/2020,8/13/2020,Joseph Zarate,Imported from Bank of America Visa-New hire equipment,,HJ,,9.98,-58101.39
2032,8/13/2020,8/13/2020,Joseph Zarate,Imported from Bank of America Visa-New hire equipment,,HJ,,9.98,-58111.37
2032,8/13/2020,8/13/2020,Joseph Zarate,Imported from Bank of America Visa-New hire equipment,,HJ,,9.98,-58121.35
2032,8/13/2020,8/13/2020,Joseph Zarate,Imported from Bank of America Visa-New hire equipment,,HJ,,9.98,-58131.33
2032,8/13/2020,8/13/2020,Joseph Zarate,Imported from Bank of America Visa-New hire equipment,,HJ,,9.98,-58141.31
2032,8/13/2020,8/13/2020,Joseph Zarate,Imported from Bank of America Visa-New hire equipment,,HJ,,9.98,-58151.29
2032,8/13/2020,8/13/2020,Joseph Zarate,Imported from Bank of America Visa-New hire equipment,,HJ,,9.98,-58161.27
2032,8/13/2020,8/13/2020,Joseph Zarate,Imported from Bank of America Visa-New hire equipment,,HJ,,10.68,-58171.95
2032,8/13/2020,8/13/2020,Joseph Zarate,Imported from Bank of America Visa-New hire equipment,,HJ,,10.99,-58182.94
2032,8/13/2020,8/13/2020,Joseph Zarate,Imported from Bank of America Visa-New hire equipment,,HJ,,14.99,-58197.93
2032,8/13/2020,8/13/2020,Joseph Zarate,Imported from Bank of America Visa-New hire equipment,,HJ,,19.75,-58217.68
2032,8/13/2020,8/13/2020,Joseph Zarate,Imported from Bank of America Visa-New hire equipment,,HJ,,19.75,-58237.43
2032,8/13/2020,8/13/2020,Joseph Zarate,Imported from Bank of America Visa-New hire equipment,,HJ,,19.75,-58257.18
2032,8/13/2020,8/13/2020,Joseph Zarate,Imported from Bank of America Visa-New hire equipment,,HJ,,21.03,-58278.21
2032,8/13/2020,8/13/2020,Joseph Zarate,Imported from Bank of America Visa-New hire equipment,,HJ,,21.1,-58299.31
2032,8/13/2020,8/13/2020,Joseph Zarate,Imported from Bank of America Visa-New hire equipment,,HJ,,49.49,-58348.8
2032,8/13/2020,8/13/2020,Joseph Zarate,Imported from Bank of America Visa-New hire equipment,,HJ,,49.99,-58398.79
2032,8/13/2020,8/13/2020,Joseph Zarate,Imported from Bank of America Visa-New hire equipment,,HJ,,54.04,-58452.83
2032,8/13/2020,8/13/2020,Joseph Zarate,Imported from Bank of America Visa-New hire equipment,,HJ,,88.89,-58541.72
2032,8/13/2020,8/13/2020,Joseph Zarate,Imported from Bank of America Visa-New hire equipment,,HJ,,88.89,-58630.61
2032,8/13/2020,8/13/2020,Joseph Zarate,Imported from Bank of America Visa-New hire equipment,,HJ,,88.89,-58719.5
2032,8/13/2020,8/13/2020,Joseph Zarate,Imported from Bank of America Visa-New hire equipment,,HJ,,88.89,-58808.39
2032,8/13/2020,8/13/2020,Joseph Zarate,Imported from Bank of America Visa-New hire equipment,,HJ,,88.89,-58897.28
2032,8/13/2020,8/13/2020,Joseph Zarate,Imported from Bank of America Visa-New hire equipment,,HJ,,94.22,-58991.5
2032,8/13/2020,8/13/2020,Joseph Zarate,Imported from Bank of America Visa-New hire equipment,,HJ,,95.33,-59086.83
2032,8/13/2020,8/13/2020,Joseph Zarate,Imported from Bank of America Visa-New hire equipment,,HJ,,97.33,-59184.16
2032,8/13/2020,8/13/2020,Joseph Zarate,Imported from Bank of America Visa-New hire equipment,,HJ,,104.68,-59288.84
2032,8/13/2020,8/13/2020,Joseph Zarate,Imported from Bank of America Visa-New hire equipment,,HJ,,140.67,-59429.51
2032,8/13/2020,8/13/2020,Joseph Zarate,Imported from Bank of America Visa-New hire equipment,,HJ,,260,-59689.51
2032,8/13/2020,8/13/2020,Joseph Zarate,Imported from Bank of America Visa-New hire equipment.returns,,HJ,,94.53,-59784.04
2032,8/13/2020,8/13/2020,Joseph Zarate,Imported from Bank of America Visa-equipment,,HJ,,9.98,-59794.02
2032,8/13/2020,8/13/2020,Joseph Zarate,Imported from Bank of America Visa-office supplies,,HJ,,4.4,-59798.42
2032,8/13/2020,8/13/2020,Joseph Zarate,Imported from Bank of America Visa-returns,,HJ,,15.05,-59813.47
2032,8/13/2020,8/13/2020,Monivett Acevedo,Imported from Bank of America Visa-Mouse pad,,HJ,,8.33,-59821.8
2032,8/13/2020,8/13/2020,Monivett Acevedo,Imported from Bank of America Visa-Ports for mouse and headset,,HJ,,7.89,-59829.69
2032,8/14/2020,8/14/2020,Alan Safran,Imported from Bank of America Visa-Background checks for fellows,,HJ,,3.16,-59832.85
2032,8/14/2020,8/14/2020,Alan Safran,Imported from Bank of America Visa-Background checks for fellows,,HJ,,3.16,-59836.01
2032,8/14/2020,8/14/2020,Alan Safran,Imported from Bank of America Visa-Background checks for fellows,,HJ,,3.16,-59839.17
2032,8/14/2020,8/14/2020,Alan Safran,Imported from Bank of America Visa-Background checks for fellows,,HJ,,4.02,-59843.19
2032,8/14/2020,8/14/2020,Alan Safran,Imported from Bank of America Visa-Background checks for fellows,,HJ,,4.89,-59848.08
2032,8/14/2020,8/14/2020,Alan Safran,Imported from Bank of America Visa-Background checks for fellows,,HJ,,4.89,-59852.97
2032,8/14/2020,8/14/2020,Alan Safran,Imported from Bank of America Visa-Background checks for fellows,,HJ,,4.89,-59857.86
2032,8/14/2020,8/14/2020,Alan Safran,Imported from Bank of America Visa-Background checks for fellows,,HJ,,4.89,-59862.75
2032,8/14/2020,8/14/2020,Alan Safran,Imported from Bank of America Visa-Background checks for fellows,,HJ,,4.89,-59867.64
2032,8/14/2020,8/14/2020,Alan Safran,Imported from Bank of America Visa-Background checks for fellows,,HJ,,4.89,-59872.53
2032,8/14/2020,8/14/2020,Alan Safran,Imported from Bank of America Visa-Background checks for fellows,,HJ,,6.2,-59878.73
2032,8/14/2020,8/14/2020,Alan Safran,Imported from Bank of America Visa-Background checks for fellows,,HJ,,6.21,-59884.94
2032,8/14/2020,8/14/2020,Alan Safran,Imported from Bank of America Visa-Background checks for fellows,,HJ,,13.48,-59898.42
2032,8/14/2020,8/14/2020,Alan Safran,Imported from Bank of America Visa-Background checks for fellows,,HJ,,13.48,-59911.9
2032,8/14/2020,8/14/2020,Alan Safran,Imported from Bank of America Visa-Background checks for fellows,,HJ,,15.81,-59927.71
2032,8/14/2020,8/14/2020,Alan Safran,Imported from Bank of America Visa-Background checks for fellows,,HJ,,15.81,-59943.52
2032,8/14/2020,8/14/2020,Alan Safran,Imported from Bank of America Visa-Background checks for fellows,,HJ,,15.81,-59959.33
2032,8/14/2020,8/14/2020,Alan Safran,Imported from Bank of America Visa-Background checks for fellows,,HJ,,20.07,-59979.4
2032,8/14/2020,8/14/2020,Alan Safran,Imported from Bank of America Visa-Background checks for fellows,,HJ,,20.82,-60000.22
2032,8/14/2020,8/14/2020,Alan Safran,Imported from Bank of America Visa-Background checks for fellows,,HJ,,20.82,-60021.04
2032,8/14/2020,8/14/2020,Alan Safran,Imported from Bank of America Visa-Background checks for fellows,,HJ,,20.83,-60041.87
2032,8/14/2020,8/14/2020,Alan Safran,Imported from Bank of America Visa-Background checks for fellows,,HJ,,20.83,-60062.7
2032,8/14/2020,8/14/2020,Alan Safran,Imported from Bank of America Visa-Background checks for fellows,,HJ,,67.37,-60130.07
2032,8/14/2020,8/14/2020,Alan Safran,Imported from Bank of America Visa-Background checks for fellows,,HJ,,67.37,-60197.44
2032,8/14/2020,8/14/2020,Antonio Gutierrez,Imported from Bank of America Visa-Professional Development,,HJ,,9.52,-60206.96
2032,8/14/2020,8/14/2020,Joseph Zarate,Imported from Bank of America Visa-New hire equipment,,HJ,,0.99,-60207.95
2032,8/14/2020,8/14/2020,Joseph Zarate,Imported from Bank of America Visa-New hire equipment,,HJ,,1,-60208.95
2032,8/14/2020,8/14/2020,Joseph Zarate,Imported from Bank of America Visa-New hire equipment,,HJ,,10.18,-60219.13
2032,8/14/2020,8/14/2020,Joseph Zarate,Imported from Bank of America Visa-New hire equipment,,HJ,,10.18,-60229.31
2032,8/14/2020,8/14/2020,Joseph Zarate,Imported from Bank of America Visa-New hire equipment,,HJ,,10.2,-60239.51
2032,8/14/2020,8/14/2020,Joseph Zarate,Imported from Bank of America Visa-New hire equipment,,HJ,,10.2,-60249.71
2032,8/14/2020,8/14/2020,Joseph Zarate,Imported from Bank of America Visa-New hire equipment,,HJ,,10.2,-60259.91
2032,8/14/2020,8/14/2020,Joseph Zarate,Imported from Bank of America Visa-New hire equipment,,HJ,,10.9,-60270.81
2032,8/14/2020,8/14/2020,Joseph Zarate,Imported from Bank of America Visa-New hire equipment,,HJ,,11.65,-60282.46
2032,8/14/2020,8/14/2020,Joseph Zarate,Imported from Bank of America Visa-New hire equipment,,HJ,,11.65,-60294.11
2032,8/14/2020,8/14/2020,Joseph Zarate,Imported from Bank of America Visa-New hire equipment,,HJ,,11.65,-60305.76
2032,8/14/2020,8/14/2020,Joseph Zarate,Imported from Bank of America Visa-New hire equipment,,HJ,,11.65,-60317.41
2032,8/14/2020,8/14/2020,Joseph Zarate,Imported from Bank of America Visa-New hire equipment,,HJ,,11.65,-60329.06
2032,8/14/2020,8/14/2020,Joseph Zarate,Imported from Bank of America Visa-New hire equipment,,HJ,,11.65,-60340.71
2032,8/14/2020,8/14/2020,Joseph Zarate,Imported from Bank of America Visa-New hire equipment,,HJ,,11.65,-60352.36
2032,8/14/2020,8/14/2020,Joseph Zarate,Imported from Bank of America Visa-New hire equipment,,HJ,,12.03,-60364.39
2032,8/14/2020,8/14/2020,Joseph Zarate,Imported from Bank of America Visa-New hire equipment,,HJ,,12.35,-60376.74
2032,8/14/2020,8/14/2020,Joseph Zarate,Imported from Bank of America Visa-New hire equipment,,HJ,,13.1,-60389.84
2032,8/14/2020,8/14/2020,Joseph Zarate,Imported from Bank of America Visa-New hire equipment,,HJ,,14.99,-60404.83
2032,8/14/2020,8/14/2020,Joseph Zarate,Imported from Bank of America Visa-New hire equipment,,HJ,,14.99,-60419.82
2032,8/14/2020,8/14/2020,Joseph Zarate,Imported from Bank of America Visa-New hire equipment,,HJ,,15.05,-60434.87
2032,8/14/2020,8/14/2020,Joseph Zarate,Imported from Bank of America Visa-New hire equipment,,HJ,,25.35,-60460.22
2032,8/14/2020,8/14/2020,Joseph Zarate,Imported from Bank of America Visa-New hire equipment,,HJ,,26.82,-60487.04
2032,8/14/2020,8/14/2020,Joseph Zarate,Imported from Bank of America Visa-New hire equipment,,HJ,,26.82,-60513.86
2032,8/14/2020,8/14/2020,Joseph Zarate,Imported from Bank of America Visa-New hire equipment,,HJ,,26.82,-60540.68
2032,8/14/2020,8/14/2020,Joseph Zarate,Imported from Bank of America Visa-New hire equipment,,HJ,,26.82,-60567.5
2032,8/14/2020,8/14/2020,Joseph Zarate,Imported from Bank of America Visa-New hire equipment,,HJ,,26.82,-60594.32
2032,8/14/2020,8/14/2020,Joseph Zarate,Imported from Bank of America Visa-New hire equipment,,HJ,,26.82,-60621.14
2032,8/14/2020,8/14/2020,Joseph Zarate,Imported from Bank of America Visa-New hire equipment,,HJ,,26.82,-60647.96
2032,8/14/2020,8/14/2020,Joseph Zarate,Imported from Bank of America Visa-New hire equipment,,HJ,,37.61,-60685.57
2032,8/14/2020,8/14/2020,Joseph Zarate,Imported from Bank of America Visa-New hire equipment,,HJ,,39.77,-60725.34
2032,8/14/2020,8/14/2020,Joseph Zarate,Imported from Bank of America Visa-New hire equipment,,HJ,,49.99,-60775.33
2032,8/14/2020,8/14/2020,Joseph Zarate,Imported from Bank of America Visa-New hire equipment,,HJ,,49.99,-60825.32
2032,8/14/2020,8/14/2020,Joseph Zarate,Imported from Bank of America Visa-New hire equipment,,HJ,,49.99,-60875.31
2032,8/14/2020,8/14/2020,Joseph Zarate,Imported from Bank of America Visa-New hire equipment,,HJ,,49.99,-60925.3
2032,8/14/2020,8/14/2020,Joseph Zarate,Imported from Bank of America Visa-New hire equipment,,HJ,,94.22,-61019.52
2032,8/14/2020,8/14/2020,Joseph Zarate,Imported from Bank of America Visa-New hire equipment,,HJ,,94.22,-61113.74
2032,8/14/2020,8/14/2020,Joseph Zarate,Imported from Bank of America Visa-New hire equipment,,HJ,,94.22,-61207.96
2032,8/14/2020,8/14/2020,Joseph Zarate,Imported from Bank of America Visa-New hire equipment,,HJ,,110.96,-61318.92
2032,8/14/2020,8/14/2020,Joseph Zarate,Imported from Bank of America Visa-New hire equipment,,HJ,,119.67,-61438.59
2032,8/14/2020,8/14/2020,Joseph Zarate,Imported from Bank of America Visa-New hire equipment,,HJ,,144.87,-61583.46
2032,8/14/2020,8/14/2020,Joseph Zarate,Imported from Bank of America Visa-New hire equipment,,HJ,,148.33,-61731.79
2032,8/14/2020,8/14/2020,Joseph Zarate,Imported from Bank of America Visa-New hire equipment,,HJ,,202.58,-61934.37
2032,8/14/2020,8/14/2020,Joseph Zarate,Imported from Bank of America Visa-New hire equipment,,HJ,,324.8,-62259.17
2032,8/14/2020,8/14/2020,Joseph Zarate,Imported from Bank of America Visa-New hire equipment,,HJ,,579,-62838.17
2032,8/14/2020,8/14/2020,Joseph Zarate,Imported from Bank of America Visa-Return Equipment,,HJ,,21.1,-62859.27
2032,8/14/2020,8/14/2020,Joseph Zarate,Imported from Bank of America Visa-equipment,,HJ,,16.41,-62875.68
2032,8/14/2020,8/14/2020,Joseph Zarate,Imported from Bank of America Visa-returns,,HJ,,21.1,-62896.78
2032,8/14/2020,8/14/2020,Maryellen Leneghan,Imported from Bank of America Visa-Fellow Appreciation during training,,HJ,,14.08,-62910.86
2032,8/14/2020,8/14/2020,Myesha Hossain,Imported from Bank of America Visa-Packaging supplies,,HJ,,8.7,-62919.56
2032,8/14/2020,8/14/2020,Uriel Guadarrama,Imported from Bank of America Visa-Adobe apps for Mahaliah and Myesha,,HJ,,5.94,-62925.5
2032,8/14/2020,8/14/2020,Uriel Guadarrama,Imported from Bank of America Visa-Adobe apps for Mahaliah and Myesha,,HJ,,9.18,-62934.68
2032,8/14/2020,8/14/2020,Uriel Guadarrama,Imported from Bank of America Visa-Adobe apps for Mahaliah and Myesha,,HJ,,9.18,-62943.86
2032,8/14/2020,8/14/2020,Uriel Guadarrama,Imported from Bank of America Visa-Adobe apps for Mahaliah and Myesha,,HJ,,29.7,-62973.56
2032,8/15/2020,8/15/2020,Alan Safran,Imported from Bank of America Visa-Background checks for fellows,,HJ,,3.16,-62976.72
2032,8/15/2020,8/15/2020,Alan Safran,Imported from Bank of America Visa-Background checks for fellows,,HJ,,3.16,-62979.88
2032,8/15/2020,8/15/2020,Alan Safran,Imported from Bank of America Visa-Background checks for fellows,,HJ,,4.89,-62984.77
2032,8/15/2020,8/15/2020,Alan Safran,Imported from Bank of America Visa-Background checks for fellows,,HJ,,4.89,-62989.66
2032,8/15/2020,8/15/2020,Alan Safran,Imported from Bank of America Visa-Background checks for fellows,,HJ,,4.89,-62994.55
2032,8/15/2020,8/15/2020,Alan Safran,Imported from Bank of America Visa-Background checks for fellows,,HJ,,4.89,-62999.44
2032,8/15/2020,8/15/2020,Alan Safran,Imported from Bank of America Visa-Background checks for fellows,,HJ,,13.48,-63012.92
2032,8/15/2020,8/15/2020,Alan Safran,Imported from Bank of America Visa-Background checks for fellows,,HJ,,15.81,-63028.73
2032,8/15/2020,8/15/2020,Alan Safran,Imported from Bank of America Visa-Background checks for fellows,,HJ,,15.81,-63044.54
2032,8/15/2020,8/15/2020,Alan Safran,Imported from Bank of America Visa-Background checks for fellows,,HJ,,20.82,-63065.36
2032,8/15/2020,8/15/2020,Alan Safran,Imported from Bank of America Visa-Background checks for fellows,,HJ,,20.83,-63086.19
2032,8/15/2020,8/15/2020,Alan Safran,Imported from Bank of America Visa-Background checks for fellows,,HJ,,67.37,-63153.56
2032,8/15/2020,8/15/2020,Joseph Zarate,Imported from Bank of America Visa-New hire equipment,,HJ,,9.98,-63163.54
2032,8/15/2020,8/15/2020,Joseph Zarate,Imported from Bank of America Visa-New hire equipment,,HJ,,10.18,-63173.72
2032,8/15/2020,8/15/2020,Joseph Zarate,Imported from Bank of America Visa-New hire equipment,,HJ,,10.18,-63183.9
2032,8/15/2020,8/15/2020,Joseph Zarate,Imported from Bank of America Visa-New hire equipment,,HJ,,10.18,-63194.08
2032,8/15/2020,8/15/2020,Joseph Zarate,Imported from Bank of America Visa-New hire equipment,,HJ,,10.18,-63204.26
2032,8/15/2020,8/15/2020,Joseph Zarate,Imported from Bank of America Visa-New hire equipment,,HJ,,10.18,-63214.44
2032,8/15/2020,8/15/2020,Joseph Zarate,Imported from Bank of America Visa-New hire equipment,,HJ,,10.18,-63224.62
2032,8/15/2020,8/15/2020,Joseph Zarate,Imported from Bank of America Visa-New hire equipment,,HJ,,10.88,-63235.5
2032,8/15/2020,8/15/2020,Joseph Zarate,Imported from Bank of America Visa-New hire equipment,,HJ,,11.46,-63246.96
2032,8/15/2020,8/15/2020,Joseph Zarate,Imported from Bank of America Visa-New hire equipment,,HJ,,11.46,-63258.42
2032,8/15/2020,8/15/2020,Joseph Zarate,Imported from Bank of America Visa-New hire equipment,,HJ,,11.65,-63270.07
2032,8/15/2020,8/15/2020,Joseph Zarate,Imported from Bank of America Visa-New hire equipment,,HJ,,11.65,-63281.72
2032,8/15/2020,8/15/2020,Joseph Zarate,Imported from Bank of America Visa-New hire equipment,,HJ,,11.65,-63293.37
2032,8/15/2020,8/15/2020,Joseph Zarate,Imported from Bank of America Visa-New hire equipment,,HJ,,11.65,-63305.02
2032,8/15/2020,8/15/2020,Joseph Zarate,Imported from Bank of America Visa-New hire equipment,,HJ,,11.65,-63316.67
2032,8/15/2020,8/15/2020,Joseph Zarate,Imported from Bank of America Visa-New hire equipment,,HJ,,11.65,-63328.32
2032,8/15/2020,8/15/2020,Joseph Zarate,Imported from Bank of America Visa-New hire equipment,,HJ,,11.65,-63339.97
2032,8/15/2020,8/15/2020,Joseph Zarate,Imported from Bank of America Visa-New hire equipment,,HJ,,11.65,-63351.62
2032,8/15/2020,8/15/2020,Joseph Zarate,Imported from Bank of America Visa-New hire equipment,,HJ,,11.65,-63363.27
2032,8/15/2020,8/15/2020,Joseph Zarate,Imported from Bank of America Visa-New hire equipment,,HJ,,11.65,-63374.92
2032,8/15/2020,8/15/2020,Joseph Zarate,Imported from Bank of America Visa-New hire equipment,,HJ,,24.83,-63399.75
2032,8/15/2020,8/15/2020,Joseph Zarate,Imported from Bank of America Visa-New hire equipment,,HJ,,88.89,-63488.64
2032,8/15/2020,8/15/2020,Joseph Zarate,Imported from Bank of America Visa-New hire equipment,,HJ,,94.22,-63582.86
2032,8/15/2020,8/15/2020,Joseph Zarate,Imported from Bank of America Visa-New hire equipment,,HJ,,95.45,-63678.31
2032,8/15/2020,8/15/2020,Joseph Zarate,Imported from Bank of America Visa-New hire equipment,,HJ,,145.56,-63823.87
2032,8/15/2020,8/15/2020,Joseph Zarate,Imported from Bank of America Visa-New hire equipment,,HJ,,295,-64118.87
2032,8/15/2020,8/15/2020,Joseph Zarate,Imported from Bank of America Visa-New hire equipment,,HJ,,316.39,-64435.26
2032,8/15/2020,8/15/2020,Mahaliah Sejour,Imported from Bank of America Visa-Adobe trial refund,,HJ,21.24,,-64414.02
2032,8/16/2020,8/16/2020,Alan Safran,Imported from Bank of America Visa-Background checks for fellows,,HJ,,3.16,-64417.18
2032,8/16/2020,8/16/2020,Alan Safran,Imported from Bank of America Visa-Background checks for fellows,,HJ,,4.02,-64421.2
2032,8/16/2020,8/16/2020,Alan Safran,Imported from Bank of America Visa-Background checks for fellows,,HJ,,4.89,-64426.09
2032,8/16/2020,8/16/2020,Alan Safran,Imported from Bank of America Visa-Background checks for fellows,,HJ,,4.89,-64430.98
2032,8/16/2020,8/16/2020,Alan Safran,Imported from Bank of America Visa-Background checks for fellows,,HJ,,6.2,-64437.18
2032,8/16/2020,8/16/2020,Alan Safran,Imported from Bank of America Visa-Background checks for fellows,,HJ,,6.21,-64443.39
2032,8/16/2020,8/16/2020,Alan Safran,Imported from Bank of America Visa-Background checks for fellows,,HJ,,13.48,-64456.87
2032,8/16/2020,8/16/2020,Alan Safran,Imported from Bank of America Visa-Background checks for fellows,,HJ,,13.48,-64470.35
2032,8/16/2020,8/16/2020,Alan Safran,Imported from Bank of America Visa-Background checks for fellows,,HJ,,15.81,-64486.16
2032,8/16/2020,8/16/2020,Alan Safran,Imported from Bank of America Visa-Background checks for fellows,,HJ,,20.07,-64506.23
2032,8/16/2020,8/16/2020,Alan Safran,Imported from Bank of America Visa-Background checks for fellows,,HJ,,20.82,-64527.05
2032,8/16/2020,8/16/2020,Alan Safran,Imported from Bank of America Visa-Background checks for fellows,,HJ,,20.82,-64547.87
2032,8/16/2020,8/16/2020,Alan Safran,Imported from Bank of America Visa-Background checks for fellows,,HJ,,20.83,-64568.7
2032,8/16/2020,8/16/2020,Alan Safran,Imported from Bank of America Visa-Background checks for fellows,,HJ,,20.83,-64589.53
2032,8/16/2020,8/16/2020,Alan Safran,Imported from Bank of America Visa-Background checks for fellows,,HJ,,67.37,-64656.9
2032,8/16/2020,8/16/2020,Alan Safran,Imported from Bank of America Visa-Background checks for fellows,,HJ,,67.37,-64724.27
2032,8/16/2020,8/16/2020,Joseph Zarate,Imported from Bank of America Visa-New hire equipment,,HJ,,88.89,-64813.16
2032,8/16/2020,8/16/2020,Joseph Zarate,Imported from Bank of America Visa-New hire equipment,,HJ,,119.62,-64932.78
2032,8/16/2020,8/16/2020,Mahaliah Sejour,Imported from Bank of America Visa-MS printer,,HJ,,5.35,-64938.13
2032,8/16/2020,8/16/2020,Monivett Acevedo,Imported from Bank of America Visa-Office Supplies,,HJ,,5.3,-64943.43
2032,8/17/2020,8/17/2020,Alan Safran,Imported from Bank of America Visa-Background checks for fellows,,HJ,,0.83,-64944.26
2032,8/17/2020,8/17/2020,Alan Safran,Imported from Bank of America Visa-Background checks for fellows,,HJ,,1.27,-64945.53
2032,8/17/2020,8/17/2020,Alan Safran,Imported from Bank of America Visa-Background checks for fellows,,HJ,,1.28,-64946.81
2032,8/17/2020,8/17/2020,Alan Safran,Imported from Bank of America Visa-Background checks for fellows,,HJ,,3.16,-64949.97
2032,8/17/2020,8/17/2020,Alan Safran,Imported from Bank of America Visa-Background checks for fellows,,HJ,,3.16,-64953.13
2032,8/17/2020,8/17/2020,Alan Safran,Imported from Bank of America Visa-Background checks for fellows,,HJ,,4.02,-64957.15
2032,8/17/2020,8/17/2020,Alan Safran,Imported from Bank of America Visa-Background checks for fellows,,HJ,,4.02,-64961.17
2032,8/17/2020,8/17/2020,Alan Safran,Imported from Bank of America Visa-Background checks for fellows,,HJ,,4.12,-64965.29
2032,8/17/2020,8/17/2020,Alan Safran,Imported from Bank of America Visa-Background checks for fellows,,HJ,,4.89,-64970.18
2032,8/17/2020,8/17/2020,Alan Safran,Imported from Bank of America Visa-Background checks for fellows,,HJ,,4.89,-64975.07
2032,8/17/2020,8/17/2020,Alan Safran,Imported from Bank of America Visa-Background checks for fellows,,HJ,,4.89,-64979.96
2032,8/17/2020,8/17/2020,Alan Safran,Imported from Bank of America Visa-Background checks for fellows,,HJ,,4.89,-64984.85
2032,8/17/2020,8/17/2020,Alan Safran,Imported from Bank of America Visa-Background checks for fellows,,HJ,,6.2,-64991.05
2032,8/17/2020,8/17/2020,Alan Safran,Imported from Bank of America Visa-Background checks for fellows,,HJ,,6.2,-64997.25
2032,8/17/2020,8/17/2020,Alan Safran,Imported from Bank of America Visa-Background checks for fellows,,HJ,,6.21,-65003.46
2032,8/17/2020,8/17/2020,Alan Safran,Imported from Bank of America Visa-Background checks for fellows,,HJ,,6.21,-65009.67
2032,8/17/2020,8/17/2020,Alan Safran,Imported from Bank of America Visa-Background checks for fellows,,HJ,,6.51,-65016.18
2032,8/17/2020,8/17/2020,Alan Safran,Imported from Bank of America Visa-Background checks for fellows,,HJ,,10.06,-65026.24
2032,8/17/2020,8/17/2020,Alan Safran,Imported from Bank of America Visa-Background checks for fellows,,HJ,,10.06,-65036.3
2032,8/17/2020,8/17/2020,Alan Safran,Imported from Bank of America Visa-Background checks for fellows,,HJ,,15.81,-65052.11
2032,8/17/2020,8/17/2020,Alan Safran,Imported from Bank of America Visa-Background checks for fellows,,HJ,,15.81,-65067.92
2032,8/17/2020,8/17/2020,Alan Safran,Imported from Bank of America Visa-Background checks for fellows,,HJ,,19.03,-65086.95
2032,8/17/2020,8/17/2020,Alan Safran,Imported from Bank of America Visa-Background checks for fellows,,HJ,,20.07,-65107.02
2032,8/17/2020,8/17/2020,Alan Safran,Imported from Bank of America Visa-Background checks for fellows,,HJ,,20.07,-65127.09
2032,8/17/2020,8/17/2020,Alan Safran,Imported from Bank of America Visa-Background checks for fellows,,HJ,,29.41,-65156.5
2032,8/17/2020,8/17/2020,Alan Safran,Imported from Bank of America Visa-Background checks for fellows,,HJ,,29.41,-65185.91
2032,8/17/2020,8/17/2020,Alan Safran,Imported from Bank of America Visa-Background checks for fellows,,HJ,,32.52,-65218.43
2032,8/17/2020,8/17/2020,Alan Safran,Imported from Bank of America Visa-Background checks for fellows,,HJ,,95.15,-65313.58
2032,8/17/2020,8/17/2020,BA8BDBABF6A048FD8056,Imported from Bank of America Visa-Mailing Welcome Packages,,HJ,,39.55,-65353.13
2032,8/17/2020,8/17/2020,Halley Bowman,Imported from Bank of America Visa-Staff bookclub,,HJ,,1.75,-65354.88
2032,8/17/2020,8/17/2020,Halley Bowman,Imported from Bank of America Visa-Staff bookclub,,HJ,,2.7,-65357.58
2032,8/17/2020,8/17/2020,Halley Bowman,Imported from Bank of America Visa-Staff bookclub,,HJ,,2.7,-65360.28
2032,8/17/2020,8/17/2020,Halley Bowman,Imported from Bank of America Visa-Staff bookclub,,HJ,,8.74,-65369.02
2032,8/17/2020,8/17/2020,Joseph Zarate,Imported from Bank of America Visa-New hire equipment,,HJ,,1,-65370.02
2032,8/17/2020,8/17/2020,Joseph Zarate,Imported from Bank of America Visa-New hire equipment,,HJ,,1,-65371.02
2032,8/17/2020,8/17/2020,Joseph Zarate,Imported from Bank of America Visa-New hire equipment,,HJ,,1,-65372.02
2032,8/17/2020,8/17/2020,Joseph Zarate,Imported from Bank of America Visa-New hire equipment,,HJ,,1,-65373.02
2032,8/17/2020,8/17/2020,Joseph Zarate,Imported from Bank of America Visa-New hire equipment,,HJ,,2.16,-65375.18
2032,8/17/2020,8/17/2020,Joseph Zarate,Imported from Bank of America Visa-New hire equipment,,HJ,,4.15,-65379.33
2032,8/17/2020,8/17/2020,Joseph Zarate,Imported from Bank of America Visa-New hire equipment,,HJ,,4.15,-65383.48
2032,8/17/2020,8/17/2020,Joseph Zarate,Imported from Bank of America Visa-New hire equipment,,HJ,,8.3,-65391.78
2032,8/17/2020,8/17/2020,Joseph Zarate,Imported from Bank of America Visa-New hire equipment,,HJ,,16.04,-65407.82
2032,8/17/2020,8/17/2020,Joseph Zarate,Imported from Bank of America Visa-New hire equipment,,HJ,,50.2,-65458.02
2032,8/17/2020,8/17/2020,Joseph Zarate,Imported from Bank of America Visa-New hire equipment,,HJ,,58.1,-65516.12
2032,8/17/2020,8/17/2020,Joseph Zarate,Imported from Bank of America Visa-Return Equipment,,HJ,,15.05,-65531.17
2032,8/17/2020,8/17/2020,Lativa Holder,Imported from Bank of America Visa-Storage Unit,,HJ,,105.5,-65636.67
2032,8/17/2020,8/17/2020,Maryellen Leneghan,Imported from Bank of America Visa-Fellow Appreciation during training,,HJ,,10.59,-65647.26
2032,8/17/2020,8/17/2020,Myesha Hossain,Imported from Bank of America Visa-Fingerprinting,,HJ,,135,-65782.26
2032,8/17/2020,8/17/2020,Nicole Prahin,Imported from Bank of America Visa-Google drive storage space,,HJ,,2.13,-65784.39
2032,8/17/2020,8/17/2020,Uriel Guadarrama,Imported from Bank of America Visa-Document Studio for Jashive,,HJ,,59.4,-65843.79
2032,8/18/2020,8/18/2020,Alan Safran,Imported from Bank of America Visa-Background checks for fellows,,HJ,,3.16,-65846.95
2032,8/18/2020,8/18/2020,Alan Safran,Imported from Bank of America Visa-Background checks for fellows,,HJ,,4.89,-65851.84
2032,8/18/2020,8/18/2020,Alan Safran,Imported from Bank of America Visa-Background checks for fellows,,HJ,,4.89,-65856.73
2032,8/18/2020,8/18/2020,Alan Safran,Imported from Bank of America Visa-Background checks for fellows,,HJ,,10.45,-65867.18
2032,8/18/2020,8/18/2020,Alan Safran,Imported from Bank of America Visa-Background checks for fellows,,HJ,,15.81,-65882.99
2032,8/18/2020,8/18/2020,Alan Safran,Imported from Bank of America Visa-Background checks for fellows,,HJ,,16.15,-65899.14
2032,8/18/2020,8/18/2020,Alan Safran,Imported from Bank of America Visa-Background checks for fellows,,HJ,,16.15,-65915.29
2032,8/18/2020,8/18/2020,Alan Safran,Imported from Bank of America Visa-Background checks for fellows,,HJ,,52.25,-65967.54
2032,8/18/2020,8/18/2020,Alan Safran,Imported from Bank of America Visa-HP Instant INK for Alan,,HJ,,10.61,-65978.15
2032,8/18/2020,8/18/2020,Amena Wallace,Imported from Bank of America Visa-Office Supplies,,HJ,,7.99,-65986.14
2032,8/18/2020,8/18/2020,Elizabeth Peinado,Imported from Bank of America Visa-Fellow Staff advertising. Brand Awareness,,HJ,,6.6,-65992.74
2032,8/18/2020,8/18/2020,Elizabeth Peinado,Imported from Bank of America Visa-Fellow Staff advertising. Brand Awareness,,HJ,,10.2,-66002.94
2032,8/18/2020,8/18/2020,Elizabeth Peinado,Imported from Bank of America Visa-Fellow Staff advertising. Brand Awareness,,HJ,,10.2,-66013.14
2032,8/18/2020,8/18/2020,Elizabeth Peinado,Imported from Bank of America Visa-Fellow Staff advertising. Brand Awareness,,HJ,,33,-66046.14
2032,8/18/2020,8/18/2020,Joseph Zarate,Imported from Bank of America Visa-New hire equipment,,HJ,,7.75,-66053.89
2032,8/18/2020,8/18/2020,Joseph Zarate,Imported from Bank of America Visa-New hire equipment,,HJ,,15.05,-66068.94
2032,8/18/2020,8/18/2020,Joseph Zarate,Imported from Bank of America Visa-New hire equipment,,HJ,,15.15,-66084.09
2032,8/18/2020,8/18/2020,Joseph Zarate,Imported from Bank of America Visa-New hire equipment,,HJ,,16.05,-66100.14
2032,8/18/2020,8/18/2020,Joseph Zarate,Imported from Bank of America Visa-New hire equipment,,HJ,,16.05,-66116.19
2032,8/18/2020,8/18/2020,Joseph Zarate,Imported from Bank of America Visa-New hire equipment,,HJ,,16.05,-66132.24
2032,8/18/2020,8/18/2020,Joseph Zarate,Imported from Bank of America Visa-New hire equipment,,HJ,,16.06,-66148.3
2032,8/18/2020,8/18/2020,Joseph Zarate,Imported from Bank of America Visa-New hire equipment,,HJ,,16.06,-66164.36
2032,8/18/2020,8/18/2020,Joseph Zarate,Imported from Bank of America Visa-New hire equipment,,HJ,,16.06,-66180.42
2032,8/18/2020,8/18/2020,Joseph Zarate,Imported from Bank of America Visa-New hire equipment,,HJ,,16.06,-66196.48
2032,8/18/2020,8/18/2020,Joseph Zarate,Imported from Bank of America Visa-New hire equipment,,HJ,,19.01,-66215.49
2032,8/18/2020,8/18/2020,Joseph Zarate,Imported from Bank of America Visa-New hire equipment,,HJ,,19.01,-66234.5
2032,8/18/2020,8/18/2020,Joseph Zarate,Imported from Bank of America Visa-New hire equipment,,HJ,,19.01,-66253.51
2032,8/18/2020,8/18/2020,Joseph Zarate,Imported from Bank of America Visa-New hire equipment,,HJ,,19.01,-66272.52
2032,8/18/2020,8/18/2020,Joseph Zarate,Imported from Bank of America Visa-New hire equipment,,HJ,,19.01,-66291.53
2032,8/18/2020,8/18/2020,Joseph Zarate,Imported from Bank of America Visa-New hire equipment,,HJ,,19.01,-66310.54
2032,8/18/2020,8/18/2020,Joseph Zarate,Imported from Bank of America Visa-New hire equipment,,HJ,,19.01,-66329.55
2032,8/18/2020,8/18/2020,Joseph Zarate,Imported from Bank of America Visa-New hire equipment,,HJ,,19.01,-66348.56
2032,8/18/2020,8/18/2020,Joseph Zarate,Imported from Bank of America Visa-New hire equipment,,HJ,,19.01,-66367.57
2032,8/18/2020,8/18/2020,Joseph Zarate,Imported from Bank of America Visa-New hire equipment,,HJ,,19.01,-66386.58
2032,8/18/2020,8/18/2020,Joseph Zarate,Imported from Bank of America Visa-New hire equipment,,HJ,,19.01,-66405.59
2032,8/18/2020,8/18/2020,Joseph Zarate,Imported from Bank of America Visa-New hire equipment,,HJ,,19.01,-66424.6
2032,8/18/2020,8/18/2020,Joseph Zarate,Imported from Bank of America Visa-New hire equipment,,HJ,,19.01,-66443.61
2032,8/18/2020,8/18/2020,Joseph Zarate,Imported from Bank of America Visa-New hire equipment,,HJ,,19.01,-66462.62
2032,8/18/2020,8/18/2020,Joseph Zarate,Imported from Bank of America Visa-New hire equipment,,HJ,,19.01,-66481.63
2032,8/18/2020,8/18/2020,Joseph Zarate,Imported from Bank of America Visa-New hire equipment,,HJ,,19.01,-66500.64
2032,8/18/2020,8/18/2020,Joseph Zarate,Imported from Bank of America Visa-New hire equipment,,HJ,,19.01,-66519.65
2032,8/18/2020,8/18/2020,Joseph Zarate,Imported from Bank of America Visa-New hire equipment,,HJ,,19.01,-66538.66
2032,8/18/2020,8/18/2020,Joseph Zarate,Imported from Bank of America Visa-New hire equipment,,HJ,,19.09,-66557.75
2032,8/18/2020,8/18/2020,Joseph Zarate,Imported from Bank of America Visa-New hire equipment,,HJ,,19.09,-66576.84
2032,8/18/2020,8/18/2020,Joseph Zarate,Imported from Bank of America Visa-New hire equipment,,HJ,,19.09,-66595.93
2032,8/18/2020,8/18/2020,Joseph Zarate,Imported from Bank of America Visa-New hire equipment,,HJ,,19.09,-66615.02
2032,8/18/2020,8/18/2020,Joseph Zarate,Imported from Bank of America Visa-New hire equipment,,HJ,,19.09,-66634.11
2032,8/18/2020,8/18/2020,Joseph Zarate,Imported from Bank of America Visa-New hire equipment,,HJ,,19.09,-66653.2
2032,8/18/2020,8/18/2020,Joseph Zarate,Imported from Bank of America Visa-New hire equipment,,HJ,,19.09,-66672.29
2032,8/18/2020,8/18/2020,Joseph Zarate,Imported from Bank of America Visa-New hire equipment,,HJ,,19.09,-66691.38
2032,8/18/2020,8/18/2020,Joseph Zarate,Imported from Bank of America Visa-New hire equipment,,HJ,,19.09,-66710.47
2032,8/18/2020,8/18/2020,Joseph Zarate,Imported from Bank of America Visa-New hire equipment,,HJ,,19.09,-66729.56
2032,8/18/2020,8/18/2020,Joseph Zarate,Imported from Bank of America Visa-New hire equipment,,HJ,,19.09,-66748.65
2032,8/18/2020,8/18/2020,Joseph Zarate,Imported from Bank of America Visa-New hire equipment,,HJ,,19.09,-66767.74
2032,8/18/2020,8/18/2020,Joseph Zarate,Imported from Bank of America Visa-New hire equipment,,HJ,,19.09,-66786.83
2032,8/18/2020,8/18/2020,Joseph Zarate,Imported from Bank of America Visa-New hire equipment,,HJ,,19.09,-66805.92
2032,8/18/2020,8/18/2020,Joseph Zarate,Imported from Bank of America Visa-New hire equipment,,HJ,,19.09,-66825.01
2032,8/18/2020,8/18/2020,Joseph Zarate,Imported from Bank of America Visa-New hire equipment,,HJ,,19.09,-66844.1
2032,8/18/2020,8/18/2020,Joseph Zarate,Imported from Bank of America Visa-New hire equipment,,HJ,,19.09,-66863.19
2032,8/18/2020,8/18/2020,Joseph Zarate,Imported from Bank of America Visa-New hire equipment,,HJ,,19.09,-66882.28
2032,8/18/2020,8/18/2020,Joseph Zarate,Imported from Bank of America Visa-New hire equipment,,HJ,,19.09,-66901.37
2032,8/18/2020,8/18/2020,Joseph Zarate,Imported from Bank of America Visa-New hire equipment,,HJ,,19.09,-66920.46
2032,8/18/2020,8/18/2020,Joseph Zarate,Imported from Bank of America Visa-New hire equipment,,HJ,,19.09,-66939.55
2032,8/18/2020,8/18/2020,Joseph Zarate,Imported from Bank of America Visa-New hire equipment,,HJ,,19.09,-66958.64
2032,8/18/2020,8/18/2020,Joseph Zarate,Imported from Bank of America Visa-New hire equipment,,HJ,,19.09,-66977.73
2032,8/18/2020,8/18/2020,Joseph Zarate,Imported from Bank of America Visa-New hire equipment,,HJ,,19.09,-66996.82
2032,8/18/2020,8/18/2020,Joseph Zarate,Imported from Bank of America Visa-New hire equipment,,HJ,,19.09,-67015.91
2032,8/18/2020,8/18/2020,Joseph Zarate,Imported from Bank of America Visa-New hire equipment,,HJ,,19.09,-67035
2032,8/18/2020,8/18/2020,Joseph Zarate,Imported from Bank of America Visa-New hire equipment,,HJ,,19.09,-67054.09
2032,8/18/2020,8/18/2020,Joseph Zarate,Imported from Bank of America Visa-New hire equipment,,HJ,,19.09,-67073.18
2032,8/18/2020,8/18/2020,Joseph Zarate,Imported from Bank of America Visa-New hire equipment,,HJ,,19.09,-67092.27
2032,8/18/2020,8/18/2020,Joseph Zarate,Imported from Bank of America Visa-New hire equipment,,HJ,,20.1,-67112.37
2032,8/18/2020,8/18/2020,Joseph Zarate,Imported from Bank of America Visa-New hire equipment,,HJ,,20.24,-67132.61
2032,8/18/2020,8/18/2020,Joseph Zarate,Imported from Bank of America Visa-New hire equipment,,HJ,,20.34,-67152.95
2032,8/18/2020,8/18/2020,Joseph Zarate,Imported from Bank of America Visa-New hire equipment,,HJ,,20.34,-67173.29
2032,8/18/2020,8/18/2020,Joseph Zarate,Imported from Bank of America Visa-New hire equipment,,HJ,,20.35,-67193.64
2032,8/18/2020,8/18/2020,Joseph Zarate,Imported from Bank of America Visa-New hire equipment,,HJ,,20.43,-67214.07
2032,8/18/2020,8/18/2020,Joseph Zarate,Imported from Bank of America Visa-New hire equipment,,HJ,,20.57,-67234.64
2032,8/18/2020,8/18/2020,Joseph Zarate,Imported from Bank of America Visa-New hire equipment,,HJ,,20.64,-67255.28
2032,8/18/2020,8/18/2020,Joseph Zarate,Imported from Bank of America Visa-New hire equipment,,HJ,,20.99,-67276.27
2032,8/18/2020,8/18/2020,Joseph Zarate,Imported from Bank of America Visa-New hire equipment,,HJ,,47,-67323.27
2032,8/18/2020,8/18/2020,Joseph Zarate,Imported from Bank of America Visa-New hire equipment,,HJ,,47,-67370.27
2032,8/18/2020,8/18/2020,Joseph Zarate,Imported from Bank of America Visa-New hire equipment,,HJ,,47,-67417.27
2032,8/18/2020,8/18/2020,Joseph Zarate,Imported from Bank of America Visa-New hire equipment,,HJ,,50.29,-67467.56
2032,8/18/2020,8/18/2020,Joseph Zarate,Imported from Bank of America Visa-New hire equipment,,HJ,,66,-67533.56
2032,8/18/2020,8/18/2020,Joseph Zarate,Imported from Bank of America Visa-New hire equipment,,HJ,,88.89,-67622.45
2032,8/18/2020,8/18/2020,Joseph Zarate,Imported from Bank of America Visa-New hire equipment,,HJ,,109.81,-67732.26
2032,8/18/2020,8/18/2020,Joseph Zarate,Imported from Bank of America Visa-New hire equipment,,HJ,,136.17,-67868.43
2032,8/18/2020,8/18/2020,Joseph Zarate,Imported from Bank of America Visa-New hire equipment,,HJ,,347.7,-68216.13
2032,8/18/2020,8/18/2020,Joseph Zarate,Imported from Bank of America Visa-New hire equipment.returns,,HJ,,45.15,-68261.28
2032,8/18/2020,8/18/2020,Mahaliah Sejour,Imported from Bank of America Visa-Fellows jeopardy gift,,HJ,,14.79,-68276.07
2032,8/18/2020,8/18/2020,Uriel Guadarrama,Imported from Bank of America Visa-Fee for purchasing Document Studio from an Indian company,,HJ,,1.19,-68277.26
2032,8/19/2020,8/19/2020,Antonio Gutierrez,Imported from Bank of America Visa-Fellow Recruitment,,HJ,,299,-68576.26
2032,8/19/2020,8/19/2020,Antonio Gutierrez,Imported from Bank of America Visa-website,,HJ,,637.48,-69213.74
2032,8/19/2020,8/19/2020,Joseph Zarate,Imported from Bank of America Visa-New hire equipment,,HJ,,10.99,-69224.73
2032,8/19/2020,8/19/2020,Joseph Zarate,Imported from Bank of America Visa-New hire equipment,,HJ,,13.38,-69238.11
2032,8/19/2020,8/19/2020,Joseph Zarate,Imported from Bank of America Visa-New hire equipment,,HJ,,13.39,-69251.5
2032,8/19/2020,8/19/2020,Joseph Zarate,Imported from Bank of America Visa-New hire equipment,,HJ,,13.39,-69264.89
2032,8/19/2020,8/19/2020,Joseph Zarate,Imported from Bank of America Visa-New hire equipment,,HJ,,13.39,-69278.28
2032,8/19/2020,8/19/2020,Joseph Zarate,Imported from Bank of America Visa-New hire equipment,,HJ,,14.99,-69293.27
2032,8/19/2020,8/19/2020,Joseph Zarate,Imported from Bank of America Visa-New hire equipment,,HJ,,47,-69340.27
2032,8/19/2020,8/19/2020,Joseph Zarate,Imported from Bank of America Visa-New hire equipment,,HJ,,47,-69387.27
2032,8/19/2020,8/19/2020,Joseph Zarate,Imported from Bank of America Visa-New hire equipment,,HJ,,47,-69434.27
2032,8/19/2020,8/19/2020,Joseph Zarate,Imported from Bank of America Visa-New hire equipment,,HJ,,47,-69481.27
2032,8/19/2020,8/19/2020,Joseph Zarate,Imported from Bank of America Visa-New hire equipment,,HJ,,47,-69528.27
2032,8/19/2020,8/19/2020,Joseph Zarate,Imported from Bank of America Visa-New hire equipment,,HJ,,47,-69575.27
2032,8/19/2020,8/19/2020,Joseph Zarate,Imported from Bank of America Visa-New hire equipment,,HJ,,47,-69622.27
2032,8/19/2020,8/19/2020,Joseph Zarate,Imported from Bank of America Visa-New hire equipment,,HJ,,47,-69669.27
2032,8/19/2020,8/19/2020,Joseph Zarate,Imported from Bank of America Visa-New hire equipment,,HJ,,47,-69716.27
2032,8/19/2020,8/19/2020,Joseph Zarate,Imported from Bank of America Visa-New hire equipment,,HJ,,50.29,-69766.56
2032,8/19/2020,8/19/2020,Joseph Zarate,Imported from Bank of America Visa-New hire equipment,,HJ,,50.95,-69817.51
2032,8/19/2020,8/19/2020,Joseph Zarate,Imported from Bank of America Visa-New hire equipment,,HJ,,88.89,-69906.4
2032,8/19/2020,8/19/2020,Joseph Zarate,Imported from Bank of America Visa-New hire equipment,,HJ,,95.33,-70001.73
2032,8/19/2020,8/19/2020,Joseph Zarate,Imported from Bank of America Visa-New hire equipment.returns,,HJ,,31.1,-70032.83
2032,8/19/2020,8/19/2020,Joseph Zarate,Imported from Bank of America Visa-shipping,,HJ,,0.48,-70033.31
2032,8/19/2020,8/19/2020,Mahaliah Sejour,Imported from Bank of America Visa-Fellows jeopardy gift,,HJ,,14.99,-70048.3
2032,8/19/2020,8/19/2020,Mahaliah Sejour,Imported from Bank of America Visa-Fellows jeopardy gift,,HJ,,15.98,-70064.28
2032,8/19/2020,8/19/2020,Mahaliah Sejour,Imported from Bank of America Visa-Fellows jeopardy gift,,HJ,,19.99,-70084.27
2032,8/19/2020,8/19/2020,Myesha Hossain,Imported from Bank of America Visa-Fellow Social Raffle Prize,,HJ,,15.72,-70099.99
2032,8/19/2020,8/19/2020,Myesha Hossain,Imported from Bank of America Visa-Fellow Social Raffle Prize,,HJ,,22.98,-70122.97
2032,8/19/2020,8/19/2020,Myesha Hossain,Imported from Bank of America Visa-Fellow Social Raffle Prize,,HJ,,22.98,-70145.95
2032,8/20/2020,8/20/2020,Alan Safran,Imported from Bank of America Visa-Background checks for fellows,,HJ,,3.16,-70149.11
2032,8/20/2020,8/20/2020,Alan Safran,Imported from Bank of America Visa-Background checks for fellows,,HJ,,4.89,-70154
2032,8/20/2020,8/20/2020,Alan Safran,Imported from Bank of America Visa-Background checks for fellows,,HJ,,4.89,-70158.89
2032,8/20/2020,8/20/2020,Alan Safran,Imported from Bank of America Visa-Background checks for fellows,,HJ,,15.81,-70174.7
2032,8/20/2020,8/20/2020,Bank of America VISA,Concur Payment Bambora-Concur Payment Bambora,,HJ,2349.41,,-67825.29
2032,8/20/2020,8/20/2020,Chris D PLACEHOLDER,Imported from Bank of America Visa-Book prize sent to AmeriCorps Member,,HJ,,12.1,-67837.39
2032,8/20/2020,8/20/2020,Chris D PLACEHOLDER,Imported from Bank of America Visa-Book prize sent to AmeriCorps Member,,HJ,,12.19,-67849.58
2032,8/20/2020,8/20/2020,Chris D PLACEHOLDER,Imported from Bank of America Visa-Book prize sent to AmeriCorps Member,,HJ,,20.43,-67870.01
2032,8/20/2020,8/20/2020,Chris D PLACEHOLDER,Imported from Bank of America Visa-Book prize sent to AmeriCorps member,,HJ,,12.3,-67882.31
2032,8/20/2020,8/20/2020,Chris D PLACEHOLDER,Imported from Bank of America Visa-Book prize sent to employee,,HJ,,12.4,-67894.71
2032,8/20/2020,8/20/2020,Chris D PLACEHOLDER,Imported from Bank of America Visa-Book prize sent to employee,,HJ,,16.52,-67911.23
2032,8/20/2020,8/20/2020,Chris D PLACEHOLDER,Imported from Bank of America Visa-Book prize sent to employee,,HJ,,44.74,-67955.97
2032,8/20/2020,8/20/2020,Elizabeth Peinado,Imported from Bank of America Visa-Fellow Staff advertising. Brand Awareness,,HJ,,11.23,-67967.2
2032,8/20/2020,8/20/2020,Elizabeth Peinado,Imported from Bank of America Visa-Fellow Staff advertising. Brand Awareness,,HJ,,17.35,-67984.55
2032,8/20/2020,8/20/2020,Elizabeth Peinado,Imported from Bank of America Visa-Fellow Staff advertising. Brand Awareness,,HJ,,17.35,-68001.9
2032,8/20/2020,8/20/2020,Elizabeth Peinado,Imported from Bank of America Visa-Fellow Staff advertising. Brand Awareness,,HJ,,56.13,-68058.03
2032,8/20/2020,8/20/2020,Jennifer Winans,Imported from Bank of America Visa-Recruitment PD,,HJ,,299.94,-68357.97
2032,8/20/2020,8/20/2020,Joseph Zarate,Imported from Bank of America Visa-New hire equipment,,HJ,,9.89,-68367.86
2032,8/20/2020,8/20/2020,Joseph Zarate,Imported from Bank of America Visa-New hire equipment,,HJ,,9.89,-68377.75
2032,8/20/2020,8/20/2020,Joseph Zarate,Imported from Bank of America Visa-New hire equipment,,HJ,,9.89,-68387.64
2032,8/20/2020,8/20/2020,Joseph Zarate,Imported from Bank of America Visa-New hire equipment,,HJ,,9.89,-68397.53
2032,8/20/2020,8/20/2020,Joseph Zarate,Imported from Bank of America Visa-New hire equipment,,HJ,,9.89,-68407.42
2032,8/20/2020,8/20/2020,Joseph Zarate,Imported from Bank of America Visa-New hire equipment,,HJ,,9.89,-68417.31
2032,8/20/2020,8/20/2020,Joseph Zarate,Imported from Bank of America Visa-New hire equipment,,HJ,,9.89,-68427.2
2032,8/20/2020,8/20/2020,Joseph Zarate,Imported from Bank of America Visa-New hire equipment,,HJ,,9.89,-68437.09
2032,8/20/2020,8/20/2020,Joseph Zarate,Imported from Bank of America Visa-New hire equipment,,HJ,,9.89,-68446.98
2032,8/20/2020,8/20/2020,Joseph Zarate,Imported from Bank of America Visa-New hire equipment,,HJ,,9.89,-68456.87
2032,8/20/2020,8/20/2020,Joseph Zarate,Imported from Bank of America Visa-New hire equipment,,HJ,,9.89,-68466.76
2032,8/20/2020,8/20/2020,Joseph Zarate,Imported from Bank of America Visa-New hire equipment,,HJ,,9.89,-68476.65
2032,8/20/2020,8/20/2020,Joseph Zarate,Imported from Bank of America Visa-New hire equipment,,HJ,,9.89,-68486.54
2032,8/20/2020,8/20/2020,Joseph Zarate,Imported from Bank of America Visa-New hire equipment,,HJ,,9.89,-68496.43
2032,8/20/2020,8/20/2020,Joseph Zarate,Imported from Bank of America Visa-New hire equipment,,HJ,,9.89,-68506.32
2032,8/20/2020,8/20/2020,Joseph Zarate,Imported from Bank of America Visa-New hire equipment,,HJ,,9.89,-68516.21
2032,8/20/2020,8/20/2020,Joseph Zarate,Imported from Bank of America Visa-New hire equipment,,HJ,,9.89,-68526.1
2032,8/20/2020,8/20/2020,Joseph Zarate,Imported from Bank of America Visa-New hire equipment,,HJ,,9.89,-68535.99
2032,8/20/2020,8/20/2020,Joseph Zarate,Imported from Bank of America Visa-New hire equipment,,HJ,,9.89,-68545.88
2032,8/20/2020,8/20/2020,Joseph Zarate,Imported from Bank of America Visa-New hire equipment,,HJ,,9.89,-68555.77
2032,8/20/2020,8/20/2020,Joseph Zarate,Imported from Bank of America Visa-New hire equipment,,HJ,,9.89,-68565.66
2032,8/20/2020,8/20/2020,Joseph Zarate,Imported from Bank of America Visa-New hire equipment,,HJ,,9.89,-68575.55
2032,8/20/2020,8/20/2020,Joseph Zarate,Imported from Bank of America Visa-New hire equipment,,HJ,,9.89,-68585.44
2032,8/20/2020,8/20/2020,Joseph Zarate,Imported from Bank of America Visa-New hire equipment,,HJ,,9.89,-68595.33
2032,8/20/2020,8/20/2020,Joseph Zarate,Imported from Bank of America Visa-New hire equipment,,HJ,,9.89,-68605.22
2032,8/20/2020,8/20/2020,Joseph Zarate,Imported from Bank of America Visa-New hire equipment,,HJ,,9.89,-68615.11
2032,8/20/2020,8/20/2020,Joseph Zarate,Imported from Bank of America Visa-New hire equipment,,HJ,,9.89,-68625
2032,8/20/2020,8/20/2020,Joseph Zarate,Imported from Bank of America Visa-New hire equipment,,HJ,,9.89,-68634.89
2032,8/20/2020,8/20/2020,Joseph Zarate,Imported from Bank of America Visa-New hire equipment,,HJ,,9.89,-68644.78
2032,8/20/2020,8/20/2020,Joseph Zarate,Imported from Bank of America Visa-New hire equipment,,HJ,,9.89,-68654.67
2032,8/20/2020,8/20/2020,Joseph Zarate,Imported from Bank of America Visa-New hire equipment,,HJ,,9.89,-68664.56
2032,8/20/2020,8/20/2020,Joseph Zarate,Imported from Bank of America Visa-New hire equipment,,HJ,,9.89,-68674.45
2032,8/20/2020,8/20/2020,Joseph Zarate,Imported from Bank of America Visa-New hire equipment,,HJ,,9.89,-68684.34
2032,8/20/2020,8/20/2020,Joseph Zarate,Imported from Bank of America Visa-New hire equipment,,HJ,,9.89,-68694.23
2032,8/20/2020,8/20/2020,Joseph Zarate,Imported from Bank of America Visa-New hire equipment,,HJ,,9.89,-68704.12
2032,8/20/2020,8/20/2020,Joseph Zarate,Imported from Bank of America Visa-New hire equipment,,HJ,,9.89,-68714.01
2032,8/20/2020,8/20/2020,Joseph Zarate,Imported from Bank of America Visa-New hire equipment,,HJ,,9.89,-68723.9
2032,8/20/2020,8/20/2020,Joseph Zarate,Imported from Bank of America Visa-New hire equipment,,HJ,,9.89,-68733.79
2032,8/20/2020,8/20/2020,Joseph Zarate,Imported from Bank of America Visa-New hire equipment,,HJ,,9.89,-68743.68
2032,8/20/2020,8/20/2020,Joseph Zarate,Imported from Bank of America Visa-New hire equipment,,HJ,,9.89,-68753.57
2032,8/20/2020,8/20/2020,Joseph Zarate,Imported from Bank of America Visa-New hire equipment,,HJ,,9.89,-68763.46
2032,8/20/2020,8/20/2020,Joseph Zarate,Imported from Bank of America Visa-New hire equipment,,HJ,,9.89,-68773.35
2032,8/20/2020,8/20/2020,Joseph Zarate,Imported from Bank of America Visa-New hire equipment,,HJ,,9.89,-68783.24
2032,8/20/2020,8/20/2020,Joseph Zarate,Imported from Bank of America Visa-New hire equipment,,HJ,,9.89,-68793.13
2032,8/20/2020,8/20/2020,Joseph Zarate,Imported from Bank of America Visa-New hire equipment,,HJ,,9.89,-68803.02
2032,8/20/2020,8/20/2020,Joseph Zarate,Imported from Bank of America Visa-New hire equipment,,HJ,,9.89,-68812.91
2032,8/20/2020,8/20/2020,Joseph Zarate,Imported from Bank of America Visa-New hire equipment,,HJ,,9.89,-68822.8
2032,8/20/2020,8/20/2020,Joseph Zarate,Imported from Bank of America Visa-New hire equipment,,HJ,,9.89,-68832.69
2032,8/20/2020,8/20/2020,Joseph Zarate,Imported from Bank of America Visa-New hire equipment,,HJ,,9.89,-68842.58
2032,8/20/2020,8/20/2020,Joseph Zarate,Imported from Bank of America Visa-New hire equipment,,HJ,,9.89,-68852.47
2032,8/20/2020,8/20/2020,Joseph Zarate,Imported from Bank of America Visa-New hire equipment,,HJ,,9.89,-68862.36
2032,8/20/2020,8/20/2020,Joseph Zarate,Imported from Bank of America Visa-New hire equipment,,HJ,,10.43,-68872.79
2032,8/20/2020,8/20/2020,Joseph Zarate,Imported from Bank of America Visa-New hire equipment,,HJ,,10.48,-68883.27
2032,8/20/2020,8/20/2020,Joseph Zarate,Imported from Bank of America Visa-New hire equipment,,HJ,,10.55,-68893.82
2032,8/20/2020,8/20/2020,Joseph Zarate,Imported from Bank of America Visa-New hire equipment,,HJ,,10.55,-68904.37
2032,8/20/2020,8/20/2020,Joseph Zarate,Imported from Bank of America Visa-New hire equipment,,HJ,,10.58,-68914.95
2032,8/20/2020,8/20/2020,Joseph Zarate,Imported from Bank of America Visa-New hire equipment,,HJ,,10.66,-68925.61
2032,8/20/2020,8/20/2020,Joseph Zarate,Imported from Bank of America Visa-New hire equipment,,HJ,,10.69,-68936.3
2032,8/20/2020,8/20/2020,Joseph Zarate,Imported from Bank of America Visa-New hire equipment,,HJ,,10.72,-68947.02
2032,8/20/2020,8/20/2020,Joseph Zarate,Imported from Bank of America Visa-New hire equipment,,HJ,,10.76,-68957.78
2032,8/20/2020,8/20/2020,Joseph Zarate,Imported from Bank of America Visa-New hire equipment,,HJ,,10.99,-68968.77
2032,8/20/2020,8/20/2020,Joseph Zarate,Imported from Bank of America Visa-New hire equipment,,HJ,,10.99,-68979.76
2032,8/20/2020,8/20/2020,Joseph Zarate,Imported from Bank of America Visa-New hire equipment,,HJ,,10.99,-68990.75
2032,8/20/2020,8/20/2020,Joseph Zarate,Imported from Bank of America Visa-New hire equipment,,HJ,,10.99,-69001.74
2032,8/20/2020,8/20/2020,Joseph Zarate,Imported from Bank of America Visa-New hire equipment,,HJ,,10.99,-69012.73
2032,8/20/2020,8/20/2020,Joseph Zarate,Imported from Bank of America Visa-New hire equipment,,HJ,,11.76,-69024.49
2032,8/20/2020,8/20/2020,Joseph Zarate,Imported from Bank of America Visa-New hire equipment,,HJ,12.03,,-69012.46
2032,8/20/2020,8/20/2020,Joseph Zarate,Imported from Bank of America Visa-New hire equipment,,HJ,,15.05,-69027.51
2032,8/20/2020,8/20/2020,Joseph Zarate,Imported from Bank of America Visa-New hire equipment,,HJ,,15.05,-69042.56
2032,8/20/2020,8/20/2020,Joseph Zarate,Imported from Bank of America Visa-New hire equipment,,HJ,,21.5,-69064.06
2032,8/20/2020,8/20/2020,Joseph Zarate,Imported from Bank of America Visa-New hire equipment,,HJ,,21.5,-69085.56
2032,8/20/2020,8/20/2020,Joseph Zarate,Imported from Bank of America Visa-New hire equipment,,HJ,,21.5,-69107.06
2032,8/20/2020,8/20/2020,Joseph Zarate,Imported from Bank of America Visa-New hire equipment,,HJ,,21.5,-69128.56
2032,8/20/2020,8/20/2020,Joseph Zarate,Imported from Bank of America Visa-New hire equipment,,HJ,,21.5,-69150.06
2032,8/20/2020,8/20/2020,Joseph Zarate,Imported from Bank of America Visa-New hire equipment,,HJ,,21.5,-69171.56
2032,8/20/2020,8/20/2020,Joseph Zarate,Imported from Bank of America Visa-New hire equipment,,HJ,,21.5,-69193.06
2032,8/20/2020,8/20/2020,Joseph Zarate,Imported from Bank of America Visa-New hire equipment,,HJ,,21.5,-69214.56
2032,8/20/2020,8/20/2020,Joseph Zarate,Imported from Bank of America Visa-New hire equipment,,HJ,,21.5,-69236.06
2032,8/20/2020,8/20/2020,Joseph Zarate,Imported from Bank of America Visa-New hire equipment,,HJ,,21.5,-69257.56
2032,8/20/2020,8/20/2020,Joseph Zarate,Imported from Bank of America Visa-New hire equipment,,HJ,,21.5,-69279.06
2032,8/20/2020,8/20/2020,Joseph Zarate,Imported from Bank of America Visa-New hire equipment,,HJ,,21.5,-69300.56
2032,8/20/2020,8/20/2020,Joseph Zarate,Imported from Bank of America Visa-New hire equipment,,HJ,,21.5,-69322.06
2032,8/20/2020,8/20/2020,Joseph Zarate,Imported from Bank of America Visa-New hire equipment,,HJ,,21.5,-69343.56
2032,8/20/2020,8/20/2020,Joseph Zarate,Imported from Bank of America Visa-New hire equipment,,HJ,,21.5,-69365.06
2032,8/20/2020,8/20/2020,Joseph Zarate,Imported from Bank of America Visa-New hire equipment,,HJ,,21.5,-69386.56
2032,8/20/2020,8/20/2020,Joseph Zarate,Imported from Bank of America Visa-New hire equipment,,HJ,,21.5,-69408.06
2032,8/20/2020,8/20/2020,Joseph Zarate,Imported from Bank of America Visa-New hire equipment,,HJ,,21.84,-69429.9
2032,8/20/2020,8/20/2020,Joseph Zarate,Imported from Bank of America Visa-New hire equipment,,HJ,,22.87,-69452.77
2032,8/20/2020,8/20/2020,Joseph Zarate,Imported from Bank of America Visa-New hire equipment,,HJ,,22.92,-69475.69
2032,8/20/2020,8/20/2020,Joseph Zarate,Imported from Bank of America Visa-New hire equipment,,HJ,,23.06,-69498.75
2032,8/20/2020,8/20/2020,Joseph Zarate,Imported from Bank of America Visa-New hire equipment,,HJ,,29.04,-69527.79
2032,8/20/2020,8/20/2020,Joseph Zarate,Imported from Bank of America Visa-New hire equipment,,HJ,,47,-69574.79
2032,8/20/2020,8/20/2020,Joseph Zarate,Imported from Bank of America Visa-New hire equipment,,HJ,,47,-69621.79
2032,8/20/2020,8/20/2020,Joseph Zarate,Imported from Bank of America Visa-New hire equipment,,HJ,,47,-69668.79
2032,8/20/2020,8/20/2020,Joseph Zarate,Imported from Bank of America Visa-New hire equipment,,HJ,,47,-69715.79
2032,8/20/2020,8/20/2020,Joseph Zarate,Imported from Bank of America Visa-New hire equipment,,HJ,,47,-69762.79
2032,8/20/2020,8/20/2020,Joseph Zarate,Imported from Bank of America Visa-New hire equipment,,HJ,,47,-69809.79
2032,8/20/2020,8/20/2020,Joseph Zarate,Imported from Bank of America Visa-New hire equipment,,HJ,,47,-69856.79
2032,8/20/2020,8/20/2020,Joseph Zarate,Imported from Bank of America Visa-New hire equipment,,HJ,,47,-69903.79
2032,8/20/2020,8/20/2020,Joseph Zarate,Imported from Bank of America Visa-New hire equipment,,HJ,,47,-69950.79
2032,8/20/2020,8/20/2020,Joseph Zarate,Imported from Bank of America Visa-New hire equipment,,HJ,,47,-69997.79
2032,8/20/2020,8/20/2020,Joseph Zarate,Imported from Bank of America Visa-New hire equipment,,HJ,,47,-70044.79
2032,8/20/2020,8/20/2020,Joseph Zarate,Imported from Bank of America Visa-New hire equipment,,HJ,,47,-70091.79
2032,8/20/2020,8/20/2020,Joseph Zarate,Imported from Bank of America Visa-New hire equipment,,HJ,,47,-70138.79
2032,8/20/2020,8/20/2020,Joseph Zarate,Imported from Bank of America Visa-New hire equipment,,HJ,,47,-70185.79
2032,8/20/2020,8/20/2020,Joseph Zarate,Imported from Bank of America Visa-New hire equipment,,HJ,,47,-70232.79
2032,8/20/2020,8/20/2020,Joseph Zarate,Imported from Bank of America Visa-New hire equipment,,HJ,,47,-70279.79
2032,8/20/2020,8/20/2020,Joseph Zarate,Imported from Bank of America Visa-New hire equipment,,HJ,,47,-70326.79
2032,8/20/2020,8/20/2020,Joseph Zarate,Imported from Bank of America Visa-New hire equipment,,HJ,,47,-70373.79
2032,8/20/2020,8/20/2020,Joseph Zarate,Imported from Bank of America Visa-New hire equipment,,HJ,,47,-70420.79
2032,8/20/2020,8/20/2020,Joseph Zarate,Imported from Bank of America Visa-New hire equipment,,HJ,,47,-70467.79
2032,8/20/2020,8/20/2020,Joseph Zarate,Imported from Bank of America Visa-New hire equipment,,HJ,,47,-70514.79
2032,8/20/2020,8/20/2020,Joseph Zarate,Imported from Bank of America Visa-New hire equipment,,HJ,,47,-70561.79
2032,8/20/2020,8/20/2020,Joseph Zarate,Imported from Bank of America Visa-New hire equipment,,HJ,,47,-70608.79
2032,8/20/2020,8/20/2020,Joseph Zarate,Imported from Bank of America Visa-New hire equipment,,HJ,,47,-70655.79
2032,8/20/2020,8/20/2020,Joseph Zarate,Imported from Bank of America Visa-New hire equipment,,HJ,,47,-70702.79
2032,8/20/2020,8/20/2020,Joseph Zarate,Imported from Bank of America Visa-New hire equipment,,HJ,,49,-70751.79
2032,8/20/2020,8/20/2020,Joseph Zarate,Imported from Bank of America Visa-refund,,HJ,119.62,,-70632.17
2032,8/20/2020,8/20/2020,Maryellen Leneghan,Imported from Bank of America Visa-DoP Appreciation for the summer. BC specific,,HJ,,38.51,-70670.68
2032,8/20/2020,8/20/2020,Monivett Acevedo,Imported from Bank of America Visa-Mechanical Pencil,,HJ,,9.9,-70680.58
2032,8/20/2020,8/20/2020,Myesha Hossain,Imported from Bank of America Visa-Training,,HJ,,9.88,-70690.46
2032,8/21/2020,8/21/2020,3BF0E5FAC6964956886C,Imported from Bank of America Visa-Mailing Welcome Packages,,HJ,,31.9,-70722.36
2032,8/21/2020,8/21/2020,Chris D PLACEHOLDER,Imported from Bank of America Visa-Book prize sent to AmeriCorps member,,HJ,,17.73,-70740.09
2032,8/21/2020,8/21/2020,Chris D PLACEHOLDER,Imported from Bank of America Visa-Book prize sent to employee,,HJ,,12.3,-70752.39
2032,8/21/2020,8/21/2020,Elizabeth Peinado,Imported from Bank of America Visa-Math Assessment software,,HJ,,4.39,-70756.78
2032,8/21/2020,8/21/2020,Elizabeth Peinado,Imported from Bank of America Visa-Math Assessment software,,HJ,,6.79,-70763.57
2032,8/21/2020,8/21/2020,Elizabeth Peinado,Imported from Bank of America Visa-Math Assessment software,,HJ,,6.79,-70770.36
2032,8/21/2020,8/21/2020,Elizabeth Peinado,Imported from Bank of America Visa-Math Assessment software,,HJ,,21.98,-70792.34
2032,8/21/2020,8/21/2020,Jennifer Winans,Imported from Bank of America Visa-Bag fees for flight - Chicago ACM,,HJ,,30,-70822.34
2032,8/21/2020,8/21/2020,Jennifer Winans,Imported from Bank of America Visa-Bag fees for flight - Chicago ACM,,HJ,,40,-70862.34
2032,8/21/2020,8/21/2020,Joseph Zarate,Imported from Bank of America Visa-New hire equipment,,HJ,,9.89,-70872.23
2032,8/21/2020,8/21/2020,Joseph Zarate,Imported from Bank of America Visa-New hire equipment,,HJ,,9.89,-70882.12
2032,8/21/2020,8/21/2020,Joseph Zarate,Imported from Bank of America Visa-New hire equipment,,HJ,,10.48,-70892.6
2032,8/21/2020,8/21/2020,Joseph Zarate,Imported from Bank of America Visa-New hire equipment,,HJ,,10.58,-70903.18
2032,8/21/2020,8/21/2020,Joseph Zarate,Imported from Bank of America Visa-New hire equipment,,HJ,,10.61,-70913.79
2032,8/21/2020,8/21/2020,Joseph Zarate,Imported from Bank of America Visa-New hire equipment,,HJ,,10.71,-70924.5
2032,8/21/2020,8/21/2020,Joseph Zarate,Imported from Bank of America Visa-New hire equipment,,HJ,,38.5,-70963
2032,8/21/2020,8/21/2020,Joseph Zarate,Imported from Bank of America Visa-New hire equipment,,HJ,,47,-71010
2032,8/21/2020,8/21/2020,Joseph Zarate,Imported from Bank of America Visa-New hire equipment,,HJ,,47,-71057
2032,8/21/2020,8/21/2020,Joseph Zarate,Imported from Bank of America Visa-New hire equipment,,HJ,,47,-71104
2032,8/21/2020,8/21/2020,Joseph Zarate,Imported from Bank of America Visa-New hire equipment,,HJ,,47,-71151
2032,8/21/2020,8/21/2020,Joseph Zarate,Imported from Bank of America Visa-New hire equipment,,HJ,,47,-71198
2032,8/21/2020,8/21/2020,Joseph Zarate,Imported from Bank of America Visa-New hire equipment,,HJ,,49,-71247
2032,8/21/2020,8/21/2020,Joseph Zarate,Imported from Bank of America Visa-New hire equipment,,HJ,,50.29,-71297.29
2032,8/21/2020,8/21/2020,Joseph Zarate,Imported from Bank of America Visa-New hire equipment,,HJ,,52.8,-71350.09
2032,8/21/2020,8/21/2020,Joseph Zarate,Imported from Bank of America Visa-New hire equipment,,HJ,,68.4,-71418.49
2032,8/21/2020,8/21/2020,Joseph Zarate,Imported from Bank of America Visa-New hire equipment,,HJ,,461,-71879.49
2032,8/21/2020,8/21/2020,Joseph Zarate,Imported from Bank of America Visa-New hire equipment.returns,,HJ,,15.05,-71894.54
2032,8/21/2020,8/21/2020,Joseph Zarate,Imported from Bank of America Visa-refund,,HJ,6.8,,-71887.74
2032,8/21/2020,8/21/2020,Joseph Zarate,Imported from Bank of America Visa-refund,,HJ,284.07,,-71603.67
2032,8/21/2020,8/21/2020,Joseph Zarate,Imported from Bank of America Visa-returns,,HJ,,7.75,-71611.42
2032,8/21/2020,8/21/2020,Mahaliah Sejour,Imported from Bank of America Visa-DoP/RPOM site placement,,HJ,,125.62,-71737.04
2032,8/21/2020,8/21/2020,Mahaliah Sejour,Imported from Bank of America Visa-MS wireless mouse,,HJ,,12.12,-71749.16
2032,8/21/2020,8/21/2020,Monivett Acevedo,Imported from Bank of America Visa-Daily planner,,HJ,,26.7,-71775.86
2032,8/21/2020,8/21/2020,Myesha Hossain,Imported from Bank of America Visa-Training,,HJ,,13.6,-71789.46
2032,8/22/2020,8/22/2020,Alan Safran,Imported from Bank of America Visa-Background checks for fellows,,HJ,,3.16,-71792.62
2032,8/22/2020,8/22/2020,Alan Safran,Imported from Bank of America Visa-Background checks for fellows,,HJ,,4.89,-71797.51
2032,8/22/2020,8/22/2020,Alan Safran,Imported from Bank of America Visa-Background checks for fellows,,HJ,,4.89,-71802.4
2032,8/22/2020,8/22/2020,Alan Safran,Imported from Bank of America Visa-Background checks for fellows,,HJ,,15.81,-71818.21
2032,8/22/2020,8/22/2020,Chris D PLACEHOLDER,Imported from Bank of America Visa-Book prize sent to AmeriCorps member,,HJ,,24.3,-71842.51
2032,8/22/2020,8/22/2020,Elizabeth Peinado,Imported from Bank of America Visa-Fellow Staff advertising. Brand Awareness,,HJ,,17.98,-71860.49
2032,8/22/2020,8/22/2020,Elizabeth Peinado,Imported from Bank of America Visa-Fellow Staff advertising. Brand Awareness,,HJ,,27.78,-71888.27
2032,8/22/2020,8/22/2020,Elizabeth Peinado,Imported from Bank of America Visa-Fellow Staff advertising. Brand Awareness,,HJ,,27.78,-71916.05
2032,8/22/2020,8/22/2020,Elizabeth Peinado,Imported from Bank of America Visa-Fellow Staff advertising. Brand Awareness,,HJ,,89.88,-72005.93
2032,8/22/2020,8/22/2020,Joseph Zarate,Imported from Bank of America Visa-New hire equipment,,HJ,,9.89,-72015.82
2032,8/22/2020,8/22/2020,Joseph Zarate,Imported from Bank of America Visa-New hire equipment,,HJ,,9.98,-72025.8
2032,8/22/2020,8/22/2020,Joseph Zarate,Imported from Bank of America Visa-New hire equipment,,HJ,,21.1,-72046.9
2032,8/22/2020,8/22/2020,Joseph Zarate,Imported from Bank of America Visa-New hire equipment,,HJ,,47,-72093.9
2032,8/22/2020,8/22/2020,Joseph Zarate,Imported from Bank of America Visa-New hire equipment,,HJ,,47,-72140.9
2032,8/22/2020,8/22/2020,Joseph Zarate,Imported from Bank of America Visa-New hire equipment,,HJ,,47,-72187.9
2032,8/22/2020,8/22/2020,Joseph Zarate,Imported from Bank of America Visa-New hire equipment,,HJ,,47,-72234.9
2032,8/22/2020,8/22/2020,Joseph Zarate,Imported from Bank of America Visa-New hire equipment,,HJ,,49,-72283.9
2032,8/22/2020,8/22/2020,Joseph Zarate,Imported from Bank of America Visa-New hire equipment,,HJ,,147.54,-72431.44
2032,8/22/2020,8/22/2020,Joseph Zarate,Imported from Bank of America Visa-New hire equipment,,HJ,,178.66,-72610.1
2032,8/22/2020,8/22/2020,Myesha Hossain,Imported from Bank of America Visa-Training,,HJ,,13.99,-72624.09
2032,8/22/2020,8/22/2020,Myesha Hossain,Imported from Bank of America Visa-Training,,HJ,,15.5,-72639.59
2032,8/23/2020,8/23/2020,Elizabeth Peinado,Imported from Bank of America Visa-Fellow Staff advertising. Brand Awareness,,HJ,,12.13,-72651.72
2032,8/23/2020,8/23/2020,Elizabeth Peinado,Imported from Bank of America Visa-Fellow Staff advertising. Brand Awareness,,HJ,,18.74,-72670.46
2032,8/23/2020,8/23/2020,Elizabeth Peinado,Imported from Bank of America Visa-Fellow Staff advertising. Brand Awareness,,HJ,,18.74,-72689.2
2032,8/23/2020,8/23/2020,Elizabeth Peinado,Imported from Bank of America Visa-Fellow Staff advertising. Brand Awareness,,HJ,,60.62,-72749.82
2032,8/23/2020,8/23/2020,Joseph Zarate,Imported from Bank of America Visa-New hire equipment,,HJ,,29.99,-72779.81
2032,8/23/2020,8/23/2020,Joseph Zarate,Imported from Bank of America Visa-New hire equipment,,HJ,,51.7,-72831.51
2032,8/23/2020,8/23/2020,Joseph Zarate,Imported from Bank of America Visa-refund,,HJ,9.89,,-72821.62
2032,8/23/2020,8/23/2020,Monivett Acevedo,Imported from Bank of America Visa-Office Supplies,,HJ,,3.18,-72824.8
2032,8/24/2020,8/24/2020,Antonio Gutierrez,Imported from Bank of America Visa-Fellow Recruitment,,HJ,,900,-73724.8
2032,8/24/2020,8/24/2020,Elizabeth Peinado,Imported from Bank of America Visa-Fellow Staff advertising. Brand Awareness,,HJ,,11.77,-73736.57
2032,8/24/2020,8/24/2020,Elizabeth Peinado,Imported from Bank of America Visa-Fellow Staff advertising. Brand Awareness,,HJ,,18.19,-73754.76
2032,8/24/2020,8/24/2020,Elizabeth Peinado,Imported from Bank of America Visa-Fellow Staff advertising. Brand Awareness,,HJ,,18.19,-73772.95
2032,8/24/2020,8/24/2020,Elizabeth Peinado,Imported from Bank of America Visa-Fellow Staff advertising. Brand Awareness,,HJ,,58.87,-73831.82
2032,8/24/2020,8/24/2020,Elizabeth Peinado,Imported from Bank of America Visa-international fee for math assessment software,,HJ,,0.09,-73831.91
2032,8/24/2020,8/24/2020,Elizabeth Peinado,Imported from Bank of America Visa-international fee for math assessment software,,HJ,,0.14,-73832.05
2032,8/24/2020,8/24/2020,Elizabeth Peinado,Imported from Bank of America Visa-international fee for math assessment software,,HJ,,0.14,-73832.19
2032,8/24/2020,8/24/2020,Elizabeth Peinado,Imported from Bank of America Visa-international fee for math assessment software,,HJ,,0.43,-73832.62
2032,8/24/2020,8/24/2020,Joseph Zarate,Imported from Bank of America Visa-New hire equipment,,HJ,,7.52,-73840.14
2032,8/24/2020,8/24/2020,Joseph Zarate,Imported from Bank of America Visa-New hire equipment,,HJ,,7.53,-73847.67
2032,8/24/2020,8/24/2020,Joseph Zarate,Imported from Bank of America Visa-New hire equipment,,HJ,,10.71,-73858.38
2032,8/24/2020,8/24/2020,Joseph Zarate,Imported from Bank of America Visa-New hire equipment,,HJ,,15.05,-73873.43
2032,8/24/2020,8/24/2020,Joseph Zarate,Imported from Bank of America Visa-New hire equipment,,HJ,,15.05,-73888.48
2032,8/24/2020,8/24/2020,Joseph Zarate,Imported from Bank of America Visa-New hire equipment,,HJ,,568,-74456.48
2032,8/24/2020,8/24/2020,Joseph Zarate,Imported from Bank of America Visa-New hire equipment,,HJ,,579.97,-75036.45
2032,8/24/2020,8/24/2020,Joseph Zarate,Imported from Bank of America Visa-New hire equipment.returns,,HJ,,28.85,-75065.3
2032,8/24/2020,8/24/2020,Joseph Zarate,Imported from Bank of America Visa-return,,HJ,,15.05,-75080.35
2032,8/24/2020,8/24/2020,Mahaliah Sejour,Imported from Bank of America Visa-MS mouse,,HJ,,12.99,-75093.34
2032,8/24/2020,8/24/2020,Monivett Acevedo,Imported from Bank of America Visa-Marketing PD,,HJ,,203.29,-75296.63
2032,8/24/2020,8/24/2020,Myesha Hossain,Imported from Bank of America Visa-Tech Cleaner,,HJ,,237.8,-75534.43
2032,8/24/2020,8/24/2020,Myesha Hossain,Imported from Bank of America Visa-Training,,HJ,,13.03,-75547.46
2032,8/24/2020,8/24/2020,Myesha Hossain,Imported from Bank of America Visa-Training,,HJ,,17.69,-75565.15
2032,8/24/2020,8/24/2020,Nicole Prahin,Imported from Bank of America Visa-Rented Resource for Fellow Training access,,HJ,,1.99,-75567.14
2032,8/25/2020,8/25/2020,Alan Safran,Imported from Bank of America Visa-Background checks for fellows,,HJ,,0.83,-75567.97
2032,8/25/2020,8/25/2020,Alan Safran,Imported from Bank of America Visa-Background checks for fellows,,HJ,,1.27,-75569.24
2032,8/25/2020,8/25/2020,Alan Safran,Imported from Bank of America Visa-Background checks for fellows,,HJ,,1.28,-75570.52
2032,8/25/2020,8/25/2020,Alan Safran,Imported from Bank of America Visa-Background checks for fellows,,HJ,,3.16,-75573.68
2032,8/25/2020,8/25/2020,Alan Safran,Imported from Bank of America Visa-Background checks for fellows,,HJ,,4.02,-75577.7
2032,8/25/2020,8/25/2020,Alan Safran,Imported from Bank of America Visa-Background checks for fellows,,HJ,,4.02,-75581.72
2032,8/25/2020,8/25/2020,Alan Safran,Imported from Bank of America Visa-Background checks for fellows,,HJ,,4.12,-75585.84
2032,8/25/2020,8/25/2020,Alan Safran,Imported from Bank of America Visa-Background checks for fellows,,HJ,,4.89,-75590.73
2032,8/25/2020,8/25/2020,Alan Safran,Imported from Bank of America Visa-Background checks for fellows,,HJ,,4.89,-75595.62
2032,8/25/2020,8/25/2020,Alan Safran,Imported from Bank of America Visa-Background checks for fellows,,HJ,,5.56,-75601.18
2032,8/25/2020,8/25/2020,Alan Safran,Imported from Bank of America Visa-Background checks for fellows,,HJ,,6.2,-75607.38
2032,8/25/2020,8/25/2020,Alan Safran,Imported from Bank of America Visa-Background checks for fellows,,HJ,,6.2,-75613.58
2032,8/25/2020,8/25/2020,Alan Safran,Imported from Bank of America Visa-Background checks for fellows,,HJ,,6.21,-75619.79
2032,8/25/2020,8/25/2020,Alan Safran,Imported from Bank of America Visa-Background checks for fellows,,HJ,,6.21,-75626
2032,8/25/2020,8/25/2020,Alan Safran,Imported from Bank of America Visa-Background checks for fellows,,HJ,,8.58,-75634.58
2032,8/25/2020,8/25/2020,Alan Safran,Imported from Bank of America Visa-Background checks for fellows,,HJ,,8.59,-75643.17
2032,8/25/2020,8/25/2020,Alan Safran,Imported from Bank of America Visa-Background checks for fellows,,HJ,,13.48,-75656.65
2032,8/25/2020,8/25/2020,Alan Safran,Imported from Bank of America Visa-Background checks for fellows,,HJ,,13.48,-75670.13
2032,8/25/2020,8/25/2020,Alan Safran,Imported from Bank of America Visa-Background checks for fellows,,HJ,,15.81,-75685.94
2032,8/25/2020,8/25/2020,Alan Safran,Imported from Bank of America Visa-Background checks for fellows,,HJ,,20.07,-75706.01
2032,8/25/2020,8/25/2020,Alan Safran,Imported from Bank of America Visa-Background checks for fellows,,HJ,,20.07,-75726.08
2032,8/25/2020,8/25/2020,Alan Safran,Imported from Bank of America Visa-Background checks for fellows,,HJ,,20.82,-75746.9
2032,8/25/2020,8/25/2020,Alan Safran,Imported from Bank of America Visa-Background checks for fellows,,HJ,,20.82,-75767.72
2032,8/25/2020,8/25/2020,Alan Safran,Imported from Bank of America Visa-Background checks for fellows,,HJ,,20.83,-75788.55
2032,8/25/2020,8/25/2020,Alan Safran,Imported from Bank of America Visa-Background checks for fellows,,HJ,,20.83,-75809.38
2032,8/25/2020,8/25/2020,Alan Safran,Imported from Bank of America Visa-Background checks for fellows,,HJ,,27.77,-75837.15
2032,8/25/2020,8/25/2020,Alan Safran,Imported from Bank of America Visa-Background checks for fellows,,HJ,,67.37,-75904.52
2032,8/25/2020,8/25/2020,Alan Safran,Imported from Bank of America Visa-Background checks for fellows,,HJ,,67.37,-75971.89
2032,8/25/2020,8/25/2020,Denise Parham-Gantt,Imported from Bank of America Visa-office chair,,HJ,,84.99,-76056.88
2032,8/25/2020,8/25/2020,Elizabeth Peinado,Imported from Bank of America Visa-Fellow Staff advertising. Brand Awareness,,HJ,,11.36,-76068.24
2032,8/25/2020,8/25/2020,Elizabeth Peinado,Imported from Bank of America Visa-Fellow Staff advertising. Brand Awareness,,HJ,,17.55,-76085.79
2032,8/25/2020,8/25/2020,Elizabeth Peinado,Imported from Bank of America Visa-Fellow Staff advertising. Brand Awareness,,HJ,,17.55,-76103.34
2032,8/25/2020,8/25/2020,Elizabeth Peinado,Imported from Bank of America Visa-Fellow Staff advertising. Brand Awareness,,HJ,,56.77,-76160.11
2032,8/25/2020,8/25/2020,Halley Bowman,Imported from Bank of America Visa-Keyboard for Emily,,HJ,,31.79,-76191.9
2032,8/25/2020,8/25/2020,Jennifer Winans,Imported from Bank of America Visa-Recruitment PD,,HJ,,169.22,-76361.12
2032,8/25/2020,8/25/2020,Joseph Zarate,Imported from Bank of America Visa-New hire equipment,,HJ,,9.89,-76371.01
2032,8/25/2020,8/25/2020,Joseph Zarate,Imported from Bank of America Visa-New hire equipment,,HJ,,10.99,-76382
2032,8/25/2020,8/25/2020,Joseph Zarate,Imported from Bank of America Visa-New hire equipment,,HJ,,23.75,-76405.75
2032,8/25/2020,8/25/2020,Joseph Zarate,Imported from Bank of America Visa-New hire equipment,,HJ,,23.75,-76429.5
2032,8/25/2020,8/25/2020,Joseph Zarate,Imported from Bank of America Visa-New hire equipment,,HJ,,33.2,-76462.7
2032,8/25/2020,8/25/2020,Joseph Zarate,Imported from Bank of America Visa-New hire equipment.returns,,HJ,,61.65,-76524.35
2032,8/25/2020,8/25/2020,Maryellen Leneghan,Imported from Bank of America Visa-Appreciation for DC DoP,,HJ,,49.5,-76573.85
2032,8/25/2020,8/25/2020,Myesha Hossain,Imported from Bank of America Visa-A. Philip Randolph Supplies,,HJ,,25.49,-76599.34
2032,8/25/2020,8/25/2020,Myesha Hossain,Imported from Bank of America Visa-A. Philip Randolph Supplies,,HJ,,25.49,-76624.83
2032,8/25/2020,8/25/2020,Myesha Hossain,Imported from Bank of America Visa-A. Philip Randolph Supplies,,HJ,,107.63,-76732.46
2032,8/25/2020,8/25/2020,Myesha Hossain,Imported from Bank of America Visa-Cleveland Supplies,,HJ,,47.95,-76780.41
2032,8/25/2020,8/25/2020,Myesha Hossain,Imported from Bank of America Visa-HSFI supplies,,HJ,,47.95,-76828.36
2032,8/25/2020,8/25/2020,Myesha Hossain,Imported from Bank of America Visa-HSFI supplies,,HJ,,47.95,-76876.31
2032,8/25/2020,8/25/2020,Myesha Hossain,Imported from Bank of America Visa-HSHPHS Supplies,,HJ,,50.98,-76927.29
2032,8/25/2020,8/25/2020,Myesha Hossain,Imported from Bank of America Visa-HSHPHS Supplies,,HJ,,215.26,-77142.55
2032,8/25/2020,8/25/2020,Myesha Hossain,Imported from Bank of America Visa-PPE & Cleaning supplies,,HJ,,95.9,-77238.45
2032,8/25/2020,8/25/2020,Myesha Hossain,Imported from Bank of America Visa-PPE & Cleaning supplies,,HJ,,107.63,-77346.08
2032,8/25/2020,8/25/2020,Nicole Prahin,Imported from Bank of America Visa-X Co.  swag sent to CSSI Director,,HJ,,9.2,-77355.28
2032,8/26/2020,8/26/2020,Alan Safran,Imported from Bank of America Visa-Background checks for fellows,,HJ,,5.56,-77360.84
2032,8/26/2020,8/26/2020,Alan Safran,Imported from Bank of America Visa-Background checks for fellows,,HJ,,8.58,-77369.42
2032,8/26/2020,8/26/2020,Alan Safran,Imported from Bank of America Visa-Background checks for fellows,,HJ,,8.59,-77378.01
2032,8/26/2020,8/26/2020,Alan Safran,Imported from Bank of America Visa-Background checks for fellows,,HJ,,13.48,-77391.49
2032,8/26/2020,8/26/2020,Alan Safran,Imported from Bank of America Visa-Background checks for fellows,,HJ,,20.82,-77412.31
2032,8/26/2020,8/26/2020,Alan Safran,Imported from Bank of America Visa-Background checks for fellows,,HJ,,20.83,-77433.14
2032,8/26/2020,8/26/2020,Alan Safran,Imported from Bank of America Visa-Background checks for fellows,,HJ,,27.77,-77460.91
2032,8/26/2020,8/26/2020,Alan Safran,Imported from Bank of America Visa-Background checks for fellows,,HJ,,67.37,-77528.28
2032,8/26/2020,8/26/2020,Antonio Gutierrez,Imported from Bank of America Visa-Fellow Recruitment,,HJ,,525,-78053.28
2032,8/26/2020,8/26/2020,Elizabeth Peinado,Imported from Bank of America Visa-Fellow Staff advertising. Brand Awareness,,HJ,,11.12,-78064.4
2032,8/26/2020,8/26/2020,Elizabeth Peinado,Imported from Bank of America Visa-Fellow Staff advertising. Brand Awareness,,HJ,,17.19,-78081.59
2032,8/26/2020,8/26/2020,Elizabeth Peinado,Imported from Bank of America Visa-Fellow Staff advertising. Brand Awareness,,HJ,,17.19,-78098.78
2032,8/26/2020,8/26/2020,Elizabeth Peinado,Imported from Bank of America Visa-Fellow Staff advertising. Brand Awareness,,HJ,,55.6,-78154.38
2032,8/26/2020,8/26/2020,Jennifer Winans,Imported from Bank of America Visa-Recruitment PD,,HJ,,3.38,-78157.76
2032,8/26/2020,8/26/2020,Joseph Zarate,Imported from Bank of America Visa-New hire equipment,,HJ,,15.05,-78172.81
2032,8/26/2020,8/26/2020,Joseph Zarate,Imported from Bank of America Visa-New hire equipment,,HJ,,60.2,-78233.01
2032,8/26/2020,8/26/2020,Joseph Zarate,Imported from Bank of America Visa-New hire equipment,,HJ,,79.99,-78313
2032,8/26/2020,8/26/2020,Kyra Detone,Imported from Bank of America Visa-Laptop Stand. Grant Team Supplies Remote Work,,HJ,,49.63,-78362.63
2032,8/26/2020,8/26/2020,Myesha Hossain,Imported from Bank of America Visa-A. Philip Randolph Supplies,,HJ,,32.99,-78395.62
2032,8/26/2020,8/26/2020,Myesha Hossain,Imported from Bank of America Visa-PPE and Cleaning Supplies,,HJ,,107.63,-78503.25
2032,8/26/2020,8/26/2020,Myesha Hossain,Imported from Bank of America Visa-Training,,HJ,,13.38,-78516.63
2032,8/27/2020,8/27/2020,Antonio Gutierrez,Imported from Bank of America Visa-Fellow Recruitment,,HJ,,151.69,-78668.32
2032,8/27/2020,8/27/2020,Antonio Gutierrez,Imported from Bank of America Visa-X Co.  Promotional gear for Monica Bahtt,,HJ,,29.7,-78698.02
2032,8/27/2020,8/27/2020,Joseph Zarate,Imported from Bank of America Visa-New hire equipment,,HJ,,9.89,-78707.91
2032,8/27/2020,8/27/2020,Joseph Zarate,Imported from Bank of America Visa-New hire equipment,,HJ,,9.89,-78717.8
2032,8/27/2020,8/27/2020,Joseph Zarate,Imported from Bank of America Visa-New hire equipment,,HJ,,15.05,-78732.85
2032,8/27/2020,8/27/2020,Joseph Zarate,Imported from Bank of America Visa-equipment,,HJ,,8.3,-78741.15
2032,8/27/2020,8/27/2020,Myesha Hossain,Imported from Bank of America Visa-DoP PPE,,HJ,,4.5,-78745.65
2032,8/27/2020,8/27/2020,Myesha Hossain,Imported from Bank of America Visa-Fellow Social Raffle Prize,,HJ,,14.99,-78760.64
2032,8/27/2020,8/27/2020,Myesha Hossain,Imported from Bank of America Visa-Fellow Training,,HJ,,10.14,-78770.78
2032,8/27/2020,8/27/2020,Myesha Hossain,Imported from Bank of America Visa-PPE Gear for Staff,,HJ,,4.8,-78775.58
2032,8/27/2020,8/27/2020,Myesha Hossain,Imported from Bank of America Visa-PPE Gear for Staff,,HJ,,7.8,-78783.38
2032,8/27/2020,8/27/2020,Myesha Hossain,Imported from Bank of America Visa-PPE Gear for Staff,,HJ,,32.99,-78816.37
2032,8/27/2020,8/27/2020,Myesha Hossain,Imported from Bank of America Visa-Staff Appreciation,,HJ,,10.64,-78827.01
2032,8/27/2020,8/27/2020,Myesha Hossain,Imported from Bank of America Visa-Staff Appreciation,,HJ,,15.44,-78842.45
2032,8/27/2020,8/27/2020,Myesha Hossain,Imported from Bank of America Visa-Staff Appreciation,,HJ,,17,-78859.45
2032,8/27/2020,8/27/2020,Myesha Hossain,Imported from Bank of America Visa-Staff Appreciation,,HJ,,44.94,-78904.39
2032,8/27/2020,8/27/2020,Myesha Hossain,Imported from Bank of America Visa-Training,,HJ,,13.38,-78917.77
2032,8/27/2020,8/27/2020,Uriel Guadarrama,Imported from Bank of America Visa-Zoom for SDs,,HJ,,88.78,-79006.55
2032,8/27/2020,8/27/2020,Uriel Guadarrama,Imported from Bank of America Visa-Zoom for SDs,,HJ,,137.21,-79143.76
2032,8/27/2020,8/27/2020,Uriel Guadarrama,Imported from Bank of America Visa-Zoom for SDs,,HJ,,137.21,-79280.97
2032,8/27/2020,8/27/2020,Uriel Guadarrama,Imported from Bank of America Visa-Zoom for SDs,,HJ,,443.9,-79724.87
2032,8/28/2020,8/28/2020,Alan Safran,Imported from Bank of America Visa-Background checks for fellows,,HJ,,3.16,-79728.03
2032,8/28/2020,8/28/2020,Alan Safran,Imported from Bank of America Visa-Background checks for fellows,,HJ,,4.02,-79732.05
2032,8/28/2020,8/28/2020,Alan Safran,Imported from Bank of America Visa-Background checks for fellows,,HJ,,4.02,-79736.07
2032,8/28/2020,8/28/2020,Alan Safran,Imported from Bank of America Visa-Background checks for fellows,,HJ,,4.89,-79740.96
2032,8/28/2020,8/28/2020,Alan Safran,Imported from Bank of America Visa-Background checks for fellows,,HJ,,4.89,-79745.85
2032,8/28/2020,8/28/2020,Alan Safran,Imported from Bank of America Visa-Background checks for fellows,,HJ,,6.2,-79752.05
2032,8/28/2020,8/28/2020,Alan Safran,Imported from Bank of America Visa-Background checks for fellows,,HJ,,6.2,-79758.25
2032,8/28/2020,8/28/2020,Alan Safran,Imported from Bank of America Visa-Background checks for fellows,,HJ,,6.21,-79764.46
2032,8/28/2020,8/28/2020,Alan Safran,Imported from Bank of America Visa-Background checks for fellows,,HJ,,6.21,-79770.67
2032,8/28/2020,8/28/2020,Alan Safran,Imported from Bank of America Visa-Background checks for fellows,,HJ,,15.81,-79786.48
2032,8/28/2020,8/28/2020,Alan Safran,Imported from Bank of America Visa-Background checks for fellows,,HJ,,20.07,-79806.55
2032,8/28/2020,8/28/2020,Alan Safran,Imported from Bank of America Visa-Background checks for fellows,,HJ,,20.07,-79826.62
2032,8/28/2020,8/28/2020,Antonio Gutierrez,Imported from Bank of America Visa-Professional Development,,HJ,,13.92,-79840.54
2032,8/28/2020,8/28/2020,Elizabeth Peinado,Imported from Bank of America Visa-Fellow Staff advertising. Brand Awareness,,HJ,,20.37,-79860.91
2032,8/28/2020,8/28/2020,Elizabeth Peinado,Imported from Bank of America Visa-Fellow Staff advertising. Brand Awareness,,HJ,,31.47,-79892.38
2032,8/28/2020,8/28/2020,Elizabeth Peinado,Imported from Bank of America Visa-Fellow Staff advertising. Brand Awareness,,HJ,,31.47,-79923.85
2032,8/28/2020,8/28/2020,Elizabeth Peinado,Imported from Bank of America Visa-Fellow Staff advertising. Brand Awareness,,HJ,,101.83,-80025.68
2032,8/28/2020,8/28/2020,Joseph Zarate,Imported from Bank of America Visa-New hire equipment,,HJ,,49,-80074.68
2032,8/28/2020,8/28/2020,Joseph Zarate,Imported from Bank of America Visa-New hire equipment.returns,,HJ,,29.4,-80104.08
2032,8/28/2020,8/28/2020,Monivett Acevedo,Imported from Bank of America Visa-Office Ink,,HJ,,10.61,-80114.69
2032,8/28/2020,8/28/2020,Myesha Hossain,Imported from Bank of America Visa-PPE Gear for Staff,,HJ,,8.32,-80123.01
2032,8/28/2020,8/28/2020,Myesha Hossain,Imported from Bank of America Visa-PPE Gear for Staff,,HJ,,9.99,-80133
2032,8/28/2020,8/28/2020,Myesha Hossain,Imported from Bank of America Visa-Packaging supplies,,HJ,,41.89,-80174.89
2032,8/28/2020,8/28/2020,Myesha Hossain,Imported from Bank of America Visa-Training,,HJ,,19.52,-80194.41
2032,8/28/2020,8/28/2020,Myesha Hossain,Imported from Bank of America Visa-Training,,HJ,,20.22,-80214.63
2032,8/29/2020,8/29/2020,Myesha Hossain,Imported from Bank of America Visa-PPE Gear for Staff,,HJ,,65.98,-80280.61
2032,8/29/2020,8/29/2020,Myesha Hossain,Imported from Bank of America Visa-Staff Appreciation,,HJ,,180.7,-80461.31
2032,8/29/2020,8/29/2020,Myesha Hossain,Imported from Bank of America Visa-Storage,,HJ,,95.3,-80556.61
2032,8/29/2020,8/29/2020,Tiffany Jordan,Imported from Bank of America Visa-Internet booster,,HJ,,35.05,-80591.66
2032,8/30/2020,8/30/2020,Joseph Zarate,Imported from Bank of America Visa-refund,,HJ,19.09,,-80572.57
2032,8/30/2020,8/30/2020,Kyra Detone,Imported from Bank of America Visa-Wristpad & Mouse Pad. Grants Team Remote Work,,HJ,,13.09,-80585.66
2032,9/1/2020,9/1/2020,Alan Safran,Imported from Bank of America Visa-Bank Service Fees and Charges,,HJ,,15,-80600.66
2032,9/1/2020,9/1/2020,Antonio Gutierrez,Imported from Bank of America Visa-expense reporting,,HJ,,1226.38,-81827.04
2032,9/1/2020,9/1/2020,Elizabeth Peinado,Imported from Bank of America Visa-National brand awareness,,HJ,,7.46,-81834.5
2032,9/1/2020,9/1/2020,Elizabeth Peinado,Imported from Bank of America Visa-National brand awareness,,HJ,,11.53,-81846.03
2032,9/1/2020,9/1/2020,Elizabeth Peinado,Imported from Bank of America Visa-National brand awareness,,HJ,,11.53,-81857.56
2032,9/1/2020,9/1/2020,Elizabeth Peinado,Imported from Bank of America Visa-National brand awareness,,HJ,,37.28,-81894.84
2032,9/1/2020,9/1/2020,Elizabeth Peinado,Imported from Bank of America Visa-Refund for remaining balance,,HJ,58.21,,-81836.63
2032,9/1/2020,9/1/2020,Elizabeth Peinado,Imported from Bank of America Visa-Refund for remaining balance,,HJ,89.96,,-81746.67
2032,9/1/2020,9/1/2020,Elizabeth Peinado,Imported from Bank of America Visa-Refund for remaining balance,,HJ,89.96,,-81656.71
2032,9/1/2020,9/1/2020,Elizabeth Peinado,Imported from Bank of America Visa-Refund for remaining balance,,HJ,291.07,,-81365.64
2032,9/1/2020,9/1/2020,Elizabeth Peinado,Imported from Bank of America Visa-Staf postings. all regions depts,,HJ,,2.94,-81368.58
2032,9/1/2020,9/1/2020,Elizabeth Peinado,Imported from Bank of America Visa-Staf postings. all regions depts,,HJ,,4.54,-81373.12
2032,9/1/2020,9/1/2020,Elizabeth Peinado,Imported from Bank of America Visa-Staf postings. all regions depts,,HJ,,4.54,-81377.66
2032,9/1/2020,9/1/2020,Elizabeth Peinado,Imported from Bank of America Visa-Staf postings. all regions depts,,HJ,,14.71,-81392.37
2032,9/1/2020,9/1/2020,Elizabeth Peinado,Imported from Bank of America Visa-Staf postings. all regions depts,,HJ,,346.5,-81738.87
2032,9/1/2020,9/1/2020,Elizabeth Peinado,Imported from Bank of America Visa-Staf postings. all regions depts,,HJ,,535.5,-82274.37
2032,9/1/2020,9/1/2020,Elizabeth Peinado,Imported from Bank of America Visa-Staf postings. all regions depts,,HJ,,535.5,-82809.87
2032,9/1/2020,9/1/2020,Elizabeth Peinado,Imported from Bank of America Visa-Staf postings. all regions depts,,HJ,,551.4,-83361.27
2032,9/1/2020,9/1/2020,Elizabeth Peinado,Imported from Bank of America Visa-Staf postings. all regions depts,,HJ,,852.17,-84213.44
2032,9/1/2020,9/1/2020,Elizabeth Peinado,Imported from Bank of America Visa-Staf postings. all regions depts,,HJ,,852.17,-85065.61
2032,9/1/2020,9/1/2020,Elizabeth Peinado,Imported from Bank of America Visa-Staf postings. all regions depts,,HJ,,1732.5,-86798.11
2032,9/1/2020,9/1/2020,Elizabeth Peinado,Imported from Bank of America Visa-Staf postings. all regions depts,,HJ,,2757.01,-89555.12
2032,9/1/2020,9/1/2020,Joseph Zarate,Imported from Bank of America Visa-New hire equipment,,HJ,6.75,,-89548.37
2032,9/1/2020,9/1/2020,Joseph Zarate,Imported from Bank of America Visa-New hire equipment,,HJ,,11.67,-89560.04
2032,9/1/2020,9/1/2020,Joseph Zarate,Imported from Bank of America Visa-New hire equipment,,HJ,,11.68,-89571.72
2032,9/1/2020,9/1/2020,Joseph Zarate,Imported from Bank of America Visa-New hire equipment,,HJ,,913.97,-90485.69
2032,9/1/2020,9/1/2020,Joseph Zarate,Imported from Bank of America Visa-shipping,,HJ,,8.3,-90493.99
2032,9/1/2020,9/1/2020,Kyra Detone,Imported from Bank of America Visa-Breakfast + Coffee for two; Finance & Grants Meeting,,HJ,,23.22,-90517.21
2032,9/1/2020,9/1/2020,Kyra Detone,Imported from Bank of America Visa-Lunch for two Finance Grants Meeting,,HJ,,46.75,-90563.96
2032,9/1/2020,9/1/2020,Lisa Kapusta,Imported from Bank of America Visa-Care package item,,HJ,,232.05,-90796.01
2032,9/1/2020,9/1/2020,Monivett Acevedo,Imported from Bank of America Visa-Meals Team Meetings,,HJ,,17.65,-90813.66
2032,9/1/2020,9/1/2020,Myesha Hossain,Imported from Bank of America Visa-Fellow Training,,HJ,,9.99,-90823.65
2032,9/1/2020,9/1/2020,Myesha Hossain,Imported from Bank of America Visa-Fingerprinting,,HJ,,135,-90958.65
2032,9/1/2020,9/1/2020,Myesha Hossain,Imported from Bank of America Visa-Fingerprinting,,HJ,,135,-91093.65
2032,9/1/2020,9/1/2020,Myesha Hossain,Imported from Bank of America Visa-Fingerprinting,,HJ,,135,-91228.65
2032,9/1/2020,9/1/2020,Myesha Hossain,Imported from Bank of America Visa-PPE,,HJ,,32.99,-91261.64
2032,9/1/2020,9/1/2020,Myesha Hossain,Imported from Bank of America Visa-PPE Gear for APR,,HJ,,25.49,-91287.13
2032,9/2/2020,9/2/2020,Alan Safran,Imported from Bank of America Visa-Background Checks for Fellows,,HJ,,4.02,-91291.15
2032,9/2/2020,9/2/2020,Alan Safran,Imported from Bank of America Visa-Background Checks for Fellows,,HJ,,6.2,-91297.35
2032,9/2/2020,9/2/2020,Alan Safran,Imported from Bank of America Visa-Background Checks for Fellows,,HJ,,6.21,-91303.56
2032,9/2/2020,9/2/2020,Alan Safran,Imported from Bank of America Visa-Background Checks for Fellows,,HJ,,20.07,-91323.63
2032,9/2/2020,9/2/2020,Angela Mason,Imported from Bank of America Visa-Storage unit,,HJ,,149,-91472.63
2032,9/2/2020,9/2/2020,Angela Mason,Imported from Bank of America Visa-Storage unit Chicago,,HJ,,173,-91645.63
2032,9/2/2020,9/2/2020,Antonio Gutierrez,Imported from Bank of America Visa-Fellow Recruitment,,HJ,,400,-92045.63
2032,9/2/2020,9/2/2020,Antonio Gutierrez,Imported from Bank of America Visa-storage space for google drive,,HJ,,1.99,-92047.62
2032,9/2/2020,9/2/2020,Elecia D Lacey,Imported from Bank of America Visa-Final charge on behalf of Elecia,,HJ,,49,-92096.62
2032,9/2/2020,9/2/2020,iaklestad,Imported from Bank of America Visa-Mailing Welcome Packages,,HJ,,13.95,-92110.57
2032,9/2/2020,9/2/2020,Joseph Zarate,Imported from Bank of America Visa-New hire equipment,,HJ,,24.99,-92135.56
2032,9/2/2020,9/2/2020,Joseph Zarate,Imported from Bank of America Visa-New hire equipment,,HJ,,224.99,-92360.55
2032,9/2/2020,9/2/2020,Joseph Zarate,Imported from Bank of America Visa-New hire equipment,,HJ,,224.99,-92585.54
2032,9/2/2020,9/2/2020,Joseph Zarate,Imported from Bank of America Visa-New hire equipment returns,,HJ,,21.1,-92606.64
2032,9/2/2020,9/2/2020,Mahaliah Sejour,Imported from Bank of America Visa-MS mouse pad,,HJ,,9.48,-92616.12
2032,9/2/2020,9/2/2020,Myesha Hossain,Imported from Bank of America Visa-Fingerprinting,,HJ,,135,-92751.12
2032,9/2/2020,9/2/2020,Myesha Hossain,Imported from Bank of America Visa-Training,,HJ,,18.24,-92769.36
2032,9/3/2020,9/3/2020,Antonio Gutierrez,Imported from Bank of America Visa-Fellow Recruitment,,HJ,,900,-93669.36
2032,9/3/2020,9/3/2020,Mahaliah Sejour,Imported from Bank of America Visa-Fellows gifts,,HJ,,39.95,-93709.31
2032,9/3/2020,9/3/2020,Mahaliah Sejour,Imported from Bank of America Visa-SD gifts,,HJ,,197.82,-93907.13
2032,9/3/2020,9/3/2020,Mahaliah Sejour,Imported from Bank of America Visa-harlan printer,,HJ,,5.35,-93912.48
2032,9/3/2020,9/3/2020,Monivett Acevedo,Imported from Bank of America Visa-Ink for Office Printer,,HJ,,10.61,-93923.09
2032,9/3/2020,9/3/2020,Uriel Guadarrama,Imported from Bank of America Visa-Monday.com licenses for 5 more users,,HJ,,1456.55,-95379.64
2032,9/4/2020,9/4/2020,Alan Safran,Imported from Bank of America Visa-Monthly google storage cost,,HJ,,1.99,-95381.63
2032,9/4/2020,9/4/2020,Angela Mason,Imported from Bank of America Visa-Pens calendar and planner,,HJ,,42.1,-95423.73
2032,9/4/2020,9/4/2020,Bank of America VISA,BofA CC Transactions August Payments-BofA CC Transaction August Payment,,HJ,264.99,,-95158.74
2032,9/4/2020,9/4/2020,Bank of America VISA,BofA CC Transactions August Payments-BofA CC Transaction August Payment,,HJ,719.26,,-94439.48
2032,9/4/2020,9/4/2020,Bank of America VISA,BofA CC Transactions August Payments-BofA CC Transaction August Payment,,HJ,2624,,-91815.48
2032,9/4/2020,9/4/2020,Bank of America VISA,BofA CC Transactions August Payments-BofA CC Transaction August Payment,,HJ,3395.14,,-88420.34
2032,9/4/2020,9/4/2020,Bank of America VISA,BofA CC Transactions August Payments-BofA CC Transaction August Payment,,HJ,9193.8,,-79226.54
2032,9/4/2020,9/4/2020,Bank of America VISA,BofA CC Transactions August Payments-BofA CC Transaction August Payment,,HJ,11186.79,,-68039.75
2032,9/4/2020,9/4/2020,Bank of America VISA,BofA CC Transactions August Payments-BofA CC Transaction August Payment,,HJ,15240.51,,-52799.24
2032,9/4/2020,9/4/2020,Bank of America VISA,BofA CC Transactions August Payments-BofA CC Transaction August Payment,,HJ,37961.17,,-14838.07
2032,9/4/2020,9/4/2020,Joseph Zarate,Imported from Bank of America Visa-New hire equipment,,HJ,,10.99,-14849.06
2032,9/4/2020,9/4/2020,Joseph Zarate,Imported from Bank of America Visa-New hire equipment,,HJ,,10.99,-14860.05
2032,9/4/2020,9/4/2020,Joseph Zarate,Imported from Bank of America Visa-New hire equipment,,HJ,,112.01,-14972.06
2032,9/4/2020,9/4/2020,Maryellen Leneghan,Imported from Bank of America Visa-SD and DoP appreciation,,HJ,,17.11,-14989.17
2032,9/4/2020,9/4/2020,Maryellen Leneghan,Imported from Bank of America Visa-SD and DoP appreciation,,HJ,,17.11,-15006.28
2032,9/4/2020,9/4/2020,Maryellen Leneghan,Imported from Bank of America Visa-SD and DoP appreciation,,HJ,,18.18,-15024.46
2032,9/4/2020,9/4/2020,Maryellen Leneghan,Imported from Bank of America Visa-X Co.  shirts for SDs in BC postage,,HJ,,15.75,-15040.21
2032,9/4/2020,9/4/2020,Myesha Hossain,Imported from Bank of America Visa-Fingerprinting,,HJ,,135,-15175.21
2032,9/4/2020,9/4/2020,Myesha Hossain,Imported from Bank of America Visa-Fingerprinting,,HJ,,135,-15310.21
2032,9/4/2020,9/4/2020,Myesha Hossain,Imported from Bank of America Visa-Fingerprinting,,HJ,,135,-15445.21
2032,9/5/2020,9/5/2020,Alan Safran,Imported from Bank of America Visa-Personal expenses. Will be reimbursed,,HJ,,48.22,-15493.43
2032,9/5/2020,9/5/2020,Joseph Zarate,Imported from Bank of America Visa-New hire equipment,,HJ,,79.99,-15573.42
2032,9/5/2020,9/5/2020,Joseph Zarate,Imported from Bank of America Visa-New hire equipment,,HJ,,139.88,-15713.3
2032,9/5/2020,9/5/2020,Joseph Zarate,Imported from Bank of America Visa-New hire equipment,,HJ,,833.78,-16547.08
2032,9/5/2020,9/5/2020,Maryellen Leneghan,Imported from Bank of America Visa-SD and DoP appreciation,,HJ,,17.11,-16564.19
2032,9/5/2020,9/5/2020,Maryellen Leneghan,Imported from Bank of America Visa-SD and DoP appreciation,,HJ,,17.11,-16581.3
2032,9/5/2020,9/5/2020,Maryellen Leneghan,Imported from Bank of America Visa-SD and DoP appreciation,,HJ,,17.11,-16598.41
2032,9/5/2020,9/5/2020,Maryellen Leneghan,Imported from Bank of America Visa-SD and DoP appreciation,,HJ,,18.01,-16616.42
2032,9/5/2020,9/5/2020,Maryellen Leneghan,Imported from Bank of America Visa-SD and DoP appreciation,,HJ,,18.09,-16634.51
2032,9/6/2020,9/6/2020,Joseph Zarate,Imported from Bank of America Visa-New hire equipment,,HJ,,79.99,-16714.5
2032,9/7/2020,9/7/2020,Alan Safran,Imported from Bank of America Visa-Personal expenses. Will be reimbursed,,HJ,,5,-16719.5
2032,9/8/2020,9/8/2020,Alan Safran,Imported from Bank of America Visa-Background Checks for Fellows,,HJ,,5.56,-16725.06
2032,9/8/2020,9/8/2020,Alan Safran,Imported from Bank of America Visa-Background Checks for Fellows,,HJ,,8.58,-16733.64
2032,9/8/2020,9/8/2020,Alan Safran,Imported from Bank of America Visa-Background Checks for Fellows,,HJ,,8.59,-16742.23
2032,9/8/2020,9/8/2020,Alan Safran,Imported from Bank of America Visa-Background Checks for Fellows,,HJ,,27.77,-16770
2032,9/8/2020,9/8/2020,Maryellen Leneghan,Imported from Bank of America Visa-SD and DoP appreciation,,HJ,,17.11,-16787.11
2032,9/8/2020,9/8/2020,Maryellen Leneghan,Imported from Bank of America Visa-SD and DoP appreciation,,HJ,,18.01,-16805.12
2032,9/8/2020,9/8/2020,Maryellen Leneghan,Imported from Bank of America Visa-SD and DoP appreciation,,HJ,,18.01,-16823.13
2032,9/8/2020,9/8/2020,Maryellen Leneghan,Imported from Bank of America Visa-SD and DoP appreciation,,HJ,,18.01,-16841.14
2032,9/8/2020,9/8/2020,Monivett Acevedo,Imported from Bank of America Visa-ADOBE,,HJ,,14.99,-16856.13
2032,9/8/2020,9/8/2020,Monivett Acevedo,Imported from Bank of America Visa-monthly accounting module,,HJ,,210.77,-17066.9
2032,9/8/2020,9/8/2020,Myesha Hossain,Imported from Bank of America Visa-Fingerprinting,,HJ,,135,-17201.9
2032,9/9/2020,9/9/2020,Antonio Gutierrez,Imported from Bank of America Visa-background check,,HJ,,7.5,-17209.4
2032,9/9/2020,9/9/2020,Antonio Gutierrez,Imported from Bank of America Visa-background check,,HJ,,122.5,-17331.9
2032,9/9/2020,9/9/2020,claice Jackson,Imported from Bank of America Visa-Staff Appreciation,,HJ,,11.3,-17343.2
2032,9/9/2020,9/9/2020,Denise Parham-Gantt,Imported from Bank of America Visa-collecting SAT devices for general use,,HJ,,50,-17393.2
2032,9/9/2020,9/9/2020,Kyra Detone,Imported from Bank of America Visa-Gallup Strengths Test Fee. Grants Team Professional Dev,,HJ,,53.11,-17446.31
2032,9/9/2020,9/9/2020,Kyra Detone,Imported from Bank of America Visa-Wrist Rest. Mouse Pad. Supplies for Remote Work. Grants Team,,HJ,,21.84,-17468.15
2032,9/9/2020,9/9/2020,Monivett Acevedo,Imported from Bank of America Visa-Home office supplies,,HJ,,45.99,-17514.14
2032,9/9/2020,9/9/2020,Myesha Hossain,Imported from Bank of America Visa-Fingerprinting,,HJ,,135,-17649.14
2032,9/10/2020,9/10/2020,Alan Safran,Imported from Bank of America Visa-Background Checks for Fellows,,HJ,,5.56,-17654.7
2032,9/10/2020,9/10/2020,Alan Safran,Imported from Bank of America Visa-Background Checks for Fellows,,HJ,,8.58,-17663.28
2032,9/10/2020,9/10/2020,Alan Safran,Imported from Bank of America Visa-Background Checks for Fellows,,HJ,,8.59,-17671.87
2032,9/10/2020,9/10/2020,Alan Safran,Imported from Bank of America Visa-Background Checks for Fellows,,HJ,,27.77,-17699.64
2032,9/10/2020,9/10/2020,Monivett Acevedo,Imported from Bank of America Visa-Teams activity handbook,,HJ,,49.99,-17749.63
2032,9/10/2020,9/10/2020,Nicole Prahin,Imported from Bank of America Visa-Ink for at home work use,,HJ,,5.35,-17754.98
2032,9/11/2020,9/11/2020,Amena Wallace,Imported from Bank of America Visa-Recruitment Inbox and Drive storage,,HJ,,19.99,-17774.97
2032,9/11/2020,9/11/2020,Antonio Gutierrez,Imported from Bank of America Visa-Fellow Recruitment,,HJ,,900,-18674.97
2032,9/11/2020,9/11/2020,Antonio Gutierrez,Imported from Bank of America Visa-Office Supplies,,HJ,,46.24,-18721.21
2032,9/11/2020,9/11/2020,Antonio Gutierrez,Imported from Bank of America Visa-stamps for face mask mailing,,HJ,,60,-18781.21
2032,9/11/2020,9/11/2020,Antonio Gutierrez,Imported from Bank of America Visa-supplies for distributing face masks to sites,,HJ,,15.71,-18796.92
2032,9/11/2020,9/11/2020,Joseph Zarate,Imported from Bank of America Visa-New hire equipment,,HJ,,25,-18821.92
2032,9/11/2020,9/11/2020,Joseph Zarate,Imported from Bank of America Visa-equipment,,HJ,,17.59,-18839.51
2032,9/11/2020,9/11/2020,Myesha Hossain,Imported from Bank of America Visa-DOE incorrect transaction,,HJ,,60,-18899.51
2032,9/12/2020,9/12/2020,Antonio Gutierrez,Imported from Bank of America Visa-Supplies. face mask postage,,HJ,,10,-18909.51
2032,9/12/2020,9/12/2020,Antonio Gutierrez,Imported from Bank of America Visa-phone and fax system,,HJ,,234.79,-19144.3
2032,9/12/2020,9/12/2020,Joseph Zarate,Imported from Bank of America Visa-New hire equipment,,HJ,,13.99,-19158.29
2032,9/12/2020,9/12/2020,Joseph Zarate,Imported from Bank of America Visa-New hire equipment,,HJ,,104.68,-19262.97
2032,9/12/2020,9/12/2020,Joseph Zarate,Imported from Bank of America Visa-New hire equipment,,HJ,,128.46,-19391.43
2032,9/12/2020,9/12/2020,Joseph Zarate,Imported from Bank of America Visa-equipment,,HJ,,13.99,-19405.42
2032,9/12/2020,9/12/2020,Joseph Zarate,Imported from Bank of America Visa-equipment,,HJ,,104.68,-19510.1
2032,9/12/2020,9/12/2020,Joseph Zarate,Imported from Bank of America Visa-equipment,,HJ,,104.68,-19614.78
2032,9/13/2020,9/13/2020,Denise Parham-Gantt,Imported from Bank of America Visa-woot puzzle prize,,HJ,,13.55,-19628.33
2032,9/13/2020,9/13/2020,Denise Parham-Gantt,Imported from Bank of America Visa-woot puzzle prize,,HJ,,14.43,-19642.76
2032,9/13/2020,9/13/2020,Denise Parham-Gantt,Imported from Bank of America Visa-woot puzzle prize,,HJ,,14.55,-19657.31
2032,9/13/2020,9/13/2020,Joseph Zarate,Imported from Bank of America Visa-New hire equipment,,HJ,,11.12,-19668.43
2032,9/14/2020,9/14/2020,Joseph Zarate,Imported from Bank of America Visa-equipment,,HJ,,30.1,-19698.53
2032,9/14/2020,9/14/2020,Myesha Hossain,Imported from Bank of America Visa-DOE incorrect transaction,,HJ,,60,-19758.53
2032,9/14/2020,9/14/2020,Myesha Hossain,Imported from Bank of America Visa-Dewey Supplies,,HJ,,156.57,-19915.1
2032,9/14/2020,9/14/2020,Myesha Hossain,Imported from Bank of America Visa-HSFI supplies,,HJ,,18,-19933.1
2032,9/14/2020,9/14/2020,Myesha Hossain,Imported from Bank of America Visa-HSFI supplies,,HJ,,256.77,-20189.87
2032,9/14/2020,9/14/2020,Myesha Hossain,Imported from Bank of America Visa-Moving Men for Supplies,,HJ,,155.95,-20345.82
2032,9/15/2020,9/15/2020,Alan Safran,Imported from Bank of America Visa-Background Checks for Fellows,,HJ,,2.92,-20348.74
2032,9/15/2020,9/15/2020,Alan Safran,Imported from Bank of America Visa-Background Checks for Fellows,,HJ,,2.92,-20351.66
2032,9/15/2020,9/15/2020,Alan Safran,Imported from Bank of America Visa-Background Checks for Fellows,,HJ,,4.5,-20356.16
2032,9/15/2020,9/15/2020,Alan Safran,Imported from Bank of America Visa-Background Checks for Fellows,,HJ,,4.5,-20360.66
2032,9/15/2020,9/15/2020,Alan Safran,Imported from Bank of America Visa-Background Checks for Fellows,,HJ,,4.51,-20365.17
2032,9/15/2020,9/15/2020,Alan Safran,Imported from Bank of America Visa-Background Checks for Fellows,,HJ,,4.51,-20369.68
2032,9/15/2020,9/15/2020,Alan Safran,Imported from Bank of America Visa-Background Checks for Fellows,,HJ,,14.57,-20384.25
2032,9/15/2020,9/15/2020,Alan Safran,Imported from Bank of America Visa-Background Checks for Fellows,,HJ,,14.57,-20398.82
2032,9/15/2020,9/15/2020,Denise Parham-Gantt,Imported from Bank of America Visa-woot puzzle prize,,HJ,,13.55,-20412.37
2032,9/15/2020,9/15/2020,Mahaliah Sejour,Imported from Bank of America Visa-MS printer,,HJ,,5.35,-20417.72
2032,9/15/2020,9/15/2020,Mahaliah Sejour,Imported from Bank of America Visa-Schurz Team Appreciation,,HJ,,66.82,-20484.54
2032,9/15/2020,9/15/2020,Monivett Acevedo,Imported from Bank of America Visa-Hotel for trip to Boston,,HJ,,486.49,-20971.03
2032,9/15/2020,9/15/2020,Monivett Acevedo,Imported from Bank of America Visa-Office Supplies,,HJ,,25.67,-20996.7
2032,9/15/2020,9/15/2020,Myesha Hossain,Imported from Bank of America Visa-Moving Men Tip,,HJ,,20,-21016.7
2032,9/15/2020,9/15/2020,Myesha Hossain,Imported from Bank of America Visa-Refund,,HJ,5.95,,-21010.75
2032,9/15/2020,9/15/2020,Myesha Hossain,Imported from Bank of America Visa-Site move in,,HJ,,79.47,-21090.22
2032,9/15/2020,9/15/2020,Myesha Hossain,Imported from Bank of America Visa-headphones for APR,,HJ,,239.98,-21330.2
2032,9/15/2020,9/15/2020,Myesha Hossain,Imported from Bank of America Visa-headphones for HSFI,,HJ,,119.99,-21450.19
2032,9/15/2020,9/15/2020,Tiffani Bibb,Imported from Bank of America Visa-Assessment for HR Admin Team,,HJ,,59.97,-21510.16
2032,9/15/2020,9/15/2020,Tiffani Bibb,Imported from Bank of America Visa-Printer for home office,,HJ,,213.88,-21724.04
2032,9/15/2020,9/15/2020,Uriel Guadarrama,Imported from Bank of America Visa-Up to 10 mail merge licenses for recruitment team,,HJ,,240,-21964.04
2032,9/16/2020,9/16/2020,Monivett Acevedo,Imported from Bank of America Visa-Gallup strengths activity book,,HJ,,122.81,-22086.85
2032,9/16/2020,9/16/2020,Myesha Hossain,Imported from Bank of America Visa-DOE incorrect transaction,,HJ,,60,-22146.85
2032,9/16/2020,9/16/2020,Myesha Hossain,Imported from Bank of America Visa-Headphones for Dewey,,HJ,,119.99,-22266.84
2032,9/16/2020,9/16/2020,Nicole Prahin,Imported from Bank of America Visa-Google drive storage space,,HJ,,2.13,-22268.97
2032,9/17/2020,9/17/2020,Joseph Zarate,Imported from Bank of America Visa-equipment,,HJ,,8.3,-22277.27
2032,9/18/2020,9/18/2020,Alan Safran,Imported from Bank of America Visa-Monthly HP instant ink for office,,HJ,,10.61,-22287.88
2032,9/18/2020,9/18/2020,iaklestad,Imported from Bank of America Visa-SUNY Stony Brook Fair,,HJ,,75,-22362.88
2032,9/18/2020,9/18/2020,Jennifer Winans,Imported from Bank of America Visa-Career Fair,,HJ,,125,-22487.88
2032,9/18/2020,9/18/2020,Joseph Zarate,Imported from Bank of America Visa-New hire equipment,,HJ,,8.3,-22496.18
2032,9/18/2020,9/18/2020,Joseph Zarate,Imported from Bank of America Visa-New hire equipment,,HJ,,259.12,-22755.3
2032,9/18/2020,9/18/2020,Joseph Zarate,Imported from Bank of America Visa-New hire equipment,,HJ,,790,-23545.3
2032,9/18/2020,9/18/2020,Joseph Zarate,Imported from Bank of America Visa-equipment,,HJ,,11.65,-23556.95
2032,9/18/2020,9/18/2020,Joseph Zarate,Imported from Bank of America Visa-equipment,,HJ,,51.94,-23608.89
2032,9/18/2020,9/18/2020,Miranda Cortez,Imported from Bank of America Visa-Career Fairs Fees,,HJ,,150,-23758.89
2032,9/18/2020,9/18/2020,Myesha Hossain,Imported from Bank of America Visa-HSFI supplies,,HJ,,37.75,-23796.64
2032,9/18/2020,9/18/2020,Myesha Hossain,Imported from Bank of America Visa-Parking for site supply drop off,,HJ,,0.75,-23797.39
2032,9/19/2020,9/19/2020,Antonio Gutierrez,Imported from Bank of America Visa-Fellow Recruitment,,HJ,,299,-24096.39
2032,9/19/2020,9/19/2020,iaklestad,Imported from Bank of America Visa-CUNY City College Fair,,HJ,,211,-24307.39
2032,9/19/2020,9/19/2020,Tiffani Bibb,Imported from Bank of America Visa-Compensation Course for PD,,HJ,,1285,-25592.39
2032,9/20/2020,9/20/2020,Antonio Gutierrez,Imported from Bank of America Visa-Fellow Recruitment,,HJ,16.09,,-25576.3
2032,9/20/2020,9/20/2020,Myesha Hossain,Imported from Bank of America Visa-PPE Gear for Staff,,HJ,,6.99,-25583.29
2032,9/20/2020,9/20/2020,Myesha Hossain,Imported from Bank of America Visa-PPE Gear for Staff,,HJ,,9.99,-25593.28
2032,9/21/2020,9/21/2020,Antonio Gutierrez,Imported from Bank of America Visa-PPE masks,,HJ,,13.41,-25606.69
2032,9/21/2020,9/21/2020,Elizabeth Peinado,Imported from Bank of America Visa-Math assessment software,,HJ,,4.39,-25611.08
2032,9/21/2020,9/21/2020,Elizabeth Peinado,Imported from Bank of America Visa-Math assessment software,,HJ,,6.79,-25617.87
2032,9/21/2020,9/21/2020,Elizabeth Peinado,Imported from Bank of America Visa-Math assessment software,,HJ,,6.79,-25624.66
2032,9/21/2020,9/21/2020,Elizabeth Peinado,Imported from Bank of America Visa-Math assessment software,,HJ,,21.98,-25646.64
2032,9/21/2020,9/21/2020,Jennifer Winans,Imported from Bank of America Visa-Career Fair,,HJ,,50,-25696.64
2032,9/21/2020,9/21/2020,Jennifer Winans,Imported from Bank of America Visa-Career Fair,,HJ,,200,-25896.64
2032,9/21/2020,9/21/2020,Joseph Zarate,Imported from Bank of America Visa-New hire equipment,,HJ,,15.05,-25911.69
2032,9/21/2020,9/21/2020,Joseph Zarate,Imported from Bank of America Visa-New hire equipment,,HJ,,16.8,-25928.49
2032,9/21/2020,9/21/2020,Joseph Zarate,Imported from Bank of America Visa-New hire equipment,,HJ,,16.8,-25945.29
2032,9/21/2020,9/21/2020,Miranda Cortez,Imported from Bank of America Visa-Career Fairs Fees,,HJ,,100,-26045.29
2032,9/21/2020,9/21/2020,Monivett Acevedo,Imported from Bank of America Visa-Amazon Prime annual fee,,HJ,,499,-26544.29
2032,9/21/2020,9/21/2020,Myesha Hossain,Imported from Bank of America Visa-DOE incorrect transaction,,HJ,,60,-26604.29
2032,9/21/2020,9/21/2020,Myesha Hossain,Imported from Bank of America Visa-DOE incorrect transaction,,HJ,,60,-26664.29
2032,9/21/2020,9/21/2020,Myesha Hossain,Imported from Bank of America Visa-Fingerprinting,,HJ,,135,-26799.29
2032,9/21/2020,9/21/2020,Myesha Hossain,Imported from Bank of America Visa-Storage,,HJ,,37,-26836.29
2032,9/22/2020,9/22/2020,Alan Safran,Imported from Bank of America Visa-Background Checks for Fellows,,HJ,,5.56,-26841.85
2032,9/22/2020,9/22/2020,Alan Safran,Imported from Bank of America Visa-Background Checks for Fellows,,HJ,,8.58,-26850.43
2032,9/22/2020,9/22/2020,Alan Safran,Imported from Bank of America Visa-Background Checks for Fellows,,HJ,,8.59,-26859.02
2032,9/22/2020,9/22/2020,Alan Safran,Imported from Bank of America Visa-Background Checks for Fellows,,HJ,,27.77,-26886.79
2032,9/22/2020,9/22/2020,Antonio Gutierrez,Imported from Bank of America Visa-Compensation Analysis,,HJ,,379,-27265.79
2032,9/22/2020,9/22/2020,Antonio Gutierrez,Imported from Bank of America Visa-Compensation Analysis,,HJ,,399,-27664.79
2032,9/22/2020,9/22/2020,Elizabeth Peinado,Imported from Bank of America Visa-International fee for math assessment software,,HJ,,0.09,-27664.88
2032,9/22/2020,9/22/2020,Elizabeth Peinado,Imported from Bank of America Visa-International fee for math assessment software,,HJ,,0.14,-27665.02
2032,9/22/2020,9/22/2020,Elizabeth Peinado,Imported from Bank of America Visa-International fee for math assessment software,,HJ,,0.14,-27665.16
2032,9/22/2020,9/22/2020,Elizabeth Peinado,Imported from Bank of America Visa-International fee for math assessment software,,HJ,,0.43,-27665.59
2032,9/22/2020,9/22/2020,iaklestad,Imported from Bank of America Visa-Tufts Career Fair,,HJ,,200,-27865.59
2032,9/22/2020,9/22/2020,Joseph Zarate,Imported from Bank of America Visa-anti virus,,HJ,,8,-27873.59
2032,9/22/2020,9/22/2020,Uriel Guadarrama,Imported from Bank of America Visa-Annual Zoom license for AJ,,HJ,,75.76,-27949.35
2032,9/23/2020,9/23/2020,Alan Safran,Imported from Bank of America Visa-Background Checks for Fellows,,HJ,,3.16,-27952.51
2032,9/23/2020,9/23/2020,Alan Safran,Imported from Bank of America Visa-Background Checks for Fellows,,HJ,,3.16,-27955.67
2032,9/23/2020,9/23/2020,Alan Safran,Imported from Bank of America Visa-Background Checks for Fellows,,HJ,,3.16,-27958.83
2032,9/23/2020,9/23/2020,Alan Safran,Imported from Bank of America Visa-Background Checks for Fellows,,HJ,,3.16,-27961.99
2032,9/23/2020,9/23/2020,Alan Safran,Imported from Bank of America Visa-Background Checks for Fellows,,HJ,,3.16,-27965.15
2032,9/23/2020,9/23/2020,Alan Safran,Imported from Bank of America Visa-Background Checks for Fellows,,HJ,,3.16,-27968.31
2032,9/23/2020,9/23/2020,Alan Safran,Imported from Bank of America Visa-Background Checks for Fellows,,HJ,,3.16,-27971.47
2032,9/23/2020,9/23/2020,Alan Safran,Imported from Bank of America Visa-Background Checks for Fellows,,HJ,,4.89,-27976.36
2032,9/23/2020,9/23/2020,Alan Safran,Imported from Bank of America Visa-Background Checks for Fellows,,HJ,,4.89,-27981.25
2032,9/23/2020,9/23/2020,Alan Safran,Imported from Bank of America Visa-Background Checks for Fellows,,HJ,,4.89,-27986.14
2032,9/23/2020,9/23/2020,Alan Safran,Imported from Bank of America Visa-Background Checks for Fellows,,HJ,,4.89,-27991.03
2032,9/23/2020,9/23/2020,Alan Safran,Imported from Bank of America Visa-Background Checks for Fellows,,HJ,,4.89,-27995.92
2032,9/23/2020,9/23/2020,Alan Safran,Imported from Bank of America Visa-Background Checks for Fellows,,HJ,,4.89,-28000.81
2032,9/23/2020,9/23/2020,Alan Safran,Imported from Bank of America Visa-Background Checks for Fellows,,HJ,,4.89,-28005.7
2032,9/23/2020,9/23/2020,Alan Safran,Imported from Bank of America Visa-Background Checks for Fellows,,HJ,,4.89,-28010.59
2032,9/23/2020,9/23/2020,Alan Safran,Imported from Bank of America Visa-Background Checks for Fellows,,HJ,,4.89,-28015.48
2032,9/23/2020,9/23/2020,Alan Safran,Imported from Bank of America Visa-Background Checks for Fellows,,HJ,,4.89,-28020.37
2032,9/23/2020,9/23/2020,Alan Safran,Imported from Bank of America Visa-Background Checks for Fellows,,HJ,,4.89,-28025.26
2032,9/23/2020,9/23/2020,Alan Safran,Imported from Bank of America Visa-Background Checks for Fellows,,HJ,,4.89,-28030.15
2032,9/23/2020,9/23/2020,Alan Safran,Imported from Bank of America Visa-Background Checks for Fellows,,HJ,,4.89,-28035.04
2032,9/23/2020,9/23/2020,Alan Safran,Imported from Bank of America Visa-Background Checks for Fellows,,HJ,,4.89,-28039.93
2032,9/23/2020,9/23/2020,Alan Safran,Imported from Bank of America Visa-Background Checks for Fellows,,HJ,,15.81,-28055.74
2032,9/23/2020,9/23/2020,Alan Safran,Imported from Bank of America Visa-Background Checks for Fellows,,HJ,,15.81,-28071.55
2032,9/23/2020,9/23/2020,Alan Safran,Imported from Bank of America Visa-Background Checks for Fellows,,HJ,,15.81,-28087.36
2032,9/23/2020,9/23/2020,Alan Safran,Imported from Bank of America Visa-Background Checks for Fellows,,HJ,,15.81,-28103.17
2032,9/23/2020,9/23/2020,Alan Safran,Imported from Bank of America Visa-Background Checks for Fellows,,HJ,,15.81,-28118.98
2032,9/23/2020,9/23/2020,Alan Safran,Imported from Bank of America Visa-Background Checks for Fellows,,HJ,,15.81,-28134.79
2032,9/23/2020,9/23/2020,Alan Safran,Imported from Bank of America Visa-Background Checks for Fellows,,HJ,,15.81,-28150.6
2032,9/23/2020,9/23/2020,Denise Parham-Gantt,Imported from Bank of America Visa-collecting SAT devices for general use,,HJ,,100,-28250.6
2032,9/23/2020,9/23/2020,Denise Parham-Gantt,Imported from Bank of America Visa-collecting SAT devices for general use,,HJ,,300,-28550.6
2032,9/23/2020,9/23/2020,iaklestad,Imported from Bank of America Visa-Career Fair,,HJ,,100,-28650.6
2032,9/23/2020,9/23/2020,iaklestad,Imported from Bank of America Visa-Valparaiso Career Fair,,HJ,,100,-28750.6
2032,9/23/2020,9/23/2020,Jennifer Winans,Imported from Bank of America Visa-Career Fair,,HJ,,37.5,-28788.1
2032,9/23/2020,9/23/2020,Joseph Zarate,Imported from Bank of America Visa-equipment,,HJ,,699,-29487.1
2032,9/23/2020,9/23/2020,Mahaliah Sejour,Imported from Bank of America Visa-Cart to tranfer care packages for SDs,,HJ,,69.29,-29556.39
2032,9/23/2020,9/23/2020,Monivett Acevedo,Imported from Bank of America Visa-Office Supplies,,HJ,,3.18,-29559.57
2032,9/23/2020,9/23/2020,Tiffani Bibb,Imported from Bank of America Visa-paper Shredder for Home office,,HJ,,43.86,-29603.43
2032,9/24/2020,9/24/2020,Alan Safran,Imported from Bank of America Visa-Background Checks for Fellows,,HJ,,4.02,-29607.45
2032,9/24/2020,9/24/2020,Alan Safran,Imported from Bank of America Visa-Background Checks for Fellows,,HJ,,6.2,-29613.65
2032,9/24/2020,9/24/2020,Alan Safran,Imported from Bank of America Visa-Background Checks for Fellows,,HJ,,6.21,-29619.86
2032,9/24/2020,9/24/2020,Alan Safran,Imported from Bank of America Visa-Background Checks for Fellows,,HJ,,7.26,-29627.12
2032,9/24/2020,9/24/2020,Alan Safran,Imported from Bank of America Visa-Background Checks for Fellows,,HJ,,11.22,-29638.34
2032,9/24/2020,9/24/2020,Alan Safran,Imported from Bank of America Visa-Background Checks for Fellows,,HJ,,11.22,-29649.56
2032,9/24/2020,9/24/2020,Alan Safran,Imported from Bank of America Visa-Background Checks for Fellows,,HJ,,20.07,-29669.63
2032,9/24/2020,9/24/2020,Alan Safran,Imported from Bank of America Visa-Background Checks for Fellows,,HJ,,36.3,-29705.93
2032,9/24/2020,9/24/2020,iaklestad,Imported from Bank of America Visa-Mailing Welcome Packages,,HJ,,79.9,-29785.83
2032,9/24/2020,9/24/2020,Joseph Zarate,Imported from Bank of America Visa-New hire equipment,,HJ,,309.29,-30095.12
2032,9/24/2020,9/24/2020,Joseph Zarate,Imported from Bank of America Visa-New hire equipment,,HJ,,589.99,-30685.11
2032,9/24/2020,9/24/2020,Myesha Hossain,Imported from Bank of America Visa-Fellow tech supplies,,HJ,,49,-30734.11
2032,9/25/2020,9/25/2020,Alan Safran,Imported from Bank of America Visa-Background Checks for Fellows,,HJ,,4.02,-30738.13
2032,9/25/2020,9/25/2020,Alan Safran,Imported from Bank of America Visa-Background Checks for Fellows,,HJ,,4.02,-30742.15
2032,9/25/2020,9/25/2020,Alan Safran,Imported from Bank of America Visa-Background Checks for Fellows,,HJ,,6.2,-30748.35
2032,9/25/2020,9/25/2020,Alan Safran,Imported from Bank of America Visa-Background Checks for Fellows,,HJ,,6.2,-30754.55
2032,9/25/2020,9/25/2020,Alan Safran,Imported from Bank of America Visa-Background Checks for Fellows,,HJ,,6.21,-30760.76
2032,9/25/2020,9/25/2020,Alan Safran,Imported from Bank of America Visa-Background Checks for Fellows,,HJ,,6.21,-30766.97
2032,9/25/2020,9/25/2020,Alan Safran,Imported from Bank of America Visa-Background Checks for Fellows,,HJ,,6.51,-30773.48
2032,9/25/2020,9/25/2020,Alan Safran,Imported from Bank of America Visa-Background Checks for Fellows,,HJ,,10.06,-30783.54
2032,9/25/2020,9/25/2020,Alan Safran,Imported from Bank of America Visa-Background Checks for Fellows,,HJ,,10.06,-30793.6
2032,9/25/2020,9/25/2020,Alan Safran,Imported from Bank of America Visa-Background Checks for Fellows,,HJ,,20.07,-30813.67
2032,9/25/2020,9/25/2020,Alan Safran,Imported from Bank of America Visa-Background Checks for Fellows,,HJ,,20.07,-30833.74
2032,9/25/2020,9/25/2020,Alan Safran,Imported from Bank of America Visa-Background Checks for Fellows,,HJ,,32.52,-30866.26
2032,9/25/2020,9/25/2020,Elizabeth Peinado,Imported from Bank of America Visa-Staf postings. all regions depts,,HJ,,39.93,-30906.19
2032,9/25/2020,9/25/2020,Elizabeth Peinado,Imported from Bank of America Visa-Staf postings. all regions depts,,HJ,,61.7,-30967.89
2032,9/25/2020,9/25/2020,Elizabeth Peinado,Imported from Bank of America Visa-Staf postings. all regions depts,,HJ,,61.7,-31029.59
2032,9/25/2020,9/25/2020,Elizabeth Peinado,Imported from Bank of America Visa-Staf postings. all regions depts,,HJ,,199.63,-31229.22
2032,9/25/2020,9/25/2020,iaklestad,Imported from Bank of America Visa-Career Fair UMich,,HJ,,150,-31379.22
2032,9/25/2020,9/25/2020,Joseph Zarate,Imported from Bank of America Visa-New hire equipment,,HJ,,81.99,-31461.21
2032,9/25/2020,9/25/2020,Joseph Zarate,Imported from Bank of America Visa-New hire equipment,,HJ,,331.9,-31793.11
2032,9/25/2020,9/25/2020,Joseph Zarate,Imported from Bank of America Visa-equipment,,HJ,,18.62,-31811.73
2032,9/25/2020,9/25/2020,Monivett Acevedo,Imported from Bank of America Visa-Blue Ocean Strategy,,HJ,,18.62,-31830.35
2032,9/25/2020,9/25/2020,Myesha Hossain,Imported from Bank of America Visa-Packaging supplies,,HJ,,4.99,-31835.34
2032,9/25/2020,9/25/2020,Myesha Hossain,Imported from Bank of America Visa-Packaging supplies,,HJ,,9.48,-31844.82
2032,9/25/2020,9/25/2020,Myesha Hossain,Imported from Bank of America Visa-Printing and Copying,,HJ,,303.59,-32148.41
2032,9/25/2020,9/25/2020,Tiffani Bibb,Imported from Bank of America Visa-Printer for Angela's home office,,HJ,,159.32,-32307.73
2032,9/26/2020,9/26/2020,Alan Safran,Imported from Bank of America Visa-Background Checks for Fellows,,HJ,,3.16,-32310.89
2032,9/26/2020,9/26/2020,Alan Safran,Imported from Bank of America Visa-Background Checks for Fellows,,HJ,,4.02,-32314.91
2032,9/26/2020,9/26/2020,Alan Safran,Imported from Bank of America Visa-Background Checks for Fellows,,HJ,,4.89,-32319.8
2032,9/26/2020,9/26/2020,Alan Safran,Imported from Bank of America Visa-Background Checks for Fellows,,HJ,,4.89,-32324.69
2032,9/26/2020,9/26/2020,Alan Safran,Imported from Bank of America Visa-Background Checks for Fellows,,HJ,,6.2,-32330.89
2032,9/26/2020,9/26/2020,Alan Safran,Imported from Bank of America Visa-Background Checks for Fellows,,HJ,,6.21,-32337.1
2032,9/26/2020,9/26/2020,Alan Safran,Imported from Bank of America Visa-Background Checks for Fellows,,HJ,,15.81,-32352.91
2032,9/26/2020,9/26/2020,Alan Safran,Imported from Bank of America Visa-Background Checks for Fellows,,HJ,,20.07,-32372.98
2032,9/26/2020,9/26/2020,Joseph Zarate,Imported from Bank of America Visa-New hire equipment,,HJ,,58.98,-32431.96
2032,9/26/2020,9/26/2020,Joseph Zarate,Imported from Bank of America Visa-equipment,,HJ,,7.75,-32439.71
2032,9/26/2020,9/26/2020,Mahaliah Sejour,Imported from Bank of America Visa-USPS shipping labels,,HJ,,60.2,-32499.91
2032,9/26/2020,9/26/2020,Mahaliah Sejour,Imported from Bank of America Visa-USPS shipping labels,,HJ,,60.2,-32560.11
2032,9/26/2020,9/26/2020,Myesha Hossain,Imported from Bank of America Visa-PPE,,HJ,,7.49,-32567.6
2032,9/27/2020,9/27/2020,Antonio Gutierrez,Imported from Bank of America Visa-Fellow Recruitment,,HJ,,481.51,-33049.11
2032,9/27/2020,9/27/2020,Joseph Zarate,Imported from Bank of America Visa-New hire equipment,,HJ,,37.04,-33086.15
2032,9/27/2020,9/27/2020,Joseph Zarate,Imported from Bank of America Visa-New hire equipment,,HJ,,160.58,-33246.73
2032,9/27/2020,9/27/2020,Joseph Zarate,Imported from Bank of America Visa-New hire equipment,,HJ,,589.99,-33836.72
2032,9/27/2020,9/27/2020,Joseph Zarate,Imported from Bank of America Visa-New hire equipment,,HJ,,726.12,-34562.84
2032,9/27/2020,9/27/2020,Myesha Hossain,Imported from Bank of America Visa-HSFI ppe,,HJ,,7.49,-34570.33
2032,9/27/2020,9/27/2020,Myesha Hossain,Imported from Bank of America Visa-PPE Dewey,,HJ,,7.49,-34577.82
2032,9/27/2020,9/27/2020,Uriel Guadarrama,Imported from Bank of America Visa-Zoom accounts for Andrew Cathryn Alan,,HJ,,47.78,-34625.6
2032,9/28/2020,9/28/2020,Alan Safran,Imported from Bank of America Visa-Background Checks for Fellows,,HJ,,13.48,-34639.08
2032,9/28/2020,9/28/2020,Alan Safran,Imported from Bank of America Visa-Background Checks for Fellows,,HJ,,20.82,-34659.9
2032,9/28/2020,9/28/2020,Alan Safran,Imported from Bank of America Visa-Background Checks for Fellows,,HJ,,20.83,-34680.73
2032,9/28/2020,9/28/2020,Alan Safran,Imported from Bank of America Visa-Background Checks for Fellows,,HJ,,67.37,-34748.1
2032,9/28/2020,9/28/2020,Joseph Zarate,Imported from Bank of America Visa-New hire equipment,,HJ,,18.62,-34766.72
2032,9/28/2020,9/28/2020,Joseph Zarate,Imported from Bank of America Visa-New hire equipment,,HJ,,88.34,-34855.06
2032,9/28/2020,9/28/2020,Joseph Zarate,Imported from Bank of America Visa-Returns,,HJ,,78.8,-34933.86
2032,9/28/2020,9/28/2020,Joseph Zarate,Imported from Bank of America Visa-Tape for shipement,,HJ,,3.99,-34937.85
2032,9/28/2020,9/28/2020,Myesha Hossain,Imported from Bank of America Visa-Delivery materials,,HJ,,16.07,-34953.92
2032,9/28/2020,9/28/2020,Myesha Hossain,Imported from Bank of America Visa-IT Return laptops,,HJ,,92.7,-35046.62
2032,9/28/2020,9/28/2020,Myesha Hossain,Imported from Bank of America Visa-PPE HSHP,,HJ,,7.49,-35054.11
2032,9/28/2020,9/28/2020,Myesha Hossain,Imported from Bank of America Visa-PPE supplies,,HJ,,4.36,-35058.47
2032,9/29/2020,9/29/2020,Alan Safran,Imported from Bank of America Visa-Background Checks for Fellows,,HJ,,3.16,-35061.63
2032,9/29/2020,9/29/2020,Alan Safran,Imported from Bank of America Visa-Background Checks for Fellows,,HJ,,4.02,-35065.65
2032,9/29/2020,9/29/2020,Alan Safran,Imported from Bank of America Visa-Background Checks for Fellows,,HJ,,4.02,-35069.67
2032,9/29/2020,9/29/2020,Alan Safran,Imported from Bank of America Visa-Background Checks for Fellows,,HJ,,4.89,-35074.56
2032,9/29/2020,9/29/2020,Alan Safran,Imported from Bank of America Visa-Background Checks for Fellows,,HJ,,4.89,-35079.45
2032,9/29/2020,9/29/2020,Alan Safran,Imported from Bank of America Visa-Background Checks for Fellows,,HJ,,6.2,-35085.65
2032,9/29/2020,9/29/2020,Alan Safran,Imported from Bank of America Visa-Background Checks for Fellows,,HJ,,6.2,-35091.85
2032,9/29/2020,9/29/2020,Alan Safran,Imported from Bank of America Visa-Background Checks for Fellows,,HJ,,6.21,-35098.06
2032,9/29/2020,9/29/2020,Alan Safran,Imported from Bank of America Visa-Background Checks for Fellows,,HJ,,6.21,-35104.27
2032,9/29/2020,9/29/2020,Alan Safran,Imported from Bank of America Visa-Background Checks for Fellows,,HJ,,15.81,-35120.08
2032,9/29/2020,9/29/2020,Alan Safran,Imported from Bank of America Visa-Background Checks for Fellows,,HJ,,20.07,-35140.15
2032,9/29/2020,9/29/2020,Alan Safran,Imported from Bank of America Visa-Background Checks for Fellows,,HJ,,20.07,-35160.22
2032,9/29/2020,9/29/2020,Antonio Gutierrez,Imported from Bank of America Visa-filing fee,,HJ,,3.5,-35163.72
2032,9/29/2020,9/29/2020,Antonio Gutierrez,Imported from Bank of America Visa-filing fee,,HJ,,15,-35178.72
2032,9/29/2020,9/29/2020,Antonio Gutierrez,Imported from Bank of America Visa-filing fee,,HJ,,299,-35477.72
2032,9/29/2020,9/29/2020,Chris D PLACEHOLDER,Imported from Bank of America Visa-Curriculum Material for PD,,HJ,,37.13,-35514.85
2032,9/29/2020,9/29/2020,Joseph Zarate,Imported from Bank of America Visa-Repair equipment,,HJ,,140.6,-35655.45
2032,9/29/2020,9/29/2020,Maryellen Leneghan,Imported from Bank of America Visa-PPE and Cleaning Supplies for BC Sites,,HJ,,13.27,-35668.72
2032,9/29/2020,9/29/2020,Maryellen Leneghan,Imported from Bank of America Visa-PPE and Cleaning Supplies for BC Sites,,HJ,,13.27,-35681.99
2032,9/29/2020,9/29/2020,Maryellen Leneghan,Imported from Bank of America Visa-PPE and Cleaning Supplies for BC Sites,,HJ,,13.27,-35695.26
2032,9/29/2020,9/29/2020,Maryellen Leneghan,Imported from Bank of America Visa-PPE and Cleaning Supplies for BC Sites,,HJ,,13.27,-35708.53
2032,9/29/2020,9/29/2020,Maryellen Leneghan,Imported from Bank of America Visa-PPE and Cleaning Supplies for BC Sites,,HJ,,28.31,-35736.84
2032,9/29/2020,9/29/2020,Maryellen Leneghan,Imported from Bank of America Visa-PPE and Cleaning Supplies for BC Sites,,HJ,,598.71,-36335.55
2032,9/29/2020,9/29/2020,Maryellen Leneghan,Imported from Bank of America Visa-PPE and Cleaning Supplies for BC Sites,,HJ,,598.71,-36934.26
2032,9/29/2020,9/29/2020,Maryellen Leneghan,Imported from Bank of America Visa-PPE and Cleaning Supplies for BC Sites,,HJ,,598.71,-37532.97
2032,9/29/2020,9/29/2020,Maryellen Leneghan,Imported from Bank of America Visa-PPE and Cleaning Supplies for BC Sites,,HJ,,598.71,-38131.68
2032,9/29/2020,9/29/2020,Maryellen Leneghan,Imported from Bank of America Visa-PPE and Cleaning Supplies for DC Sites,,HJ,,6.58,-38138.26
2032,9/29/2020,9/29/2020,Maryellen Leneghan,Imported from Bank of America Visa-PPE and Cleaning Supplies for DC Sites,,HJ,,13.14,-38151.4
2032,9/29/2020,9/29/2020,Maryellen Leneghan,Imported from Bank of America Visa-PPE and Cleaning Supplies for DC Sites,,HJ,,28.57,-38179.97
2032,9/29/2020,9/29/2020,Maryellen Leneghan,Imported from Bank of America Visa-PPE and Cleaning Supplies for DC Sites,,HJ,,434.23,-38614.2
2032,9/29/2020,9/29/2020,Maryellen Leneghan,Imported from Bank of America Visa-PPE and Cleaning Supplies for DC Sites,,HJ,,732.8,-39347
2032,9/29/2020,9/29/2020,Myesha Hossain,Imported from Bank of America Visa-Bathroom passes,,HJ,,4.99,-39351.99
2032,9/29/2020,9/29/2020,Myesha Hossain,Imported from Bank of America Visa-Bathroom passes,,HJ,,4.99,-39356.98
2032,9/29/2020,9/29/2020,Myesha Hossain,Imported from Bank of America Visa-Classroom posters,,HJ,,108.6,-39465.58
2032,9/29/2020,9/29/2020,Myesha Hossain,Imported from Bank of America Visa-Incorrect transaction,,HJ,,60,-39525.58
2032,9/29/2020,9/29/2020,Myesha Hossain,Imported from Bank of America Visa-PPE material,,HJ,,4.99,-39530.57
2032,9/29/2020,9/29/2020,Tiffani Bibb,Imported from Bank of America Visa-Mistake-Personal Charge,,HJ,,43.19,-39573.76
2032,10/1/2020,10/1/2020,Alan Safran,Imported from reimbursements-Background checks for fellows,,HJ,,5.56,-39579.32
2032,10/1/2020,10/1/2020,Alan Safran,Imported from reimbursements-Background checks for fellows,,HJ,,8.58,-39587.9
2032,10/1/2020,10/1/2020,Alan Safran,Imported from reimbursements-Background checks for fellows,,HJ,,8.59,-39596.49
2032,10/1/2020,10/1/2020,Alan Safran,Imported from reimbursements-Background checks for fellows,,HJ,,27.77,-39624.26
2032,10/1/2020,10/1/2020,Alan Safran,Imported from reimbursements-Bank Service Fees and Charges,,HJ,,15,-39639.26
2032,10/1/2020,10/1/2020,Antonio Gutierrez,Imported from reimbursements-expense reporting,,HJ,,1226.38,-40865.64
2032,10/1/2020,10/1/2020,Cathryn Cook,Imported from reimbursements-Strengthsfinder tests for ISA team,,HJ,,159.34,-41024.98
2032,10/1/2020,10/1/2020,Elizabeth Peinado,Imported from reimbursements-Advertising staff roles,,HJ,,415.19,-41440.17
2032,10/1/2020,10/1/2020,Elizabeth Peinado,Imported from reimbursements-Advertising staff roles,,HJ,,641.65,-42081.82
2032,10/1/2020,10/1/2020,Elizabeth Peinado,Imported from reimbursements-Advertising staff roles,,HJ,,641.65,-42723.47
2032,10/1/2020,10/1/2020,Elizabeth Peinado,Imported from reimbursements-Advertising staff roles,,HJ,,2075.94,-44799.41
2032,10/1/2020,10/1/2020,Joseph Zarate,Imported from reimbursements-Replacement/return,,HJ,,16.15,-44815.56
2032,10/1/2020,10/1/2020,Joseph Zarate,Imported from reimbursements-equipment,,HJ,,16.15,-44831.71
2032,10/1/2020,10/1/2020,Joseph Zarate,Imported from reimbursements-equipment,,HJ,,299,-45130.71
2032,10/1/2020,10/1/2020,Maryellen Leneghan,Imported from reimbursements-PPE and Cleaning Supplies for DC Sites,,HJ,,13.55,-45144.26
2032,10/1/2020,10/1/2020,Maryellen Leneghan,Imported from reimbursements-RBHS Fellow Appreciation,,HJ,,10.48,-45154.74
2032,10/1/2020,10/1/2020,Maryellen Leneghan,Imported from reimbursements-RBHS Fellow Appreciation,,HJ,,15.37,-45170.11
2032,10/1/2020,10/1/2020,Maryellen Leneghan,Imported from reimbursements-RBHS Fellow Appreciation,,HJ,,18.01,-45188.12
2032,10/1/2020,10/1/2020,Maryellen Leneghan,Imported from reimbursements-RBHS Fellow Appreciation,,HJ,,26.94,-45215.06
2032,10/1/2020,10/1/2020,Monivett Acevedo,Imported from reimbursements-Business Registration and Filing Fees,,HJ,,3,-45218.06
2032,10/1/2020,10/1/2020,Monivett Acevedo,Imported from reimbursements-Business Registration and Filing Fees,,HJ,,12,-45230.06
2032,10/1/2020,10/1/2020,Monivett Acevedo,Imported from reimbursements-Professional Development,,HJ,,23.98,-45254.04
2032,10/1/2020,10/1/2020,Myesha Hossain,Imported from reimbursements-Fingerprinting,,HJ,,135.31,-45389.35
2032,10/1/2020,10/1/2020,Myesha Hossain,Imported from reimbursements-HPHS site set up,,HJ,,124.67,-45514.02
2032,10/1/2020,10/1/2020,Myesha Hossain,Imported from reimbursements-HPHS site set up,,HJ,,195.95,-45709.97
2032,10/1/2020,10/1/2020,Myesha Hossain,Imported from reimbursements-PPE,,HJ,,4.99,-45714.96
2032,10/1/2020,10/1/2020,Myesha Hossain,Imported from reimbursements-Site set up,,HJ,5.95,,-45709.01
2032,10/1/2020,10/1/2020,Myesha Hossain,Imported from reimbursements-Tutor incentives,,HJ,,15.87,-45724.88
2032,10/1/2020,10/1/2020,Nicole Prahin,Imported from reimbursements-PD Book for DoP can take out NP Office Supply budget,,HJ,,91.35,-45816.23
2032,10/1/2020,10/1/2020,Nicole Prahin,Imported from reimbursements-PD Book for RPOM can take out NP Office Supply budget,,HJ,,11.68,-45827.91
2032,10/2/2020,10/2/2020,Angela Mason,Imported from reimbursements-Chicago storage unit,,HJ,,149,-45976.91
2032,10/2/2020,10/2/2020,Angela Mason,Imported from reimbursements-Chicago storage unit,,HJ,,173,-46149.91
2032,10/2/2020,10/2/2020,Antonio Gutierrez,Imported from reimbursements-Google Drive Storage,,HJ,,1.99,-46151.9
2032,10/2/2020,10/2/2020,Elizabeth Peinado,Imported from reimbursements-Advertising staff roles,,HJ,,280.5,-46432.4
2032,10/2/2020,10/2/2020,Elizabeth Peinado,Imported from reimbursements-Advertising staff roles,,HJ,,433.5,-46865.9
2032,10/2/2020,10/2/2020,Elizabeth Peinado,Imported from reimbursements-Advertising staff roles,,HJ,,433.5,-47299.4
2032,10/2/2020,10/2/2020,Elizabeth Peinado,Imported from reimbursements-Advertising staff roles,,HJ,,1402.5,-48701.9
2032,10/2/2020,10/2/2020,Joseph Zarate,Imported from reimbursements-equipment,,HJ,,60.2,-48762.1
2032,10/2/2020,10/2/2020,Joseph Zarate,Imported from reimbursements-equipment,,HJ,,75.25,-48837.35
2032,10/2/2020,10/2/2020,Joseph Zarate,Imported from reimbursements-equipment,,HJ,,574,-49411.35
2032,10/2/2020,10/2/2020,Joseph Zarate,Imported from reimbursements-equipment,,HJ,,574,-49985.35
2032,10/2/2020,10/2/2020,Joseph Zarate,Imported from reimbursements-new hire equipment,,HJ,,30.1,-50015.45
2032,10/2/2020,10/2/2020,Joseph Zarate,Imported from reimbursements-new hire equipment shipments,,HJ,,75.25,-50090.7
2032,10/2/2020,10/2/2020,Monivett Acevedo,Imported from reimbursements-Office Supplies,,HJ,,15.24,-50105.94
2032,10/2/2020,10/2/2020,Monivett Acevedo,Imported from reimbursements-Office Supplies,,HJ,,58.99,-50164.93
2032,10/2/2020,10/2/2020,Myesha Hossain,Imported from reimbursements-Headphones for HPHS,,HJ,,5.9,-50170.83
2032,10/2/2020,10/2/2020,Myesha Hossain,Imported from reimbursements-Tutor incentives,,HJ,,9.78,-50180.61
2032,10/2/2020,10/2/2020,Myesha Hossain,Imported from reimbursements-Tutor incentives,,HJ,,11.55,-50192.16
2032,10/2/2020,10/2/2020,Myesha Hossain,Imported from reimbursements-Tutor incentives,,HJ,,11.94,-50204.1
2032,10/2/2020,10/2/2020,Myesha Hossain,Imported from reimbursements-Tutor incentives,,HJ,,14.99,-50219.09
2032,10/2/2020,10/2/2020,Myesha Hossain,Imported from reimbursements-Tutor incentives,,HJ,,17.94,-50237.03
2032,10/3/2020,10/3/2020,Alan Safran,Imported from reimbursements-Background checks for fellows,,HJ,,3.16,-50240.19
2032,10/3/2020,10/3/2020,Alan Safran,Imported from reimbursements-Background checks for fellows,,HJ,,4.89,-50245.08
2032,10/3/2020,10/3/2020,Alan Safran,Imported from reimbursements-Background checks for fellows,,HJ,,4.89,-50249.97
2032,10/3/2020,10/3/2020,Alan Safran,Imported from reimbursements-Background checks for fellows,,HJ,,15.81,-50265.78
2032,10/3/2020,10/3/2020,Monivett Acevedo,Imported from reimbursements-Travel Exp,,HJ,486.49,,-49779.29
2032,10/3/2020,10/3/2020,Tiffani Bibb,Imported from reimbursements-Printer Ink,,HJ,,43.86,-49823.15
2032,10/4/2020,10/4/2020,Alan Safran,Imported from reimbursements-Extra google storage for Alan,,HJ,,1.99,-49825.14
2032,10/4/2020,10/4/2020,Maryellen Leneghan,Imported from reimbursements-Fellow appreciation,,HJ,,2.43,-49827.57
2032,10/4/2020,10/4/2020,Myesha Hossain,Imported from reimbursements-HPHS,,HJ,,7.99,-49835.56
2032,10/5/2020,10/5/2020,Bank of America VISA,BofA CC Transactions September Payment-BofA CC September Statement Payment,,HJ,979.85,,-48855.71
2032,10/5/2020,10/5/2020,Bank of America VISA,BofA CC Transactions September Payment-BofA CC September Statement Payment,,HJ,2394.33,,-46461.38
2032,10/5/2020,10/5/2020,Bank of America VISA,BofA CC Transactions September Payment-BofA CC September Statement Payment,,HJ,3452.23,,-43009.15
2032,10/5/2020,10/5/2020,Bank of America VISA,BofA CC Transactions September Payment-BofA CC September Statement Payment,,HJ,7167.12,,-35842.03
2032,10/5/2020,10/5/2020,Bank of America VISA,BofA CC Transactions September Payment-BofA CC September Statement Payment,,HJ,7191.95,,-28650.08
2032,10/5/2020,10/5/2020,Bank of America VISA,BofA CC Transactions September Payment-BofA CC September Statement Payment,,HJ,8352.07,,-20298.01
2032,10/5/2020,10/5/2020,Bank of America VISA,BofA CC Transactions September Payment-BofA CC September Statement Payment,,HJ,10036.21,,-10261.8
2032,10/5/2020,10/5/2020,Joseph Zarate,Imported from reimbursements-equipment,,HJ,,224.02,-10485.82
2032,10/5/2020,10/5/2020,Joseph Zarate,Imported from reimbursements-equipment,,HJ,,224.02,-10709.84
2032,10/6/2020,10/6/2020,Alan Safran,Imported from reimbursements-Background checks for fellows,,HJ,,8.8,-10718.64
2032,10/6/2020,10/6/2020,Alan Safran,Imported from reimbursements-Background checks for fellows,,HJ,,13.6,-10732.24
2032,10/6/2020,10/6/2020,Alan Safran,Imported from reimbursements-Background checks for fellows,,HJ,,13.6,-10745.84
2032,10/6/2020,10/6/2020,Alan Safran,Imported from reimbursements-Background checks for fellows,,HJ,,44,-10789.84
2032,10/6/2020,10/6/2020,Joseph Zarate,Imported from reimbursements-replacement equipment,,HJ,,10.58,-10800.42
2032,10/6/2020,10/6/2020,Maryellen Leneghan,Imported from reimbursements-DC fellow appreciation,,HJ,,10.59,-10811.01
2032,10/6/2020,10/6/2020,Nicole Prahin,Imported from reimbursements-PD book,,HJ,,32.64,-10843.65
2032,10/7/2020,10/7/2020,Antonio Gutierrez,Imported from reimbursements-Refund,,HJ,7.5,,-10836.15
2032,10/7/2020,10/7/2020,Antonio Gutierrez,Imported from reimbursements-Refund,,HJ,122.5,,-10713.65
2032,10/7/2020,10/7/2020,Mahaliah Sejour,Imported from reimbursements-Fellows gifts,,HJ,,21.38,-10735.03
2032,10/7/2020,10/7/2020,Maryellen Leneghan,Imported from reimbursements-BC supplies for headphone storage due to COVID,,HJ,,8.66,-10743.69
2032,10/7/2020,10/7/2020,Maryellen Leneghan,Imported from reimbursements-BC supplies for headphone storage due to COVID,,HJ,,8.66,-10752.35
2032,10/7/2020,10/7/2020,Maryellen Leneghan,Imported from reimbursements-BC supplies for headphone storage due to COVID,,HJ,,8.66,-10761.01
2032,10/7/2020,10/7/2020,Maryellen Leneghan,Imported from reimbursements-BC supplies for headphone storage due to COVID,,HJ,,8.66,-10769.67
2032,10/7/2020,10/7/2020,Maryellen Leneghan,Imported from reimbursements-Winning prize for fellow social game in BC,,HJ,,11.33,-10781
2032,10/7/2020,10/7/2020,Monivett Acevedo,Imported from reimbursements-Meals with KDT in Boston,,HJ,,15.24,-10796.24
2032,10/7/2020,10/7/2020,Monivett Acevedo,Imported from reimbursements-Office Supplies,,HJ,,139.3,-10935.54
2032,10/7/2020,10/7/2020,Myesha Hossain,Imported from reimbursements-Fingerprinting,,HJ,,135,-11070.54
2032,10/7/2020,10/7/2020,Myesha Hossain,Imported from reimbursements-Fingerprinting,,HJ,,135,-11205.54
2032,10/8/2020,10/8/2020,Elizabeth Peinado,Imported from reimbursements-Recruiter - corporate,,HJ,,409.41,-11614.95
2032,10/8/2020,10/8/2020,Elizabeth Peinado,Imported from reimbursements-Recruiter - corporate,,HJ,,632.72,-12247.67
2032,10/8/2020,10/8/2020,Elizabeth Peinado,Imported from reimbursements-Recruiter - corporate,,HJ,,632.72,-12880.39
2032,10/8/2020,10/8/2020,Elizabeth Peinado,Imported from reimbursements-Recruiter - corporate,,HJ,,2047.03,-14927.42
2032,10/8/2020,10/8/2020,Mahaliah Sejour,Imported from reimbursements-Fellows gifts,,HJ,,31.81,-14959.23
2032,10/8/2020,10/8/2020,Mahaliah Sejour,Imported from reimbursements-Fellows gifts,,HJ,,31.81,-14991.04
2032,10/8/2020,10/8/2020,Mahaliah Sejour,Imported from reimbursements-Fellows gifts,,HJ,,31.81,-15022.85
2032,10/8/2020,10/8/2020,Mahaliah Sejour,Imported from reimbursements-Fellows gifts,,HJ,,31.81,-15054.66
2032,10/8/2020,10/8/2020,Mahaliah Sejour,Imported from reimbursements-Fellows gifts,,HJ,,31.81,-15086.47
2032,10/8/2020,10/8/2020,Mahaliah Sejour,Imported from reimbursements-Fellows gifts,,HJ,,73.27,-15159.74
2032,10/8/2020,10/8/2020,Maryellen Leneghan,Imported from reimbursements-BC BOY site materials,,HJ,,10.17,-15169.91
2032,10/8/2020,10/8/2020,Maryellen Leneghan,Imported from reimbursements-BC BOY site materials,,HJ,,10.17,-15180.08
2032,10/8/2020,10/8/2020,Maryellen Leneghan,Imported from reimbursements-BC BOY site materials,,HJ,,10.17,-15190.25
2032,10/8/2020,10/8/2020,Maryellen Leneghan,Imported from reimbursements-BC BOY site materials,,HJ,,14.45,-15204.7
2032,10/8/2020,10/8/2020,Maryellen Leneghan,Imported from reimbursements-BC BOY site materials,,HJ,,14.45,-15219.15
2032,10/8/2020,10/8/2020,Maryellen Leneghan,Imported from reimbursements-BC BOY site materials,,HJ,,14.45,-15233.6
2032,10/8/2020,10/8/2020,Maryellen Leneghan,Imported from reimbursements-BC BOY site materials,,HJ,,14.45,-15248.05
2032,10/8/2020,10/8/2020,Maryellen Leneghan,Imported from reimbursements-BC BOY site materials,,HJ,,29.41,-15277.46
2032,10/8/2020,10/8/2020,Maryellen Leneghan,Imported from reimbursements-BC BOY site materials,,HJ,,29.41,-15306.87
2032,10/8/2020,10/8/2020,Maryellen Leneghan,Imported from reimbursements-BC BOY site materials,,HJ,,29.41,-15336.28
2032,10/8/2020,10/8/2020,Maryellen Leneghan,Imported from reimbursements-BC BOY site materials,,HJ,,39.57,-15375.85
2032,10/8/2020,10/8/2020,Maryellen Leneghan,Imported from reimbursements-BC BOY site materials,,HJ,,44.38,-15420.23
2032,10/8/2020,10/8/2020,Maryellen Leneghan,Imported from reimbursements-BC BOY site materials,,HJ,,44.38,-15464.61
2032,10/8/2020,10/8/2020,Maryellen Leneghan,Imported from reimbursements-BC BOY site materials,,HJ,,75.75,-15540.36
2032,10/8/2020,10/8/2020,Maryellen Leneghan,Imported from reimbursements-BC BOY site materials,,HJ,,97.52,-15637.88
2032,10/8/2020,10/8/2020,Maryellen Leneghan,Imported from reimbursements-BC BOY site materials,,HJ,,97.52,-15735.4
2032,10/8/2020,10/8/2020,Maryellen Leneghan,Imported from reimbursements-BC BOY site materials,,HJ,,97.52,-15832.92
2032,10/8/2020,10/8/2020,Maryellen Leneghan,Imported from reimbursements-BC BOY site materials,,HJ,,149.95,-15982.87
2032,10/8/2020,10/8/2020,Maryellen Leneghan,Imported from reimbursements-BC BOY site materials,,HJ,,149.95,-16132.82
2032,10/8/2020,10/8/2020,Maryellen Leneghan,Imported from reimbursements-BC BOY site materials,,HJ,,149.95,-16282.77
2032,10/8/2020,10/8/2020,Maryellen Leneghan,Imported from reimbursements-BC BOY site materials,,HJ,,149.95,-16432.72
2032,10/8/2020,10/8/2020,Maryellen Leneghan,Imported from reimbursements-BC BOY site materials,,HJ,,236.2,-16668.92
2032,10/8/2020,10/8/2020,Maryellen Leneghan,Imported from reimbursements-BC BOY site materials,,HJ,,834.06,-17502.98
2032,10/8/2020,10/8/2020,Maryellen Leneghan,Imported from reimbursements-BC BOY site materials,,HJ,,1085.15,-18588.13
2032,10/8/2020,10/8/2020,Maryellen Leneghan,Imported from reimbursements-BC BOY site materials,,HJ,,1092.59,-19680.72
2032,10/8/2020,10/8/2020,Maryellen Leneghan,Imported from reimbursements-BC BOY site materials,,HJ,,1121.48,-20802.2
2032,10/8/2020,10/8/2020,Monivett Acevedo,Imported from reimbursements-Adobe Subscription,,HJ,,14.99,-20817.19
2032,10/8/2020,10/8/2020,Monivett Acevedo,Imported from reimbursements-Bill.com fee,,HJ,,159.72,-20976.91
2032,10/8/2020,10/8/2020,Monivett Acevedo,Imported from reimbursements-Office Supplies,,HJ,,139.3,-21116.21
2032,10/8/2020,10/8/2020,Myesha Hossain,Imported from reimbursements-Fingerprinting,,HJ,,135,-21251.21
2032,10/8/2020,10/8/2020,Myesha Hossain,Imported from reimbursements-HPHS site set up,,HJ,,9.22,-21260.43
2032,10/8/2020,10/8/2020,Myesha Hossain,Imported from reimbursements-Refund,,HJ,15.87,,-21244.56
2032,10/8/2020,10/8/2020,Uriel Guadarrama,Imported from reimbursements-Zoom licenses for Nancy Quionna,,HJ,,20.18,-21264.74
2032,10/9/2020,10/9/2020,Antonio Gutierrez,Imported from reimbursements-X Co.  6 year anniversary celebration,,HJ,,3000,-24264.74
2032,10/9/2020,10/9/2020,Elizabeth Peinado,Imported from reimbursements-SHRM subscription,,HJ,,24.09,-24288.83
2032,10/9/2020,10/9/2020,Elizabeth Peinado,Imported from reimbursements-SHRM subscription,,HJ,,37.23,-24326.06
2032,10/9/2020,10/9/2020,Elizabeth Peinado,Imported from reimbursements-SHRM subscription,,HJ,,37.23,-24363.29
2032,10/9/2020,10/9/2020,Elizabeth Peinado,Imported from reimbursements-SHRM subscription,,HJ,,120.45,-24483.74
2032,10/9/2020,10/9/2020,Joseph Zarate,Imported from reimbursements-equipment,,HJ,,30.39,-24514.13
2032,10/9/2020,10/9/2020,Joseph Zarate,Imported from reimbursements-equipment,,HJ,,30.39,-24544.52
2032,10/9/2020,10/9/2020,Joseph Zarate,Imported from reimbursements-equipment,,HJ,,32.21,-24576.73
2032,10/9/2020,10/9/2020,Joseph Zarate,Imported from reimbursements-equipment,,HJ,,32.59,-24609.32
2032,10/9/2020,10/9/2020,Joseph Zarate,Imported from reimbursements-shipments,,HJ,,15.05,-24624.37
2032,10/9/2020,10/9/2020,Joseph Zarate,Imported from reimbursements-shipments,,HJ,,15.05,-24639.42
2032,10/9/2020,10/9/2020,Mahaliah Sejour,Imported from reimbursements-Fellows gifts,,HJ,,13.8,-24653.22
2032,10/9/2020,10/9/2020,Maryellen Leneghan,Imported from reimbursements-BC BOY site materials,,HJ,,16.79,-24670.01
2032,10/9/2020,10/9/2020,Maryellen Leneghan,Imported from reimbursements-BC BOY site materials,,HJ,,22.99,-24693
2032,10/9/2020,10/9/2020,Maryellen Leneghan,Imported from reimbursements-BC BOY site materials,,HJ,,44.38,-24737.38
2032,10/9/2020,10/9/2020,Maryellen Leneghan,Imported from reimbursements-BC BOY site materials,,HJ,,44.38,-24781.76
2032,10/9/2020,10/9/2020,Maryellen Leneghan,Imported from reimbursements-BC BOY site materials,,HJ,,91.97,-24873.73
2032,10/9/2020,10/9/2020,Maryellen Leneghan,Imported from reimbursements-BC BOY site materials,,HJ,,95.98,-24969.71
2032,10/9/2020,10/9/2020,Maryellen Leneghan,Imported from reimbursements-BC BOY site materials,,HJ,,95.98,-25065.69
2032,10/9/2020,10/9/2020,Maryellen Leneghan,Imported from reimbursements-BC BOY site materials,,HJ,,106.99,-25172.68
2032,10/9/2020,10/9/2020,Myesha Hossain,Imported from reimbursements-Fingerprinting,,HJ,,135,-25307.68
2032,10/9/2020,10/9/2020,Myesha Hossain,Imported from reimbursements-Tutor incentives,,HJ,,15.33,-25323.01
2032,10/9/2020,10/9/2020,Tiffani Bibb,Imported from reimbursements-Approval Tool,,HJ,,480,-25803.01
2032,10/9/2020,10/9/2020,Uriel Guadarrama,Imported from reimbursements-Zoom for Recruitment,,HJ,,70.82,-25873.83
2032,10/10/2020,10/10/2020,Alan Safran,Imported from reimbursements-Background checks for fellows,,HJ,,3.16,-25876.99
2032,10/10/2020,10/10/2020,Alan Safran,Imported from reimbursements-Background checks for fellows,,HJ,,4.89,-25881.88
2032,10/10/2020,10/10/2020,Alan Safran,Imported from reimbursements-Background checks for fellows,,HJ,,4.89,-25886.77
2032,10/10/2020,10/10/2020,Alan Safran,Imported from reimbursements-Background checks for fellows,,HJ,,15.81,-25902.58
2032,10/10/2020,10/10/2020,Joseph Zarate,Imported from reimbursements-equipment,,HJ,,10.9,-25913.48
2032,10/10/2020,10/10/2020,Joseph Zarate,Imported from reimbursements-equipment,,HJ,,33.2,-25946.68
2032,10/10/2020,10/10/2020,Joseph Zarate,Imported from reimbursements-equipment,,HJ,,89.97,-26036.65
2032,10/10/2020,10/10/2020,Joseph Zarate,Imported from reimbursements-equipment,,HJ,,89.97,-26126.62
2032,10/10/2020,10/10/2020,Joseph Zarate,Imported from reimbursements-equipment,,HJ,,95.37,-26221.99
2032,10/10/2020,10/10/2020,Joseph Zarate,Imported from reimbursements-equipment,,HJ,,95.37,-26317.36
2032,10/10/2020,10/10/2020,Joseph Zarate,Imported from reimbursements-equipment,,HJ,,96.49,-26413.85
2032,10/10/2020,10/10/2020,Mahaliah Sejour,Imported from reimbursements-Fellows gifts,,HJ,,10.99,-26424.84
2032,10/10/2020,10/10/2020,Mahaliah Sejour,Imported from reimbursements-Fellows gifts,,HJ,,10.99,-26435.83
2032,10/10/2020,10/10/2020,Mahaliah Sejour,Imported from reimbursements-Fellows gifts,,HJ,,13.21,-26449.04
2032,10/10/2020,10/10/2020,Mahaliah Sejour,Imported from reimbursements-Fellows gifts,,HJ,,16.98,-26466.02
2032,10/10/2020,10/10/2020,Mahaliah Sejour,Imported from reimbursements-Fellows gifts,,HJ,,16.98,-26483
2032,10/10/2020,10/10/2020,Maryellen Leneghan,Imported from reimbursements-BC BOY site materials,,HJ,,95.98,-26578.98
2032,10/11/2020,10/11/2020,Alan Safran,Imported from reimbursements-Background checks for fellows,,HJ,,3.36,-26582.34
2032,10/11/2020,10/11/2020,Alan Safran,Imported from reimbursements-Background checks for fellows,,HJ,,4.02,-26586.36
2032,10/11/2020,10/11/2020,Alan Safran,Imported from reimbursements-Background checks for fellows,,HJ,,5.18,-26591.54
2032,10/11/2020,10/11/2020,Alan Safran,Imported from reimbursements-Background checks for fellows,,HJ,,5.19,-26596.73
2032,10/11/2020,10/11/2020,Alan Safran,Imported from reimbursements-Background checks for fellows,,HJ,,6.2,-26602.93
2032,10/11/2020,10/11/2020,Alan Safran,Imported from reimbursements-Background checks for fellows,,HJ,,6.21,-26609.14
2032,10/11/2020,10/11/2020,Alan Safran,Imported from reimbursements-Background checks for fellows,,HJ,,16.77,-26625.91
2032,10/11/2020,10/11/2020,Alan Safran,Imported from reimbursements-Background checks for fellows,,HJ,,20.07,-26645.98
2032,10/11/2020,10/11/2020,Antonio Gutierrez,Imported from reimbursements-Shipping postage for swag,,HJ,,19.11,-26665.09
2032,10/11/2020,10/11/2020,Joseph Zarate,Imported from reimbursements-equipment,,HJ,,14.24,-26679.33
2032,10/11/2020,10/11/2020,Joseph Zarate,Imported from reimbursements-equipment,,HJ,,15.09,-26694.42
2032,10/11/2020,10/11/2020,Joseph Zarate,Imported from reimbursements-equipment,,HJ,,15.09,-26709.51
2032,10/11/2020,10/11/2020,Joseph Zarate,Imported from reimbursements-equipment,,HJ,,87.39,-26796.9
2032,10/11/2020,10/11/2020,Joseph Zarate,Imported from reimbursements-equipment,,HJ,,95.37,-26892.27
2032,10/11/2020,10/11/2020,Joseph Zarate,Imported from reimbursements-refund,,HJ,47,,-26845.27
2032,10/11/2020,10/11/2020,Mahaliah Sejour,Imported from reimbursements-Fellows gifts,,HJ,,10.99,-26856.26
2032,10/11/2020,10/11/2020,Mahaliah Sejour,Imported from reimbursements-Fellows gifts,,HJ,,10.99,-26867.25
2032,10/11/2020,10/11/2020,Mahaliah Sejour,Imported from reimbursements-Fellows gifts,,HJ,,10.99,-26878.24
2032,10/11/2020,10/11/2020,Mahaliah Sejour,Imported from reimbursements-Fellows gifts,,HJ,,11.99,-26890.23
2032,10/11/2020,10/11/2020,Mahaliah Sejour,Imported from reimbursements-Fellows gifts,,HJ,,24.97,-26915.2
2032,10/11/2020,10/11/2020,Mahaliah Sejour,Imported from reimbursements-Fellows gifts,,HJ,,24.97,-26940.17
2032,10/11/2020,10/11/2020,Mahaliah Sejour,Imported from reimbursements-Fellows gifts,,HJ,,27.79,-26967.96
2032,10/11/2020,10/11/2020,Monivett Acevedo,Imported from reimbursements-Orbitz Payment,,HJ,,105.96,-27073.92
2032,10/12/2020,10/12/2020,Alan Safran,Imported from reimbursements-Background checks for fellows,,HJ,,3.36,-27077.28
2032,10/12/2020,10/12/2020,Alan Safran,Imported from reimbursements-Background checks for fellows,,HJ,,3.36,-27080.64
2032,10/12/2020,10/12/2020,Alan Safran,Imported from reimbursements-Background checks for fellows,,HJ,,4.02,-27084.66
2032,10/12/2020,10/12/2020,Alan Safran,Imported from reimbursements-Background checks for fellows,,HJ,,5.18,-27089.84
2032,10/12/2020,10/12/2020,Alan Safran,Imported from reimbursements-Background checks for fellows,,HJ,,5.18,-27095.02
2032,10/12/2020,10/12/2020,Alan Safran,Imported from reimbursements-Background checks for fellows,,HJ,,5.19,-27100.21
2032,10/12/2020,10/12/2020,Alan Safran,Imported from reimbursements-Background checks for fellows,,HJ,,5.19,-27105.4
2032,10/12/2020,10/12/2020,Alan Safran,Imported from reimbursements-Background checks for fellows,,HJ,,6.2,-27111.6
2032,10/12/2020,10/12/2020,Alan Safran,Imported from reimbursements-Background checks for fellows,,HJ,,6.21,-27117.81
2032,10/12/2020,10/12/2020,Alan Safran,Imported from reimbursements-Background checks for fellows,,HJ,,16.77,-27134.58
2032,10/12/2020,10/12/2020,Alan Safran,Imported from reimbursements-Background checks for fellows,,HJ,,16.77,-27151.35
2032,10/12/2020,10/12/2020,Alan Safran,Imported from reimbursements-Background checks for fellows,,HJ,,20.07,-27171.42
2032,10/12/2020,10/12/2020,Antonio Gutierrez,Imported from reimbursements-online phone and fax,,HJ,,235.07,-27406.49
2032,10/12/2020,10/12/2020,Joseph Zarate,Imported from reimbursements-equipment,,HJ,,89.97,-27496.46
2032,10/12/2020,10/12/2020,Joseph Zarate,Imported from reimbursements-refund equipment,,HJ,112.01,,-27384.45
2032,10/12/2020,10/12/2020,Joseph Zarate,Imported from reimbursements-refund equipment,,HJ,112.01,,-27272.44
2032,10/12/2020,10/12/2020,Mahaliah Sejour,Imported from reimbursements-Fellows gifts,,HJ,,26.79,-27299.23
2032,10/12/2020,10/12/2020,Maryellen Leneghan,Imported from reimbursements-BC BOY site materials,,HJ,,143.97,-27443.2
2032,10/13/2020,10/13/2020,Alan Safran,Imported from reimbursements-Background checks for fellows,,HJ,,3.36,-27446.56
2032,10/13/2020,10/13/2020,Alan Safran,Imported from reimbursements-Background checks for fellows,,HJ,,4.35,-27450.91
2032,10/13/2020,10/13/2020,Alan Safran,Imported from reimbursements-Background checks for fellows,,HJ,,5.18,-27456.09
2032,10/13/2020,10/13/2020,Alan Safran,Imported from reimbursements-Background checks for fellows,,HJ,,5.19,-27461.28
2032,10/13/2020,10/13/2020,Alan Safran,Imported from reimbursements-Background checks for fellows,,HJ,,5.56,-27466.84
2032,10/13/2020,10/13/2020,Alan Safran,Imported from reimbursements-Background checks for fellows,,HJ,,6.71,-27473.55
2032,10/13/2020,10/13/2020,Alan Safran,Imported from reimbursements-Background checks for fellows,,HJ,,6.72,-27480.27
2032,10/13/2020,10/13/2020,Alan Safran,Imported from reimbursements-Background checks for fellows,,HJ,,8.58,-27488.85
2032,10/13/2020,10/13/2020,Alan Safran,Imported from reimbursements-Background checks for fellows,,HJ,,8.59,-27497.44
2032,10/13/2020,10/13/2020,Alan Safran,Imported from reimbursements-Background checks for fellows,,HJ,,16.77,-27514.21
2032,10/13/2020,10/13/2020,Alan Safran,Imported from reimbursements-Background checks for fellows,,HJ,,21.72,-27535.93
2032,10/13/2020,10/13/2020,Alan Safran,Imported from reimbursements-Background checks for fellows,,HJ,,27.77,-27563.7
2032,10/13/2020,10/13/2020,Joseph Zarate,Imported from reimbursements-equipment returns,,HJ,,21.1,-27584.8
2032,10/13/2020,10/13/2020,Joseph Zarate,Imported from reimbursements-returns,,HJ,,42.2,-27627
2032,10/13/2020,10/13/2020,Joseph Zarate,Imported from reimbursements-shipments,,HJ,,60.2,-27687.2
2032,10/13/2020,10/13/2020,Joseph Zarate,Imported from reimbursements-shipments,,HJ,,60.2,-27747.4
2032,10/13/2020,10/13/2020,Mahaliah Sejour,Imported from reimbursements-Fellows gifts refund,,HJ,10.99,,-27736.41
2032,10/13/2020,10/13/2020,Maryellen Leneghan,Imported from reimbursements-Tax refund from staples order,,HJ,1.86,,-27734.55
2032,10/13/2020,10/13/2020,Maryellen Leneghan,Imported from reimbursements-Tax refund from staples order,,HJ,1.99,,-27732.56
2032,10/13/2020,10/13/2020,Maryellen Leneghan,Imported from reimbursements-Tax refund from staples order,,HJ,15.46,,-27717.1
2032,10/13/2020,10/13/2020,Myesha Hossain,Imported from reimbursements-Mailing tubes,,HJ,,8.69,-27725.79
2032,10/13/2020,10/13/2020,Myesha Hossain,Imported from reimbursements-PPE for HPHS,,HJ,,13.59,-27739.38
2032,10/13/2020,10/13/2020,Myesha Hossain,Imported from reimbursements-PPE posters,,HJ,,16.2,-27755.58
2032,10/13/2020,10/13/2020,Myesha Hossain,Imported from reimbursements-PPE posters,,HJ,,202.4,-27957.98
2032,10/13/2020,10/13/2020,Nicole Prahin,Imported from reimbursements-Printing,,HJ,,5.35,-27963.33
2032,10/14/2020,10/14/2020,Alan Safran,Imported from reimbursements-Background checks for fellows,,HJ,,3.36,-27966.69
2032,10/14/2020,10/14/2020,Alan Safran,Imported from reimbursements-Background checks for fellows,,HJ,,5.18,-27971.87
2032,10/14/2020,10/14/2020,Alan Safran,Imported from reimbursements-Background checks for fellows,,HJ,,5.19,-27977.06
2032,10/14/2020,10/14/2020,Alan Safran,Imported from reimbursements-Background checks for fellows,,HJ,,5.85,-27982.91
2032,10/14/2020,10/14/2020,Alan Safran,Imported from reimbursements-Background checks for fellows,,HJ,,9.04,-27991.95
2032,10/14/2020,10/14/2020,Alan Safran,Imported from reimbursements-Background checks for fellows,,HJ,,9.04,-28000.99
2032,10/14/2020,10/14/2020,Alan Safran,Imported from reimbursements-Background checks for fellows,,HJ,,16.77,-28017.76
2032,10/14/2020,10/14/2020,Alan Safran,Imported from reimbursements-Background checks for fellows,,HJ,,29.22,-28046.98
2032,10/14/2020,10/14/2020,Angela Mason,Imported from reimbursements-Condolences O. P.,,HJ,,64.18,-28111.16
2032,10/14/2020,10/14/2020,Joseph Zarate,Imported from reimbursements-equipment,,HJ,,8.4,-28119.56
2032,10/14/2020,10/14/2020,Joseph Zarate,Imported from reimbursements-equipment,,HJ,,23,-28142.56
2032,10/14/2020,10/14/2020,Joseph Zarate,Imported from reimbursements-equipment,,HJ,,23,-28165.56
2032,10/14/2020,10/14/2020,Joseph Zarate,Imported from reimbursements-equipment,,HJ,23,,-28142.56
2032,10/14/2020,10/14/2020,Joseph Zarate,Imported from reimbursements-equipment,,HJ,,24.38,-28166.94
2032,10/14/2020,10/14/2020,Joseph Zarate,Imported from reimbursements-equipment,,HJ,,24.67,-28191.61
2032,10/14/2020,10/14/2020,Joseph Zarate,Imported from reimbursements-equipment,,HJ,,139.33,-28330.94
2032,10/14/2020,10/14/2020,Joseph Zarate,Imported from reimbursements-equipment return,,HJ,24.67,,-28306.27
2032,10/14/2020,10/14/2020,Mahaliah Sejour,Imported from reimbursements-Fellows gifts,,HJ,,15.19,-28321.46
2032,10/14/2020,10/14/2020,Maryellen Leneghan,Imported from reimbursements-BC BOY site materials,,HJ,,99.99,-28421.45
2032,10/14/2020,10/14/2020,Maryellen Leneghan,Imported from reimbursements-BC BOY site materials,,HJ,,99.99,-28521.44
2032,10/14/2020,10/14/2020,Maryellen Leneghan,Imported from reimbursements-BOY supply orders for BC,,HJ,,99.99,-28621.43
2032,10/14/2020,10/14/2020,Maryellen Leneghan,Imported from reimbursements-Tax refund from staples order,,HJ,40.04,,-28581.39
2032,10/14/2020,10/14/2020,Maryellen Leneghan,Imported from reimbursements-Tax refund from staples order,,HJ,40.04,,-28541.35
2032,10/14/2020,10/14/2020,Maryellen Leneghan,Imported from reimbursements-Tax refund from staples order,,HJ,40.04,,-28501.31
2032,10/14/2020,10/14/2020,Maryellen Leneghan,Imported from reimbursements-Tax refund from staples order,,HJ,40.04,,-28461.27
2032,10/14/2020,10/14/2020,Maryellen Leneghan,Imported from reimbursements-Tax refund from staples order,,HJ,65.12,,-28396.15
2032,10/14/2020,10/14/2020,Maryellen Leneghan,Imported from reimbursements-Tax refund from staples order,,HJ,81.55,,-28314.6
2032,10/14/2020,10/14/2020,Maryellen Leneghan,Imported from reimbursements-Tax refund from staples order,,HJ,82.03,,-28232.57
2032,10/14/2020,10/14/2020,Maryellen Leneghan,Imported from reimbursements-Tax refund from staples order,,HJ,83.91,,-28148.66
2032,10/14/2020,10/14/2020,Monivett Acevedo,Imported from reimbursements-Grammarly,,HJ,,139.95,-28288.61
2032,10/14/2020,10/14/2020,Monivett Acevedo,Imported from reimbursements-Travel Exp,,HJ,,10.99,-28299.6
2032,10/15/2020,10/15/2020,Alan Safran,Imported from reimbursements-Background checks for fellows,,HJ,,3.36,-28302.96
2032,10/15/2020,10/15/2020,Alan Safran,Imported from reimbursements-Background checks for fellows,,HJ,,5.18,-28308.14
2032,10/15/2020,10/15/2020,Alan Safran,Imported from reimbursements-Background checks for fellows,,HJ,,5.19,-28313.33
2032,10/15/2020,10/15/2020,Alan Safran,Imported from reimbursements-Background checks for fellows,,HJ,,16.77,-28330.1
2032,10/15/2020,10/15/2020,Antonio Gutierrez,Imported from reimbursements-Shipping Supplies,,HJ,,14.29,-28344.39
2032,10/15/2020,10/15/2020,Antonio Gutierrez,Imported from reimbursements-shipping fee for swag,,HJ,,34.12,-28378.51
2032,10/15/2020,10/15/2020,Joseph Zarate,Imported from reimbursements-equipment,,HJ,24.38,,-28354.13
2032,10/15/2020,10/15/2020,Joseph Zarate,Imported from reimbursements-equipment,,HJ,,43.64,-28397.77
2032,10/15/2020,10/15/2020,Joseph Zarate,Imported from reimbursements-equipment,,HJ,,104.68,-28502.45
2032,10/15/2020,10/15/2020,Joseph Zarate,Imported from reimbursements-equipment,,HJ,,142.89,-28645.34
2032,10/15/2020,10/15/2020,Joseph Zarate,Imported from reimbursements-equipment,,HJ,,209.36,-28854.7
2032,10/15/2020,10/15/2020,Joseph Zarate,Imported from reimbursements-equipment,,HJ,,599,-29453.7
2032,10/15/2020,10/15/2020,Joseph Zarate,Imported from reimbursements-equipment,,HJ,,638.98,-30092.68
2032,10/15/2020,10/15/2020,Joseph Zarate,Imported from reimbursements-equipment return,,HJ,23,,-30069.68
2032,10/15/2020,10/15/2020,Joseph Zarate,Imported from reimbursements-equipment shipment,,HJ,,33.6,-30103.28
2032,10/15/2020,10/15/2020,Mahaliah Sejour,Imported from reimbursements-Fellows gifts,,HJ,,10.99,-30114.27
2032,10/15/2020,10/15/2020,Maryellen Leneghan,Imported from reimbursements-pumpkin carving kit for DC fellow for challenge,,HJ,,15.09,-30129.36
2032,10/16/2020,10/16/2020,Alan Safran,Imported from reimbursements-Background checks for fellows,,HJ,,3.36,-30132.72
2032,10/16/2020,10/16/2020,Alan Safran,Imported from reimbursements-Background checks for fellows,,HJ,,3.36,-30136.08
2032,10/16/2020,10/16/2020,Alan Safran,Imported from reimbursements-Background checks for fellows,,HJ,,5.18,-30141.26
2032,10/16/2020,10/16/2020,Alan Safran,Imported from reimbursements-Background checks for fellows,,HJ,,5.18,-30146.44
2032,10/16/2020,10/16/2020,Alan Safran,Imported from reimbursements-Background checks for fellows,,HJ,,5.19,-30151.63
2032,10/16/2020,10/16/2020,Alan Safran,Imported from reimbursements-Background checks for fellows,,HJ,,5.19,-30156.82
2032,10/16/2020,10/16/2020,Alan Safran,Imported from reimbursements-Background checks for fellows,,HJ,,16.77,-30173.59
2032,10/16/2020,10/16/2020,Alan Safran,Imported from reimbursements-Background checks for fellows,,HJ,,16.77,-30190.36
2032,10/16/2020,10/16/2020,Joseph Zarate,Imported from reimbursements-equipment,,HJ,,83.99,-30274.35
2032,10/16/2020,10/16/2020,Mahaliah Sejour,Imported from reimbursements-MS printer,,HJ,,5.35,-30279.7
2032,10/16/2020,10/16/2020,Monivett Acevedo,Imported from reimbursements-Office Supplies,,HJ,,19.98,-30299.68
2032,10/16/2020,10/16/2020,Monivett Acevedo,Imported from reimbursements-Office Supplies,,HJ,,268.98,-30568.66
2032,10/16/2020,10/16/2020,Myesha Hossain,Imported from reimbursements-Refund,,HJ,360,,-30208.66
2032,10/16/2020,10/16/2020,Nicole Prahin,Imported from reimbursements-Google drive storage space,,HJ,,2.13,-30210.79
2032,10/17/2020,10/17/2020,Elizabeth Peinado,Imported from reimbursements-Scheduling software,,HJ,,158.4,-30369.19
2032,10/17/2020,10/17/2020,Elizabeth Peinado,Imported from reimbursements-Scheduling software,,HJ,,244.8,-30613.99
2032,10/17/2020,10/17/2020,Elizabeth Peinado,Imported from reimbursements-Scheduling software,,HJ,,244.8,-30858.79
2032,10/17/2020,10/17/2020,Elizabeth Peinado,Imported from reimbursements-Scheduling software,,HJ,,792,-31650.79
2032,10/17/2020,10/17/2020,Joseph Zarate,Imported from reimbursements-equipment,,HJ,,119.36,-31770.15
2032,10/17/2020,10/17/2020,Monivett Acevedo,Imported from reimbursements-Office Supplies,,HJ,,13.97,-31784.12
2032,10/17/2020,10/17/2020,Monivett Acevedo,Imported from reimbursements-Professional Development,,HJ,,8.95,-31793.07
2032,10/17/2020,10/17/2020,Monivett Acevedo,Imported from reimbursements-Professional Development,,HJ,,13.89,-31806.96
2032,10/17/2020,10/17/2020,Tiffani Bibb,Imported from reimbursements-Printer J Messing,,HJ,,250,-32056.96
2032,10/17/2020,10/17/2020,Tiffani Bibb,Imported from reimbursements-Printer for home office-Replacement A Mason,,HJ,,265.63,-32322.59
2032,10/17/2020,10/17/2020,Tiffani Bibb,Imported from reimbursements-Shredder for J Messing Home Office,,HJ,,46.87,-32369.46
2032,10/18/2020,10/18/2020,Joseph Zarate,Imported from reimbursements-Microsoft License monthly charges,,HJ,,311.48,-32680.94
2032,10/18/2020,10/18/2020,Mahaliah Sejour,Imported from reimbursements-Fellows gifts,,HJ,,17.09,-32698.03
2032,10/18/2020,10/18/2020,Monivett Acevedo,Imported from reimbursements-Office Supplies,,HJ,,10.35,-32708.38
2032,10/19/2020,10/19/2020,Alan Safran,Imported from reimbursements-Monthly HP instant Inks for office,,HJ,,10.61,-32718.99
2032,10/19/2020,10/19/2020,Antonio Gutierrez,Imported from reimbursements-Media Subscription,,HJ,,47.88,-32766.87
2032,10/19/2020,10/19/2020,Antonio Gutierrez,Imported from reimbursements-fellow recruitment,,HJ,,299,-33065.87
2032,10/19/2020,10/19/2020,Joseph Zarate,Imported from reimbursements-equipment,,HJ,,25,-33090.87
2032,10/19/2020,10/19/2020,Joseph Zarate,Imported from reimbursements-equipment shipment,,HJ,,15.05,-33105.92
2032,10/19/2020,10/19/2020,Joseph Zarate,Imported from reimbursements-equipment shipment,,HJ,,21.1,-33127.02
2032,10/19/2020,10/19/2020,Maryellen Leneghan,Imported from reimbursements-pumpkin carving kit for DC fellow for challenge,,HJ,,10.95,-33137.97
2032,10/20/2020,10/20/2020,Elizabeth Peinado,Imported from reimbursements-Ink for X Co.  printer,,HJ,,12.66,-33150.63
2032,10/20/2020,10/20/2020,Elizabeth Peinado,Imported from reimbursements-Ink for X Co.  printer,,HJ,,19.56,-33170.19
2032,10/20/2020,10/20/2020,Elizabeth Peinado,Imported from reimbursements-Ink for X Co.  printer,,HJ,,19.56,-33189.75
2032,10/20/2020,10/20/2020,Elizabeth Peinado,Imported from reimbursements-Ink for X Co.  printer,,HJ,,63.28,-33253.03
2032,10/20/2020,10/20/2020,Joseph Zarate,Imported from reimbursements-equipment,,HJ,,104.68,-33357.71
2032,10/20/2020,10/20/2020,Joseph Zarate,Imported from reimbursements-equipment,,HJ,,419,-33776.71
2032,10/20/2020,10/20/2020,Joseph Zarate,Imported from reimbursements-equipment,,HJ,,582,-34358.71
2032,10/20/2020,10/20/2020,Maryellen Leneghan,Imported from reimbursements-Fellow appreciation fellow team time winner,,HJ,,11.64,-34370.35
2032,10/20/2020,10/20/2020,Maryellen Leneghan,Imported from reimbursements-PPE and Cleaning Supplies for BC Sites,,HJ,,14.5,-34384.85
2032,10/20/2020,10/20/2020,Myesha Hossain,Imported from reimbursements-PPE,,HJ,,123.3,-34508.15
2032,10/20/2020,10/20/2020,Thomas Fischaber,Imported from reimbursements-Fellow laptop testing,,HJ,,439.89,-34948.04
2032,10/20/2020,10/20/2020,Tiffani Bibb,Imported from reimbursements-Book for Performance Management,,HJ,,159.05,-35107.09
2032,10/20/2020,10/20/2020,Tiffani Bibb,Imported from reimbursements-Book for performance Management-E Peinaldo,,HJ,,160.52,-35267.61
2032,10/21/2020,10/21/2020,Alan Safran,Imported from reimbursements-Book for Alan,,HJ,,19.22,-35286.83
2032,10/21/2020,10/21/2020,Elizabeth Peinado,Imported from reimbursements-Math assessment software,,HJ,,4.39,-35291.22
2032,10/21/2020,10/21/2020,Elizabeth Peinado,Imported from reimbursements-Math assessment software,,HJ,,6.79,-35298.01
2032,10/21/2020,10/21/2020,Elizabeth Peinado,Imported from reimbursements-Math assessment software,,HJ,,6.79,-35304.8
2032,10/21/2020,10/21/2020,Elizabeth Peinado,Imported from reimbursements-Math assessment software,,HJ,,21.98,-35326.78
2032,10/21/2020,10/21/2020,Elizabeth Peinado,Imported from reimbursements-Woot Welcome packages,,HJ,,3.33,-35330.11
2032,10/21/2020,10/21/2020,Elizabeth Peinado,Imported from reimbursements-Woot Welcome packages,,HJ,,4,-35334.11
2032,10/21/2020,10/21/2020,Elizabeth Peinado,Imported from reimbursements-Woot Welcome packages,,HJ,,4.26,-35338.37
2032,10/21/2020,10/21/2020,Elizabeth Peinado,Imported from reimbursements-Woot Welcome packages,,HJ,,4.7,-35343.07
2032,10/21/2020,10/21/2020,Elizabeth Peinado,Imported from reimbursements-Woot Welcome packages,,HJ,,5.15,-35348.22
2032,10/21/2020,10/21/2020,Elizabeth Peinado,Imported from reimbursements-Woot Welcome packages,,HJ,,5.15,-35353.37
2032,10/21/2020,10/21/2020,Elizabeth Peinado,Imported from reimbursements-Woot Welcome packages,,HJ,,6.18,-35359.55
2032,10/21/2020,10/21/2020,Elizabeth Peinado,Imported from reimbursements-Woot Welcome packages,,HJ,,6.18,-35365.73
2032,10/21/2020,10/21/2020,Elizabeth Peinado,Imported from reimbursements-Woot Welcome packages,,HJ,,6.58,-35372.31
2032,10/21/2020,10/21/2020,Elizabeth Peinado,Imported from reimbursements-Woot Welcome packages,,HJ,,6.58,-35378.89
2032,10/21/2020,10/21/2020,Elizabeth Peinado,Imported from reimbursements-Woot Welcome packages,,HJ,,7.26,-35386.15
2032,10/21/2020,10/21/2020,Elizabeth Peinado,Imported from reimbursements-Woot Welcome packages,,HJ,,7.26,-35393.41
2032,10/21/2020,10/21/2020,Elizabeth Peinado,Imported from reimbursements-Woot Welcome packages,,HJ,,16.67,-35410.08
2032,10/21/2020,10/21/2020,Elizabeth Peinado,Imported from reimbursements-Woot Welcome packages,,HJ,,19.99,-35430.07
2032,10/21/2020,10/21/2020,Elizabeth Peinado,Imported from reimbursements-Woot Welcome packages,,HJ,,21.28,-35451.35
2032,10/21/2020,10/21/2020,Elizabeth Peinado,Imported from reimbursements-Woot Welcome packages,,HJ,,23.47,-35474.82
2032,10/21/2020,10/21/2020,iaklestad,Imported from reimbursements-Welcome Packages,,HJ,,65.85,-35540.67
2032,10/21/2020,10/21/2020,iaklestad,Imported from reimbursements-Welcome Packages Print Flyers,,HJ,,65.34,-35606.01
2032,10/21/2020,10/21/2020,Joseph Zarate,Imported from reimbursements-Adobe license fees,,HJ,,234.19,-35840.2
2032,10/21/2020,10/21/2020,Joseph Zarate,Imported from reimbursements-equipment,,HJ,,16.29,-35856.49
2032,10/21/2020,10/21/2020,Joseph Zarate,Imported from reimbursements-equipment,,HJ,,27.98,-35884.47
2032,10/21/2020,10/21/2020,Monivett Acevedo,Imported from reimbursements-Hardware -Laptop and Tech Equipment,,HJ,,611.01,-36495.48
2032,10/21/2020,10/21/2020,Tiffani Bibb,Imported from reimbursements-Office Supplies,,HJ,114.34,,-36381.14
2032,10/21/2020,10/21/2020,Uriel Guadarrama,Imported from reimbursements-5 more Monday licenses for Woot,,HJ,,1418.5,-37799.64
2032,10/21/2020,10/21/2020,Uriel Guadarrama,Imported from reimbursements-Webinar for AJ,,HJ,,134.74,-37934.38
2032,10/21/2020,10/21/2020,Uriel Guadarrama,Imported from reimbursements-Zoom for Krista Marks,,HJ,,67.34,-38001.72
2032,10/22/2020,10/22/2020,Elizabeth Peinado,Imported from reimbursements-International fee for math assessment software,,HJ,,0.09,-38001.81
2032,10/22/2020,10/22/2020,Elizabeth Peinado,Imported from reimbursements-International fee for math assessment software,,HJ,,0.14,-38001.95
2032,10/22/2020,10/22/2020,Elizabeth Peinado,Imported from reimbursements-International fee for math assessment software,,HJ,,0.14,-38002.09
2032,10/22/2020,10/22/2020,Elizabeth Peinado,Imported from reimbursements-International fee for math assessment software,,HJ,,0.43,-38002.52
2032,10/22/2020,10/22/2020,Elizabeth Peinado,Imported from reimbursements-Refund of taxes on ink purchase,,HJ,0.74,,-38001.78
2032,10/22/2020,10/22/2020,Elizabeth Peinado,Imported from reimbursements-Refund of taxes on ink purchase,,HJ,1.15,,-38000.63
2032,10/22/2020,10/22/2020,Elizabeth Peinado,Imported from reimbursements-Refund of taxes on ink purchase,,HJ,1.15,,-37999.48
2032,10/22/2020,10/22/2020,Elizabeth Peinado,Imported from reimbursements-Refund of taxes on ink purchase,,HJ,3.73,,-37995.75
2032,10/22/2020,10/22/2020,Joseph Zarate,Imported from reimbursements-equipment,,HJ,,419,-38414.75
2032,10/22/2020,10/22/2020,Joseph Zarate,Imported from reimbursements-equipment,,HJ,,569,-38983.75
2032,10/22/2020,10/22/2020,Joseph Zarate,Imported from reimbursements-equipment returns,,HJ,,22.8,-39006.55
2032,10/22/2020,10/22/2020,Mahaliah Sejour,Imported from reimbursements-Fellows gifts,,HJ,,13.92,-39020.47
2032,10/22/2020,10/22/2020,Monivett Acevedo,Imported from reimbursements-Book. The power of..,,HJ,,8.52,-39028.99
2032,10/22/2020,10/22/2020,Monivett Acevedo,Imported from reimbursements-Office Supplies,,HJ,,363.8,-39392.79
2032,10/22/2020,10/22/2020,Monivett Acevedo,Imported from reimbursements-Office Supplies,,HJ,,367.06,-39759.85
2032,10/22/2020,10/22/2020,Myesha Hossain,Imported from reimbursements-HPHS site set up,,HJ,,24.12,-39783.97
2032,10/22/2020,10/22/2020,Thomas Fischaber,Imported from reimbursements-Computer for new hire,,HJ,,1085,-40868.97
2032,10/23/2020,10/23/2020,Joseph Zarate,Imported from reimbursements-equipment,,HJ,,11.99,-40880.96
2032,10/23/2020,10/23/2020,Joseph Zarate,Imported from reimbursements-equipment shipments,,HJ,,10.08,-40891.04
2032,10/23/2020,10/23/2020,Joseph Zarate,Imported from reimbursements-equipment shipments,,HJ,,10.08,-40901.12
2032,10/23/2020,10/23/2020,Joseph Zarate,Imported from reimbursements-equipment shipments,,HJ,,10.39,-40911.51
2032,10/23/2020,10/23/2020,Monivett Acevedo,Imported from reimbursements-Office Supplies,,HJ,,3.18,-40914.69
2032,10/23/2020,10/23/2020,Monivett Acevedo,Imported from reimbursements-Office Supplies,,HJ,,25.13,-40939.82
2032,10/23/2020,10/23/2020,Monivett Acevedo,Imported from reimbursements-Professional Development,,HJ,,37.65,-40977.47
2032,10/23/2020,10/23/2020,Monivett Acevedo,Imported from reimbursements-Text for engineering team,,HJ,,36.92,-41014.39
2032,10/24/2020,10/24/2020,Joseph Zarate,Imported from reimbursements-software,,HJ,,113.43,-41127.82
2032,10/24/2020,10/24/2020,Monivett Acevedo,Imported from reimbursements-Books for new engineer,,HJ,,153.41,-41281.23
2032,10/24/2020,10/24/2020,Monivett Acevedo,Imported from reimbursements-Office supplies,,HJ,,102.96,-41384.19
2032,10/24/2020,10/24/2020,Monivett Acevedo,Imported from reimbursements-Office supplies for home,,HJ,,178.83,-41563.02
2032,10/24/2020,10/24/2020,Monivett Acevedo,Imported from reimbursements-The power of ..,,HJ,,8.59,-41571.61
2032,10/24/2020,10/24/2020,Myesha Hossain,Imported from reimbursements-Storage,,HJ,,157.35,-41728.96
2032,10/25/2020,10/25/2020,Joseph Zarate,Imported from reimbursements-equipment,,HJ,582,,-41146.96
2032,10/25/2020,10/25/2020,Mahaliah Sejour,Imported from reimbursements-Fellows gifts,,HJ,,12.99,-41159.95
2032,10/25/2020,10/25/2020,Mahaliah Sejour,Imported from reimbursements-Fellows gifts,,HJ,,19.68,-41179.63
2032,10/25/2020,10/25/2020,Monivett Acevedo,Imported from reimbursements-Book. The power of..,,HJ,,8.46,-41188.09
2032,10/25/2020,10/25/2020,Monivett Acevedo,Imported from reimbursements-Office Supplies,,HJ,,58.7,-41246.79
2032,10/26/2020,10/26/2020,Cathryn Cook,Imported from reimbursements-Adobe Creative Cloud for Kyra DeTone,,HJ,,382.37,-41629.16
2032,10/26/2020,10/26/2020,Joseph Zarate,Imported from reimbursements-equipment shipment,,HJ,,15.05,-41644.21
2032,10/26/2020,10/26/2020,Mahaliah Sejour,Imported from reimbursements-Fellows gifts,,HJ,,2.78,-41646.99
2032,10/26/2020,10/26/2020,Maryellen Leneghan,Imported from reimbursements-PPE and Cleaning Supplies for BC Sites,,HJ,,71.96,-41718.95
2032,10/26/2020,10/26/2020,Myesha Hossain,Imported from reimbursements-PPE,,HJ,123.3,,-41595.65
2032,10/26/2020,10/26/2020,Uriel Guadarrama,Imported from reimbursements-Monday licenses for Woot team,,HJ,,1073.34,-42668.99
2032,10/27/2020,10/27/2020,Alan Safran,Imported from reimbursements-Background checks for fellows,,HJ,,3.36,-42672.35
2032,10/27/2020,10/27/2020,Alan Safran,Imported from reimbursements-Background checks for fellows,,HJ,,5.18,-42677.53
2032,10/27/2020,10/27/2020,Alan Safran,Imported from reimbursements-Background checks for fellows,,HJ,,5.19,-42682.72
2032,10/27/2020,10/27/2020,Alan Safran,Imported from reimbursements-Background checks for fellows,,HJ,,16.77,-42699.49
2032,10/27/2020,10/27/2020,Antonio Gutierrez,Imported from reimbursements-fellow recruitment,,HJ,,457.66,-43157.15
2032,10/27/2020,10/27/2020,Myesha Hossain,Imported from reimbursements-PPE,,HJ,118.9,,-43038.25
2032,10/27/2020,10/27/2020,Tiffany Jordan,Imported from reimbursements-Office Supply,,HJ,,19.11,-43057.36
2032,10/27/2020,10/27/2020,Uriel Guadarrama,Imported from reimbursements-Dropbox for Woot team,,HJ,,78.95,-43136.31
2032,10/27/2020,10/27/2020,Uriel Guadarrama,Imported from reimbursements-Monthly charge for SD Zoom accounts,,HJ,,15.93,-43152.24
2032,10/27/2020,10/27/2020,Uriel Guadarrama,Imported from reimbursements-Monthly charge for SD Zoom accounts,,HJ,,31.85,-43184.09
2032,10/27/2020,10/27/2020,Uriel Guadarrama,Imported from reimbursements-Monthly charge for SD Zoom accounts,,HJ,,31.85,-43215.94
2032,10/28/2020,10/28/2020,Alan Safran,Imported from reimbursements-Background checks for fellows,,HJ,,4.62,-43220.56
2032,10/28/2020,10/28/2020,Alan Safran,Imported from reimbursements-Background checks for fellows,,HJ,,7.14,-43227.7
2032,10/28/2020,10/28/2020,Alan Safran,Imported from reimbursements-Background checks for fellows,,HJ,,7.14,-43234.84
2032,10/28/2020,10/28/2020,Alan Safran,Imported from reimbursements-Background checks for fellows,,HJ,,23.1,-43257.94
2032,10/28/2020,10/28/2020,Mahaliah Sejour,Imported from reimbursements-Fellows virtual social,,HJ,,120,-43377.94
2032,10/28/2020,10/28/2020,Uriel Guadarrama,Imported from reimbursements-Dropbox for Adam Gillian,,HJ,,77.11,-43455.05
2032,10/29/2020,10/29/2020,Antonio Gutierrez,Imported from reimbursements-Fellow recruitment,,HJ,,49,-43504.05
2032,10/29/2020,10/29/2020,Joseph Zarate,Imported from reimbursements-equipment,,HJ,,480,-43984.05
2032,10/29/2020,10/29/2020,Joseph Zarate,Imported from reimbursements-equipment,,HJ,,629,-44613.05
2032,10/29/2020,10/29/2020,Mahaliah Sejour,Imported from reimbursements-PPE,,HJ,,254.94,-44867.99
2032,10/29/2020,10/29/2020,Mahaliah Sejour,Imported from reimbursements-PPE,,HJ,,336.45,-45204.44
2032,10/29/2020,10/29/2020,Myesha Hossain,Imported from reimbursements-Fellow Challenge Prize,,HJ,,16.99,-45221.43
2032,10/29/2020,10/29/2020,Myesha Hossain,Imported from reimbursements-PPE Return,,HJ,118.9,,-45102.53
2032,10/29/2020,10/29/2020,Myesha Hossain,Imported from reimbursements-Packaging supplies,,HJ,,25.28,-45127.81
2032,10/30/2020,10/30/2020,Elizabeth Peinado,Imported from reimbursements-Recruiter- corporate seat,,HJ,,409.41,-45537.22
2032,10/30/2020,10/30/2020,Elizabeth Peinado,Imported from reimbursements-Recruiter- corporate seat,,HJ,,632.72,-46169.94
2032,10/30/2020,10/30/2020,Elizabeth Peinado,Imported from reimbursements-Recruiter- corporate seat,,HJ,,632.72,-46802.66
2032,10/30/2020,10/30/2020,Elizabeth Peinado,Imported from reimbursements-Recruiter- corporate seat,,HJ,,2047.03,-48849.69
2032,11/1/2020,11/1/2020,Elizabeth Peinado,Imported from Bank of America Visa-Staff posting and advertising,,HJ,,69.27,-48918.96
2032,11/1/2020,11/1/2020,Elizabeth Peinado,Imported from Bank of America Visa-Staff posting and advertising,,HJ,,107.06,-49026.02
2032,11/1/2020,11/1/2020,Elizabeth Peinado,Imported from Bank of America Visa-Staff posting and advertising,,HJ,,107.06,-49133.08
2032,11/1/2020,11/1/2020,Elizabeth Peinado,Imported from Bank of America Visa-Staff posting and advertising,,HJ,,346.35,-49479.43
2032,11/1/2020,11/1/2020,Joseph Zarate,Imported from Bank of America Visa-equipment returns,,HJ,,22.8,-49502.23
2032,11/1/2020,11/1/2020,Joseph Zarate,Imported from Bank of America Visa-equipment shipment,,HJ,,7.75,-49509.98
2032,11/1/2020,11/1/2020,Mahaliah Sejour,Imported from Bank of America Visa-Fellows gifts,,HJ,,6.87,-49516.85
2032,11/1/2020,11/1/2020,Mahaliah Sejour,Imported from Bank of America Visa-Fellows gifts,,HJ,,6.87,-49523.72
2032,11/1/2020,11/1/2020,Mahaliah Sejour,Imported from Bank of America Visa-Fellows gifts,,HJ,,26.9,-49550.62
2032,11/1/2020,11/1/2020,Mahaliah Sejour,Imported from Bank of America Visa-Fellows gifts,,HJ,,26.9,-49577.52
2032,11/1/2020,11/1/2020,Mahaliah Sejour,Imported from Bank of America Visa-Fellows gifts,,HJ,,28.82,-49606.34
2032,11/1/2020,11/1/2020,Mahaliah Sejour,Imported from Bank of America Visa-Fellows gifts,,HJ,,28.82,-49635.16
2032,11/1/2020,11/1/2020,Mahaliah Sejour,Imported from Bank of America Visa-Fellows gifts,,HJ,,28.82,-49663.98
2032,11/1/2020,11/1/2020,Mahaliah Sejour,Imported from Bank of America Visa-Fellows gifts,,HJ,,28.82,-49692.8
2032,11/1/2020,11/1/2020,Mahaliah Sejour,Imported from Bank of America Visa-shipped X Co.  gift to fellow,,HJ,,26.35,-49719.15
2032,11/1/2020,11/1/2020,Myesha Hossain,Imported from Bank of America Visa-Key Players Appreciation,,HJ,,35.75,-49754.9
2032,11/1/2020,11/1/2020,Thomas Fischaber,Imported from Bank of America Visa-Tutor app AV,,HJ,,10.16,-49765.06
2032,11/1/2020,11/1/2020,Thomas Fischaber,Imported from Bank of America Visa-Tutor app AV,,HJ,,10.24,-49775.3
2032,11/1/2020,11/1/2020,Thomas Fischaber,Imported from Bank of America Visa-Tutor app AV,,HJ,,10.29,-49785.59
2032,11/1/2020,11/1/2020,Thomas Fischaber,Imported from Bank of America Visa-Tutor app AV,,HJ,,10.7,-49796.29
2032,11/1/2020,11/1/2020,Thomas Fischaber,Imported from Bank of America Visa-Tutor app AV,,HJ,,11.45,-49807.74
2032,11/1/2020,11/1/2020,Thomas Fischaber,Imported from Bank of America Visa-Tutor application av,,HJ,,10.01,-49817.75
2032,11/1/2020,11/1/2020,Thomas Fischaber,Imported from Bank of America Visa-Tutor application av,,HJ,,10.34,-49828.09
2032,11/1/2020,11/1/2020,Thomas Fischaber,Imported from Bank of America Visa-Tutor application av,,HJ,,11,-49839.09
2032,11/1/2020,11/1/2020,Thomas Fischaber,Imported from Bank of America Visa-servers for marketing pages,,HJ,,82.21,-49921.3
2032,11/1/2020,11/1/2020,Thomas Fischaber,Imported from Bank of America Visa-tutorial recording servers,,HJ,,119,-50040.3
2032,11/2/2020,11/2/2020,Alan Safran,Imported from Bank of America Visa-Bank monthly fee,,HJ,,15,-50055.3
2032,11/2/2020,11/2/2020,Angela Mason,Imported from Bank of America Visa-Chicago storage unit,,HJ,,149,-50204.3
2032,11/2/2020,11/2/2020,Angela Mason,Imported from Bank of America Visa-Chicago storage unit,,HJ,,173,-50377.3
2032,11/2/2020,11/2/2020,Angela Mason,Imported from Bank of America Visa-PayPro,,HJ,,719.4,-51096.7
2032,11/2/2020,11/2/2020,Denise Parham-Gantt,Imported from Bank of America Visa-prize for woot training activity for option schools,,HJ,,13.77,-51110.47
2032,11/2/2020,11/2/2020,Joseph Zarate,Imported from Bank of America Visa-equipment returns,,HJ,,36.15,-51146.62
2032,11/2/2020,11/2/2020,Joseph Zarate,Imported from Bank of America Visa-equipment shipment,,HJ,,15.05,-51161.67
2032,11/2/2020,11/2/2020,Joseph Zarate,Imported from Bank of America Visa-equipment shipment,,HJ,,26.95,-51188.62
2032,11/2/2020,11/2/2020,Lisa Kapusta,Imported from Bank of America Visa-Appreciation for SD,,HJ,,20.81,-51209.43
2032,11/2/2020,11/2/2020,Lisa Kapusta,Imported from Bank of America Visa-Gratuity for SD appreciation meal,,HJ,,3.92,-51213.35
2032,11/2/2020,11/2/2020,Mahaliah Sejour,Imported from Bank of America Visa-Fellows gifts,,HJ,,12.83,-51226.18
2032,11/3/2020,11/3/2020,Antonio Gutierrez,Imported from Bank of America Visa-Google Drive Storage,,HJ,,1.99,-51228.17
2032,11/3/2020,11/3/2020,Bank of America VISA,Boaf CC October's transactions payment-BofA CC transactions October Payment,,HJ,787.72,,-50440.45
2032,11/3/2020,11/3/2020,Bank of America VISA,Boaf CC October's transactions payment-BofA CC transactions October Payment,,HJ,2007.1,,-48433.35
2032,11/3/2020,11/3/2020,Bank of America VISA,Boaf CC October's transactions payment-BofA CC transactions October Payment,,HJ,2053.07,,-46380.28
2032,11/3/2020,11/3/2020,Bank of America VISA,Boaf CC October's transactions payment-BofA CC transactions October Payment,,HJ,4105.89,,-42274.39
2032,11/3/2020,11/3/2020,Bank of America VISA,Boaf CC October's transactions payment-BofA CC transactions October Payment,,HJ,4833.88,,-37440.51
2032,11/3/2020,11/3/2020,Bank of America VISA,Boaf CC October's transactions payment-BofA CC transactions October Payment,,HJ,6507.51,,-30933
2032,11/3/2020,11/3/2020,Bank of America VISA,Boaf CC October's transactions payment-BofA CC transactions October Payment,,HJ,11878.45,,-19054.55
2032,11/3/2020,11/3/2020,Bank of America VISA,Boaf CC October's transactions payment-BofA CC transactions October Payment,,HJ,16676.07,,-2378.48
2032,11/3/2020,11/3/2020,Mahaliah Sejour,Imported from Bank of America Visa-Fellows gifts,,HJ,,11.88,-2390.36
2032,11/3/2020,11/3/2020,Mahaliah Sejour,Imported from Bank of America Visa-Fellows gifts,,HJ,,12.99,-2403.35
2032,11/3/2020,11/3/2020,Mahaliah Sejour,Imported from Bank of America Visa-Fellows gifts,,HJ,,13.99,-2417.34
2032,11/3/2020,11/3/2020,Mahaliah Sejour,Imported from Bank of America Visa-Fellows gifts,,HJ,,14.84,-2432.18
2032,11/3/2020,11/3/2020,Mahaliah Sejour,Imported from Bank of America Visa-Fellows gifts,,HJ,,14.99,-2447.17
2032,11/3/2020,11/3/2020,Mahaliah Sejour,Imported from Bank of America Visa-Fellows gifts,,HJ,,17.99,-2465.16
2032,11/3/2020,11/3/2020,Maryellen Leneghan,Imported from Bank of America Visa-Staff professional development book,,HJ,,11.65,-2476.81
2032,11/3/2020,11/3/2020,Nicole Prahin,Imported from Bank of America Visa-Reimbursement of PD book that couldnt be shipped bc out of stock,,HJ,32.64,,-2444.17
2032,11/3/2020,11/3/2020,Thomas Fischaber,Imported from Bank of America Visa-Tutor application av,,HJ,,10.01,-2454.18
2032,11/3/2020,11/3/2020,Thomas Fischaber,Imported from Bank of America Visa-Tutor application av,,HJ,,10.05,-2464.23
2032,11/3/2020,11/3/2020,Thomas Fischaber,Imported from Bank of America Visa-Tutor application av,,HJ,,10.1,-2474.33
2032,11/3/2020,11/3/2020,Thomas Fischaber,Imported from Bank of America Visa-Tutor application av,,HJ,,10.69,-2485.02
2032,11/3/2020,11/3/2020,Thomas Fischaber,Imported from Bank of America Visa-Tutor application av,,HJ,,10.92,-2495.94
2032,11/3/2020,11/3/2020,Thomas Fischaber,Imported from Bank of America Visa-Tutor application av,,HJ,,11.25,-2507.19
2032,11/3/2020,11/3/2020,Thomas Fischaber,Imported from Bank of America Visa-code repository subscription,,HJ,,94,-2601.19
2032,11/3/2020,11/3/2020,Thomas Fischaber,Imported from Bank of America Visa-office chair,,HJ,,173.2,-2774.39
2032,11/3/2020,11/3/2020,Thomas Fischaber,Imported from Bank of America Visa-office chair,,HJ,,499,-3273.39
2032,11/3/2020,11/3/2020,Thomas Fischaber,Imported from Bank of America Visa-wootmath.com and woottutor.com servers,,HJ,,2079.5,-5352.89
2032,11/3/2020,11/3/2020,Thomas Fischaber,Imported from Bank of America Visa-wootmath.com email provider,,HJ,,36.78,-5389.67
2032,11/4/2020,11/4/2020,Alan Safran,Imported from Bank of America Visa-Alan monthly google storage,,HJ,,1.99,-5391.66
2032,11/4/2020,11/4/2020,Cathryn Cook,Imported from Bank of America Visa-Strengthsfinder tests for me and Uriel,,HJ,,84.98,-5476.64
2032,11/4/2020,11/4/2020,claice Jackson,Imported from Bank of America Visa-Staff Appreciation,,HJ,,42.17,-5518.81
2032,11/4/2020,11/4/2020,iaklestad,Imported from Bank of America Visa-Fellow Welcome Packages,,HJ,,15.05,-5533.86
2032,11/4/2020,11/4/2020,Joseph Zarate,Imported from Bank of America Visa-equipment returns,,HJ,,22.8,-5556.66
2032,11/4/2020,11/4/2020,Joseph Zarate,Imported from Bank of America Visa-software,,HJ,,48.57,-5605.23
2032,11/4/2020,11/4/2020,Myesha Hossain,Imported from Bank of America Visa-Classroom supplies and student incentives,,HJ,,79.19,-5684.42
2032,11/4/2020,11/4/2020,Myesha Hossain,Imported from Bank of America Visa-Staff Appreciation,,HJ,,15.95,-5700.37
2032,11/4/2020,11/4/2020,Myesha Hossain,Imported from Bank of America Visa-Virtual Social Event,,HJ,,14.99,-5715.36
2032,11/4/2020,11/4/2020,Thomas Fischaber,Imported from Bank of America Visa-Monitor cables and switch,,HJ,,435.52,-6150.88
2032,11/4/2020,11/4/2020,Thomas Fischaber,Imported from Bank of America Visa-Tutor application av,,HJ,,10,-6160.88
2032,11/4/2020,11/4/2020,Thomas Fischaber,Imported from Bank of America Visa-Tutor application av,,HJ,,10.27,-6171.15
2032,11/4/2020,11/4/2020,Thomas Fischaber,Imported from Bank of America Visa-Tutor application av,,HJ,,10.53,-6181.68
2032,11/4/2020,11/4/2020,Thomas Fischaber,Imported from Bank of America Visa-Tutor application av,,HJ,,10.74,-6192.42
2032,11/4/2020,11/4/2020,Thomas Fischaber,Imported from Bank of America Visa-Tutor application av,,HJ,,11.17,-6203.59
2032,11/4/2020,11/4/2020,Thomas Fischaber,Imported from Bank of America Visa-Tutor application av,,HJ,,11.88,-6215.47
2032,11/4/2020,11/4/2020,Thomas Fischaber,Imported from Bank of America Visa-Tutor application av,,HJ,,500,-6715.47
2032,11/5/2020,11/5/2020,Antonio Gutierrez,Imported from Bank of America Visa-Alan Safran Appreciation,,HJ,,192.94,-6908.41
2032,11/5/2020,11/5/2020,Myesha Hossain,Imported from Bank of America Visa-Fellow Appreciation,,HJ,,16.64,-6925.05
2032,11/5/2020,11/5/2020,Myesha Hossain,Imported from Bank of America Visa-Staff Appreciation,,HJ,,10.91,-6935.96
2032,11/5/2020,11/5/2020,Myesha Hossain,Imported from Bank of America Visa-Staff Appreciation,,HJ,,14.96,-6950.92
2032,11/5/2020,11/5/2020,Myesha Hossain,Imported from Bank of America Visa-Staff Appreciation,,HJ,,14.96,-6965.88
2032,11/5/2020,11/5/2020,Myesha Hossain,Imported from Bank of America Visa-Team Time,,HJ,,14.96,-6980.84
2032,11/5/2020,11/5/2020,Myesha Hossain,Imported from Bank of America Visa-Virtual Social Event,,HJ,,7.95,-6988.79
2032,11/5/2020,11/5/2020,Thomas Fischaber,Imported from Bank of America Visa-Monitor and cable,,HJ,,410.13,-7398.92
2032,11/5/2020,11/5/2020,Thomas Fischaber,Imported from Bank of America Visa-Tutor application av,,HJ,,10.04,-7408.96
2032,11/5/2020,11/5/2020,Thomas Fischaber,Imported from Bank of America Visa-Tutor application av,,HJ,,10.26,-7419.22
2032,11/5/2020,11/5/2020,Thomas Fischaber,Imported from Bank of America Visa-Tutor application av,,HJ,,10.4,-7429.62
2032,11/5/2020,11/5/2020,Thomas Fischaber,Imported from Bank of America Visa-Tutor application av,,HJ,,10.6,-7440.22
2032,11/5/2020,11/5/2020,Thomas Fischaber,Imported from Bank of America Visa-Tutor application av,,HJ,,10.61,-7450.83
2032,11/5/2020,11/5/2020,Thomas Fischaber,Imported from Bank of America Visa-Tutor application av,,HJ,,10.86,-7461.69
2032,11/5/2020,11/5/2020,Thomas Fischaber,Imported from Bank of America Visa-Tutor application av,,HJ,,10.94,-7472.63
2032,11/5/2020,11/5/2020,Thomas Fischaber,Imported from Bank of America Visa-Tutor application av,,HJ,,11.1,-7483.73
2032,11/5/2020,11/5/2020,Thomas Fischaber,Imported from Bank of America Visa-Tutor application av,,HJ,,11.17,-7494.9
2032,11/5/2020,11/5/2020,Thomas Fischaber,Imported from Bank of America Visa-Tutor application av,,HJ,,47.93,-7542.83
2032,11/5/2020,11/5/2020,Thomas Fischaber,Imported from Bank of America Visa-Tutor application av,,HJ,,985.77,-8528.6
2032,11/6/2020,11/6/2020,Joseph Zarate,Imported from Bank of America Visa-equipment shipment,,HJ,,15.05,-8543.65
2032,11/6/2020,11/6/2020,Maryellen Leneghan,Imported from Bank of America Visa-Fellow appreciation,,HJ,,9.99,-8553.64
2032,11/6/2020,11/6/2020,Myesha Hossain,Imported from Bank of America Visa-SD Appreciation,,HJ,,14.96,-8568.6
2032,11/6/2020,11/6/2020,Myesha Hossain,Imported from Bank of America Visa-Staff Appreciation,,HJ,,14.96,-8583.56
2032,11/6/2020,11/6/2020,Myesha Hossain,Imported from Bank of America Visa-Staff Appreciation,,HJ,,14.96,-8598.52
2032,11/6/2020,11/6/2020,Myesha Hossain,Imported from Bank of America Visa-Team Time,,HJ,,8.76,-8607.28
2032,11/6/2020,11/6/2020,Myesha Hossain,Imported from Bank of America Visa-Team Time,,HJ,,15.7,-8622.98
2032,11/6/2020,11/6/2020,Thomas Fischaber,Imported from Bank of America Visa-Software for wootmath.com,,HJ,,1248,-9870.98
2032,11/6/2020,11/6/2020,Thomas Fischaber,Imported from Bank of America Visa-Tutor application av,,HJ,,10.32,-9881.3
2032,11/6/2020,11/6/2020,Thomas Fischaber,Imported from Bank of America Visa-Tutor application av,,HJ,,10.35,-9891.65
2032,11/6/2020,11/6/2020,Thomas Fischaber,Imported from Bank of America Visa-Tutor application av,,HJ,,10.41,-9902.06
2032,11/6/2020,11/6/2020,Thomas Fischaber,Imported from Bank of America Visa-Tutor application av,,HJ,,11.03,-9913.09
2032,11/6/2020,11/6/2020,Uriel Guadarrama,Imported from Bank of America Visa-5 more licences,,HJ,,1170.98,-11084.07
2032,11/7/2020,11/7/2020,Myesha Hossain,Imported from Bank of America Visa-ASD Appreciation,,HJ,,14.96,-11099.03
2032,11/7/2020,11/7/2020,Myesha Hossain,Imported from Bank of America Visa-SD Appreciation,,HJ,,14.96,-11113.99
2032,11/7/2020,11/7/2020,Myesha Hossain,Imported from Bank of America Visa-SD Appreciation,,HJ,,14.96,-11128.95
2032,11/7/2020,11/7/2020,Myesha Hossain,Imported from Bank of America Visa-SD Appreciation,,HJ,,14.96,-11143.91
2032,11/7/2020,11/7/2020,Myesha Hossain,Imported from Bank of America Visa-Virtual Social Event,,HJ,,19.54,-11163.45
2032,11/7/2020,11/7/2020,Nicole Prahin,Imported from Bank of America Visa-Ink for at home work use,,HJ,,5.35,-11168.8
2032,11/8/2020,11/8/2020,Monivett Acevedo,Imported from Bank of America Visa-Accounts payable module,,HJ,,154.05,-11322.85
2032,11/8/2020,11/8/2020,Monivett Acevedo,Imported from Bank of America Visa-Adobe for Finance,,HJ,,14.99,-11337.84
2032,11/8/2020,11/8/2020,Thomas Fischaber,Imported from Bank of America Visa-Phone system for Woot Math,,HJ,,59,-11396.84
2032,11/8/2020,11/8/2020,Thomas Fischaber,Imported from Bank of America Visa-Software for woottutor.com,,HJ,,7,-11403.84
2032,11/9/2020,11/9/2020,Joseph Zarate,Imported from Bank of America Visa-Pilot Program equipment,,HJ,,3779.93,-15183.77
2032,11/9/2020,11/9/2020,Joseph Zarate,Imported from Bank of America Visa-equipment shipment.returns,,HJ,,42.2,-15225.97
2032,11/9/2020,11/9/2020,Maryellen Leneghan,Imported from Bank of America Visa-Fellow appreciation,,HJ,,2.64,-15228.61
2032,11/9/2020,11/9/2020,Maryellen Leneghan,Imported from Bank of America Visa-Fellow appreciation,,HJ,,2.64,-15231.25
2032,11/9/2020,11/9/2020,Maryellen Leneghan,Imported from Bank of America Visa-Fellow appreciation,,HJ,,2.64,-15233.89
2032,11/9/2020,11/9/2020,Maryellen Leneghan,Imported from Bank of America Visa-Fellow appreciation,,HJ,,2.64,-15236.53
2032,11/9/2020,11/9/2020,Maryellen Leneghan,Imported from Bank of America Visa-Fellow appreciation,,HJ,,14.88,-15251.41
2032,11/9/2020,11/9/2020,Maryellen Leneghan,Imported from Bank of America Visa-Fellow appreciation,,HJ,,15.77,-15267.18
2032,11/9/2020,11/9/2020,Maryellen Leneghan,Imported from Bank of America Visa-Fellow appreciation,,HJ,,15.77,-15282.95
2032,11/9/2020,11/9/2020,Maryellen Leneghan,Imported from Bank of America Visa-Fellow appreciation,,HJ,,15.77,-15298.72
2032,11/9/2020,11/9/2020,Maryellen Leneghan,Imported from Bank of America Visa-Staff appreciation,,HJ,,19.99,-15318.71
2032,11/9/2020,11/9/2020,Maryellen Leneghan,Imported from Bank of America Visa-Staff appreciation,,HJ,,21.95,-15340.66
2032,11/9/2020,11/9/2020,Maryellen Leneghan,Imported from Bank of America Visa-Staff appreciation,,HJ,,24.95,-15365.61
2032,11/9/2020,11/9/2020,Monivett Acevedo,Imported from Bank of America Visa-Office Supplies,,HJ,,3.18,-15368.79
2032,11/9/2020,11/9/2020,Myesha Hossain,Imported from Bank of America Visa-ASD Appreciation,,HJ,,14,-15382.79
2032,11/9/2020,11/9/2020,Myesha Hossain,Imported from Bank of America Visa-ASD Appreciation,,HJ,,14.96,-15397.75
2032,11/9/2020,11/9/2020,Myesha Hossain,Imported from Bank of America Visa-Refund,,HJ,10.91,,-15386.84
2032,11/9/2020,11/9/2020,Myesha Hossain,Imported from Bank of America Visa-SD Appreciation,,HJ,,130.12,-15516.96
2032,11/9/2020,11/9/2020,Myesha Hossain,Imported from Bank of America Visa-Team Time,,HJ,,15,-15531.96
2032,11/9/2020,11/9/2020,Thomas Fischaber,Imported from Bank of America Visa-tutorial recording servers,,HJ,,119,-15650.96
2032,11/10/2020,11/10/2020,Antonio Gutierrez,Imported from Bank of America Visa-SWAG Shipment to Staff,,HJ,,11.98,-15662.94
2032,11/10/2020,11/10/2020,Halley Bowman,Imported from Bank of America Visa-Editing program,,HJ,,15.39,-15678.33
2032,11/10/2020,11/10/2020,Halley Bowman,Imported from Bank of America Visa-Editing program,,HJ,,23.79,-15702.12
2032,11/10/2020,11/10/2020,Halley Bowman,Imported from Bank of America Visa-Editing program,,HJ,,23.79,-15725.91
2032,11/10/2020,11/10/2020,Halley Bowman,Imported from Bank of America Visa-Editing program,,HJ,,76.98,-15802.89
2032,11/10/2020,11/10/2020,Joseph Zarate,Imported from Bank of America Visa-equipment returns,,HJ,,42.2,-15845.09
2032,11/10/2020,11/10/2020,Joseph Zarate,Imported from Bank of America Visa-equipment shipment,,HJ,,15.05,-15860.14
2032,11/10/2020,11/10/2020,Maryellen Leneghan,Imported from Bank of America Visa-Fellow appreciation,,HJ,,2.71,-15862.85
2032,11/10/2020,11/10/2020,Maryellen Leneghan,Imported from Bank of America Visa-Fellow appreciation,,HJ,,15.77,-15878.62
2032,11/10/2020,11/10/2020,Maryellen Leneghan,Imported from Bank of America Visa-Staff appreciation,,HJ,,9.72,-15888.34
2032,11/10/2020,11/10/2020,Maryellen Leneghan,Imported from Bank of America Visa-Staff appreciation,,HJ,,9.97,-15898.31
2032,11/10/2020,11/10/2020,Maryellen Leneghan,Imported from Bank of America Visa-Staff appreciation,,HJ,,29.95,-15928.26
2032,11/10/2020,11/10/2020,Myesha Hossain,Imported from Bank of America Visa-SD Appreciation,,HJ,,14.96,-15943.22
2032,11/10/2020,11/10/2020,Myesha Hossain,Imported from Bank of America Visa-Staff Appreciation,,HJ,,40.67,-15983.89
2032,11/10/2020,11/10/2020,Myesha Hossain,Imported from Bank of America Visa-Team Time,,HJ,,12.87,-15996.76
2032,11/10/2020,11/10/2020,Nicole Prahin,Imported from Bank of America Visa-Organization planner,,HJ,,25.06,-16021.82
2032,11/10/2020,11/10/2020,Uriel Guadarrama,Imported from Bank of America Visa-Tax refund from Monday,,HJ,60.76,,-15961.06
2032,11/10/2020,11/10/2020,Uriel Guadarrama,Imported from Bank of America Visa-Tax refund from Monday,,HJ,66.29,,-15894.77
2032,11/10/2020,11/10/2020,Uriel Guadarrama,Imported from Bank of America Visa-Tax refund from Monday,,HJ,80.3,,-15814.47
2032,11/10/2020,11/10/2020,Uriel Guadarrama,Imported from Bank of America Visa-Tax refund from Monday,,HJ,82.45,,-15732.02
2032,11/10/2020,11/10/2020,Uriel Guadarrama,Imported from Bank of America Visa-Tax refund from Monday,,HJ,114.48,,-15617.54
2032,11/11/2020,11/11/2020,Antonio Gutierrez,Imported from Bank of America Visa-Fellow Recruitment,,HJ,,900,-16517.54
2032,11/11/2020,11/11/2020,Antonio Gutierrez,Imported from Bank of America Visa-Shipment of Swag to staff,,HJ,,19.11,-16536.65
2032,11/11/2020,11/11/2020,Joseph Zarate,Imported from Bank of America Visa-software,,HJ,,44.42,-16581.07
2032,11/11/2020,11/11/2020,Joseph Zarate,Imported from Bank of America Visa-software,,HJ,,44.42,-16625.49
2032,11/11/2020,11/11/2020,Mahaliah Sejour,Imported from Bank of America Visa-Fellows gifts,,HJ,12.83,,-16612.66
2032,11/11/2020,11/11/2020,Maryellen Leneghan,Imported from Bank of America Visa-Fellow appreciation,,HJ,,18.59,-16631.25
2032,11/11/2020,11/11/2020,Maryellen Leneghan,Imported from Bank of America Visa-Fellow appreciation,,HJ,,24.76,-16656.01
2032,11/11/2020,11/11/2020,Maryellen Leneghan,Imported from Bank of America Visa-Fellow appreciation,,HJ,,24.98,-16680.99
2032,11/11/2020,11/11/2020,Maryellen Leneghan,Imported from Bank of America Visa-Fellow appreciation,,HJ,,25.13,-16706.12
2032,11/11/2020,11/11/2020,Myesha Hossain,Imported from Bank of America Visa-ASD Appreciation,,HJ,,15.44,-16721.56
2032,11/11/2020,11/11/2020,Myesha Hossain,Imported from Bank of America Visa-SD Appreciation,,HJ,,5.69,-16727.25
2032,11/11/2020,11/11/2020,Thomas Fischaber,Imported from Bank of America Visa-Backup software,,HJ,,9.99,-16737.24
2032,11/11/2020,11/11/2020,Thomas Fischaber,Imported from Bank of America Visa-Mailing laptop to Chicago office,,HJ,,26.1,-16763.34
2032,11/12/2020,11/12/2020,Antonio Gutierrez,Imported from Bank of America Visa-phone and fax system,,HJ,,235.07,-16998.41
2032,11/12/2020,11/12/2020,Joseph Zarate,Imported from Bank of America Visa-Equipment,,HJ,,10.5,-17008.91
2032,11/12/2020,11/12/2020,Joseph Zarate,Imported from Bank of America Visa-equipment shipment,,HJ,,15.05,-17023.96
2032,11/12/2020,11/12/2020,Mahaliah Sejour,Imported from Bank of America Visa-Fellows gifts,,HJ,,14.1,-17038.06
2032,11/12/2020,11/12/2020,Mahaliah Sejour,Imported from Bank of America Visa-Fellows gifts,,HJ,,15.31,-17053.37
2032,11/12/2020,11/12/2020,Mahaliah Sejour,Imported from Bank of America Visa-Fellows gifts,,HJ,,23.99,-17077.36
2032,11/12/2020,11/12/2020,Maryellen Leneghan,Imported from Bank of America Visa-Refund for amazon item,,HJ,9.99,,-17067.37
2032,11/12/2020,11/12/2020,Myesha Hossain,Imported from Bank of America Visa-ASD Appreciation,,HJ,,13.68,-17081.05
2032,11/12/2020,11/12/2020,Myesha Hossain,Imported from Bank of America Visa-Fellow Appreciation,,HJ,,13.85,-17094.9
2032,11/13/2020,11/13/2020,Antonio Gutierrez,Imported from Bank of America Visa-Fellow Recruitment,,HJ,,900,-17994.9
2032,11/13/2020,11/13/2020,iaklestad,Imported from Bank of America Visa-Job Board,,HJ,,495,-18489.9
2032,11/13/2020,11/13/2020,Joseph Zarate,Imported from Bank of America Visa-equipment,,HJ,,10.48,-18500.38
2032,11/13/2020,11/13/2020,Mahaliah Sejour,Imported from Bank of America Visa-Fellows gifts,,HJ,,19.99,-18520.37
2032,11/13/2020,11/13/2020,Mahaliah Sejour,Imported from Bank of America Visa-Fellows gifts,,HJ,,60.37,-18580.74
2032,11/13/2020,11/13/2020,Myesha Hossain,Imported from Bank of America Visa-ASD Appreciation,,HJ,,12.99,-18593.73
2032,11/13/2020,11/13/2020,Myesha Hossain,Imported from Bank of America Visa-Fellow Appreciation,,HJ,,7.69,-18601.42
2032,11/13/2020,11/13/2020,Myesha Hossain,Imported from Bank of America Visa-Fellow Appreciation,,HJ,,10.88,-18612.3
2032,11/13/2020,11/13/2020,Myesha Hossain,Imported from Bank of America Visa-SD Office Supplies WFH,,HJ,,12.99,-18625.29
2032,11/14/2020,11/14/2020,Antonio Gutierrez,Imported from Bank of America Visa-Expense Reporting,,HJ,,780.92,-19406.21
2032,11/14/2020,11/14/2020,Mahaliah Sejour,Imported from Bank of America Visa-Fellows gifts,,HJ,,19.07,-19425.28
2032,11/14/2020,11/14/2020,Myesha Hossain,Imported from Bank of America Visa-Fellow Appreciation,,HJ,,16.85,-19442.13
2032,11/15/2020,11/15/2020,Antonio Gutierrez,Imported from Bank of America Visa-Fellow Recruitment,,HJ,,900,-20342.13
2032,11/15/2020,11/15/2020,Mahaliah Sejour,Imported from Bank of America Visa-Fellows gifts,,HJ,,11.65,-20353.78
2032,11/15/2020,11/15/2020,Myesha Hossain,Imported from Bank of America Visa-Fellow Appreciation,,HJ,,14.79,-20368.57
2032,11/16/2020,11/16/2020,Maryellen Leneghan,Imported from Bank of America Visa-Fellow appreciation,,HJ,,17.51,-20386.08
2032,11/16/2020,11/16/2020,Maryellen Leneghan,Imported from Bank of America Visa-Fellow appreciation,,HJ,,18.5,-20404.58
2032,11/16/2020,11/16/2020,Maryellen Leneghan,Imported from Bank of America Visa-Fellow appreciation,,HJ,,18.97,-20423.55
2032,11/16/2020,11/16/2020,Maryellen Leneghan,Imported from Bank of America Visa-Fellow appreciation,,HJ,,26.15,-20449.7
2032,11/16/2020,11/16/2020,Maryellen Leneghan,Imported from Bank of America Visa-Fellow appreciation,,HJ,,26.15,-20475.85
2032,11/16/2020,11/16/2020,Maryellen Leneghan,Imported from Bank of America Visa-Fellow appreciation,,HJ,,26.45,-20502.3
2032,11/16/2020,11/16/2020,Maryellen Leneghan,Imported from Bank of America Visa-Fellow appreciation,,HJ,,26.7,-20529
2032,11/16/2020,11/16/2020,Nicole Prahin,Imported from Bank of America Visa-Google drive storage space,,HJ,,2.13,-20531.13
2032,11/16/2020,11/16/2020,Uriel Guadarrama,Imported from Bank of America Visa-Tax refund from Monday,,HJ,55.23,,-20475.9
2032,11/17/2020,11/17/2020,Antonio Gutierrez,Imported from Bank of America Visa-Fellow Recruitment,,HJ,,900,-21375.9
2032,11/17/2020,11/17/2020,Antonio Gutierrez,Imported from Bank of America Visa-media subscription,,HJ,,4,-21379.9
2032,11/17/2020,11/17/2020,Joseph Zarate,Imported from Bank of America Visa-equipment returns,,HJ,,28.85,-21408.75
2032,11/17/2020,11/17/2020,Mahaliah Sejour,Imported from Bank of America Visa-MS printer,,HJ,,5.35,-21414.1
2032,11/17/2020,11/17/2020,Mahaliah Sejour,Imported from Bank of America Visa-accidental card use for personal exense by SD Nancy Morgan,,HJ,,46.95,-21461.05
2032,11/17/2020,11/17/2020,Maryellen Leneghan,Imported from Bank of America Visa-Fellow appreciation,,HJ,,4.97,-21466.02
2032,11/17/2020,11/17/2020,Maryellen Leneghan,Imported from Bank of America Visa-Fellow appreciation,,HJ,,16.99,-21483.01
2032,11/17/2020,11/17/2020,Maryellen Leneghan,Imported from Bank of America Visa-Fellow appreciation,,HJ,,17,-21500.01
2032,11/17/2020,11/17/2020,Maryellen Leneghan,Imported from Bank of America Visa-Fellow appreciation,,HJ,,22.78,-21522.79
2032,11/17/2020,11/17/2020,Thomas Fischaber,Imported from Bank of America Visa-Fellow laptop for testing,,HJ,439.89,,-21082.9
2032,11/18/2020,11/18/2020,Joseph Zarate,Imported from Bank of America Visa-New hire equipment,,HJ,,8.59,-21091.49
2032,11/18/2020,11/18/2020,Joseph Zarate,Imported from Bank of America Visa-equipment,,HJ,,104.68,-21196.17
2032,11/18/2020,11/18/2020,Mahaliah Sejour,Imported from Bank of America Visa-Fellows gifts,,HJ,,23.53,-21219.7
2032,11/18/2020,11/18/2020,Monivett Acevedo,Imported from Bank of America Visa-Monitor stand for Director of F&A,,HJ,,87.99,-21307.69
2032,11/18/2020,11/18/2020,Monivett Acevedo,Imported from Bank of America Visa-Monitor stands,,HJ,,87.99,-21395.68
2032,11/18/2020,11/18/2020,Myesha Hossain,Imported from Bank of America Visa-NYC Storage,,HJ,,159.3,-21554.98
2032,11/18/2020,11/18/2020,Thomas Fischaber,Imported from Bank of America Visa-Tutor application AV,,HJ,,990.04,-22545.02
2032,11/18/2020,11/18/2020,Uriel Guadarrama,Imported from Bank of America Visa-Tax refund from Monday,,HJ,281.65,,-22263.37
2032,11/19/2020,11/19/2020,Alan Safran,Imported from Bank of America Visa-HP Ink for Alan,,HJ,,10.61,-22273.98
2032,11/19/2020,11/19/2020,Antonio Gutierrez,Imported from Bank of America Visa-Fellow Recruitment,,HJ,10.54,,-22263.44
2032,11/19/2020,11/19/2020,Antonio Gutierrez,Imported from Bank of America Visa-Fellow Recruitment,,HJ,33.56,,-22229.88
2032,11/19/2020,11/19/2020,Antonio Gutierrez,Imported from Bank of America Visa-Fellow Recruitment,,HJ,,299,-22528.88
2032,11/19/2020,11/19/2020,Joseph Zarate,Imported from Bank of America Visa-New hire equipment,,HJ,,13.8,-22542.68
2032,11/19/2020,11/19/2020,Mahaliah Sejour,Imported from Bank of America Visa-Fellows gifts,,HJ,,19.99,-22562.67
2032,11/19/2020,11/19/2020,Mahaliah Sejour,Imported from Bank of America Visa-Fellows gifts,,HJ,,23.53,-22586.2
2032,11/19/2020,11/19/2020,Mahaliah Sejour,Imported from Bank of America Visa-Fellows gifts,,HJ,,23.53,-22609.73
2032,11/19/2020,11/19/2020,Mahaliah Sejour,Imported from Bank of America Visa-Fellows gifts,,HJ,,23.53,-22633.26
2032,11/19/2020,11/19/2020,Mahaliah Sejour,Imported from Bank of America Visa-Fellows gifts,,HJ,,23.53,-22656.79
2032,11/19/2020,11/19/2020,Mahaliah Sejour,Imported from Bank of America Visa-Fellows gifts,,HJ,,25.76,-22682.55
2032,11/19/2020,11/19/2020,Mahaliah Sejour,Imported from Bank of America Visa-Fellows gifts,,HJ,,27.53,-22710.08
2032,11/20/2020,11/20/2020,Alan Safran,Imported from Bank of America Visa-Alan Fedex charge,,HJ,,30.95,-22741.03
2032,11/20/2020,11/20/2020,Alan Safran,Imported from Bank of America Visa-receipt for Staff appreciation. Broward County,,HJ,,98.98,-22840.01
2032,11/20/2020,11/20/2020,iaklestad,Imported from Bank of America Visa-Fellow Welcome Packages,,HJ,,23.03,-22863.04
2032,11/20/2020,11/20/2020,Joseph Zarate,Imported from Bank of America Visa-equipment,,HJ,,7.75,-22870.79
2032,11/20/2020,11/20/2020,Joseph Zarate,Imported from Bank of America Visa-equipment,,HJ,,7.75,-22878.54
2032,11/20/2020,11/20/2020,Mahaliah Sejour,Imported from Bank of America Visa-Fellows gifts,,HJ,,6.29,-22884.83
2032,11/20/2020,11/20/2020,Maryellen Leneghan,Imported from Bank of America Visa-Fellow appreciation,,HJ,,22.14,-22906.97
2032,11/20/2020,11/20/2020,Nicole Prahin,Imported from Bank of America Visa-Get Well Gifts for DoP out on FMLA,,HJ,,32.75,-22939.72
2032,11/20/2020,11/20/2020,Nicole Prahin,Imported from Bank of America Visa-Get Well Gifts for DoP out on FMLA,,HJ,,32.9,-22972.62
2032,11/21/2020,11/21/2020,Elizabeth Peinado,Imported from Bank of America Visa-Math Assessment subscription,,HJ,,4.39,-22977.01
2032,11/21/2020,11/21/2020,Elizabeth Peinado,Imported from Bank of America Visa-Math Assessment subscription,,HJ,,6.79,-22983.8
2032,11/21/2020,11/21/2020,Elizabeth Peinado,Imported from Bank of America Visa-Math Assessment subscription,,HJ,,6.79,-22990.59
2032,11/21/2020,11/21/2020,Elizabeth Peinado,Imported from Bank of America Visa-Math Assessment subscription,,HJ,,21.98,-23012.57
2032,11/21/2020,11/21/2020,Halley Bowman,Imported from Bank of America Visa-PD books for bookclubs,,HJ,,3.78,-23016.35
2032,11/21/2020,11/21/2020,Halley Bowman,Imported from Bank of America Visa-PD books for bookclubs,,HJ,,5.83,-23022.18
2032,11/21/2020,11/21/2020,Halley Bowman,Imported from Bank of America Visa-PD books for bookclubs,,HJ,,5.83,-23028.01
2032,11/21/2020,11/21/2020,Halley Bowman,Imported from Bank of America Visa-PD books for bookclubs,,HJ,,18.88,-23046.89
2032,11/21/2020,11/21/2020,Joseph Zarate,Imported from Bank of America Visa-software,,HJ,,281.56,-23328.45
2032,11/21/2020,11/21/2020,Mahaliah Sejour,Imported from Bank of America Visa-Fellows gifts,,HJ,,17.04,-23345.49
2032,11/21/2020,11/21/2020,Mahaliah Sejour,Imported from Bank of America Visa-Fellows gifts,,HJ,,19.49,-23364.98
2032,11/21/2020,11/21/2020,Mahaliah Sejour,Imported from Bank of America Visa-Fellows gifts,,HJ,,27.88,-23392.86
2032,11/21/2020,11/21/2020,Nicole Prahin,Imported from Bank of America Visa-Get Well Gifts for DoP out on FMLA,,HJ,,28.23,-23421.09
2032,11/22/2020,11/22/2020,Mahaliah Sejour,Imported from Bank of America Visa-Fellows gifts,,HJ,,19.14,-23440.23
2032,11/23/2020,11/23/2020,Elizabeth Peinado,Imported from Bank of America Visa-International fee math assessment subscription,,HJ,,0.09,-23440.32
2032,11/23/2020,11/23/2020,Elizabeth Peinado,Imported from Bank of America Visa-International fee math assessment subscription,,HJ,,0.14,-23440.46
2032,11/23/2020,11/23/2020,Elizabeth Peinado,Imported from Bank of America Visa-International fee math assessment subscription,,HJ,,0.14,-23440.6
2032,11/23/2020,11/23/2020,Elizabeth Peinado,Imported from Bank of America Visa-International fee math assessment subscription,,HJ,,0.43,-23441.03
2032,11/23/2020,11/23/2020,iaklestad,Imported from Bank of America Visa-Mailing Welcome Packages,,HJ,,92.1,-23533.13
2032,11/23/2020,11/23/2020,Joseph Zarate,Imported from Bank of America Visa-New hire equipment,,HJ,,15.05,-23548.18
2032,11/23/2020,11/23/2020,Joseph Zarate,Imported from Bank of America Visa-New hire equipment,,HJ,,15.05,-23563.23
2032,11/23/2020,11/23/2020,Joseph Zarate,Imported from Bank of America Visa-New hire equipment,,HJ,,60.2,-23623.43
2032,11/23/2020,11/23/2020,Joseph Zarate,Imported from Bank of America Visa-Pilot Program equipment,,HJ,,509,-24132.43
2032,11/23/2020,11/23/2020,Joseph Zarate,Imported from Bank of America Visa-equipment,,HJ,,7.64,-24140.07
2032,11/23/2020,11/23/2020,Mahaliah Sejour,Imported from Bank of America Visa-Fellows gifts,,HJ,,19.05,-24159.12
2032,11/23/2020,11/23/2020,Mahaliah Sejour,Imported from Bank of America Visa-Fellows gifts,,HJ,,44.79,-24203.91
2032,11/23/2020,11/23/2020,Monivett Acevedo,Imported from Bank of America Visa-Office Supplies,,HJ,,3.18,-24207.09
2032,11/23/2020,11/23/2020,Myesha Hossain,Imported from Bank of America Visa-Student Incentives,,HJ,,87,-24294.09
2032,11/23/2020,11/23/2020,Thomas Fischaber,Imported from Bank of America Visa-Google Play store subscription for Woot Math app,,HJ,,25,-24319.09
2032,11/24/2020,11/24/2020,Mahaliah Sejour,Imported from Bank of America Visa-Fellows gifts,,HJ,,0.9,-24319.99
2032,11/24/2020,11/24/2020,Myesha Hossain,Imported from Bank of America Visa-Fellow Appreciation,,HJ,,13.93,-24333.92
2032,11/24/2020,11/24/2020,Myesha Hossain,Imported from Bank of America Visa-Refund,,HJ,87,,-24246.92
2032,11/24/2020,11/24/2020,Myesha Hossain,Imported from Bank of America Visa-Student Incentives,,HJ,,21.75,-24268.67
2032,11/24/2020,11/24/2020,Myesha Hossain,Imported from Bank of America Visa-Student Incentives,,HJ,,21.75,-24290.42
2032,11/25/2020,11/25/2020,Alan Safran,Imported from Bank of America Visa-Alan conference-Refunded,,HJ,,149,-24439.42
2032,11/25/2020,11/25/2020,Joseph Zarate,Imported from Bank of America Visa-Pilot program shipment,,HJ,,15.05,-24454.47
2032,11/25/2020,11/25/2020,Joseph Zarate,Imported from Bank of America Visa-Pilot program shipment,,HJ,,30.1,-24484.57
2032,11/25/2020,11/25/2020,Myesha Hossain,Imported from Bank of America Visa-Student Incentives,,HJ,,21.75,-24506.32
2032,11/25/2020,11/25/2020,Myesha Hossain,Imported from Bank of America Visa-Student Incentives,,HJ,,21.75,-24528.07
2032,11/26/2020,11/26/2020,Alan Safran,Imported from Bank of America Visa-Staff appreciation -refund,,HJ,18.99,,-24509.08
2032,11/26/2020,11/26/2020,Myesha Hossain,Imported from Bank of America Visa-Fellow Appreciation,,HJ,,4.95,-24514.03
2032,11/26/2020,11/26/2020,Myesha Hossain,Imported from Bank of America Visa-Fellow Appreciation,,HJ,,12.21,-24526.24
2032,11/27/2020,11/27/2020,Alan Safran,Imported from Bank of America Visa-Alan conference-refund,,HJ,149,,-24377.24
2032,11/27/2020,11/27/2020,Antonio Gutierrez,Imported from Bank of America Visa-Fellow Recruitment,,HJ,,179.42,-24556.66
2032,11/27/2020,11/27/2020,Myesha Hossain,Imported from Bank of America Visa-Fellow Appreciation,,HJ,,12.2,-24568.86
2032,11/27/2020,11/27/2020,Myesha Hossain,Imported from Bank of America Visa-Fellow Appreciation,,HJ,,12.2,-24581.06
2032,11/27/2020,11/27/2020,Myesha Hossain,Imported from Bank of America Visa-Fellow Appreciation,,HJ,,12.2,-24593.26
2032,11/27/2020,11/27/2020,Myesha Hossain,Imported from Bank of America Visa-Fellow Appreciation,,HJ,,12.2,-24605.46
2032,11/27/2020,11/27/2020,Myesha Hossain,Imported from Bank of America Visa-Fellow Appreciation,,HJ,,12.2,-24617.66
2032,11/27/2020,11/27/2020,Myesha Hossain,Imported from Bank of America Visa-Fellow Appreciation,,HJ,,12.2,-24629.86
2032,11/27/2020,11/27/2020,Myesha Hossain,Imported from Bank of America Visa-Fellow Appreciation,,HJ,,12.2,-24642.06
2032,11/27/2020,11/27/2020,Myesha Hossain,Imported from Bank of America Visa-Fellow Appreciation,,HJ,,14.96,-24657.02
2032,11/27/2020,11/27/2020,Myesha Hossain,Imported from Bank of America Visa-Fellow Appreciation,,HJ,,19.86,-24676.88
2032,11/27/2020,11/27/2020,Myesha Hossain,Imported from Bank of America Visa-Fellow Appreciation,,HJ,,19.91,-24696.79
2032,11/27/2020,11/27/2020,Myesha Hossain,Imported from Bank of America Visa-Fellow Appreciation,,HJ,,20.9,-24717.69
2032,11/27/2020,11/27/2020,Uriel Guadarrama,Imported from Bank of America Visa-Monthly Zoom for staff,,HJ,,15.93,-24733.62
2032,11/27/2020,11/27/2020,Uriel Guadarrama,Imported from Bank of America Visa-Monthly Zoom for staff,,HJ,,31.85,-24765.47
2032,11/27/2020,11/27/2020,Uriel Guadarrama,Imported from Bank of America Visa-Monthly Zoom for staff,,HJ,,31.85,-24797.32
2032,11/28/2020,11/28/2020,Mahaliah Sejour,Imported from Bank of America Visa-Fellows gifts,,HJ,,42.3,-24839.62
2032,11/28/2020,11/28/2020,Mahaliah Sejour,Imported from Bank of America Visa-Fellows gifts,,HJ,,42.3,-24881.92
2032,11/28/2020,11/28/2020,Myesha Hossain,Imported from Bank of America Visa-Fellow Appreciation,,HJ,,4.95,-24886.87
2032,11/28/2020,11/28/2020,Myesha Hossain,Imported from Bank of America Visa-Fellow Appreciation,,HJ,,14.96,-24901.83
2032,11/28/2020,11/28/2020,Myesha Hossain,Imported from Bank of America Visa-Fellow Appreciation,,HJ,,19.91,-24921.74
2032,12/1/2020,12/1/2020,Alan Safran,Imported from Bank of America Visa-Bank Service Fees and Charges,,HJ,,15,-24936.74
2032,12/1/2020,12/1/2020,Antonio Gutierrez,Imported from Bank of America Visa-Expense Reporting,,HJ,,530.67,-25467.41
2032,12/1/2020,12/1/2020,Elizabeth Peinado,Imported from Bank of America Visa-Competency Training Korn Ferry Interview Guide,,HJ,,19.5,-25486.91
2032,12/1/2020,12/1/2020,Elizabeth Peinado,Imported from Bank of America Visa-Competency Training Korn Ferry Interview Guide,,HJ,,30.14,-25517.05
2032,12/1/2020,12/1/2020,Elizabeth Peinado,Imported from Bank of America Visa-Competency Training Korn Ferry Interview Guide,,HJ,,30.14,-25547.19
2032,12/1/2020,12/1/2020,Elizabeth Peinado,Imported from Bank of America Visa-Competency Training Korn Ferry Interview Guide,,HJ,,97.49,-25644.68
2032,12/1/2020,12/1/2020,Elizabeth Peinado,Imported from Bank of America Visa-Competency Training. Korn Ferry Interview Guide,,HJ,,17.45,-25662.13
2032,12/1/2020,12/1/2020,Elizabeth Peinado,Imported from Bank of America Visa-Competency Training. Korn Ferry Interview Guide,,HJ,,26.97,-25689.1
2032,12/1/2020,12/1/2020,Elizabeth Peinado,Imported from Bank of America Visa-Competency Training. Korn Ferry Interview Guide,,HJ,,26.97,-25716.07
2032,12/1/2020,12/1/2020,Elizabeth Peinado,Imported from Bank of America Visa-Competency Training. Korn Ferry Interview Guide,,HJ,,87.28,-25803.35
2032,12/1/2020,12/1/2020,Joseph Zarate,Imported from Bank of America Visa-equipment shipment,,HJ,,8.3,-25811.65
2032,12/1/2020,12/1/2020,Joseph Zarate,Imported from Bank of America Visa-equipment shipment,,HJ,,8.4,-25820.05
2032,12/1/2020,12/1/2020,Mahaliah Sejour,Imported from Bank of America Visa-X Co.  award shipping,,HJ,,7.5,-25827.55
2032,12/1/2020,12/1/2020,Thomas Fischaber,Imported from Bank of America Visa-Office Supplies,,HJ,,82.21,-25909.76
2032,12/1/2020,12/1/2020,Thomas Fischaber,Imported from Bank of America Visa-Office Supplies,,HJ,,119,-26028.76
2032,12/2/2020,12/2/2020,Mahaliah Sejour,Imported from Bank of America Visa-PPE supplies,,HJ,,299.51,-26328.27
2032,12/2/2020,12/2/2020,Mahaliah Sejour,Imported from Bank of America Visa-PPE supplies,,HJ,,494.57,-26822.84
2032,12/2/2020,12/2/2020,Mahaliah Sejour,Imported from Bank of America Visa-storage unit,,HJ,,149,-26971.84
2032,12/2/2020,12/2/2020,Mahaliah Sejour,Imported from Bank of America Visa-storage unit,,HJ,,173,-27144.84
2032,12/2/2020,12/2/2020,Thomas Fischaber,Imported from Bank of America Visa-AV for tutoring platform,,HJ,,990.33,-28135.17
2032,12/3/2020,12/3/2020,Antonio Gutierrez,Imported from Bank of America Visa-Storage Space,,HJ,,1.99,-28137.16
2032,12/3/2020,12/3/2020,Monivett Acevedo,Imported from Bank of America Visa-Pricing tool FORIO,,HJ,,75,-28212.16
2032,12/3/2020,12/3/2020,Monivett Acevedo,Imported from Bank of America Visa-Professional Development,,HJ,,34.24,-28246.4
2032,12/3/2020,12/3/2020,Thomas Fischaber,Imported from Bank of America Visa-Email marketing,,HJ,,14.95,-28261.35
2032,12/3/2020,12/3/2020,Thomas Fischaber,Imported from Bank of America Visa-Software repository,,HJ,,94,-28355.35
2032,12/3/2020,12/3/2020,Thomas Fischaber,Imported from Bank of America Visa-Woot Math & Woot Tutor servers,,HJ,,2029.46,-30384.81
2032,12/4/2020,12/4/2020,Bank of America VISA,BoaF CC November's transactions payment-BofA CC November's transaction Payment,,HJ,316.75,,-30068.06
2032,12/4/2020,12/4/2020,Bank of America VISA,BoaF CC November's transactions payment-BofA CC November's transaction Payment,,HJ,514.42,,-29553.64
2032,12/4/2020,12/4/2020,Bank of America VISA,BoaF CC November's transactions payment-BofA CC November's transaction Payment,,HJ,1240,,-28313.64
2032,12/4/2020,12/4/2020,Bank of America VISA,BoaF CC November's transactions payment-BofA CC November's transaction Payment,,HJ,1297.58,,-27016.06
2032,12/4/2020,12/4/2020,Bank of America VISA,BoaF CC November's transactions payment-BofA CC November's transaction Payment,,HJ,3619.71,,-23396.35
2032,12/4/2020,12/4/2020,Bank of America VISA,BoaF CC November's transactions payment-BofA CC November's transaction Payment,,HJ,4663.5,,-18732.85
2032,12/4/2020,12/4/2020,Bank of America VISA,BoaF CC November's transactions payment-BofA CC November's transaction Payment,,HJ,5412.61,,-13320.24
2032,12/4/2020,12/4/2020,Bank of America VISA,BoaF CC November's transactions payment-BofA CC November's transaction Payment,,HJ,7857.17,,-5463.07
2032,12/4/2020,12/4/2020,Halley Bowman,Imported from Bank of America Visa-Thank you gift for helping with curriculum,,HJ,,19.99,-5483.06
2032,12/4/2020,12/4/2020,Joseph Zarate,Imported from Bank of America Visa-equipment shipment,,HJ,,7.75,-5490.81
2032,12/4/2020,12/4/2020,Maryellen Leneghan,Imported from Bank of America Visa-Staff Fellow Appreciation,,HJ,,13.78,-5504.59
2032,12/4/2020,12/4/2020,Maryellen Leneghan,Imported from Bank of America Visa-Staff Fellow Appreciation,,HJ,,19.89,-5524.48
2032,12/5/2020,12/5/2020,Alan Safran,Imported from Bank of America Visa-Monthly Google storage for Alan,,HJ,,1.99,-5526.47
2032,12/5/2020,12/5/2020,Antonio Gutierrez,Imported from Bank of America Visa-Supplies.face mask postage,,HJ,,34.79,-5561.26
2032,12/5/2020,12/5/2020,Halley Bowman,Imported from Bank of America Visa-Thank you gift for helping with curriculum,,HJ,,13.84,-5575.1
2032,12/5/2020,12/5/2020,Mahaliah Sejour,Imported from Bank of America Visa-Fellows gifts,,HJ,,29.99,-5605.09
2032,12/5/2020,12/5/2020,Maryellen Leneghan,Imported from Bank of America Visa-Staff Fellow Appreciation,,HJ,,10.57,-5615.66
2032,12/6/2020,12/6/2020,Mahaliah Sejour,Imported from Bank of America Visa-Awards trophy,,HJ,,32.22,-5647.88
2032,12/6/2020,12/6/2020,Mahaliah Sejour,Imported from Bank of America Visa-Awards trophy,,HJ,,33.97,-5681.85
2032,12/6/2020,12/6/2020,Mahaliah Sejour,Imported from Bank of America Visa-Awards trophy,,HJ,,34.11,-5715.96
2032,12/6/2020,12/6/2020,Mahaliah Sejour,Imported from Bank of America Visa-Awards trophy,,HJ,,34.11,-5750.07
2032,12/6/2020,12/6/2020,Mahaliah Sejour,Imported from Bank of America Visa-Awards trophy,,HJ,,34.11,-5784.18
2032,12/6/2020,12/6/2020,Mahaliah Sejour,Imported from Bank of America Visa-Awards trophy,,HJ,,34.11,-5818.29
2032,12/6/2020,12/6/2020,Mahaliah Sejour,Imported from Bank of America Visa-Awards trophy,,HJ,,34.11,-5852.4
2032,12/6/2020,12/6/2020,Mahaliah Sejour,Imported from Bank of America Visa-Awards trophy,,HJ,,34.11,-5886.51
2032,12/6/2020,12/6/2020,Mahaliah Sejour,Imported from Bank of America Visa-Awards trophy,,HJ,,34.11,-5920.62
2032,12/6/2020,12/6/2020,Mahaliah Sejour,Imported from Bank of America Visa-Awards trophy,,HJ,,34.11,-5954.73
2032,12/6/2020,12/6/2020,Mahaliah Sejour,Imported from Bank of America Visa-Awards trophy,,HJ,,34.11,-5988.84
2032,12/6/2020,12/6/2020,Mahaliah Sejour,Imported from Bank of America Visa-Fellows gifts,,HJ,,29.99,-6018.83
2032,12/6/2020,12/6/2020,Mahaliah Sejour,Imported from Bank of America Visa-Fellows gifts,,HJ,,29.99,-6048.82
2032,12/6/2020,12/6/2020,Mahaliah Sejour,Imported from Bank of America Visa-Fellows gifts,,HJ,,29.99,-6078.81
2032,12/6/2020,12/6/2020,Mahaliah Sejour,Imported from Bank of America Visa-Fellows gifts,,HJ,,29.99,-6108.8
2032,12/6/2020,12/6/2020,Mahaliah Sejour,Imported from Bank of America Visa-Fellows gifts,,HJ,,29.99,-6138.79
2032,12/6/2020,12/6/2020,Maryellen Leneghan,Imported from Bank of America Visa-Staff Fellow Appreciation,,HJ,,25.43,-6164.22
2032,12/6/2020,12/6/2020,Maryellen Leneghan,Imported from Bank of America Visa-Staff Fellow Appreciation,,HJ,,25.43,-6189.65
2032,12/6/2020,12/6/2020,Maryellen Leneghan,Imported from Bank of America Visa-Staff Fellow Appreciation,,HJ,,25.43,-6215.08
2032,12/6/2020,12/6/2020,Maryellen Leneghan,Imported from Bank of America Visa-Staff Fellow Appreciation,,HJ,,25.43,-6240.51
2032,12/6/2020,12/6/2020,Maryellen Leneghan,Imported from Bank of America Visa-Staff Fellow Appreciation,,HJ,,25.43,-6265.94
2032,12/6/2020,12/6/2020,Maryellen Leneghan,Imported from Bank of America Visa-Staff Fellow Appreciation,,HJ,,40.23,-6306.17
2032,12/7/2020,12/7/2020,iaklestad,Imported from Bank of America Visa-Fellow Welcome Packages,,HJ,,22.4,-6328.57
2032,12/7/2020,12/7/2020,Mahaliah Sejour,Imported from Bank of America Visa-Awards trophy,,HJ,,33.88,-6362.45
2032,12/7/2020,12/7/2020,Mahaliah Sejour,Imported from Bank of America Visa-Awards trophy,,HJ,,33.88,-6396.33
2032,12/7/2020,12/7/2020,Mahaliah Sejour,Imported from Bank of America Visa-Awards trophy,,HJ,,33.88,-6430.21
2032,12/7/2020,12/7/2020,Mahaliah Sejour,Imported from Bank of America Visa-Fellows gifts,,HJ,,16.99,-6447.2
2032,12/7/2020,12/7/2020,Mahaliah Sejour,Imported from Bank of America Visa-Fellows gifts,,HJ,,16.99,-6464.19
2032,12/7/2020,12/7/2020,Mahaliah Sejour,Imported from Bank of America Visa-Fellows gifts,,HJ,,16.99,-6481.18
2032,12/7/2020,12/7/2020,Mahaliah Sejour,Imported from Bank of America Visa-Fellows gifts,,HJ,,16.99,-6498.17
2032,12/7/2020,12/7/2020,Mahaliah Sejour,Imported from Bank of America Visa-Fellows gifts,,HJ,,18.52,-6516.69
2032,12/7/2020,12/7/2020,Maryellen Leneghan,Imported from Bank of America Visa-Staff Fellow Appreciation,,HJ,,10.57,-6527.26
2032,12/7/2020,12/7/2020,Maryellen Leneghan,Imported from Bank of America Visa-Staff Fellow Appreciation,,HJ,,10.57,-6537.83
2032,12/7/2020,12/7/2020,Maryellen Leneghan,Imported from Bank of America Visa-Staff Fellow Appreciation,,HJ,,10.57,-6548.4
2032,12/8/2020,12/8/2020,Antonio Gutierrez,Imported from Bank of America Visa-Headphones,,HJ,,112.31,-6660.71
2032,12/8/2020,12/8/2020,claice Jackson,Imported from Bank of America Visa-Appreciation,,HJ,,24.19,-6684.9
2032,12/8/2020,12/8/2020,iaklestad,Imported from Bank of America Visa-Fellow Welcome Packages,,HJ,,56.25,-6741.15
2032,12/8/2020,12/8/2020,Mahaliah Sejour,Imported from Bank of America Visa-Fellows gifts,,HJ,,16.77,-6757.92
2032,12/8/2020,12/8/2020,Mahaliah Sejour,Imported from Bank of America Visa-Fellows gifts,,HJ,,16.77,-6774.69
2032,12/8/2020,12/8/2020,Mahaliah Sejour,Imported from Bank of America Visa-Fellows gifts,,HJ,,16.77,-6791.46
2032,12/8/2020,12/8/2020,Mahaliah Sejour,Imported from Bank of America Visa-Fellows gifts,,HJ,,16.77,-6808.23
2032,12/8/2020,12/8/2020,Mahaliah Sejour,Imported from Bank of America Visa-Fellows gifts,,HJ,,16.99,-6825.22
2032,12/8/2020,12/8/2020,Mahaliah Sejour,Imported from Bank of America Visa-Fellows gifts,,HJ,,16.99,-6842.21
2032,12/8/2020,12/8/2020,Mahaliah Sejour,Imported from Bank of America Visa-Fellows gifts,,HJ,,22.93,-6865.14
2032,12/8/2020,12/8/2020,Mahaliah Sejour,Imported from Bank of America Visa-Fellows gifts,,HJ,,22.93,-6888.07
2032,12/8/2020,12/8/2020,Mahaliah Sejour,Imported from Bank of America Visa-Fellows gifts,,HJ,,22.93,-6911
2032,12/8/2020,12/8/2020,Mahaliah Sejour,Imported from Bank of America Visa-Fellows gifts,,HJ,,46.98,-6957.98
2032,12/8/2020,12/8/2020,Maryellen Leneghan,Imported from Bank of America Visa-Staff Fellow Appreciation,,HJ,,10.57,-6968.55
2032,12/8/2020,12/8/2020,Maryellen Leneghan,Imported from Bank of America Visa-Staff Fellow Appreciation,,HJ,,13.95,-6982.5
2032,12/8/2020,12/8/2020,Maryellen Leneghan,Imported from Bank of America Visa-Staff Fellow Appreciation,,HJ,,16.24,-6998.74
2032,12/8/2020,12/8/2020,Maryellen Leneghan,Imported from Bank of America Visa-Staff Fellow Appreciation,,HJ,,19.38,-7018.12
2032,12/8/2020,12/8/2020,Maryellen Leneghan,Imported from Bank of America Visa-Staff Fellow Appreciation,,HJ,,19.94,-7038.06
2032,12/8/2020,12/8/2020,Maryellen Leneghan,Imported from Bank of America Visa-Staff Fellow Appreciation,,HJ,,25.85,-7063.91
2032,12/8/2020,12/8/2020,Monivett Acevedo,Imported from Bank of America Visa-AP system,,HJ,,174.69,-7238.6
2032,12/8/2020,12/8/2020,Monivett Acevedo,Imported from Bank of America Visa-Monthly subscription for ADOBE,,HJ,,14.99,-7253.59
2032,12/8/2020,12/8/2020,Monivett Acevedo,Imported from Bank of America Visa-Office Supplies,,HJ,,3.18,-7256.77
2032,12/8/2020,12/8/2020,Myesha Hossain,Imported from Bank of America Visa-Dewey Team Time,,HJ,,7.67,-7264.44
2032,12/8/2020,12/8/2020,Thomas Fischaber,Imported from Bank of America Visa-Phone system for Woot Math,,HJ,,59,-7323.44
2032,12/8/2020,12/8/2020,Thomas Fischaber,Imported from Bank of America Visa-SW for server management,,HJ,,7,-7330.44
2032,12/8/2020,12/8/2020,Tiffani Bibb,Imported from Bank of America Visa-Team Assessment for HR Admin and Talent,,HJ,,376,-7706.44
2032,12/9/2020,12/9/2020,Halley Bowman,Imported from Bank of America Visa-Thank you gift for helping with curriculum,,HJ,,21.14,-7727.58
2032,12/9/2020,12/9/2020,Mahaliah Sejour,Imported from Bank of America Visa-Fellows gifts,,HJ,,4.99,-7732.57
2032,12/9/2020,12/9/2020,Mahaliah Sejour,Imported from Bank of America Visa-Fellows gifts,,HJ,,4.99,-7737.56
2032,12/9/2020,12/9/2020,Mahaliah Sejour,Imported from Bank of America Visa-Fellows gifts,,HJ,,4.99,-7742.55
2032,12/9/2020,12/9/2020,Mahaliah Sejour,Imported from Bank of America Visa-Fellows gifts,,HJ,,4.99,-7747.54
2032,12/9/2020,12/9/2020,Mahaliah Sejour,Imported from Bank of America Visa-Fellows gifts,,HJ,,4.99,-7752.53
2032,12/9/2020,12/9/2020,Mahaliah Sejour,Imported from Bank of America Visa-Fellows gifts,,HJ,,16.77,-7769.3
2032,12/9/2020,12/9/2020,Mahaliah Sejour,Imported from Bank of America Visa-Fellows gifts,,HJ,,16.77,-7786.07
2032,12/9/2020,12/9/2020,Mahaliah Sejour,Imported from Bank of America Visa-Fellows gifts,,HJ,,22.93,-7809
2032,12/9/2020,12/9/2020,Mahaliah Sejour,Imported from Bank of America Visa-Fellows gifts,,HJ,,22.93,-7831.93
2032,12/9/2020,12/9/2020,Mahaliah Sejour,Imported from Bank of America Visa-Fellows gifts,,HJ,,22.93,-7854.86
2032,12/9/2020,12/9/2020,Mahaliah Sejour,Imported from Bank of America Visa-Fellows gifts,,HJ,,41.84,-7896.7
2032,12/9/2020,12/9/2020,Mahaliah Sejour,Imported from Bank of America Visa-Fellows gifts,,HJ,,41.84,-7938.54
2032,12/9/2020,12/9/2020,Mahaliah Sejour,Imported from Bank of America Visa-Fellows gifts,,HJ,,41.84,-7980.38
2032,12/9/2020,12/9/2020,Mahaliah Sejour,Imported from Bank of America Visa-Fellows gifts,,HJ,,41.84,-8022.22
2032,12/9/2020,12/9/2020,Myesha Hossain,Imported from Bank of America Visa-Dewey Team Time,,HJ,,19.99,-8042.21
2032,12/9/2020,12/9/2020,Myesha Hossain,Imported from Bank of America Visa-Dewey Team Time,,HJ,,19.99,-8062.2
2032,12/9/2020,12/9/2020,Myesha Hossain,Imported from Bank of America Visa-Dewey Team Time,,HJ,,19.99,-8082.19
2032,12/9/2020,12/9/2020,Myesha Hossain,Imported from Bank of America Visa-Dewey Team Time,,HJ,,19.99,-8102.18
2032,12/9/2020,12/9/2020,Myesha Hossain,Imported from Bank of America Visa-Dewey Team Time,,HJ,,19.99,-8122.17
2032,12/9/2020,12/9/2020,Myesha Hossain,Imported from Bank of America Visa-Dewey Team Time,,HJ,,21.26,-8143.43
2032,12/9/2020,12/9/2020,Thomas Fischaber,Imported from Bank of America Visa-A.V for tutoring platform,,HJ,,990.03,-9133.46
2032,12/9/2020,12/9/2020,Thomas Fischaber,Imported from Bank of America Visa-Stock photos for marketing,,HJ,,29.87,-9163.33
2032,12/9/2020,12/9/2020,Thomas Fischaber,Imported from Bank of America Visa-Tutoring platform . recording servers,,HJ,,88.29,-9251.62
2032,12/10/2020,12/10/2020,Halley Bowman,Imported from Bank of America Visa-Book for Emily for PD,,HJ,,34.2,-9285.82
2032,12/10/2020,12/10/2020,Halley Bowman,Imported from Bank of America Visa-Book for Emily for PD,,HJ,,37,-9322.82
2032,12/10/2020,12/10/2020,Halley Bowman,Imported from Bank of America Visa-NCTM for Halley.curriculum team,,HJ,,16.39,-9339.21
2032,12/10/2020,12/10/2020,Halley Bowman,Imported from Bank of America Visa-NCTM for Halley.curriculum team,,HJ,,25.33,-9364.54
2032,12/10/2020,12/10/2020,Halley Bowman,Imported from Bank of America Visa-NCTM for Halley.curriculum team,,HJ,,25.33,-9389.87
2032,12/10/2020,12/10/2020,Halley Bowman,Imported from Bank of America Visa-NCTM for Halley.curriculum team,,HJ,,81.95,-9471.82
2032,12/10/2020,12/10/2020,Halley Bowman,Imported from Bank of America Visa-book for Mallory for PD,,HJ,,3.84,-9475.66
2032,12/10/2020,12/10/2020,Halley Bowman,Imported from Bank of America Visa-book for Mallory for PD,,HJ,,5.93,-9481.59
2032,12/10/2020,12/10/2020,Halley Bowman,Imported from Bank of America Visa-book for Mallory for PD,,HJ,,5.93,-9487.52
2032,12/10/2020,12/10/2020,Halley Bowman,Imported from Bank of America Visa-book for Mallory for PD,,HJ,,19.21,-9506.73
2032,12/10/2020,12/10/2020,Mahaliah Sejour,Imported from Bank of America Visa-Awards trophy,,HJ,,21.24,-9527.97
2032,12/10/2020,12/10/2020,Mahaliah Sejour,Imported from Bank of America Visa-Fellows gifts,,HJ,,4.99,-9532.96
2032,12/10/2020,12/10/2020,Mahaliah Sejour,Imported from Bank of America Visa-Fellows gifts,,HJ,,11.85,-9544.81
2032,12/10/2020,12/10/2020,Mahaliah Sejour,Imported from Bank of America Visa-Fellows gifts,,HJ,,16.77,-9561.58
2032,12/10/2020,12/10/2020,Mahaliah Sejour,Imported from Bank of America Visa-Fellows gifts,,HJ,,16.77,-9578.35
2032,12/10/2020,12/10/2020,Mahaliah Sejour,Imported from Bank of America Visa-Fellows gifts,,HJ,,17.16,-9595.51
2032,12/10/2020,12/10/2020,Mahaliah Sejour,Imported from Bank of America Visa-Fellows gifts,,HJ,,17.16,-9612.67
2032,12/10/2020,12/10/2020,Mahaliah Sejour,Imported from Bank of America Visa-Fellows gifts,,HJ,,17.16,-9629.83
2032,12/10/2020,12/10/2020,Mahaliah Sejour,Imported from Bank of America Visa-Fellows gifts,,HJ,,17.16,-9646.99
2032,12/10/2020,12/10/2020,Mahaliah Sejour,Imported from Bank of America Visa-Fellows gifts,,HJ,,22.87,-9669.86
2032,12/10/2020,12/10/2020,Mahaliah Sejour,Imported from Bank of America Visa-Fellows gifts,,HJ,,29.88,-9699.74
2032,12/10/2020,12/10/2020,Mahaliah Sejour,Imported from Bank of America Visa-Fellows gifts,,HJ,,41.84,-9741.58
2032,12/10/2020,12/10/2020,Mahaliah Sejour,Imported from Bank of America Visa-Fellows gifts,,HJ,,42.22,-9783.8
2032,12/10/2020,12/10/2020,Maryellen Leneghan,Imported from Bank of America Visa-Staff Fellow Appreciation,,HJ,,28.61,-9812.41
2032,12/10/2020,12/10/2020,Maryellen Leneghan,Imported from Bank of America Visa-video software fee for the year refunded wrong purchase,,HJ,,31.99,-9844.4
2032,12/10/2020,12/10/2020,Miranda Cortez,Imported from Bank of America Visa-Promotional materials for RT and marketing,,HJ,,29.85,-9874.25
2032,12/10/2020,12/10/2020,Miranda Cortez,Imported from Bank of America Visa-Promotional materials for RT and marketing,,HJ,,29.85,-9904.1
2032,12/10/2020,12/10/2020,Miranda Cortez,Imported from Bank of America Visa-Promotional materials for RT and marketing,,HJ,,29.85,-9933.95
2032,12/10/2020,12/10/2020,Miranda Cortez,Imported from Bank of America Visa-Promotional materials for RT and marketing,,HJ,,29.85,-9963.8
2032,12/10/2020,12/10/2020,Myesha Hossain,Imported from Bank of America Visa-Dewey Team Time,,HJ,,19.99,-9983.79
2032,12/10/2020,12/10/2020,Myesha Hossain,Imported from Bank of America Visa-Lincoln Appreciation,,HJ,,15,-9998.79
2032,12/11/2020,12/11/2020,Antonio Gutierrez,Imported from Bank of America Visa-Shipping postage for swag,,HJ,,19.11,-10017.9
2032,12/11/2020,12/11/2020,Antonio Gutierrez,Imported from Bank of America Visa-Supplies.face mask postage,,HJ,,11.67,-10029.57
2032,12/11/2020,12/11/2020,Joseph Zarate,Imported from Bank of America Visa-Equipment,,HJ,,23.53,-10053.1
2032,12/11/2020,12/11/2020,Mahaliah Sejour,Imported from Bank of America Visa-Fellows gifts,,HJ,,41.84,-10094.94
2032,12/11/2020,12/11/2020,Maryellen Leneghan,Imported from Bank of America Visa-Refund for video platform for the year,,HJ,31.99,,-10062.95
2032,12/11/2020,12/11/2020,Maryellen Leneghan,Imported from Bank of America Visa-Staff Fellow Appreciation,,HJ,,9.99,-10072.94
2032,12/11/2020,12/11/2020,Maryellen Leneghan,Imported from Bank of America Visa-Staff Fellow Appreciation,,HJ,,11.76,-10084.7
2032,12/11/2020,12/11/2020,Maryellen Leneghan,Imported from Bank of America Visa-Staff Fellow Appreciation,,HJ,,21.54,-10106.24
2032,12/11/2020,12/11/2020,Maryellen Leneghan,Imported from Bank of America Visa-video software fee for the year for 3 regions,,HJ,,0.64,-10106.88
2032,12/11/2020,12/11/2020,Maryellen Leneghan,Imported from Bank of America Visa-video software fee for the year for 3 regions,,HJ,,4.95,-10111.83
2032,12/11/2020,12/11/2020,Maryellen Leneghan,Imported from Bank of America Visa-video software fee for the year for 3 regions,,HJ,,35.99,-10147.82
2032,12/11/2020,12/11/2020,Monivett Acevedo,Imported from Bank of America Visa-Office,,HJ,,15.29,-10163.11
2032,12/11/2020,12/11/2020,Myesha Hossain,Imported from Bank of America Visa-Staff Appreciation,,HJ,,12.53,-10175.64
2032,12/11/2020,12/11/2020,Thomas Fischaber,Imported from Bank of America Visa-Adaptive Learning CFT,,HJ,,86.99,-10262.63
2032,12/11/2020,12/11/2020,Thomas Fischaber,Imported from Bank of America Visa-Adaptive Learning CFT,,HJ,,86.99,-10349.62
2032,12/11/2020,12/11/2020,Thomas Fischaber,Imported from Bank of America Visa-Adaptive Learning CFT,,HJ,,105.6,-10455.22
2032,12/11/2020,12/11/2020,Thomas Fischaber,Imported from Bank of America Visa-Adaptive Learning CFT,,HJ,,114,-10569.22
2032,12/11/2020,12/11/2020,Thomas Fischaber,Imported from Bank of America Visa-Backups,,HJ,,9.99,-10579.21
2032,12/12/2020,12/12/2020,Antonio Gutierrez,Imported from Bank of America Visa-Online Phone and Fax,,HJ,,235.07,-10814.28
2032,12/12/2020,12/12/2020,Mahaliah Sejour,Imported from Bank of America Visa-Fellows gifts,,HJ,,29.87,-10844.15
2032,12/12/2020,12/12/2020,Mahaliah Sejour,Imported from Bank of America Visa-Fellows gifts,,HJ,,40.74,-10884.89
2032,12/12/2020,12/12/2020,Mahaliah Sejour,Imported from Bank of America Visa-Fellows gifts,,HJ,,51.73,-10936.62
2032,12/12/2020,12/12/2020,Thomas Fischaber,Imported from Bank of America Visa-Adaptive Learning CFT,,HJ,,77,-11013.62
2032,12/13/2020,12/13/2020,Amena Wallace,Imported from Bank of America Visa-Books for DEIB,,HJ,,84.18,-11097.8
2032,12/13/2020,12/13/2020,Halley Bowman,Imported from Bank of America Visa-PD book for Halley,,HJ,,4.07,-11101.87
2032,12/13/2020,12/13/2020,Halley Bowman,Imported from Bank of America Visa-PD book for Halley,,HJ,,6.29,-11108.16
2032,12/13/2020,12/13/2020,Halley Bowman,Imported from Bank of America Visa-PD book for Halley,,HJ,,6.29,-11114.45
2032,12/13/2020,12/13/2020,Halley Bowman,Imported from Bank of America Visa-PD book for Halley,,HJ,,20.36,-11134.81
2032,12/13/2020,12/13/2020,Halley Bowman,Imported from Bank of America Visa-PD books for Mallory,,HJ,,3.55,-11138.36
2032,12/13/2020,12/13/2020,Halley Bowman,Imported from Bank of America Visa-PD books for Mallory,,HJ,,5.48,-11143.84
2032,12/13/2020,12/13/2020,Halley Bowman,Imported from Bank of America Visa-PD books for Mallory,,HJ,,5.48,-11149.32
2032,12/13/2020,12/13/2020,Halley Bowman,Imported from Bank of America Visa-PD books for Mallory,,HJ,,17.75,-11167.07
2032,12/13/2020,12/13/2020,Mahaliah Sejour,Imported from Bank of America Visa-Fellows gifts,,HJ,,6.98,-11174.05
2032,12/13/2020,12/13/2020,Mahaliah Sejour,Imported from Bank of America Visa-Fellows gifts,,HJ,,21.45,-11195.5
2032,12/13/2020,12/13/2020,Mahaliah Sejour,Imported from Bank of America Visa-Fellows gifts,,HJ,,50.84,-11246.34
2032,12/13/2020,12/13/2020,Mahaliah Sejour,Imported from Bank of America Visa-Fellows gifts,,HJ,,61.11,-11307.45
2032,12/13/2020,12/13/2020,Monivett Acevedo,Imported from Bank of America Visa-headphones,,HJ,,159,-11466.45
2032,12/13/2020,12/13/2020,Myesha Hossain,Imported from Bank of America Visa-Dewey Team Time,,HJ,,5.59,-11472.04
2032,12/13/2020,12/13/2020,Nicole Prahin,Imported from Bank of America Visa-Printing for at home office,,HJ,,5.35,-11477.39
2032,12/14/2020,12/14/2020,Mahaliah Sejour,Imported from Bank of America Visa-Fellows gifts,,HJ,,11.33,-11488.72
2032,12/14/2020,12/14/2020,Mahaliah Sejour,Imported from Bank of America Visa-Fellows gifts,,HJ,,12.95,-11501.67
2032,12/14/2020,12/14/2020,Mahaliah Sejour,Imported from Bank of America Visa-Fellows gifts,,HJ,,12.99,-11514.66
2032,12/14/2020,12/14/2020,Mahaliah Sejour,Imported from Bank of America Visa-Fellows gifts,,HJ,,16.61,-11531.27
2032,12/14/2020,12/14/2020,Mahaliah Sejour,Imported from Bank of America Visa-Fellows gifts,,HJ,,24.57,-11555.84
2032,12/14/2020,12/14/2020,Mahaliah Sejour,Imported from Bank of America Visa-Fellows gifts,,HJ,,24.59,-11580.43
2032,12/14/2020,12/14/2020,Mahaliah Sejour,Imported from Bank of America Visa-Fellows gifts,,HJ,,24.6,-11605.03
2032,12/14/2020,12/14/2020,Mahaliah Sejour,Imported from Bank of America Visa-Fellows gifts,,HJ,,35.88,-11640.91
2032,12/14/2020,12/14/2020,Maryellen Leneghan,Imported from Bank of America Visa-Refund for video platform for the year,,HJ,0.64,,-11640.27
2032,12/14/2020,12/14/2020,Maryellen Leneghan,Imported from Bank of America Visa-Staff Fellow Appreciation,,HJ,,18.98,-11659.25
2032,12/14/2020,12/14/2020,Maryellen Leneghan,Imported from Bank of America Visa-Staff Fellow Appreciation,,HJ,,19.95,-11679.2
2032,12/14/2020,12/14/2020,Maryellen Leneghan,Imported from Bank of America Visa-Staff Fellow Appreciation,,HJ,,26.78,-11705.98
2032,12/14/2020,12/14/2020,Maryellen Leneghan,Imported from Bank of America Visa-Staff Fellow Appreciation,,HJ,,27.98,-11733.96
2032,12/14/2020,12/14/2020,Maryellen Leneghan,Imported from Bank of America Visa-Staff Fellow Appreciation,,HJ,,52.98,-11786.94
2032,12/14/2020,12/14/2020,Maryellen Leneghan,Imported from Bank of America Visa-video software fee for the year for 3 regions,,HJ,,0.1,-11787.04
2032,12/14/2020,12/14/2020,Maryellen Leneghan,Imported from Bank of America Visa-video software fee for the year for 3 regions,,HJ,,0.72,-11787.76
2032,12/14/2020,12/14/2020,Myesha Hossain,Imported from Bank of America Visa-Dewey Team Time,,HJ,,5.59,-11793.35
2032,12/14/2020,12/14/2020,Nicole Prahin,Imported from Bank of America Visa-Student Testimonial laminated postcards for CPS district leaders,,HJ,,82.69,-11876.04
2032,12/15/2020,12/15/2020,Antonio Gutierrez,Imported from Bank of America Visa-Swag shipment,,HJ,,23.65,-11899.69
2032,12/15/2020,12/15/2020,Elizabeth Peinado,Imported from Bank of America Visa-Card Stock paper for welcome package notes,,HJ,,0.73,-11900.42
2032,12/15/2020,12/15/2020,Elizabeth Peinado,Imported from Bank of America Visa-Card Stock paper for welcome package notes,,HJ,,1.12,-11901.54
2032,12/15/2020,12/15/2020,Elizabeth Peinado,Imported from Bank of America Visa-Card Stock paper for welcome package notes,,HJ,,1.12,-11902.66
2032,12/15/2020,12/15/2020,Elizabeth Peinado,Imported from Bank of America Visa-Card Stock paper for welcome package notes,,HJ,,3.63,-11906.29
2032,12/15/2020,12/15/2020,Joseph Zarate,Imported from Bank of America Visa-New hire equipment,,HJ,,1209,-13115.29
2032,12/15/2020,12/15/2020,Joseph Zarate,Imported from Bank of America Visa-equipment shipment,,HJ,,16.8,-13132.09
2032,12/15/2020,12/15/2020,Mahaliah Sejour,Imported from Bank of America Visa-Fellows gifts,,HJ,,7.99,-13140.08
2032,12/15/2020,12/15/2020,Mahaliah Sejour,Imported from Bank of America Visa-Fellows gifts,,HJ,,7.99,-13148.07
2032,12/15/2020,12/15/2020,Mahaliah Sejour,Imported from Bank of America Visa-Fellows gifts,,HJ,,7.99,-13156.06
2032,12/15/2020,12/15/2020,Mahaliah Sejour,Imported from Bank of America Visa-Fellows gifts,,HJ,,7.99,-13164.05
2032,12/15/2020,12/15/2020,Mahaliah Sejour,Imported from Bank of America Visa-Fellows gifts,,HJ,,12.95,-13177
2032,12/15/2020,12/15/2020,Mahaliah Sejour,Imported from Bank of America Visa-Fellows gifts,,HJ,,13.73,-13190.73
2032,12/15/2020,12/15/2020,Mahaliah Sejour,Imported from Bank of America Visa-Fellows gifts,,HJ,,13.8,-13204.53
2032,12/15/2020,12/15/2020,Mahaliah Sejour,Imported from Bank of America Visa-Fellows gifts,,HJ,,13.86,-13218.39
2032,12/15/2020,12/15/2020,Mahaliah Sejour,Imported from Bank of America Visa-Fellows gifts,,HJ,,25.9,-13244.29
2032,12/15/2020,12/15/2020,Mahaliah Sejour,Imported from Bank of America Visa-MS printer,,HJ,,5.35,-13249.64
2032,12/15/2020,12/15/2020,Maryellen Leneghan,Imported from Bank of America Visa-Staff Fellow Appreciation,,HJ,,14.09,-13263.73
2032,12/15/2020,12/15/2020,Maryellen Leneghan,Imported from Bank of America Visa-Staff Fellow Appreciation,,HJ,,14.97,-13278.7
2032,12/15/2020,12/15/2020,Maryellen Leneghan,Imported from Bank of America Visa-Staff Fellow Appreciation,,HJ,,18.99,-13297.69
2032,12/15/2020,12/15/2020,Maryellen Leneghan,Imported from Bank of America Visa-Staff Fellow Appreciation,,HJ,,21.99,-13319.68
2032,12/15/2020,12/15/2020,Maryellen Leneghan,Imported from Bank of America Visa-Staff Fellow Appreciation,,HJ,,22.97,-13342.65
2032,12/15/2020,12/15/2020,Myesha Hossain,Imported from Bank of America Visa-Dewey Team Time,,HJ,,5.59,-13348.24
2032,12/15/2020,12/15/2020,Myesha Hossain,Imported from Bank of America Visa-Dewey Team Time,,HJ,,5.59,-13353.83
2032,12/15/2020,12/15/2020,Myesha Hossain,Imported from Bank of America Visa-Dewey Team Time,,HJ,,5.59,-13359.42
2032,12/15/2020,12/15/2020,Myesha Hossain,Imported from Bank of America Visa-Dewey Team Time,,HJ,,5.59,-13365.01
2032,12/15/2020,12/15/2020,Myesha Hossain,Imported from Bank of America Visa-Dewey Team Time,,HJ,,5.94,-13370.95
2032,12/15/2020,12/15/2020,Myesha Hossain,Imported from Bank of America Visa-Lincoln Appreciation,,HJ,,32.23,-13403.18
2032,12/15/2020,12/15/2020,Myesha Hossain,Imported from Bank of America Visa-Lincoln Team Time,,HJ,,31.43,-13434.61
2032,12/15/2020,12/15/2020,Myesha Hossain,Imported from Bank of America Visa-Randolph Team Time,,HJ,,16.96,-13451.57
2032,12/15/2020,12/15/2020,Myesha Hossain,Imported from Bank of America Visa-Randolph Team Time,,HJ,,16.96,-13468.53
2032,12/15/2020,12/15/2020,Nicole Prahin,Imported from Bank of America Visa-Mailed Student Testimonial cards to CPS district leaders,,HJ,,17.57,-13486.1
2032,12/16/2020,12/16/2020,Mahaliah Sejour,Imported from Bank of America Visa-Fellows gifts,,HJ,,10.81,-13496.91
2032,12/16/2020,12/16/2020,Mahaliah Sejour,Imported from Bank of America Visa-Fellows gifts,,HJ,,16.11,-13513.02
2032,12/16/2020,12/16/2020,Mahaliah Sejour,Imported from Bank of America Visa-Fellows gifts,,HJ,,16.95,-13529.97
2032,12/16/2020,12/16/2020,Maryellen Leneghan,Imported from Bank of America Visa-Staff Fellow Appreciation,,HJ,,9.86,-13539.83
2032,12/16/2020,12/16/2020,Maryellen Leneghan,Imported from Bank of America Visa-Staff Fellow Appreciation,,HJ,,13.89,-13553.72
2032,12/16/2020,12/16/2020,Maryellen Leneghan,Imported from Bank of America Visa-Staff Fellow Appreciation,,HJ,,13.95,-13567.67
2032,12/16/2020,12/16/2020,Maryellen Leneghan,Imported from Bank of America Visa-Staff Fellow Appreciation,,HJ,,14.22,-13581.89
2032,12/16/2020,12/16/2020,Maryellen Leneghan,Imported from Bank of America Visa-Staff Fellow Appreciation,,HJ,,15.89,-13597.78
2032,12/16/2020,12/16/2020,Maryellen Leneghan,Imported from Bank of America Visa-Staff Fellow Appreciation,,HJ,,15.95,-13613.73
2032,12/16/2020,12/16/2020,Maryellen Leneghan,Imported from Bank of America Visa-Staff Fellow Appreciation,,HJ,,21.91,-13635.64
2032,12/16/2020,12/16/2020,Maryellen Leneghan,Imported from Bank of America Visa-Staff Fellow Appreciation,,HJ,,21.99,-13657.63
2032,12/16/2020,12/16/2020,Maryellen Leneghan,Imported from Bank of America Visa-Staff Fellow Appreciation,,HJ,,23.96,-13681.59
2032,12/16/2020,12/16/2020,Monivett Acevedo,Imported from Bank of America Visa-Boston trip,,HJ,,493.22,-14174.81
2032,12/16/2020,12/16/2020,Myesha Hossain,Imported from Bank of America Visa-Lincoln Appreciation,,HJ,,16.5,-14191.31
2032,12/16/2020,12/16/2020,Myesha Hossain,Imported from Bank of America Visa-Lincoln Team Time,,HJ,,31.43,-14222.74
2032,12/16/2020,12/16/2020,Myesha Hossain,Imported from Bank of America Visa-Lincoln Team Time,,HJ,,33.71,-14256.45
2032,12/16/2020,12/16/2020,Nicole Prahin,Imported from Bank of America Visa-Google drive storage space,,HJ,,2.13,-14258.58
2032,12/17/2020,12/17/2020,Antonio Gutierrez,Imported from Bank of America Visa-Media Subscription,,HJ,,4,-14262.58
2032,12/17/2020,12/17/2020,Elizabeth Peinado,Imported from Bank of America Visa-New hire packages,,HJ,,9.21,-14271.79
2032,12/17/2020,12/17/2020,Elizabeth Peinado,Imported from Bank of America Visa-New hire packages,,HJ,,14.24,-14286.03
2032,12/17/2020,12/17/2020,Elizabeth Peinado,Imported from Bank of America Visa-New hire packages,,HJ,,14.24,-14300.27
2032,12/17/2020,12/17/2020,Elizabeth Peinado,Imported from Bank of America Visa-New hire packages,,HJ,,46.06,-14346.33
2032,12/17/2020,12/17/2020,Mahaliah Sejour,Imported from Bank of America Visa-Fellows gifts,,HJ,,12.4,-14358.73
2032,12/17/2020,12/17/2020,Mahaliah Sejour,Imported from Bank of America Visa-Fellows gifts,,HJ,,15.89,-14374.62
2032,12/17/2020,12/17/2020,Mahaliah Sejour,Imported from Bank of America Visa-Fellows gifts,,HJ,,34.92,-14409.54
2032,12/17/2020,12/17/2020,Mahaliah Sejour,Imported from Bank of America Visa-Fellows gifts,,HJ,,34.92,-14444.46
2032,12/17/2020,12/17/2020,Mahaliah Sejour,Imported from Bank of America Visa-Fellows gifts,,HJ,,34.92,-14479.38
2032,12/17/2020,12/17/2020,Mahaliah Sejour,Imported from Bank of America Visa-Fellows gifts,,HJ,,34.92,-14514.3
2032,12/17/2020,12/17/2020,Mahaliah Sejour,Imported from Bank of America Visa-holiday dinner,,HJ,,3.31,-14517.61
2032,12/17/2020,12/17/2020,Mahaliah Sejour,Imported from Bank of America Visa-holiday dinner,,HJ,,27.89,-14545.5
2032,12/17/2020,12/17/2020,Maryellen Leneghan,Imported from Bank of America Visa-Staff Fellow Appreciation,,HJ,,14.3,-14559.8
2032,12/17/2020,12/17/2020,Maryellen Leneghan,Imported from Bank of America Visa-Staff Fellow Appreciation,,HJ,,14.98,-14574.78
2032,12/17/2020,12/17/2020,Maryellen Leneghan,Imported from Bank of America Visa-Staff Fellow Appreciation,,HJ,,14.99,-14589.77
2032,12/17/2020,12/17/2020,Maryellen Leneghan,Imported from Bank of America Visa-Staff Fellow Appreciation,,HJ,,18.56,-14608.33
2032,12/17/2020,12/17/2020,Maryellen Leneghan,Imported from Bank of America Visa-Staff Fellow Appreciation,,HJ,,18.78,-14627.11
2032,12/17/2020,12/17/2020,Maryellen Leneghan,Imported from Bank of America Visa-Staff Fellow Appreciation,,HJ,,20,-14647.11
2032,12/17/2020,12/17/2020,Maryellen Leneghan,Imported from Bank of America Visa-Staff Fellow Appreciation,,HJ,,21.09,-14668.2
2032,12/17/2020,12/17/2020,Maryellen Leneghan,Imported from Bank of America Visa-Staff Fellow Appreciation,,HJ,,23.69,-14691.89
2032,12/17/2020,12/17/2020,Myesha Hossain,Imported from Bank of America Visa-Lincoln Team Time,,HJ,,31.43,-14723.32
2032,12/17/2020,12/17/2020,Myesha Hossain,Imported from Bank of America Visa-Lincoln Team Time,,HJ,,31.43,-14754.75
2032,12/17/2020,12/17/2020,Myesha Hossain,Imported from Bank of America Visa-Lincoln Team Time,,HJ,,33.52,-14788.27
2032,12/17/2020,12/17/2020,Myesha Hossain,Imported from Bank of America Visa-Randolph Team Time,,HJ,,16.96,-14805.23
2032,12/17/2020,12/17/2020,Thomas Fischaber,Imported from Bank of America Visa-AV for tutoring platform,,HJ,,990.72,-15795.95
2032,12/17/2020,12/17/2020,Thomas Fischaber,Imported from Bank of America Visa-Refund . Woot Math testing,,HJ,58.95,,-15737
2032,12/17/2020,12/17/2020,Thomas Fischaber,Imported from Bank of America Visa-Woot Math testing,,HJ,,58.95,-15795.95
2032,12/18/2020,12/18/2020,Alan Safran,Imported from Bank of America Visa-Background Checks for fellows,,HJ,,70,-15865.95
2032,12/18/2020,12/18/2020,Alan Safran,Imported from Bank of America Visa-Background Checks for fellowsBackground Checks for fellows,,HJ,,41.5,-15907.45
2032,12/18/2020,12/18/2020,Joseph Zarate,Imported from Bank of America Visa-New hire equipment,,HJ,,29.5,-15936.95
2032,12/18/2020,12/18/2020,Joseph Zarate,Imported from Bank of America Visa-software,,HJ,,281.56,-16218.51
2032,12/18/2020,12/18/2020,Lisa Kapusta,Imported from Bank of America Visa-Staff appreciation gift,,HJ,,36.1,-16254.61
2032,12/18/2020,12/18/2020,Mahaliah Sejour,Imported from Bank of America Visa-Fellows gifts,,HJ,,13.49,-16268.1
2032,12/18/2020,12/18/2020,Maryellen Leneghan,Imported from Bank of America Visa-Staff Fellow Appreciation,,HJ,,19.5,-16287.6
2032,12/18/2020,12/18/2020,Maryellen Leneghan,Imported from Bank of America Visa-Staff Fellow Appreciation,,HJ,,19.99,-16307.59
2032,12/18/2020,12/18/2020,Maryellen Leneghan,Imported from Bank of America Visa-Staff Fellow Appreciation,,HJ,,27.99,-16335.58
2032,12/18/2020,12/18/2020,Maryellen Leneghan,Imported from Bank of America Visa-Staff Fellow Appreciation,,HJ,,33.91,-16369.49
2032,12/18/2020,12/18/2020,Myesha Hossain,Imported from Bank of America Visa-Dewey Key Player Appreciation,,HJ,,18.99,-16388.48
2032,12/18/2020,12/18/2020,Myesha Hossain,Imported from Bank of America Visa-Dewey Key Player Appreciation,,HJ,,18.99,-16407.47
2032,12/19/2020,12/19/2020,Alan Safran,Imported from Bank of America Visa-HP Ink for Alan printer,,HJ,,5.3,-16412.77
2032,12/19/2020,12/19/2020,Antonio Gutierrez,Imported from Bank of America Visa-Fellow Recruitment,,HJ,,299,-16711.77
2032,12/19/2020,12/19/2020,Joseph Zarate,Imported from Bank of America Visa-New hire equipment,,HJ,,103.97,-16815.74
2032,12/19/2020,12/19/2020,Mahaliah Sejour,Imported from Bank of America Visa-PPE supplies,,HJ,,241.77,-17057.51
2032,12/19/2020,12/19/2020,Maryellen Leneghan,Imported from Bank of America Visa-Staff Fellow Appreciation,,HJ,,10.99,-17068.5
2032,12/19/2020,12/19/2020,Maryellen Leneghan,Imported from Bank of America Visa-Staff Fellow Appreciation,,HJ,,19.96,-17088.46
2032,12/19/2020,12/19/2020,Maryellen Leneghan,Imported from Bank of America Visa-Wrong payment charged .refund on another transaction,,HJ,,10.11,-17098.57
2032,12/19/2020,12/19/2020,Myesha Hossain,Imported from Bank of America Visa-Dewey Key Player Appreciation,,HJ,,14.95,-17113.52
2032,12/19/2020,12/19/2020,Myesha Hossain,Imported from Bank of America Visa-Dewey Key Player Appreciation,,HJ,,14.95,-17128.47
2032,12/19/2020,12/19/2020,Myesha Hossain,Imported from Bank of America Visa-Randolph Team Time,,HJ,,16.96,-17145.43
2032,12/19/2020,12/19/2020,Myesha Hossain,Imported from Bank of America Visa-Team Time,,HJ,,16.96,-17162.39
2032,12/20/2020,12/20/2020,Halley Bowman,Imported from Bank of America Visa-Starting books for Anna Hernandez,,HJ,,8.98,-17171.37
2032,12/20/2020,12/20/2020,Halley Bowman,Imported from Bank of America Visa-Starting books for Anna Hernandez,,HJ,,13.87,-17185.24
2032,12/20/2020,12/20/2020,Halley Bowman,Imported from Bank of America Visa-Starting books for Anna Hernandez,,HJ,,13.87,-17199.11
2032,12/20/2020,12/20/2020,Halley Bowman,Imported from Bank of America Visa-Starting books for Anna Hernandez,,HJ,,44.89,-17244
2032,12/20/2020,12/20/2020,Halley Bowman,Imported from Bank of America Visa-book for dept heads recommended by Chris,,HJ,,10.03,-17254.03
2032,12/20/2020,12/20/2020,Halley Bowman,Imported from Bank of America Visa-book for dept heads recommended by Chris,,HJ,,15.49,-17269.52
2032,12/20/2020,12/20/2020,Halley Bowman,Imported from Bank of America Visa-book for dept heads recommended by Chris,,HJ,,15.49,-17285.01
2032,12/20/2020,12/20/2020,Halley Bowman,Imported from Bank of America Visa-book for dept heads recommended by Chris,,HJ,,50.13,-17335.14
2032,12/20/2020,12/20/2020,Mahaliah Sejour,Imported from Bank of America Visa-Fellows gifts,,HJ,,10.95,-17346.09
2032,12/20/2020,12/20/2020,Mahaliah Sejour,Imported from Bank of America Visa-Fellows gifts,,HJ,,21.95,-17368.04
2032,12/20/2020,12/20/2020,Maryellen Leneghan,Imported from Bank of America Visa-Refund for wrong payment,,HJ,10.11,,-17357.93
2032,12/20/2020,12/20/2020,Maryellen Leneghan,Imported from Bank of America Visa-Staff Fellow Appreciation,,HJ,,14.95,-17372.88
2032,12/20/2020,12/20/2020,Maryellen Leneghan,Imported from Bank of America Visa-Staff Fellow Appreciation,,HJ,,19.99,-17392.87
2032,12/20/2020,12/20/2020,Maryellen Leneghan,Imported from Bank of America Visa-Staff Fellow Appreciation,,HJ,,21.99,-17414.86
2032,12/21/2020,12/21/2020,Alan Safran,Imported from Bank of America Visa-Background Checks for fellows,,HJ,,36.5,-17451.36
2032,12/21/2020,12/21/2020,Antonio Gutierrez,Imported from Bank of America Visa-Registered Agent Fee Maryland,,HJ,,49,-17500.36
2032,12/21/2020,12/21/2020,Elizabeth Peinado,Imported from Bank of America Visa-Math Assessment Subscription,,HJ,,4.39,-17504.75
2032,12/21/2020,12/21/2020,Elizabeth Peinado,Imported from Bank of America Visa-Math Assessment Subscription,,HJ,,6.79,-17511.54
2032,12/21/2020,12/21/2020,Elizabeth Peinado,Imported from Bank of America Visa-Math Assessment Subscription,,HJ,,6.79,-17518.33
2032,12/21/2020,12/21/2020,Elizabeth Peinado,Imported from Bank of America Visa-Math Assessment Subscription,,HJ,,21.98,-17540.31
2032,12/21/2020,12/21/2020,Mahaliah Sejour,Imported from Bank of America Visa-Fellows gifts,,HJ,,18.97,-17559.28
2032,12/21/2020,12/21/2020,Maryellen Leneghan,Imported from Bank of America Visa-Staff Fellow Appreciation,,HJ,,14.99,-17574.27
2032,12/21/2020,12/21/2020,Maryellen Leneghan,Imported from Bank of America Visa-Staff Fellow Appreciation,,HJ,,18.35,-17592.62
2032,12/21/2020,12/21/2020,Monivett Acevedo,Imported from Bank of America Visa-Coffee,,HJ,,7.43,-17600.05
2032,12/21/2020,12/21/2020,Myesha Hossain,Imported from Bank of America Visa-Dewey Key Player Appreciation,,HJ,,33.94,-17633.99
2032,12/21/2020,12/21/2020,Myesha Hossain,Imported from Bank of America Visa-NYC Storage,,HJ,,159.3,-17793.29
2032,12/21/2020,12/21/2020,Thomas Fischaber,Imported from Bank of America Visa-Holiday celebration,,HJ,,25,-17818.29
2032,12/21/2020,12/21/2020,Uriel Guadarrama,Imported from Bank of America Visa-Monday for new Academics members,,HJ,,620.95,-18439.24
2032,12/22/2020,12/22/2020,Elizabeth Peinado,Imported from Bank of America Visa-Internernation Fee for Math Assessment Subscription,,HJ,,0.09,-18439.33
2032,12/22/2020,12/22/2020,Elizabeth Peinado,Imported from Bank of America Visa-Internernation Fee for Math Assessment Subscription,,HJ,,0.14,-18439.47
2032,12/22/2020,12/22/2020,Elizabeth Peinado,Imported from Bank of America Visa-Internernation Fee for Math Assessment Subscription,,HJ,,0.14,-18439.61
2032,12/22/2020,12/22/2020,Elizabeth Peinado,Imported from Bank of America Visa-Internernation Fee for Math Assessment Subscription,,HJ,,0.43,-18440.04
2032,12/22/2020,12/22/2020,Elizabeth Peinado,Imported from Bank of America Visa-New hire packages,,HJ,,2.11,-18442.15
2032,12/22/2020,12/22/2020,Elizabeth Peinado,Imported from Bank of America Visa-New hire packages,,HJ,,3.26,-18445.41
2032,12/22/2020,12/22/2020,Elizabeth Peinado,Imported from Bank of America Visa-New hire packages,,HJ,,3.26,-18448.67
2032,12/22/2020,12/22/2020,Elizabeth Peinado,Imported from Bank of America Visa-New hire packages,,HJ,,10.52,-18459.19
2032,12/22/2020,12/22/2020,Maryellen Leneghan,Imported from Bank of America Visa-Staff Fellow Appreciation,,HJ,,18.9,-18478.09
2032,12/22/2020,12/22/2020,Maryellen Leneghan,Imported from Bank of America Visa-Staff Fellow Appreciation,,HJ,,22.99,-18501.08
2032,12/22/2020,12/22/2020,Maryellen Leneghan,Imported from Bank of America Visa-Staff Fellow Appreciation,,HJ,,27.99,-18529.07
2032,12/22/2020,12/22/2020,Maryellen Leneghan,Imported from Bank of America Visa-Staff Fellow Appreciation,,HJ,,28.99,-18558.06
2032,12/22/2020,12/22/2020,Maryellen Leneghan,Imported from Bank of America Visa-Staff Fellow Appreciation,,HJ,,39.89,-18597.95
2032,12/22/2020,12/22/2020,Maryellen Leneghan,Imported from Bank of America Visa-Staff Fellow Appreciation,,HJ,,69.85,-18667.8
2032,12/22/2020,12/22/2020,Monivett Acevedo,Imported from Bank of America Visa-Lunch.Dinner Boston trip,,HJ,,22.47,-18690.27
2032,12/22/2020,12/22/2020,Myesha Hossain,Imported from Bank of America Visa-SD Appreciation,,HJ,,14.95,-18705.22
2032,12/22/2020,12/22/2020,Myesha Hossain,Imported from Bank of America Visa-SD Appreciation,,HJ,,24.95,-18730.17
2032,12/22/2020,12/22/2020,Thomas Fischaber,Imported from Bank of America Visa-Care package,,HJ,,6.92,-18737.09
2032,12/22/2020,12/22/2020,Thomas Fischaber,Imported from Bank of America Visa-Care package,,HJ,,68.8,-18805.89
2032,12/22/2020,12/22/2020,Thomas Fischaber,Imported from Bank of America Visa-Holiday celebration,,HJ,,19.58,-18825.47
2032,12/22/2020,12/22/2020,Thomas Fischaber,Imported from Bank of America Visa-Holiday celebration,,HJ,,19.93,-18845.4
2032,12/22/2020,12/22/2020,Thomas Fischaber,Imported from Bank of America Visa-Holiday celebration,,HJ,,21.39,-18866.79
2032,12/22/2020,12/22/2020,Uriel Guadarrama,Imported from Bank of America Visa-Tax refund for new Monday licenses,,HJ,35.15,,-18831.64
2032,12/23/2020,12/23/2020,Maryellen Leneghan,Imported from Bank of America Visa-Staff Fellow Appreciation,,HJ,,28.6,-18860.24
2032,12/23/2020,12/23/2020,Monivett Acevedo,Imported from Bank of America Visa-Office ink,,HJ,,3.18,-18863.42
2032,12/23/2020,12/23/2020,Myesha Hossain,Imported from Bank of America Visa-PPE,,HJ,,79.99,-18943.41
2032,12/23/2020,12/23/2020,Myesha Hossain,Imported from Bank of America Visa-SD Appreciation,,HJ,,17.95,-18961.36
2032,12/23/2020,12/23/2020,Myesha Hossain,Imported from Bank of America Visa-SD Appreciation,,HJ,,17.95,-18979.31
2032,12/23/2020,12/23/2020,Myesha Hossain,Imported from Bank of America Visa-Staff Appreciation,,HJ,,18.95,-18998.26
2032,12/24/2020,12/24/2020,Halley Bowman,Imported from Bank of America Visa-book for Ashlee Cooper,,HJ,,2.61,-19000.87
2032,12/24/2020,12/24/2020,Halley Bowman,Imported from Bank of America Visa-book for Ashlee Cooper,,HJ,,4.04,-19004.91
2032,12/24/2020,12/24/2020,Halley Bowman,Imported from Bank of America Visa-book for Ashlee Cooper,,HJ,,4.04,-19008.95
2032,12/24/2020,12/24/2020,Halley Bowman,Imported from Bank of America Visa-book for Ashlee Cooper,,HJ,,13.06,-19022.01
2032,12/24/2020,12/24/2020,Maryellen Leneghan,Imported from Bank of America Visa-Staff Fellow Appreciation,,HJ,,28.6,-19050.61
2032,12/24/2020,12/24/2020,Maryellen Leneghan,Imported from Bank of America Visa-Staff Fellow Appreciation,,HJ,,28.6,-19079.21
2032,12/24/2020,12/24/2020,Myesha Hossain,Imported from Bank of America Visa-PPE,,HJ,,29.97,-19109.18
2032,12/24/2020,12/24/2020,Myesha Hossain,Imported from Bank of America Visa-PPE,,HJ,,59.98,-19169.16
2032,12/24/2020,12/24/2020,Myesha Hossain,Imported from Bank of America Visa-PPE Gear for Staff,,HJ,,40.44,-19209.6
2032,12/24/2020,12/24/2020,Myesha Hossain,Imported from Bank of America Visa-SD Appreciation,,HJ,,14.95,-19224.55
2032,12/25/2020,12/25/2020,Monivett Acevedo,Imported from Bank of America Visa-Airport to the house,,HJ,,24.8,-19249.35
2032,12/26/2020,12/26/2020,Myesha Hossain,Imported from Bank of America Visa-PPE Gear for Staff,,HJ,,20.97,-19270.32
2032,12/27/2020,12/27/2020,Myesha Hossain,Imported from Bank of America Visa-Holiday Social,,HJ,,18.99,-19289.31
2032,12/27/2020,12/27/2020,Uriel Guadarrama,Imported from Bank of America Visa-Monthly Zoom for 5 users,,HJ,,15.93,-19305.24
2032,12/27/2020,12/27/2020,Uriel Guadarrama,Imported from Bank of America Visa-Monthly Zoom for 5 users,,HJ,,31.85,-19337.09
2032,12/27/2020,12/27/2020,Uriel Guadarrama,Imported from Bank of America Visa-Monthly Zoom for 5 users,,HJ,,31.85,-19368.94
2032,12/28/2020,12/28/2020,Mahaliah Sejour,Imported from Bank of America Visa-Fellows gifts,,HJ,,5.99,-19374.93
2032,12/29/2020,12/29/2020,Joseph Zarate,Imported from Bank of America Visa-equipment returns,,HJ,,28.08,-19403.01
2032,12/30/2020,12/30/2020,Alan Safran,Imported from Bank of America Visa-Background Checks for fellows,,HJ,,36.5,-19439.51
2032,12/30/2020,12/30/2020,Antonio Gutierrez,Imported from Bank of America Visa-Expense Reporting,,HJ,,780.92,-20220.43
2032,12/30/2020,12/30/2020,iaklestad,Imported from Bank of America Visa-Fellow Welcome Packages,,HJ,,55.85,-20276.28
2032,12/31/2020,12/31/2020,Myesha Hossain,Imported from Bank of America Visa-Lincoln ASD Appreciation,,HJ,,22.99,-20299.27
2032,1/1/2021,1/1/2021,Mahaliah Sejour,Imported from Bank of America Visa-PPE supplies,,HJ,,892.43,-21191.7
2032,1/1/2021,1/1/2021,Thomas Fischaber,Imported from Bank of America Visa-marketing servers,,HJ,,82.21,-21273.91
2032,1/1/2021,1/1/2021,Thomas Fischaber,Imported from Bank of America Visa-recording servers,,HJ,,238,-21511.91
2032,1/2/2021,1/2/2021,Mahaliah Sejour,Imported from Bank of America Visa-Programs storage,,HJ,,149,-21660.91
2032,1/2/2021,1/2/2021,Mahaliah Sejour,Imported from Bank of America Visa-Recruitment storage,,HJ,,173,-21833.91
2032,1/3/2021,1/3/2021,Antonio Gutierrez,Imported from Bank of America Visa-Storage Space for google drive,,HJ,,1.99,-21835.9
2032,1/3/2021,1/3/2021,Thomas Fischaber,Imported from Bank of America Visa-servers,,HJ,,2071.77,-23907.67
2032,1/3/2021,1/3/2021,Thomas Fischaber,Imported from Bank of America Visa-sw repository,,HJ,,94,-24001.67
2032,1/4/2021,1/4/2021,Alan Safran,Imported from Bank of America Visa-Background Check for fellow Chicago,,HJ,,7.5,-24009.17
2032,1/4/2021,1/4/2021,Alan Safran,Imported from Bank of America Visa-Monthly CC Charge,,HJ,,15,-24024.17
2032,1/4/2021,1/4/2021,Antonio Gutierrez,Imported from Bank of America Visa-tutor appreciation-books,,HJ,,26.97,-24051.14
2032,1/4/2021,1/4/2021,Halley Bowman,Imported from Bank of America Visa-bookclub book for Halley,,HJ,,1.73,-24052.87
2032,1/4/2021,1/4/2021,Halley Bowman,Imported from Bank of America Visa-bookclub book for Halley,,HJ,,2.68,-24055.55
2032,1/4/2021,1/4/2021,Halley Bowman,Imported from Bank of America Visa-bookclub book for Halley,,HJ,,2.68,-24058.23
2032,1/4/2021,1/4/2021,Halley Bowman,Imported from Bank of America Visa-bookclub book for Halley,,HJ,,8.66,-24066.89
2032,1/4/2021,1/4/2021,Uriel Guadarrama,Imported from Bank of America Visa-Dropbox for mpires,,HJ,,7.8,-24074.69
2032,1/5/2021,1/5/2021,Alan Safran,Imported from Bank of America Visa-Google Storage for Alan Monthly Subscription,,HJ,,1.99,-24076.68
2032,1/5/2021,1/5/2021,Antonio Gutierrez,Imported from Bank of America Visa-Computer security,,HJ,,95.61,-24172.29
2032,1/5/2021,1/5/2021,Bank of America VISA,BofA concur payment-BofA CC December's transaction Payment,,HJ,433.5,,-23738.79
2032,1/5/2021,1/5/2021,Bank of America VISA,BofA concur payment-BofA CC December's transaction Payment,,HJ,591.8,,-23146.99
2032,1/5/2021,1/5/2021,Bank of America VISA,BofA concur payment-BofA CC December's transaction Payment,,HJ,698.92,,-22448.07
2032,1/5/2021,1/5/2021,Bank of America VISA,BofA concur payment-BofA CC December's transaction Payment,,HJ,1248.88,,-21199.19
2032,1/5/2021,1/5/2021,Bank of America VISA,BofA concur payment-BofA CC December's transaction Payment,,HJ,1341.76,,-19857.43
2032,1/5/2021,1/5/2021,Bank of America VISA,BofA concur payment-BofA CC December's transaction Payment,,HJ,2888.22,,-16969.21
2032,1/5/2021,1/5/2021,Bank of America VISA,BofA concur payment-BofA CC December's transaction Payment,,HJ,6137.05,,-10832.16
2032,1/5/2021,1/5/2021,Bank of America VISA,BofA concur payment-BofA CC December's transaction Payment,,HJ,6959.14,,-3873.02
2032,1/5/2021,1/5/2021,Joseph Zarate,Imported from Bank of America Visa-Returns,,HJ,,21.1,-3894.12
2032,1/5/2021,1/5/2021,Joseph Zarate,Imported from Bank of America Visa-equipment,,HJ,,160.5,-4054.62
2032,1/5/2021,1/5/2021,Joseph Zarate,Imported from Bank of America Visa-equipment shipment,,HJ,,25.9,-4080.52
2032,1/6/2021,1/6/2021,Halley Bowman,Imported from Bank of America Visa-book club book as reward for attending first book club,,HJ,,14.86,-4095.38
2032,1/6/2021,1/6/2021,Joseph Zarate,Imported from Bank of America Visa-Returns,,HJ,,15.05,-4110.43
2032,1/6/2021,1/6/2021,Joseph Zarate,Imported from Bank of America Visa-equipment,,HJ,,197.74,-4308.17
2032,1/6/2021,1/6/2021,Joseph Zarate,Imported from Bank of America Visa-equipment shipment,,HJ,,7.75,-4315.92
2032,1/6/2021,1/6/2021,Joseph Zarate,Imported from Bank of America Visa-equipment shipment,,HJ,,7.75,-4323.67
2032,1/6/2021,1/6/2021,Maryellen Leneghan,Imported from Bank of America Visa-Staff.Fellow Appreciation,,HJ,,14.83,-4338.5
2032,1/6/2021,1/6/2021,Maryellen Leneghan,Imported from Bank of America Visa-Staff.Fellow Appreciation,,HJ,,24.06,-4362.56
2032,1/6/2021,1/6/2021,Thomas Fischaber,Imported from Bank of America Visa-email marketing,,HJ,,33.28,-4395.84
2032,1/6/2021,1/6/2021,Thomas Fischaber,Imported from Bank of America Visa-woot math office storage,,HJ,,1200,-5595.84
2032,1/7/2021,1/7/2021,Alan Safran,Imported from Bank of America Visa-Background Check for Sunaina Vyas,,HJ,,36.5,-5632.34
2032,1/7/2021,1/7/2021,Alan Safran,Imported from Bank of America Visa-Gift for Monivett,,HJ,,19.24,-5651.58
2032,1/7/2021,1/7/2021,iaklestad,Imported from Bank of America Visa-Welcome Package Mailing,,HJ,,29.65,-5681.23
2032,1/7/2021,1/7/2021,Joseph Zarate,Imported from Bank of America Visa-Returns,,HJ,,22.8,-5704.03
2032,1/7/2021,1/7/2021,Joseph Zarate,Imported from Bank of America Visa-equipment,,HJ,,10.38,-5714.41
2032,1/7/2021,1/7/2021,Thomas Fischaber,Imported from Bank of America Visa-av hosting,,HJ,,992.39,-6706.8
2032,1/7/2021,1/7/2021,Tiffani Bibb,Imported from Bank of America Visa-Desk for home office,,HJ,,338.61,-7045.41
2032,1/8/2021,1/8/2021,Alan Safran,Imported from Bank of America Visa-Background Check for Grady Lai,,HJ,,50.5,-7095.91
2032,1/8/2021,1/8/2021,Antonio Gutierrez,Imported from Bank of America Visa-Product Marketing Domain Purchases,,HJ,,77.94,-7173.85
2032,1/8/2021,1/8/2021,Halley Bowman,Imported from Bank of America Visa-Editing.plagiarism software for Mallory Parets,,HJ,,8.25,-7182.1
2032,1/8/2021,1/8/2021,Halley Bowman,Imported from Bank of America Visa-Editing.plagiarism software for Mallory Parets,,HJ,,12.75,-7194.85
2032,1/8/2021,1/8/2021,Halley Bowman,Imported from Bank of America Visa-Editing.plagiarism software for Mallory Parets,,HJ,,12.75,-7207.6
2032,1/8/2021,1/8/2021,Halley Bowman,Imported from Bank of America Visa-Editing.plagiarism software for Mallory Parets,,HJ,,41.25,-7248.85
2032,1/8/2021,1/8/2021,iaklestad,Imported from Bank of America Visa-Welcome Package Flyer,,HJ,,4.54,-7253.39
2032,1/8/2021,1/8/2021,iaklestad,Imported from Bank of America Visa-Welcome Package Mailing,,HJ,,28.7,-7282.09
2032,1/8/2021,1/8/2021,Joseph Zarate,Imported from Bank of America Visa-Returns,,HJ,,15.05,-7297.14
2032,1/8/2021,1/8/2021,Joseph Zarate,Imported from Bank of America Visa-equipment,,HJ,,117.69,-7414.83
2032,1/8/2021,1/8/2021,Joseph Zarate,Imported from Bank of America Visa-equipment,,HJ,,745.78,-8160.61
2032,1/8/2021,1/8/2021,Monivett Acevedo,Imported from Bank of America Visa-AP services,,HJ,,199.07,-8359.68
2032,1/8/2021,1/8/2021,Monivett Acevedo,Imported from Bank of America Visa-Adobe Subscription,,HJ,,14.99,-8374.67
2032,1/8/2021,1/8/2021,Monivett Acevedo,Imported from Bank of America Visa-Office Supplies,,HJ,,3.18,-8377.85
2032,1/8/2021,1/8/2021,Thomas Fischaber,Imported from Bank of America Visa-docker,,HJ,,53,-8430.85
2032,1/8/2021,1/8/2021,Thomas Fischaber,Imported from Bank of America Visa-woot math phone,,HJ,,59,-8489.85
2032,1/9/2021,1/9/2021,Thomas Fischaber,Imported from Bank of America Visa-stock photo,,HJ,,29.87,-8519.72
2032,1/10/2021,1/10/2021,Alan Safran,Imported from Bank of America Visa-Gift for Monivett,,HJ,,10.99,-8530.71
2032,1/10/2021,1/10/2021,Halley Bowman,Imported from Bank of America Visa-book club book as reward for attending first book club,,HJ,,15.75,-8546.46
2032,1/10/2021,1/10/2021,Mahaliah Sejour,Imported from Bank of America Visa-video edit,,HJ,,21.24,-8567.7
2032,1/10/2021,1/10/2021,Maryellen Leneghan,Imported from Bank of America Visa-Staff.Fellow Appreciation,,HJ,,73.98,-8641.68
2032,1/11/2021,1/11/2021,Antonio Gutierrez,Imported from Bank of America Visa-SWAG Shipment to Staff,,HJ,,19.11,-8660.79
2032,1/11/2021,1/11/2021,Myesha Hossain,Imported from Bank of America Visa-Lincoln student incentive,,HJ,,11.99,-8672.78
2032,1/11/2021,1/11/2021,Myesha Hossain,Imported from Bank of America Visa-Lincoln student incentive,,HJ,,11.99,-8684.77
2032,1/11/2021,1/11/2021,Myesha Hossain,Imported from Bank of America Visa-Lincoln student incentive,,HJ,,11.99,-8696.76
2032,1/11/2021,1/11/2021,Myesha Hossain,Imported from Bank of America Visa-Lincoln student incentive,,HJ,,11.99,-8708.75
2032,1/11/2021,1/11/2021,Thomas Fischaber,Imported from Bank of America Visa-backup,,HJ,,9.99,-8718.74
2032,1/12/2021,1/12/2021,Alan Safran,Imported from Bank of America Visa-Background Check Field Print for Christian Kibingwa,,HJ,,28.75,-8747.49
2032,1/12/2021,1/12/2021,Antonio Gutierrez,Imported from Bank of America Visa-Online phone and fax,,HJ,,235.79,-8983.28
2032,1/12/2021,1/12/2021,Nicole Prahin,Imported from Bank of America Visa-Ink for at home work use,,HJ,,5.35,-8988.63
2032,1/13/2021,1/13/2021,Antonio Gutierrez,Imported from Bank of America Visa-Jeff Ward Appreciation,,HJ,,79,-9067.63
2032,1/13/2021,1/13/2021,Antonio Gutierrez,Imported from Bank of America Visa-Product Marketing Domain Purchases,,HJ,,549.2,-9616.83
2032,1/13/2021,1/13/2021,Antonio Gutierrez,Imported from Bank of America Visa-Product Marketing Domain Purchases,,HJ,,858.35,-10475.18
2032,1/13/2021,1/13/2021,Joseph Zarate,Imported from Bank of America Visa-Returns,,HJ,,24.57,-10499.75
2032,1/13/2021,1/13/2021,Joseph Zarate,Imported from Bank of America Visa-Returns,,HJ,,49.88,-10549.63
2032,1/13/2021,1/13/2021,Joseph Zarate,Imported from Bank of America Visa-equipment,,HJ,,564.27,-11113.9
2032,1/13/2021,1/13/2021,Maryellen Leneghan,Imported from Bank of America Visa-Staff.Fellow Appreciation,,HJ,,65.98,-11179.88
2032,1/13/2021,1/13/2021,Myesha Hossain,Imported from Bank of America Visa-Lincoln student incentive,,HJ,,16.88,-11196.76
2032,1/14/2021,1/14/2021,Antonio Gutierrez,Imported from Bank of America Visa-Product Marketing Domain Purchases,,HJ,,220.38,-11417.14
2032,1/14/2021,1/14/2021,Joseph Zarate,Imported from Bank of America Visa-Equipment,,HJ,,187.54,-11604.68
2032,1/14/2021,1/14/2021,Joseph Zarate,Imported from Bank of America Visa-Returns,,HJ,,15.05,-11619.73
2032,1/14/2021,1/14/2021,Joseph Zarate,Imported from Bank of America Visa-equipment,,HJ,,6.05,-11625.78
2032,1/15/2021,1/15/2021,Thomas Fischaber,Imported from Bank of America Visa-av hosting,,HJ,,990.75,-12616.53
2032,1/15/2021,1/15/2021,Uriel Guadarrama,Imported from Bank of America Visa-Zoom annual for Alan,,HJ,,42.38,-12658.91
2032,1/16/2021,1/16/2021,Halley Bowman,Imported from Bank of America Visa-Mailing textbook to Mallory,,HJ,,0.64,-12659.55
2032,1/16/2021,1/16/2021,Halley Bowman,Imported from Bank of America Visa-Mailing textbook to Mallory,,HJ,,1,-12660.55
2032,1/16/2021,1/16/2021,Halley Bowman,Imported from Bank of America Visa-Mailing textbook to Mallory,,HJ,,1,-12661.55
2032,1/16/2021,1/16/2021,Halley Bowman,Imported from Bank of America Visa-Mailing textbook to Mallory,,HJ,,3.22,-12664.77
2032,1/16/2021,1/16/2021,Halley Bowman,Imported from Bank of America Visa-Wifi booster for Ashlee,,HJ,,3.3,-12668.07
2032,1/16/2021,1/16/2021,Halley Bowman,Imported from Bank of America Visa-Wifi booster for Ashlee,,HJ,,5.1,-12673.17
2032,1/16/2021,1/16/2021,Halley Bowman,Imported from Bank of America Visa-Wifi booster for Ashlee,,HJ,,5.1,-12678.27
2032,1/16/2021,1/16/2021,Halley Bowman,Imported from Bank of America Visa-Wifi booster for Ashlee,,HJ,,16.49,-12694.76
2032,1/16/2021,1/16/2021,Mahaliah Sejour,Imported from Bank of America Visa-MS printer,,HJ,,5.35,-12700.11
2032,1/17/2021,1/17/2021,Alan Safran,Imported from Bank of America Visa-Book for Alan Professional Development,,HJ,,39.26,-12739.37
2032,1/17/2021,1/17/2021,Antonio Gutierrez,Imported from Bank of America Visa-Marketing,,HJ,,4,-12743.37
2032,1/17/2021,1/17/2021,Nicole Prahin,Imported from Bank of America Visa-Google drive storage space,,HJ,,2.13,-12745.5
2032,1/18/2021,1/18/2021,Alan Safran,Imported from Bank of America Visa-Background Check for Christian Kibingwa,,HJ,,36.5,-12782
2032,1/18/2021,1/18/2021,Antonio Gutierrez,Imported from Bank of America Visa-Product Marketing Domain Purchases,,HJ,,274.55,-13056.55
2032,1/18/2021,1/18/2021,Halley Bowman,Imported from Bank of America Visa-batteries for Emily,,HJ,,11.65,-13068.2
2032,1/18/2021,1/18/2021,Joseph Zarate,Imported from Bank of America Visa-Microsoft License monthly charges,,HJ,,299.05,-13367.25
2032,1/19/2021,1/19/2021,Antonio Gutierrez,Imported from Bank of America Visa-Fellow Recruitment,,HJ,,299,-13666.25
2032,1/19/2021,1/19/2021,Joseph Zarate,Imported from Bank of America Visa-equipment,,HJ,,35.39,-13701.64
2032,1/19/2021,1/19/2021,Joseph Zarate,Imported from Bank of America Visa-equipment shipment,,HJ,,7.75,-13709.39
2032,1/19/2021,1/19/2021,Joseph Zarate,Imported from Bank of America Visa-equipment shipment,,HJ,,7.75,-13717.14
2032,1/20/2021,1/20/2021,Alan Safran,Imported from Bank of America Visa-Background Check for Samuel Briante,,HJ,,50.5,-13767.64
2032,1/20/2021,1/20/2021,Alan Safran,Imported from Bank of America Visa-Purchase of HP Ink,,HJ,,5.3,-13772.94
2032,1/20/2021,1/20/2021,Halley Bowman,Imported from Bank of America Visa-Starting book for Mika,,HJ,,1.75,-13774.69
2032,1/20/2021,1/20/2021,Halley Bowman,Imported from Bank of America Visa-Starting book for Mika,,HJ,,2.71,-13777.4
2032,1/20/2021,1/20/2021,Halley Bowman,Imported from Bank of America Visa-Starting book for Mika,,HJ,,2.71,-13780.11
2032,1/20/2021,1/20/2021,Halley Bowman,Imported from Bank of America Visa-Starting book for Mika,,HJ,,8.78,-13788.89
2032,1/20/2021,1/20/2021,Joseph Zarate,Imported from Bank of America Visa-Equipment,,HJ,,7.99,-13796.88
2032,1/20/2021,1/20/2021,Monivett Acevedo,Imported from Bank of America Visa-1099 filings,,HJ,,29.9,-13826.78
2032,1/20/2021,1/20/2021,Myesha Hossain,Imported from Bank of America Visa-HSFI Team Time,,HJ,,22.1,-13848.88
2032,1/20/2021,1/20/2021,Uriel Guadarrama,Imported from Bank of America Visa-Annual Dropbox licenses for National teams,,HJ,,3024,-16872.88
2032,1/21/2021,1/21/2021,Antonio Gutierrez,Imported from Bank of America Visa-Fellow Recruitment,,HJ,,30,-16902.88
2032,1/21/2021,1/21/2021,Antonio Gutierrez,Imported from Bank of America Visa-SWAG Shipment to Staff,,HJ,,98.55,-17001.43
2032,1/21/2021,1/21/2021,Elizabeth Peinado,Imported from Bank of America Visa-Math Assessment subscription,,HJ,,4.39,-17005.82
2032,1/21/2021,1/21/2021,Elizabeth Peinado,Imported from Bank of America Visa-Math Assessment subscription,,HJ,,6.79,-17012.61
2032,1/21/2021,1/21/2021,Elizabeth Peinado,Imported from Bank of America Visa-Math Assessment subscription,,HJ,,6.79,-17019.4
2032,1/21/2021,1/21/2021,Elizabeth Peinado,Imported from Bank of America Visa-Math Assessment subscription,,HJ,,21.98,-17041.38
2032,1/21/2021,1/21/2021,Joseph Zarate,Imported from Bank of America Visa-equipment,,HJ,,164.28,-17205.66
2032,1/21/2021,1/21/2021,Myesha Hossain,Imported from Bank of America Visa-HSFI Team Time,,HJ,,27.75,-17233.41
2032,1/21/2021,1/21/2021,Thomas Fischaber,Imported from Bank of America Visa-condolences,,HJ,,83.84,-17317.25
2032,1/21/2021,1/21/2021,Thomas Fischaber,Imported from Bank of America Visa-webcam,,HJ,,25.63,-17342.88
2032,1/22/2021,1/22/2021,Antonio Gutierrez,Imported from Bank of America Visa-Product Marketing Domain Purchases,,HJ,,119.99,-17462.87
2032,1/22/2021,1/22/2021,Elizabeth Peinado,Imported from Bank of America Visa-Math assessment subscription is international,,HJ,,0.09,-17462.96
2032,1/22/2021,1/22/2021,Elizabeth Peinado,Imported from Bank of America Visa-Math assessment subscription is international,,HJ,,0.14,-17463.1
2032,1/22/2021,1/22/2021,Elizabeth Peinado,Imported from Bank of America Visa-Math assessment subscription is international,,HJ,,0.14,-17463.24
2032,1/22/2021,1/22/2021,Elizabeth Peinado,Imported from Bank of America Visa-Math assessment subscription is international,,HJ,,0.43,-17463.67
2032,1/22/2021,1/22/2021,Halley Bowman,Imported from Bank of America Visa-notebook for Halley to take notes,,HJ,,1.51,-17465.18
2032,1/22/2021,1/22/2021,Halley Bowman,Imported from Bank of America Visa-notebook for Halley to take notes,,HJ,,2.34,-17467.52
2032,1/22/2021,1/22/2021,Halley Bowman,Imported from Bank of America Visa-notebook for Halley to take notes,,HJ,,2.34,-17469.86
2032,1/22/2021,1/22/2021,Halley Bowman,Imported from Bank of America Visa-notebook for Halley to take notes,,HJ,,7.58,-17477.44
2032,1/22/2021,1/22/2021,Maryellen Leneghan,Imported from Bank of America Visa-Staff.Fellow Appreciation,,HJ,,8.76,-17486.2
2032,1/23/2021,1/23/2021,Joseph Zarate,Imported from Bank of America Visa-equipment,,HJ,,1183.63,-18669.83
2032,1/23/2021,1/23/2021,Maryellen Leneghan,Imported from Bank of America Visa-Staff.Fellow Appreciation,,HJ,,8.68,-18678.51
2032,1/23/2021,1/23/2021,Maryellen Leneghan,Imported from Bank of America Visa-Staff.Fellow Appreciation,,HJ,,8.68,-18687.19
2032,1/23/2021,1/23/2021,Maryellen Leneghan,Imported from Bank of America Visa-Staff.Fellow Appreciation,,HJ,,8.68,-18695.87
2032,1/23/2021,1/23/2021,Maryellen Leneghan,Imported from Bank of America Visa-Staff.Fellow Appreciation,,HJ,,8.68,-18704.55
2032,1/24/2021,1/24/2021,Halley Bowman,Imported from Bank of America Visa-pens,,HJ,,1.91,-18706.46
2032,1/24/2021,1/24/2021,Halley Bowman,Imported from Bank of America Visa-pens,,HJ,,2.95,-18709.41
2032,1/24/2021,1/24/2021,Halley Bowman,Imported from Bank of America Visa-pens,,HJ,,2.95,-18712.36
2032,1/24/2021,1/24/2021,Halley Bowman,Imported from Bank of America Visa-pens,,HJ,,9.53,-18721.89
2032,1/24/2021,1/24/2021,Maryellen Leneghan,Imported from Bank of America Visa-Staff.Fellow Appreciation,,HJ,,8.68,-18730.57
2032,1/24/2021,1/24/2021,Maryellen Leneghan,Imported from Bank of America Visa-Staff.Fellow Appreciation,,HJ,,8.68,-18739.25
2032,1/24/2021,1/24/2021,Maryellen Leneghan,Imported from Bank of America Visa-Staff.Fellow Appreciation,,HJ,,8.68,-18747.93
2032,1/24/2021,1/24/2021,Maryellen Leneghan,Imported from Bank of America Visa-Staff.Fellow Appreciation,,HJ,,21.95,-18769.88
2032,1/24/2021,1/24/2021,Maryellen Leneghan,Imported from Bank of America Visa-Staff.Fellow Appreciation,,HJ,,21.95,-18791.83
2032,1/24/2021,1/24/2021,Maryellen Leneghan,Imported from Bank of America Visa-Staff.Fellow Appreciation,,HJ,,21.95,-18813.78
2032,1/24/2021,1/24/2021,Maryellen Leneghan,Imported from Bank of America Visa-Staff.Fellow Appreciation,,HJ,,21.95,-18835.73
2032,1/24/2021,1/24/2021,Myesha Hossain,Imported from Bank of America Visa-Storage,,HJ,,159.3,-18995.03
2032,1/25/2021,1/25/2021,Antonio Gutierrez,Imported from Bank of America Visa-Fellow Recruitment,,HJ,,900,-19895.03
2032,1/25/2021,1/25/2021,Joseph Zarate,Imported from Bank of America Visa-Adobe license fees,,HJ,,3925.21,-23820.24
2032,1/25/2021,1/25/2021,Kyra Detone,Imported from Bank of America Visa-Webinar Registration Fee.Win Grants for Racial Equity,,HJ,,69,-23889.24
2032,1/25/2021,1/25/2021,Kyra Detone,Imported from Bank of America Visa-Webinar Registration Fee.Win Grants for Racial Equity,,HJ,,69,-23958.24
2032,1/25/2021,1/25/2021,Maryellen Leneghan,Imported from Bank of America Visa-Staff.Fellow Appreciation,,HJ,,8.19,-23966.43
2032,1/25/2021,1/25/2021,Maryellen Leneghan,Imported from Bank of America Visa-Staff.Fellow Appreciation,,HJ,,8.68,-23975.11
2032,1/25/2021,1/25/2021,Maryellen Leneghan,Imported from Bank of America Visa-Staff.Fellow Appreciation,,HJ,,8.68,-23983.79
2032,1/25/2021,1/25/2021,Maryellen Leneghan,Imported from Bank of America Visa-Staff.Fellow Appreciation,,HJ,,8.68,-23992.47
2032,1/25/2021,1/25/2021,Myesha Hossain,Imported from Bank of America Visa-Birthday Card,,HJ,,4.99,-23997.46
2032,1/25/2021,1/25/2021,Myesha Hossain,Imported from Bank of America Visa-Fellow Bday,,HJ,,8.47,-24005.93
2032,1/25/2021,1/25/2021,Myesha Hossain,Imported from Bank of America Visa-HPHS Fellow Bday,,HJ,,4.99,-24010.92
2032,1/25/2021,1/25/2021,Thomas Fischaber,Imported from Bank of America Visa-developer machine,,HJ,,920.36,-24931.28
2032,1/25/2021,1/25/2021,Thomas Fischaber,Imported from Bank of America Visa-development computer,,HJ,,1688.23,-26619.51
2032,1/26/2021,1/26/2021,Halley Bowman,Imported from Bank of America Visa-appreciation gift for Julie Dziedzic,,HJ,,7.99,-26627.5
2032,1/26/2021,1/26/2021,Joseph Zarate,Imported from Bank of America Visa-Twilio,,HJ,,100,-26727.5
2032,1/26/2021,1/26/2021,Joseph Zarate,Imported from Bank of America Visa-equipment,,HJ,,17.29,-26744.79
2032,1/26/2021,1/26/2021,Maryellen Leneghan,Imported from Bank of America Visa-Staff.Fellow Appreciation,,HJ,,8.68,-26753.47
2032,1/26/2021,1/26/2021,Maryellen Leneghan,Imported from Bank of America Visa-Staff.Fellow Appreciation,,HJ,,8.68,-26762.15
2032,1/26/2021,1/26/2021,Maryellen Leneghan,Imported from Bank of America Visa-Staff.Fellow Appreciation,,HJ,,8.74,-26770.89
2032,1/26/2021,1/26/2021,Maryellen Leneghan,Imported from Bank of America Visa-Staff.Fellow Appreciation,,HJ,,8.85,-26779.74
2032,1/26/2021,1/26/2021,Monivett Acevedo,Imported from Bank of America Visa-Post It White Board,,HJ,,35.79,-26815.53
2032,1/26/2021,1/26/2021,Myesha Hossain,Imported from Bank of America Visa-HPHS Fellow Bday,,HJ,,20.06,-26835.59
2032,1/26/2021,1/26/2021,Myesha Hossain,Imported from Bank of America Visa-charge to IT,,HJ,,13.02,-26848.61
2032,1/26/2021,1/26/2021,Thomas Fischaber,Imported from Bank of America Visa-av hosting,,HJ,,400,-27248.61
2032,1/26/2021,1/26/2021,Thomas Fischaber,Imported from Bank of America Visa-av hosting,,HJ,,990.56,-28239.17
2032,1/26/2021,1/26/2021,Thomas Fischaber,Imported from Bank of America Visa-monitor,,HJ,,251.95,-28491.12
2032,1/27/2021,1/27/2021,Alan Safran,Imported from Bank of America Visa-Background Check Field Print for Bao Khanh Cu,,HJ,,28.75,-28519.87
2032,1/27/2021,1/27/2021,Alan Safran,Imported from Bank of America Visa-Background Check Field Print for Ethan Purcell,,HJ,,28.75,-28548.62
2032,1/27/2021,1/27/2021,Alan Safran,Imported from Bank of America Visa-Background Check Field Print for Rangai Elena,,HJ,,28.75,-28577.37
2032,1/27/2021,1/27/2021,Antonio Gutierrez,Imported from Bank of America Visa-Fellow Recruitment,,HJ,,392.53,-28969.9
2032,1/27/2021,1/27/2021,Halley Bowman,Imported from Bank of America Visa-PD book for Ashlee,,HJ,,40.67,-29010.57
2032,1/27/2021,1/27/2021,Halley Bowman,Imported from Bank of America Visa-PD books for Anna Hernandez,,HJ,,133.1,-29143.67
2032,1/27/2021,1/27/2021,Joseph Zarate,Imported from Bank of America Visa-Equipment,,HJ,,1183.63,-30327.3
2032,1/27/2021,1/27/2021,Joseph Zarate,Imported from Bank of America Visa-equipment,,HJ,,609.93,-30937.23
2032,1/27/2021,1/27/2021,Maryellen Leneghan,Imported from Bank of America Visa-Staff.Fellow Appreciation,,HJ,,21.04,-30958.27
2032,1/27/2021,1/27/2021,Myesha Hossain,Imported from Bank of America Visa-Cleveland Team Time,,HJ,,14.99,-30973.26
2032,1/27/2021,1/27/2021,Myesha Hossain,Imported from Bank of America Visa-Cleveland Team Time,,HJ,,14.99,-30988.25
2032,1/27/2021,1/27/2021,Thomas Fischaber,Imported from Bank of America Visa-av hosting,,HJ,,1000,-31988.25
2032,1/27/2021,1/27/2021,Uriel Guadarrama,Imported from Bank of America Visa-Monthly Zoom licenses,,HJ,,15.93,-32004.18
2032,1/27/2021,1/27/2021,Uriel Guadarrama,Imported from Bank of America Visa-Monthly Zoom licenses,,HJ,,15.93,-32020.11
2032,1/27/2021,1/27/2021,Uriel Guadarrama,Imported from Bank of America Visa-Monthly Zoom licenses,,HJ,,31.85,-32051.96
2032,1/28/2021,1/28/2021,Alan Safran,Imported from Bank of America Visa-Background Check for Elena Rangai,,HJ,,36.5,-32088.46
2032,1/28/2021,1/28/2021,Mahaliah Sejour,Imported from Bank of America Visa-google drive storage,,HJ,,1.99,-32090.45
2032,1/28/2021,1/28/2021,Maryellen Leneghan,Imported from Bank of America Visa-Staff.Fellow Appreciation,,HJ,,17.89,-32108.34
2032,1/28/2021,1/28/2021,Maryellen Leneghan,Imported from Bank of America Visa-Staff.Fellow Appreciation,,HJ,,21.11,-32129.45
2032,1/28/2021,1/28/2021,Maryellen Leneghan,Imported from Bank of America Visa-Staff.Fellow Appreciation,,HJ,,24.99,-32154.44
2032,1/28/2021,1/28/2021,Monivett Acevedo,Imported from Bank of America Visa-1099 filings,,HJ,,7.45,-32161.89
2032,1/28/2021,1/28/2021,Monivett Acevedo,Imported from Bank of America Visa-Spartan Race for Finance Team,,HJ,,41.89,-32203.78
2032,1/28/2021,1/28/2021,Monivett Acevedo,Imported from Bank of America Visa-Spartan Race for Finance Team,,HJ,,142.21,-32345.99
2032,1/28/2021,1/28/2021,Monivett Acevedo,Imported from Bank of America Visa-Spartan Race for Finance Team,,HJ,,143.3,-32489.29
2032,1/28/2021,1/28/2021,Monivett Acevedo,Imported from Bank of America Visa-Spartan Race for Finance Team,,HJ,,143.3,-32632.59
2032,1/28/2021,1/28/2021,Myesha Hossain,Imported from Bank of America Visa-Cleveland Team Time,,HJ,,14.99,-32647.58
2032,1/28/2021,1/28/2021,Myesha Hossain,Imported from Bank of America Visa-Cleveland Team Time,,HJ,,15.89,-32663.47
2032,1/28/2021,1/28/2021,Myesha Hossain,Imported from Bank of America Visa-Fellow Birthday,,HJ,,26.75,-32690.22
2032,1/29/2021,1/29/2021,Alan Safran,Imported from Bank of America Visa-Background Check Field Print for Victoria Warren,,HJ,,28.75,-32718.97
2032,1/29/2021,1/29/2021,Elizabeth Peinado,Imported from Bank of America Visa-Recruiter Subscription for Talent Team,,HJ,,409.4,-33128.37
2032,1/29/2021,1/29/2021,Elizabeth Peinado,Imported from Bank of America Visa-Recruiter Subscription for Talent Team,,HJ,,632.72,-33761.09
2032,1/29/2021,1/29/2021,Elizabeth Peinado,Imported from Bank of America Visa-Recruiter Subscription for Talent Team,,HJ,,632.72,-34393.81
2032,1/29/2021,1/29/2021,Elizabeth Peinado,Imported from Bank of America Visa-Recruiter Subscription for Talent Team,,HJ,,2047.02,-36440.83
2032,1/29/2021,1/29/2021,Nicole Prahin,Imported from Bank of America Visa-Options School Student Gift for New Baby,,HJ,,23.32,-36464.15
2032,2/1/2021,2/1/2021,Alan Safran,Imported from Bank of America Visa-Background Check for Bao Khanh Cu,,HJ,,36.5,-36500.65
2032,2/1/2021,2/1/2021,Alan Safran,Imported from Bank of America Visa-Bank Service Fees and Charges,,HJ,,15,-36515.65
2032,2/1/2021,2/1/2021,Antonio Gutierrez,Imported from Bank of America Visa-Expense Reporting,,HJ,,780.92,-37296.57
2032,2/1/2021,2/1/2021,Antonio Gutierrez,Imported from Bank of America Visa-Fellow Recruitment,,HJ,,900,-38196.57
2032,2/1/2021,2/1/2021,Antonio Gutierrez,Imported from Bank of America Visa-Website fee,,HJ,,229.5,-38426.07
2032,2/1/2021,2/1/2021,Elizabeth Peinado,Imported from Bank of America Visa-Fellow posting for Chicagi,,HJ,,5000,-43426.07
2032,2/1/2021,2/1/2021,iaklestad,Imported from Bank of America Visa-Welcome Package Mailing,,HJ,,31,-43457.07
2032,2/1/2021,2/1/2021,Joseph Zarate,Imported from Bank of America Visa-Returns,,HJ,,21.9,-43478.97
2032,2/1/2021,2/1/2021,Joseph Zarate,Imported from Bank of America Visa-Returns,,HJ,,21.9,-43500.87
2032,2/1/2021,2/1/2021,Joseph Zarate,Imported from Bank of America Visa-shipping,,HJ,,4.4,-43505.27
2032,2/1/2021,2/1/2021,Monivett Acevedo,Imported from Bank of America Visa-Computer HDMI connector,,HJ,,16.99,-43522.26
2032,2/1/2021,2/1/2021,Monivett Acevedo,Imported from Bank of America Visa-Holiday Dinner for Finance Staff,,HJ,,195,-43717.26
2032,2/1/2021,2/1/2021,Monivett Acevedo,Imported from Bank of America Visa-Office Supplies,,HJ,,3.18,-43720.44
2032,2/1/2021,2/1/2021,Monivett Acevedo,Imported from Bank of America Visa-Storage,,HJ,,19.99,-43740.43
2032,2/1/2021,2/1/2021,Thomas Fischaber,Imported from Bank of America Visa-docker,,HJ,,468,-44208.43
2032,2/1/2021,2/1/2021,Thomas Fischaber,Imported from Bank of America Visa-server hardware,,HJ,,238,-44446.43
2032,2/1/2021,2/1/2021,Thomas Fischaber,Imported from Bank of America Visa-servers,,HJ,,82.21,-44528.64
2032,2/2/2021,2/2/2021,Alan Safran,Imported from Bank of America Visa-Background Check for Ethan Purcell,,HJ,,36.5,-44565.14
2032,2/2/2021,2/2/2021,Bank of America VISA,BofA Concur Payment-BofA CC January's transaction Payment,,HJ,726.39,,-43838.75
2032,2/2/2021,2/2/2021,Bank of America VISA,BofA Concur Payment-BofA CC January's transaction Payment,,HJ,1015.08,,-42823.67
2032,2/2/2021,2/2/2021,Bank of America VISA,BofA Concur Payment-BofA CC January's transaction Payment,,HJ,1520.01,,-41303.66
2032,2/2/2021,2/2/2021,Bank of America VISA,BofA Concur Payment-BofA CC January's transaction Payment,,HJ,4793.35,,-36510.31
2032,2/2/2021,2/2/2021,Bank of America VISA,BofA Concur Payment-BofA CC January's transaction Payment,,HJ,6454.48,,-30055.83
2032,2/2/2021,2/2/2021,Bank of America VISA,BofA Concur Payment-BofA CC January's transaction Payment,,HJ,10640.01,,-19415.82
2032,2/2/2021,2/2/2021,Bank of America VISA,BofA Concur Payment-BofA CC January's transaction Payment,,HJ,11314.83,,-8100.99
2032,2/2/2021,2/2/2021,Elizabeth Peinado,Imported from Bank of America Visa-Podcast learning tool . This American Life,,HJ,,0.22,-8101.21
2032,2/2/2021,2/2/2021,Elizabeth Peinado,Imported from Bank of America Visa-Podcast learning tool . This American Life,,HJ,,0.34,-8101.55
2032,2/2/2021,2/2/2021,Elizabeth Peinado,Imported from Bank of America Visa-Podcast learning tool . This American Life,,HJ,,0.34,-8101.89
2032,2/2/2021,2/2/2021,Elizabeth Peinado,Imported from Bank of America Visa-Podcast learning tool . This American Life,,HJ,,1.1,-8102.99
2032,2/2/2021,2/2/2021,Joseph Zarate,Imported from Bank of America Visa-Equipment,,HJ,,37.49,-8140.48
2032,2/2/2021,2/2/2021,Joseph Zarate,Imported from Bank of America Visa-equipment shipment,,HJ,,16.96,-8157.44
2032,2/2/2021,2/2/2021,Mahaliah Sejour,Imported from Bank of America Visa-programs storage,,HJ,,149,-8306.44
2032,2/2/2021,2/2/2021,Mahaliah Sejour,Imported from Bank of America Visa-recruitment storage,,HJ,,173,-8479.44
2032,2/2/2021,2/2/2021,Myesha Hossain,Imported from Bank of America Visa-Fellow PD,,HJ,,13.99,-8493.43
2032,2/2/2021,2/2/2021,Nicole Prahin,Imported from Bank of America Visa-Professional Development,,HJ,,12.5,-8505.93
2032,2/2/2021,2/2/2021,Thomas Fischaber,Imported from Bank of America Visa-woot math email,,HJ,,84,-8589.93
2032,2/2/2021,2/2/2021,Tiffani Bibb,Imported from Bank of America Visa-Labor And Insurance Fees for Washington-,,HJ,,70.48,-8660.41
2032,2/2/2021,2/2/2021,Tiffani Bibb,Imported from Bank of America Visa-Labor And Insurance Fees for Washington-,,HJ,,112.68,-8773.09
2032,2/2/2021,2/2/2021,Tiffani Bibb,Imported from Bank of America Visa-Labor And Insurance Fees for Washington-processing fee,,HJ,,3.95,-8777.04
2032,2/2/2021,2/2/2021,Tiffani Bibb,Imported from Bank of America Visa-Labor and Insurance Fees for WA,,HJ,,3.95,-8780.99
2032,2/3/2021,2/3/2021,Antonio Gutierrez,Imported from Bank of America Visa-google drive storage,,HJ,,1.99,-8782.98
2032,2/3/2021,2/3/2021,Joseph Zarate,Imported from Bank of America Visa-Equipment,,HJ,,133.98,-8916.96
2032,2/3/2021,2/3/2021,Joseph Zarate,Imported from Bank of America Visa-Equipment,,HJ,,267.96,-9184.92
2032,2/3/2021,2/3/2021,Joseph Zarate,Imported from Bank of America Visa-replacement equipment,,HJ,,28.99,-9213.91
2032,2/3/2021,2/3/2021,Maryellen Leneghan,Imported from Bank of America Visa-Competencies Book,,HJ,,79.19,-9293.1
2032,2/3/2021,2/3/2021,Myesha Hossain,Imported from Bank of America Visa-Fellow PD,,HJ,,8.9,-9302
2032,2/3/2021,2/3/2021,Myesha Hossain,Imported from Bank of America Visa-Fellow PD,,HJ,,13.71,-9315.71
2032,2/3/2021,2/3/2021,Myesha Hossain,Imported from Bank of America Visa-Fellow PD,,HJ,,15.99,-9331.7
2032,2/3/2021,2/3/2021,Thomas Fischaber,Imported from Bank of America Visa-aws hosting,,HJ,,2105.76,-11437.46
2032,2/3/2021,2/3/2021,Thomas Fischaber,Imported from Bank of America Visa-code repository,,HJ,,94,-11531.46
2032,2/3/2021,2/3/2021,Thomas Fischaber,Imported from Bank of America Visa-email marketing,,HJ,,35.15,-11566.61
2032,2/4/2021,2/4/2021,Alan Safran,Imported from Bank of America Visa-Background Check for Victoria Warren,,HJ,,36.5,-11603.11
2032,2/4/2021,2/4/2021,Alan Safran,Imported from Bank of America Visa-Google Storage for Alan Monthly Subscription,,HJ,,1.99,-11605.1
2032,2/4/2021,2/4/2021,Antonio Gutierrez,Imported from Bank of America Visa-Fellow Recruitment,,HJ,,900,-12505.1
2032,2/4/2021,2/4/2021,Halley Bowman,Imported from Bank of America Visa-Computer Stand for Mika Iwasaki,,HJ,,2.32,-12507.42
2032,2/4/2021,2/4/2021,Halley Bowman,Imported from Bank of America Visa-Computer Stand for Mika Iwasaki,,HJ,,3.59,-12511.01
2032,2/4/2021,2/4/2021,Halley Bowman,Imported from Bank of America Visa-Computer Stand for Mika Iwasaki,,HJ,,3.59,-12514.6
2032,2/4/2021,2/4/2021,Halley Bowman,Imported from Bank of America Visa-Computer Stand for Mika Iwasaki,,HJ,,11.63,-12526.23
2032,2/4/2021,2/4/2021,Joseph Zarate,Imported from Bank of America Visa-Equipment,,HJ,,25.9,-12552.13
2032,2/4/2021,2/4/2021,Mahaliah Sejour,Imported from Bank of America Visa-YCSS,,HJ,,5.9,-12558.03
2032,2/4/2021,2/4/2021,Myesha Hossain,Imported from Bank of America Visa-HSFI Team Time,,HJ,,16.96,-12574.99
2032,2/4/2021,2/4/2021,Myesha Hossain,Imported from Bank of America Visa-PD Raffle,,HJ,,5.99,-12580.98
2032,2/4/2021,2/4/2021,Nicole Prahin,Imported from Bank of America Visa-Professional Development,,HJ,,59,-12639.98
2032,2/4/2021,2/4/2021,Uriel Guadarrama,Imported from Bank of America Visa-Monthly Zoom license for kdetone,,HJ,,11.82,-12651.8
2032,2/5/2021,2/5/2021,Joseph Zarate,Imported from Bank of America Visa-Returns,,HJ,,31,-12682.8
2032,2/5/2021,2/5/2021,Joseph Zarate,Imported from Bank of America Visa-Returns,,HJ,,31,-12713.8
2032,2/5/2021,2/5/2021,Maryellen Leneghan,Imported from Bank of America Visa-Staff.Fellow Appreciation,,HJ,,9.9,-12723.7
2032,2/5/2021,2/5/2021,Maryellen Leneghan,Imported from Bank of America Visa-Staff.Fellow Appreciation,,HJ,,10.59,-12734.29
2032,2/5/2021,2/5/2021,Maryellen Leneghan,Imported from Bank of America Visa-Staff.Fellow Appreciation,,HJ,,11.95,-12746.24
2032,2/5/2021,2/5/2021,Miranda Cortez,Imported from Bank of America Visa-Mailing recruitment materials,,HJ,,12.67,-12758.91
2032,2/5/2021,2/5/2021,Miranda Cortez,Imported from Bank of America Visa-Mailing recruitment materials,,HJ,,12.67,-12771.58
2032,2/5/2021,2/5/2021,Miranda Cortez,Imported from Bank of America Visa-Mailing recruitment materials,,HJ,,12.68,-12784.26
2032,2/5/2021,2/5/2021,Miranda Cortez,Imported from Bank of America Visa-Mailing recruitment materials,,HJ,,12.68,-12796.94
2032,2/5/2021,2/5/2021,Myesha Hossain,Imported from Bank of America Visa-hphs team time,,HJ,,16.31,-12813.25
2032,2/5/2021,2/5/2021,Myesha Hossain,Imported from Bank of America Visa-hphs team time,,HJ,,16.62,-12829.87
2032,2/5/2021,2/5/2021,Myesha Hossain,Imported from Bank of America Visa-hphs team time,,HJ,,16.66,-12846.53
2032,2/5/2021,2/5/2021,Myesha Hossain,Imported from Bank of America Visa-hphs team time,,HJ,,16.66,-12863.19
2032,2/5/2021,2/5/2021,Myesha Hossain,Imported from Bank of America Visa-hphs team time,,HJ,,16.66,-12879.85
2032,2/5/2021,2/5/2021,Myesha Hossain,Imported from Bank of America Visa-hphs team time,,HJ,,16.66,-12896.51
2032,2/5/2021,2/5/2021,Myesha Hossain,Imported from Bank of America Visa-hphs team time,,HJ,,16.66,-12913.17
2032,2/5/2021,2/5/2021,Tiffani Bibb,Imported from Bank of America Visa-Wellness Contest,,HJ,,101.39,-13014.56
2032,2/6/2021,2/6/2021,Joseph Zarate,Imported from Bank of America Visa-Equipment,,HJ,,1271.54,-14286.1
2032,2/6/2021,2/6/2021,Joseph Zarate,Imported from Bank of America Visa-Equipment,,HJ,,2581.62,-16867.72
2032,2/6/2021,2/6/2021,Joseph Zarate,Imported from Bank of America Visa-Returns,,HJ,,23.45,-16891.17
2032,2/6/2021,2/6/2021,Joseph Zarate,Imported from Bank of America Visa-Returns,,HJ,,77.5,-16968.67
2032,2/6/2021,2/6/2021,Monivett Acevedo,Imported from Bank of America Visa-Laptop Sleeve,,HJ,,16.14,-16984.81
2032,2/7/2021,2/7/2021,Alan Safran,Imported from Bank of America Visa-fedex HR expenses,,HJ,,28.2,-17013.01
2032,2/7/2021,2/7/2021,Maryellen Leneghan,Imported from Bank of America Visa-Supply for ML home office,,HJ,,59.11,-17072.12
2032,2/8/2021,2/8/2021,Alan Safran,Imported from Bank of America Visa-Background Check for Baljit Saini,,HJ,,50.5,-17122.62
2032,2/8/2021,2/8/2021,Alan Safran,Imported from Bank of America Visa-Background Check for Fernanda Calvo,,HJ,,122.5,-17245.12
2032,2/8/2021,2/8/2021,Antonio Gutierrez,Imported from Bank of America Visa-external hard drive,,HJ,,109.99,-17355.11
2032,2/8/2021,2/8/2021,Joseph Zarate,Imported from Bank of America Visa-Equipment,,HJ,,34.14,-17389.25
2032,2/8/2021,2/8/2021,Joseph Zarate,Imported from Bank of America Visa-Equipment,,HJ,,179.21,-17568.46
2032,2/8/2021,2/8/2021,Joseph Zarate,Imported from Bank of America Visa-Returns,,HJ,,15.5,-17583.96
2032,2/8/2021,2/8/2021,Mahaliah Sejour,Imported from Bank of America Visa-Fellows gifts,,HJ,,21.82,-17605.78
2032,2/8/2021,2/8/2021,Mahaliah Sejour,Imported from Bank of America Visa-Fellows gifts,,HJ,,22.82,-17628.6
2032,2/8/2021,2/8/2021,Mahaliah Sejour,Imported from Bank of America Visa-Fellows gifts,,HJ,,22.82,-17651.42
2032,2/8/2021,2/8/2021,Mahaliah Sejour,Imported from Bank of America Visa-Fellows gifts,,HJ,,22.82,-17674.24
2032,2/8/2021,2/8/2021,Mahaliah Sejour,Imported from Bank of America Visa-Fellows gifts,,HJ,,22.82,-17697.06
2032,2/8/2021,2/8/2021,Mahaliah Sejour,Imported from Bank of America Visa-Fellows gifts,,HJ,,22.82,-17719.88
2032,2/8/2021,2/8/2021,Mahaliah Sejour,Imported from Bank of America Visa-Fellows gifts,,HJ,,22.88,-17742.76
2032,2/8/2021,2/8/2021,Mahaliah Sejour,Imported from Bank of America Visa-Fellows gifts,,HJ,,24.97,-17767.73
2032,2/8/2021,2/8/2021,Maryellen Leneghan,Imported from Bank of America Visa-Staff.Fellow Appreciation,,HJ,,7.55,-17775.28
2032,2/8/2021,2/8/2021,Monivett Acevedo,Imported from Bank of America Visa-AP module,,HJ,,178.18,-17953.46
2032,2/8/2021,2/8/2021,Monivett Acevedo,Imported from Bank of America Visa-Adobe for CFO,,HJ,,14.99,-17968.45
2032,2/8/2021,2/8/2021,Monivett Acevedo,Imported from Bank of America Visa-Office Supplies,,HJ,,3.18,-17971.63
2032,2/8/2021,2/8/2021,Thomas Fischaber,Imported from Bank of America Visa-woot math phone system,,HJ,,59,-18030.63
2032,2/9/2021,2/9/2021,Antonio Gutierrez,Imported from Bank of America Visa-Fellow Recruitment,,HJ,,900,-18930.63
2032,2/9/2021,2/9/2021,Antonio Gutierrez,Imported from Bank of America Visa-Laptops for tutors,,HJ,,10975.6,-29906.23
2032,2/9/2021,2/9/2021,Antonio Gutierrez,Imported from Bank of America Visa-Laptops for tutors,,HJ,,16962.28,-46868.51
2032,2/9/2021,2/9/2021,Antonio Gutierrez,Imported from Bank of America Visa-Laptops for tutors,,HJ,,16962.28,-63830.79
2032,2/9/2021,2/9/2021,Antonio Gutierrez,Imported from Bank of America Visa-Laptops for tutors,,HJ,,54877.98,-118708.77
2032,2/9/2021,2/9/2021,Antonio Gutierrez,Imported from Bank of America Visa-web Domains,,HJ,,125.36,-118834.13
2032,2/9/2021,2/9/2021,Halley Bowman,Imported from Bank of America Visa-PD book for Emily,,HJ,,15.89,-118850.02
2032,2/9/2021,2/9/2021,Halley Bowman,Imported from Bank of America Visa-PD book for Halley,,HJ,,5.8,-118855.82
2032,2/9/2021,2/9/2021,Halley Bowman,Imported from Bank of America Visa-PD book for Halley,,HJ,,8.96,-118864.78
2032,2/9/2021,2/9/2021,Halley Bowman,Imported from Bank of America Visa-PD book for Halley,,HJ,,8.96,-118873.74
2032,2/9/2021,2/9/2021,Halley Bowman,Imported from Bank of America Visa-PD book for Halley,,HJ,,29.01,-118902.75
2032,2/9/2021,2/9/2021,Joseph Zarate,Imported from Bank of America Visa-equipment,,HJ,,1339.99,-120242.74
2032,2/9/2021,2/9/2021,Joseph Zarate,Imported from Bank of America Visa-equipment shipment,,HJ,,42.36,-120285.1
2032,2/9/2021,2/9/2021,Maryellen Leneghan,Imported from Bank of America Visa-Site supplies,,HJ,,46.98,-120332.08
2032,2/9/2021,2/9/2021,Maryellen Leneghan,Imported from Bank of America Visa-Site supplies,,HJ,,51.97,-120384.05
2032,2/9/2021,2/9/2021,Maryellen Leneghan,Imported from Bank of America Visa-Staff.Fellow Appreciation,,HJ,,5.99,-120390.04
2032,2/9/2021,2/9/2021,Monivett Acevedo,Imported from Bank of America Visa-CFA and Birthday Gift for Staff Accountant,,HJ,,98.98,-120489.02
2032,2/9/2021,2/9/2021,Myesha Hossain,Imported from Bank of America Visa-Vision board raffle,,HJ,,17.99,-120507.01
2032,2/9/2021,2/9/2021,Thomas Fischaber,Imported from Bank of America Visa-marketing photos,,HJ,,29.87,-120536.88
2032,2/10/2021,2/10/2021,Joseph Zarate,Imported from Bank of America Visa-Equipment,,HJ,,26.83,-120563.71
2032,2/10/2021,2/10/2021,Joseph Zarate,Imported from Bank of America Visa-Equipment,,HJ,,445.96,-121009.67
2032,2/10/2021,2/10/2021,Joseph Zarate,Imported from Bank of America Visa-Returns,,HJ,,20.19,-121029.86
2032,2/10/2021,2/10/2021,Joseph Zarate,Imported from Bank of America Visa-TESTING,,HJ,,69.88,-121099.74
2032,2/10/2021,2/10/2021,Mahaliah Sejour,Imported from Bank of America Visa-fellow social,,HJ,,34.99,-121134.73
2032,2/10/2021,2/10/2021,Mahaliah Sejour,Imported from Bank of America Visa-video editing,,HJ,,21.24,-121155.97
2032,2/11/2021,2/11/2021,Antonio Gutierrez,Imported from Bank of America Visa-subscription,,HJ,,19.11,-121175.08
2032,2/11/2021,2/11/2021,Elizabeth Peinado,Imported from Bank of America Visa-Work-anniversary token of appreciate,,HJ,,2.75,-121177.83
2032,2/11/2021,2/11/2021,Elizabeth Peinado,Imported from Bank of America Visa-Work-anniversary token of appreciate,,HJ,,4.25,-121182.08
2032,2/11/2021,2/11/2021,Elizabeth Peinado,Imported from Bank of America Visa-Work-anniversary token of appreciate,,HJ,,4.25,-121186.33
2032,2/11/2021,2/11/2021,Elizabeth Peinado,Imported from Bank of America Visa-Work-anniversary token of appreciate,,HJ,,13.75,-121200.08
2032,2/11/2021,2/11/2021,Joseph Zarate,Imported from Bank of America Visa-Equipment,,HJ,,9.33,-121209.41
2032,2/11/2021,2/11/2021,Joseph Zarate,Imported from Bank of America Visa-Returns,,HJ,,14.1,-121223.51
2032,2/11/2021,2/11/2021,Joseph Zarate,Imported from Bank of America Visa-Returns,,HJ,,206.53,-121430.04
2032,2/11/2021,2/11/2021,Mahaliah Sejour,Imported from Bank of America Visa-Fellows gifts,,HJ,,9.99,-121440.03
2032,2/11/2021,2/11/2021,Mahaliah Sejour,Imported from Bank of America Visa-red herring purchase for fellow social,,HJ,,0.7,-121440.73
2032,2/11/2021,2/11/2021,Myesha Hossain,Imported from Bank of America Visa-Cleveland ASD appreciation,,HJ,,15.43,-121456.16
2032,2/11/2021,2/11/2021,Myesha Hossain,Imported from Bank of America Visa-Cleveland Fellow Appreciation,,HJ,,9.12,-121465.28
2032,2/11/2021,2/11/2021,Myesha Hossain,Imported from Bank of America Visa-Cleveland Fellow Appreciation,,HJ,,9.12,-121474.4
2032,2/11/2021,2/11/2021,Myesha Hossain,Imported from Bank of America Visa-Cleveland Fellow Appreciation,,HJ,,11.49,-121485.89
2032,2/11/2021,2/11/2021,Myesha Hossain,Imported from Bank of America Visa-HPHS Appreciation,,HJ,,60,-121545.89
2032,2/11/2021,2/11/2021,Thomas Fischaber,Imported from Bank of America Visa-gift card thank you,,HJ,,100,-121645.89
2032,2/12/2021,2/12/2021,Antonio Gutierrez,Imported from Bank of America Visa-Online Phone and Fax,,HJ,,235.79,-121881.68
2032,2/12/2021,2/12/2021,Antonio Gutierrez,Imported from Bank of America Visa-marketing high definition web camera,,HJ,,219.44,-122101.12
2032,2/12/2021,2/12/2021,Elizabeth Peinado,Imported from Bank of America Visa-Mail anniversary gift to Miranda,,HJ,,0.47,-122101.59
2032,2/12/2021,2/12/2021,Elizabeth Peinado,Imported from Bank of America Visa-Mail anniversary gift to Miranda,,HJ,,0.73,-122102.32
2032,2/12/2021,2/12/2021,Elizabeth Peinado,Imported from Bank of America Visa-Mail anniversary gift to Miranda,,HJ,,0.73,-122103.05
2032,2/12/2021,2/12/2021,Elizabeth Peinado,Imported from Bank of America Visa-Mail anniversary gift to Miranda,,HJ,,2.37,-122105.42
2032,2/12/2021,2/12/2021,Mahaliah Sejour,Imported from Bank of America Visa-Fellows gifts,,HJ,,9.99,-122115.41
2032,2/12/2021,2/12/2021,Mahaliah Sejour,Imported from Bank of America Visa-Fellows gifts,,HJ,,29.98,-122145.39
2032,2/12/2021,2/12/2021,Myesha Hossain,Imported from Bank of America Visa-Cleveland Fellow Appreciation,,HJ,,9.12,-122154.51
2032,2/12/2021,2/12/2021,Myesha Hossain,Imported from Bank of America Visa-Cleveland SD appreciation,,HJ,,34.41,-122188.92
2032,2/12/2021,2/12/2021,Nicole Prahin,Imported from Bank of America Visa-Office Supplies,,HJ,,5.35,-122194.27
2032,2/12/2021,2/12/2021,Thomas Fischaber,Imported from Bank of America Visa-backup software,,HJ,,9.99,-122204.26
2032,2/13/2021,2/13/2021,Joseph Zarate,Imported from Bank of America Visa-equipment,,HJ,,463.9,-122668.16
2032,2/14/2021,2/14/2021,Antonio Gutierrez,Imported from Bank of America Visa-Fellow Recruitment,,HJ,,900,-123568.16
2032,2/14/2021,2/14/2021,Halley Bowman,Imported from Bank of America Visa-PD book for Mallory,,HJ,,6.15,-123574.31
2032,2/14/2021,2/14/2021,Halley Bowman,Imported from Bank of America Visa-PD book for Mallory,,HJ,,9.5,-123583.81
2032,2/14/2021,2/14/2021,Halley Bowman,Imported from Bank of America Visa-PD book for Mallory,,HJ,,9.5,-123593.31
2032,2/14/2021,2/14/2021,Halley Bowman,Imported from Bank of America Visa-PD book for Mallory,,HJ,,30.74,-123624.05
2032,2/14/2021,2/14/2021,Joseph Zarate,Imported from Bank of America Visa-equipment,,HJ,,463.9,-124087.95
2032,2/14/2021,2/14/2021,Myesha Hossain,Imported from Bank of America Visa-Vision board raffle,,HJ,,13.59,-124101.54
2032,2/15/2021,2/15/2021,Halley Bowman,Imported from Bank of America Visa-fellow book club book for Halley,,HJ,,1.99,-124103.53
2032,2/15/2021,2/15/2021,Halley Bowman,Imported from Bank of America Visa-fellow book club book for Halley,,HJ,,3.08,-124106.61
2032,2/15/2021,2/15/2021,Halley Bowman,Imported from Bank of America Visa-fellow book club book for Halley,,HJ,,3.08,-124109.69
2032,2/15/2021,2/15/2021,Halley Bowman,Imported from Bank of America Visa-fellow book club book for Halley,,HJ,,9.97,-124119.66
2032,2/15/2021,2/15/2021,Mahaliah Sejour,Imported from Bank of America Visa-Fellows gifts,,HJ,,9.99,-124129.65
2032,2/15/2021,2/15/2021,Mahaliah Sejour,Imported from Bank of America Visa-Fellows gifts,,HJ,,9.99,-124139.64
2032,2/16/2021,2/16/2021,Joseph Zarate,Imported from Bank of America Visa-Equipment,,HJ,,460,-124599.64
2032,2/16/2021,2/16/2021,Joseph Zarate,Imported from Bank of America Visa-Returns,,HJ,,15.5,-124615.14
2032,2/16/2021,2/16/2021,Mahaliah Sejour,Imported from Bank of America Visa-MS printer,,HJ,,5.35,-124620.49
2032,2/16/2021,2/16/2021,Maryellen Leneghan,Imported from Bank of America Visa-Site supplies,,HJ,,19.99,-124640.48
2032,2/16/2021,2/16/2021,Myesha Hossain,Imported from Bank of America Visa-SD PD,,HJ,,5.99,-124646.47
2032,2/16/2021,2/16/2021,Myesha Hossain,Imported from Bank of America Visa-SD PD,,HJ,,5.99,-124652.46
2032,2/16/2021,2/16/2021,Nicole Prahin,Imported from Bank of America Visa-Google drive storage space,,HJ,,2.17,-124654.63
2032,2/17/2021,2/17/2021,Antonio Gutierrez,Imported from Bank of America Visa-media subscription,,HJ,,4,-124658.63
2032,2/17/2021,2/17/2021,Elizabeth Peinado,Imported from Bank of America Visa-Envelops for mailing new hire packages,,HJ,,0.81,-124659.44
2032,2/17/2021,2/17/2021,Elizabeth Peinado,Imported from Bank of America Visa-Envelops for mailing new hire packages,,HJ,,1.26,-124660.7
2032,2/17/2021,2/17/2021,Elizabeth Peinado,Imported from Bank of America Visa-Envelops for mailing new hire packages,,HJ,,1.26,-124661.96
2032,2/17/2021,2/17/2021,Elizabeth Peinado,Imported from Bank of America Visa-Envelops for mailing new hire packages,,HJ,,4.06,-124666.02
2032,2/17/2021,2/17/2021,Halley Bowman,Imported from Bank of America Visa-laptop stand,,HJ,,25.43,-124691.45
2032,2/17/2021,2/17/2021,Joseph Zarate,Imported from Bank of America Visa-Equipment,,HJ,,34.45,-124725.9
2032,2/17/2021,2/17/2021,Joseph Zarate,Imported from Bank of America Visa-Returns,,HJ,,15.5,-124741.4
2032,2/17/2021,2/17/2021,Mahaliah Sejour,Imported from Bank of America Visa-amazon refund,,HJ,9.99,,-124731.41
2032,2/17/2021,2/17/2021,Myesha Hossain,Imported from Bank of America Visa-SD PD,,HJ,,5.99,-124737.4
2032,2/17/2021,2/17/2021,Myesha Hossain,Imported from Bank of America Visa-SD PD,,HJ,,5.99,-124743.39
2032,2/17/2021,2/17/2021,Myesha Hossain,Imported from Bank of America Visa-SD PD,,HJ,,5.99,-124749.38
2032,2/17/2021,2/17/2021,Thomas Fischaber,Imported from Bank of America Visa-Simbulus insurance close-out,,HJ,,2835,-127584.38
2032,2/17/2021,2/17/2021,Tiffani Bibb,Imported from Bank of America Visa-Compensation Course for PD,,HJ,,350,-127934.38
2032,2/18/2021,2/18/2021,Halley Bowman,Imported from Bank of America Visa-Conference for Anna Hernandez EML Specialist,,HJ,,8.25,-127942.63
2032,2/18/2021,2/18/2021,Halley Bowman,Imported from Bank of America Visa-Conference for Anna Hernandez EML Specialist,,HJ,,12.75,-127955.38
2032,2/18/2021,2/18/2021,Halley Bowman,Imported from Bank of America Visa-Conference for Anna Hernandez EML Specialist,,HJ,,12.75,-127968.13
2032,2/18/2021,2/18/2021,Halley Bowman,Imported from Bank of America Visa-Conference for Anna Hernandez EML Specialist,,HJ,,20.9,-127989.03
2032,2/18/2021,2/18/2021,Halley Bowman,Imported from Bank of America Visa-Conference for Anna Hernandez EML Specialist,,HJ,,32.3,-128021.33
2032,2/18/2021,2/18/2021,Halley Bowman,Imported from Bank of America Visa-Conference for Anna Hernandez EML Specialist,,HJ,,32.3,-128053.63
2032,2/18/2021,2/18/2021,Halley Bowman,Imported from Bank of America Visa-Conference for Anna Hernandez EML Specialist,,HJ,,41.25,-128094.88
2032,2/18/2021,2/18/2021,Halley Bowman,Imported from Bank of America Visa-Conference for Anna Hernandez EML Specialist,,HJ,,104.5,-128199.38
2032,2/19/2021,2/19/2021,Alan Safran,Imported from Bank of America Visa-Purchase of HP Ink,,HJ,,5.3,-128204.68
2032,2/19/2021,2/19/2021,Antonio Gutierrez,Imported from Bank of America Visa-Fellow Recruitment,,HJ,,899.98,-129104.66
2032,2/19/2021,2/19/2021,Antonio Gutierrez,Imported from Bank of America Visa-Fellow recruitment,,HJ,,338.99,-129443.65
2032,2/19/2021,2/19/2021,Joseph Zarate,Imported from Bank of America Visa-Equipment,,HJ,,124.99,-129568.64
2032,2/19/2021,2/19/2021,Joseph Zarate,Imported from Bank of America Visa-refund,,HJ,10.55,,-129558.09
2032,2/19/2021,2/19/2021,Joseph Zarate,Imported from Bank of America Visa-software,,HJ,,299.9,-129857.99
2032,2/19/2021,2/19/2021,Lisa Kapusta,Imported from Bank of America Visa-FLORAL PRODUCTS,,HJ,,89.76,-129947.75
2032,2/19/2021,2/19/2021,Tiffani Bibb,Imported from Bank of America Visa-Assessment for HR Admin Team,,HJ,,59.97,-130007.72
2032,2/19/2021,2/19/2021,Tiffani Bibb,Imported from Bank of America Visa-Assessment for HR Admin Team,,HJ,,141,-130148.72
2032,2/20/2021,2/20/2021,Halley Bowman,Imported from Bank of America Visa-desk lamp,,HJ,,3.03,-130151.75
2032,2/20/2021,2/20/2021,Halley Bowman,Imported from Bank of America Visa-desk lamp,,HJ,,4.68,-130156.43
2032,2/20/2021,2/20/2021,Halley Bowman,Imported from Bank of America Visa-desk lamp,,HJ,,4.68,-130161.11
2032,2/20/2021,2/20/2021,Halley Bowman,Imported from Bank of America Visa-desk lamp,,HJ,,15.16,-130176.27
2032,2/20/2021,2/20/2021,Halley Bowman,Imported from Bank of America Visa-laptop stand,,HJ,,4.2,-130180.47
2032,2/20/2021,2/20/2021,Halley Bowman,Imported from Bank of America Visa-laptop stand,,HJ,,6.49,-130186.96
2032,2/20/2021,2/20/2021,Halley Bowman,Imported from Bank of America Visa-laptop stand,,HJ,,6.49,-130193.45
2032,2/20/2021,2/20/2021,Halley Bowman,Imported from Bank of America Visa-laptop stand,,HJ,,20.97,-130214.42
2032,2/21/2021,2/21/2021,Elizabeth Peinado,Imported from Bank of America Visa-Math Assessment subscription,,HJ,,4.39,-130218.81
2032,2/21/2021,2/21/2021,Elizabeth Peinado,Imported from Bank of America Visa-Math Assessment subscription,,HJ,,6.79,-130225.6
2032,2/21/2021,2/21/2021,Elizabeth Peinado,Imported from Bank of America Visa-Math Assessment subscription,,HJ,,6.79,-130232.39
2032,2/21/2021,2/21/2021,Elizabeth Peinado,Imported from Bank of America Visa-Math Assessment subscription,,HJ,,21.98,-130254.37
2032,2/21/2021,2/21/2021,Joseph Zarate,Imported from Bank of America Visa-Equipment,,HJ,,104.95,-130359.32
2032,2/21/2021,2/21/2021,Mahaliah Sejour,Imported from Bank of America Visa-Fellows gifts,,HJ,,30.58,-130389.9
2032,2/21/2021,2/21/2021,Mahaliah Sejour,Imported from Bank of America Visa-Lanigan baby shower,,HJ,,100.5,-130490.4
2032,2/22/2021,2/22/2021,Antonio Gutierrez,Imported from Bank of America Visa-Fellow Recruitment,,HJ,,900,-131390.4
2032,2/22/2021,2/22/2021,Elizabeth Peinado,Imported from Bank of America Visa-International fee for Class Marker,,HJ,,0.8,-131391.2
2032,2/22/2021,2/22/2021,iaklestad,Imported from Bank of America Visa-Welcome Package Mailing,,HJ,,37.35,-131428.55
2032,2/22/2021,2/22/2021,Maryellen Leneghan,Imported from Bank of America Visa-Staff Social,,HJ,,26.48,-131455.03
2032,2/22/2021,2/22/2021,Myesha Hossain,Imported from Bank of America Visa-NYC Storage,,HJ,,159.3,-131614.33
2032,2/22/2021,2/22/2021,Myesha Hossain,Imported from Bank of America Visa-tax exempt refund,,HJ,1.32,,-131613.01
2032,2/22/2021,2/22/2021,Myesha Hossain,Imported from Bank of America Visa-tax exempt refund,,HJ,1.36,,-131611.65
2032,2/22/2021,2/22/2021,Myesha Hossain,Imported from Bank of America Visa-tax exempt refund,,HJ,1.36,,-131610.29
2032,2/22/2021,2/22/2021,Myesha Hossain,Imported from Bank of America Visa-tax exempt refund,,HJ,1.36,,-131608.93
2032,2/22/2021,2/22/2021,Myesha Hossain,Imported from Bank of America Visa-tax exempt refund,,HJ,1.36,,-131607.57
2032,2/22/2021,2/22/2021,Myesha Hossain,Imported from Bank of America Visa-tax exempt refund,,HJ,1.36,,-131606.21
2032,2/23/2021,2/23/2021,Alan Safran,Imported from Bank of America Visa-Background Check for Alison Kerins,,HJ,,50.5,-131656.71
2032,2/23/2021,2/23/2021,Halley Bowman,Imported from Bank of America Visa-working geniuses quiz,,HJ,,1.38,-131658.09
2032,2/23/2021,2/23/2021,Halley Bowman,Imported from Bank of America Visa-working geniuses quiz,,HJ,,2.12,-131660.21
2032,2/23/2021,2/23/2021,Halley Bowman,Imported from Bank of America Visa-working geniuses quiz,,HJ,,2.13,-131662.34
2032,2/23/2021,2/23/2021,Halley Bowman,Imported from Bank of America Visa-working geniuses quiz,,HJ,,6.87,-131669.21
2032,2/23/2021,2/23/2021,Joseph Zarate,Imported from Bank of America Visa-software,,HJ,,1298,-132967.21
2032,2/23/2021,2/23/2021,Mahaliah Sejour,Imported from Bank of America Visa-Lanigan baby shower,,HJ,,17.89,-132985.1
2032,2/23/2021,2/23/2021,Mahaliah Sejour,Imported from Bank of America Visa-SD social,,HJ,,27.55,-133012.65
2032,2/23/2021,2/23/2021,Mahaliah Sejour,Imported from Bank of America Visa-SD social,,HJ,,27.55,-133040.2
2032,2/23/2021,2/23/2021,Mahaliah Sejour,Imported from Bank of America Visa-SD social,,HJ,,27.55,-133067.75
2032,2/23/2021,2/23/2021,Mahaliah Sejour,Imported from Bank of America Visa-SD social,,HJ,,27.55,-133095.3
2032,2/23/2021,2/23/2021,Mahaliah Sejour,Imported from Bank of America Visa-SD social,,HJ,,27.68,-133122.98
2032,2/23/2021,2/23/2021,Mahaliah Sejour,Imported from Bank of America Visa-SD social,,HJ,,33.56,-133156.54
2032,2/23/2021,2/23/2021,Mahaliah Sejour,Imported from Bank of America Visa-SD social,,HJ,,47.84,-133204.38
2032,2/23/2021,2/23/2021,Mahaliah Sejour,Imported from Bank of America Visa-notebooks,,HJ,,37.59,-133241.97
2032,2/23/2021,2/23/2021,Monivett Acevedo,Imported from Bank of America Visa-Office Ink Boston,,HJ,,3.18,-133245.15
2032,2/23/2021,2/23/2021,Myesha Hossain,Imported from Bank of America Visa-HPHS Fellow Bday,,HJ,,4.99,-133250.14
2032,2/23/2021,2/23/2021,Myesha Hossain,Imported from Bank of America Visa-HPHS Fellow Bday,,HJ,,19.99,-133270.13
2032,2/23/2021,2/23/2021,Myesha Hossain,Imported from Bank of America Visa-SD Appreciation,,HJ,27.2,,-133242.93
2032,2/23/2021,2/23/2021,Myesha Hossain,Imported from Bank of America Visa-SD PD,,HJ,,5.99,-133248.92
2032,2/23/2021,2/23/2021,Myesha Hossain,Imported from Bank of America Visa-SD social,,HJ,,27.2,-133276.12
2032,2/23/2021,2/23/2021,Myesha Hossain,Imported from Bank of America Visa-SD social,,HJ,,27.2,-133303.32
2032,2/23/2021,2/23/2021,Myesha Hossain,Imported from Bank of America Visa-sd social,,HJ,,27.2,-133330.52
2032,2/23/2021,2/23/2021,Myesha Hossain,Imported from Bank of America Visa-sd social,,HJ,,27.2,-133357.72
2032,2/23/2021,2/23/2021,Myesha Hossain,Imported from Bank of America Visa-sd social,,HJ,27.2,,-133330.52
2032,2/24/2021,2/24/2021,Joseph Zarate,Imported from Bank of America Visa-Equipment,,HJ,,35.6,-133366.12
2032,2/24/2021,2/24/2021,Joseph Zarate,Imported from Bank of America Visa-Returns,,HJ,,21.9,-133388.02
2032,2/24/2021,2/24/2021,Mahaliah Sejour,Imported from Bank of America Visa-Fellows gifts,,HJ,,18.83,-133406.85
2032,2/24/2021,2/24/2021,Mahaliah Sejour,Imported from Bank of America Visa-Fellows gifts,,HJ,,33.95,-133440.8
2032,2/24/2021,2/24/2021,Maryellen Leneghan,Imported from Bank of America Visa-Staff.Fellow Appreciation,,HJ,,1.99,-133442.79
2032,2/24/2021,2/24/2021,Maryellen Leneghan,Imported from Bank of America Visa-Staff.Fellow Appreciation,,HJ,,3,-133445.79
2032,2/24/2021,2/24/2021,Maryellen Leneghan,Imported from Bank of America Visa-Staff.Fellow Appreciation,,HJ,,3.07,-133448.86
2032,2/24/2021,2/24/2021,Maryellen Leneghan,Imported from Bank of America Visa-Staff.Fellow Appreciation,,HJ,,4.29,-133453.15
2032,2/24/2021,2/24/2021,Maryellen Leneghan,Imported from Bank of America Visa-Staff.Fellow Appreciation,,HJ,,6.99,-133460.14
2032,2/24/2021,2/24/2021,Maryellen Leneghan,Imported from Bank of America Visa-Staff.Fellow Appreciation,,HJ,,6.99,-133467.13
2032,2/24/2021,2/24/2021,Maryellen Leneghan,Imported from Bank of America Visa-Staff.Fellow Appreciation,,HJ,,7.99,-133475.12
2032,2/24/2021,2/24/2021,Maryellen Leneghan,Imported from Bank of America Visa-Staff.Fellow Appreciation,,HJ,,7.99,-133483.11
2032,2/24/2021,2/24/2021,Thomas Fischaber,Imported from Bank of America Visa-office supply - desk,,HJ,,216.6,-133699.71
2032,2/24/2021,2/24/2021,Tiffani Bibb,Imported from Bank of America Visa-Working Lunch,,HJ,,15.51,-133715.22
2032,2/25/2021,2/25/2021,Alan Safran,Imported from Bank of America Visa-Background Check for Marta Sidorek,,HJ,,50.5,-133765.72
2032,2/25/2021,2/25/2021,Alan Safran,Imported from Bank of America Visa-Background Check for Nicole Horton,,HJ,,50.5,-133816.22
2032,2/25/2021,2/25/2021,Amena Wallace,Imported from Bank of America Visa-Survey Monkey Annual Subscription,,HJ,,288,-134104.22
2032,2/25/2021,2/25/2021,Halley Bowman,Imported from Bank of America Visa-laptop stand return,,HJ,25.43,,-134078.79
2032,2/25/2021,2/25/2021,iaklestad,Imported from Bank of America Visa-Welcome Package Mailing,,HJ,,44.95,-134123.74
2032,2/25/2021,2/25/2021,Joseph Zarate,Imported from Bank of America Visa-TESTING,,HJ,,25.49,-134149.23
2032,2/25/2021,2/25/2021,Joseph Zarate,Imported from Bank of America Visa-TESTING,,HJ,,319.99,-134469.22
2032,2/25/2021,2/25/2021,Joseph Zarate,Imported from Bank of America Visa-credit return,,HJ,1.19,,-134468.03
2032,2/25/2021,2/25/2021,Joseph Zarate,Imported from Bank of America Visa-credit return,,HJ,87.44,,-134380.59
2032,2/25/2021,2/25/2021,Maryellen Leneghan,Imported from Bank of America Visa-Staff.Fellow Appreciation,,HJ,,4.84,-134385.43
2032,2/25/2021,2/25/2021,Maryellen Leneghan,Imported from Bank of America Visa-Staff.Fellow Appreciation,,HJ,,4.99,-134390.42
2032,2/25/2021,2/25/2021,Maryellen Leneghan,Imported from Bank of America Visa-Staff.Fellow Appreciation,,HJ,,5.99,-134396.41
2032,2/25/2021,2/25/2021,Maryellen Leneghan,Imported from Bank of America Visa-Staff.Fellow Appreciation,,HJ,,6.82,-134403.23
2032,2/25/2021,2/25/2021,Maryellen Leneghan,Imported from Bank of America Visa-Staff.Fellow Appreciation,,HJ,,6.98,-134410.21
2032,2/25/2021,2/25/2021,Maryellen Leneghan,Imported from Bank of America Visa-Staff.Fellow Appreciation,,HJ,,6.99,-134417.2
2032,2/25/2021,2/25/2021,Maryellen Leneghan,Imported from Bank of America Visa-Staff.Fellow Appreciation,,HJ,,7.98,-134425.18
2032,2/25/2021,2/25/2021,Maryellen Leneghan,Imported from Bank of America Visa-Staff.Fellow Appreciation,,HJ,,7.99,-134433.17
2032,2/25/2021,2/25/2021,Maryellen Leneghan,Imported from Bank of America Visa-Staff.Fellow Appreciation,,HJ,,7.99,-134441.16
2032,2/25/2021,2/25/2021,Maryellen Leneghan,Imported from Bank of America Visa-Staff.Fellow Appreciation,,HJ,,7.99,-134449.15
2032,2/25/2021,2/25/2021,Maryellen Leneghan,Imported from Bank of America Visa-Staff.Fellow Appreciation,,HJ,,7.99,-134457.14
2032,2/25/2021,2/25/2021,Maryellen Leneghan,Imported from Bank of America Visa-Staff.Fellow Appreciation,,HJ,,8.66,-134465.8
2032,2/25/2021,2/25/2021,Myesha Hossain,Imported from Bank of America Visa-Cleveland Fellow Appreciation from Dewey,,HJ,,14.95,-134480.75
2032,2/26/2021,2/26/2021,Joseph Zarate,Imported from Bank of America Visa-Equipment,,HJ,,1486.44,-135967.19
2032,3/1/2021,3/1/2021,Alan Safran,Imported from Bank of America Visa,,HJ,,9,-135976.19
2032,3/1/2021,3/1/2021,Alan Safran,Imported from Bank of America Visa,,HJ,,166,-136142.19
2032,3/1/2021,3/1/2021,Alan Safran,Imported from Bank of America Visa,,HJ,,15,-136157.19
2032,3/1/2021,3/1/2021,Antonio Gutierrez,Imported from Bank of America Visa,,HJ,,182.93,-136340.12
2032,3/1/2021,3/1/2021,Antonio Gutierrez,Imported from Bank of America Visa,,HJ,,780.92,-137121.04
2032,3/1/2021,3/1/2021,Antonio Gutierrez,Imported from Bank of America Visa,,HJ,,828.62,-137949.66
2032,3/1/2021,3/1/2021,Antonio Gutierrez,Imported from Bank of America Visa,,HJ,,900,-138849.66
2032,3/1/2021,3/1/2021,Elizabeth Peinado,Imported from Bank of America Visa,,HJ,,198,-139047.66
2032,3/1/2021,3/1/2021,Elizabeth Peinado,Imported from Bank of America Visa,,HJ,,306,-139353.66
2032,3/1/2021,3/1/2021,Elizabeth Peinado,Imported from Bank of America Visa,,HJ,,306,-139659.66
2032,3/1/2021,3/1/2021,Elizabeth Peinado,Imported from Bank of America Visa,,HJ,,550,-140209.66
2032,3/1/2021,3/1/2021,Elizabeth Peinado,Imported from Bank of America Visa,,HJ,,850,-141059.66
2032,3/1/2021,3/1/2021,Elizabeth Peinado,Imported from Bank of America Visa,,HJ,,850,-141909.66
2032,3/1/2021,3/1/2021,Elizabeth Peinado,Imported from Bank of America Visa,,HJ,,990,-142899.66
2032,3/1/2021,3/1/2021,Elizabeth Peinado,Imported from Bank of America Visa,,HJ,,2750,-145649.66
2032,3/1/2021,3/1/2021,Elizabeth Peinado,Imported from Bank of America Visa,,HJ,,575.52,-146225.18
2032,3/1/2021,3/1/2021,Elizabeth Peinado,Imported from Bank of America Visa,,HJ,,889.44,-147114.62
2032,3/1/2021,3/1/2021,Elizabeth Peinado,Imported from Bank of America Visa,,HJ,,889.44,-148004.06
2032,3/1/2021,3/1/2021,Elizabeth Peinado,Imported from Bank of America Visa,,HJ,,2877.6,-150881.66
2032,3/1/2021,3/1/2021,Halley Bowman,Imported from Bank of America Visa,,HJ,,0.72,-150882.38
2032,3/1/2021,3/1/2021,Halley Bowman,Imported from Bank of America Visa,,HJ,,1.1,-150883.48
2032,3/1/2021,3/1/2021,Halley Bowman,Imported from Bank of America Visa,,HJ,,1.11,-150884.59
2032,3/1/2021,3/1/2021,Halley Bowman,Imported from Bank of America Visa,,HJ,,3.57,-150888.16
2032,3/1/2021,3/1/2021,iaklestad,Imported from Bank of America Visa,,HJ,,15.5,-150903.66
2032,3/1/2021,3/1/2021,Joseph Zarate,Imported from Bank of America Visa,,HJ,,10.99,-150914.65
2032,3/1/2021,3/1/2021,Joseph Zarate,Imported from Bank of America Visa,,HJ,,10.99,-150925.64
2032,3/1/2021,3/1/2021,Joseph Zarate,Imported from Bank of America Visa,,HJ,,10.99,-150936.63
2032,3/1/2021,3/1/2021,Joseph Zarate,Imported from Bank of America Visa,,HJ,,11.87,-150948.5
2032,3/1/2021,3/1/2021,Joseph Zarate,Imported from Bank of America Visa,,HJ,,24.99,-150973.49
2032,3/1/2021,3/1/2021,Joseph Zarate,Imported from Bank of America Visa,,HJ,,26.65,-151000.14
2032,3/1/2021,3/1/2021,Joseph Zarate,Imported from Bank of America Visa,,HJ,,26.65,-151026.79
2032,3/1/2021,3/1/2021,Joseph Zarate,Imported from Bank of America Visa,,HJ,,73.78,-151100.57
2032,3/1/2021,3/1/2021,Mahaliah Sejour,Imported from Bank of America Visa,,HJ,,22.25,-151122.82
2032,3/1/2021,3/1/2021,Mahaliah Sejour,Imported from Bank of America Visa,,HJ,,1.99,-151124.81
2032,3/1/2021,3/1/2021,Maryellen Leneghan,Imported from Bank of America Visa,,HJ,,5.89,-151130.7
2032,3/1/2021,3/1/2021,Maryellen Leneghan,Imported from Bank of America Visa,,HJ,,6.45,-151137.15
2032,3/1/2021,3/1/2021,Maryellen Leneghan,Imported from Bank of America Visa,,HJ,,6.59,-151143.74
2032,3/1/2021,3/1/2021,Maryellen Leneghan,Imported from Bank of America Visa,,HJ,,6.79,-151150.53
2032,3/1/2021,3/1/2021,Maryellen Leneghan,Imported from Bank of America Visa,,HJ,,6.99,-151157.52
2032,3/1/2021,3/1/2021,Maryellen Leneghan,Imported from Bank of America Visa,,HJ,,6.99,-151164.51
2032,3/1/2021,3/1/2021,Maryellen Leneghan,Imported from Bank of America Visa,,HJ,,7.99,-151172.5
2032,3/1/2021,3/1/2021,Maryellen Leneghan,Imported from Bank of America Visa,,HJ,,7.99,-151180.49
2032,3/1/2021,3/1/2021,Maryellen Leneghan,Imported from Bank of America Visa,,HJ,,8.75,-151189.24
2032,3/1/2021,3/1/2021,Maryellen Leneghan,Imported from Bank of America Visa,,HJ,,8.99,-151198.23
2032,3/1/2021,3/1/2021,Maryellen Leneghan,Imported from Bank of America Visa,,HJ,,8.99,-151207.22
2032,3/1/2021,3/1/2021,Maryellen Leneghan,Imported from Bank of America Visa,,HJ,,8.99,-151216.21
2032,3/1/2021,3/1/2021,Maryellen Leneghan,Imported from Bank of America Visa,,HJ,,10.35,-151226.56
2032,3/1/2021,3/1/2021,Monivett Acevedo,Imported from Bank of America Visa,,HJ,,16.9,-151243.46
2032,3/1/2021,3/1/2021,Monivett Acevedo,Imported from Bank of America Visa,,HJ,,134.79,-151378.25
2032,3/1/2021,3/1/2021,Myesha Hossain,Imported from Bank of America Visa,,HJ,,10.99,-151389.24
2032,3/1/2021,3/1/2021,Myesha Hossain,Imported from Bank of America Visa,,HJ,,10.99,-151400.23
2032,3/1/2021,3/1/2021,Myesha Hossain,Imported from Bank of America Visa,,HJ,,10.99,-151411.22
2032,3/1/2021,3/1/2021,Myesha Hossain,Imported from Bank of America Visa,,HJ,,10.99,-151422.21
2032,3/1/2021,3/1/2021,Myesha Hossain,Imported from Bank of America Visa,,HJ,,15.99,-151438.2
2032,3/1/2021,3/1/2021,Myesha Hossain,Imported from Bank of America Visa,,HJ,,28.6,-151466.8
2032,3/1/2021,3/1/2021,Thomas Fischaber,Imported from Bank of America Visa,,HJ,,82.21,-151549.01
2032,3/1/2021,3/1/2021,Thomas Fischaber,Imported from Bank of America Visa,,HJ,,84,-151633.01
2032,3/1/2021,3/1/2021,Thomas Fischaber,Imported from Bank of America Visa,,HJ,,238,-151871.01
2032,3/1/2021,3/1/2021,Tiffani Bibb,Imported from Bank of America Visa,,HJ,,13.4,-151884.41
2032,3/1/2021,3/1/2021,Tiffani Bibb,Imported from Bank of America Visa,,HJ,,28.46,-151912.87
2032,3/1/2021,3/1/2021,Uriel Guadarrama,Imported from Bank of America Visa,,HJ,,15.93,-151928.8
2032,3/1/2021,3/1/2021,Uriel Guadarrama,Imported from Bank of America Visa,,HJ,,31.85,-151960.65
2032,3/1/2021,3/1/2021,Uriel Guadarrama,Imported from Bank of America Visa,,HJ,,31.85,-151992.5
2032,3/2/2021,3/2/2021,Antonio Gutierrez,Imported from Bank of America Visa,,HJ,,1.99,-151994.49
2032,3/2/2021,3/2/2021,Antonio Gutierrez,Imported from Bank of America Visa,,HJ,,900,-152894.49
2032,3/2/2021,3/2/2021,Antonio Gutierrez,Imported from Bank of America Visa,,HJ,,900,-153794.49
2032,3/2/2021,3/2/2021,Bank of America VISA,BofA Concur Payment,,HJ,1439.63,,-152354.86
2032,3/2/2021,3/2/2021,Bank of America VISA,BofA Concur Payment,,HJ,6357.58,,-145997.28
2032,3/2/2021,3/2/2021,Bank of America VISA,BofA Concur Payment,,HJ,9497.08,,-136500.2
2032,3/2/2021,3/2/2021,Bank of America VISA,BofA Concur Payment,,HJ,11176.52,,-125323.68
2032,3/2/2021,3/2/2021,Bank of America VISA,BofA Concur Payment,,HJ,19297.52,,-106026.16
2032,3/2/2021,3/2/2021,Bank of America VISA,BofA Concur Payment,,HJ,25040.89,,-80985.27
2032,3/2/2021,3/2/2021,Bank of America VISA,BofA Concur Payment,,HJ,63157.97,,-17827.3
2032,3/2/2021,3/2/2021,Elizabeth Peinado,Imported from Bank of America Visa,,HJ,,0.8,-17828.1
2032,3/2/2021,3/2/2021,Elizabeth Peinado,Imported from Bank of America Visa,,HJ,,4.39,-17832.49
2032,3/2/2021,3/2/2021,Elizabeth Peinado,Imported from Bank of America Visa,,HJ,,6.79,-17839.28
2032,3/2/2021,3/2/2021,Elizabeth Peinado,Imported from Bank of America Visa,,HJ,,6.79,-17846.07
2032,3/2/2021,3/2/2021,Elizabeth Peinado,Imported from Bank of America Visa,,HJ,,21.98,-17868.05
2032,3/2/2021,3/2/2021,Joseph Zarate,Imported from Bank of America Visa,,HJ,,11.76,-17879.81
2032,3/2/2021,3/2/2021,Joseph Zarate,Imported from Bank of America Visa,,HJ,,42.86,-17922.67
2032,3/2/2021,3/2/2021,Joseph Zarate,Imported from Bank of America Visa,,HJ,,86.99,-18009.66
2032,3/2/2021,3/2/2021,Joseph Zarate,Imported from Bank of America Visa,,HJ,,95.99,-18105.65
2032,3/2/2021,3/2/2021,Joseph Zarate,Imported from Bank of America Visa,,HJ,,95.99,-18201.64
2032,3/2/2021,3/2/2021,Joseph Zarate,Imported from Bank of America Visa,,HJ,,95.99,-18297.63
2032,3/2/2021,3/2/2021,Joseph Zarate,Imported from Bank of America Visa,,HJ,,95.99,-18393.62
2032,3/2/2021,3/2/2021,Mahaliah Sejour,Imported from Bank of America Visa,,HJ,,19.99,-18413.61
2032,3/2/2021,3/2/2021,Mahaliah Sejour,Imported from Bank of America Visa,,HJ,,23.11,-18436.72
2032,3/2/2021,3/2/2021,Mahaliah Sejour,Imported from Bank of America Visa,,HJ,,149,-18585.72
2032,3/2/2021,3/2/2021,Mahaliah Sejour,Imported from Bank of America Visa,,HJ,,173,-18758.72
2032,3/2/2021,3/2/2021,Monivett Acevedo,Imported from Bank of America Visa,,HJ,,17.99,-18776.71
2032,3/2/2021,3/2/2021,Monivett Acevedo,Imported from Bank of America Visa,,HJ,,53.11,-18829.82
2032,3/2/2021,3/2/2021,Myesha Hossain,Imported from Bank of America Visa,,HJ,,10.99,-18840.81
2032,3/2/2021,3/2/2021,Myesha Hossain,Imported from Bank of America Visa,,HJ,,10.99,-18851.8
2032,3/2/2021,3/2/2021,Myesha Hossain,Imported from Bank of America Visa,,HJ,,10.99,-18862.79
2032,3/2/2021,3/2/2021,Thomas Fischaber,Imported from Bank of America Visa,,HJ,,7.3,-18870.09
2032,3/2/2021,3/2/2021,Thomas Fischaber,Imported from Bank of America Visa,,HJ,94,,-18776.09
2032,3/2/2021,3/2/2021,Tiffani Bibb,Imported from Bank of America Visa,,HJ,,83.98,-18860.07
2032,3/2/2021,3/2/2021,Tiffani Bibb,Imported from Bank of America Visa,,HJ,,83.98,-18944.05
2032,3/2/2021,3/2/2021,Uriel Guadarrama,Imported from Bank of America Visa,,HJ,,1358.26,-20302.31
2032,3/3/2021,3/3/2021,Antonio Gutierrez,Imported from Bank of America Visa,,HJ,,900,-21202.31
2032,3/3/2021,3/3/2021,Joseph Zarate,Imported from Bank of America Visa,,HJ,,28.25,-21230.56
2032,3/3/2021,3/3/2021,Joseph Zarate,Imported from Bank of America Visa,,HJ,,582.48,-21813.04
2032,3/3/2021,3/3/2021,Monivett Acevedo,Imported from Bank of America Visa,,HJ,,49.99,-21863.03
2032,3/3/2021,3/3/2021,Myesha Hossain,Imported from Bank of America Visa,,HJ,,104.52,-21967.55
2032,3/3/2021,3/3/2021,Tiffani Bibb,Imported from Bank of America Visa,,HJ,,29.99,-21997.54
2032,3/5/2021,3/5/2021,Alan Safran,Imported from Bank of America Visa,,HJ,,1.99,-21999.53
2032,3/5/2021,3/5/2021,Alan Safran,Imported from Bank of America Visa,,HJ,,24.3,-22023.83
2032,3/5/2021,3/5/2021,Antonio Gutierrez,Imported from Bank of America Visa,,HJ,,900,-22923.83
2032,3/5/2021,3/5/2021,claice Jackson,Imported from Bank of America Visa,,HJ,,24.45,-22948.28
2032,3/5/2021,3/5/2021,claice Jackson,Imported from Bank of America Visa,,HJ,24.45,,-22923.83
2032,3/5/2021,3/5/2021,Joseph Zarate,Imported from Bank of America Visa,,HJ,,5.99,-22929.82
2032,3/5/2021,3/5/2021,Joseph Zarate,Imported from Bank of America Visa,,HJ,,29.85,-22959.67
2032,3/5/2021,3/5/2021,Joseph Zarate,Imported from Bank of America Visa,,HJ,,29.85,-22989.52
2032,3/5/2021,3/5/2021,Joseph Zarate,Imported from Bank of America Visa,,HJ,,29.85,-23019.37
2032,3/5/2021,3/5/2021,Joseph Zarate,Imported from Bank of America Visa,,HJ,,91.85,-23111.22
2032,3/5/2021,3/5/2021,Joseph Zarate,Imported from Bank of America Visa,,HJ,,95.99,-23207.21
2032,3/5/2021,3/5/2021,Joseph Zarate,Imported from Bank of America Visa,,HJ,,155.18,-23362.39
2032,3/5/2021,3/5/2021,Joseph Zarate,Imported from Bank of America Visa,,HJ,,155.19,-23517.58
2032,3/5/2021,3/5/2021,Mahaliah Sejour,Imported from Bank of America Visa,,HJ,,18.94,-23536.52
2032,3/5/2021,3/5/2021,Maryellen Leneghan,Imported from Bank of America Visa,,HJ,,19.99,-23556.51
2032,3/5/2021,3/5/2021,Myesha Hossain,Imported from Bank of America Visa,,HJ,2.21,,-23554.3
2032,3/5/2021,3/5/2021,Myesha Hossain,Imported from Bank of America Visa,,HJ,2.21,,-23552.09
2032,3/5/2021,3/5/2021,Myesha Hossain,Imported from Bank of America Visa,,HJ,,6.49,-23558.58
2032,3/5/2021,3/5/2021,Thomas Fischaber,Imported from Bank of America Visa,,HJ,,14.95,-23573.53
2032,3/8/2021,3/8/2021,Antonio Gutierrez,Imported from Bank of America Visa,,HJ,,100,-23673.53
2032,3/8/2021,3/8/2021,Antonio Gutierrez,Imported from Bank of America Visa,,HJ,,100,-23773.53
2032,3/8/2021,3/8/2021,Halley Bowman,Imported from Bank of America Visa,,HJ,,2.75,-23776.28
2032,3/8/2021,3/8/2021,Halley Bowman,Imported from Bank of America Visa,,HJ,,2.92,-23779.2
2032,3/8/2021,3/8/2021,Halley Bowman,Imported from Bank of America Visa,,HJ,,2.94,-23782.14
2032,3/8/2021,3/8/2021,Halley Bowman,Imported from Bank of America Visa,,HJ,,2.94,-23785.08
2032,3/8/2021,3/8/2021,Halley Bowman,Imported from Bank of America Visa,,HJ,,2.99,-23788.07
2032,3/8/2021,3/8/2021,Halley Bowman,Imported from Bank of America Visa,,HJ,,2.99,-23791.06
2032,3/8/2021,3/8/2021,Halley Bowman,Imported from Bank of America Visa,,HJ,,3.03,-23794.09
2032,3/8/2021,3/8/2021,Halley Bowman,Imported from Bank of America Visa,,HJ,,3.03,-23797.12
2032,3/8/2021,3/8/2021,Halley Bowman,Imported from Bank of America Visa,,HJ,,4.25,-23801.37
2032,3/8/2021,3/8/2021,Halley Bowman,Imported from Bank of America Visa,,HJ,,4.25,-23805.62
2032,3/8/2021,3/8/2021,Halley Bowman,Imported from Bank of America Visa,,HJ,,4.51,-23810.13
2032,3/8/2021,3/8/2021,Halley Bowman,Imported from Bank of America Visa,,HJ,,4.51,-23814.64
2032,3/8/2021,3/8/2021,Halley Bowman,Imported from Bank of America Visa,,HJ,,4.55,-23819.19
2032,3/8/2021,3/8/2021,Halley Bowman,Imported from Bank of America Visa,,HJ,,4.55,-23823.74
2032,3/8/2021,3/8/2021,Halley Bowman,Imported from Bank of America Visa,,HJ,,4.55,-23828.29
2032,3/8/2021,3/8/2021,Halley Bowman,Imported from Bank of America Visa,,HJ,,4.55,-23832.84
2032,3/8/2021,3/8/2021,Halley Bowman,Imported from Bank of America Visa,,HJ,,4.61,-23837.45
2032,3/8/2021,3/8/2021,Halley Bowman,Imported from Bank of America Visa,,HJ,,4.61,-23842.06
2032,3/8/2021,3/8/2021,Halley Bowman,Imported from Bank of America Visa,,HJ,,4.62,-23846.68
2032,3/8/2021,3/8/2021,Halley Bowman,Imported from Bank of America Visa,,HJ,,4.62,-23851.3
2032,3/8/2021,3/8/2021,Halley Bowman,Imported from Bank of America Visa,,HJ,,4.68,-23855.98
2032,3/8/2021,3/8/2021,Halley Bowman,Imported from Bank of America Visa,,HJ,,4.68,-23860.66
2032,3/8/2021,3/8/2021,Halley Bowman,Imported from Bank of America Visa,,HJ,,4.68,-23865.34
2032,3/8/2021,3/8/2021,Halley Bowman,Imported from Bank of America Visa,,HJ,,4.68,-23870.02
2032,3/8/2021,3/8/2021,Halley Bowman,Imported from Bank of America Visa,,HJ,,13.74,-23883.76
2032,3/8/2021,3/8/2021,Halley Bowman,Imported from Bank of America Visa,,HJ,,14.61,-23898.37
2032,3/8/2021,3/8/2021,Halley Bowman,Imported from Bank of America Visa,,HJ,,14.7,-23913.07
2032,3/8/2021,3/8/2021,Halley Bowman,Imported from Bank of America Visa,,HJ,,14.7,-23927.77
2032,3/8/2021,3/8/2021,Halley Bowman,Imported from Bank of America Visa,,HJ,,14.93,-23942.7
2032,3/8/2021,3/8/2021,Halley Bowman,Imported from Bank of America Visa,,HJ,,14.97,-23957.67
2032,3/8/2021,3/8/2021,Halley Bowman,Imported from Bank of America Visa,,HJ,,15.16,-23972.83
2032,3/8/2021,3/8/2021,Halley Bowman,Imported from Bank of America Visa,,HJ,,15.16,-23987.99
2032,3/8/2021,3/8/2021,Halley Bowman,Imported from Bank of America Visa,,HJ,,26.49,-24014.48
2032,3/8/2021,3/8/2021,Halley Bowman,Imported from Bank of America Visa,,HJ,,26.55,-24041.03
2032,3/8/2021,3/8/2021,Joseph Zarate,Imported from Bank of America Visa,,HJ,,2798,-26839.03
2032,3/8/2021,3/8/2021,Myesha Hossain,Imported from Bank of America Visa,,HJ,,6.99,-26846.02
2032,3/8/2021,3/8/2021,Myesha Hossain,Imported from Bank of America Visa,,HJ,,7.56,-26853.58
2032,3/8/2021,3/8/2021,Myesha Hossain,Imported from Bank of America Visa,,HJ,,8.95,-26862.53
2032,3/8/2021,3/8/2021,Myesha Hossain,Imported from Bank of America Visa,,HJ,,8.99,-26871.52
2032,3/8/2021,3/8/2021,Myesha Hossain,Imported from Bank of America Visa,,HJ,,8.99,-26880.51
2032,3/8/2021,3/8/2021,Myesha Hossain,Imported from Bank of America Visa,,HJ,,14.5,-26895.01
2032,3/8/2021,3/8/2021,Myesha Hossain,Imported from Bank of America Visa,,HJ,,19.76,-26914.77
2032,3/8/2021,3/8/2021,Thomas Fischaber,Imported from Bank of America Visa,,HJ,,59,-26973.77
2032,3/8/2021,3/8/2021,Tiffani Bibb,Imported from Bank of America Visa,,HJ,,16.14,-26989.91
2032,3/8/2021,3/8/2021,Tiffani Bibb,Imported from Bank of America Visa,,HJ,,69.42,-27059.33
2032,3/9/2021,3/9/2021,Joseph Zarate,Imported from Bank of America Visa,,HJ,,13.02,-27072.35
2032,3/9/2021,3/9/2021,Joseph Zarate,Imported from Bank of America Visa,,HJ,,29.94,-27102.29
2032,3/9/2021,3/9/2021,Myesha Hossain,Imported from Bank of America Visa,,HJ,,6.99,-27109.28
2032,3/9/2021,3/9/2021,Myesha Hossain,Imported from Bank of America Visa,,HJ,,6.99,-27116.27
2032,3/9/2021,3/9/2021,Myesha Hossain,Imported from Bank of America Visa,,HJ,,7.45,-27123.72
2032,3/9/2021,3/9/2021,Myesha Hossain,Imported from Bank of America Visa,,HJ,,26.55,-27150.27
2032,3/9/2021,3/9/2021,Myesha Hossain,Imported from Bank of America Visa,,HJ,,59.85,-27210.12
2032,3/9/2021,3/9/2021,Thomas Fischaber,Imported from Bank of America Visa,,HJ,,29.87,-27239.99
2032,3/9/2021,3/9/2021,Uriel Guadarrama,Imported from Bank of America Visa,,HJ,,145.91,-27385.9
2032,3/10/2021,3/10/2021,Alan Safran,Imported from Bank of America Visa,,HJ,,70,-27455.9
2032,3/10/2021,3/10/2021,Antonio Gutierrez,Imported from Bank of America Visa,,HJ,,19.11,-27475.01
2032,3/10/2021,3/10/2021,Antonio Gutierrez,Imported from Bank of America Visa,,HJ,,280.5,-27755.51
2032,3/10/2021,3/10/2021,Antonio Gutierrez,Imported from Bank of America Visa,,HJ,,900,-28655.51
2032,3/10/2021,3/10/2021,Halley Bowman,Imported from Bank of America Visa,,HJ,,3.64,-28659.15
2032,3/10/2021,3/10/2021,Halley Bowman,Imported from Bank of America Visa,,HJ,,3.64,-28662.79
2032,3/10/2021,3/10/2021,Halley Bowman,Imported from Bank of America Visa,,HJ,,5.62,-28668.41
2032,3/10/2021,3/10/2021,Halley Bowman,Imported from Bank of America Visa,,HJ,,5.62,-28674.03
2032,3/10/2021,3/10/2021,Halley Bowman,Imported from Bank of America Visa,,HJ,,5.62,-28679.65
2032,3/10/2021,3/10/2021,Halley Bowman,Imported from Bank of America Visa,,HJ,,5.62,-28685.27
2032,3/10/2021,3/10/2021,Halley Bowman,Imported from Bank of America Visa,,HJ,,18.19,-28703.46
2032,3/10/2021,3/10/2021,Halley Bowman,Imported from Bank of America Visa,,HJ,,18.19,-28721.65
2032,3/10/2021,3/10/2021,Joseph Zarate,Imported from Bank of America Visa,,HJ,,10.33,-28731.98
2032,3/10/2021,3/10/2021,Joseph Zarate,Imported from Bank of America Visa,,HJ,,13.02,-28745
2032,3/10/2021,3/10/2021,Joseph Zarate,Imported from Bank of America Visa,,HJ,,30.42,-28775.42
2032,3/10/2021,3/10/2021,Joseph Zarate,Imported from Bank of America Visa,,HJ,,94.38,-28869.8
2032,3/10/2021,3/10/2021,Joseph Zarate,Imported from Bank of America Visa,,HJ,,119.99,-28989.79
2032,3/10/2021,3/10/2021,Joseph Zarate,Imported from Bank of America Visa,,HJ,,153.66,-29143.45
2032,3/10/2021,3/10/2021,Joseph Zarate,Imported from Bank of America Visa,,HJ,,199.59,-29343.04
2032,3/10/2021,3/10/2021,Joseph Zarate,Imported from Bank of America Visa,,HJ,,488.6,-29831.64
2032,3/10/2021,3/10/2021,Joseph Zarate,Imported from Bank of America Visa,,HJ,,1566.96,-31398.6
2032,3/10/2021,3/10/2021,Joseph Zarate,Imported from Bank of America Visa,,HJ,,4490,-35888.6
2032,3/10/2021,3/10/2021,Mahaliah Sejour,Imported from Bank of America Visa,,HJ,,21.24,-35909.84
2032,3/10/2021,3/10/2021,Maryellen Leneghan,Imported from Bank of America Visa,,HJ,,7.48,-35917.32
2032,3/10/2021,3/10/2021,Maryellen Leneghan,Imported from Bank of America Visa,,HJ,,34.99,-35952.31
2032,3/10/2021,3/10/2021,Maryellen Leneghan,Imported from Bank of America Visa,,HJ,,42.99,-35995.3
2032,3/10/2021,3/10/2021,Monivett Acevedo,Imported from Bank of America Visa,,HJ,,3,-35998.3
2032,3/10/2021,3/10/2021,Monivett Acevedo,Imported from Bank of America Visa,,HJ,,3.5,-36001.8
2032,3/10/2021,3/10/2021,Monivett Acevedo,Imported from Bank of America Visa,,HJ,,9,-36010.8
2032,3/10/2021,3/10/2021,Monivett Acevedo,Imported from Bank of America Visa,,HJ,,9,-36019.8
2032,3/10/2021,3/10/2021,Monivett Acevedo,Imported from Bank of America Visa,,HJ,,12,-36031.8
2032,3/10/2021,3/10/2021,Monivett Acevedo,Imported from Bank of America Visa,,HJ,,14.99,-36046.79
2032,3/10/2021,3/10/2021,Monivett Acevedo,Imported from Bank of America Visa,,HJ,,15,-36061.79
2032,3/10/2021,3/10/2021,Monivett Acevedo,Imported from Bank of America Visa,,HJ,,250,-36311.79
2032,3/10/2021,3/10/2021,Monivett Acevedo,Imported from Bank of America Visa,,HJ,,300,-36611.79
2032,3/10/2021,3/10/2021,Monivett Acevedo,Imported from Bank of America Visa,,HJ,,300,-36911.79
2032,3/10/2021,3/10/2021,Myesha Hossain,Imported from Bank of America Visa,,HJ,,21,-36932.79
2032,3/10/2021,3/10/2021,Myesha Hossain,Imported from Bank of America Visa,,HJ,,24.37,-36957.16
2032,3/10/2021,3/10/2021,Nicole Prahin,Imported from Bank of America Visa,,HJ,,5.35,-36962.51
2032,3/10/2021,3/10/2021,Uriel Guadarrama,Imported from Bank of America Visa,,HJ,81.5,,-36881.01
2032,3/12/2021,3/12/2021,Antonio Gutierrez,Imported from Bank of America Visa,,HJ,,1,-36882.01
2032,3/12/2021,3/12/2021,Antonio Gutierrez,Imported from Bank of America Visa,,HJ,,20.28,-36902.29
2032,3/12/2021,3/12/2021,Antonio Gutierrez,Imported from Bank of America Visa,,HJ,,235.79,-37138.08
2032,3/12/2021,3/12/2021,Joseph Zarate,Imported from Bank of America Visa,,HJ,,8.55,-37146.63
2032,3/12/2021,3/12/2021,Joseph Zarate,Imported from Bank of America Visa,,HJ,,43.8,-37190.43
2032,3/12/2021,3/12/2021,Monivett Acevedo,Imported from Bank of America Visa,,HJ,,4.5,-37194.93
2032,3/12/2021,3/12/2021,Monivett Acevedo,Imported from Bank of America Visa,,HJ,,9,-37203.93
2032,3/12/2021,3/12/2021,Monivett Acevedo,Imported from Bank of America Visa,,HJ,,45,-37248.93
2032,3/12/2021,3/12/2021,Monivett Acevedo,Imported from Bank of America Visa,,HJ,,150,-37398.93
2032,3/12/2021,3/12/2021,Monivett Acevedo,Imported from Bank of America Visa,,HJ,,223.76,-37622.69
2032,3/12/2021,3/12/2021,Myesha Hossain,Imported from Bank of America Visa,,HJ,,4.99,-37627.68
2032,3/12/2021,3/12/2021,Nicole Prahin,Imported from Bank of America Visa,,HJ,,44.39,-37672.07
2032,3/12/2021,3/12/2021,Thomas Fischaber,Imported from Bank of America Visa,,HJ,,9.99,-37682.06
2032,3/13/2021,3/13/2021,Mahaliah Sejour,Imported from Bank of America Visa,,HJ,,12.07,-37694.13
2032,3/13/2021,3/13/2021,Mahaliah Sejour,Imported from Bank of America Visa,,HJ,,12.07,-37706.2
2032,3/13/2021,3/13/2021,Mahaliah Sejour,Imported from Bank of America Visa,,HJ,,12.07,-37718.27
2032,3/13/2021,3/13/2021,Mahaliah Sejour,Imported from Bank of America Visa,,HJ,,12.07,-37730.34
2032,3/13/2021,3/13/2021,Mahaliah Sejour,Imported from Bank of America Visa,,HJ,,12.07,-37742.41
2032,3/13/2021,3/13/2021,Maryellen Leneghan,Imported from Bank of America Visa,,HJ,,7.68,-37750.09
2032,3/13/2021,3/13/2021,Tiffani Bibb,Imported from Bank of America Visa,,HJ,,26.07,-37776.16
2032,3/15/2021,3/15/2021,Halley Bowman,Imported from Bank of America Visa,,HJ,,1.63,-37777.79
2032,3/15/2021,3/15/2021,Halley Bowman,Imported from Bank of America Visa,,HJ,,2.51,-37780.3
2032,3/15/2021,3/15/2021,Halley Bowman,Imported from Bank of America Visa,,HJ,,2.51,-37782.81
2032,3/15/2021,3/15/2021,Halley Bowman,Imported from Bank of America Visa,,HJ,,8.14,-37790.95
2032,3/15/2021,3/15/2021,Joseph Zarate,Imported from Bank of America Visa,,HJ,,117.09,-37908.04
2032,3/15/2021,3/15/2021,Maryellen Leneghan,Imported from Bank of America Visa,,HJ,,6.98,-37915.02
2032,3/15/2021,3/15/2021,Maryellen Leneghan,Imported from Bank of America Visa,,HJ,,7.99,-37923.01
2032,3/15/2021,3/15/2021,Monivett Acevedo,Imported from Bank of America Visa,,HJ,,51.38,-37974.39
2032,3/15/2021,3/15/2021,Monivett Acevedo,Imported from Bank of America Visa,,HJ,,51.38,-38025.77
2032,3/15/2021,3/15/2021,Monivett Acevedo,Imported from Bank of America Visa,,HJ,,51.5,-38077.27
2032,3/16/2021,3/16/2021,Antonio Gutierrez,Imported from Bank of America Visa,,HJ,,900,-38977.27
2032,3/16/2021,3/16/2021,Joseph Zarate,Imported from Bank of America Visa,,HJ,,10.19,-38987.46
2032,3/16/2021,3/16/2021,Joseph Zarate,Imported from Bank of America Visa,,HJ,,13.39,-39000.85
2032,3/16/2021,3/16/2021,Joseph Zarate,Imported from Bank of America Visa,,HJ,,174.72,-39175.57
2032,3/16/2021,3/16/2021,Joseph Zarate,Imported from Bank of America Visa,,HJ,,176.62,-39352.19
2032,3/16/2021,3/16/2021,Joseph Zarate,Imported from Bank of America Visa,,HJ,,193.77,-39545.96
2032,3/16/2021,3/16/2021,Joseph Zarate,Imported from Bank of America Visa,,HJ,,193.78,-39739.74
2032,3/16/2021,3/16/2021,Joseph Zarate,Imported from Bank of America Visa,,HJ,,373.89,-40113.63
2032,3/16/2021,3/16/2021,Joseph Zarate,Imported from Bank of America Visa,,HJ,,1207.38,-41321.01
2032,3/16/2021,3/16/2021,Mahaliah Sejour,Imported from Bank of America Visa,,HJ,,5.35,-41326.36
2032,3/16/2021,3/16/2021,Mahaliah Sejour,Imported from Bank of America Visa,,HJ,,11.99,-41338.35
2032,3/16/2021,3/16/2021,Thomas Fischaber,Imported from Bank of America Visa,,HJ,,121.05,-41459.4
2032,3/16/2021,3/16/2021,Uriel Guadarrama,Imported from Bank of America Visa,,HJ,72.27,,-41387.13
2032,3/17/2021,3/17/2021,Antonio Gutierrez,Imported from Bank of America Visa,,HJ,,4,-41391.13
2032,3/17/2021,3/17/2021,Joseph Zarate,Imported from Bank of America Visa,,HJ,13.39,,-41377.74
2032,3/17/2021,3/17/2021,Joseph Zarate,Imported from Bank of America Visa,,HJ,,26.69,-41404.43
2032,3/17/2021,3/17/2021,Joseph Zarate,Imported from Bank of America Visa,,HJ,,212.24,-41616.67
2032,3/17/2021,3/17/2021,Mahaliah Sejour,Imported from Bank of America Visa,,HJ,9.99,,-41606.68
2032,3/17/2021,3/17/2021,Mahaliah Sejour,Imported from Bank of America Visa,,HJ,,13.97,-41620.65
2032,3/17/2021,3/17/2021,Mahaliah Sejour,Imported from Bank of America Visa,,HJ,,21.35,-41642
2032,3/17/2021,3/17/2021,Mahaliah Sejour,Imported from Bank of America Visa,,HJ,,32.78,-41674.78
2032,3/17/2021,3/17/2021,Monivett Acevedo,Imported from Bank of America Visa,,HJ,,50,-41724.78
2032,3/17/2021,3/17/2021,Monivett Acevedo,Imported from Bank of America Visa,,HJ,,50,-41774.78
2032,3/17/2021,3/17/2021,Monivett Acevedo,Imported from Bank of America Visa,,HJ,,50,-41824.78
2032,3/17/2021,3/17/2021,Myesha Hossain,Imported from Bank of America Visa,,HJ,,6.99,-41831.77
2032,3/17/2021,3/17/2021,Myesha Hossain,Imported from Bank of America Visa,,HJ,,9,-41840.77
2032,3/17/2021,3/17/2021,Myesha Hossain,Imported from Bank of America Visa,,HJ,,15,-41855.77
2032,3/17/2021,3/17/2021,Nicole Prahin,Imported from Bank of America Visa,,HJ,,2.17,-41857.94
2032,3/18/2021,3/18/2021,Antonio Gutierrez,Imported from Bank of America Visa,,HJ,,15.93,-41873.87
2032,3/18/2021,3/18/2021,Halley Bowman,Imported from Bank of America Visa,,HJ,,8.69,-41882.56
2032,3/18/2021,3/18/2021,Halley Bowman,Imported from Bank of America Visa,,HJ,,13.43,-41895.99
2032,3/18/2021,3/18/2021,Halley Bowman,Imported from Bank of America Visa,,HJ,,13.43,-41909.42
2032,3/18/2021,3/18/2021,Halley Bowman,Imported from Bank of America Visa,,HJ,,43.45,-41952.87
2032,3/18/2021,3/18/2021,Joseph Zarate,Imported from Bank of America Visa,,HJ,,7.99,-41960.86
2032,3/18/2021,3/18/2021,Joseph Zarate,Imported from Bank of America Visa,,HJ,7.99,,-41952.87
2032,3/18/2021,3/18/2021,Joseph Zarate,Imported from Bank of America Visa,,HJ,10.33,,-41942.54
2032,3/18/2021,3/18/2021,Joseph Zarate,Imported from Bank of America Visa,,HJ,,13.99,-41956.53
2032,3/18/2021,3/18/2021,Joseph Zarate,Imported from Bank of America Visa,,HJ,,29.31,-41985.84
2032,3/18/2021,3/18/2021,Joseph Zarate,Imported from Bank of America Visa,,HJ,29.31,,-41956.53
2032,3/18/2021,3/18/2021,Joseph Zarate,Imported from Bank of America Visa,,HJ,,31.84,-41988.37
2032,3/18/2021,3/18/2021,Joseph Zarate,Imported from Bank of America Visa,,HJ,31.84,,-41956.53
2032,3/18/2021,3/18/2021,Joseph Zarate,Imported from Bank of America Visa,,HJ,,34.99,-41991.52
2032,3/18/2021,3/18/2021,Joseph Zarate,Imported from Bank of America Visa,,HJ,,119.61,-42111.13
2032,3/18/2021,3/18/2021,Mahaliah Sejour,Imported from Bank of America Visa,,HJ,,15.24,-42126.37
2032,3/18/2021,3/18/2021,Mahaliah Sejour,Imported from Bank of America Visa,,HJ,,15.99,-42142.36
2032,3/18/2021,3/18/2021,Mahaliah Sejour,Imported from Bank of America Visa,,HJ,,99.89,-42242.25
2032,3/18/2021,3/18/2021,Myesha Hossain,Imported from Bank of America Visa,,HJ,,11,-42253.25
2032,3/18/2021,3/18/2021,Myesha Hossain,Imported from Bank of America Visa,,HJ,,12,-42265.25
2032,3/18/2021,3/18/2021,Myesha Hossain,Imported from Bank of America Visa,,HJ,,12,-42277.25
2032,3/18/2021,3/18/2021,Myesha Hossain,Imported from Bank of America Visa,,HJ,,12,-42289.25
2032,3/18/2021,3/18/2021,Myesha Hossain,Imported from Bank of America Visa,,HJ,,12.8,-42302.05
2032,3/18/2021,3/18/2021,Nicole Prahin,Imported from Bank of America Visa,,HJ,,79,-42381.05
2032,3/18/2021,3/18/2021,Tiffani Bibb,Imported from Bank of America Visa,,HJ,,109.78,-42490.83
2032,3/19/2021,3/19/2021,Alan Safran,Imported from Bank of America Visa,,HJ,,29.74,-42520.57
2032,3/19/2021,3/19/2021,Alan Safran,Imported from Bank of America Visa,,HJ,,45.94,-42566.51
2032,3/19/2021,3/19/2021,Alan Safran,Imported from Bank of America Visa,,HJ,,240.4,-42806.91
2032,3/19/2021,3/19/2021,Antonio Gutierrez,Imported from Bank of America Visa,,HJ,,97.66,-42904.57
2032,3/19/2021,3/19/2021,Antonio Gutierrez,Imported from Bank of America Visa,,HJ,,378.98,-43283.55
2032,3/19/2021,3/19/2021,Antonio Gutierrez,Imported from Bank of America Visa,,HJ,,1446.8,-44730.35
2032,3/19/2021,3/19/2021,Elizabeth Peinado,Imported from Bank of America Visa,,HJ,,511.5,-45241.85
2032,3/19/2021,3/19/2021,Elizabeth Peinado,Imported from Bank of America Visa,,HJ,,790.5,-46032.35
2032,3/19/2021,3/19/2021,Elizabeth Peinado,Imported from Bank of America Visa,,HJ,,790.5,-46822.85
2032,3/19/2021,3/19/2021,Elizabeth Peinado,Imported from Bank of America Visa,,HJ,,2557.5,-49380.35
2032,3/19/2021,3/19/2021,Joseph Zarate,Imported from Bank of America Visa,,HJ,,9.33,-49389.68
2032,3/19/2021,3/19/2021,Joseph Zarate,Imported from Bank of America Visa,,HJ,,10.97,-49400.65
2032,3/19/2021,3/19/2021,Joseph Zarate,Imported from Bank of America Visa,,HJ,10.97,,-49389.68
2032,3/19/2021,3/19/2021,Joseph Zarate,Imported from Bank of America Visa,,HJ,,171.66,-49561.34
2032,3/19/2021,3/19/2021,Joseph Zarate,Imported from Bank of America Visa,,HJ,,326.73,-49888.07
2032,3/19/2021,3/19/2021,Joseph Zarate,Imported from Bank of America Visa,,HJ,,1339.38,-51227.45
2032,3/19/2021,3/19/2021,Mahaliah Sejour,Imported from Bank of America Visa,,HJ,10.99,,-51216.46
2032,3/19/2021,3/19/2021,Tiffany Jordan,Imported from Bank of America Visa,,HJ,,111.01,-51327.47
2032,3/22/2021,3/22/2021,Antonio Gutierrez,Imported from Bank of America Visa,,HJ,,100,-51427.47
2032,3/22/2021,3/22/2021,Joseph Zarate,Imported from Bank of America Visa,,HJ,,15.62,-51443.09
2032,3/22/2021,3/22/2021,Joseph Zarate,Imported from Bank of America Visa,,HJ,,15.62,-51458.71
2032,3/22/2021,3/22/2021,Joseph Zarate,Imported from Bank of America Visa,,HJ,,46.88,-51505.59
2032,3/22/2021,3/22/2021,Joseph Zarate,Imported from Bank of America Visa,,HJ,,46.95,-51552.54
2032,3/22/2021,3/22/2021,Joseph Zarate,Imported from Bank of America Visa,,HJ,,119.96,-51672.5
2032,3/22/2021,3/22/2021,Mahaliah Sejour,Imported from Bank of America Visa,,HJ,,16.97,-51689.47
2032,3/22/2021,3/22/2021,Mahaliah Sejour,Imported from Bank of America Visa,,HJ,,16.97,-51706.44
2032,3/22/2021,3/22/2021,Mahaliah Sejour,Imported from Bank of America Visa,,HJ,,16.97,-51723.41
2032,3/22/2021,3/22/2021,Mahaliah Sejour,Imported from Bank of America Visa,,HJ,,16.97,-51740.38
2032,3/22/2021,3/22/2021,Mahaliah Sejour,Imported from Bank of America Visa,,HJ,,16.97,-51757.35
2032,3/22/2021,3/22/2021,Mahaliah Sejour,Imported from Bank of America Visa,,HJ,,16.97,-51774.32
2032,3/22/2021,3/22/2021,Mahaliah Sejour,Imported from Bank of America Visa,,HJ,,24.99,-51799.31
2032,3/22/2021,3/22/2021,Mahaliah Sejour,Imported from Bank of America Visa,,HJ,,26.49,-51825.8
2032,3/22/2021,3/22/2021,Mahaliah Sejour,Imported from Bank of America Visa,,HJ,,26.55,-51852.35
2032,3/22/2021,3/22/2021,Mahaliah Sejour,Imported from Bank of America Visa,,HJ,,26.98,-51879.33
2032,3/22/2021,3/22/2021,Mahaliah Sejour,Imported from Bank of America Visa,,HJ,26.98,,-51852.35
2032,3/22/2021,3/22/2021,Mahaliah Sejour,Imported from Bank of America Visa,,HJ,,27.24,-51879.59
2032,3/22/2021,3/22/2021,Mahaliah Sejour,Imported from Bank of America Visa,,HJ,,27.3,-51906.89
2032,3/22/2021,3/22/2021,Mahaliah Sejour,Imported from Bank of America Visa,,HJ,,27.36,-51934.25
2032,3/22/2021,3/22/2021,Mahaliah Sejour,Imported from Bank of America Visa,,HJ,,27.55,-51961.8
2032,3/22/2021,3/22/2021,Mahaliah Sejour,Imported from Bank of America Visa,,HJ,,27.55,-51989.35
2032,3/22/2021,3/22/2021,Mahaliah Sejour,Imported from Bank of America Visa,,HJ,,27.55,-52016.9
2032,3/22/2021,3/22/2021,Mahaliah Sejour,Imported from Bank of America Visa,,HJ,,27.55,-52044.45
2032,3/22/2021,3/22/2021,Mahaliah Sejour,Imported from Bank of America Visa,,HJ,,27.55,-52072
2032,3/22/2021,3/22/2021,Mahaliah Sejour,Imported from Bank of America Visa,,HJ,,27.55,-52099.55
2032,3/22/2021,3/22/2021,Mahaliah Sejour,Imported from Bank of America Visa,,HJ,,27.55,-52127.1
2032,3/22/2021,3/22/2021,Mahaliah Sejour,Imported from Bank of America Visa,,HJ,,139.98,-52267.08
2032,3/22/2021,3/22/2021,Monivett Acevedo,Imported from Bank of America Visa,,HJ,,49.99,-52317.07
2032,3/22/2021,3/22/2021,Monivett Acevedo,Imported from Bank of America Visa,,HJ,,130,-52447.07
2032,3/22/2021,3/22/2021,Myesha Hossain,Imported from Bank of America Visa,,HJ,,177.95,-52625.02
2032,3/22/2021,3/22/2021,Nicole Prahin,Imported from Bank of America Visa,,HJ,,139.93,-52764.95
2032,3/22/2021,3/22/2021,Nicole Prahin,Imported from Bank of America Visa,,HJ,,139.93,-52904.88
2032,3/22/2021,3/22/2021,Nicole Prahin,Imported from Bank of America Visa,,HJ,139.93,,-52764.95
2032,3/22/2021,3/22/2021,Tiffani Bibb,Imported from Bank of America Visa,,HJ,,78,-52842.95
2032,3/24/2021,3/24/2021,Alan Safran,Imported from Bank of America Visa,,HJ,,50.5,-52893.45
2032,3/24/2021,3/24/2021,Antonio Gutierrez,Imported from Bank of America Visa,,HJ,,19.34,-52912.79
2032,3/24/2021,3/24/2021,Antonio Gutierrez,Imported from Bank of America Visa,,HJ,,42.49,-52955.28
2032,3/24/2021,3/24/2021,Antonio Gutierrez,Imported from Bank of America Visa,,HJ,,42.5,-52997.78
2032,3/24/2021,3/24/2021,Antonio Gutierrez,Imported from Bank of America Visa,,HJ,,900,-53897.78
2032,3/24/2021,3/24/2021,claice Jackson,Imported from Bank of America Visa,,HJ,,67.45,-53965.23
2032,3/24/2021,3/24/2021,Halley Bowman,Imported from Bank of America Visa,,HJ,,1.75,-53966.98
2032,3/24/2021,3/24/2021,Halley Bowman,Imported from Bank of America Visa,,HJ,,2.7,-53969.68
2032,3/24/2021,3/24/2021,Halley Bowman,Imported from Bank of America Visa,,HJ,,2.7,-53972.38
2032,3/24/2021,3/24/2021,Halley Bowman,Imported from Bank of America Visa,,HJ,,8.74,-53981.12
2032,3/24/2021,3/24/2021,iaklestad,Imported from Bank of America Visa,,HJ,,50.85,-54031.97
2032,3/24/2021,3/24/2021,Joseph Zarate,Imported from Bank of America Visa,,HJ,7.03,,-54024.94
2032,3/24/2021,3/24/2021,Joseph Zarate,Imported from Bank of America Visa,,HJ,,13.9,-54038.84
2032,3/24/2021,3/24/2021,Joseph Zarate,Imported from Bank of America Visa,,HJ,,25.33,-54064.17
2032,3/24/2021,3/24/2021,Joseph Zarate,Imported from Bank of America Visa,,HJ,,51.42,-54115.59
2032,3/24/2021,3/24/2021,Joseph Zarate,Imported from Bank of America Visa,,HJ,,74.98,-54190.57
2032,3/24/2021,3/24/2021,Joseph Zarate,Imported from Bank of America Visa,,HJ,,139.46,-54330.03
2032,3/24/2021,3/24/2021,Joseph Zarate,Imported from Bank of America Visa,,HJ,,1349.99,-55680.02
2032,3/24/2021,3/24/2021,Mahaliah Sejour,Imported from Bank of America Visa,,HJ,,1.99,-55682.01
2032,3/24/2021,3/24/2021,Mahaliah Sejour,Imported from Bank of America Visa,,HJ,,16.97,-55698.98
2032,3/24/2021,3/24/2021,Mahaliah Sejour,Imported from Bank of America Visa,,HJ,,16.97,-55715.95
2032,3/24/2021,3/24/2021,Mahaliah Sejour,Imported from Bank of America Visa,,HJ,,16.97,-55732.92
2032,3/24/2021,3/24/2021,Mahaliah Sejour,Imported from Bank of America Visa,,HJ,,16.97,-55749.89
2032,3/24/2021,3/24/2021,Mahaliah Sejour,Imported from Bank of America Visa,,HJ,,16.97,-55766.86
2032,3/24/2021,3/24/2021,Mahaliah Sejour,Imported from Bank of America Visa,,HJ,,16.97,-55783.83
2032,3/24/2021,3/24/2021,Mahaliah Sejour,Imported from Bank of America Visa,,HJ,,23.89,-55807.72
2032,3/24/2021,3/24/2021,Mahaliah Sejour,Imported from Bank of America Visa,,HJ,,23.89,-55831.61
2032,3/24/2021,3/24/2021,Mahaliah Sejour,Imported from Bank of America Visa,,HJ,,23.89,-55855.5
2032,3/24/2021,3/24/2021,Mahaliah Sejour,Imported from Bank of America Visa,,HJ,,23.89,-55879.39
2032,3/24/2021,3/24/2021,Mahaliah Sejour,Imported from Bank of America Visa,,HJ,,23.89,-55903.28
2032,3/24/2021,3/24/2021,Mahaliah Sejour,Imported from Bank of America Visa,,HJ,,23.89,-55927.17
2032,3/24/2021,3/24/2021,Mahaliah Sejour,Imported from Bank of America Visa,,HJ,,42.94,-55970.11
2032,3/24/2021,3/24/2021,Mahaliah Sejour,Imported from Bank of America Visa,,HJ,,42.94,-56013.05
2032,3/24/2021,3/24/2021,Mahaliah Sejour,Imported from Bank of America Visa,,HJ,,42.94,-56055.99
2032,3/24/2021,3/24/2021,Mahaliah Sejour,Imported from Bank of America Visa,,HJ,,42.94,-56098.93
2032,3/24/2021,3/24/2021,Mahaliah Sejour,Imported from Bank of America Visa,,HJ,,42.94,-56141.87
2032,3/24/2021,3/24/2021,Mahaliah Sejour,Imported from Bank of America Visa,,HJ,,42.94,-56184.81
2032,3/24/2021,3/24/2021,Mahaliah Sejour,Imported from Bank of America Visa,,HJ,,42.94,-56227.75
2032,3/24/2021,3/24/2021,Mahaliah Sejour,Imported from Bank of America Visa,,HJ,,42.94,-56270.69
2032,3/24/2021,3/24/2021,Mahaliah Sejour,Imported from Bank of America Visa,,HJ,,42.94,-56313.63
2032,3/24/2021,3/24/2021,Mahaliah Sejour,Imported from Bank of America Visa,,HJ,,42.94,-56356.57
2032,3/24/2021,3/24/2021,Mahaliah Sejour,Imported from Bank of America Visa,,HJ,,42.94,-56399.51
2032,3/24/2021,3/24/2021,Mahaliah Sejour,Imported from Bank of America Visa,,HJ,,42.94,-56442.45
2032,3/24/2021,3/24/2021,Mahaliah Sejour,Imported from Bank of America Visa,,HJ,,42.94,-56485.39
2032,3/24/2021,3/24/2021,Mahaliah Sejour,Imported from Bank of America Visa,,HJ,,42.94,-56528.33
2032,3/24/2021,3/24/2021,Mahaliah Sejour,Imported from Bank of America Visa,,HJ,,42.94,-56571.27
2032,3/24/2021,3/24/2021,Mahaliah Sejour,Imported from Bank of America Visa,,HJ,,42.94,-56614.21
2032,3/24/2021,3/24/2021,Mahaliah Sejour,Imported from Bank of America Visa,,HJ,,42.94,-56657.15
2032,3/24/2021,3/24/2021,Mahaliah Sejour,Imported from Bank of America Visa,,HJ,,45.95,-56703.1
2032,3/24/2021,3/24/2021,Mahaliah Sejour,Imported from Bank of America Visa,,HJ,,99.06,-56802.16
2032,3/24/2021,3/24/2021,Maryellen Leneghan,Imported from Bank of America Visa,,HJ,,6.99,-56809.15
2032,3/24/2021,3/24/2021,Maryellen Leneghan,Imported from Bank of America Visa,,HJ,,6.99,-56816.14
2032,3/24/2021,3/24/2021,Maryellen Leneghan,Imported from Bank of America Visa,,HJ,,19.92,-56836.06
2032,3/24/2021,3/24/2021,Maryellen Leneghan,Imported from Bank of America Visa,,HJ,,60.15,-56896.21
2032,3/24/2021,3/24/2021,Monivett Acevedo,Imported from Bank of America Visa,,HJ,,21.24,-56917.45
2032,3/24/2021,3/24/2021,Monivett Acevedo,Imported from Bank of America Visa,,HJ,,125,-57042.45
2032,3/24/2021,3/24/2021,Monivett Acevedo,Imported from Bank of America Visa,,HJ,,130,-57172.45
2032,3/24/2021,3/24/2021,Monivett Acevedo,Imported from Bank of America Visa,,HJ,,225,-57397.45
2032,3/24/2021,3/24/2021,Myesha Hossain,Imported from Bank of America Visa,,HJ,,15.99,-57413.44
2032,3/24/2021,3/24/2021,Nicole Prahin,Imported from Bank of America Visa,,HJ,,80,-57493.44
2032,3/24/2021,3/24/2021,Thomas Fischaber,Imported from Bank of America Visa,,HJ,,40.78,-57534.22
2032,3/24/2021,3/24/2021,Thomas Fischaber,Imported from Bank of America Visa,,HJ,,94,-57628.22
2032,3/24/2021,3/24/2021,Thomas Fischaber,Imported from Bank of America Visa,,HJ,,209.94,-57838.16
2032,3/24/2021,3/24/2021,Thomas Fischaber,Imported from Bank of America Visa,,HJ,,2395.04,-60233.2
2032,3/24/2021,3/24/2021,Tiffani Bibb,Imported from Bank of America Visa,,HJ,,146.85,-60380.05
2032,3/24/2021,3/24/2021,Uriel Guadarrama,Imported from Bank of America Visa,,HJ,,15.93,-60395.98
2032,3/24/2021,3/24/2021,Uriel Guadarrama,Imported from Bank of America Visa,,HJ,,31.85,-60427.83
2032,3/24/2021,3/24/2021,Uriel Guadarrama,Imported from Bank of America Visa,,HJ,,31.85,-60459.68
2032,3/31/2021,3/31/2021,Alan Safran,Imported from Bank of America Visa,,HJ,,36.5,-60496.18
2032,3/31/2021,3/31/2021,Antonio Gutierrez,Imported from Bank of America Visa,,HJ,,98.94,-60595.12
2032,3/31/2021,3/31/2021,iaklestad,Imported from Bank of America Visa,,HJ,,25.05,-60620.17
2032,3/31/2021,3/31/2021,Joseph Zarate,Imported from Bank of America Visa,,HJ,,11.55,-60631.72
2032,3/31/2021,3/31/2021,Joseph Zarate,Imported from Bank of America Visa,,HJ,,1355.38,-61987.1
2032,3/31/2021,3/31/2021,Maryellen Leneghan,Imported from Bank of America Visa,,HJ,,9.59,-61996.69
2032,3/31/2021,3/31/2021,Myesha Hossain,Imported from Bank of America Visa,,HJ,,20.4,-62017.09
2032,4/1/2021,4/1/2021,Alan Safran,Imported from Bank of America Visa,,HJ,,15,-62032.09
2032,4/1/2021,4/1/2021,Alan Safran,Imported from Bank of America Visa,,HJ,,13,-62045.09
2032,4/1/2021,4/1/2021,Amena Wallace,Imported from Bank of America Visa,,HJ,,14.95,-62060.04
2032,4/1/2021,4/1/2021,Antonio Gutierrez,Imported from Bank of America Visa,,HJ,,183.58,-62243.62
2032,4/1/2021,4/1/2021,Antonio Gutierrez,Imported from Bank of America Visa,,HJ,,780.92,-63024.54
2032,4/1/2021,4/1/2021,Antonio Gutierrez,Imported from Bank of America Visa,,HJ,,19.11,-63043.65
2032,4/1/2021,4/1/2021,claice Jackson,Imported from Bank of America Visa,,HJ,67.45,,-62976.2
2032,4/1/2021,4/1/2021,Denise Parham-Gantt,Imported from Bank of America Visa,,HJ,,84,-63060.2
2032,4/1/2021,4/1/2021,Elizabeth Peinado,Imported from Bank of America Visa,,HJ,,550,-63610.2
2032,4/1/2021,4/1/2021,Elizabeth Peinado,Imported from Bank of America Visa,,HJ,,850,-64460.2
2032,4/1/2021,4/1/2021,Elizabeth Peinado,Imported from Bank of America Visa,,HJ,,850,-65310.2
2032,4/1/2021,4/1/2021,Elizabeth Peinado,Imported from Bank of America Visa,,HJ,,2750,-68060.2
2032,4/1/2021,4/1/2021,iaklestad,Imported from Bank of America Visa,,HJ,,19.65,-68079.85
2032,4/1/2021,4/1/2021,Joseph Zarate,Imported from Bank of America Visa,,HJ,,15.48,-68095.33
2032,4/1/2021,4/1/2021,Joseph Zarate,Imported from Bank of America Visa,,HJ,,20.13,-68115.46
2032,4/1/2021,4/1/2021,Joseph Zarate,Imported from Bank of America Visa,,HJ,,307.97,-68423.43
2032,4/1/2021,4/1/2021,Joseph Zarate,Imported from Bank of America Visa,,HJ,,317.97,-68741.4
2032,4/1/2021,4/1/2021,Mahaliah Sejour,Imported from Bank of America Visa,,HJ,,13.77,-68755.17
2032,4/1/2021,4/1/2021,Mahaliah Sejour,Imported from Bank of America Visa,,HJ,,21.24,-68776.41
2032,4/1/2021,4/1/2021,Mahaliah Sejour,Imported from Bank of America Visa,,HJ,,41.88,-68818.29
2032,4/1/2021,4/1/2021,Mahaliah Sejour,Imported from Bank of America Visa,,HJ,,42.94,-68861.23
2032,4/1/2021,4/1/2021,Maryellen Leneghan,Imported from Bank of America Visa,,HJ,,29.89,-68891.12
2032,4/1/2021,4/1/2021,Nicole Prahin,Imported from Bank of America Visa,,HJ,,51.39,-68942.51
2032,4/1/2021,4/1/2021,Thomas Fischaber,Imported from Bank of America Visa,,HJ,,9.99,-68952.5
2032,4/1/2021,4/1/2021,Thomas Fischaber,Imported from Bank of America Visa,,HJ,,800,-69752.5
2032,4/1/2021,4/1/2021,Thomas Fischaber,Imported from Bank of America Visa,,HJ,,82.21,-69834.71
2032,4/1/2021,4/1/2021,Thomas Fischaber,Imported from Bank of America Visa,,HJ,,238,-70072.71
2032,4/1/2021,4/1/2021,Thomas Fischaber,Imported from Bank of America Visa,,HJ,,700,-70772.71
2032,4/1/2021,4/1/2021,Tiffani Bibb,Imported from Bank of America Visa,,HJ,,6.06,-70778.77
2032,4/1/2021,4/1/2021,Tiffani Bibb,Imported from Bank of America Visa,,HJ,,57.92,-70836.69
2032,4/2/2021,4/2/2021,Antonio Gutierrez,Imported from Bank of America Visa,,HJ,,27.95,-70864.64
2032,4/2/2021,4/2/2021,Antonio Gutierrez,Imported from Bank of America Visa,,HJ,,900,-71764.64
2032,4/2/2021,4/2/2021,Elizabeth Peinado,Imported from Bank of America Visa,,HJ,,330,-72094.64
2032,4/2/2021,4/2/2021,Elizabeth Peinado,Imported from Bank of America Visa,,HJ,,510,-72604.64
2032,4/2/2021,4/2/2021,Elizabeth Peinado,Imported from Bank of America Visa,,HJ,,510,-73114.64
2032,4/2/2021,4/2/2021,Elizabeth Peinado,Imported from Bank of America Visa,,HJ,,1650,-74764.64
2032,4/2/2021,4/2/2021,Joseph Zarate,Imported from Bank of America Visa,,HJ,,3024.54,-77789.18
2032,4/2/2021,4/2/2021,Joseph Zarate,Imported from Bank of America Visa,,HJ,,25.57,-77814.75
2032,4/2/2021,4/2/2021,Joseph Zarate,Imported from Bank of America Visa,,HJ,,52.38,-77867.13
2032,4/2/2021,4/2/2021,Mahaliah Sejour,Imported from Bank of America Visa,,HJ,,149,-78016.13
2032,4/2/2021,4/2/2021,Mahaliah Sejour,Imported from Bank of America Visa,,HJ,,173,-78189.13
2032,4/2/2021,4/2/2021,Myesha Hossain,Imported from Bank of America Visa,,HJ,,9.79,-78198.92
2032,4/2/2021,4/2/2021,Myesha Hossain,Imported from Bank of America Visa,,HJ,,14.99,-78213.91
2032,4/2/2021,4/2/2021,Myesha Hossain,Imported from Bank of America Visa,,HJ,,20,-78233.91
2032,4/2/2021,4/2/2021,Myesha Hossain,Imported from Bank of America Visa,,HJ,,37.84,-78271.75
2032,4/2/2021,4/2/2021,Thomas Fischaber,Imported from Bank of America Visa,,HJ,,19.94,-78291.69
2032,4/5/2021,4/5/2021,Alan Safran,Imported from Bank of America Visa,,HJ,,51.5,-78343.19
2032,4/5/2021,4/5/2021,Antonio Gutierrez,Imported from Bank of America Visa,,HJ,,900,-79243.19
2032,4/5/2021,4/5/2021,Bank of America VISA,BofA Concur Payment,,HJ,405.04,,-78838.15
2032,4/5/2021,4/5/2021,Bank of America VISA,BofA Concur Payment,,HJ,1570.32,,-77267.83
2032,4/5/2021,4/5/2021,Bank of America VISA,BofA Concur Payment,,HJ,2058.86,,-75208.97
2032,4/5/2021,4/5/2021,Bank of America VISA,BofA Concur Payment,,HJ,3292.13,,-71916.84
2032,4/5/2021,4/5/2021,Bank of America VISA,BofA Concur Payment,,HJ,3561.09,,-68355.75
2032,4/5/2021,4/5/2021,Bank of America VISA,BofA Concur Payment,,HJ,4007.11,,-64348.64
2032,4/5/2021,4/5/2021,Bank of America VISA,BofA Concur Payment,,HJ,13957.63,,-50391.01
2032,4/5/2021,4/5/2021,Bank of America VISA,BofA Concur Payment,,HJ,13963.61,,-36427.4
2032,4/5/2021,4/5/2021,Bank of America VISA,BofA Concur Payment,,HJ,19201.3,,-17226.1
2032,4/5/2021,4/5/2021,Jennifer Winans,Imported from Bank of America Visa,,HJ,,100,-17326.1
2032,4/5/2021,4/5/2021,Joseph Zarate,Imported from Bank of America Visa,,HJ,13.9,,-17312.2
2032,4/5/2021,4/5/2021,Joseph Zarate,Imported from Bank of America Visa,,HJ,,12578,-29890.2
2032,4/5/2021,4/5/2021,Mahaliah Sejour,Imported from Bank of America Visa,,HJ,,23.95,-29914.15
2032,4/5/2021,4/5/2021,Mahaliah Sejour,Imported from Bank of America Visa,,HJ,,23.95,-29938.1
2032,4/5/2021,4/5/2021,Mahaliah Sejour,Imported from Bank of America Visa,,HJ,,24.34,-29962.44
2032,4/5/2021,4/5/2021,Mahaliah Sejour,Imported from Bank of America Visa,,HJ,,22.48,-29984.92
2032,4/5/2021,4/5/2021,Mahaliah Sejour,Imported from Bank of America Visa,,HJ,,22.48,-30007.4
2032,4/5/2021,4/5/2021,Mahaliah Sejour,Imported from Bank of America Visa,,HJ,,22.48,-30029.88
2032,4/5/2021,4/5/2021,Mahaliah Sejour,Imported from Bank of America Visa,,HJ,,22.48,-30052.36
2032,4/5/2021,4/5/2021,Mahaliah Sejour,Imported from Bank of America Visa,,HJ,,22.48,-30074.84
2032,4/5/2021,4/5/2021,Mahaliah Sejour,Imported from Bank of America Visa,,HJ,,22.48,-30097.32
2032,4/5/2021,4/5/2021,Mahaliah Sejour,Imported from Bank of America Visa,,HJ,,22.48,-30119.8
2032,4/5/2021,4/5/2021,Mahaliah Sejour,Imported from Bank of America Visa,,HJ,,23.95,-30143.75
2032,4/5/2021,4/5/2021,Mahaliah Sejour,Imported from Bank of America Visa,,HJ,,23.95,-30167.7
2032,4/5/2021,4/5/2021,Mahaliah Sejour,Imported from Bank of America Visa,,HJ,,23.95,-30191.65
2032,4/5/2021,4/5/2021,Mahaliah Sejour,Imported from Bank of America Visa,,HJ,,23.95,-30215.6
2032,4/5/2021,4/5/2021,Mahaliah Sejour,Imported from Bank of America Visa,,HJ,,24.96,-30240.56
2032,4/5/2021,4/5/2021,Monivett Acevedo,Imported from Bank of America Visa,,HJ,,6,-30246.56
2032,4/5/2021,4/5/2021,Myesha Hossain,Imported from Bank of America Visa,,HJ,,13.96,-30260.52
2032,4/5/2021,4/5/2021,Myesha Hossain,Imported from Bank of America Visa,,HJ,,43.18,-30303.7
2032,4/5/2021,4/5/2021,Thomas Fischaber,Imported from Bank of America Visa,,HJ,,572.88,-30876.58
2032,4/7/2021,4/7/2021,Angela Mason,Imported from Bank of America Visa,,HJ,,32.69,-30909.27
2032,4/7/2021,4/7/2021,Denise Parham-Gantt,Imported from Bank of America Visa,,HJ,,85.49,-30994.76
2032,4/7/2021,4/7/2021,Halley Bowman,Imported from Bank of America Visa,,HJ,,4.74,-30999.5
2032,4/7/2021,4/7/2021,Halley Bowman,Imported from Bank of America Visa,,HJ,,7.33,-31006.83
2032,4/7/2021,4/7/2021,Halley Bowman,Imported from Bank of America Visa,,HJ,,7.33,-31014.16
2032,4/7/2021,4/7/2021,Halley Bowman,Imported from Bank of America Visa,,HJ,,23.71,-31037.87
2032,4/7/2021,4/7/2021,Mahaliah Sejour,Imported from Bank of America Visa,,HJ,,12.99,-31050.86
2032,4/7/2021,4/7/2021,Mahaliah Sejour,Imported from Bank of America Visa,,HJ,,12.99,-31063.85
2032,4/7/2021,4/7/2021,Mahaliah Sejour,Imported from Bank of America Visa,,HJ,,12.99,-31076.84
2032,4/7/2021,4/7/2021,Mahaliah Sejour,Imported from Bank of America Visa,,HJ,,23.95,-31100.79
2032,4/7/2021,4/7/2021,Mahaliah Sejour,Imported from Bank of America Visa,,HJ,,574.73,-31675.52
2032,4/7/2021,4/7/2021,Mahaliah Sejour,Imported from Bank of America Visa,,HJ,,12.99,-31688.51
2032,4/7/2021,4/7/2021,Mahaliah Sejour,Imported from Bank of America Visa,,HJ,,12.99,-31701.5
2032,4/7/2021,4/7/2021,Mahaliah Sejour,Imported from Bank of America Visa,,HJ,,133.4,-31834.9
2032,4/7/2021,4/7/2021,Mahaliah Sejour,Imported from Bank of America Visa,,HJ,,850.17,-32685.07
2032,4/7/2021,4/7/2021,Mahaliah Sejour,Imported from Bank of America Visa,,HJ,,985.8,-33670.87
2032,4/7/2021,4/7/2021,Monivett Acevedo,Imported from Bank of America Visa,,HJ,,7,-33677.87
2032,4/7/2021,4/7/2021,Monivett Acevedo,Imported from Bank of America Visa,,HJ,,14.99,-33692.86
2032,4/7/2021,4/7/2021,Monivett Acevedo,Imported from Bank of America Visa,,HJ,,125,-33817.86
2032,4/7/2021,4/7/2021,Monivett Acevedo,Imported from Bank of America Visa,,HJ,,228.7,-34046.56
2032,4/7/2021,4/7/2021,Monivett Acevedo,Imported from Bank of America Visa,,HJ,,489.3,-34535.86
2032,4/7/2021,4/7/2021,Myesha Hossain,Imported from Bank of America Visa,,HJ,,13.96,-34549.82
2032,4/7/2021,4/7/2021,Myesha Hossain,Imported from Bank of America Visa,,HJ,,14.5,-34564.32
2032,4/7/2021,4/7/2021,Nicole Prahin,Imported from Bank of America Visa,,HJ,,22,-34586.32
2032,4/7/2021,4/7/2021,Thomas Fischaber,Imported from Bank of America Visa,,HJ,,29.87,-34616.19
2032,4/7/2021,4/7/2021,Thomas Fischaber,Imported from Bank of America Visa,,HJ,,59,-34675.19
2032,4/9/2021,4/9/2021,Denise Parham-Gantt,Imported from Bank of America Visa,,HJ,,186.99,-34862.18
2032,4/9/2021,4/9/2021,Mahaliah Sejour,Imported from Bank of America Visa,,HJ,135.63,,-34726.55
2032,4/9/2021,4/9/2021,Mahaliah Sejour,Imported from Bank of America Visa,,HJ,,196.71,-34923.26
2032,4/9/2021,4/9/2021,Maryellen Leneghan,Imported from Bank of America Visa,,HJ,,146.21,-35069.47
2032,4/9/2021,4/9/2021,Myesha Hossain,Imported from Bank of America Visa,,HJ,,50.97,-35120.44
2032,4/9/2021,4/9/2021,Myesha Hossain,Imported from Bank of America Visa,,HJ,,116.32,-35236.76
2032,4/12/2021,4/12/2021,Antonio Gutierrez,Imported from Bank of America Visa,,HJ,,15,-35251.76
2032,4/12/2021,4/12/2021,Antonio Gutierrez,Imported from Bank of America Visa,,HJ,,235.17,-35486.93
2032,4/12/2021,4/12/2021,Joseph Zarate,Imported from Bank of America Visa,,HJ,,34.24,-35521.17
2032,4/12/2021,4/12/2021,Joseph Zarate,Imported from Bank of America Visa,,HJ,,307.97,-35829.14
2032,4/12/2021,4/12/2021,Mahaliah Sejour,Imported from Bank of America Visa,,HJ,,40.67,-35869.81
2032,4/12/2021,4/12/2021,Mahaliah Sejour,Imported from Bank of America Visa,,HJ,,399.99,-36269.8
2032,4/12/2021,4/12/2021,Monivett Acevedo,Imported from Bank of America Visa,,HJ,,25.68,-36295.48
2032,4/12/2021,4/12/2021,Myesha Hossain,Imported from Bank of America Visa,,HJ,,15.99,-36311.47
2032,4/12/2021,4/12/2021,Nicole Prahin,Imported from Bank of America Visa,,HJ,,5.35,-36316.82
2032,4/13/2021,4/13/2021,Antonio Gutierrez,Imported from Bank of America Visa,,HJ,7.5,,-36309.32
2032,4/13/2021,4/13/2021,Jennifer Winans,Imported from Bank of America Visa,,HJ,,40,-36349.32
2032,4/13/2021,4/13/2021,Joseph Zarate,Imported from Bank of America Visa,,HJ,,21.9,-36371.22
2032,4/13/2021,4/13/2021,Joseph Zarate,Imported from Bank of America Visa,,HJ,,30.91,-36402.13
2032,4/13/2021,4/13/2021,Joseph Zarate,Imported from Bank of America Visa,,HJ,,111.19,-36513.32
2032,4/13/2021,4/13/2021,Joseph Zarate,Imported from Bank of America Visa,,HJ,119.99,,-36393.33
2032,4/13/2021,4/13/2021,Joseph Zarate,Imported from Bank of America Visa,,HJ,,199.97,-36593.3
2032,4/13/2021,4/13/2021,Joseph Zarate,Imported from Bank of America Visa,,HJ,,199.97,-36793.27
2032,4/13/2021,4/13/2021,Joseph Zarate,Imported from Bank of America Visa,,HJ,,199.97,-36993.24
2032,4/13/2021,4/13/2021,Joseph Zarate,Imported from Bank of America Visa,,HJ,,199.97,-37193.21
2032,4/13/2021,4/13/2021,Mahaliah Sejour,Imported from Bank of America Visa,,HJ,,5.99,-37199.2
2032,4/13/2021,4/13/2021,Mahaliah Sejour,Imported from Bank of America Visa,,HJ,,12.97,-37212.17
2032,4/13/2021,4/13/2021,Mahaliah Sejour,Imported from Bank of America Visa,,HJ,,16.77,-37228.94
2032,4/13/2021,4/13/2021,Mahaliah Sejour,Imported from Bank of America Visa,,HJ,,21.9,-37250.84
2032,4/13/2021,4/13/2021,Mahaliah Sejour,Imported from Bank of America Visa,,HJ,,27.89,-37278.73
2032,4/13/2021,4/13/2021,Mahaliah Sejour,Imported from Bank of America Visa,,HJ,,66.97,-37345.7
2032,4/13/2021,4/13/2021,Mahaliah Sejour,Imported from Bank of America Visa,,HJ,,74.07,-37419.77
2032,4/13/2021,4/13/2021,Mahaliah Sejour,Imported from Bank of America Visa,,HJ,,80.6,-37500.37
2032,4/13/2021,4/13/2021,Mahaliah Sejour,Imported from Bank of America Visa,,HJ,,84.97,-37585.34
2032,4/13/2021,4/13/2021,Mahaliah Sejour,Imported from Bank of America Visa,,HJ,,98.15,-37683.49
2032,4/13/2021,4/13/2021,Mahaliah Sejour,Imported from Bank of America Visa,,HJ,,145.54,-37829.03
2032,4/13/2021,4/13/2021,Mahaliah Sejour,Imported from Bank of America Visa,,HJ,,399.99,-38229.02
2032,4/13/2021,4/13/2021,Mahaliah Sejour,Imported from Bank of America Visa,,HJ,850.17,,-37378.85
2032,4/13/2021,4/13/2021,Mahaliah Sejour,Imported from Bank of America Visa,,HJ,850.17,,-36528.68
2032,4/13/2021,4/13/2021,Monivett Acevedo,Imported from Bank of America Visa,,HJ,,131.25,-36659.93
2032,4/13/2021,4/13/2021,Myesha Hossain,Imported from Bank of America Visa,,HJ,,15.98,-36675.91
2032,4/13/2021,4/13/2021,Myesha Hossain,Imported from Bank of America Visa,,HJ,,43,-36718.91
2032,4/13/2021,4/13/2021,Tiffani Bibb,Imported from Bank of America Visa,,HJ,,26.07,-36744.98
2032,4/15/2021,4/15/2021,Mahaliah Sejour,Imported from Bank of America Visa,,HJ,,26.85,-36771.83
2032,4/15/2021,4/15/2021,Mahaliah Sejour,Imported from Bank of America Visa,,HJ,,34.33,-36806.16
2032,4/15/2021,4/15/2021,Mahaliah Sejour,Imported from Bank of America Visa,,HJ,,66.13,-36872.29
2032,4/15/2021,4/15/2021,Mahaliah Sejour,Imported from Bank of America Visa,,HJ,,272.16,-37144.45
2032,4/15/2021,4/15/2021,Myesha Hossain,Imported from Bank of America Visa,,HJ,,6.99,-37151.44
2032,4/15/2021,4/15/2021,Myesha Hossain,Imported from Bank of America Visa,,HJ,,6.99,-37158.43
2032,4/15/2021,4/15/2021,Myesha Hossain,Imported from Bank of America Visa,,HJ,,14.34,-37172.77
2032,4/15/2021,4/15/2021,Myesha Hossain,Imported from Bank of America Visa,,HJ,,14.99,-37187.76
2032,4/15/2021,4/15/2021,Myesha Hossain,Imported from Bank of America Visa,,HJ,,15.99,-37203.75
2032,4/15/2021,4/15/2021,Thomas Fischaber,Imported from Bank of America Visa,,HJ,25,,-37178.75
2032,4/15/2021,4/15/2021,Thomas Fischaber,Imported from Bank of America Visa,,HJ,25,,-37153.75
2032,4/16/2021,4/16/2021,Alan Safran,Imported from Bank of America Visa,,HJ,,11.68,-37165.43
2032,4/16/2021,4/16/2021,Antonio Gutierrez,Imported from Bank of America Visa,,HJ,,4,-37169.43
2032,4/16/2021,4/16/2021,Antonio Gutierrez,Imported from Bank of America Visa,,HJ,,15.93,-37185.36
2032,4/16/2021,4/16/2021,Antonio Gutierrez,Imported from Bank of America Visa,,HJ,,900,-38085.36
2032,4/16/2021,4/16/2021,Antonio Gutierrez,Imported from Bank of America Visa,,HJ,,1072.91,-39158.27
2032,4/16/2021,4/16/2021,Denise Parham-Gantt,Imported from Bank of America Visa,,HJ,,13.99,-39172.26
2032,4/16/2021,4/16/2021,Elizabeth Peinado,Imported from Bank of America Visa,,HJ,,550.09,-39722.35
2032,4/16/2021,4/16/2021,Elizabeth Peinado,Imported from Bank of America Visa,,HJ,,850.14,-40572.49
2032,4/16/2021,4/16/2021,Elizabeth Peinado,Imported from Bank of America Visa,,HJ,,850.14,-41422.63
2032,4/16/2021,4/16/2021,Elizabeth Peinado,Imported from Bank of America Visa,,HJ,,2750.44,-44173.07
2032,4/16/2021,4/16/2021,iaklestad,Imported from Bank of America Visa,,HJ,,99,-44272.07
2032,4/16/2021,4/16/2021,iaklestad,Imported from Bank of America Visa,,HJ,,199,-44471.07
2032,4/16/2021,4/16/2021,iaklestad,Imported from Bank of America Visa,,HJ,,199,-44670.07
2032,4/16/2021,4/16/2021,Joseph Zarate,Imported from Bank of America Visa,,HJ,,15.5,-44685.57
2032,4/16/2021,4/16/2021,Joseph Zarate,Imported from Bank of America Visa,,HJ,,1428.99,-46114.56
2032,4/16/2021,4/16/2021,Joseph Zarate,Imported from Bank of America Visa,,HJ,,12.74,-46127.3
2032,4/16/2021,4/16/2021,Joseph Zarate,Imported from Bank of America Visa,,HJ,,30.51,-46157.81
2032,4/16/2021,4/16/2021,Joseph Zarate,Imported from Bank of America Visa,,HJ,,35.99,-46193.8
2032,4/16/2021,4/16/2021,Joseph Zarate,Imported from Bank of America Visa,,HJ,,124.99,-46318.79
2032,4/16/2021,4/16/2021,Joseph Zarate,Imported from Bank of America Visa,,HJ,,199.97,-46518.76
2032,4/16/2021,4/16/2021,Joseph Zarate,Imported from Bank of America Visa,,HJ,,199.97,-46718.73
2032,4/16/2021,4/16/2021,Joseph Zarate,Imported from Bank of America Visa,,HJ,,199.97,-46918.7
2032,4/16/2021,4/16/2021,Joseph Zarate,Imported from Bank of America Visa,,HJ,,199.97,-47118.67
2032,4/16/2021,4/16/2021,Joseph Zarate,Imported from Bank of America Visa,,HJ,,199.97,-47318.64
2032,4/16/2021,4/16/2021,Joseph Zarate,Imported from Bank of America Visa,,HJ,,199.97,-47518.61
2032,4/16/2021,4/16/2021,Joseph Zarate,Imported from Bank of America Visa,,HJ,,199.97,-47718.58
2032,4/16/2021,4/16/2021,Joseph Zarate,Imported from Bank of America Visa,,HJ,,207.96,-47926.54
2032,4/16/2021,4/16/2021,Joseph Zarate,Imported from Bank of America Visa,,HJ,,351.13,-48277.67
2032,4/16/2021,4/16/2021,Kyra Detone,Imported from Bank of America Visa,,HJ,,798.17,-49075.84
2032,4/16/2021,4/16/2021,Mahaliah Sejour,Imported from Bank of America Visa,,HJ,,5.35,-49081.19
2032,4/16/2021,4/16/2021,Mahaliah Sejour,Imported from Bank of America Visa,,HJ,,47.27,-49128.46
2032,4/16/2021,4/16/2021,Mahaliah Sejour,Imported from Bank of America Visa,,HJ,,88.95,-49217.41
2032,4/16/2021,4/16/2021,Mahaliah Sejour,Imported from Bank of America Visa,,HJ,55.46,,-49161.95
2032,4/16/2021,4/16/2021,Mahaliah Sejour,Imported from Bank of America Visa,,HJ,,100.93,-49262.88
2032,4/16/2021,4/16/2021,Mahaliah Sejour,Imported from Bank of America Visa,,HJ,,132.72,-49395.6
2032,4/16/2021,4/16/2021,Mahaliah Sejour,Imported from Bank of America Visa,,HJ,,348.09,-49743.69
2032,4/16/2021,4/16/2021,Myesha Hossain,Imported from Bank of America Visa,,HJ,,6.99,-49750.68
2032,4/16/2021,4/16/2021,Myesha Hossain,Imported from Bank of America Visa,,HJ,,6.99,-49757.67
2032,4/16/2021,4/16/2021,Myesha Hossain,Imported from Bank of America Visa,,HJ,,9.83,-49767.5
2032,4/16/2021,4/16/2021,Myesha Hossain,Imported from Bank of America Visa,,HJ,,9.83,-49777.33
2032,4/16/2021,4/16/2021,Myesha Hossain,Imported from Bank of America Visa,,HJ,,12,-49789.33
2032,4/16/2021,4/16/2021,Myesha Hossain,Imported from Bank of America Visa,,HJ,,12,-49801.33
2032,4/16/2021,4/16/2021,Nicole Prahin,Imported from Bank of America Visa,,HJ,,2.17,-49803.5
2032,4/16/2021,4/16/2021,Tiffani Bibb,Imported from Bank of America Visa,,HJ,,3.95,-49807.45
2032,4/16/2021,4/16/2021,Tiffani Bibb,Imported from Bank of America Visa,,HJ,,81.99,-49889.44
2032,4/16/2021,4/16/2021,Tiffani Bibb,Imported from Bank of America Visa,,HJ,,106.13,-49995.57
2032,4/16/2021,4/16/2021,Tiffani Bibb,Imported from Bank of America Visa,,HJ,,81.99,-50077.56
2032,4/16/2021,4/16/2021,Tiffani Bibb,Imported from Bank of America Visa,,HJ,,81.99,-50159.55
2032,4/16/2021,4/16/2021,Tiffani Bibb,Imported from Bank of America Visa,,HJ,,81.99,-50241.54
2032,4/19/2021,4/19/2021,Antonio Gutierrez,Imported from Bank of America Visa,,HJ,,458.96,-50700.5
2032,4/19/2021,4/19/2021,iaklestad,Imported from Bank of America Visa,,HJ,,3.98,-50704.48
2032,4/19/2021,4/19/2021,iaklestad,Imported from Bank of America Visa,,HJ,,25,-50729.48
2032,4/19/2021,4/19/2021,Joseph Zarate,Imported from Bank of America Visa,,HJ,,319.96,-51049.44
2032,4/19/2021,4/19/2021,Mahaliah Sejour,Imported from Bank of America Visa,,HJ,,11.93,-51061.37
2032,4/19/2021,4/19/2021,Mahaliah Sejour,Imported from Bank of America Visa,,HJ,,43.98,-51105.35
2032,4/19/2021,4/19/2021,Mahaliah Sejour,Imported from Bank of America Visa,,HJ,,79.95,-51185.3
2032,4/19/2021,4/19/2021,Mahaliah Sejour,Imported from Bank of America Visa,,HJ,,268,-51453.3
2032,4/19/2021,4/19/2021,Maryellen Leneghan,Imported from Bank of America Visa,,HJ,,17.98,-51471.28
2032,4/19/2021,4/19/2021,Myesha Hossain,Imported from Bank of America Visa,,HJ,,9.6,-51480.88
2032,4/19/2021,4/19/2021,Myesha Hossain,Imported from Bank of America Visa,,HJ,,11,-51491.88
2032,4/19/2021,4/19/2021,Myesha Hossain,Imported from Bank of America Visa,,HJ,,12,-51503.88
2032,4/19/2021,4/19/2021,Myesha Hossain,Imported from Bank of America Visa,,HJ,,177.95,-51681.83
2032,4/19/2021,4/19/2021,Thomas Fischaber,Imported from Bank of America Visa,,HJ,,84,-51765.83
2032,4/19/2021,4/19/2021,Tiffani Bibb,Imported from Bank of America Visa,,HJ,,53.75,-51819.58
2032,4/19/2021,4/19/2021,Tiffani Bibb,Imported from Bank of America Visa,,HJ,,81.99,-51901.57
2032,4/19/2021,4/19/2021,Tiffani Bibb,Imported from Bank of America Visa,,HJ,,81.99,-51983.56
2032,4/19/2021,4/19/2021,Tiffani Bibb,Imported from Bank of America Visa,,HJ,,81.99,-52065.55
2032,4/19/2021,4/19/2021,Tiffani Bibb,Imported from Bank of America Visa,,HJ,,86.91,-52152.46
2032,4/21/2021,4/21/2021,Antonio Gutierrez,Imported from Bank of America Visa,,HJ,,900,-53052.46
2032,4/21/2021,4/21/2021,Elizabeth Peinado,Imported from Bank of America Visa,,HJ,,4.39,-53056.85
2032,4/21/2021,4/21/2021,Elizabeth Peinado,Imported from Bank of America Visa,,HJ,,6.79,-53063.64
2032,4/21/2021,4/21/2021,Elizabeth Peinado,Imported from Bank of America Visa,,HJ,,6.79,-53070.43
2032,4/21/2021,4/21/2021,Elizabeth Peinado,Imported from Bank of America Visa,,HJ,,21.98,-53092.41
2032,4/21/2021,4/21/2021,iaklestad,Imported from Bank of America Visa,,HJ,,4.15,-53096.56
2032,4/21/2021,4/21/2021,Mahaliah Sejour,Imported from Bank of America Visa,,HJ,,41.9,-53138.46
2032,4/21/2021,4/21/2021,Mahaliah Sejour,Imported from Bank of America Visa,,HJ,,68.28,-53206.74
2032,4/21/2021,4/21/2021,Mahaliah Sejour,Imported from Bank of America Visa,,HJ,,88.95,-53295.69
2032,4/21/2021,4/21/2021,Mahaliah Sejour,Imported from Bank of America Visa,,HJ,,91.82,-53387.51
2032,4/21/2021,4/21/2021,Mahaliah Sejour,Imported from Bank of America Visa,,HJ,,155.32,-53542.83
2032,4/21/2021,4/21/2021,Mahaliah Sejour,Imported from Bank of America Visa,,HJ,,215.51,-53758.34
2032,4/21/2021,4/21/2021,Myesha Hossain,Imported from Bank of America Visa,,HJ,,80.7,-53839.04
2032,4/21/2021,4/21/2021,Nicole Horton,Imported from Bank of America Visa,,HJ,,11.94,-53850.98
2032,4/22/2021,4/22/2021,Elizabeth Peinado,Imported from Bank of America Visa,,HJ,,0.09,-53851.07
2032,4/22/2021,4/22/2021,Elizabeth Peinado,Imported from Bank of America Visa,,HJ,,0.14,-53851.21
2032,4/22/2021,4/22/2021,Elizabeth Peinado,Imported from Bank of America Visa,,HJ,,0.14,-53851.35
2032,4/22/2021,4/22/2021,Elizabeth Peinado,Imported from Bank of America Visa,,HJ,,0.43,-53851.78
2032,4/22/2021,4/22/2021,Thomas Fischaber,Imported from Bank of America Visa,,HJ,,99,-53950.78
2032,4/22/2021,4/22/2021,Thomas Fischaber,Imported from Bank of America Visa,,HJ,,800,-54750.78
2032,4/23/2021,4/23/2021,Antonio Gutierrez,Imported from Bank of America Visa,,HJ,,900,-55650.78
2032,4/23/2021,4/23/2021,Antonio Gutierrez,Imported from Bank of America Visa,,HJ,,12.99,-55663.77
2032,4/23/2021,4/23/2021,Elizabeth Peinado,Imported from Bank of America Visa,,HJ,,551.48,-56215.25
2032,4/23/2021,4/23/2021,Elizabeth Peinado,Imported from Bank of America Visa,,HJ,,852.29,-57067.54
2032,4/23/2021,4/23/2021,Elizabeth Peinado,Imported from Bank of America Visa,,HJ,,852.29,-57919.83
2032,4/23/2021,4/23/2021,Elizabeth Peinado,Imported from Bank of America Visa,,HJ,,2757.4,-60677.23
2032,4/23/2021,4/23/2021,Joseph Zarate,Imported from Bank of America Visa,,HJ,,51.13,-60728.36
2032,4/23/2021,4/23/2021,Joseph Zarate,Imported from Bank of America Visa,,HJ,,72.95,-60801.31
2032,4/23/2021,4/23/2021,Mahaliah Sejour,Imported from Bank of America Visa,,HJ,,66.95,-60868.26
2032,4/23/2021,4/23/2021,Mahaliah Sejour,Imported from Bank of America Visa,,HJ,,171.52,-61039.78
2032,4/23/2021,4/23/2021,Mahaliah Sejour,Imported from Bank of America Visa,,HJ,,11.79,-61051.57
2032,4/23/2021,4/23/2021,Mahaliah Sejour,Imported from Bank of America Visa,,HJ,,49.63,-61101.2
2032,4/23/2021,4/23/2021,Mahaliah Sejour,Imported from Bank of America Visa,,HJ,,96.7,-61197.9
2032,4/23/2021,4/23/2021,Maryellen Leneghan,Imported from Bank of America Visa,,HJ,,6.97,-61204.87
2032,4/23/2021,4/23/2021,Maryellen Leneghan,Imported from Bank of America Visa,,HJ,,6.97,-61211.84
2032,4/23/2021,4/23/2021,Maryellen Leneghan,Imported from Bank of America Visa,,HJ,,6.97,-61218.81
2032,4/23/2021,4/23/2021,Maryellen Leneghan,Imported from Bank of America Visa,,HJ,,6.97,-61225.78
2032,4/23/2021,4/23/2021,Maryellen Leneghan,Imported from Bank of America Visa,,HJ,,6.97,-61232.75
2032,4/23/2021,4/23/2021,Maryellen Leneghan,Imported from Bank of America Visa,,HJ,,6.97,-61239.72
2032,4/23/2021,4/23/2021,Maryellen Leneghan,Imported from Bank of America Visa,,HJ,,6.97,-61246.69
2032,4/23/2021,4/23/2021,Maryellen Leneghan,Imported from Bank of America Visa,,HJ,,7.53,-61254.22
2032,4/23/2021,4/23/2021,Maryellen Leneghan,Imported from Bank of America Visa,,HJ,,7.7,-61261.92
2032,4/23/2021,4/23/2021,Myesha Hossain,Imported from Bank of America Visa,,HJ,,9.21,-61271.13
2032,4/23/2021,4/23/2021,Myesha Hossain,Imported from Bank of America Visa,,HJ,,9.21,-61280.34
2032,4/23/2021,4/23/2021,Myesha Hossain,Imported from Bank of America Visa,,HJ,,14.95,-61295.29
2032,4/23/2021,4/23/2021,Myesha Hossain,Imported from Bank of America Visa,,HJ,,35.4,-61330.69
2032,4/23/2021,4/23/2021,Myesha Hossain,Imported from Bank of America Visa,,HJ,,300.02,-61630.71
2032,4/23/2021,4/23/2021,Nicole Horton,Imported from Bank of America Visa,,HJ,,28.45,-61659.16
2032,4/23/2021,4/23/2021,Tiffani Bibb,Imported from Bank of America Visa,,HJ,,3295,-64954.16
2032,4/23/2021,4/23/2021,Tiffani Bibb,Imported from Bank of America Visa,,HJ,81.99,,-64872.17
2032,4/27/2021,4/27/2021,Alan Safran,Imported from Bank of America Visa,,HJ,,51.5,-64923.67
2032,4/27/2021,4/27/2021,Antonio Gutierrez,Imported from Bank of America Visa,,HJ,,135.63,-65059.3
2032,4/27/2021,4/27/2021,Antonio Gutierrez,Imported from Bank of America Visa,,HJ,644.78,,-64414.52
2032,4/27/2021,4/27/2021,Antonio Gutierrez,Imported from Bank of America Visa,,HJ,,900,-65314.52
2032,4/27/2021,4/27/2021,Antonio Gutierrez,Imported from Bank of America Visa,,HJ,996.48,,-64318.04
2032,4/27/2021,4/27/2021,Antonio Gutierrez,Imported from Bank of America Visa,,HJ,996.48,,-63321.56
2032,4/27/2021,4/27/2021,Antonio Gutierrez,Imported from Bank of America Visa,,HJ,3223.89,,-60097.67
2032,4/27/2021,4/27/2021,Halley Bowman,Imported from Bank of America Visa,,HJ,,13.63,-60111.3
2032,4/27/2021,4/27/2021,Halley Bowman,Imported from Bank of America Visa,,HJ,,26.45,-60137.75
2032,4/27/2021,4/27/2021,Joseph Zarate,Imported from Bank of America Visa,,HJ,,2.48,-60140.23
2032,4/27/2021,4/27/2021,Joseph Zarate,Imported from Bank of America Visa,,HJ,,23.74,-60163.97
2032,4/27/2021,4/27/2021,Joseph Zarate,Imported from Bank of America Visa,,HJ,,25.31,-60189.28
2032,4/27/2021,4/27/2021,Joseph Zarate,Imported from Bank of America Visa,,HJ,,25.65,-60214.93
2032,4/27/2021,4/27/2021,Joseph Zarate,Imported from Bank of America Visa,,HJ,,29.74,-60244.67
2032,4/27/2021,4/27/2021,Joseph Zarate,Imported from Bank of America Visa,,HJ,,159.96,-60404.63
2032,4/27/2021,4/27/2021,Joseph Zarate,Imported from Bank of America Visa,,HJ,,161.43,-60566.06
2032,4/27/2021,4/27/2021,Joseph Zarate,Imported from Bank of America Visa,,HJ,,311.52,-60877.58
2032,4/27/2021,4/27/2021,Joseph Zarate,Imported from Bank of America Visa,,HJ,,311.52,-61189.1
2032,4/27/2021,4/27/2021,Joseph Zarate,Imported from Bank of America Visa,,HJ,,467.28,-61656.38
2032,4/27/2021,4/27/2021,Joseph Zarate,Imported from Bank of America Visa,,HJ,,484.73,-62141.11
2032,4/27/2021,4/27/2021,Joseph Zarate,Imported from Bank of America Visa,,HJ,,501.76,-62642.87
2032,4/27/2021,4/27/2021,Joseph Zarate,Imported from Bank of America Visa,,HJ,,1365,-64007.87
2032,4/27/2021,4/27/2021,Joseph Zarate,Imported from Bank of America Visa,,HJ,,2076.8,-66084.67
2032,4/27/2021,4/27/2021,Mahaliah Sejour,Imported from Bank of America Visa,,HJ,,1.99,-66086.66
2032,4/27/2021,4/27/2021,Mahaliah Sejour,Imported from Bank of America Visa,,HJ,,90,-66176.66
2032,4/27/2021,4/27/2021,Mahaliah Sejour,Imported from Bank of America Visa,,HJ,,91.5,-66268.16
2032,4/27/2021,4/27/2021,Myesha Hossain,Imported from Bank of America Visa,,HJ,,9.21,-66277.37
2032,4/27/2021,4/27/2021,Myesha Hossain,Imported from Bank of America Visa,,HJ,,9.21,-66286.58
2032,4/27/2021,4/27/2021,Myesha Hossain,Imported from Bank of America Visa,,HJ,,9.21,-66295.79
2032,4/27/2021,4/27/2021,Myesha Hossain,Imported from Bank of America Visa,,HJ,,9.21,-66305
2032,4/27/2021,4/27/2021,Myesha Hossain,Imported from Bank of America Visa,,HJ,,14.75,-66319.75
2032,4/27/2021,4/27/2021,Myesha Hossain,Imported from Bank of America Visa,,HJ,,19.4,-66339.15
2032,4/27/2021,4/27/2021,Myesha Hossain,Imported from Bank of America Visa,,HJ,,35.48,-66374.63
2032,4/27/2021,4/27/2021,Myesha Hossain,Imported from Bank of America Visa,,HJ,,35.93,-66410.56
2032,4/27/2021,4/27/2021,Myesha Hossain,Imported from Bank of America Visa,,HJ,,44.97,-66455.53
2032,4/27/2021,4/27/2021,Thomas Fischaber,Imported from Bank of America Visa,,HJ,,42.37,-66497.9
2032,4/27/2021,4/27/2021,Tiffani Bibb,Imported from Bank of America Visa,,HJ,,80.86,-66578.76
2032,4/27/2021,4/27/2021,Uriel Guadarrama,Imported from Bank of America Visa,,HJ,,15.93,-66594.69
2032,4/27/2021,4/27/2021,Uriel Guadarrama,Imported from Bank of America Visa,,HJ,,31.85,-66626.54
2032,4/27/2021,4/27/2021,Uriel Guadarrama,Imported from Bank of America Visa,,HJ,,31.85,-66658.39
2032,4/28/2021,4/28/2021,Antonio Gutierrez,Imported from Bank of America Visa,,HJ,,40,-66698.39
2032,4/28/2021,4/28/2021,Antonio Gutierrez,Imported from Bank of America Visa,,HJ,,500,-67198.39
2032,4/28/2021,4/28/2021,Antonio Gutierrez,Imported from Bank of America Visa,,HJ,,900,-68098.39
2032,4/28/2021,4/28/2021,Antonio Gutierrez,Imported from Bank of America Visa,,HJ,,900,-68998.39
2032,4/28/2021,4/28/2021,Joseph Zarate,Imported from Bank of America Visa,,HJ,,32.99,-69031.38
2032,4/28/2021,4/28/2021,Mahaliah Sejour,Imported from Bank of America Visa,,HJ,,1.88,-69033.26
2032,4/28/2021,4/28/2021,Mahaliah Sejour,Imported from Bank of America Visa,,HJ,,16.18,-69049.44
2032,4/28/2021,4/28/2021,Mahaliah Sejour,Imported from Bank of America Visa,,HJ,,24.47,-69073.91
2032,4/28/2021,4/28/2021,Monivett Acevedo,Imported from Bank of America Visa,,HJ,,45,-69118.91
2032,4/29/2021,4/29/2021,Antonio Gutierrez,Imported from Bank of America Visa,,HJ,,1.99,-69120.9
2032,4/29/2021,4/29/2021,Maryellen Leneghan,Imported from Bank of America Visa,,HJ,,9.99,-69130.89
2032,4/29/2021,4/29/2021,Maryellen Leneghan,Imported from Bank of America Visa,,HJ,,10.99,-69141.88
2032,4/29/2021,4/29/2021,Myesha Hossain,Imported from Bank of America Visa,,HJ,,7.44,-69149.32
2032,4/29/2021,4/29/2021,Myesha Hossain,Imported from Bank of America Visa,,HJ,,7.95,-69157.27
2032,4/29/2021,4/29/2021,Myesha Hossain,Imported from Bank of America Visa,,HJ,,7.95,-69165.22
2032,4/29/2021,4/29/2021,Myesha Hossain,Imported from Bank of America Visa,,HJ,,7.95,-69173.17
2032,4/29/2021,4/29/2021,Myesha Hossain,Imported from Bank of America Visa,,HJ,,7.95,-69181.12
2032,4/29/2021,4/29/2021,Myesha Hossain,Imported from Bank of America Visa,,HJ,,7.95,-69189.07
2032,4/29/2021,4/29/2021,Myesha Hossain,Imported from Bank of America Visa,,HJ,,9.99,-69199.06
2032,4/29/2021,4/29/2021,Thomas Fischaber,Imported from Bank of America Visa,,HJ,,94,-69293.06
2032,4/29/2021,4/29/2021,Thomas Fischaber,Imported from Bank of America Visa,,HJ,,2567.99,-71861.05
2032,4/30/2021,4/30/2021,Alan Safran,Imported from Bank of America Visa,,HJ,,75,-71936.05
2032,4/30/2021,4/30/2021,Alan Safran,Imported from Bank of America Visa,,HJ,,1.99,-71938.04
2032,4/30/2021,4/30/2021,Chris D PLACEHOLDER,Imported from Bank of America Visa,,HJ,,75,-72013.04
2032,4/30/2021,4/30/2021,Joseph Zarate,Imported from Bank of America Visa,,HJ,,32.14,-72045.18
2032,4/30/2021,4/30/2021,Joseph Zarate,Imported from Bank of America Visa,,HJ,,1429.98,-73475.16
2032,4/30/2021,4/30/2021,Thomas Fischaber,Imported from Bank of America Visa,,HJ,,14.95,-73490.11
2032,4/30/2021,4/30/2021,Uriel Guadarrama,Imported from Bank of America Visa,,HJ,,75,-73565.11
2032,5/1/2021,5/1/2021,Antonio Gutierrez,Imported from Bank of America Visa,,HJ,,900,-74465.11
2032,5/1/2021,5/1/2021,Antonio Gutierrez,Imported from Bank of America Visa,,HJ,,900,-75365.11
2032,5/1/2021,5/1/2021,Antonio Gutierrez,Imported from Bank of America Visa,,HJ,,999.75,-76364.86
2032,5/1/2021,5/1/2021,Elizabeth Peinado,Imported from Bank of America Visa,,HJ,,12.63,-76377.49
2032,5/1/2021,5/1/2021,Elizabeth Peinado,Imported from Bank of America Visa,,HJ,,19.53,-76397.02
2032,5/1/2021,5/1/2021,Elizabeth Peinado,Imported from Bank of America Visa,,HJ,,19.53,-76416.55
2032,5/1/2021,5/1/2021,Elizabeth Peinado,Imported from Bank of America Visa,,HJ,,63.17,-76479.72
2032,5/1/2021,5/1/2021,Elizabeth Peinado,Imported from Bank of America Visa,,HJ,,81.62,-76561.34
2032,5/1/2021,5/1/2021,Elizabeth Peinado,Imported from Bank of America Visa,,HJ,,126.14,-76687.48
2032,5/1/2021,5/1/2021,Elizabeth Peinado,Imported from Bank of America Visa,,HJ,,126.14,-76813.62
2032,5/1/2021,5/1/2021,Elizabeth Peinado,Imported from Bank of America Visa,,HJ,,214.5,-77028.12
2032,5/1/2021,5/1/2021,Elizabeth Peinado,Imported from Bank of America Visa,,HJ,,331.5,-77359.62
2032,5/1/2021,5/1/2021,Elizabeth Peinado,Imported from Bank of America Visa,,HJ,,331.5,-77691.12
2032,5/1/2021,5/1/2021,Elizabeth Peinado,Imported from Bank of America Visa,,HJ,,408.1,-78099.22
2032,5/1/2021,5/1/2021,Elizabeth Peinado,Imported from Bank of America Visa,,HJ,,414.91,-78514.13
2032,5/1/2021,5/1/2021,Elizabeth Peinado,Imported from Bank of America Visa,,HJ,,548.43,-79062.56
2032,5/1/2021,5/1/2021,Elizabeth Peinado,Imported from Bank of America Visa,,HJ,,641.22,-79703.78
2032,5/1/2021,5/1/2021,Elizabeth Peinado,Imported from Bank of America Visa,,HJ,,641.22,-80345
2032,5/1/2021,5/1/2021,Elizabeth Peinado,Imported from Bank of America Visa,,HJ,,847.57,-81192.57
2032,5/1/2021,5/1/2021,Elizabeth Peinado,Imported from Bank of America Visa,,HJ,,847.57,-82040.14
2032,5/1/2021,5/1/2021,Elizabeth Peinado,Imported from Bank of America Visa,,HJ,,1072.5,-83112.64
2032,5/1/2021,5/1/2021,Elizabeth Peinado,Imported from Bank of America Visa,,HJ,,2074.53,-85187.17
2032,5/1/2021,5/1/2021,Elizabeth Peinado,Imported from Bank of America Visa,,HJ,,2742.16,-87929.33
2032,5/1/2021,5/1/2021,Joseph Zarate,Imported from Bank of America Visa,,HJ,,38.89,-87968.22
2032,5/1/2021,5/1/2021,Joseph Zarate,Imported from Bank of America Visa,,HJ,,38.89,-88007.11
2032,5/1/2021,5/1/2021,Joseph Zarate,Imported from Bank of America Visa,,HJ,,40.06,-88047.17
2032,5/1/2021,5/1/2021,Kyra Detone,Imported from Bank of America Visa,,HJ,,1.56,-88048.73
2032,5/1/2021,5/1/2021,Kyra Detone,Imported from Bank of America Visa,,HJ,,2.17,-88050.9
2032,5/1/2021,5/1/2021,Kyra Detone,Imported from Bank of America Visa,,HJ,,4.68,-88055.58
2032,5/1/2021,5/1/2021,Kyra Detone,Imported from Bank of America Visa,,HJ,,5,-88060.58
2032,5/1/2021,5/1/2021,Kyra Detone,Imported from Bank of America Visa,,HJ,,7,-88067.58
2032,5/1/2021,5/1/2021,Kyra Detone,Imported from Bank of America Visa,,HJ,,9,-88076.58
2032,5/1/2021,5/1/2021,Kyra Detone,Imported from Bank of America Visa,,HJ,,11.75,-88088.33
2032,5/1/2021,5/1/2021,Kyra Detone,Imported from Bank of America Visa,,HJ,,14.6,-88102.93
2032,5/1/2021,5/1/2021,Kyra Detone,Imported from Bank of America Visa,,HJ,,37.12,-88140.05
2032,5/1/2021,5/1/2021,Kyra Detone,Imported from Bank of America Visa,,HJ,,94.15,-88234.2
2032,5/1/2021,5/1/2021,Kyra Detone,Imported from Bank of America Visa,,HJ,,251.39,-88485.59
2032,5/1/2021,5/1/2021,Mahaliah Sejour,Imported from Bank of America Visa,,HJ,,21.24,-88506.83
2032,5/1/2021,5/1/2021,Mahaliah Sejour,Imported from Bank of America Visa,,HJ,,13.99,-88520.82
2032,5/1/2021,5/1/2021,Mahaliah Sejour,Imported from Bank of America Visa,,HJ,,149,-88669.82
2032,5/1/2021,5/1/2021,Mahaliah Sejour,Imported from Bank of America Visa,,HJ,,173,-88842.82
2032,5/1/2021,5/1/2021,Maryellen Leneghan,Imported from Bank of America Visa,,HJ,,20.39,-88863.21
2032,5/1/2021,5/1/2021,Maryellen Leneghan,Imported from Bank of America Visa,,HJ,,20.46,-88883.67
2032,5/1/2021,5/1/2021,Maryellen Leneghan,Imported from Bank of America Visa,,HJ,,30.62,-88914.29
2032,5/1/2021,5/1/2021,Miranda Cortez,Imported from Bank of America Visa,,HJ,,25,-88939.29
2032,5/1/2021,5/1/2021,Miranda Cortez,Imported from Bank of America Visa,,HJ,,25,-88964.29
2032,5/1/2021,5/1/2021,Monivett Acevedo,Imported from Bank of America Visa,,HJ,,41.02,-89005.31
2032,5/1/2021,5/1/2021,Monivett Acevedo,Imported from Bank of America Visa,,HJ,41.89,,-88963.42
2032,5/1/2021,5/1/2021,Monivett Acevedo,Imported from Bank of America Visa,,HJ,150,,-88813.42
2032,5/1/2021,5/1/2021,Monivett Acevedo,Imported from Bank of America Visa,,HJ,,283.64,-89097.06
2032,5/1/2021,5/1/2021,Myesha Hossain,Imported from Bank of America Visa,,HJ,,6.99,-89104.05
2032,5/1/2021,5/1/2021,Myesha Hossain,Imported from Bank of America Visa,,HJ,,13.72,-89117.77
2032,5/1/2021,5/1/2021,Myesha Hossain,Imported from Bank of America Visa,,HJ,,16.97,-89134.74
2032,5/1/2021,5/1/2021,Myesha Hossain,Imported from Bank of America Visa,,HJ,,21.05,-89155.79
2032,5/1/2021,5/1/2021,Myesha Hossain,Imported from Bank of America Visa,,HJ,,23.99,-89179.78
2032,5/1/2021,5/1/2021,Myesha Hossain,Imported from Bank of America Visa,,HJ,,80.56,-89260.34
2032,5/1/2021,5/1/2021,Thomas Fischaber,Imported from Bank of America Visa,,HJ,,82.21,-89342.55
2032,5/1/2021,5/1/2021,Thomas Fischaber,Imported from Bank of America Visa,,HJ,,238,-89580.55
2032,5/1/2021,5/1/2021,Thomas Fischaber,Imported from Bank of America Visa,,HJ,,700,-90280.55
2032,5/3/2021,5/3/2021,Alan Safran,Imported from Bank of America Visa,,HJ,,15,-90295.55
2032,5/3/2021,5/3/2021,Antonio Gutierrez,Imported from Bank of America Visa,,HJ,,1.99,-90297.54
2032,5/3/2021,5/3/2021,Antonio Gutierrez,Imported from Bank of America Visa,,HJ,,496.18,-90793.72
2032,5/3/2021,5/3/2021,Antonio Gutierrez,Imported from Bank of America Visa,,HJ,,900,-91693.72
2032,5/3/2021,5/3/2021,Elizabeth Peinado,Imported from Bank of America Visa,,HJ,,26.9,-91720.62
2032,5/3/2021,5/3/2021,Elizabeth Peinado,Imported from Bank of America Visa,,HJ,,41.58,-91762.2
2032,5/3/2021,5/3/2021,Elizabeth Peinado,Imported from Bank of America Visa,,HJ,,41.58,-91803.78
2032,5/3/2021,5/3/2021,Elizabeth Peinado,Imported from Bank of America Visa,,HJ,,134.5,-91938.28
2032,5/3/2021,5/3/2021,Maryellen Leneghan,Imported from Bank of America Visa,,HJ,,7.99,-91946.27
2032,5/3/2021,5/3/2021,Myesha Hossain,Imported from Bank of America Visa,,HJ,,10.95,-91957.22
2032,5/3/2021,5/3/2021,Thomas Fischaber,Imported from Bank of America Visa,,HJ,,69,-92026.22
2032,5/4/2021,5/4/2021,Alan Safran,Imported from Bank of America Visa,,HJ,,27.75,-92053.97
2032,5/4/2021,5/4/2021,Alan Safran,Imported from Bank of America Visa,,HJ,,1277.6,-93331.57
2032,5/4/2021,5/4/2021,Antonio Gutierrez,Imported from Bank of America Visa,,HJ,,503.32,-93834.89
2032,5/4/2021,5/4/2021,Antonio Gutierrez,Imported from Bank of America Visa,,HJ,,900,-94734.89
2032,5/4/2021,5/4/2021,Bank of America VISA,BofA Credit Card Payment April,,HJ,1578.32,,-93156.57
2032,5/4/2021,5/4/2021,Bank of America VISA,BofA Credit Card Payment April,,HJ,,2271.39,-95427.96
2032,5/4/2021,5/4/2021,Bank of America VISA,BofA Credit Card Payment April,,HJ,2300,,-93127.96
2032,5/4/2021,5/4/2021,Bank of America VISA,BofA Credit Card Payment April,,HJ,2823.34,,-90304.62
2032,5/4/2021,5/4/2021,Bank of America VISA,BofA Credit Card Payment April,,HJ,3523.37,,-86781.25
2032,5/4/2021,5/4/2021,Bank of America VISA,BofA Credit Card Payment April,,HJ,3864.2,,-82917.05
2032,5/4/2021,5/4/2021,Bank of America VISA,BofA Credit Card Payment April,,HJ,7471.07,,-75445.98
2032,5/4/2021,5/4/2021,Bank of America VISA,BofA Credit Card Payment April,,HJ,8069.48,,-67376.5
2032,5/4/2021,5/4/2021,Bank of America VISA,BofA Credit Card Payment April,,HJ,12519.92,,-54856.58
2032,5/4/2021,5/4/2021,Bank of America VISA,BofA Credit Card Payment April,,HJ,16675.32,,-38181.26
2032,5/4/2021,5/4/2021,Bank of America VISA,BofA Credit Card Payment April,,HJ,17011.48,,-21169.78
2032,5/4/2021,5/4/2021,Elizabeth Peinado,Imported from Bank of America Visa,,HJ,,15.46,-21185.24
2032,5/4/2021,5/4/2021,Elizabeth Peinado,Imported from Bank of America Visa,,HJ,,23.9,-21209.14
2032,5/4/2021,5/4/2021,Elizabeth Peinado,Imported from Bank of America Visa,,HJ,,23.9,-21233.04
2032,5/4/2021,5/4/2021,Elizabeth Peinado,Imported from Bank of America Visa,,HJ,,77.32,-21310.36
2032,5/4/2021,5/4/2021,Joseph Zarate,Imported from Bank of America Visa,,HJ,,9.97,-21320.33
2032,5/4/2021,5/4/2021,Joseph Zarate,Imported from Bank of America Visa,,HJ,,43.58,-21363.91
2032,5/4/2021,5/4/2021,Kyra Detone,Imported from Bank of America Visa,,HJ,,1.75,-21365.66
2032,5/4/2021,5/4/2021,Kyra Detone,Imported from Bank of America Visa,,HJ,,1.97,-21367.63
2032,5/4/2021,5/4/2021,Kyra Detone,Imported from Bank of America Visa,,HJ,,12.75,-21380.38
2032,5/4/2021,5/4/2021,Kyra Detone,Imported from Bank of America Visa,,HJ,,16.15,-21396.53
2032,5/4/2021,5/4/2021,Kyra Detone,Imported from Bank of America Visa,,HJ,,102.99,-21499.52
2032,5/4/2021,5/4/2021,Mahaliah Sejour,Imported from Bank of America Visa,,HJ,,6.45,-21505.97
2032,5/4/2021,5/4/2021,Mahaliah Sejour,Imported from Bank of America Visa,,HJ,,6.45,-21512.42
2032,5/4/2021,5/4/2021,Mahaliah Sejour,Imported from Bank of America Visa,,HJ,,13.12,-21525.54
2032,5/4/2021,5/4/2021,Mahaliah Sejour,Imported from Bank of America Visa,,HJ,,14.89,-21540.43
2032,5/4/2021,5/4/2021,Mahaliah Sejour,Imported from Bank of America Visa,,HJ,,18.48,-21558.91
2032,5/4/2021,5/4/2021,Mahaliah Sejour,Imported from Bank of America Visa,,HJ,,47.93,-21606.84
2032,5/4/2021,5/4/2021,Maryellen Leneghan,Imported from Bank of America Visa,,HJ,,9.97,-21616.81
2032,5/4/2021,5/4/2021,Myesha Hossain,Imported from Bank of America Visa,,HJ,1.94,,-21614.87
2032,5/4/2021,5/4/2021,Myesha Hossain,Imported from Bank of America Visa,,HJ,,4.99,-21619.86
2032,5/4/2021,5/4/2021,Myesha Hossain,Imported from Bank of America Visa,,HJ,,22.99,-21642.85
2032,5/4/2021,5/4/2021,Myesha Hossain,Imported from Bank of America Visa,,HJ,,24.99,-21667.84
2032,5/4/2021,5/4/2021,Myesha Hossain,Imported from Bank of America Visa,,HJ,,26.99,-21694.83
2032,5/4/2021,5/4/2021,Myesha Hossain,Imported from Bank of America Visa,,HJ,,26.99,-21721.82
2032,5/4/2021,5/4/2021,Myesha Hossain,Imported from Bank of America Visa,,HJ,,26.99,-21748.81
2032,5/4/2021,5/4/2021,Myesha Hossain,Imported from Bank of America Visa,,HJ,,26.99,-21775.8
2032,5/4/2021,5/4/2021,Myesha Hossain,Imported from Bank of America Visa,,HJ,,34,-21809.8
2032,5/4/2021,5/4/2021,Myesha Hossain,Imported from Bank of America Visa,,HJ,,34,-21843.8
2032,5/4/2021,5/4/2021,Myesha Hossain,Imported from Bank of America Visa,,HJ,,34,-21877.8
2032,5/4/2021,5/4/2021,Thomas Fischaber,Imported from Bank of America Visa,,HJ,,40.02,-21917.82
2032,5/5/2021,5/5/2021,Alan Safran,Imported from Bank of America Visa,,HJ,,1.99,-21919.81
2032,5/5/2021,5/5/2021,Alan Safran,Imported from Bank of America Visa,,HJ,,11,-21930.81
2032,5/5/2021,5/5/2021,Alan Safran,Imported from Bank of America Visa,,HJ,,36.5,-21967.31
2032,5/5/2021,5/5/2021,Antonio Gutierrez,Imported from Bank of America Visa,,HJ,12.99,,-21954.32
2032,5/5/2021,5/5/2021,Denise Parham-Gantt,Imported from Bank of America Visa,,HJ,,7.99,-21962.31
2032,5/5/2021,5/5/2021,Joseph Zarate,Imported from Bank of America Visa,,HJ,,99.56,-22061.87
2032,5/5/2021,5/5/2021,Joseph Zarate,Imported from Bank of America Visa,,HJ,,35.51,-22097.38
2032,5/5/2021,5/5/2021,Joseph Zarate,Imported from Bank of America Visa,,HJ,,1357.38,-23454.76
2032,5/5/2021,5/5/2021,Kyra Detone,Imported from Bank of America Visa,,HJ,,10.75,-23465.51
2032,5/5/2021,5/5/2021,Kyra Detone,Imported from Bank of America Visa,,HJ,,11.45,-23476.96
2032,5/5/2021,5/5/2021,Kyra Detone,Imported from Bank of America Visa,,HJ,,77,-23553.96
2032,5/5/2021,5/5/2021,Mahaliah Sejour,Imported from Bank of America Visa,,HJ,,6.05,-23560.01
2032,5/5/2021,5/5/2021,Mahaliah Sejour,Imported from Bank of America Visa,,HJ,,6.45,-23566.46
2032,5/5/2021,5/5/2021,Mahaliah Sejour,Imported from Bank of America Visa,,HJ,,6.45,-23572.91
2032,5/5/2021,5/5/2021,Mahaliah Sejour,Imported from Bank of America Visa,,HJ,,6.45,-23579.36
2032,5/5/2021,5/5/2021,Mahaliah Sejour,Imported from Bank of America Visa,,HJ,,14.84,-23594.2
2032,5/5/2021,5/5/2021,Mahaliah Sejour,Imported from Bank of America Visa,,HJ,,16.75,-23610.95
2032,5/5/2021,5/5/2021,Mahaliah Sejour,Imported from Bank of America Visa,,HJ,,17.99,-23628.94
2032,5/5/2021,5/5/2021,Maryellen Leneghan,Imported from Bank of America Visa,,HJ,,23.98,-23652.92
2032,5/5/2021,5/5/2021,Maryellen Leneghan,Imported from Bank of America Visa,,HJ,,25.42,-23678.34
2032,5/5/2021,5/5/2021,Maryellen Leneghan,Imported from Bank of America Visa,,HJ,,25.42,-23703.76
2032,5/5/2021,5/5/2021,Maryellen Leneghan,Imported from Bank of America Visa,,HJ,,25.42,-23729.18
2032,5/5/2021,5/5/2021,Maryellen Leneghan,Imported from Bank of America Visa,,HJ,,25.42,-23754.6
2032,5/5/2021,5/5/2021,Monivett Acevedo,Imported from Bank of America Visa,,HJ,,126.98,-23881.58
2032,5/5/2021,5/5/2021,Monivett Acevedo,Imported from Bank of America Visa,,HJ,,166.11,-24047.69
2032,5/5/2021,5/5/2021,Monivett Acevedo,Imported from Bank of America Visa,,HJ,,218.98,-24266.67
2032,5/5/2021,5/5/2021,Myesha Hossain,Imported from Bank of America Visa,,HJ,,4.89,-24271.56
2032,5/5/2021,5/5/2021,Myesha Hossain,Imported from Bank of America Visa,,HJ,,5.54,-24277.1
2032,5/5/2021,5/5/2021,Myesha Hossain,Imported from Bank of America Visa,,HJ,,57.6,-24334.7
2032,5/5/2021,5/5/2021,Myesha Hossain,Imported from Bank of America Visa,,HJ,,10.98,-24345.68
2032,5/5/2021,5/5/2021,Myesha Hossain,Imported from Bank of America Visa,,HJ,,24.98,-24370.66
2032,5/5/2021,5/5/2021,Tiffani Bibb,Imported from Bank of America Visa,,HJ,,279,-24649.66
2032,5/6/2021,5/6/2021,Antonio Gutierrez,Imported from Bank of America Visa,,HJ,,50,-24699.66
2032,5/6/2021,5/6/2021,Myesha Hossain,Imported from Bank of America Visa,,HJ,,13.47,-24713.13
2032,5/6/2021,5/6/2021,Myesha Hossain,Imported from Bank of America Visa,,HJ,,19.42,-24732.55
2032,5/7/2021,5/7/2021,Antonio Gutierrez,Imported from Bank of America Visa,,HJ,,900,-25632.55
2032,5/7/2021,5/7/2021,Halley Bowman,Imported from Bank of America Visa,,HJ,,7.44,-25639.99
2032,5/7/2021,5/7/2021,Halley Bowman,Imported from Bank of America Visa,,HJ,,11.49,-25651.48
2032,5/7/2021,5/7/2021,Halley Bowman,Imported from Bank of America Visa,,HJ,,11.49,-25662.97
2032,5/7/2021,5/7/2021,Halley Bowman,Imported from Bank of America Visa,,HJ,,37.19,-25700.16
2032,5/7/2021,5/7/2021,Joseph Zarate,Imported from Bank of America Visa,,HJ,,129.59,-25829.75
2032,5/7/2021,5/7/2021,Joseph Zarate,Imported from Bank of America Visa,,HJ,,4063.16,-29892.91
2032,5/7/2021,5/7/2021,Mahaliah Sejour,Imported from Bank of America Visa,,HJ,,16.75,-29909.66
2032,5/7/2021,5/7/2021,Mahaliah Sejour,Imported from Bank of America Visa,,HJ,,25.64,-29935.3
2032,5/7/2021,5/7/2021,Mahaliah Sejour,Imported from Bank of America Visa,,HJ,,70.56,-30005.86
2032,5/7/2021,5/7/2021,Mahaliah Sejour,Imported from Bank of America Visa,,HJ,,76.56,-30082.42
2032,5/7/2021,5/7/2021,Maryellen Leneghan,Imported from Bank of America Visa,,HJ,,10.99,-30093.41
2032,5/7/2021,5/7/2021,Maryellen Leneghan,Imported from Bank of America Visa,,HJ,,30.62,-30124.03
2032,5/7/2021,5/7/2021,Monivett Acevedo,Imported from Bank of America Visa,,HJ,,14.99,-30139.02
2032,5/7/2021,5/7/2021,Monivett Acevedo,Imported from Bank of America Visa,,HJ,,43.95,-30182.97
2032,5/7/2021,5/7/2021,Monivett Acevedo,Imported from Bank of America Visa,,HJ,,239.1,-30422.07
2032,5/7/2021,5/7/2021,Myesha Hossain,Imported from Bank of America Visa,,HJ,,8.99,-30431.06
2032,5/7/2021,5/7/2021,Myesha Hossain,Imported from Bank of America Visa,,HJ,,13.47,-30444.53
2032,5/7/2021,5/7/2021,Thomas Fischaber,Imported from Bank of America Visa,,HJ,,29.87,-30474.4
2032,5/7/2021,5/7/2021,Thomas Fischaber,Imported from Bank of America Visa,,HJ,,59,-30533.4
2032,5/10/2021,5/10/2021,Elizabeth Peinado,Imported from Bank of America Visa,,HJ,,599.62,-31133.02
2032,5/10/2021,5/10/2021,Elizabeth Peinado,Imported from Bank of America Visa,,HJ,,926.69,-32059.71
2032,5/10/2021,5/10/2021,Elizabeth Peinado,Imported from Bank of America Visa,,HJ,,926.69,-32986.4
2032,5/10/2021,5/10/2021,Elizabeth Peinado,Imported from Bank of America Visa,,HJ,,2998.12,-35984.52
2032,5/10/2021,5/10/2021,Halley Bowman,Imported from Bank of America Visa,,HJ,,22.58,-36007.1
2032,5/10/2021,5/10/2021,Halley Bowman,Imported from Bank of America Visa,,HJ,,34.89,-36041.99
2032,5/10/2021,5/10/2021,Halley Bowman,Imported from Bank of America Visa,,HJ,,34.89,-36076.88
2032,5/10/2021,5/10/2021,Halley Bowman,Imported from Bank of America Visa,,HJ,,112.87,-36189.75
2032,5/11/2021,5/11/2021,Alan Safran,Imported from Bank of America Visa,,HJ,,105.97,-36295.72
2032,5/11/2021,5/11/2021,Antonio Gutierrez,Imported from Bank of America Visa,,HJ,,19.11,-36314.83
2032,5/11/2021,5/11/2021,Halley Bowman,Imported from Bank of America Visa,,HJ,,1.9,-36316.73
2032,5/11/2021,5/11/2021,Halley Bowman,Imported from Bank of America Visa,,HJ,,2.94,-36319.67
2032,5/11/2021,5/11/2021,Halley Bowman,Imported from Bank of America Visa,,HJ,,2.94,-36322.61
2032,5/11/2021,5/11/2021,Halley Bowman,Imported from Bank of America Visa,,HJ,,9.51,-36332.12
2032,5/11/2021,5/11/2021,iaklestad,Imported from Bank of America Visa,,HJ,,46.5,-36378.62
2032,5/11/2021,5/11/2021,Joseph Zarate,Imported from Bank of America Visa,,HJ,,59.99,-36438.61
2032,5/11/2021,5/11/2021,Joseph Zarate,Imported from Bank of America Visa,,HJ,,49.06,-36487.67
2032,5/11/2021,5/11/2021,Joseph Zarate,Imported from Bank of America Visa,,HJ,,76.25,-36563.92
2032,5/11/2021,5/11/2021,Mahaliah Sejour,Imported from Bank of America Visa,,HJ,,14.18,-36578.1
2032,5/11/2021,5/11/2021,Mahaliah Sejour,Imported from Bank of America Visa,,HJ,,15.87,-36593.97
2032,5/11/2021,5/11/2021,Mahaliah Sejour,Imported from Bank of America Visa,,HJ,,17.98,-36611.95
2032,5/11/2021,5/11/2021,Mahaliah Sejour,Imported from Bank of America Visa,,HJ,,44.34,-36656.29
2032,5/11/2021,5/11/2021,Mahaliah Sejour,Imported from Bank of America Visa,,HJ,,1087.65,-37743.94
2032,5/11/2021,5/11/2021,Mahaliah Sejour,Imported from Bank of America Visa,,HJ,,9.97,-37753.91
2032,5/11/2021,5/11/2021,Mahaliah Sejour,Imported from Bank of America Visa,,HJ,,25.18,-37779.09
2032,5/11/2021,5/11/2021,Monivett Acevedo,Imported from Bank of America Visa,,HJ,43.95,,-37735.14
2032,5/11/2021,5/11/2021,Myesha Hossain,Imported from Bank of America Visa,,HJ,,14.97,-37750.11
2032,5/11/2021,5/11/2021,Myesha Hossain,Imported from Bank of America Visa,,HJ,,6.99,-37757.1
2032,5/11/2021,5/11/2021,Thomas Fischaber,Imported from Bank of America Visa,,HJ,,9.99,-37767.09
2032,5/11/2021,5/11/2021,Thomas Fischaber,Imported from Bank of America Visa,,HJ,,27.25,-37794.34
2032,5/11/2021,5/11/2021,Thomas Fischaber,Imported from Bank of America Visa,,HJ,,35.25,-37829.59
2032,5/11/2021,5/11/2021,Tiffani Bibb,Imported from Bank of America Visa,,HJ,,13.94,-37843.53
2032,5/12/2021,5/12/2021,Antonio Gutierrez,Imported from Bank of America Visa,,HJ,,235.17,-38078.7
2032,5/12/2021,5/12/2021,Antonio Gutierrez,Imported from Bank of America Visa,,HJ,,900,-38978.7
2032,5/12/2021,5/12/2021,claice Jackson,Imported from Bank of America Visa,,HJ,,12.82,-38991.52
2032,5/12/2021,5/12/2021,Nicole Prahin,Imported from Bank of America Visa,,HJ,,67.52,-39059.04
2032,5/12/2021,5/12/2021,Nicole Prahin,Imported from Bank of America Visa,,HJ,,87.18,-39146.22
2032,5/12/2021,5/12/2021,Nicole Prahin,Imported from Bank of America Visa,,HJ,,87.98,-39234.2
2032,5/13/2021,5/13/2021,Alan Safran,Imported from Bank of America Visa,,HJ,,10,-39244.2
2032,5/13/2021,5/13/2021,Alan Safran,Imported from Bank of America Visa,,HJ,,11,-39255.2
2032,5/13/2021,5/13/2021,Alan Safran,Imported from Bank of America Visa,,HJ,14.99,,-39240.21
2032,5/13/2021,5/13/2021,Alan Safran,Imported from Bank of America Visa,,HJ,,37.99,-39278.2
2032,5/13/2021,5/13/2021,Alan Safran,Imported from Bank of America Visa,,HJ,,161.12,-39439.32
2032,5/13/2021,5/13/2021,Alan Safran,Imported from Bank of America Visa,,HJ,,216.36,-39655.68
2032,5/13/2021,5/13/2021,Antonio Gutierrez,Imported from Bank of America Visa,,HJ,,76,-39731.68
2032,5/13/2021,5/13/2021,Joseph Zarate,Imported from Bank of America Visa,,HJ,,20.19,-39751.87
2032,5/13/2021,5/13/2021,Joseph Zarate,Imported from Bank of America Visa,,HJ,,20.19,-39772.06
2032,5/13/2021,5/13/2021,Joseph Zarate,Imported from Bank of America Visa,,HJ,,63.59,-39835.65
2032,5/13/2021,5/13/2021,Nicole Prahin,Imported from Bank of America Visa,,HJ,,5.35,-39841
2032,5/13/2021,5/13/2021,Thomas Fischaber,Imported from Bank of America Visa,,HJ,,32.64,-39873.64
2032,5/14/2021,5/14/2021,Antonio Gutierrez,Imported from Bank of America Visa,,HJ,,900,-40773.64
2032,5/14/2021,5/14/2021,Joseph Zarate,Imported from Bank of America Visa,,HJ,32.99,,-40740.65
2032,5/14/2021,5/14/2021,Joseph Zarate,Imported from Bank of America Visa,,HJ,,76.85,-40817.5
2032,5/14/2021,5/14/2021,Joseph Zarate,Imported from Bank of America Visa,,HJ,,1273.94,-42091.44
2032,5/14/2021,5/14/2021,Joseph Zarate,Imported from Bank of America Visa,,HJ,,1273.94,-43365.38
2032,5/14/2021,5/14/2021,Joseph Zarate,Imported from Bank of America Visa,,HJ,,2547.88,-45913.26
2032,5/14/2021,5/14/2021,Mahaliah Sejour,Imported from Bank of America Visa,,HJ,,5.35,-45918.61
2032,5/14/2021,5/14/2021,Mahaliah Sejour,Imported from Bank of America Visa,,HJ,,8.57,-45927.18
2032,5/14/2021,5/14/2021,Mahaliah Sejour,Imported from Bank of America Visa,,HJ,,27.99,-45955.17
2032,5/14/2021,5/14/2021,Mahaliah Sejour,Imported from Bank of America Visa,,HJ,,78.28,-46033.45
2032,5/14/2021,5/14/2021,Mahaliah Sejour,Imported from Bank of America Visa,,HJ,,444.8,-46478.25
2032,5/14/2021,5/14/2021,Maryellen Leneghan,Imported from Bank of America Visa,,HJ,,77.12,-46555.37
2032,5/14/2021,5/14/2021,Monivett Acevedo,Imported from Bank of America Visa,,HJ,,8,-46563.37
2032,5/14/2021,5/14/2021,Myesha Hossain,Imported from Bank of America Visa,,HJ,13.72,,-46549.65
2032,5/14/2021,5/14/2021,Odalis Polanco,Imported from Bank of America Visa,,HJ,,10.57,-46560.22
2032,5/14/2021,5/14/2021,Odalis Polanco,Imported from Bank of America Visa,,HJ,,150,-46710.22
2032,5/14/2021,5/14/2021,Tiffani Bibb,Imported from Bank of America Visa,,HJ,,26.07,-46736.29
2032,5/14/2021,5/14/2021,Tiffani Bibb,Imported from Bank of America Visa,,HJ,,150,-46886.29
2032,5/14/2021,5/14/2021,Tiffani Bibb,Imported from Bank of America Visa,,HJ,,314.79,-47201.08
2032,5/14/2021,5/14/2021,Tiffani Bibb,Imported from Bank of America Visa,,HJ,,314.79,-47515.87
2032,5/17/2021,5/17/2021,Alan Safran,Imported from Bank of America Visa,,HJ,,6.36,-47522.23
2032,5/17/2021,5/17/2021,Alan Safran,Imported from Bank of America Visa,,HJ,,8.8,-47531.03
2032,5/17/2021,5/17/2021,Alan Safran,Imported from Bank of America Visa,,HJ,,29.65,-47560.68
2032,5/17/2021,5/17/2021,Antonio Gutierrez,Imported from Bank of America Visa,,HJ,,4,-47564.68
2032,5/17/2021,5/17/2021,Antonio Gutierrez,Imported from Bank of America Visa,,HJ,,15.93,-47580.61
2032,5/17/2021,5/17/2021,Antonio Gutierrez,Imported from Bank of America Visa,,HJ,,48.84,-47629.45
2032,5/17/2021,5/17/2021,claice Jackson,Imported from Bank of America Visa,,HJ,,61.47,-47690.92
2032,5/17/2021,5/17/2021,Joseph Zarate,Imported from Bank of America Visa,,HJ,,106.89,-47797.81
2032,5/17/2021,5/17/2021,Joseph Zarate,Imported from Bank of America Visa,,HJ,,449,-48246.81
2032,5/17/2021,5/17/2021,Kyra Detone,Imported from Bank of America Visa,,HJ,,411.4,-48658.21
2032,5/17/2021,5/17/2021,Mahaliah Sejour,Imported from Bank of America Visa,,HJ,,6.42,-48664.63
2032,5/17/2021,5/17/2021,Mahaliah Sejour,Imported from Bank of America Visa,,HJ,,10.77,-48675.4
2032,5/17/2021,5/17/2021,Mahaliah Sejour,Imported from Bank of America Visa,,HJ,,36.98,-48712.38
2032,5/17/2021,5/17/2021,Mahaliah Sejour,Imported from Bank of America Visa,,HJ,,36.98,-48749.36
2032,5/17/2021,5/17/2021,Mahaliah Sejour,Imported from Bank of America Visa,,HJ,,36.98,-48786.34
2032,5/17/2021,5/17/2021,Mahaliah Sejour,Imported from Bank of America Visa,,HJ,,53.98,-48840.32
2032,5/17/2021,5/17/2021,Monivett Acevedo,Imported from Bank of America Visa,,HJ,,433.62,-49273.94
2032,5/17/2021,5/17/2021,Nicole Horton,Imported from Bank of America Visa,,HJ,,1,-49274.94
2032,5/17/2021,5/17/2021,Nicole Prahin,Imported from Bank of America Visa,,HJ,,2.17,-49277.11
2032,5/17/2021,5/17/2021,Tiffani Bibb,Imported from Bank of America Visa,,HJ,,664.19,-49941.3
2032,5/18/2021,5/18/2021,Alan Safran,Imported from Bank of America Visa,,HJ,,552.8,-50494.1
2032,5/18/2021,5/18/2021,Antonio Gutierrez,Imported from Bank of America Visa,,HJ,,618.92,-51113.02
2032,5/18/2021,5/18/2021,Joseph Zarate,Imported from Bank of America Visa,,HJ,,14.97,-51127.99
2032,5/18/2021,5/18/2021,Joseph Zarate,Imported from Bank of America Visa,,HJ,,21.9,-51149.89
2032,5/18/2021,5/18/2021,Joseph Zarate,Imported from Bank of America Visa,,HJ,,32.46,-51182.35
2032,5/18/2021,5/18/2021,Joseph Zarate,Imported from Bank of America Visa,,HJ,,375.6,-51557.95
2032,5/18/2021,5/18/2021,Joseph Zarate,Imported from Bank of America Visa,,HJ,,449,-52006.95
2032,5/18/2021,5/18/2021,Mahaliah Sejour,Imported from Bank of America Visa,,HJ,,5.35,-52012.3
2032,5/18/2021,5/18/2021,Mahaliah Sejour,Imported from Bank of America Visa,,HJ,,37.56,-52049.86
2032,5/18/2021,5/18/2021,Mahaliah Sejour,Imported from Bank of America Visa,,HJ,,161.02,-52210.88
2032,5/18/2021,5/18/2021,Maryellen Leneghan,Imported from Bank of America Visa,,HJ,,92.98,-52303.86
2032,5/18/2021,5/18/2021,Myesha Hossain,Imported from Bank of America Visa,,HJ,,18.95,-52322.81
2032,5/18/2021,5/18/2021,Myesha Hossain,Imported from Bank of America Visa,,HJ,,48.21,-52371.02
2032,5/18/2021,5/18/2021,Nicole Horton,Imported from Bank of America Visa,,HJ,,311.37,-52682.39
2032,5/19/2021,5/19/2021,Antonio Gutierrez,Imported from Bank of America Visa,,HJ,,900,-53582.39
2032,5/19/2021,5/19/2021,Joseph Zarate,Imported from Bank of America Visa,,HJ,,29.98,-53612.37
2032,5/19/2021,5/19/2021,Joseph Zarate,Imported from Bank of America Visa,,HJ,,34.98,-53647.35
2032,5/19/2021,5/19/2021,Maryellen Leneghan,Imported from Bank of America Visa,,HJ,,5.99,-53653.34
2032,5/19/2021,5/19/2021,Maryellen Leneghan,Imported from Bank of America Visa,,HJ,,7.49,-53660.83
2032,5/19/2021,5/19/2021,Maryellen Leneghan,Imported from Bank of America Visa,,HJ,,17.97,-53678.8
2032,5/19/2021,5/19/2021,Maryellen Leneghan,Imported from Bank of America Visa,,HJ,,18.99,-53697.79
2032,5/19/2021,5/19/2021,Maryellen Leneghan,Imported from Bank of America Visa,,HJ,,18.99,-53716.78
2032,5/19/2021,5/19/2021,Maryellen Leneghan,Imported from Bank of America Visa,,HJ,,20.13,-53736.91
2032,5/19/2021,5/19/2021,Maryellen Leneghan,Imported from Bank of America Visa,,HJ,,20.46,-53757.37
2032,5/19/2021,5/19/2021,Maryellen Leneghan,Imported from Bank of America Visa,,HJ,,20.46,-53777.83
2032,5/19/2021,5/19/2021,Maryellen Leneghan,Imported from Bank of America Visa,,HJ,,30.62,-53808.45
2032,5/19/2021,5/19/2021,Maryellen Leneghan,Imported from Bank of America Visa,,HJ,,30.62,-53839.07
2032,5/19/2021,5/19/2021,Maryellen Leneghan,Imported from Bank of America Visa,,HJ,,30.62,-53869.69
2032,5/19/2021,5/19/2021,Maryellen Leneghan,Imported from Bank of America Visa,,HJ,,33.8,-53903.49
2032,5/19/2021,5/19/2021,Myesha Hossain,Imported from Bank of America Visa,,HJ,,6.99,-53910.48
2032,5/19/2021,5/19/2021,Myesha Hossain,Imported from Bank of America Visa,,HJ,,8.47,-53918.95
2032,5/19/2021,5/19/2021,Myesha Hossain,Imported from Bank of America Visa,,HJ,,9.5,-53928.45
2032,5/19/2021,5/19/2021,Myesha Hossain,Imported from Bank of America Visa,,HJ,,10.95,-53939.4
2032,5/19/2021,5/19/2021,Myesha Hossain,Imported from Bank of America Visa,,HJ,,10.99,-53950.39
2032,5/19/2021,5/19/2021,Myesha Hossain,Imported from Bank of America Visa,,HJ,,22.99,-53973.38
2032,5/19/2021,5/19/2021,Thomas Fischaber,Imported from Bank of America Visa,,HJ,,84,-54057.38
2032,5/19/2021,5/19/2021,Thomas Fischaber,Imported from Bank of America Visa,,HJ,,2521.07,-56578.45
2032,5/20/2021,5/20/2021,Alan Safran,Imported from Bank of America Visa,,HJ,,26.5,-56604.95
2032,5/20/2021,5/20/2021,Alan Safran,Imported from Bank of America Visa,,HJ,,59.97,-56664.92
2032,5/20/2021,5/20/2021,Antonio Gutierrez,Imported from Bank of America Visa,,HJ,,6.75,-56671.67
2032,5/20/2021,5/20/2021,Antonio Gutierrez,Imported from Bank of America Visa,,HJ,,900,-57571.67
2032,5/20/2021,5/20/2021,Joseph Zarate,Imported from Bank of America Visa,,HJ,,32.88,-57604.55
2032,5/20/2021,5/20/2021,Joseph Zarate,Imported from Bank of America Visa,,HJ,,179.99,-57784.54
2032,5/20/2021,5/20/2021,Josh Hall,Imported from Bank of America Visa,,HJ,,16.18,-57800.72
2032,5/20/2021,5/20/2021,Mahaliah Sejour,Imported from Bank of America Visa,,HJ,,20,-57820.72
2032,5/20/2021,5/20/2021,Mahaliah Sejour,Imported from Bank of America Visa,,HJ,,24.11,-57844.83
2032,5/20/2021,5/20/2021,Mahaliah Sejour,Imported from Bank of America Visa,,HJ,,30.46,-57875.29
2032,5/20/2021,5/20/2021,Mahaliah Sejour,Imported from Bank of America Visa,,HJ,,34.93,-57910.22
2032,5/20/2021,5/20/2021,Mahaliah Sejour,Imported from Bank of America Visa,,HJ,,124.68,-58034.9
2032,5/20/2021,5/20/2021,Mahaliah Sejour,Imported from Bank of America Visa,,HJ,,135,-58169.9
2032,5/20/2021,5/20/2021,Myesha Hossain,Imported from Bank of America Visa,,HJ,,6.99,-58176.89
2032,5/20/2021,5/20/2021,Myesha Hossain,Imported from Bank of America Visa,,HJ,,71.3,-58248.19
2032,5/20/2021,5/20/2021,Nicole Prahin,Imported from Bank of America Visa,,HJ,,199.9,-58448.09
2032,5/20/2021,5/20/2021,Thomas Fischaber,Imported from Bank of America Visa,,HJ,,39,-58487.09
2032,5/21/2021,5/21/2021,Antonio Gutierrez,Imported from Bank of America Visa,,HJ,,900,-59387.09
2032,5/21/2021,5/21/2021,Elizabeth Peinado,Imported from Bank of America Visa,,HJ,,4.39,-59391.48
2032,5/21/2021,5/21/2021,Elizabeth Peinado,Imported from Bank of America Visa,,HJ,,6.79,-59398.27
2032,5/21/2021,5/21/2021,Elizabeth Peinado,Imported from Bank of America Visa,,HJ,,6.79,-59405.06
2032,5/21/2021,5/21/2021,Elizabeth Peinado,Imported from Bank of America Visa,,HJ,,21.98,-59427.04
2032,5/21/2021,5/21/2021,iaklestad,Imported from Bank of America Visa,,HJ,,350,-59777.04
2032,5/21/2021,5/21/2021,Joseph Zarate,Imported from Bank of America Visa,,HJ,,18.99,-59796.03
2032,5/21/2021,5/21/2021,Joseph Zarate,Imported from Bank of America Visa,,HJ,,1273.94,-61069.97
2032,5/21/2021,5/21/2021,Joseph Zarate,Imported from Bank of America Visa,,HJ,,1273.94,-62343.91
2032,5/21/2021,5/21/2021,Joseph Zarate,Imported from Bank of America Visa,,HJ,,15.5,-62359.41
2032,5/21/2021,5/21/2021,Joseph Zarate,Imported from Bank of America Visa,,HJ,,55.5,-62414.91
2032,5/21/2021,5/21/2021,Joseph Zarate,Imported from Bank of America Visa,,HJ,,124.99,-62539.9
2032,5/21/2021,5/21/2021,Joseph Zarate,Imported from Bank of America Visa,,HJ,,129.46,-62669.36
2032,5/21/2021,5/21/2021,Joseph Zarate,Imported from Bank of America Visa,,HJ,,399,-63068.36
2032,5/21/2021,5/21/2021,Josh Hall,Imported from Bank of America Visa,,HJ,,68.03,-63136.39
2032,5/21/2021,5/21/2021,Josh Hall,Imported from Bank of America Visa,,HJ,,39.95,-63176.34
2032,5/21/2021,5/21/2021,Josh Hall,Imported from Bank of America Visa,,HJ,,164.98,-63341.32
2032,5/21/2021,5/21/2021,Mahaliah Sejour,Imported from Bank of America Visa,,HJ,,16.98,-63358.3
2032,5/21/2021,5/21/2021,Mahaliah Sejour,Imported from Bank of America Visa,,HJ,,19.9,-63378.2
2032,5/21/2021,5/21/2021,Mahaliah Sejour,Imported from Bank of America Visa,,HJ,,25.53,-63403.73
2032,5/21/2021,5/21/2021,Mahaliah Sejour,Imported from Bank of America Visa,,HJ,,31.9,-63435.63
2032,5/21/2021,5/21/2021,Mahaliah Sejour,Imported from Bank of America Visa,,HJ,,130.9,-63566.53
2032,5/21/2021,5/21/2021,Mahaliah Sejour,Imported from Bank of America Visa,,HJ,,163.01,-63729.54
2032,5/21/2021,5/21/2021,Mahaliah Sejour,Imported from Bank of America Visa,,HJ,,19.4,-63748.94
2032,5/21/2021,5/21/2021,Mahaliah Sejour,Imported from Bank of America Visa,,HJ,,119.15,-63868.09
2032,5/21/2021,5/21/2021,Mahaliah Sejour,Imported from Bank of America Visa,,HJ,,206.15,-64074.24
2032,5/21/2021,5/21/2021,Maryellen Leneghan,Imported from Bank of America Visa,,HJ,,5.98,-64080.22
2032,5/21/2021,5/21/2021,Maryellen Leneghan,Imported from Bank of America Visa,,HJ,,3.07,-64083.29
2032,5/21/2021,5/21/2021,Maryellen Leneghan,Imported from Bank of America Visa,,HJ,,26.49,-64109.78
2032,5/21/2021,5/21/2021,Maryellen Leneghan,Imported from Bank of America Visa,,HJ,,30.65,-64140.43
2032,5/21/2021,5/21/2021,Maryellen Leneghan,Imported from Bank of America Visa,,HJ,,41,-64181.43
2032,5/21/2021,5/21/2021,Maryellen Leneghan,Imported from Bank of America Visa,,HJ,,57.85,-64239.28
2032,5/21/2021,5/21/2021,Thomas Fischaber,Imported from Bank of America Visa,,HJ,,0.78,-64240.06
2032,5/21/2021,5/21/2021,Tiffany Jordan,Imported from Bank of America Visa,,HJ,,235.45,-64475.51
2032,5/24/2021,5/24/2021,Alan Safran,Imported from Bank of America Visa,,HJ,,14.59,-64490.1
2032,5/24/2021,5/24/2021,Alan Safran,Imported from Bank of America Visa,,HJ,,17.21,-64507.31
2032,5/24/2021,5/24/2021,Alan Safran,Imported from Bank of America Visa,,HJ,,30.3,-64537.61
2032,5/24/2021,5/24/2021,Alan Safran,Imported from Bank of America Visa,,HJ,,54.94,-64592.55
2032,5/24/2021,5/24/2021,Alan Safran,Imported from Bank of America Visa,,HJ,,76,-64668.55
2032,5/24/2021,5/24/2021,Alan Safran,Imported from Bank of America Visa,,HJ,,206.27,-64874.82
2032,5/24/2021,5/24/2021,Denise Parham-Gantt,Imported from Bank of America Visa,,HJ,,2.37,-64877.19
2032,5/24/2021,5/24/2021,Denise Parham-Gantt,Imported from Bank of America Visa,,HJ,,957.78,-65834.97
2032,5/24/2021,5/24/2021,Denise Parham-Gantt,Imported from Bank of America Visa,,HJ,,118.3,-65953.27
2032,5/24/2021,5/24/2021,Elizabeth Peinado,Imported from Bank of America Visa,,HJ,,0.09,-65953.36
2032,5/24/2021,5/24/2021,Elizabeth Peinado,Imported from Bank of America Visa,,HJ,,0.14,-65953.5
2032,5/24/2021,5/24/2021,Elizabeth Peinado,Imported from Bank of America Visa,,HJ,,0.14,-65953.64
2032,5/24/2021,5/24/2021,Elizabeth Peinado,Imported from Bank of America Visa,,HJ,,0.43,-65954.07
2032,5/24/2021,5/24/2021,Elizabeth Peinado,Imported from Bank of America Visa,,HJ,,525.25,-66479.32
2032,5/24/2021,5/24/2021,Elizabeth Peinado,Imported from Bank of America Visa,,HJ,,811.75,-67291.07
2032,5/24/2021,5/24/2021,Elizabeth Peinado,Imported from Bank of America Visa,,HJ,,811.75,-68102.82
2032,5/24/2021,5/24/2021,Elizabeth Peinado,Imported from Bank of America Visa,,HJ,,2626.25,-70729.07
2032,5/24/2021,5/24/2021,iaklestad,Imported from Bank of America Visa,,HJ,,100,-70829.07
2032,5/24/2021,5/24/2021,iaklestad,Imported from Bank of America Visa,,HJ,,100,-70929.07
2032,5/24/2021,5/24/2021,iaklestad,Imported from Bank of America Visa,,HJ,,100,-71029.07
2032,5/24/2021,5/24/2021,iaklestad,Imported from Bank of America Visa,,HJ,,250,-71279.07
2032,5/24/2021,5/24/2021,iaklestad,Imported from Bank of America Visa,,HJ,,250,-71529.07
2032,5/24/2021,5/24/2021,Joseph Zarate,Imported from Bank of America Visa,,HJ,,65.74,-71594.81
2032,5/24/2021,5/24/2021,Joseph Zarate,Imported from Bank of America Visa,,HJ,,75.98,-71670.79
2032,5/24/2021,5/24/2021,Joseph Zarate,Imported from Bank of America Visa,,HJ,,82.06,-71752.85
2032,5/24/2021,5/24/2021,Joseph Zarate,Imported from Bank of America Visa,,HJ,,85,-71837.85
2032,5/24/2021,5/24/2021,Joseph Zarate,Imported from Bank of America Visa,,HJ,,151.96,-71989.81
2032,5/24/2021,5/24/2021,Mahaliah Sejour,Imported from Bank of America Visa,,HJ,,5.35,-71995.16
2032,5/24/2021,5/24/2021,Mahaliah Sejour,Imported from Bank of America Visa,,HJ,,39.98,-72035.14
2032,5/24/2021,5/24/2021,Mahaliah Sejour,Imported from Bank of America Visa,,HJ,,56.25,-72091.39
2032,5/24/2021,5/24/2021,Maryellen Leneghan,Imported from Bank of America Visa,,HJ,,15.94,-72107.33
2032,5/24/2021,5/24/2021,Maryellen Leneghan,Imported from Bank of America Visa,,HJ,,254.28,-72361.61
2032,5/24/2021,5/24/2021,Monivett Acevedo,Imported from Bank of America Visa,,HJ,,109.98,-72471.59
2032,5/24/2021,5/24/2021,Myesha Hossain,Imported from Bank of America Visa,,HJ,,177.95,-72649.54
2032,5/24/2021,5/24/2021,Tiffany Jordan,Imported from Bank of America Visa,,HJ,,108.99,-72758.53
2032,5/25/2021,5/25/2021,Alan Safran,Imported from Bank of America Visa,,HJ,,27.75,-72786.28
2032,5/25/2021,5/25/2021,Mahaliah Sejour,Imported from Bank of America Visa,,HJ,,22.99,-72809.27
2032,5/25/2021,5/25/2021,Myesha Hossain,Imported from Bank of America Visa,,HJ,,40.8,-72850.07
2032,5/25/2021,5/25/2021,Nicole Prahin,Imported from Bank of America Visa,,HJ,,4.25,-72854.32
2032,5/25/2021,5/25/2021,Nicole Prahin,Imported from Bank of America Visa,,HJ,,4.25,-72858.57
2032,5/25/2021,5/25/2021,Nicole Prahin,Imported from Bank of America Visa,,HJ,,4.29,-72862.86
2032,5/25/2021,5/25/2021,Nicole Prahin,Imported from Bank of America Visa,,HJ,,10.99,-72873.85
2032,5/25/2021,5/25/2021,Nicole Prahin,Imported from Bank of America Visa,,HJ,,11.87,-72885.72
2032,5/25/2021,5/25/2021,Nicole Prahin,Imported from Bank of America Visa,,HJ,,15.86,-72901.58
2032,5/25/2021,5/25/2021,Nicole Prahin,Imported from Bank of America Visa,,HJ,,16.31,-72917.89
2032,5/25/2021,5/25/2021,Nicole Prahin,Imported from Bank of America Visa,,HJ,,16.46,-72934.35
2032,5/25/2021,5/25/2021,Nicole Prahin,Imported from Bank of America Visa,,HJ,,16.5,-72950.85
2032,5/25/2021,5/25/2021,Nicole Prahin,Imported from Bank of America Visa,,HJ,,16.5,-72967.35
2032,5/26/2021,5/26/2021,Alan Safran,Imported from Bank of America Visa,,HJ,,27.75,-72995.1
2032,5/26/2021,5/26/2021,Alan Safran,Imported from Bank of America Visa,,HJ,,27.75,-73022.85
2032,5/26/2021,5/26/2021,Alan Safran,Imported from Bank of America Visa,,HJ,,27.75,-73050.6
2032,5/26/2021,5/26/2021,Alan Safran,Imported from Bank of America Visa,,HJ,,27.75,-73078.35
2032,5/26/2021,5/26/2021,Alan Safran,Imported from Bank of America Visa,,HJ,,27.75,-73106.1
2032,5/26/2021,5/26/2021,Alan Safran,Imported from Bank of America Visa,,HJ,,36.5,-73142.6
2032,5/26/2021,5/26/2021,Alan Safran,Imported from Bank of America Visa,,HJ,,36.5,-73179.1
2032,5/26/2021,5/26/2021,Antonio Gutierrez,Imported from Bank of America Visa,,HJ,,49,-73228.1
2032,5/26/2021,5/26/2021,Antonio Gutierrez,Imported from Bank of America Visa,,HJ,,900,-74128.1
2032,5/26/2021,5/26/2021,Elizabeth Peinado,Imported from Bank of America Visa,,HJ,,165,-74293.1
2032,5/26/2021,5/26/2021,Elizabeth Peinado,Imported from Bank of America Visa,,HJ,,255,-74548.1
2032,5/26/2021,5/26/2021,Elizabeth Peinado,Imported from Bank of America Visa,,HJ,,255,-74803.1
2032,5/26/2021,5/26/2021,Elizabeth Peinado,Imported from Bank of America Visa,,HJ,,825,-75628.1
2032,5/26/2021,5/26/2021,Joseph Zarate,Imported from Bank of America Visa,,HJ,,79.63,-75707.73
2032,5/26/2021,5/26/2021,Joseph Zarate,Imported from Bank of America Visa,,HJ,1357.38,,-74350.35
2032,5/26/2021,5/26/2021,Joseph Zarate,Imported from Bank of America Visa,,HJ,4063.16,,-70287.19
2032,5/26/2021,5/26/2021,Mahaliah Sejour,Imported from Bank of America Visa,,HJ,,1.99,-70289.18
2032,5/26/2021,5/26/2021,Mahaliah Sejour,Imported from Bank of America Visa,,HJ,,71.7,-70360.88
2032,5/26/2021,5/26/2021,Maryellen Leneghan,Imported from Bank of America Visa,,HJ,,11.49,-70372.37
2032,5/26/2021,5/26/2021,Maryellen Leneghan,Imported from Bank of America Visa,,HJ,,13.99,-70386.36
2032,5/26/2021,5/26/2021,Maryellen Leneghan,Imported from Bank of America Visa,,HJ,,15.94,-70402.3
2032,5/26/2021,5/26/2021,Maryellen Leneghan,Imported from Bank of America Visa,,HJ,,16.9,-70419.2
2032,5/26/2021,5/26/2021,Maryellen Leneghan,Imported from Bank of America Visa,,HJ,,16.9,-70436.1
2032,5/26/2021,5/26/2021,Maryellen Leneghan,Imported from Bank of America Visa,,HJ,,16.9,-70453
2032,5/26/2021,5/26/2021,Maryellen Leneghan,Imported from Bank of America Visa,,HJ,,16.9,-70469.9
2032,5/26/2021,5/26/2021,Maryellen Leneghan,Imported from Bank of America Visa,,HJ,,17.1,-70487
2032,5/26/2021,5/26/2021,Maryellen Leneghan,Imported from Bank of America Visa,,HJ,,17.22,-70504.22
2032,5/26/2021,5/26/2021,Maryellen Leneghan,Imported from Bank of America Visa,,HJ,,17.88,-70522.1
2032,5/26/2021,5/26/2021,Maryellen Leneghan,Imported from Bank of America Visa,,HJ,,28.39,-70550.49
2032,5/26/2021,5/26/2021,Maryellen Leneghan,Imported from Bank of America Visa,,HJ,,279,-70829.49
2032,5/26/2021,5/26/2021,Monivett Acevedo,Imported from Bank of America Visa,,HJ,,36.99,-70866.48
2032,5/26/2021,5/26/2021,Myesha Hossain,Imported from Bank of America Visa,,HJ,,8.49,-70874.97
2032,5/26/2021,5/26/2021,Nicole Prahin,Imported from Bank of America Visa,,HJ,,11.76,-70886.73
2032,5/26/2021,5/26/2021,Nicole Prahin,Imported from Bank of America Visa,,HJ,,16.29,-70903.02
2032,5/26/2021,5/26/2021,Nicole Prahin,Imported from Bank of America Visa,,HJ,,45.54,-70948.56
2032,5/26/2021,5/26/2021,Odalis Polanco,Imported from Bank of America Visa,,HJ,,780.92,-71729.48
2032,5/26/2021,5/26/2021,Thomas Fischaber,Imported from Bank of America Visa,,HJ,,30.23,-71759.71
2032,5/27/2021,5/27/2021,Antonio Gutierrez,Imported from Bank of America Visa,,HJ,,58.47,-71818.18
2032,5/27/2021,5/27/2021,Nicole Prahin,Imported from Bank of America Visa,,HJ,,104.16,-71922.34
2032,5/28/2021,5/28/2021,Alan Safran,Imported from Bank of America Visa,,HJ,,27.75,-71950.09
2032,5/28/2021,5/28/2021,Alan Safran,Imported from Bank of America Visa,,HJ,,27.75,-71977.84
2032,5/28/2021,5/28/2021,Alan Safran,Imported from Bank of America Visa,,HJ,,78,-72055.84
2032,5/28/2021,5/28/2021,Alan Safran,Imported from Bank of America Visa,,HJ,,36.5,-72092.34
2032,5/28/2021,5/28/2021,Antonio Gutierrez,Imported from Bank of America Visa,,HJ,,50,-72142.34
2032,5/28/2021,5/28/2021,Antonio Gutierrez,Imported from Bank of America Visa,,HJ,,50,-72192.34
2032,5/28/2021,5/28/2021,Antonio Gutierrez,Imported from Bank of America Visa,,HJ,,900,-73092.34
2032,5/28/2021,5/28/2021,iaklestad,Imported from Bank of America Visa,,HJ,,28.99,-73121.33
2032,5/28/2021,5/28/2021,iaklestad,Imported from Bank of America Visa,,HJ,,34.92,-73156.25
2032,5/28/2021,5/28/2021,iaklestad,Imported from Bank of America Visa,,HJ,,18.92,-73175.17
2032,5/28/2021,5/28/2021,Joseph Zarate,Imported from Bank of America Visa,,HJ,,4318.16,-77493.33
2032,5/28/2021,5/28/2021,Kyra Detone,Imported from Bank of America Visa,,HJ,,9.05,-77502.38
2032,5/28/2021,5/28/2021,Kyra Detone,Imported from Bank of America Visa,,HJ,,54.74,-77557.12
2032,5/28/2021,5/28/2021,Kyra Detone,Imported from Bank of America Visa,,HJ,,63.68,-77620.8
2032,5/28/2021,5/28/2021,Maryellen Leneghan,Imported from Bank of America Visa,,HJ,,14.95,-77635.75
2032,5/28/2021,5/28/2021,Myesha Hossain,Imported from Bank of America Visa,,HJ,,8.49,-77644.24
2032,5/28/2021,5/28/2021,Nicole Prahin,Imported from Bank of America Visa,,HJ,,85.55,-77729.79
2032,5/28/2021,5/28/2021,Thomas Fischaber,Imported from Bank of America Visa,,HJ,,48.9,-77778.69
2032,5/30/2021,5/30/2021,Alan Safran,Imported from Bank of America Visa,,HJ,,27.75,-77806.44
2032,5/30/2021,5/30/2021,Antonio Gutierrez,Imported from Bank of America Visa,,HJ,,900,-78706.44
2032,5/30/2021,5/30/2021,Maryellen Leneghan,Imported from Bank of America Visa,,HJ,,16.56,-78723
2032,5/31/2021,5/31/2021,Antonio Gutierrez,Imported from Bank of America Visa,,HJ,,75,-78798
2032,5/31/2021,5/31/2021,Elizabeth Peinado,Imported from Bank of America Visa,,HJ,,8.25,-78806.25
2032,5/31/2021,5/31/2021,Elizabeth Peinado,Imported from Bank of America Visa,,HJ,,12.75,-78819
2032,5/31/2021,5/31/2021,Elizabeth Peinado,Imported from Bank of America Visa,,HJ,,12.75,-78831.75
2032,5/31/2021,5/31/2021,Elizabeth Peinado,Imported from Bank of America Visa,,HJ,,41.25,-78873
2032,6/1/2021,6/1/2021,Alan Safran,Imported from Bank of America Visa,,HJ,,36.5,-78909.5
2032,6/1/2021,6/1/2021,Alan Safran,Imported from Bank of America Visa,,HJ,,61,-78970.5
2032,6/1/2021,6/1/2021,Antonio Gutierrez,Imported from Bank of America Visa,,HJ,,45,-79015.5
2032,6/1/2021,6/1/2021,Antonio Gutierrez,Imported from Bank of America Visa,,HJ,,354.46,-79369.96
2032,6/1/2021,6/1/2021,Antonio Gutierrez,Imported from Bank of America Visa,,HJ,,545.54,-79915.5
2032,6/1/2021,6/1/2021,Denise Parham-Gantt,Imported from Bank of America Visa,,HJ,,138.4,-80053.9
2032,6/1/2021,6/1/2021,Elizabeth Peinado,Imported from Bank of America Visa,,HJ,,99,-80152.9
2032,6/1/2021,6/1/2021,Elizabeth Peinado,Imported from Bank of America Visa,,HJ,,153,-80305.9
2032,6/1/2021,6/1/2021,Elizabeth Peinado,Imported from Bank of America Visa,,HJ,,153,-80458.9
2032,6/1/2021,6/1/2021,Elizabeth Peinado,Imported from Bank of America Visa,,HJ,,495,-80953.9
2032,6/1/2021,6/1/2021,Elizabeth Peinado,Imported from Bank of America Visa,,HJ,,541.05,-81494.95
2032,6/1/2021,6/1/2021,Elizabeth Peinado,Imported from Bank of America Visa,,HJ,,836.17,-82331.12
2032,6/1/2021,6/1/2021,Elizabeth Peinado,Imported from Bank of America Visa,,HJ,,836.17,-83167.29
2032,6/1/2021,6/1/2021,Elizabeth Peinado,Imported from Bank of America Visa,,HJ,,2705.26,-85872.55
2032,6/1/2021,6/1/2021,iaklestad,Imported from Bank of America Visa,,HJ,,31,-85903.55
2032,6/1/2021,6/1/2021,Joseph Zarate,Imported from Bank of America Visa,,HJ,,111.45,-86015
2032,6/1/2021,6/1/2021,Joseph Zarate,Imported from Bank of America Visa,,HJ,,112.99,-86127.99
2032,6/1/2021,6/1/2021,Joseph Zarate,Imported from Bank of America Visa,,HJ,,367.5,-86495.49
2032,6/1/2021,6/1/2021,Mahaliah Sejour,Imported from Bank of America Visa,,HJ,,149,-86644.49
2032,6/1/2021,6/1/2021,Mahaliah Sejour,Imported from Bank of America Visa,,HJ,,173,-86817.49
2032,6/1/2021,6/1/2021,Maryellen Leneghan,Imported from Bank of America Visa,,HJ,,35.96,-86853.45
2032,6/1/2021,6/1/2021,Odalis Polanco,Imported from Bank of America Visa,,HJ,,780.92,-87634.37
2032,6/1/2021,6/1/2021,Thomas Fischaber,Imported from Bank of America Visa,,HJ,,11,-87645.37
2032,6/1/2021,6/1/2021,Thomas Fischaber,Imported from Bank of America Visa,,HJ,,12,-87657.37
2032,6/1/2021,6/1/2021,Thomas Fischaber,Imported from Bank of America Visa,,HJ,,12,-87669.37
2032,6/1/2021,6/1/2021,Thomas Fischaber,Imported from Bank of America Visa,,HJ,,12,-87681.37
2032,6/1/2021,6/1/2021,Thomas Fischaber,Imported from Bank of America Visa,,HJ,,12,-87693.37
2032,6/1/2021,6/1/2021,Thomas Fischaber,Imported from Bank of America Visa,,HJ,,12,-87705.37
2032,6/1/2021,6/1/2021,Thomas Fischaber,Imported from Bank of America Visa,,HJ,,12,-87717.37
2032,6/1/2021,6/1/2021,Thomas Fischaber,Imported from Bank of America Visa,,HJ,,12,-87729.37
2032,6/1/2021,6/1/2021,Thomas Fischaber,Imported from Bank of America Visa,,HJ,,82.21,-87811.58
2032,6/1/2021,6/1/2021,Thomas Fischaber,Imported from Bank of America Visa,,HJ,,238,-88049.58
2032,6/1/2021,6/1/2021,Thomas Fischaber,Imported from Bank of America Visa,,HJ,,700,-88749.58
2032,6/2/2021,6/2/2021,Alan Safran,Imported from Bank of America Visa,,HJ,,83.4,-88832.98
2032,6/2/2021,6/2/2021,Alan Safran,Imported from Bank of America Visa,,HJ,,26.5,-88859.48
2032,6/2/2021,6/2/2021,Alan Safran,Imported from Bank of America Visa,,HJ,,27.75,-88887.23
2032,6/2/2021,6/2/2021,Alan Safran,Imported from Bank of America Visa,,HJ,,27.75,-88914.98
2032,6/2/2021,6/2/2021,Alan Safran,Imported from Bank of America Visa,,HJ,,27.75,-88942.73
2032,6/2/2021,6/2/2021,Alan Safran,Imported from Bank of America Visa,,HJ,,58,-89000.73
2032,6/2/2021,6/2/2021,Alan Safran,Imported from Bank of America Visa,,HJ,,66,-89066.73
2032,6/2/2021,6/2/2021,Antonio Gutierrez,Imported from Bank of America Visa,,HJ,,100,-89166.73
2032,6/2/2021,6/2/2021,Antonio Gutierrez,Imported from Bank of America Visa,,HJ,,110,-89276.73
2032,6/2/2021,6/2/2021,Antonio Gutierrez,Imported from Bank of America Visa,,HJ,,180,-89456.73
2032,6/2/2021,6/2/2021,Antonio Gutierrez,Imported from Bank of America Visa,,HJ,,790,-90246.73
2032,6/2/2021,6/2/2021,Antonio Gutierrez,Imported from Bank of America Visa,,HJ,,800,-91046.73
2032,6/2/2021,6/2/2021,Elizabeth Peinado,Imported from Bank of America Visa,,HJ,,4.39,-91051.12
2032,6/2/2021,6/2/2021,Elizabeth Peinado,Imported from Bank of America Visa,,HJ,,6.79,-91057.91
2032,6/2/2021,6/2/2021,Elizabeth Peinado,Imported from Bank of America Visa,,HJ,,6.79,-91064.7
2032,6/2/2021,6/2/2021,Elizabeth Peinado,Imported from Bank of America Visa,,HJ,,21.98,-91086.68
2032,6/2/2021,6/2/2021,Joseph Zarate,Imported from Bank of America Visa,,HJ,,399,-91485.68
2032,6/2/2021,6/2/2021,Joseph Zarate,Imported from Bank of America Visa,,HJ,,2880.27,-94365.95
2032,6/2/2021,6/2/2021,Joseph Zarate,Imported from Bank of America Visa,,HJ,,67.57,-94433.52
2032,6/2/2021,6/2/2021,Joseph Zarate,Imported from Bank of America Visa,,HJ,,100,-94533.52
2032,6/2/2021,6/2/2021,Joseph Zarate,Imported from Bank of America Visa,,HJ,,100,-94633.52
2032,6/2/2021,6/2/2021,Joseph Zarate,Imported from Bank of America Visa,,HJ,,100,-94733.52
2032,6/2/2021,6/2/2021,Joseph Zarate,Imported from Bank of America Visa,,HJ,,100,-94833.52
2032,6/2/2021,6/2/2021,Joseph Zarate,Imported from Bank of America Visa,,HJ,,100,-94933.52
2032,6/2/2021,6/2/2021,Joseph Zarate,Imported from Bank of America Visa,,HJ,,2547.88,-97481.4
2032,6/2/2021,6/2/2021,Mahaliah Sejour,Imported from Bank of America Visa,,HJ,,5.35,-97486.75
2032,6/2/2021,6/2/2021,Mahaliah Sejour,Imported from Bank of America Visa,,HJ,,5.35,-97492.1
2032,6/2/2021,6/2/2021,Mahaliah Sejour,Imported from Bank of America Visa,,HJ,,11.99,-97504.09
2032,6/2/2021,6/2/2021,Mahaliah Sejour,Imported from Bank of America Visa,,HJ,,22.47,-97526.56
2032,6/2/2021,6/2/2021,Mahaliah Sejour,Imported from Bank of America Visa,,HJ,,35.96,-97562.52
2032,6/2/2021,6/2/2021,Maryellen Leneghan,Imported from Bank of America Visa,,HJ,,13.49,-97576.01
2032,6/2/2021,6/2/2021,Maryellen Leneghan,Imported from Bank of America Visa,,HJ,,8.99,-97585
2032,6/2/2021,6/2/2021,Maryellen Leneghan,Imported from Bank of America Visa,,HJ,,8.99,-97593.99
2032,6/2/2021,6/2/2021,Maryellen Leneghan,Imported from Bank of America Visa,,HJ,,8.99,-97602.98
2032,6/2/2021,6/2/2021,Maryellen Leneghan,Imported from Bank of America Visa,,HJ,,8.99,-97611.97
2032,6/2/2021,6/2/2021,Monivett Acevedo,Imported from Bank of America Visa,,HJ,,11.99,-97623.96
2032,6/2/2021,6/2/2021,Monivett Acevedo,Imported from Bank of America Visa,,HJ,,12.8,-97636.76
2032,6/2/2021,6/2/2021,Myesha Hossain,Imported from Bank of America Visa,,HJ,,5.94,-97642.7
2032,6/2/2021,6/2/2021,Myesha Hossain,Imported from Bank of America Visa,,HJ,,8.62,-97651.32
2032,6/2/2021,6/2/2021,Myesha Hossain,Imported from Bank of America Visa,,HJ,,9.3,-97660.62
2032,6/2/2021,6/2/2021,Myesha Hossain,Imported from Bank of America Visa,,HJ,,9.3,-97669.92
2032,6/2/2021,6/2/2021,Myesha Hossain,Imported from Bank of America Visa,,HJ,,14.97,-97684.89
2032,6/2/2021,6/2/2021,Myesha Hossain,Imported from Bank of America Visa,,HJ,,14.97,-97699.86
2032,6/2/2021,6/2/2021,Myesha Hossain,Imported from Bank of America Visa,,HJ,,14.99,-97714.85
2032,6/2/2021,6/2/2021,Myesha Hossain,Imported from Bank of America Visa,,HJ,,16.99,-97731.84
2032,6/2/2021,6/2/2021,Myesha Hossain,Imported from Bank of America Visa,,HJ,,16.99,-97748.83
2032,6/2/2021,6/2/2021,Myesha Hossain,Imported from Bank of America Visa,,HJ,,17.95,-97766.78
2032,6/2/2021,6/2/2021,Myesha Hossain,Imported from Bank of America Visa,,HJ,,18.48,-97785.26
2032,6/2/2021,6/2/2021,Myesha Hossain,Imported from Bank of America Visa,,HJ,,28.17,-97813.43
2032,6/2/2021,6/2/2021,Myesha Hossain,Imported from Bank of America Visa,,HJ,,28.45,-97841.88
2032,6/2/2021,6/2/2021,Myesha Hossain,Imported from Bank of America Visa,,HJ,,28.45,-97870.33
2032,6/2/2021,6/2/2021,Myesha Hossain,Imported from Bank of America Visa,,HJ,,28.45,-97898.78
2032,6/2/2021,6/2/2021,Myesha Hossain,Imported from Bank of America Visa,,HJ,,28.47,-97927.25
2032,6/2/2021,6/2/2021,Myesha Hossain,Imported from Bank of America Visa,,HJ,,50,-97977.25
2032,6/2/2021,6/2/2021,Myesha Hossain,Imported from Bank of America Visa,,HJ,,61.72,-98038.97
2032,6/2/2021,6/2/2021,Myesha Hossain,Imported from Bank of America Visa,,HJ,,133.95,-98172.92
2032,6/2/2021,6/2/2021,Myesha Hossain,Imported from Bank of America Visa,,HJ,,177.95,-98350.87
2032,6/2/2021,6/2/2021,Thomas Fischaber,Imported from Bank of America Visa,,HJ,,12,-98362.87
2032,6/2/2021,6/2/2021,Thomas Fischaber,Imported from Bank of America Visa,,HJ,,12,-98374.87
2032,6/2/2021,6/2/2021,Thomas Fischaber,Imported from Bank of America Visa,,HJ,,84,-98458.87
2032,6/2/2021,6/2/2021,Thomas Fischaber,Imported from Bank of America Visa,,HJ,,1280,-99738.87
2032,6/4/2021,6/4/2021,Alan Safran,Imported from Bank of America Visa,,HJ,,1.99,-99740.86
2032,6/4/2021,6/4/2021,Alan Safran,Imported from Bank of America Visa,,HJ,,27.75,-99768.61
2032,6/4/2021,6/4/2021,Alan Safran,Imported from Bank of America Visa,,HJ,,27.75,-99796.36
2032,6/4/2021,6/4/2021,Alan Safran,Imported from Bank of America Visa,,HJ,,27.75,-99824.11
2032,6/4/2021,6/4/2021,Alan Safran,Imported from Bank of America Visa,,HJ,,27.75,-99851.86
2032,6/4/2021,6/4/2021,Alan Safran,Imported from Bank of America Visa,,HJ,,27.75,-99879.61
2032,6/4/2021,6/4/2021,Alan Safran,Imported from Bank of America Visa,,HJ,,27.75,-99907.36
2032,6/4/2021,6/4/2021,Alan Safran,Imported from Bank of America Visa,,HJ,,27.75,-99935.11
2032,6/4/2021,6/4/2021,Alan Safran,Imported from Bank of America Visa,,HJ,,51.5,-99986.61
2032,6/4/2021,6/4/2021,Antonio Gutierrez,Imported from Bank of America Visa,,HJ,,33.48,-100020.09
2032,6/4/2021,6/4/2021,Antonio Gutierrez,Imported from Bank of America Visa,,HJ,,294.4,-100314.49
2032,6/4/2021,6/4/2021,Antonio Gutierrez,Imported from Bank of America Visa,,HJ,,329.96,-100644.45
2032,6/4/2021,6/4/2021,Antonio Gutierrez,Imported from Bank of America Visa,,HJ,,900,-101544.45
2032,6/4/2021,6/4/2021,Bank of America VISA,May B of A Payment,,HJ,2909.84,,-98634.61
2032,6/4/2021,6/4/2021,Bank of America VISA,May B of A Payment,,HJ,4359.42,,-94275.19
2032,6/4/2021,6/4/2021,Bank of America VISA,May B of A Payment,,HJ,5182.97,,-89092.22
2032,6/4/2021,6/4/2021,Bank of America VISA,May B of A Payment,,HJ,7250.43,,-81841.79
2032,6/4/2021,6/4/2021,Bank of America VISA,May B of A Payment,,HJ,7804.23,,-74037.56
2032,6/4/2021,6/4/2021,Bank of America VISA,May B of A Payment,,HJ,8505.99,,-65531.57
2032,6/4/2021,6/4/2021,Bank of America VISA,May B of A Payment,,HJ,14156.9,,-51374.67
2032,6/4/2021,6/4/2021,Bank of America VISA,May B of A Payment,,HJ,28703.22,,-22671.45
2032,6/4/2021,6/4/2021,Denise Parham-Gantt,Imported from Bank of America Visa,,HJ,31.99,,-22639.46
2032,6/4/2021,6/4/2021,Denise Parham-Gantt,Imported from Bank of America Visa,,HJ,,50,-22689.46
2032,6/4/2021,6/4/2021,Denise Parham-Gantt,Imported from Bank of America Visa,,HJ,,200,-22889.46
2032,6/4/2021,6/4/2021,Denise Parham-Gantt,Imported from Bank of America Visa,,HJ,,12.92,-22902.38
2032,6/4/2021,6/4/2021,Joseph Zarate,Imported from Bank of America Visa,,HJ,,39.99,-22942.37
2032,6/4/2021,6/4/2021,Joseph Zarate,Imported from Bank of America Visa,,HJ,,46.5,-22988.87
2032,6/4/2021,6/4/2021,Joseph Zarate,Imported from Bank of America Visa,,HJ,,50,-23038.87
2032,6/4/2021,6/4/2021,Joseph Zarate,Imported from Bank of America Visa,,HJ,,50,-23088.87
2032,6/4/2021,6/4/2021,Joseph Zarate,Imported from Bank of America Visa,,HJ,,100,-23188.87
2032,6/4/2021,6/4/2021,Joseph Zarate,Imported from Bank of America Visa,,HJ,,2547.88,-25736.75
2032,6/4/2021,6/4/2021,Joseph Zarate,Imported from Bank of America Visa,,HJ,,338.99,-26075.74
2032,6/4/2021,6/4/2021,Mahaliah Sejour,Imported from Bank of America Visa,,HJ,,5.35,-26081.09
2032,6/4/2021,6/4/2021,Mahaliah Sejour,Imported from Bank of America Visa,,HJ,,8.98,-26090.07
2032,6/4/2021,6/4/2021,Mahaliah Sejour,Imported from Bank of America Visa,,HJ,,8.99,-26099.06
2032,6/4/2021,6/4/2021,Mahaliah Sejour,Imported from Bank of America Visa,,HJ,,14,-26113.06
2032,6/4/2021,6/4/2021,Mahaliah Sejour,Imported from Bank of America Visa,,HJ,,18.5,-26131.56
2032,6/4/2021,6/4/2021,Mahaliah Sejour,Imported from Bank of America Visa,,HJ,,22.53,-26154.09
2032,6/4/2021,6/4/2021,Mahaliah Sejour,Imported from Bank of America Visa,,HJ,,22.89,-26176.98
2032,6/4/2021,6/4/2021,Mahaliah Sejour,Imported from Bank of America Visa,,HJ,,26.5,-26203.48
2032,6/4/2021,6/4/2021,Mahaliah Sejour,Imported from Bank of America Visa,,HJ,,26.5,-26229.98
2032,6/4/2021,6/4/2021,Mahaliah Sejour,Imported from Bank of America Visa,,HJ,,30,-26259.98
2032,6/4/2021,6/4/2021,Mahaliah Sejour,Imported from Bank of America Visa,,HJ,,36.69,-26296.67
2032,6/4/2021,6/4/2021,Mahaliah Sejour,Imported from Bank of America Visa,,HJ,,36.94,-26333.61
2032,6/4/2021,6/4/2021,Mahaliah Sejour,Imported from Bank of America Visa,,HJ,,45.95,-26379.56
2032,6/4/2021,6/4/2021,Mahaliah Sejour,Imported from Bank of America Visa,,HJ,,47.4,-26426.96
2032,6/4/2021,6/4/2021,Mahaliah Sejour,Imported from Bank of America Visa,,HJ,,47.4,-26474.36
2032,6/4/2021,6/4/2021,Mahaliah Sejour,Imported from Bank of America Visa,,HJ,,52.55,-26526.91
2032,6/4/2021,6/4/2021,Mahaliah Sejour,Imported from Bank of America Visa,,HJ,,70.86,-26597.77
2032,6/4/2021,6/4/2021,Mahaliah Sejour,Imported from Bank of America Visa,,HJ,,70.86,-26668.63
2032,6/4/2021,6/4/2021,Mahaliah Sejour,Imported from Bank of America Visa,,HJ,,83.26,-26751.89
2032,6/4/2021,6/4/2021,Mahaliah Sejour,Imported from Bank of America Visa,,HJ,,83.26,-26835.15
2032,6/4/2021,6/4/2021,Mahaliah Sejour,Imported from Bank of America Visa,,HJ,,269.5,-27104.65
2032,6/4/2021,6/4/2021,Maryellen Leneghan,Imported from Bank of America Visa,,HJ,,5.99,-27110.64
2032,6/4/2021,6/4/2021,Maryellen Leneghan,Imported from Bank of America Visa,,HJ,,9.19,-27119.83
2032,6/4/2021,6/4/2021,Maryellen Leneghan,Imported from Bank of America Visa,,HJ,,9.99,-27129.82
2032,6/4/2021,6/4/2021,Maryellen Leneghan,Imported from Bank of America Visa,,HJ,,12.49,-27142.31
2032,6/4/2021,6/4/2021,Maryellen Leneghan,Imported from Bank of America Visa,,HJ,,13.51,-27155.82
2032,6/4/2021,6/4/2021,Maryellen Leneghan,Imported from Bank of America Visa,,HJ,,39.26,-27195.08
2032,6/4/2021,6/4/2021,Maryellen Leneghan,Imported from Bank of America Visa,,HJ,,9.65,-27204.73
2032,6/4/2021,6/4/2021,Myesha Hossain,Imported from Bank of America Visa,,HJ,,14.97,-27219.7
2032,6/4/2021,6/4/2021,Tiffany Jordan,Imported from Bank of America Visa,,HJ,,49.5,-27269.2
2032,6/7/2021,6/7/2021,Alan Safran,Imported from Bank of America Visa,,HJ,,36.5,-27305.7
2032,6/7/2021,6/7/2021,Alan Safran,Imported from Bank of America Visa,,HJ,,36.5,-27342.2
2032,6/7/2021,6/7/2021,Alan Safran,Imported from Bank of America Visa,,HJ,,36.5,-27378.7
2032,6/7/2021,6/7/2021,Alan Safran,Imported from Bank of America Visa,,HJ,,46,-27424.7
2032,6/7/2021,6/7/2021,Halley Bowman,Imported from Bank of America Visa,,HJ,,18.33,-27443.03
2032,6/7/2021,6/7/2021,Mahaliah Sejour,Imported from Bank of America Visa,,HJ,,6.98,-27450.01
2032,6/7/2021,6/7/2021,Mahaliah Sejour,Imported from Bank of America Visa,,HJ,,10.95,-27460.96
2032,6/7/2021,6/7/2021,Mahaliah Sejour,Imported from Bank of America Visa,,HJ,,32.59,-27493.55
2032,6/7/2021,6/7/2021,Mahaliah Sejour,Imported from Bank of America Visa,,HJ,,33.1,-27526.65
2032,6/7/2021,6/7/2021,Mahaliah Sejour,Imported from Bank of America Visa,,HJ,,36.47,-27563.12
2032,6/7/2021,6/7/2021,Mahaliah Sejour,Imported from Bank of America Visa,,HJ,,46.08,-27609.2
2032,6/7/2021,6/7/2021,Mahaliah Sejour,Imported from Bank of America Visa,,HJ,,83.26,-27692.46
2032,6/7/2021,6/7/2021,Mahaliah Sejour,Imported from Bank of America Visa,,HJ,,91.87,-27784.33
2032,6/7/2021,6/7/2021,Maryellen Leneghan,Imported from Bank of America Visa,,HJ,,5.9,-27790.23
2032,6/7/2021,6/7/2021,Maryellen Leneghan,Imported from Bank of America Visa,,HJ,,9.66,-27799.89
2032,6/7/2021,6/7/2021,Maryellen Leneghan,Imported from Bank of America Visa,,HJ,,22.21,-27822.1
2032,6/7/2021,6/7/2021,Monivett Acevedo,Imported from Bank of America Visa,,HJ,,14.99,-27837.09
2032,6/7/2021,6/7/2021,Thomas Fischaber,Imported from Bank of America Visa,,HJ,,59,-27896.09
2032,6/7/2021,6/7/2021,Tiffani Bibb,Imported from Bank of America Visa,,HJ,,30,-27926.09
2032,6/7/2021,6/7/2021,Tiffani Bibb,Imported from Bank of America Visa,,HJ,,35,-27961.09
2032,6/7/2021,6/7/2021,Tiffani Bibb,Imported from Bank of America Visa,,HJ,,35,-27996.09
2032,6/7/2021,6/7/2021,Tiffany Jordan,Imported from Bank of America Visa,,HJ,,3,-27999.09
2032,6/7/2021,6/7/2021,Tiffany Jordan,Imported from Bank of America Visa,,HJ,,8.83,-28007.92
2032,6/7/2021,6/7/2021,Tiffany Jordan,Imported from Bank of America Visa,,HJ,,13.11,-28021.03
2032,6/8/2021,6/8/2021,Alan Safran,Imported from Bank of America Visa,,HJ,,27.75,-28048.78
2032,6/8/2021,6/8/2021,Alan Safran,Imported from Bank of America Visa,,HJ,,27.75,-28076.53
2032,6/8/2021,6/8/2021,Alan Safran,Imported from Bank of America Visa,,HJ,,27.75,-28104.28
2032,6/8/2021,6/8/2021,Alan Safran,Imported from Bank of America Visa,,HJ,,27.75,-28132.03
2032,6/8/2021,6/8/2021,Alan Safran,Imported from Bank of America Visa,,HJ,,36.5,-28168.53
2032,6/8/2021,6/8/2021,Alan Safran,Imported from Bank of America Visa,,HJ,,36.5,-28205.03
2032,6/8/2021,6/8/2021,Alan Safran,Imported from Bank of America Visa,,HJ,,36.5,-28241.53
2032,6/8/2021,6/8/2021,Alan Safran,Imported from Bank of America Visa,,HJ,,51.5,-28293.03
2032,6/8/2021,6/8/2021,Halley Bowman,Imported from Bank of America Visa,,HJ,,33.37,-28326.4
2032,6/8/2021,6/8/2021,Halley Bowman,Imported from Bank of America Visa,,HJ,,45.64,-28372.04
2032,6/8/2021,6/8/2021,Joseph Zarate,Imported from Bank of America Visa,,HJ,,6.99,-28379.03
2032,6/8/2021,6/8/2021,Joseph Zarate,Imported from Bank of America Visa,,HJ,,100,-28479.03
2032,6/8/2021,6/8/2021,Joseph Zarate,Imported from Bank of America Visa,,HJ,,6.99,-28486.02
2032,6/8/2021,6/8/2021,Joseph Zarate,Imported from Bank of America Visa,,HJ,,15.5,-28501.52
2032,6/8/2021,6/8/2021,Joseph Zarate,Imported from Bank of America Visa,,HJ,,46.5,-28548.02
2032,6/8/2021,6/8/2021,Mahaliah Sejour,Imported from Bank of America Visa,,HJ,,11.12,-28559.14
2032,6/8/2021,6/8/2021,Mahaliah Sejour,Imported from Bank of America Visa,,HJ,,15.41,-28574.55
2032,6/8/2021,6/8/2021,Mahaliah Sejour,Imported from Bank of America Visa,,HJ,,22.94,-28597.49
2032,6/8/2021,6/8/2021,Mahaliah Sejour,Imported from Bank of America Visa,,HJ,,25.95,-28623.44
2032,6/8/2021,6/8/2021,Mahaliah Sejour,Imported from Bank of America Visa,,HJ,,33.98,-28657.42
2032,6/8/2021,6/8/2021,Mahaliah Sejour,Imported from Bank of America Visa,,HJ,,53.37,-28710.79
2032,6/8/2021,6/8/2021,Mahaliah Sejour,Imported from Bank of America Visa,,HJ,,395,-29105.79
2032,6/8/2021,6/8/2021,Mahaliah Sejour,Imported from Bank of America Visa,,HJ,,408.7,-29514.49
2032,6/8/2021,6/8/2021,Maryellen Leneghan,Imported from Bank of America Visa,,HJ,,8.99,-29523.48
2032,6/8/2021,6/8/2021,Maryellen Leneghan,Imported from Bank of America Visa,,HJ,,12.49,-29535.97
2032,6/8/2021,6/8/2021,Myesha Hossain,Imported from Bank of America Visa,,HJ,,18.52,-29554.49
2032,6/8/2021,6/8/2021,Nicole Prahin,Imported from Bank of America Visa,,HJ,,5.35,-29559.84
2032,6/8/2021,6/8/2021,Odalis Polanco,Imported from Bank of America Visa,,HJ,,235.27,-29795.11
2032,6/8/2021,6/8/2021,Thomas Fischaber,Imported from Bank of America Visa,,HJ,,29.87,-29824.98
2032,6/8/2021,6/8/2021,Tiffani Bibb,Imported from Bank of America Visa,,HJ,,26.23,-29851.21
2032,6/8/2021,6/8/2021,Tiffani Bibb,Imported from Bank of America Visa,,HJ,,33.98,-29885.19
2032,6/8/2021,6/8/2021,Tiffani Bibb,Imported from Bank of America Visa,,HJ,,34.55,-29919.74
2032,6/8/2021,6/8/2021,Tiffani Bibb,Imported from Bank of America Visa,,HJ,,125.24,-30044.98
2032,6/9/2021,6/9/2021,Alan Safran,Imported from Bank of America Visa,,HJ,,11,-30055.98
2032,6/10/2021,6/10/2021,Alan Safran,Imported from Bank of America Visa,,HJ,,27.75,-30083.73
2032,6/10/2021,6/10/2021,Alan Safran,Imported from Bank of America Visa,,HJ,,27.75,-30111.48
2032,6/10/2021,6/10/2021,Alan Safran,Imported from Bank of America Visa,,HJ,,27.75,-30139.23
2032,6/10/2021,6/10/2021,Alan Safran,Imported from Bank of America Visa,,HJ,,36.5,-30175.73
2032,6/10/2021,6/10/2021,Alan Safran,Imported from Bank of America Visa,,HJ,,36.5,-30212.23
2032,6/10/2021,6/10/2021,Alan Safran,Imported from Bank of America Visa,,HJ,,36.5,-30248.73
2032,6/10/2021,6/10/2021,Alan Safran,Imported from Bank of America Visa,,HJ,,51.5,-30300.23
2032,6/10/2021,6/10/2021,Alan Safran,Imported from Bank of America Visa,,HJ,,56,-30356.23
2032,6/10/2021,6/10/2021,Alan Safran,Imported from Bank of America Visa,,HJ,,152,-30508.23
2032,6/10/2021,6/10/2021,Joseph Zarate,Imported from Bank of America Visa,,HJ,,15.5,-30523.73
2032,6/10/2021,6/10/2021,Joseph Zarate,Imported from Bank of America Visa,,HJ,,15.5,-30539.23
2032,6/10/2021,6/10/2021,Joseph Zarate,Imported from Bank of America Visa,,HJ,,100,-30639.23
2032,6/10/2021,6/10/2021,Joseph Zarate,Imported from Bank of America Visa,,HJ,,2547.88,-33187.11
2032,6/10/2021,6/10/2021,Joseph Zarate,Imported from Bank of America Visa,,HJ,,2614.91,-35802.02
2032,6/10/2021,6/10/2021,Mahaliah Sejour,Imported from Bank of America Visa,,HJ,,15.47,-35817.49
2032,6/10/2021,6/10/2021,Mahaliah Sejour,Imported from Bank of America Visa,,HJ,,15.99,-35833.48
2032,6/10/2021,6/10/2021,Mahaliah Sejour,Imported from Bank of America Visa,,HJ,,21.24,-35854.72
2032,6/10/2021,6/10/2021,Mahaliah Sejour,Imported from Bank of America Visa,,HJ,,25.28,-35880
2032,6/10/2021,6/10/2021,Mahaliah Sejour,Imported from Bank of America Visa,,HJ,,32.08,-35912.08
2032,6/10/2021,6/10/2021,Mahaliah Sejour,Imported from Bank of America Visa,,HJ,,34.04,-35946.12
2032,6/10/2021,6/10/2021,Mahaliah Sejour,Imported from Bank of America Visa,,HJ,,235.6,-36181.72
2032,6/10/2021,6/10/2021,Mahaliah Sejour,Imported from Bank of America Visa,,HJ,,1305.18,-37486.9
2032,6/10/2021,6/10/2021,Mahaliah Sejour,Imported from Bank of America Visa,,HJ,,14.99,-37501.89
2032,6/10/2021,6/10/2021,Mahaliah Sejour,Imported from Bank of America Visa,,HJ,,14.99,-37516.88
2032,6/10/2021,6/10/2021,Mahaliah Sejour,Imported from Bank of America Visa,,HJ,,24.22,-37541.1
2032,6/10/2021,6/10/2021,Mahaliah Sejour,Imported from Bank of America Visa,,HJ,,33.98,-37575.08
2032,6/10/2021,6/10/2021,Mahaliah Sejour,Imported from Bank of America Visa,,HJ,,135,-37710.08
2032,6/10/2021,6/10/2021,Maryellen Leneghan,Imported from Bank of America Visa,,HJ,16.56,,-37693.52
2032,6/10/2021,6/10/2021,Myesha Hossain,Imported from Bank of America Visa,,HJ,,4.63,-37698.15
2032,6/10/2021,6/10/2021,Myesha Hossain,Imported from Bank of America Visa,,HJ,,8.99,-37707.14
2032,6/10/2021,6/10/2021,Myesha Hossain,Imported from Bank of America Visa,,HJ,,11.99,-37719.13
2032,6/10/2021,6/10/2021,Myesha Hossain,Imported from Bank of America Visa,,HJ,,13.9,-37733.03
2032,6/10/2021,6/10/2021,Tiffani Bibb,Imported from Bank of America Visa,,HJ,,29.2,-37762.23
2032,6/10/2021,6/10/2021,Tiffani Bibb,Imported from Bank of America Visa,,HJ,,38.65,-37800.88
2032,6/10/2021,6/10/2021,Tiffani Bibb,Imported from Bank of America Visa,,HJ,,39,-37839.88
2032,6/10/2021,6/10/2021,Tiffani Bibb,Imported from Bank of America Visa,,HJ,,69.91,-37909.79
2032,6/10/2021,6/10/2021,Tiffani Bibb,Imported from Bank of America Visa,,HJ,,74.02,-37983.81
2032,6/10/2021,6/10/2021,Tiffani Bibb,Imported from Bank of America Visa,,HJ,,0.78,-37984.59
2032,6/10/2021,6/10/2021,Tiffani Bibb,Imported from Bank of America Visa,,HJ,,23.29,-38007.88
2032,6/10/2021,6/10/2021,Tiffani Bibb,Imported from Bank of America Visa,,HJ,,35,-38042.88
2032,6/10/2021,6/10/2021,Tiffani Bibb,Imported from Bank of America Visa,,HJ,,35,-38077.88
2032,6/10/2021,6/10/2021,Tiffani Bibb,Imported from Bank of America Visa,,HJ,,36.17,-38114.05
2032,6/10/2021,6/10/2021,Tiffani Bibb,Imported from Bank of America Visa,,HJ,,133.17,-38247.22
2032,6/11/2021,6/11/2021,Alan Safran,Imported from Bank of America Visa,,HJ,,7.5,-38254.72
2032,6/11/2021,6/11/2021,Alan Safran,Imported from Bank of America Visa,,HJ,,27.75,-38282.47
2032,6/11/2021,6/11/2021,Alan Safran,Imported from Bank of America Visa,,HJ,,36.5,-38318.97
2032,6/11/2021,6/11/2021,Alan Safran,Imported from Bank of America Visa,,HJ,,298,-38616.97
2032,6/11/2021,6/11/2021,Antonio Gutierrez,Imported from Bank of America Visa,,HJ,,19.11,-38636.08
2032,6/11/2021,6/11/2021,Antonio Gutierrez,Imported from Bank of America Visa,,HJ,,235.17,-38871.25
2032,6/11/2021,6/11/2021,Antonio Gutierrez,Imported from Bank of America Visa,,HJ,,251,-39122.25
2032,6/11/2021,6/11/2021,Antonio Gutierrez,Imported from Bank of America Visa,,HJ,,298,-39420.25
2032,6/11/2021,6/11/2021,Antonio Gutierrez,Imported from Bank of America Visa,,HJ,,649,-40069.25
2032,6/11/2021,6/11/2021,Elizabeth Peinado,Imported from Bank of America Visa,,HJ,,18.38,-40087.63
2032,6/11/2021,6/11/2021,Elizabeth Peinado,Imported from Bank of America Visa,,HJ,,22.92,-40110.55
2032,6/11/2021,6/11/2021,Halley Bowman,Imported from Bank of America Visa,,HJ,,2.67,-40113.22
2032,6/11/2021,6/11/2021,Halley Bowman,Imported from Bank of America Visa,,HJ,,4.13,-40117.35
2032,6/11/2021,6/11/2021,Halley Bowman,Imported from Bank of America Visa,,HJ,,4.13,-40121.48
2032,6/11/2021,6/11/2021,Halley Bowman,Imported from Bank of America Visa,,HJ,,13.34,-40134.82
2032,6/11/2021,6/11/2021,Joseph Zarate,Imported from Bank of America Visa,,HJ,,100,-40234.82
2032,6/11/2021,6/11/2021,Mahaliah Sejour,Imported from Bank of America Visa,,HJ,,12.99,-40247.81
2032,6/11/2021,6/11/2021,Mahaliah Sejour,Imported from Bank of America Visa,,HJ,,16.99,-40264.8
2032,6/11/2021,6/11/2021,Mahaliah Sejour,Imported from Bank of America Visa,,HJ,,16.99,-40281.79
2032,6/11/2021,6/11/2021,Mahaliah Sejour,Imported from Bank of America Visa,,HJ,,16.99,-40298.78
2032,6/11/2021,6/11/2021,Mahaliah Sejour,Imported from Bank of America Visa,,HJ,,16.99,-40315.77
2032,6/11/2021,6/11/2021,Mahaliah Sejour,Imported from Bank of America Visa,,HJ,,216.86,-40532.63
2032,6/11/2021,6/11/2021,Mahaliah Sejour,Imported from Bank of America Visa,,HJ,,427.83,-40960.46
2032,6/11/2021,6/11/2021,Monivett Acevedo,Imported from Bank of America Visa,,HJ,,8.79,-40969.25
2032,6/11/2021,6/11/2021,Myesha Hossain,Imported from Bank of America Visa,,HJ,,4.63,-40973.88
2032,6/11/2021,6/11/2021,Myesha Hossain,Imported from Bank of America Visa,,HJ,,15.99,-40989.87
2032,6/11/2021,6/11/2021,Nicole Horton,Imported from Bank of America Visa,,HJ,,17.12,-41006.99
2032,6/11/2021,6/11/2021,Nicole Horton,Imported from Bank of America Visa,,HJ,,21.39,-41028.38
2032,6/11/2021,6/11/2021,Nicole Horton,Imported from Bank of America Visa,,HJ,,42.88,-41071.26
2032,6/11/2021,6/11/2021,Thomas Fischaber,Imported from Bank of America Visa,,HJ,,9.99,-41081.25
2032,6/11/2021,6/11/2021,Tiffani Bibb,Imported from Bank of America Visa,,HJ,,37.96,-41119.21
2032,6/11/2021,6/11/2021,Tiffany Jordan,Imported from Bank of America Visa,,HJ,,93.47,-41212.68
2032,6/14/2021,6/14/2021,Alan Safran,Imported from Bank of America Visa,,HJ,,36.5,-41249.18
2032,6/14/2021,6/14/2021,Alan Safran,Imported from Bank of America Visa,,HJ,,36.5,-41285.68
2032,6/14/2021,6/14/2021,Alan Safran,Imported from Bank of America Visa,,HJ,,36.5,-41322.18
2032,6/14/2021,6/14/2021,Alan Safran,Imported from Bank of America Visa,,HJ,,49.15,-41371.33
2032,6/14/2021,6/14/2021,Alan Safran,Imported from Bank of America Visa,,HJ,,66,-41437.33
2032,6/14/2021,6/14/2021,Antonio Gutierrez,Imported from Bank of America Visa,,HJ,,248,-41685.33
2032,6/14/2021,6/14/2021,Antonio Gutierrez,Imported from Bank of America Visa,,HJ,,652,-42337.33
2032,6/14/2021,6/14/2021,Joseph Zarate,Imported from Bank of America Visa,,HJ,,83.97,-42421.3
2032,6/14/2021,6/14/2021,Joseph Zarate,Imported from Bank of America Visa,,HJ,,100,-42521.3
2032,6/14/2021,6/14/2021,Joseph Zarate,Imported from Bank of America Visa,,HJ,,100,-42621.3
2032,6/14/2021,6/14/2021,Myesha Hossain,Imported from Bank of America Visa,,HJ,,9.3,-42630.6
2032,6/14/2021,6/14/2021,Myesha Hossain,Imported from Bank of America Visa,,HJ,,9.3,-42639.9
2032,6/14/2021,6/14/2021,Myesha Hossain,Imported from Bank of America Visa,,HJ,,10.79,-42650.69
2032,6/14/2021,6/14/2021,Myesha Hossain,Imported from Bank of America Visa,,HJ,,13.98,-42664.67
2032,6/14/2021,6/14/2021,Thomas Fischaber,Imported from Bank of America Visa,,HJ,,8.75,-42673.42
2032,6/15/2021,6/15/2021,Alan Safran,Imported from Bank of America Visa,,HJ,,27.75,-42701.17
2032,6/15/2021,6/15/2021,Alan Safran,Imported from Bank of America Visa,,HJ,,27.75,-42728.92
2032,6/15/2021,6/15/2021,Alan Safran,Imported from Bank of America Visa,,HJ,,36.5,-42765.42
2032,6/15/2021,6/15/2021,Joseph Zarate,Imported from Bank of America Visa,,HJ,,6.99,-42772.41
2032,6/15/2021,6/15/2021,Joseph Zarate,Imported from Bank of America Visa,,HJ,,25.46,-42797.87
2032,6/15/2021,6/15/2021,Joseph Zarate,Imported from Bank of America Visa,,HJ,,120.04,-42917.91
2032,6/15/2021,6/15/2021,Mahaliah Sejour,Imported from Bank of America Visa,,HJ,,20.39,-42938.3
2032,6/15/2021,6/15/2021,Maryellen Leneghan,Imported from Bank of America Visa,,HJ,,20.17,-42958.47
2032,6/15/2021,6/15/2021,Maryellen Leneghan,Imported from Bank of America Visa,,HJ,,21.59,-42980.06
2032,6/15/2021,6/15/2021,Maryellen Leneghan,Imported from Bank of America Visa,,HJ,,29.99,-43010.05
2032,6/15/2021,6/15/2021,Myesha Hossain,Imported from Bank of America Visa,,HJ,2.93,,-43007.12
2032,6/15/2021,6/15/2021,Myesha Hossain,Imported from Bank of America Visa,,HJ,,9.3,-43016.42
2032,6/15/2021,6/15/2021,Myesha Hossain,Imported from Bank of America Visa,,HJ,,9.3,-43025.72
2032,6/15/2021,6/15/2021,Myesha Hossain,Imported from Bank of America Visa,,HJ,,9.34,-43035.06
2032,6/15/2021,6/15/2021,Myesha Hossain,Imported from Bank of America Visa,,HJ,,10,-43045.06
2032,6/15/2021,6/15/2021,Myesha Hossain,Imported from Bank of America Visa,,HJ,,16.12,-43061.18
2032,6/15/2021,6/15/2021,Thomas Fischaber,Imported from Bank of America Visa,,HJ,,800,-43861.18
2032,6/16/2021,6/16/2021,Alan Safran,Imported from Bank of America Visa,,HJ,,26.5,-43887.68
2032,6/16/2021,6/16/2021,Alan Safran,Imported from Bank of America Visa,,HJ,,27.75,-43915.43
2032,6/16/2021,6/16/2021,Alan Safran,Imported from Bank of America Visa,,HJ,,27.75,-43943.18
2032,6/16/2021,6/16/2021,Alan Safran,Imported from Bank of America Visa,,HJ,,27.75,-43970.93
2032,6/16/2021,6/16/2021,Alan Safran,Imported from Bank of America Visa,,HJ,,36.5,-44007.43
2032,6/16/2021,6/16/2021,Alan Safran,Imported from Bank of America Visa,,HJ,,36.5,-44043.93
2032,6/16/2021,6/16/2021,Alan Safran,Imported from Bank of America Visa,,HJ,,36.5,-44080.43
2032,6/16/2021,6/16/2021,Antonio Gutierrez,Imported from Bank of America Visa,,HJ,,4,-44084.43
2032,6/16/2021,6/16/2021,Antonio Gutierrez,Imported from Bank of America Visa,,HJ,,144,-44228.43
2032,6/16/2021,6/16/2021,Antonio Gutierrez,Imported from Bank of America Visa,,HJ,,756,-44984.43
2032,6/16/2021,6/16/2021,Joseph Zarate,Imported from Bank of America Visa,,HJ,,104.61,-45089.04
2032,6/16/2021,6/16/2021,Joseph Zarate,Imported from Bank of America Visa,,HJ,,214.9,-45303.94
2032,6/16/2021,6/16/2021,Joseph Zarate,Imported from Bank of America Visa,,HJ,,100,-45403.94
2032,6/16/2021,6/16/2021,Joseph Zarate,Imported from Bank of America Visa,,HJ,,100,-45503.94
2032,6/16/2021,6/16/2021,Joseph Zarate,Imported from Bank of America Visa,,HJ,,143.8,-45647.74
2032,6/16/2021,6/16/2021,Joseph Zarate,Imported from Bank of America Visa,,HJ,,427.42,-46075.16
2032,6/16/2021,6/16/2021,Joseph Zarate,Imported from Bank of America Visa,,HJ,,2980.27,-49055.43
2032,6/16/2021,6/16/2021,Mahaliah Sejour,Imported from Bank of America Visa,,HJ,,60.99,-49116.42
2032,6/16/2021,6/16/2021,Mahaliah Sejour,Imported from Bank of America Visa,,HJ,,65.71,-49182.13
2032,6/16/2021,6/16/2021,Mahaliah Sejour,Imported from Bank of America Visa,,HJ,,11.75,-49193.88
2032,6/16/2021,6/16/2021,Mahaliah Sejour,Imported from Bank of America Visa,,HJ,,11.99,-49205.87
2032,6/16/2021,6/16/2021,Mahaliah Sejour,Imported from Bank of America Visa,,HJ,,11.99,-49217.86
2032,6/16/2021,6/16/2021,Mahaliah Sejour,Imported from Bank of America Visa,,HJ,,12.59,-49230.45
2032,6/16/2021,6/16/2021,Mahaliah Sejour,Imported from Bank of America Visa,,HJ,,13.99,-49244.44
2032,6/16/2021,6/16/2021,Mahaliah Sejour,Imported from Bank of America Visa,,HJ,,29.94,-49274.38
2032,6/16/2021,6/16/2021,Mahaliah Sejour,Imported from Bank of America Visa,,HJ,,59.99,-49334.37
2032,6/16/2021,6/16/2021,Maryellen Leneghan,Imported from Bank of America Visa,,HJ,,7.64,-49342.01
2032,6/16/2021,6/16/2021,Maryellen Leneghan,Imported from Bank of America Visa,,HJ,,7.64,-49349.65
2032,6/16/2021,6/16/2021,Maryellen Leneghan,Imported from Bank of America Visa,,HJ,,7.64,-49357.29
2032,6/16/2021,6/16/2021,Maryellen Leneghan,Imported from Bank of America Visa,,HJ,,7.71,-49365
2032,6/16/2021,6/16/2021,Myesha Hossain,Imported from Bank of America Visa,,HJ,,5.99,-49370.99
2032,6/16/2021,6/16/2021,Myesha Hossain,Imported from Bank of America Visa,,HJ,,7.49,-49378.48
2032,6/16/2021,6/16/2021,Myesha Hossain,Imported from Bank of America Visa,,HJ,,8.99,-49387.47
2032,6/16/2021,6/16/2021,Myesha Hossain,Imported from Bank of America Visa,,HJ,,8.99,-49396.46
2032,6/16/2021,6/16/2021,Myesha Hossain,Imported from Bank of America Visa,,HJ,,28.32,-49424.78
2032,6/16/2021,6/16/2021,Myesha Hossain,Imported from Bank of America Visa,,HJ,,28.89,-49453.67
2032,6/16/2021,6/16/2021,Myesha Hossain,Imported from Bank of America Visa,,HJ,,29.97,-49483.64
2032,6/16/2021,6/16/2021,Myesha Hossain,Imported from Bank of America Visa,,HJ,,33.16,-49516.8
2032,6/16/2021,6/16/2021,Myesha Hossain,Imported from Bank of America Visa,,HJ,,34.29,-49551.09
2032,6/16/2021,6/16/2021,Myesha Hossain,Imported from Bank of America Visa,,HJ,,35.39,-49586.48
2032,6/16/2021,6/16/2021,Myesha Hossain,Imported from Bank of America Visa,,HJ,,35.98,-49622.46
2032,6/16/2021,6/16/2021,Myesha Hossain,Imported from Bank of America Visa,,HJ,,36.13,-49658.59
2032,6/16/2021,6/16/2021,Myesha Hossain,Imported from Bank of America Visa,,HJ,,37.29,-49695.88
2032,6/16/2021,6/16/2021,Myesha Hossain,Imported from Bank of America Visa,,HJ,,39.02,-49734.9
2032,6/16/2021,6/16/2021,Myesha Hossain,Imported from Bank of America Visa,,HJ,,59.32,-49794.22
2032,6/16/2021,6/16/2021,Myesha Hossain,Imported from Bank of America Visa,,HJ,,5,-49799.22
2032,6/16/2021,6/16/2021,Myesha Hossain,Imported from Bank of America Visa,,HJ,,5,-49804.22
2032,6/16/2021,6/16/2021,Myesha Hossain,Imported from Bank of America Visa,,HJ,,5,-49809.22
2032,6/16/2021,6/16/2021,Myesha Hossain,Imported from Bank of America Visa,,HJ,,5,-49814.22
2032,6/16/2021,6/16/2021,Myesha Hossain,Imported from Bank of America Visa,,HJ,,5,-49819.22
2032,6/16/2021,6/16/2021,Myesha Hossain,Imported from Bank of America Visa,,HJ,,5,-49824.22
2032,6/16/2021,6/16/2021,Myesha Hossain,Imported from Bank of America Visa,,HJ,,5,-49829.22
2032,6/16/2021,6/16/2021,Myesha Hossain,Imported from Bank of America Visa,,HJ,,5,-49834.22
2032,6/16/2021,6/16/2021,Myesha Hossain,Imported from Bank of America Visa,,HJ,,5,-49839.22
2032,6/16/2021,6/16/2021,Myesha Hossain,Imported from Bank of America Visa,,HJ,,5,-49844.22
2032,6/16/2021,6/16/2021,Myesha Hossain,Imported from Bank of America Visa,,HJ,,8.99,-49853.21
2032,6/16/2021,6/16/2021,Nicole Prahin,Imported from Bank of America Visa,,HJ,,2.17,-49855.38
2032,6/16/2021,6/16/2021,Uriel Guadarrama,Imported from Bank of America Visa,,HJ,,99.88,-49955.26
2032,6/16/2021,6/16/2021,Uriel Guadarrama,Imported from Bank of America Visa,,HJ,,99.88,-50055.14
2032,6/17/2021,6/17/2021,Alan Safran,Imported from Bank of America Visa,,HJ,,27.75,-50082.89
2032,6/17/2021,6/17/2021,Alan Safran,Imported from Bank of America Visa,,HJ,,36.5,-50119.39
2032,6/17/2021,6/17/2021,Alan Safran,Imported from Bank of America Visa,,HJ,,48,-50167.39
2032,6/17/2021,6/17/2021,Antonio Gutierrez,Imported from Bank of America Visa,,HJ,,15.93,-50183.32
2032,6/17/2021,6/17/2021,Antonio Gutierrez,Imported from Bank of America Visa,,HJ,,20.54,-50203.86
2032,6/17/2021,6/17/2021,Antonio Gutierrez,Imported from Bank of America Visa,,HJ,,30.39,-50234.25
2032,6/17/2021,6/17/2021,Antonio Gutierrez,Imported from Bank of America Visa,,HJ,,100,-50334.25
2032,6/17/2021,6/17/2021,Antonio Gutierrez,Imported from Bank of America Visa,,HJ,,103,-50437.25
2032,6/17/2021,6/17/2021,Antonio Gutierrez,Imported from Bank of America Visa,,HJ,,118.86,-50556.11
2032,6/17/2021,6/17/2021,Antonio Gutierrez,Imported from Bank of America Visa,,HJ,,797,-51353.11
2032,6/17/2021,6/17/2021,iaklestad,Imported from Bank of America Visa,,HJ,,5,-51358.11
2032,6/17/2021,6/17/2021,Joseph Zarate,Imported from Bank of America Visa,,HJ,,100,-51458.11
2032,6/17/2021,6/17/2021,Joseph Zarate,Imported from Bank of America Visa,,HJ,,434.12,-51892.23
2032,6/17/2021,6/17/2021,Mahaliah Sejour,Imported from Bank of America Visa,,HJ,7.67,,-51884.56
2032,6/17/2021,6/17/2021,Mahaliah Sejour,Imported from Bank of America Visa,,HJ,,11.99,-51896.55
2032,6/17/2021,6/17/2021,Mahaliah Sejour,Imported from Bank of America Visa,,HJ,,18.99,-51915.54
2032,6/17/2021,6/17/2021,Mahaliah Sejour,Imported from Bank of America Visa,,HJ,29.95,,-51885.59
2032,6/17/2021,6/17/2021,Mahaliah Sejour,Imported from Bank of America Visa,,HJ,,37.62,-51923.21
2032,6/17/2021,6/17/2021,Maryellen Leneghan,Imported from Bank of America Visa,,HJ,,16.98,-51940.19
2032,6/17/2021,6/17/2021,Myesha Hossain,Imported from Bank of America Visa,,HJ,,7.49,-51947.68
2032,6/17/2021,6/17/2021,Myesha Hossain,Imported from Bank of America Visa,,HJ,,10.99,-51958.67
2032,6/18/2021,6/18/2021,Alan Safran,Imported from Bank of America Visa,,HJ,,15.93,-51974.6
2032,6/18/2021,6/18/2021,Alan Safran,Imported from Bank of America Visa,,HJ,,26.5,-52001.1
2032,6/18/2021,6/18/2021,Alan Safran,Imported from Bank of America Visa,,HJ,,27.75,-52028.85
2032,6/18/2021,6/18/2021,Alan Safran,Imported from Bank of America Visa,,HJ,,27.75,-52056.6
2032,6/18/2021,6/18/2021,Alan Safran,Imported from Bank of America Visa,,HJ,,36.5,-52093.1
2032,6/18/2021,6/18/2021,Alan Safran,Imported from Bank of America Visa,,HJ,,36.5,-52129.6
2032,6/18/2021,6/18/2021,Antonio Gutierrez,Imported from Bank of America Visa,,HJ,,658.91,-52788.51
2032,6/18/2021,6/18/2021,claice Jackson,Imported from Bank of America Visa,,HJ,,10.07,-52798.58
2032,6/18/2021,6/18/2021,iaklestad,Imported from Bank of America Visa,,HJ,,460,-53258.58
2032,6/18/2021,6/18/2021,Joseph Zarate,Imported from Bank of America Visa,,HJ,,434.98,-53693.56
2032,6/18/2021,6/18/2021,Mahaliah Sejour,Imported from Bank of America Visa,,HJ,,5.35,-53698.91
2032,6/18/2021,6/18/2021,Mahaliah Sejour,Imported from Bank of America Visa,,HJ,,5.35,-53704.26
2032,6/18/2021,6/18/2021,Mahaliah Sejour,Imported from Bank of America Visa,,HJ,,5.61,-53709.87
2032,6/18/2021,6/18/2021,Mahaliah Sejour,Imported from Bank of America Visa,,HJ,,11.88,-53721.75
2032,6/18/2021,6/18/2021,Mahaliah Sejour,Imported from Bank of America Visa,,HJ,,17.81,-53739.56
2032,6/18/2021,6/18/2021,Mahaliah Sejour,Imported from Bank of America Visa,,HJ,,17.99,-53757.55
2032,6/18/2021,6/18/2021,Mahaliah Sejour,Imported from Bank of America Visa,,HJ,,22.95,-53780.5
2032,6/18/2021,6/18/2021,Mahaliah Sejour,Imported from Bank of America Visa,,HJ,,25.88,-53806.38
2032,6/18/2021,6/18/2021,Maryellen Leneghan,Imported from Bank of America Visa,,HJ,,1607,-55413.38
2032,6/18/2021,6/18/2021,Myesha Hossain,Imported from Bank of America Visa,,HJ,,11.49,-55424.87
2032,6/18/2021,6/18/2021,Myesha Hossain,Imported from Bank of America Visa,,HJ,,21.49,-55446.36
2032,6/18/2021,6/18/2021,Thomas Fischaber,Imported from Bank of America Visa,,HJ,,249,-55695.36
2032,6/18/2021,6/18/2021,Tiffany Jordan,Imported from Bank of America Visa,,HJ,,160.41,-55855.77
2032,6/21/2021,6/21/2021,Alan Safran,Imported from Bank of America Visa,,HJ,,1.67,-55857.44
2032,6/21/2021,6/21/2021,Alan Safran,Imported from Bank of America Visa,,HJ,,16.25,-55873.69
2032,6/21/2021,6/21/2021,Alan Safran,Imported from Bank of America Visa,,HJ,,27.75,-55901.44
2032,6/21/2021,6/21/2021,Alan Safran,Imported from Bank of America Visa,,HJ,,36.5,-55937.94
2032,6/21/2021,6/21/2021,Alan Safran,Imported from Bank of America Visa,,HJ,,36.5,-55974.44
2032,6/21/2021,6/21/2021,Alan Safran,Imported from Bank of America Visa,,HJ,,78,-56052.44
2032,6/21/2021,6/21/2021,Elizabeth Peinado,Imported from Bank of America Visa,,HJ,,0.09,-56052.53
2032,6/21/2021,6/21/2021,Elizabeth Peinado,Imported from Bank of America Visa,,HJ,,0.14,-56052.67
2032,6/21/2021,6/21/2021,Elizabeth Peinado,Imported from Bank of America Visa,,HJ,,0.14,-56052.81
2032,6/21/2021,6/21/2021,Elizabeth Peinado,Imported from Bank of America Visa,,HJ,,0.43,-56053.24
2032,6/21/2021,6/21/2021,Elizabeth Peinado,Imported from Bank of America Visa,,HJ,,551.32,-56604.56
2032,6/21/2021,6/21/2021,Elizabeth Peinado,Imported from Bank of America Visa,,HJ,,852.04,-57456.6
2032,6/21/2021,6/21/2021,Elizabeth Peinado,Imported from Bank of America Visa,,HJ,,852.04,-58308.64
2032,6/21/2021,6/21/2021,Elizabeth Peinado,Imported from Bank of America Visa,,HJ,,2756.61,-61065.25
2032,6/21/2021,6/21/2021,iaklestad,Imported from Bank of America Visa,,HJ,,2000,-63065.25
2032,6/21/2021,6/21/2021,Mahaliah Sejour,Imported from Bank of America Visa,,HJ,,6.99,-63072.24
2032,6/21/2021,6/21/2021,Mahaliah Sejour,Imported from Bank of America Visa,,HJ,,10.68,-63082.92
2032,6/21/2021,6/21/2021,Mahaliah Sejour,Imported from Bank of America Visa,,HJ,,11.6,-63094.52
2032,6/21/2021,6/21/2021,Mahaliah Sejour,Imported from Bank of America Visa,,HJ,30,,-63064.52
2032,6/21/2021,6/21/2021,Monivett Acevedo,Imported from Bank of America Visa,,HJ,,555.66,-63620.18
2032,6/21/2021,6/21/2021,Nicole Prahin,Imported from Bank of America Visa,,HJ,,170.62,-63790.8
2032,6/21/2021,6/21/2021,Tiffani Bibb,Imported from Bank of America Visa,,HJ,,219.7,-64010.5
2032,6/21/2021,6/21/2021,Tiffani Bibb,Imported from Bank of America Visa,,HJ,,219.7,-64230.2
2032,6/22/2021,6/22/2021,Alan Safran,Imported from Bank of America Visa,,HJ,,15,-64245.2
2032,6/22/2021,6/22/2021,Alan Safran,Imported from Bank of America Visa,,HJ,,27.75,-64272.95
2032,6/22/2021,6/22/2021,Alan Safran,Imported from Bank of America Visa,,HJ,,36.5,-64309.45
2032,6/22/2021,6/22/2021,Alan Safran,Imported from Bank of America Visa,,HJ,,71,-64380.45
2032,6/22/2021,6/22/2021,Alan Safran,Imported from Bank of America Visa,,HJ,,78,-64458.45
2032,6/22/2021,6/22/2021,Alan Safran,Imported from Bank of America Visa,,HJ,,118.62,-64577.07
2032,6/22/2021,6/22/2021,claice Jackson,Imported from Bank of America Visa,,HJ,,26.1,-64603.17
2032,6/22/2021,6/22/2021,claice Jackson,Imported from Bank of America Visa,,HJ,,37.23,-64640.4
2032,6/22/2021,6/22/2021,claice Jackson,Imported from Bank of America Visa,,HJ,,66.08,-64706.48
2032,6/22/2021,6/22/2021,Joseph Zarate,Imported from Bank of America Visa,,HJ,,150.88,-64857.36
2032,6/22/2021,6/22/2021,Joseph Zarate,Imported from Bank of America Visa,,HJ,,388.89,-65246.25
2032,6/22/2021,6/22/2021,Myesha Hossain,Imported from Bank of America Visa,,HJ,,9.3,-65255.55
2032,6/22/2021,6/22/2021,Myesha Hossain,Imported from Bank of America Visa,,HJ,,11.35,-65266.9
2032,6/22/2021,6/22/2021,Myesha Hossain,Imported from Bank of America Visa,,HJ,,12.99,-65279.89
2032,6/22/2021,6/22/2021,Myesha Hossain,Imported from Bank of America Visa,,HJ,,16.99,-65296.88
2032,6/22/2021,6/22/2021,Myesha Hossain,Imported from Bank of America Visa,,HJ,,16.99,-65313.87
2032,6/22/2021,6/22/2021,Myesha Hossain,Imported from Bank of America Visa,,HJ,,18.12,-65331.99
2032,6/22/2021,6/22/2021,Myesha Hossain,Imported from Bank of America Visa,,HJ,,18.88,-65350.87
2032,6/22/2021,6/22/2021,Myesha Hossain,Imported from Bank of America Visa,,HJ,,21.63,-65372.5
2032,6/23/2021,6/23/2021,Alan Safran,Imported from Bank of America Visa,,HJ,,27.75,-65400.25
2032,6/23/2021,6/23/2021,Alan Safran,Imported from Bank of America Visa,,HJ,,27.75,-65428
2032,6/23/2021,6/23/2021,Alan Safran,Imported from Bank of America Visa,,HJ,,45,-65473
2032,6/23/2021,6/23/2021,Alan Safran,Imported from Bank of America Visa,,HJ,,51.5,-65524.5
2032,6/23/2021,6/23/2021,Alan Safran,Imported from Bank of America Visa,,HJ,,68,-65592.5
2032,6/23/2021,6/23/2021,Alan Safran,Imported from Bank of America Visa,,HJ,,357,-65949.5
2032,6/23/2021,6/23/2021,Antonio Gutierrez,Imported from Bank of America Visa,,HJ,,500,-66449.5
2032,6/23/2021,6/23/2021,Antonio Gutierrez,Imported from Bank of America Visa,,HJ,,900,-67349.5
2032,6/23/2021,6/23/2021,Elizabeth Peinado,Imported from Bank of America Visa,,HJ,,5.53,-67355.03
2032,6/23/2021,6/23/2021,Elizabeth Peinado,Imported from Bank of America Visa,,HJ,,8.54,-67363.57
2032,6/23/2021,6/23/2021,Elizabeth Peinado,Imported from Bank of America Visa,,HJ,,8.54,-67372.11
2032,6/23/2021,6/23/2021,Elizabeth Peinado,Imported from Bank of America Visa,,HJ,,27.64,-67399.75
2032,6/23/2021,6/23/2021,Mahaliah Sejour,Imported from Bank of America Visa,,HJ,,6.81,-67406.56
2032,6/23/2021,6/23/2021,Mahaliah Sejour,Imported from Bank of America Visa,,HJ,,12.3,-67418.86
2032,6/23/2021,6/23/2021,Mahaliah Sejour,Imported from Bank of America Visa,,HJ,,14.99,-67433.85
2032,6/23/2021,6/23/2021,Mahaliah Sejour,Imported from Bank of America Visa,,HJ,,14.99,-67448.84
2032,6/23/2021,6/23/2021,Mahaliah Sejour,Imported from Bank of America Visa,,HJ,,18.39,-67467.23
2032,6/23/2021,6/23/2021,Mahaliah Sejour,Imported from Bank of America Visa,,HJ,,18.66,-67485.89
2032,6/23/2021,6/23/2021,Mahaliah Sejour,Imported from Bank of America Visa,,HJ,,19.96,-67505.85
2032,6/23/2021,6/23/2021,Mahaliah Sejour,Imported from Bank of America Visa,,HJ,,24.95,-67530.8
2032,6/23/2021,6/23/2021,Mahaliah Sejour,Imported from Bank of America Visa,,HJ,,24.95,-67555.75
2032,6/23/2021,6/23/2021,Mahaliah Sejour,Imported from Bank of America Visa,,HJ,,25.02,-67580.77
2032,6/23/2021,6/23/2021,Mahaliah Sejour,Imported from Bank of America Visa,,HJ,,25.76,-67606.53
2032,6/23/2021,6/23/2021,Mahaliah Sejour,Imported from Bank of America Visa,,HJ,,27.67,-67634.2
2032,6/23/2021,6/23/2021,Mahaliah Sejour,Imported from Bank of America Visa,,HJ,,29.79,-67663.99
2032,6/23/2021,6/23/2021,Mahaliah Sejour,Imported from Bank of America Visa,,HJ,,36.65,-67700.64
2032,6/23/2021,6/23/2021,Mahaliah Sejour,Imported from Bank of America Visa,,HJ,,36.65,-67737.29
2032,6/23/2021,6/23/2021,Mahaliah Sejour,Imported from Bank of America Visa,,HJ,,124.29,-67861.58
2032,6/23/2021,6/23/2021,Mahaliah Sejour,Imported from Bank of America Visa,,HJ,,124.29,-67985.87
2032,6/23/2021,6/23/2021,Mahaliah Sejour,Imported from Bank of America Visa,,HJ,,124.57,-68110.44
2032,6/23/2021,6/23/2021,Mahaliah Sejour,Imported from Bank of America Visa,,HJ,,124.57,-68235.01
2032,6/23/2021,6/23/2021,Maryellen Leneghan,Imported from Bank of America Visa,,HJ,,10.45,-68245.46
2032,6/23/2021,6/23/2021,Maryellen Leneghan,Imported from Bank of America Visa,,HJ,,42.35,-68287.81
2032,6/23/2021,6/23/2021,Maryellen Leneghan,Imported from Bank of America Visa,,HJ,,42.35,-68330.16
2032,6/23/2021,6/23/2021,Maryellen Leneghan,Imported from Bank of America Visa,,HJ,,42.39,-68372.55
2032,6/23/2021,6/23/2021,Monivett Acevedo,Imported from Bank of America Visa,,HJ,,225,-68597.55
2032,6/23/2021,6/23/2021,Thomas Fischaber,Imported from Bank of America Visa,,HJ,,198,-68795.55
2032,6/23/2021,6/23/2021,Tiffani Bibb,Imported from Bank of America Visa,,HJ,,292.2,-69087.75
2032,6/23/2021,6/23/2021,Tiffani Bibb,Imported from Bank of America Visa,,HJ,,322.2,-69409.95
2032,6/23/2021,6/23/2021,Tiffani Bibb,Imported from Bank of America Visa,,HJ,322.2,,-69087.75
2032,6/23/2021,6/23/2021,Tiffany Jordan,Imported from Bank of America Visa,,HJ,160.41,,-68927.34
2032,6/24/2021,6/24/2021,Alan Safran,Imported from Bank of America Visa,,HJ,,27.75,-68955.09
2032,6/24/2021,6/24/2021,Alan Safran,Imported from Bank of America Visa,,HJ,,36.5,-68991.59
2032,6/24/2021,6/24/2021,Alan Safran,Imported from Bank of America Visa,,HJ,,36.5,-69028.09
2032,6/24/2021,6/24/2021,Alan Safran,Imported from Bank of America Visa,,HJ,,50.5,-69078.59
2032,6/24/2021,6/24/2021,Alan Safran,Imported from Bank of America Visa,,HJ,,51.5,-69130.09
2032,6/24/2021,6/24/2021,Alan Safran,Imported from Bank of America Visa,,HJ,319.75,,-68810.34
2032,6/24/2021,6/24/2021,Antonio Gutierrez,Imported from Bank of America Visa,,HJ,,169.11,-68979.45
2032,6/24/2021,6/24/2021,Antonio Gutierrez,Imported from Bank of America Visa,,HJ,,500,-69479.45
2032,6/24/2021,6/24/2021,Antonio Gutierrez,Imported from Bank of America Visa,,HJ,,574.04,-70053.49
2032,6/24/2021,6/24/2021,Antonio Gutierrez,Imported from Bank of America Visa,,HJ,,900,-70953.49
2032,6/24/2021,6/24/2021,Antonio Gutierrez,Imported from Bank of America Visa,,HJ,,900,-71853.49
2032,6/24/2021,6/24/2021,Antonio Gutierrez,Imported from Bank of America Visa,,HJ,,900,-72753.49
2032,6/24/2021,6/24/2021,Elizabeth Peinado,Imported from Bank of America Visa,,HJ,,0.9,-72754.39
2032,6/24/2021,6/24/2021,Elizabeth Peinado,Imported from Bank of America Visa,,HJ,,1.39,-72755.78
2032,6/24/2021,6/24/2021,Elizabeth Peinado,Imported from Bank of America Visa,,HJ,,1.39,-72757.17
2032,6/24/2021,6/24/2021,Elizabeth Peinado,Imported from Bank of America Visa,,HJ,,4.47,-72761.64
2032,6/24/2021,6/24/2021,Elizabeth Peinado,Imported from Bank of America Visa,,HJ,,14.97,-72776.61
2032,6/24/2021,6/24/2021,Elizabeth Peinado,Imported from Bank of America Visa,,HJ,,23.14,-72799.75
2032,6/24/2021,6/24/2021,Elizabeth Peinado,Imported from Bank of America Visa,,HJ,,23.14,-72822.89
2032,6/24/2021,6/24/2021,Elizabeth Peinado,Imported from Bank of America Visa,,HJ,,74.86,-72897.75
2032,6/24/2021,6/24/2021,Halley Bowman,Imported from Bank of America Visa,,HJ,,12.78,-72910.53
2032,6/24/2021,6/24/2021,Joseph Zarate,Imported from Bank of America Visa,,HJ,,22.91,-72933.44
2032,6/24/2021,6/24/2021,Joseph Zarate,Imported from Bank of America Visa,,HJ,,24.07,-72957.51
2032,6/24/2021,6/24/2021,Joseph Zarate,Imported from Bank of America Visa,,HJ,,29.84,-72987.35
2032,6/24/2021,6/24/2021,Joseph Zarate,Imported from Bank of America Visa,,HJ,,31.22,-73018.57
2032,6/24/2021,6/24/2021,Joseph Zarate,Imported from Bank of America Visa,,HJ,,75.93,-73094.5
2032,6/24/2021,6/24/2021,Joseph Zarate,Imported from Bank of America Visa,,HJ,,79.63,-73174.13
2032,6/24/2021,6/24/2021,Joseph Zarate,Imported from Bank of America Visa,,HJ,,187.84,-73361.97
2032,6/24/2021,6/24/2021,Joseph Zarate,Imported from Bank of America Visa,,HJ,,320.23,-73682.2
2032,6/24/2021,6/24/2021,Joseph Zarate,Imported from Bank of America Visa,,HJ,,2000,-75682.2
2032,6/24/2021,6/24/2021,Mahaliah Sejour,Imported from Bank of America Visa,,HJ,,1.99,-75684.19
2032,6/24/2021,6/24/2021,Mahaliah Sejour,Imported from Bank of America Visa,,HJ,,16.99,-75701.18
2032,6/24/2021,6/24/2021,Mahaliah Sejour,Imported from Bank of America Visa,,HJ,,18.66,-75719.84
2032,6/24/2021,6/24/2021,Mahaliah Sejour,Imported from Bank of America Visa,,HJ,,26.44,-75746.28
2032,6/24/2021,6/24/2021,Mahaliah Sejour,Imported from Bank of America Visa,,HJ,,27.67,-75773.95
2032,6/24/2021,6/24/2021,Mahaliah Sejour,Imported from Bank of America Visa,,HJ,,27.67,-75801.62
2032,6/24/2021,6/24/2021,Mahaliah Sejour,Imported from Bank of America Visa,,HJ,,29.33,-75830.95
2032,6/24/2021,6/24/2021,Mahaliah Sejour,Imported from Bank of America Visa,,HJ,,38.38,-75869.33
2032,6/24/2021,6/24/2021,Monivett Acevedo,Imported from Bank of America Visa,,HJ,,50,-75919.33
2032,6/24/2021,6/24/2021,Myesha Hossain,Imported from Bank of America Visa,,HJ,,11.99,-75931.32
2032,6/24/2021,6/24/2021,Myesha Hossain,Imported from Bank of America Visa,,HJ,11.99,,-75919.33
2032,6/24/2021,6/24/2021,Myesha Hossain,Imported from Bank of America Visa,,HJ,,24.99,-75944.32
2032,6/24/2021,6/24/2021,Myesha Hossain,Imported from Bank of America Visa,,HJ,,29.14,-75973.46
2032,6/24/2021,6/24/2021,Myesha Hossain,Imported from Bank of America Visa,,HJ,,30.6,-76004.06
2032,6/24/2021,6/24/2021,Myesha Hossain,Imported from Bank of America Visa,,HJ,,106.84,-76110.9
2032,6/24/2021,6/24/2021,Myesha Hossain,Imported from Bank of America Visa,,HJ,,438,-76548.9
2032,6/24/2021,6/24/2021,Nicole Prahin,Imported from Bank of America Visa,,HJ,,8.71,-76557.61
2032,6/24/2021,6/24/2021,Nicole Prahin,Imported from Bank of America Visa,,HJ,,404.8,-76962.41
2032,6/24/2021,6/24/2021,Odalis Polanco,Imported from Bank of America Visa,,HJ,,10,-76972.41
2032,6/24/2021,6/24/2021,Thomas Fischaber,Imported from Bank of America Visa,,HJ,,0.78,-76973.19
2032,6/24/2021,6/24/2021,Thomas Fischaber,Imported from Bank of America Visa,,HJ,,27.44,-77000.63
2032,6/24/2021,6/24/2021,Thomas Fischaber,Imported from Bank of America Visa,,HJ,,39,-77039.63
2032,6/24/2021,6/24/2021,Tiffani Bibb,Imported from Bank of America Visa,,HJ,,17.73,-77057.36
2032,6/24/2021,6/24/2021,Tiffani Bibb,Imported from Bank of America Visa,,HJ,,17.89,-77075.25
2032,6/24/2021,6/24/2021,Tiffani Bibb,Imported from Bank of America Visa,,HJ,,322.2,-77397.45
2032,6/28/2021,6/28/2021,Alan Safran,Imported from Bank of America Visa,,HJ,,7.5,-77404.95
2032,6/28/2021,6/28/2021,Alan Safran,Imported from Bank of America Visa,,HJ,,8,-77412.95
2032,6/28/2021,6/28/2021,Alan Safran,Imported from Bank of America Visa,,HJ,,26,-77438.95
2032,6/28/2021,6/28/2021,Alan Safran,Imported from Bank of America Visa,,HJ,,27.75,-77466.7
2032,6/28/2021,6/28/2021,Alan Safran,Imported from Bank of America Visa,,HJ,,27.75,-77494.45
2032,6/28/2021,6/28/2021,Alan Safran,Imported from Bank of America Visa,,HJ,,27.75,-77522.2
2032,6/28/2021,6/28/2021,Alan Safran,Imported from Bank of America Visa,,HJ,,36.5,-77558.7
2032,6/28/2021,6/28/2021,Alan Safran,Imported from Bank of America Visa,,HJ,,42,-77600.7
2032,6/28/2021,6/28/2021,Antonio Gutierrez,Imported from Bank of America Visa,,HJ,,1.99,-77602.69
2032,6/28/2021,6/28/2021,Antonio Gutierrez,Imported from Bank of America Visa,,HJ,,259.95,-77862.64
2032,6/28/2021,6/28/2021,Antonio Gutierrez,Imported from Bank of America Visa,,HJ,,640.05,-78502.69
2032,6/28/2021,6/28/2021,Denise Parham-Gantt,Imported from Bank of America Visa,,HJ,,9.73,-78512.42
2032,6/28/2021,6/28/2021,Elizabeth Peinado,Imported from Bank of America Visa,,HJ,,11.87,-78524.29
2032,6/28/2021,6/28/2021,Elizabeth Peinado,Imported from Bank of America Visa,,HJ,,18.34,-78542.63
2032,6/28/2021,6/28/2021,Elizabeth Peinado,Imported from Bank of America Visa,,HJ,,18.34,-78560.97
2032,6/28/2021,6/28/2021,Elizabeth Peinado,Imported from Bank of America Visa,,HJ,,59.33,-78620.3
2032,6/28/2021,6/28/2021,Halley Bowman,Imported from Bank of America Visa,,HJ,,11.99,-78632.29
2032,6/28/2021,6/28/2021,Joseph Zarate,Imported from Bank of America Visa,,HJ,,15.5,-78647.79
2032,6/28/2021,6/28/2021,Joseph Zarate,Imported from Bank of America Visa,,HJ,,25.2,-78672.99
2032,6/28/2021,6/28/2021,Joseph Zarate,Imported from Bank of America Visa,,HJ,,46.5,-78719.49
2032,6/28/2021,6/28/2021,Joseph Zarate,Imported from Bank of America Visa,,HJ,,61.69,-78781.18
2032,6/28/2021,6/28/2021,Kyra Detone,Imported from Bank of America Visa,,HJ,,0.5,-78781.68
2032,6/28/2021,6/28/2021,Kyra Detone,Imported from Bank of America Visa,,HJ,,2,-78783.68
2032,6/28/2021,6/28/2021,Kyra Detone,Imported from Bank of America Visa,,HJ,,67.63,-78851.31
2032,6/28/2021,6/28/2021,Kyra Detone,Imported from Bank of America Visa,,HJ,,150,-79001.31
2032,6/28/2021,6/28/2021,Mahaliah Sejour,Imported from Bank of America Visa,,HJ,,5.35,-79006.66
2032,6/28/2021,6/28/2021,Mahaliah Sejour,Imported from Bank of America Visa,,HJ,,11.88,-79018.54
2032,6/28/2021,6/28/2021,Mahaliah Sejour,Imported from Bank of America Visa,,HJ,,43.43,-79061.97
2032,6/28/2021,6/28/2021,Maryellen Leneghan,Imported from Bank of America Visa,,HJ,,5.99,-79067.96
2032,6/28/2021,6/28/2021,Maryellen Leneghan,Imported from Bank of America Visa,,HJ,,6.99,-79074.95
2032,6/28/2021,6/28/2021,Maryellen Leneghan,Imported from Bank of America Visa,,HJ,,9.99,-79084.94
2032,6/28/2021,6/28/2021,Maryellen Leneghan,Imported from Bank of America Visa,,HJ,,9.99,-79094.93
2032,6/28/2021,6/28/2021,Maryellen Leneghan,Imported from Bank of America Visa,,HJ,,9.99,-79104.92
2032,6/28/2021,6/28/2021,Maryellen Leneghan,Imported from Bank of America Visa,,HJ,,9.99,-79114.91
2032,6/28/2021,6/28/2021,Maryellen Leneghan,Imported from Bank of America Visa,,HJ,,9.99,-79124.9
2032,6/28/2021,6/28/2021,Maryellen Leneghan,Imported from Bank of America Visa,,HJ,,9.99,-79134.89
2032,6/28/2021,6/28/2021,Maryellen Leneghan,Imported from Bank of America Visa,,HJ,,10.62,-79145.51
2032,6/28/2021,6/28/2021,Maryellen Leneghan,Imported from Bank of America Visa,,HJ,,10.69,-79156.2
2032,6/28/2021,6/28/2021,Maryellen Leneghan,Imported from Bank of America Visa,,HJ,,10.84,-79167.04
2032,6/28/2021,6/28/2021,Maryellen Leneghan,Imported from Bank of America Visa,,HJ,,10.94,-79177.98
2032,6/28/2021,6/28/2021,Maryellen Leneghan,Imported from Bank of America Visa,,HJ,,99.45,-79277.43
2032,6/28/2021,6/28/2021,Monivett Acevedo,Imported from Bank of America Visa,,HJ,,12.03,-79289.46
2032,6/28/2021,6/28/2021,Monivett Acevedo,Imported from Bank of America Visa,,HJ,,14.86,-79304.32
2032,6/28/2021,6/28/2021,Monivett Acevedo,Imported from Bank of America Visa,,HJ,,14.9,-79319.22
2032,6/28/2021,6/28/2021,Monivett Acevedo,Imported from Bank of America Visa,,HJ,,15,-79334.22
2032,6/28/2021,6/28/2021,Monivett Acevedo,Imported from Bank of America Visa,,HJ,,22.46,-79356.68
2032,6/28/2021,6/28/2021,Myesha Hossain,Imported from Bank of America Visa,,HJ,,8.75,-79365.43
2032,6/28/2021,6/28/2021,Myesha Hossain,Imported from Bank of America Visa,,HJ,,9.99,-79375.42
2032,6/28/2021,6/28/2021,Thomas Fischaber,Imported from Bank of America Visa,,HJ,,14.95,-79390.37
2032,6/28/2021,6/28/2021,Thomas Fischaber,Imported from Bank of America Visa,,HJ,,69,-79459.37
2032,6/28/2021,6/28/2021,Thomas Fischaber,Imported from Bank of America Visa,,HJ,,100.11,-79559.48
2032,6/28/2021,6/28/2021,Thomas Fischaber,Imported from Bank of America Visa,,HJ,,2266.78,-81826.26
2032,6/28/2021,6/28/2021,Tiffani Bibb,Imported from Bank of America Visa,,HJ,,443.69,-82269.95
2032,6/30/2021,6/30/2021,AAFCPAS,Bill.Com Import,,HJ,,15750,-98019.95
2032,6/30/2021,6/30/2021,ACCURATE BIOMETRICS,Bill.Com Import,,HJ,,1385.75,-99405.7
2032,6/30/2021,6/30/2021,Alan Safran,Imported from Bank of America Visa,,HJ,,15,-99420.7
2032,6/30/2021,6/30/2021,Alan Safran,Imported from Bank of America Visa,,HJ,,27.75,-99448.45
2032,6/30/2021,6/30/2021,Alan Safran,Imported from Bank of America Visa,,HJ,,27.75,-99476.2
2032,6/30/2021,6/30/2021,Alan Safran,Imported from Bank of America Visa,,HJ,,27.75,-99503.95
2032,6/30/2021,6/30/2021,Apollon & Partners,Bill.Com Import,,HJ,,2000,-101503.95
2032,6/30/2021,6/30/2021,Appcast Inc.,Bill.Com Import,,HJ,,1844.5,-103348.45
2032,6/30/2021,6/30/2021,Feinberg Hanson,Bill.Com Import,,HJ,,1890,-105238.45
2032,6/30/2021,6/30/2021,Grubhub,Bill.Com Import,,HJ,,125.95,-105364.4
2032,6/30/2021,6/30/2021,Grubhub,Bill.Com Import,,HJ,,158.23,-105522.63
2032,6/30/2021,6/30/2021,Grubhub,Bill.Com Import,,HJ,,305.59,-105828.22
2032,6/30/2021,6/30/2021,Grubhub,Bill.Com Import,,HJ,,448.86,-106277.08
2032,6/30/2021,6/30/2021,Grubhub,Bill.Com Import,,HJ,,2331.17,-108608.25
2032,6/30/2021,6/30/2021,Julie Balfour,Bill.Com Import,,HJ,,3333.33,-111941.58
2032,6/30/2021,6/30/2021,Mahaliah Sejour,Imported from Bank of America Visa,,HJ,,7.65,-111949.23
2032,6/30/2021,6/30/2021,Mahaliah Sejour,Imported from Bank of America Visa,,HJ,,25.3,-111974.53
2032,6/30/2021,6/30/2021,Mahaliah Sejour,Imported from Bank of America Visa,,HJ,,25.37,-111999.9
2032,6/30/2021,6/30/2021,Mahaliah Sejour,Imported from Bank of America Visa,,HJ,,25.67,-112025.57
2032,6/30/2021,6/30/2021,Mahaliah Sejour,Imported from Bank of America Visa,,HJ,,25.67,-112051.24
2032,6/30/2021,6/30/2021,Mahaliah Sejour,Imported from Bank of America Visa,,HJ,,25.67,-112076.91
2032,6/30/2021,6/30/2021,Mahaliah Sejour,Imported from Bank of America Visa,,HJ,,25.67,-112102.58
2032,6/30/2021,6/30/2021,Mahaliah Sejour,Imported from Bank of America Visa,,HJ,,25.7,-112128.28
2032,6/30/2021,6/30/2021,Mahaliah Sejour,Imported from Bank of America Visa,,HJ,,25.7,-112153.98
2032,6/30/2021,6/30/2021,Mahaliah Sejour,Imported from Bank of America Visa,,HJ,,26.5,-112180.48
2032,6/30/2021,6/30/2021,Mahaliah Sejour,Imported from Bank of America Visa,,HJ,,26.5,-112206.98
2032,6/30/2021,6/30/2021,Mahaliah Sejour,Imported from Bank of America Visa,,HJ,,26.5,-112233.48
2032,6/30/2021,6/30/2021,Mahaliah Sejour,Imported from Bank of America Visa,,HJ,,26.5,-112259.98
2032,6/30/2021,6/30/2021,Mahaliah Sejour,Imported from Bank of America Visa,,HJ,,26.5,-112286.48
2032,6/30/2021,6/30/2021,Mahaliah Sejour,Imported from Bank of America Visa,,HJ,,36.29,-112322.77
2032,6/30/2021,6/30/2021,Mahaliah Sejour,Imported from Bank of America Visa,,HJ,,36.47,-112359.24
2032,6/30/2021,6/30/2021,Mahaliah Sejour,Imported from Bank of America Visa,,HJ,,36.94,-112396.18
2032,6/30/2021,6/30/2021,Mahaliah Sejour,Imported from Bank of America Visa,,HJ,,37.15,-112433.33
2032,6/30/2021,6/30/2021,Mahaliah Sejour,Imported from Bank of America Visa,,HJ,,38.02,-112471.35
2032,6/30/2021,6/30/2021,Mahaliah Sejour,Imported from Bank of America Visa,,HJ,38.02,,-112433.33
2032,6/30/2021,6/30/2021,Mahaliah Sejour,Imported from Bank of America Visa,,HJ,,43.43,-112476.76
2032,6/30/2021,6/30/2021,Mahaliah Sejour,Imported from Bank of America Visa,,HJ,,43.98,-112520.74
2032,6/30/2021,6/30/2021,Mahaliah Sejour,Imported from Bank of America Visa,,HJ,,70.86,-112591.6
2032,6/30/2021,6/30/2021,Mahaliah Sejour,Imported from Bank of America Visa,,HJ,,70.86,-112662.46
2032,6/30/2021,6/30/2021,Media Cause,Bill.Com Import,,HJ,,15928.75,-128591.21
2032,6/30/2021,6/30/2021,Media Cause,Bill.Com Import,,HJ,,29883.75,-158474.96
2032,6/30/2021,6/30/2021,Monivett Acevedo,Imported from Bank of America Visa,,HJ,,34.89,-158509.85
2032,6/30/2021,6/30/2021,Monivett Acevedo,Imported from Bank of America Visa,,HJ,,26.43,-158536.28
2032,6/30/2021,6/30/2021,RobbinsSalomonPatt,Bill.Com Import,,HJ,,1495.5,-160031.78
2032,6/30/2021,6/30/2021,Teads Inc,Bill.Com Import,,HJ,,1553.9,-161585.68
2032,6/30/2021,6/30/2021,Thomas Fischaber,Imported from Bank of America Visa,,HJ,,86.64,-161672.32
2032,6/30/2021,6/30/2021,"Twilio, Inc.",Bill.Com Import,,HJ,,593.85,-162266.17
2032,6/30/2021,6/30/2021,Whiteboard,Bill.Com Import,,HJ,,17500,-179766.17
2032,6/30/2021,6/30/2021,Whiteboard,Bill.Com Import,,HJ,,26500,-206266.17
2032, Totals for 2032 - AP Clearing Acct,,,,,,783469.68,948774.11,-206266.17
2040,2040 - Accrued Expenses (Balance forward As of 07/01/2020) ,,,,,,,,-899.32
2040,7/15/2020,7/15/2020,71520,82L-PRPD-071520 -Import Payroll (GENERL)-Import Payroll,,HJ,,9.1,-908.42
2040,7/15/2020,7/15/2020,71520,82L-PRPD-071520 -Import Payroll (GENERL)-Import Payroll,,HJ,,10.4,-918.82
2040,7/15/2020,7/15/2020,71520,82L-PRPD-071520 -Import Payroll (GENERL)-Import Payroll,,HJ,,31.34,-950.16
2040,7/15/2020,7/15/2020,71520,82L-PRPD-071520 -Import Payroll (GENERL)-Import Payroll,,HJ,,40.36,-990.52
2040,7/15/2020,7/15/2020,71520,82L-PRPD-071520 -Import Payroll (GENERL)-Import Payroll,,HJ,,61.72,-1052.24
2040,7/15/2020,7/15/2020,71520,82L-PRPD-071520 -Import Payroll (GENERL)-Import Payroll,,HJ,,74.54,-1126.78
2040,7/15/2020,7/15/2020,71520,82L-PRPD-071520 -Import Payroll (GENERL)-Import Payroll,,HJ,,136.5,-1263.28
2040,7/15/2020,7/15/2020,71520,82L-PRPD-071520 -Import Payroll (GENERL)-Import Payroll,,HJ,,188.33,-1451.61
2040,7/15/2020,7/15/2020,71520,To reverse 82L payroll 0715 JE-21-0008-Reverse payroll entry 07152020 IMPORT PAYROLL,,HJ,9.1,,-1442.51
2040,7/15/2020,7/15/2020,71520,To reverse 82L payroll 0715 JE-21-0008-Reverse payroll entry 07152020 IMPORT PAYROLL,,HJ,10.4,,-1432.11
2040,7/15/2020,7/15/2020,71520,To reverse 82L payroll 0715 JE-21-0008-Reverse payroll entry 07152020 IMPORT PAYROLL,,HJ,31.34,,-1400.77
2040,7/15/2020,7/15/2020,71520,To reverse 82L payroll 0715 JE-21-0008-Reverse payroll entry 07152020 IMPORT PAYROLL,,HJ,40.36,,-1360.41
2040,7/15/2020,7/15/2020,71520,To reverse 82L payroll 0715 JE-21-0008-Reverse payroll entry 07152020 IMPORT PAYROLL,,HJ,61.72,,-1298.69
2040,7/15/2020,7/15/2020,71520,To reverse 82L payroll 0715 JE-21-0008-Reverse payroll entry 07152020 IMPORT PAYROLL,,HJ,74.54,,-1224.15
2040,7/15/2020,7/15/2020,71520,To reverse 82L payroll 0715 JE-21-0008-Reverse payroll entry 07152020 IMPORT PAYROLL,,HJ,136.5,,-1087.65
2040,7/15/2020,7/15/2020,71520,To reverse 82L payroll 0715 JE-21-0008-Reverse payroll entry 07152020 IMPORT PAYROLL,,HJ,188.33,,-899.32
2040,7/15/2020,7/15/2020,71520,82L-IMPORT PAYROLL-Import Payroll,,HJ,,9.1,-908.42
2040,7/15/2020,7/15/2020,71520,82L-IMPORT PAYROLL-Import Payroll,,HJ,,10.4,-918.82
2040,7/15/2020,7/15/2020,71520,82L-IMPORT PAYROLL-Import Payroll,,HJ,,31.34,-950.16
2040,7/15/2020,7/15/2020,71520,82L-IMPORT PAYROLL-Import Payroll,,HJ,,40.36,-990.52
2040,7/15/2020,7/15/2020,71520,82L-IMPORT PAYROLL-Import Payroll,,HJ,,61.72,-1052.24
2040,7/15/2020,7/15/2020,71520,82L-IMPORT PAYROLL-Import Payroll,,HJ,,74.54,-1126.78
2040,7/15/2020,7/15/2020,71520,82L-IMPORT PAYROLL-Import Payroll,,HJ,,136.5,-1263.28
2040,7/15/2020,7/15/2020,71520,82L-IMPORT PAYROLL-Import Payroll,,HJ,,188.33,-1451.61
2040,7/31/2020,7/31/2020,73120,82L-PRPD-073120 -Import Payroll-Import Payroll,,HJ,,10.4,-1462.01
2040,7/31/2020,7/31/2020,73120,82L-PRPD-073120 -Import Payroll-Import Payroll,,HJ,,11.7,-1473.71
2040,7/31/2020,7/31/2020,73120,82L-PRPD-073120 -Import Payroll-Import Payroll,,HJ,,46,-1519.71
2040,7/31/2020,7/31/2020,73120,82L-PRPD-073120 -Import Payroll-Import Payroll,,HJ,,49.47,-1569.18
2040,7/31/2020,7/31/2020,73120,82L-PRPD-073120 -Import Payroll-Import Payroll,,HJ,,50.01,-1619.19
2040,7/31/2020,7/31/2020,73120,82L-PRPD-073120 -Import Payroll-Import Payroll,,HJ,,66.58,-1685.77
2040,7/31/2020,7/31/2020,73120,82L-PRPD-073120 -Import Payroll-Import Payroll,,HJ,,217.76,-1903.53
2040,7/31/2020,7/31/2020,73120,To reverse 82L payroll 73120-To reverse 82L payroll of 73120 JE-21-0003,,HJ,10.4,,-1893.13
2040,7/31/2020,7/31/2020,73120,To reverse 82L payroll 73120-To reverse 82L payroll of 73120 JE-21-0003,,HJ,11.7,,-1881.43
2040,7/31/2020,7/31/2020,73120,To reverse 82L payroll 73120-To reverse 82L payroll of 73120 JE-21-0003,,HJ,46,,-1835.43
2040,7/31/2020,7/31/2020,73120,To reverse 82L payroll 73120-To reverse 82L payroll of 73120 JE-21-0003,,HJ,49.47,,-1785.96
2040,7/31/2020,7/31/2020,73120,To reverse 82L payroll 73120-To reverse 82L payroll of 73120 JE-21-0003,,HJ,50.01,,-1735.95
2040,7/31/2020,7/31/2020,73120,To reverse 82L payroll 73120-To reverse 82L payroll of 73120 JE-21-0003,,HJ,66.58,,-1669.37
2040,7/31/2020,7/31/2020,73120,To reverse 82L payroll 73120-To reverse 82L payroll of 73120 JE-21-0003,,HJ,217.76,,-1451.61
2040,7/31/2020,7/31/2020,73120,82L-IMPORT PAYROLL-Import Payroll,,HJ,,10.4,-1462.01
2040,7/31/2020,7/31/2020,73120,82L-IMPORT PAYROLL-Import Payroll,,HJ,,11.7,-1473.71
2040,7/31/2020,7/31/2020,73120,82L-IMPORT PAYROLL-Import Payroll,,HJ,,46,-1519.71
2040,7/31/2020,7/31/2020,73120,82L-IMPORT PAYROLL-Import Payroll,,HJ,,49.47,-1569.18
2040,7/31/2020,7/31/2020,73120,82L-IMPORT PAYROLL-Import Payroll,,HJ,,50.01,-1619.19
2040,7/31/2020,7/31/2020,73120,82L-IMPORT PAYROLL-Import Payroll,,HJ,,66.58,-1685.77
2040,7/31/2020,7/31/2020,73120,82L-IMPORT PAYROLL-Import Payroll,,HJ,,217.76,-1903.53
2040,8/14/2020,8/14/2020,81420,82L-IMPORT PAYROLL-Import Payroll,,HJ,,1.05,-1904.58
2040,8/14/2020,8/14/2020,81420,82L-IMPORT PAYROLL-Import Payroll,,HJ,,10.4,-1914.98
2040,8/14/2020,8/14/2020,81420,82L-IMPORT PAYROLL-Import Payroll,,HJ,,10.4,-1925.38
2040,8/14/2020,8/14/2020,81420,82L-IMPORT PAYROLL-Import Payroll,,HJ,,20,-1945.38
2040,8/14/2020,8/14/2020,81420,82L-IMPORT PAYROLL-Import Payroll,,HJ,,43.02,-1988.4
2040,8/14/2020,8/14/2020,81420,82L-IMPORT PAYROLL-Import Payroll,,HJ,,46.77,-2035.17
2040,8/14/2020,8/14/2020,81420,82L-IMPORT PAYROLL-Import Payroll,,HJ,,49.47,-2084.64
2040,8/14/2020,8/14/2020,81420,82L-IMPORT PAYROLL-Import Payroll,,HJ,,63.05,-2147.69
2040,8/14/2020,8/14/2020,81420,82L-IMPORT PAYROLL-Import Payroll,,HJ,,203.58,-2351.27
2040,8/14/2020,8/14/2020,81420,82L-IMPORT PAYROLL-MCLAUGHLIN MARA,,HJ,,0.95,-2352.22
2040,8/14/2020,8/14/2020,81420,82L-IMPORT PAYROLL-ONICA ANTHONY J,,HJ,,188.33,-2540.55
2040,8/14/2020,8/14/2020,81420,82L-IMPORT PAYROLL-STROUD DAVID,,HJ,,1,-2541.55
2040,8/14/2020,8/14/2020,82L-PRPD-081520,82L-PRPD-081520 -IMPORT PAYROLL-Import Payroll,,HJ,,0.95,-2542.5
2040,8/14/2020,8/14/2020,82L-PRPD-081520,82L-PRPD-081520 -IMPORT PAYROLL-Import Payroll,,HJ,,1,-2543.5
2040,8/14/2020,8/14/2020,82L-PRPD-081520,82L-PRPD-081520 -IMPORT PAYROLL-Import Payroll,,HJ,,1.05,-2544.55
2040,8/14/2020,8/14/2020,82L-PRPD-081520,82L-PRPD-081520 -IMPORT PAYROLL-Import Payroll,,HJ,,10.4,-2554.95
2040,8/14/2020,8/14/2020,82L-PRPD-081520,82L-PRPD-081520 -IMPORT PAYROLL-Import Payroll,,HJ,,10.4,-2565.35
2040,8/14/2020,8/14/2020,82L-PRPD-081520,82L-PRPD-081520 -IMPORT PAYROLL-Import Payroll,,HJ,,20,-2585.35
2040,8/14/2020,8/14/2020,82L-PRPD-081520,82L-PRPD-081520 -IMPORT PAYROLL-Import Payroll,,HJ,,43.02,-2628.37
2040,8/14/2020,8/14/2020,82L-PRPD-081520,82L-PRPD-081520 -IMPORT PAYROLL-Import Payroll,,HJ,,46.77,-2675.14
2040,8/14/2020,8/14/2020,82L-PRPD-081520,82L-PRPD-081520 -IMPORT PAYROLL-Import Payroll,,HJ,,49.47,-2724.61
2040,8/14/2020,8/14/2020,82L-PRPD-081520,82L-PRPD-081520 -IMPORT PAYROLL-Import Payroll,,HJ,,63.05,-2787.66
2040,8/14/2020,8/14/2020,82L-PRPD-081520,82L-PRPD-081520 -IMPORT PAYROLL-Import Payroll,,HJ,,188.33,-2975.99
2040,8/14/2020,8/14/2020,82L-PRPD-081520,82L-PRPD-081520 -IMPORT PAYROLL-Import Payroll,,HJ,,203.58,-3179.57
2040,8/15/2020,8/15/2020,82L-PRPD-081520,To reverse 82L payroll 0815 JE-21-0020-To reverse 82L Payroll of 8152020,,HJ,0.95,,-3178.62
2040,8/15/2020,8/15/2020,82L-PRPD-081520,To reverse 82L payroll 0815 JE-21-0020-To reverse 82L Payroll of 8152020,,HJ,1,,-3177.62
2040,8/15/2020,8/15/2020,82L-PRPD-081520,To reverse 82L payroll 0815 JE-21-0020-To reverse 82L Payroll of 8152020,,HJ,1.05,,-3176.57
2040,8/15/2020,8/15/2020,82L-PRPD-081520,To reverse 82L payroll 0815 JE-21-0020-To reverse 82L Payroll of 8152020,,HJ,10.4,,-3166.17
2040,8/15/2020,8/15/2020,82L-PRPD-081520,To reverse 82L payroll 0815 JE-21-0020-To reverse 82L Payroll of 8152020,,HJ,10.4,,-3155.77
2040,8/15/2020,8/15/2020,82L-PRPD-081520,To reverse 82L payroll 0815 JE-21-0020-To reverse 82L Payroll of 8152020,,HJ,20,,-3135.77
2040,8/15/2020,8/15/2020,82L-PRPD-081520,To reverse 82L payroll 0815 JE-21-0020-To reverse 82L Payroll of 8152020,,HJ,43.02,,-3092.75
2040,8/15/2020,8/15/2020,82L-PRPD-081520,To reverse 82L payroll 0815 JE-21-0020-To reverse 82L Payroll of 8152020,,HJ,46.77,,-3045.98
2040,8/15/2020,8/15/2020,82L-PRPD-081520,To reverse 82L payroll 0815 JE-21-0020-To reverse 82L Payroll of 8152020,,HJ,49.47,,-2996.51
2040,8/15/2020,8/15/2020,82L-PRPD-081520,To reverse 82L payroll 0815 JE-21-0020-To reverse 82L Payroll of 8152020,,HJ,63.05,,-2933.46
2040,8/15/2020,8/15/2020,82L-PRPD-081520,To reverse 82L payroll 0815 JE-21-0020-To reverse 82L Payroll of 8152020,,HJ,188.33,,-2745.13
2040,8/15/2020,8/15/2020,82L-PRPD-081520,To reverse 82L payroll 0815 JE-21-0020-To reverse 82L Payroll of 8152020,,HJ,203.58,,-2541.55
2040,8/31/2020,8/31/2020,83120,82L-IMPORT PAYROLL-ANTHONY BETTY S,,HJ,1916.4,,-625.15
2040,8/31/2020,8/31/2020,83120,82L-IMPORT PAYROLL-CHEN LING + CHAVOUS MILFORD,,HJ,1878.04,,1252.89
2040,8/31/2020,8/31/2020,83120,82L-IMPORT PAYROLL-Import Payroll,,HJ,,11.7,1241.19
2040,8/31/2020,8/31/2020,83120,82L-IMPORT PAYROLL-Import Payroll,,HJ,,19.38,1221.81
2040,8/31/2020,8/31/2020,83120,82L-IMPORT PAYROLL-Import Payroll,,HJ,,20.04,1201.77
2040,8/31/2020,8/31/2020,83120,82L-IMPORT PAYROLL-Import Payroll,,HJ,,28.29,1173.48
2040,8/31/2020,8/31/2020,83120,82L-IMPORT PAYROLL-Import Payroll,,HJ,,42.9,1130.58
2040,8/31/2020,8/31/2020,83120,82L-IMPORT PAYROLL-Import Payroll,,HJ,,46.77,1083.81
2040,8/31/2020,8/31/2020,83120,82L-IMPORT PAYROLL-Import Payroll,,HJ,,65.36,1018.45
2040,8/31/2020,8/31/2020,83120,82L-IMPORT PAYROLL-Import Payroll,,HJ,,121.16,897.29
2040,8/31/2020,8/31/2020,83120,82L-IMPORT PAYROLL-Import Payroll,,HJ,,139.99,757.3
2040,8/31/2020,8/31/2020,83120,82L-IMPORT PAYROLL-MCLAUGHLIN MARA,,HJ,,0.95,756.35
2040,8/31/2020,8/31/2020,83120,82L-IMPORT PAYROLL-MCLAUGHLIN MARA,,HJ,,1.05,755.3
2040,8/31/2020,8/31/2020,82L-PRPD-083120,82L-PRPD-083120 -IMPORT PAYROLL-Import Payroll,,HJ,,0.95,754.35
2040,8/31/2020,8/31/2020,82L-PRPD-083120,82L-PRPD-083120 -IMPORT PAYROLL-Import Payroll,,HJ,,1,753.35
2040,8/31/2020,8/31/2020,82L-PRPD-083120,82L-PRPD-083120 -IMPORT PAYROLL-Import Payroll,,HJ,,1.05,752.3
2040,8/31/2020,8/31/2020,82L-PRPD-083120,82L-PRPD-083120 -IMPORT PAYROLL-Import Payroll,,HJ,,10.4,741.9
2040,8/31/2020,8/31/2020,82L-PRPD-083120,82L-PRPD-083120 -IMPORT PAYROLL-Import Payroll,,HJ,,10.4,731.5
2040,8/31/2020,8/31/2020,82L-PRPD-083120,82L-PRPD-083120 -IMPORT PAYROLL-Import Payroll,,HJ,,20,711.5
2040,8/31/2020,8/31/2020,82L-PRPD-083120,82L-PRPD-083120 -IMPORT PAYROLL-Import Payroll,,HJ,,43.02,668.48
2040,8/31/2020,8/31/2020,82L-PRPD-083120,82L-PRPD-083120 -IMPORT PAYROLL-Import Payroll,,HJ,,46.77,621.71
2040,8/31/2020,8/31/2020,82L-PRPD-083120,82L-PRPD-083120 -IMPORT PAYROLL-Import Payroll,,HJ,,49.47,572.24
2040,8/31/2020,8/31/2020,82L-PRPD-083120,82L-PRPD-083120 -IMPORT PAYROLL-Import Payroll,,HJ,,63.05,509.19
2040,8/31/2020,8/31/2020,82L-PRPD-083120,82L-PRPD-083120 -IMPORT PAYROLL-Import Payroll,,HJ,,188.33,320.86
2040,8/31/2020,8/31/2020,82L-PRPD-083120,82L-PRPD-083120 -IMPORT PAYROLL-Import Payroll,,HJ,,203.58,117.28
2040,8/31/2020,8/31/2020,82L-PRPD-083120,Reverse 82L payroll of 83120 JE-21-0021-IMPORT PAYROLL,,HJ,0.95,,118.23
2040,8/31/2020,8/31/2020,82L-PRPD-083120,Reverse 82L payroll of 83120 JE-21-0021-IMPORT PAYROLL,,HJ,1,,119.23
2040,8/31/2020,8/31/2020,82L-PRPD-083120,Reverse 82L payroll of 83120 JE-21-0021-IMPORT PAYROLL,,HJ,1.05,,120.28
2040,8/31/2020,8/31/2020,82L-PRPD-083120,Reverse 82L payroll of 83120 JE-21-0021-IMPORT PAYROLL,,HJ,10.4,,130.68
2040,8/31/2020,8/31/2020,82L-PRPD-083120,Reverse 82L payroll of 83120 JE-21-0021-IMPORT PAYROLL,,HJ,10.4,,141.08
2040,8/31/2020,8/31/2020,82L-PRPD-083120,Reverse 82L payroll of 83120 JE-21-0021-IMPORT PAYROLL,,HJ,20,,161.08
2040,8/31/2020,8/31/2020,82L-PRPD-083120,Reverse 82L payroll of 83120 JE-21-0021-IMPORT PAYROLL,,HJ,43.02,,204.1
2040,8/31/2020,8/31/2020,82L-PRPD-083120,Reverse 82L payroll of 83120 JE-21-0021-IMPORT PAYROLL,,HJ,46.77,,250.87
2040,8/31/2020,8/31/2020,82L-PRPD-083120,Reverse 82L payroll of 83120 JE-21-0021-IMPORT PAYROLL,,HJ,49.47,,300.34
2040,8/31/2020,8/31/2020,82L-PRPD-083120,Reverse 82L payroll of 83120 JE-21-0021-IMPORT PAYROLL,,HJ,63.05,,363.39
2040,8/31/2020,8/31/2020,82L-PRPD-083120,Reverse 82L payroll of 83120 JE-21-0021-IMPORT PAYROLL,,HJ,188.33,,551.72
2040,8/31/2020,8/31/2020,82L-PRPD-083120,Reverse 82L payroll of 83120 JE-21-0021-IMPORT PAYROLL,,HJ,203.58,,755.3
2040,8/31/2020,8/31/2020,LUX-PRPD-083120,LUX-PRPD-083120 -Payroll-Dependant Care - DC,,HJ,,0.05,755.25
2040,8/31/2020,8/31/2020,LUX-PRPD-083120,LUX-PRPD-083120 -Payroll-Dependant Care-CHI,,HJ,,1.1,754.15
2040,9/1/2020,9/1/2020,20-Sep,To accrue Inspire Business Center Sep Oct and Nov remaining rent-To accrue Inspire Business Center Sep Oct and Nov remaining rent,,HJ,,475,279.15
2040,9/15/2020,9/15/2020,91520,82L-IMPORT PAYROLL-Import Payroll,,HJ,,0.95,278.2
2040,9/15/2020,9/15/2020,91520,82L-IMPORT PAYROLL-Import Payroll,,HJ,,1.05,277.15
2040,9/15/2020,9/15/2020,91520,82L-IMPORT PAYROLL-Import Payroll,,HJ,,1.25,275.9
2040,9/15/2020,9/15/2020,91520,82L-IMPORT PAYROLL-Import Payroll,,HJ,,2.25,273.65
2040,9/15/2020,9/15/2020,91520,82L-IMPORT PAYROLL-Import Payroll,,HJ,,11.7,261.95
2040,9/15/2020,9/15/2020,91520,82L-IMPORT PAYROLL-Import Payroll,,HJ,,19.38,242.57
2040,9/15/2020,9/15/2020,91520,82L-IMPORT PAYROLL-Import Payroll,,HJ,,20.04,222.53
2040,9/15/2020,9/15/2020,91520,82L-IMPORT PAYROLL-Import Payroll,,HJ,,28.29,194.24
2040,9/15/2020,9/15/2020,91520,82L-IMPORT PAYROLL-Import Payroll,,HJ,,31.15,163.09
2040,9/15/2020,9/15/2020,91520,82L-IMPORT PAYROLL-Import Payroll,,HJ,,40.3,122.79
2040,9/15/2020,9/15/2020,91520,82L-IMPORT PAYROLL-Import Payroll,,HJ,,46.77,76.02
2040,9/15/2020,9/15/2020,91520,82L-IMPORT PAYROLL-Import Payroll,,HJ,,69.34,6.68
2040,9/15/2020,9/15/2020,91520,82L-IMPORT PAYROLL-Import Payroll,,HJ,,115.65,-108.97
2040,9/15/2020,9/15/2020,91520,82L-IMPORT PAYROLL-Import Payroll,,HJ,,188.33,-297.3
2040,9/15/2020,9/15/2020,91520,82L-IMPORT PAYROLL-Import Payroll,,HJ,3187.25,,2889.95
2040,9/15/2020,9/15/2020,LUX-PRPD-091520,LUX-PRPD-091520-LUX-PRPD-091520 -Payroll,,HJ,,1.1,2888.85
2040,9/30/2020,9/30/2020,93020,82L-IMPORT PAYROLL-Import Payroll,,HJ,,0.95,2887.9
2040,9/30/2020,9/30/2020,93020,82L-IMPORT PAYROLL-Import Payroll,,HJ,,1.05,2886.85
2040,9/30/2020,9/30/2020,93020,82L-IMPORT PAYROLL-Import Payroll,,HJ,,10.4,2876.45
2040,9/30/2020,9/30/2020,93020,82L-IMPORT PAYROLL-Import Payroll,,HJ,,19.38,2857.07
2040,9/30/2020,9/30/2020,93020,82L-IMPORT PAYROLL-Import Payroll,,HJ,,20.04,2837.03
2040,9/30/2020,9/30/2020,93020,82L-IMPORT PAYROLL-Import Payroll,,HJ,,28.29,2808.74
2040,9/30/2020,9/30/2020,93020,82L-IMPORT PAYROLL-Import Payroll,,HJ,,40.3,2768.44
2040,9/30/2020,9/30/2020,93020,82L-IMPORT PAYROLL-Import Payroll,,HJ,,46.72,2721.72
2040,9/30/2020,9/30/2020,93020,82L-IMPORT PAYROLL-Import Payroll,,HJ,,62.12,2659.6
2040,9/30/2020,9/30/2020,93020,82L-IMPORT PAYROLL-Import Payroll,,HJ,,115.65,2543.95
2040,9/30/2020,9/30/2020,LUX-PRPD-093020,LUX-PRPD-093020-Payroll,,HJ,,1.1,2542.85
2040,10/1/2020,10/1/2020,20-Oct,To accrue Inspire Business Center Sep Oct and Nov remaining rent-To accrue Inspire Business Center Sep Oct and Nov remaining rent,,HJ,,475,2067.85
2040,10/1/2020,10/1/2020,PPP-Int,To accrue PPP loan interest for October-To accrue PPP loan interest for October 2020-Jun 2021,,HJ,,137.13,1930.72
2040,10/1/2020,10/1/2020,PPP-Int,To reverse/forgive the PPP accrued loan interest,,HJ,137.13,,2067.85
2040,10/1/2020,10/1/2020,PPP-Int,To reverse/forgive the PPP accrued loan interest,,HJ,137.13,,2204.98
2040,10/1/2020,10/1/2020,PPP-Int,To reverse/forgive the PPP accrued loan interest,,HJ,137.13,,2342.11
2040,10/1/2020,10/1/2020,PPP-Int,To reverse/forgive the PPP accrued loan interest,,HJ,137.13,,2479.24
2040,10/1/2020,10/1/2020,PPP-Int,To reverse/forgive the PPP accrued loan interest,,HJ,137.13,,2616.37
2040,10/1/2020,10/1/2020,PPP-Int,To reverse/forgive the PPP accrued loan interest,,HJ,137.13,,2753.5
2040,10/15/2020,10/15/2020,101520,82L-IMPORT PAYROLL-Import Payroll,,HJ,,0.95,2752.55
2040,10/15/2020,10/15/2020,101520,82L-IMPORT PAYROLL-Import Payroll,,HJ,,1.05,2751.5
2040,10/15/2020,10/15/2020,101520,82L-IMPORT PAYROLL-Import Payroll,,HJ,,1.25,2750.25
2040,10/15/2020,10/15/2020,101520,82L-IMPORT PAYROLL-Import Payroll,,HJ,,2.25,2748
2040,10/15/2020,10/15/2020,101520,82L-IMPORT PAYROLL-Import Payroll,,HJ,,7.8,2740.2
2040,10/15/2020,10/15/2020,101520,82L-IMPORT PAYROLL-Import Payroll,,HJ,,20.04,2720.16
2040,10/15/2020,10/15/2020,101520,82L-IMPORT PAYROLL-Import Payroll,,HJ,,42.9,2677.26
2040,10/15/2020,10/15/2020,101520,82L-IMPORT PAYROLL-Import Payroll,,HJ,,42.94,2634.32
2040,10/15/2020,10/15/2020,101520,82L-IMPORT PAYROLL-Import Payroll,,HJ,,53.98,2580.34
2040,10/15/2020,10/15/2020,101520,82L-IMPORT PAYROLL-Import Payroll,,HJ,,134.83,2445.51
2040,10/15/2020,10/15/2020,101520,82L-IMPORT PAYROLL-Import Payroll,,HJ,,188.33,2257.18
2040,10/15/2020,10/15/2020,JE-21-0061,LUX-PRPD-101520-LUX-PRPD-101520,,HJ,,1.05,2256.13
2040,10/30/2020,10/30/2020,103120,82L-IMPORT PAYROLL-Import Payroll,,HJ,,0.95,2255.18
2040,10/30/2020,10/30/2020,103120,82L-IMPORT PAYROLL-Import Payroll,,HJ,,1.05,2254.13
2040,10/30/2020,10/30/2020,103120,82L-IMPORT PAYROLL-Import Payroll,,HJ,,7.8,2246.33
2040,10/30/2020,10/30/2020,103120,82L-IMPORT PAYROLL-Import Payroll,,HJ,,16.53,2229.8
2040,10/30/2020,10/30/2020,103120,82L-IMPORT PAYROLL-Import Payroll,,HJ,,17.57,2212.23
2040,10/30/2020,10/30/2020,103120,82L-IMPORT PAYROLL-Import Payroll,,HJ,,20.04,2192.19
2040,10/30/2020,10/30/2020,103120,82L-IMPORT PAYROLL-Import Payroll,,HJ,,28.29,2163.9
2040,10/30/2020,10/30/2020,103120,82L-IMPORT PAYROLL-Import Payroll,,HJ,,42.9,2121
2040,10/30/2020,10/30/2020,103120,82L-IMPORT PAYROLL-Import Payroll,,HJ,,42.94,2078.06
2040,10/30/2020,10/30/2020,103120,82L-IMPORT PAYROLL-Import Payroll,,HJ,,48.51,2029.55
2040,10/30/2020,10/30/2020,103120,82L-IMPORT PAYROLL-Import Payroll,,HJ,,132.49,1897.06
2040,10/31/2020,10/31/2020,JE-21-0062,LUX-PRPD-103120-LUX-PRPD-103120,,HJ,,1.05,1896.01
2040,11/1/2020,11/1/2020,20-Nov,To accrue Inspire Business Center Sep Oct and Nov remaining rent-To accrue Inspire Business Center Sep Oct and Nov remaining rent,,HJ,,475,1421.01
2040,11/1/2020,11/1/2020,PPP-Int,To accrue PPP loan interest for October-To accrue PPP loan interest for October 2020-Jun 2021,,HJ,,137.13,1283.88
2040,11/12/2020,11/12/2020,JE-21-0089,LUX-PRPD-111520-LUX-PRPD-101520,,HJ,,1,1282.88
2040,11/13/2020,11/13/2020,111320,82L-IMPORT PAYROLL-Import Payroll,,HJ,,0.95,1281.93
2040,11/13/2020,11/13/2020,111320,82L-IMPORT PAYROLL-Import Payroll,,HJ,,1.05,1280.88
2040,11/13/2020,11/13/2020,111320,82L-IMPORT PAYROLL-Import Payroll,,HJ,,1.25,1279.63
2040,11/13/2020,11/13/2020,111320,82L-IMPORT PAYROLL-Import Payroll,,HJ,,2.25,1277.38
2040,11/13/2020,11/13/2020,111320,82L-IMPORT PAYROLL-Import Payroll,,HJ,,7.8,1269.58
2040,11/13/2020,11/13/2020,111320,82L-IMPORT PAYROLL-Import Payroll,,HJ,,16.53,1253.05
2040,11/13/2020,11/13/2020,111320,82L-IMPORT PAYROLL-Import Payroll,,HJ,,17.57,1235.48
2040,11/13/2020,11/13/2020,111320,82L-IMPORT PAYROLL-Import Payroll,,HJ,,20.04,1215.44
2040,11/13/2020,11/13/2020,111320,82L-IMPORT PAYROLL-Import Payroll,,HJ,,28.29,1187.15
2040,11/13/2020,11/13/2020,111320,82L-IMPORT PAYROLL-Import Payroll,,HJ,,42.9,1144.25
2040,11/13/2020,11/13/2020,111320,82L-IMPORT PAYROLL-Import Payroll,,HJ,,42.94,1101.31
2040,11/13/2020,11/13/2020,111320,82L-IMPORT PAYROLL-Import Payroll,,HJ,,48.48,1052.83
2040,11/13/2020,11/13/2020,111320,82L-IMPORT PAYROLL-Import Payroll,,HJ,,129.98,922.85
2040,11/23/2020,11/23/2020,Inspire Business Cen,Make up Jackson center September to November rent-Make up Jackson center September to November rent,,HJ,1425,,2347.85
2040,11/27/2020,11/27/2020,JE-21-0091,LUX-PRPD-113020-LUX-PRPD-113020,,HJ,,1,2346.85
2040,11/30/2020,11/30/2020,113020,82L-IMPORT PAYROLL-Import Payroll,,HJ,,0.95,2345.9
2040,11/30/2020,11/30/2020,113020,82L-IMPORT PAYROLL-Import Payroll,,HJ,,1.05,2344.85
2040,11/30/2020,11/30/2020,113020,82L-IMPORT PAYROLL-Import Payroll,,HJ,,7.8,2337.05
2040,11/30/2020,11/30/2020,113020,82L-IMPORT PAYROLL-Import Payroll,,HJ,,16.53,2320.52
2040,11/30/2020,11/30/2020,113020,82L-IMPORT PAYROLL-Import Payroll,,HJ,,20.04,2300.48
2040,11/30/2020,11/30/2020,113020,82L-IMPORT PAYROLL-Import Payroll,,HJ,,28.29,2272.19
2040,11/30/2020,11/30/2020,113020,82L-IMPORT PAYROLL-Import Payroll,,HJ,,42.9,2229.29
2040,11/30/2020,11/30/2020,113020,82L-IMPORT PAYROLL-Import Payroll,,HJ,,42.94,2186.35
2040,11/30/2020,11/30/2020,113020,82L-IMPORT PAYROLL-Import Payroll,,HJ,,67.6,2118.75
2040,11/30/2020,11/30/2020,113020,82L-IMPORT PAYROLL-Import Payroll,,HJ,,129.98,1988.77
2040,12/1/2020,12/1/2020,PPP-Int,To accrue PPP loan interest for October-To accrue PPP loan interest for October 2020-Jun 2021,,HJ,,137.13,1851.64
2040,12/15/2020,12/15/2020,121520,82L-IMPORT PAYROLL-Import Payroll,,HJ,,0.95,1850.69
2040,12/15/2020,12/15/2020,121520,82L-IMPORT PAYROLL-Import Payroll,,HJ,,1.05,1849.64
2040,12/15/2020,12/15/2020,121520,82L-IMPORT PAYROLL-Import Payroll,,HJ,,1.25,1848.39
2040,12/15/2020,12/15/2020,121520,82L-IMPORT PAYROLL-Import Payroll,,HJ,,2.25,1846.14
2040,12/15/2020,12/15/2020,121520,82L-IMPORT PAYROLL-Import Payroll,,HJ,117.23,,1963.37
2040,12/15/2020,12/15/2020,121520,82L-IMPORT PAYROLL-KOPSHEVER MELISSA,,HJ,,0.04,1963.33
2040,12/15/2020,12/15/2020,121520,82L-IMPORT PAYROLL-STROUD DAVID,,HJ,,20,1943.33
2040,12/15/2020,12/15/2020,JE-21-0112,LUX-PRPD-121520-LUX-PRPD-121520,,HJ,,1,1942.33
2040,12/31/2020,12/31/2020,123120,82L-IMPORT PAYROLL-Import Payroll,,HJ,,0.95,1941.38
2040,12/31/2020,12/31/2020,123120,82L-IMPORT PAYROLL-Import Payroll,,HJ,,1.05,1940.33
2040,12/31/2020,12/31/2020,123120,82L-IMPORT PAYROLL-KOPSHEVER MELISSA,,HJ,,0.04,1940.29
2040,12/31/2020,12/31/2020,123120,82L-IMPORT PAYROLL-STROUD DAVID,,HJ,,20,1920.29
2040,12/31/2020,12/31/2020,JE-21-0113,LUX-PRPD-123120-LUX-PRPD-123120,,HJ,,1,1919.29
2040,1/1/2021,1/1/2021,PPP-Int,To accrue PPP loan interest for October-To accrue PPP loan interest for October 2020-Jun 2021,,HJ,,137.13,1782.16
2040,1/15/2021,1/15/2021,11521,82L-IMPORT PAYROLL-Import Payroll,,HJ,,0.53,1781.63
2040,1/15/2021,1/15/2021,11521,82L-IMPORT PAYROLL-Import Payroll,,HJ,,0.58,1781.05
2040,1/15/2021,1/15/2021,11521,82L-IMPORT PAYROLL-Import Payroll,,HJ,,1,1780.05
2040,1/15/2021,1/15/2021,11521,82L-IMPORT PAYROLL-KOPSHEVER MELISSA,,HJ,,0.04,1780.01
2040,1/15/2021,1/15/2021,11521,82L-IMPORT PAYROLL-STROUD DAVID,,HJ,,20,1760.01
2040,1/15/2021,1/15/2021,JE-21-0145,LUX PayrollLUX-PRPPD-01152021-LUX-PRPD-01152021,,HJ,,1,1759.01
2040,1/29/2021,1/29/2021,12921,82L-IMPORT PAYROLL-KOPSHEVER MELISSA,,HJ,,0.04,1758.97
2040,1/29/2021,1/29/2021,12921,82L-IMPORT PAYROLL-STROUD DAVID,,HJ,,20,1738.97
2040,1/31/2021,1/31/2021,JE-21-0151,LUX PRPD- 013121-LUX-PRPD-013121,,HJ,,1,1737.97
2040,2/1/2021,2/1/2021,PPP-Int,To accrue PPP loan interest for October-To accrue PPP loan interest for October 2020-Jun 2021,,HJ,,137.13,1600.84
2040,2/12/2021,2/12/2021,21221,82L-IMPORT PAYROLL-Import Payroll,,HJ,,1,1599.84
2040,2/12/2021,2/12/2021,21221,82L-IMPORT PAYROLL-Import Payroll,,HJ,864.51,,2464.35
2040,2/12/2021,2/12/2021,21221,82L-IMPORT PAYROLL-STROUD DAVID,,HJ,,20,2444.35
2040,2/15/2021,2/15/2021,JE-21-0169,LUX PRPD- 021521-LUX-PRPD-02152021,,HJ,,1,2443.35
2040,2/26/2021,2/26/2021,22621,82L-IMPORT PAYROLL-STROUD DAVID,,HJ,,20,2423.35
2040,2/28/2021,2/28/2021,JE-21-0175,LUX PRPD -02282021-LUX-PRPD-022821,,HJ,,1,2422.35
2040,3/1/2021,3/1/2021,PPP-Int,To accrue PPP loan interest for October,,HJ,,137.13,2285.22
2040,3/12/2021,3/12/2021,JE-21-0187,LUX Payroll -PRPD 031521,,HJ,,1,2284.22
2040,3/15/2021,3/15/2021,31521,82L-IMPORT PAYROLL,,HJ,,1,2283.22
2040,3/15/2021,3/15/2021,31521,82L-IMPORT PAYROLL,,HJ,,20,2263.22
2040,3/31/2021,3/31/2021,33121,82L-IMPORT PAYROLL,,HJ,0.58,,2263.8
2040,3/31/2021,3/31/2021,33121,82L-IMPORT PAYROLL,,HJ,,20,2243.8
2040,3/31/2021,3/31/2021,JE-21-0188,LUX Payroll- PRPD 03312021,,HJ,,1,2242.8
2040,4/1/2021,4/1/2021,2VTTZG-D3-6,To accrue PPP loan interest for October,,HJ,,137.13,2105.67
2040,4/1/2021,4/1/2021,2VTTZG-D3-6,To reverse/forgive the PPP accrued loan interest,,HJ,137.13,,2242.8
2040,4/15/2021,4/15/2021,41521,82L-IMPORT PAYROLL,,HJ,,1,2241.8
2040,4/15/2021,4/15/2021,41521,82L-IMPORT PAYROLL,,HJ,,20,2221.8
2040,4/15/2021,4/15/2021,ADP,ADP state UI filings and penalties April 2021,,HJ,8.5,,2230.3
2040,4/15/2021,4/15/2021,JE-21-0200,LUX PRPD -041521,,HJ,,1,2229.3
2040,4/15/2021,4/15/2021,JE-21-0200,LUX PR 20210415 REV &CORR,,HJ,,1,2228.3
2040,4/15/2021,4/15/2021,JE-21-0200,LUX PR 20210415 REV &CORR,,HJ,1,,2229.3
2040,4/21/2021,4/21/2021,ADP,ADP state UI filings and penalties April 2021,,HJ,9458.19,,11687.49
2040,4/23/2021,4/23/2021,ADP,ADP state UI filings and penalties April 2021,,HJ,119.98,,11807.47
2040,4/23/2021,4/23/2021,ADP,ADP state UI filings and penalties April 2021,,HJ,4058.64,,15866.11
2040,4/23/2021,4/23/2021,ADP,ADP state UI filings and penalties April 2021,,HJ,4058.64,,19924.75
2040,4/23/2021,4/23/2021,ADP,ADP state UI filings and penalties April 2021,,HJ,4058.64,,23983.39
2040,4/23/2021,4/23/2021,ADP,ADP state UI filings and penalties April 2021,,HJ,4058.64,,28042.03
2040,4/23/2021,4/23/2021,ADP,ADP state UI filings and penalties April 2021,,HJ,4058.64,,32100.67
2040,4/23/2021,4/23/2021,ADP,ADP state UI filings and penalties April 2021,,HJ,4144.14,,36244.81
2040,4/27/2021,4/27/2021,ADP,ADP state UI filings and penalties April 2021,,HJ,159.28,,36404.09
2040,4/30/2021,4/30/2021,1,To adjust Liabilities booked with Payroll,,HJ,,1360.23,35043.86
2040,4/30/2021,4/30/2021,1,To adjust Liabilities booked with Payroll,,HJ,,27147.51,7896.35
2040,4/30/2021,4/30/2021,43021,82L-IMPORT PAYROLL,,HJ,,20,7876.35
2040,4/30/2021,4/30/2021,JE-21-0204,LUX Payroll 4-30-2021,,HJ,,1,7875.35
2040,4/30/2021,4/30/2021,JE-21-0204,PR LUX 20210430,,HJ,,1,7874.35
2040,4/30/2021,4/30/2021,JE-21-0204,PR LUX 20210430,,HJ,1,,7875.35
2040,5/1/2021,5/1/2021,202007-202104,To accrue PPP loan interest for October,,HJ,,137.13,7738.22
2040,5/1/2021,5/1/2021,202007-202104,To reverse/forgive the PPP accrued loan interest,,HJ,137.13,,7875.35
2040,5/5/2021,5/5/2021,ADP,ADP state UI filings and penatlies May 2021,,HJ,693.14,,8568.49
2040,5/5/2021,5/5/2021,ADP,ADP state UI filings and penatlies May 2021,,HJ,,3.72,8564.77
2040,5/13/2021,5/13/2021,JE-21-0226,LUX Payroll- PRPD 05152021,,HJ,,1,8563.77
2040,5/14/2021,5/14/2021,51421,82L-IMPORT PAYROLL,,HJ,,1,8562.77
2040,5/14/2021,5/14/2021,51421,82L-IMPORT PAYROLL,,HJ,,20,8542.77
2040,5/14/2021,5/14/2021,51421,82L-IMPORT PAYROLL,,HJ,474.18,,9016.95
2040,5/26/2021,5/26/2021,ADP,ADP state UI filings and penatlies May 2021,,HJ,254.48,,9271.43
2040,5/27/2021,5/27/2021,JE-21-0227,LUX PAyroll - PRPD 05312021,,HJ,,1,9270.43
2040,5/28/2021,5/28/2021,52821,82L-IMPORT PAYROLL,,HJ,,20,9250.43
2040,5/28/2021,5/28/2021,52821,82L-IMPORT PAYROLL,,HJ,,25.58,9224.85
2040,5/28/2021,5/28/2021,52821,82L-IMPORT PAYROLL,,HJ,220.71,,9445.56
2040,6/1/2021,6/1/2021,CD-21-0323,To accrue PPP loan interest for October,,HJ,,137.13,9308.43
2040,6/1/2021,6/1/2021,CD-21-0323,To reverse/forgive the PPP accrued loan interest,,HJ,137.13,,9445.56
2040,6/4/2021,6/4/2021,ADP,ADP state UI filings and penalties June 2021,,HJ,174.9,,9620.46
2040,6/14/2021,6/14/2021,ADP,ADP state UI filings and penalties June 2021,,HJ,414.2,,10034.66
2040,6/14/2021,6/14/2021,ADP,ADP state UI filings and penalties June 2021,,HJ,430.44,,10465.1
2040,6/14/2021,6/14/2021,ADP,ADP state UI filings and penalties June 2021,,HJ,1033.66,,11498.76
2040,6/14/2021,6/14/2021,ADP,ADP state UI filings and penalties June 2021,,HJ,1070.77,,12569.53
2040,6/14/2021,6/14/2021,JE-21-0238,PRPD 06152021 LUX,,HJ,,1,12568.53
2040,6/15/2021,6/15/2021,61521,82L-IMPORT PAYROLL,,HJ,,1,12567.53
2040,6/15/2021,6/15/2021,61521,82L-IMPORT PAYROLL,,HJ,,20,12547.53
2040,6/15/2021,6/15/2021,61521,82L-IMPORT PAYROLL,,HJ,,25.58,12521.95
2040,6/15/2021,6/15/2021,61521,82L-IMPORT PAYROLL,,HJ,296.02,,12817.97
2040,6/30/2021,6/30/2021,63021,82L-IMPORT PAYROLL,,HJ,,25.58,12792.39
2040,6/30/2021,6/30/2021,63021,82L-IMPORT PAYROLL,,HJ,288.62,,13081.01
2040,6/30/2021,6/30/2021,JE-21-0245,LUX PR-PD 20210630,,HJ,,1,13080.01
2040, Totals for 2040 - Accrued Expenses,,,,,,52439.84,38460.51,13080.01
2050,2050 - Accrued Payroll and PR Taxes (Balance forward As of 07/01/2020) ,,,,,,,,-541.69
2050,8/31/2020,8/31/2020,LUX-PRPD-083120,LUX-PRPD-083120 -Payroll-Accrued Payroll and PR Taxes -DC,,HJ,25.39,,-516.3
2050,8/31/2020,8/31/2020,LUX-PRPD-083120,LUX-PRPD-083120 -Payroll-Accrued Payroll and PR Taxes -NYC,,HJ,,45.52,-561.82
2050,9/15/2020,9/15/2020,LUX-PRPD-091520,LUX-PRPD-091520-LUX-PRPD-091520 -Payroll,,HJ,,7.88,-569.7
2050,9/15/2020,9/15/2020,LUX-PRPD-091520,LUX-PRPD-091520-LUX-PRPD-091520 -Payroll,,HJ,,11.91,-581.61
2050,9/30/2020,9/30/2020,LUX-PRPD-093020,LUX-PRPD-093020-Payroll,,HJ,,15.8,-597.41
2050,10/15/2020,10/15/2020,JE-21-0061,LUX-PRPD-101520-LUX-PRPD-101520,,HJ,,15.88,-613.29
2050,10/31/2020,10/31/2020,JE-21-0062,LUX-PRPD-103120-LUX-PRPD-103120,,HJ,,15.88,-629.17
2050,11/12/2020,11/12/2020,JE-21-0089,LUX-PRPD-111520-LUX-PRPD-101520,,HJ,,15.88,-645.05
2050,11/27/2020,11/27/2020,JE-21-0091,LUX-PRPD-113020-LUX-PRPD-113020,,HJ,,15.88,-660.93
2050,5/13/2021,5/13/2021,JE-21-0226,LUX Payroll- PRPD 05152021,,HJ,,105.59,-766.52
2050, Totals for 2050 - Accrued Payroll and PR Taxes,,,,,,25.39,250.22,-766.52
2060,2060 - Accrued Exps-Straight Line Rental Exp (Balance forward As of 07/01/2020) ,,,,,,,,-2747.06
2060,7/1/2020,7/1/2020,correct entry,To reduce the monthly rent amount to tie with agreement-Correct amount for Walnut St from 6/1/2020-5/1/2022,,HJ,18.78,,-2728.28
2060,7/1/2020,7/1/2020,Fix Accrued Rent,To clear office rent accrual for 4 months-Fix Accrued Rent for Walnut St from 6/1/2020-9/1/2020,,HJ,2178.87,,-549.41
2060,7/1/2020,7/1/2020,Fix Accrued Rent,To clear office rent accrual for 4 months-Fix Accrued Rent for Walnut St from 6/1/2020-9/1/2020,,HJ,2747.06,,2197.65
2060,7/1/2020,7/1/2020,Recurring rent,Accrual for Walnut St from 6/1/2020-11/30/2022-Accrual for Walnut St from 6/1/2020-5/1/2022,,HJ,,2197.65,0
2060,8/1/2020,8/1/2020,correct entry,To reduce the monthly rent amount to tie with agreement-Correct amount for Walnut St from 6/1/2020-5/1/2022,,HJ,18.78,,18.78
2060,8/1/2020,8/1/2020,Fix Accrued Rent,To clear office rent accrual for 4 months-Fix Accrued Rent for Walnut St from 6/1/2020-9/1/2020,,HJ,2178.87,,2197.65
2060,8/1/2020,8/1/2020,Recurring rent,Accrual for Walnut St from 6/1/2020-11/30/2022-Accrual for Walnut St from 6/1/2020-5/1/2022,,HJ,,2197.65,0
2060,9/1/2020,9/1/2020,correct entry,To reduce the monthly rent amount to tie with agreement-Correct amount for Walnut St from 6/1/2020-5/1/2022,,HJ,18.78,,18.78
2060,9/1/2020,9/1/2020,Fix Accrued Rent,To clear office rent accrual for 4 months-Fix Accrued Rent for Walnut St from 6/1/2020-9/1/2020,,HJ,2178.87,,2197.65
2060,9/1/2020,9/1/2020,Recurring rent,Accrual for Walnut St from 6/1/2020-11/30/2022-Accrual for Walnut St from 6/1/2020-5/1/2022,,HJ,,2197.65,0
2060,10/1/2020,10/1/2020,correct entry,To reduce the monthly rent amount to tie with agreement-Correct amount for Walnut St from 6/1/2020-5/1/2022,,HJ,18.78,,18.78
2060,10/1/2020,10/1/2020,Fix 2Q Rent,To clear office rent accrual for 2Q-FY20-Fix Accrued Rent for Walnut St from 10/1/2020-12/1/2020,,HJ,2178.87,,2197.65
2060,10/1/2020,10/1/2020,Recurring rent,Accrual for Walnut St from 6/1/2020-11/30/2022-Accrual for Walnut St from 6/1/2020-5/1/2022,,HJ,,2197.65,0
2060,11/1/2020,11/1/2020,correct entry,To reduce the monthly rent amount to tie with agreement-Correct amount for Walnut St from 6/1/2020-5/1/2022,,HJ,18.78,,18.78
2060,11/1/2020,11/1/2020,Fix 2Q Rent,To clear office rent accrual for 2Q-FY20-Fix Accrued Rent for Walnut St from 10/1/2020-12/1/2020,,HJ,2178.87,,2197.65
2060,11/1/2020,11/1/2020,Recurring rent,Accrual for Walnut St from 6/1/2020-11/30/2022-Accrual for Walnut St from 6/1/2020-5/1/2022,,HJ,,2197.65,0
2060,12/1/2020,12/1/2020,correct entry,To reduce the monthly rent amount to tie with agreement-Correct amount for Walnut St from 6/1/2020-5/1/2022,,HJ,18.78,,18.78
2060,12/1/2020,12/1/2020,Fix 2Q Rent,To clear office rent accrual for 2Q-FY20-Fix Accrued Rent for Walnut St from 10/1/2020-12/1/2020,,HJ,2178.87,,2197.65
2060,12/1/2020,12/1/2020,Recurring rent,Accrual for Walnut St from 6/1/2020-11/30/2022-Accrual for Walnut St from 6/1/2020-5/1/2022,,HJ,,2197.65,0
2060,1/1/2021,1/1/2021,correct entry,To reduce the monthly rent amount to tie with agreement-Correct amount for Walnut St from 6/1/2020-5/1/2022,,HJ,18.78,,18.78
2060,1/1/2021,1/1/2021,Recurring rent,Accrual for Walnut St from 6/1/2020-11/30/2022-Accrual for Walnut St from 6/1/2020-5/1/2022,,HJ,,2197.65,-2178.87
2060,1/22/2021,1/22/2021,Walnut Street Realty,Bill.Com Import-Recurring Bill Monthly rent for office at Newton,,HJ,2192.58,,13.71
2060,1/31/2021,1/31/2021,20210131,To Adj Walnut Accrued amount-To Adj Walnut Accrued amount,,HJ,,13.71,0
2060,2/1/2021,2/1/2021,correct entry,To reduce the monthly rent amount to tie with agreement-Correct amount for Walnut St from 6/1/2020-5/1/2022,,HJ,18.78,,18.78
2060,2/1/2021,2/1/2021,Recurring rent,Accrual for Walnut St from 6/1/2020-11/30/2022-Accrual for Walnut St from 6/1/2020-5/1/2022,,HJ,,2197.65,-2178.87
2060,2/1/2021,2/1/2021,Recurring rent,JE-20-0026 Rev-Accrual for Walnut St from 6/1/2020-5/1/2022,,HJ,2197.65,,18.78
2060,2/1/2021,2/1/2021,Recurring rent,JE-20-0026 Rev-Correct amount for Walnut St from 6/1/2020-5/1/2022,,HJ,,18.78,0
2060,3/1/2021,3/1/2021,correct entry,To reduce the monthly rent amount to tie with agreement,,HJ,18.78,,18.78
2060,3/1/2021,3/1/2021,correct entry,JE-20-0026 Rev,,HJ,,18.78,0
2060,3/1/2021,3/1/2021,Recurring rent,Accrual for Walnut St from 6/1/2020-11/30/2022,,HJ,,2197.65,-2197.65
2060,3/1/2021,3/1/2021,Recurring rent,JE-20-0026 Rev,,HJ,2197.65,,0
2060,4/1/2021,4/1/2021,2VTTZG-D3-6,Accrual for Walnut St from 6/1/2020-11/30/2022,,HJ,,2197.65,-2197.65
2060,4/1/2021,4/1/2021,2VTTZG-D3-6,JE-20-0026 Rev,,HJ,,18.78,-2216.43
2060,4/1/2021,4/1/2021,2VTTZG-D3-6,JE-20-0026 Rev,,HJ,2197.65,,-18.78
2060,4/1/2021,4/1/2021,2VTTZG-D3-6,To reduce the monthly rent amount to tie with agreement,,HJ,18.78,,0
2060,5/1/2021,5/1/2021,202007-202104,Accrual for Walnut St from 6/1/2020-11/30/2022,,HJ,,2197.65,-2197.65
2060,5/1/2021,5/1/2021,202007-202104,JE-20-0026 Rev,,HJ,,18.78,-2216.43
2060,5/1/2021,5/1/2021,202007-202104,JE-20-0026 Rev,,HJ,2197.65,,-18.78
2060,5/1/2021,5/1/2021,202007-202104,To reduce the monthly rent amount to tie with agreement,,HJ,18.78,,0
2060,6/1/2021,6/1/2021,CD-21-0323,Accrual for Walnut St from 6/1/2020-11/30/2022,,HJ,,2197.65,-2197.65
2060,6/1/2021,6/1/2021,CD-21-0323,JE-20-0026 Rev,,HJ,,18.78,-2216.43
2060,6/1/2021,6/1/2021,CD-21-0323,JE-20-0026 Rev,,HJ,2197.65,,-18.78
2060,6/1/2021,6/1/2021,CD-21-0323,To reduce the monthly rent amount to tie with agreement,,HJ,18.78,,0
2060, Totals for 2060 - Accrued Exps-Straight Line Rental Exp,,,,,,29226.47,26479.41,0
2300,2300 - 401k Withheld (Balance forward As of 07/01/2020) ,,,,,,,,0
2300,7/6/2020,7/6/2020,TAG Resources LLC,To record 401K payment-To record 401K payment,,HJ,2778.91,,2778.91
2300,7/15/2020,7/15/2020,71520,82L-PRPD-071520 -Import Payroll (GENERL)-Import Payroll,,HJ,,175,2603.91
2300,7/15/2020,7/15/2020,71520,82L-PRPD-071520 -Import Payroll (GENERL)-Import Payroll,,HJ,,537.5,2066.41
2300,7/15/2020,7/15/2020,71520,82L-PRPD-071520 -Import Payroll (GENERL)-Import Payroll,,HJ,,839.58,1226.83
2300,7/15/2020,7/15/2020,71520,82L-PRPD-071520 -Import Payroll (GENERL)-Import Payroll,,HJ,,2089.72,-862.89
2300,7/15/2020,7/15/2020,71520,To reverse 82L payroll 0715 JE-21-0008-Reverse payroll entry 07152020 IMPORT PAYROLL,,HJ,175,,-687.89
2300,7/15/2020,7/15/2020,71520,To reverse 82L payroll 0715 JE-21-0008-Reverse payroll entry 07152020 IMPORT PAYROLL,,HJ,537.5,,-150.39
2300,7/15/2020,7/15/2020,71520,To reverse 82L payroll 0715 JE-21-0008-Reverse payroll entry 07152020 IMPORT PAYROLL,,HJ,839.58,,689.19
2300,7/15/2020,7/15/2020,71520,To reverse 82L payroll 0715 JE-21-0008-Reverse payroll entry 07152020 IMPORT PAYROLL,,HJ,2089.72,,2778.91
2300,7/15/2020,7/15/2020,71520,82L-IMPORT PAYROLL-ACEVEDO MONIVETT,,HJ,,537.5,2241.41
2300,7/15/2020,7/15/2020,71520,82L-IMPORT PAYROLL-DETONE KYRA MAYA,,HJ,,175,2066.41
2300,7/15/2020,7/15/2020,71520,82L-IMPORT PAYROLL-Import Payroll,,HJ,,839.58,1226.83
2300,7/15/2020,7/15/2020,71520,82L-IMPORT PAYROLL-Import Payroll,,HJ,,2089.72,-862.89
2300,7/20/2020,7/20/2020,TAG Resources LLC,Employees'401K payment-Employees'401K payment,,HJ,3641.8,,2778.91
2300,7/31/2020,7/31/2020,73120,82L-PRPD-073120 -Import Payroll-Import Payroll,,HJ,,175,2603.91
2300,7/31/2020,7/31/2020,73120,82L-PRPD-073120 -Import Payroll-Import Payroll,,HJ,,537.5,2066.41
2300,7/31/2020,7/31/2020,73120,82L-PRPD-073120 -Import Payroll-Import Payroll,,HJ,,579.58,1486.83
2300,7/31/2020,7/31/2020,73120,82L-PRPD-073120 -Import Payroll-Import Payroll,,HJ,,1470.2,16.63
2300,7/31/2020,7/31/2020,73120,To reverse 82L payroll 73120-To reverse 82L payroll of 73120 JE-21-0003,,HJ,175,,191.63
2300,7/31/2020,7/31/2020,73120,To reverse 82L payroll 73120-To reverse 82L payroll of 73120 JE-21-0003,,HJ,537.5,,729.13
2300,7/31/2020,7/31/2020,73120,To reverse 82L payroll 73120-To reverse 82L payroll of 73120 JE-21-0003,,HJ,579.58,,1308.71
2300,7/31/2020,7/31/2020,73120,To reverse 82L payroll 73120-To reverse 82L payroll of 73120 JE-21-0003,,HJ,1470.2,,2778.91
2300,7/31/2020,7/31/2020,73120,82L-IMPORT PAYROLL-ACEVEDO MONIVETT,,HJ,,537.5,2241.41
2300,7/31/2020,7/31/2020,73120,82L-IMPORT PAYROLL-BOWMAN HALLEY K + Cathryn Cook,,HJ,,1470.2,771.21
2300,7/31/2020,7/31/2020,73120,82L-IMPORT PAYROLL-DETONE KYRA MAYA,,HJ,,175,596.21
2300,7/31/2020,7/31/2020,73120,82L-IMPORT PAYROLL-GUADARRAMA-ALVAREZ URIEL A,,HJ,,579.58,16.63
2300,8/4/2020,8/4/2020,TAG Resources LLC,401K Payment for PD7/31/2020-401K Payment for PD7/31/2020,,HJ,2762.28,,2778.91
2300,8/14/2020,8/14/2020,81420,82L-IMPORT PAYROLL-ACEVEDO MONIVETT,,HJ,,537.5,2241.41
2300,8/14/2020,8/14/2020,81420,82L-IMPORT PAYROLL-COOK CATHRYN ANNA + BOWMAN HALLEY K,,HJ,,1470.2,771.21
2300,8/14/2020,8/14/2020,81420,82L-IMPORT PAYROLL-DETONE KYRA MAYA,,HJ,,175,596.21
2300,8/14/2020,8/14/2020,81420,82L-IMPORT PAYROLL-GUADARRAMA-ALVAREZ URIEL A,,HJ,,579.58,16.63
2300,8/14/2020,8/14/2020,82L-PRPD-081520,82L-PRPD-081520 -IMPORT PAYROLL-Import Payroll,,HJ,,175,-158.37
2300,8/14/2020,8/14/2020,82L-PRPD-081520,82L-PRPD-081520 -IMPORT PAYROLL-Import Payroll,,HJ,,537.5,-695.87
2300,8/14/2020,8/14/2020,82L-PRPD-081520,82L-PRPD-081520 -IMPORT PAYROLL-Import Payroll,,HJ,,579.58,-1275.45
2300,8/14/2020,8/14/2020,82L-PRPD-081520,82L-PRPD-081520 -IMPORT PAYROLL-Import Payroll,,HJ,,1470.2,-2745.65
2300,8/15/2020,8/15/2020,82L-PRPD-081520,To reverse 82L payroll 0815 JE-21-0020-To reverse 82L Payroll of 8152020,,HJ,175,,-2570.65
2300,8/15/2020,8/15/2020,82L-PRPD-081520,To reverse 82L payroll 0815 JE-21-0020-To reverse 82L Payroll of 8152020,,HJ,537.5,,-2033.15
2300,8/15/2020,8/15/2020,82L-PRPD-081520,To reverse 82L payroll 0815 JE-21-0020-To reverse 82L Payroll of 8152020,,HJ,579.58,,-1453.57
2300,8/15/2020,8/15/2020,82L-PRPD-081520,To reverse 82L payroll 0815 JE-21-0020-To reverse 82L Payroll of 8152020,,HJ,1470.2,,16.63
2300,8/18/2020,8/18/2020,TAG Resources LLC,Employee 401K withholding-Employee 401K withholding,,HJ,2762.28,,2778.91
2300,8/31/2020,8/31/2020,83120,82L-IMPORT PAYROLL-ACEVEDO MONIVETT,,HJ,,537.5,2241.41
2300,8/31/2020,8/31/2020,83120,82L-IMPORT PAYROLL-Cook Cathryn + Bowman Halley,,HJ,,1470.2,771.21
2300,8/31/2020,8/31/2020,83120,82L-IMPORT PAYROLL-DETONE KYRA MAYA,,HJ,,175,596.21
2300,8/31/2020,8/31/2020,83120,82L-IMPORT PAYROLL-GUADARRAMA-ALVAREZ URIEL A,,HJ,,579.58,16.63
2300,8/31/2020,8/31/2020,82L-PRPD-083120,82L-PRPD-083120 -IMPORT PAYROLL-Import Payroll,,HJ,,175,-158.37
2300,8/31/2020,8/31/2020,82L-PRPD-083120,82L-PRPD-083120 -IMPORT PAYROLL-Import Payroll,,HJ,,537.5,-695.87
2300,8/31/2020,8/31/2020,82L-PRPD-083120,82L-PRPD-083120 -IMPORT PAYROLL-Import Payroll,,HJ,,579.58,-1275.45
2300,8/31/2020,8/31/2020,82L-PRPD-083120,82L-PRPD-083120 -IMPORT PAYROLL-Import Payroll,,HJ,,1470.2,-2745.65
2300,8/31/2020,8/31/2020,82L-PRPD-083120,Reverse 82L payroll of 83120 JE-21-0021-IMPORT PAYROLL,,HJ,175,,-2570.65
2300,8/31/2020,8/31/2020,82L-PRPD-083120,Reverse 82L payroll of 83120 JE-21-0021-IMPORT PAYROLL,,HJ,537.5,,-2033.15
2300,8/31/2020,8/31/2020,82L-PRPD-083120,Reverse 82L payroll of 83120 JE-21-0021-IMPORT PAYROLL,,HJ,579.58,,-1453.57
2300,8/31/2020,8/31/2020,82L-PRPD-083120,Reverse 82L payroll of 83120 JE-21-0021-IMPORT PAYROLL,,HJ,1470.2,,16.63
2300,9/2/2020,9/2/2020,TAG Resources LLC,Employee 401K withholding-Employee 401K withholding,,HJ,2762.28,,2778.91
2300,9/15/2020,9/15/2020,91520,82L-IMPORT PAYROLL-Import Payroll,,HJ,,100,2678.91
2300,9/15/2020,9/15/2020,91520,82L-IMPORT PAYROLL-Import Payroll,,HJ,,175,2503.91
2300,9/15/2020,9/15/2020,91520,82L-IMPORT PAYROLL-Import Payroll,,HJ,,579.58,1924.33
2300,9/15/2020,9/15/2020,91520,82L-IMPORT PAYROLL-Import Payroll,,HJ,,645,1279.33
2300,9/15/2020,9/15/2020,91520,82L-IMPORT PAYROLL-Import Payroll,,HJ,,1526.15,-246.82
2300,9/16/2020,9/16/2020,TAG Resources LLC,Employee 401K withholding-Employee 401K withholding,,HJ,3025.73,,2778.91
2300,9/30/2020,9/30/2020,93020,82L-IMPORT PAYROLL-Import Payroll,,HJ,,100,2678.91
2300,9/30/2020,9/30/2020,93020,82L-IMPORT PAYROLL-Import Payroll,,HJ,,175,2503.91
2300,9/30/2020,9/30/2020,93020,82L-IMPORT PAYROLL-Import Payroll,,HJ,,579.58,1924.33
2300,9/30/2020,9/30/2020,93020,82L-IMPORT PAYROLL-Import Payroll,,HJ,,645,1279.33
2300,9/30/2020,9/30/2020,93020,82L-IMPORT PAYROLL-Import Payroll,,HJ,,1681.15,-401.82
2300,10/2/2020,10/2/2020,TAG Resources LLC,Employee 401K withholding pd9/30-Employee 401K withholding pd9/30,,HJ,3180.73,,2778.91
2300,10/15/2020,10/15/2020,101520,82L-IMPORT PAYROLL-Import Payroll,,HJ,,100,2678.91
2300,10/15/2020,10/15/2020,101520,82L-IMPORT PAYROLL-Import Payroll,,HJ,,175,2503.91
2300,10/15/2020,10/15/2020,101520,82L-IMPORT PAYROLL-Import Payroll,,HJ,,645,1858.91
2300,10/15/2020,10/15/2020,101520,82L-IMPORT PAYROLL-Import Payroll,,HJ,,1765.01,93.9
2300,10/19/2020,10/19/2020,TAG Resources LLC,Employee 401K for PD10/15-Employee 401K for PD10/15,,HJ,3264.59,,3358.49
2300,10/30/2020,10/30/2020,103120,82L-IMPORT PAYROLL-Import Payroll,,HJ,,100,3258.49
2300,10/30/2020,10/30/2020,103120,82L-IMPORT PAYROLL-Import Payroll,,HJ,,175,3083.49
2300,10/30/2020,10/30/2020,103120,82L-IMPORT PAYROLL-Import Payroll,,HJ,,579.58,2503.91
2300,10/30/2020,10/30/2020,103120,82L-IMPORT PAYROLL-Import Payroll,,HJ,,645,1858.91
2300,10/30/2020,10/30/2020,103120,82L-IMPORT PAYROLL-Import Payroll,,HJ,,1675.77,183.14
2300,11/2/2020,11/2/2020,TAG Resources LLC,Employee 401K payment-Employee 401K payment,,HJ,3175.35,,3358.49
2300,11/13/2020,11/13/2020,111320,82L-IMPORT PAYROLL-579.58 Adjusted to rec with bank,,HJ,,1159.16,2199.33
2300,11/13/2020,11/13/2020,111320,82L-IMPORT PAYROLL-Import Payroll,,HJ,,100,2099.33
2300,11/13/2020,11/13/2020,111320,82L-IMPORT PAYROLL-Import Payroll,,HJ,,175,1924.33
2300,11/13/2020,11/13/2020,111320,82L-IMPORT PAYROLL-Import Payroll,,HJ,,645,1279.33
2300,11/13/2020,11/13/2020,111320,82L-IMPORT PAYROLL-Import Payroll,,HJ,,1573.34,-294.01
2300,11/16/2020,11/16/2020,TAG Resources LLC,Employee 401K payment for PD 11/15-Employee 401K payment for PD 11/15,,HJ,3072.92,,2778.91
2300,11/30/2020,11/30/2020,113020,82L-IMPORT PAYROLL-579.58 Adjusted to rec with bank,,HJ,,1159.16,1619.75
2300,11/30/2020,11/30/2020,113020,82L-IMPORT PAYROLL-Import Payroll,,HJ,,100,1519.75
2300,11/30/2020,11/30/2020,113020,82L-IMPORT PAYROLL-Import Payroll,,HJ,,175,1344.75
2300,11/30/2020,11/30/2020,113020,82L-IMPORT PAYROLL-Import Payroll,,HJ,,645,699.75
2300,11/30/2020,11/30/2020,113020,82L-IMPORT PAYROLL-Import Payroll,,HJ,,1972.41,-1272.66
2300,12/1/2020,12/1/2020,TAG Resources LLC,To record employee 401k payment-To record employee 401k payment,,HJ,3471.99,,2199.33
2300,12/1/2020,12/1/2020,TAG Resources LLC,To record employee 401k payment-To record employee 401k payment,,HJ,3815.83,,6015.16
2300,12/15/2020,12/15/2020,121520,82L-IMPORT PAYROLL-Adj to rec,,HJ,,281.09,5734.07
2300,12/15/2020,12/15/2020,121520,82L-IMPORT PAYROLL-Adj to rec,,HJ,,300,5434.07
2300,12/15/2020,12/15/2020,121520,82L-IMPORT PAYROLL-Adj to rec,,HJ,,311.9,5122.17
2300,12/15/2020,12/15/2020,121520,82L-IMPORT PAYROLL-Adj to rec,,HJ,,2313.96,2808.21
2300,12/15/2020,12/15/2020,121520,82L-IMPORT PAYROLL-Adj to rec,,HJ,,2886.64,-78.43
2300,12/15/2020,12/15/2020,121520,82L-IMPORT PAYROLL-Import Payroll,,HJ,,175,-253.43
2300,12/15/2020,12/15/2020,121520,82L-IMPORT PAYROLL-Import Payroll,,HJ,,579.58,-833.01
2300,12/31/2020,12/31/2020,123120,82L-IMPORT PAYROLL-Import Payroll,,HJ,,150,-983.01
2300,12/31/2020,12/31/2020,123120,82L-IMPORT PAYROLL-Import Payroll,,HJ,,155,-1138.01
2300,12/31/2020,12/31/2020,123120,82L-IMPORT PAYROLL-Import Payroll,,HJ,,155.95,-1293.96
2300,12/31/2020,12/31/2020,123120,82L-IMPORT PAYROLL-Import Payroll,,HJ,,351.38,-1645.34
2300,12/31/2020,12/31/2020,123120,82L-IMPORT PAYROLL-Import Payroll,,HJ,,1079.3,-2724.64
2300,12/31/2020,12/31/2020,123120,82L-IMPORT PAYROLL-Import Payroll,,HJ,,1106.8,-3831.44
2300,12/31/2020,12/31/2020,123120,82L-IMPORT PAYROLL-Import Payroll,,HJ,,1522.49,-5353.93
2300,1/4/2021,1/4/2021,TAG Resources LLC,Employee 401K Payment-Employee 401K Payment PD 12312020,,HJ,3993.7,,-1360.23
2300,1/15/2021,1/15/2021,11521,82L-IMPORT PAYROLL-Import Payroll,,HJ,,155,-1515.23
2300,1/15/2021,1/15/2021,11521,82L-IMPORT PAYROLL-Import Payroll,,HJ,,155.95,-1671.18
2300,1/15/2021,1/15/2021,11521,82L-IMPORT PAYROLL-Import Payroll,,HJ,,351.38,-2022.56
2300,1/15/2021,1/15/2021,11521,82L-IMPORT PAYROLL-Import Payroll,,HJ,,579.58,-2602.14
2300,1/15/2021,1/15/2021,11521,82L-IMPORT PAYROLL-Import Payroll,,HJ,,1047.52,-3649.66
2300,1/15/2021,1/15/2021,11521,82L-IMPORT PAYROLL-Import Payroll,,HJ,,1518.49,-5168.15
2300,1/15/2021,1/15/2021,11521,82L-IMPORT PAYROLL-SEJOUR MAHALIAH,,HJ,,150,-5318.15
2300,1/20/2021,1/20/2021,TAG Resources LLC,To record employee 401k payment-To record employee 401k payment,,HJ,3957.92,,-1360.23
2300,1/29/2021,1/29/2021,12921,82L-IMPORT PAYROLL-BOWMAN HALLEY K,,HJ,,859.38,-2219.61
2300,1/29/2021,1/29/2021,12921,82L-IMPORT PAYROLL-Import Payroll,,HJ,,150,-2369.61
2300,1/29/2021,1/29/2021,12921,82L-IMPORT PAYROLL-Import Payroll,,HJ,,155,-2524.61
2300,1/29/2021,1/29/2021,12921,82L-IMPORT PAYROLL-Import Payroll,,HJ,,155.95,-2680.56
2300,1/29/2021,1/29/2021,12921,82L-IMPORT PAYROLL-Import Payroll,,HJ,,175,-2855.56
2300,1/29/2021,1/29/2021,12921,82L-IMPORT PAYROLL-Import Payroll,,HJ,,351.38,-3206.94
2300,1/29/2021,1/29/2021,12921,82L-IMPORT PAYROLL-Import Payroll,,HJ,,579.58,-3786.52
2300,1/29/2021,1/29/2021,12921,82L-IMPORT PAYROLL-Import Payroll,,HJ,,1522.49,-5309.01
2300,2/1/2021,2/1/2021,TAG Resources LLC,Employee 401K Payment PD 01282021-Employee 401K Payment PD 01282021,,HJ,3948.78,,-1360.23
2300,2/12/2021,2/12/2021,21221,82L-IMPORT PAYROLL-Import Payroll,,HJ,,135.42,-1495.65
2300,2/12/2021,2/12/2021,21221,82L-IMPORT PAYROLL-Import Payroll,,HJ,,150,-1645.65
2300,2/12/2021,2/12/2021,21221,82L-IMPORT PAYROLL-Import Payroll,,HJ,,151.65,-1797.3
2300,2/12/2021,2/12/2021,21221,82L-IMPORT PAYROLL-Import Payroll,,HJ,,155,-1952.3
2300,2/12/2021,2/12/2021,21221,82L-IMPORT PAYROLL-Import Payroll,,HJ,,351.38,-2303.68
2300,2/12/2021,2/12/2021,21221,82L-IMPORT PAYROLL-Import Payroll,,HJ,,579.58,-2883.26
2300,2/12/2021,2/12/2021,21221,82L-IMPORT PAYROLL-Import Payroll,,HJ,,1034.38,-3917.64
2300,2/12/2021,2/12/2021,21221,82L-IMPORT PAYROLL-Import Payroll,,HJ,,1518.49,-5436.13
2300,2/16/2021,2/16/2021,TAG Resources LLC,Employee 401K Payment PD 02.12-Employee 401K Payment PD 02.12,,HJ,4075.9,,-1360.23
2300,2/26/2021,2/26/2021,22621,82L-IMPORT PAYROLL-Import Payroll,,HJ,,100,-1460.23
2300,2/26/2021,2/26/2021,22621,82L-IMPORT PAYROLL-Import Payroll,,HJ,,135.42,-1595.65
2300,2/26/2021,2/26/2021,22621,82L-IMPORT PAYROLL-Import Payroll,,HJ,,150,-1745.65
2300,2/26/2021,2/26/2021,22621,82L-IMPORT PAYROLL-Import Payroll,,HJ,,155,-1900.65
2300,2/26/2021,2/26/2021,22621,82L-IMPORT PAYROLL-Import Payroll,,HJ,,579.58,-2480.23
2300,2/26/2021,2/26/2021,22621,82L-IMPORT PAYROLL-Import Payroll,,HJ,,928,-3408.23
2300,2/26/2021,2/26/2021,22621,82L-IMPORT PAYROLL-Import Payroll,,HJ,,1576.05,-4984.28
2300,2/26/2021,2/26/2021,22621,82L-IMPORT PAYROLL-Import Payroll,,HJ,,1727.49,-6711.77
2300,2/26/2021,2/26/2021,22621,82L-IMPORT PAYROLL-Import Payroll,,HJ,,1976.38,-8688.15
2300,3/1/2021,3/1/2021,"TAG Resources, LLC",Employee 401K Payment PD02.25,,HJ,7327.92,,-1360.23
2300,3/15/2021,3/15/2021,31521,82L-IMPORT PAYROLL,,HJ,,100,-1460.23
2300,3/15/2021,3/15/2021,31521,82L-IMPORT PAYROLL,,HJ,,135.42,-1595.65
2300,3/15/2021,3/15/2021,31521,82L-IMPORT PAYROLL,,HJ,,150,-1745.65
2300,3/15/2021,3/15/2021,31521,82L-IMPORT PAYROLL,,HJ,,260.52,-2006.17
2300,3/15/2021,3/15/2021,31521,82L-IMPORT PAYROLL,,HJ,,579.58,-2585.75
2300,3/15/2021,3/15/2021,31521,82L-IMPORT PAYROLL,,HJ,,928,-3513.75
2300,3/15/2021,3/15/2021,31521,82L-IMPORT PAYROLL,,HJ,,1576.05,-5089.8
2300,3/15/2021,3/15/2021,31521,82L-IMPORT PAYROLL,,HJ,,1718.49,-6808.29
2300,3/15/2021,3/15/2021,31521,82L-IMPORT PAYROLL,,HJ,,1976.38,-8784.67
2300,3/15/2021,3/15/2021,"TAG Resources, LLC",Employee 401K Payment PD03.12,,HJ,7424.44,,-1360.23
2300,3/31/2021,3/31/2021,33121,82L-IMPORT PAYROLL,,HJ,,100,-1460.23
2300,3/31/2021,3/31/2021,33121,82L-IMPORT PAYROLL,,HJ,,135.42,-1595.65
2300,3/31/2021,3/31/2021,33121,82L-IMPORT PAYROLL,,HJ,,155,-1750.65
2300,3/31/2021,3/31/2021,33121,82L-IMPORT PAYROLL,,HJ,,377.08,-2127.73
2300,3/31/2021,3/31/2021,33121,82L-IMPORT PAYROLL,,HJ,,579.58,-2707.31
2300,3/31/2021,3/31/2021,33121,82L-IMPORT PAYROLL,,HJ,,928,-3635.31
2300,3/31/2021,3/31/2021,33121,82L-IMPORT PAYROLL,,HJ,,1576.05,-5211.36
2300,3/31/2021,3/31/2021,33121,82L-IMPORT PAYROLL,,HJ,,1727.49,-6938.85
2300,3/31/2021,3/31/2021,33121,82L-IMPORT PAYROLL,,HJ,,2156.38,-9095.23
2300,4/1/2021,4/1/2021,"TAG Resources, LLC",Employee 401K Payment PD03.31,,HJ,7735,,-1360.23
2300,4/15/2021,4/15/2021,41521,82L-IMPORT PAYROLL,,HJ,,100,-1460.23
2300,4/15/2021,4/15/2021,41521,82L-IMPORT PAYROLL,,HJ,,135.42,-1595.65
2300,4/15/2021,4/15/2021,41521,82L-IMPORT PAYROLL,,HJ,,155,-1750.65
2300,4/15/2021,4/15/2021,41521,82L-IMPORT PAYROLL,,HJ,,377.08,-2127.73
2300,4/15/2021,4/15/2021,41521,82L-IMPORT PAYROLL,,HJ,,579.58,-2707.31
2300,4/15/2021,4/15/2021,41521,82L-IMPORT PAYROLL,,HJ,,928,-3635.31
2300,4/15/2021,4/15/2021,41521,82L-IMPORT PAYROLL,,HJ,,1404.17,-5039.48
2300,4/15/2021,4/15/2021,41521,82L-IMPORT PAYROLL,,HJ,,1718.49,-6757.97
2300,4/15/2021,4/15/2021,41521,82L-IMPORT PAYROLL,,HJ,,2006.38,-8764.35
2300,4/16/2021,4/16/2021,"TAG Resources, LLC",Employee 401K Payment PD04.15,,HJ,7404.12,,-1360.23
2300,4/30/2021,4/30/2021,1,To adjust Liabilities booked with Payroll,,HJ,1360.23,,0
2300,4/30/2021,4/30/2021,43021,82L-IMPORT PAYROLL,,HJ,,100,-100
2300,4/30/2021,4/30/2021,43021,82L-IMPORT PAYROLL,,HJ,,135.42,-235.42
2300,4/30/2021,4/30/2021,43021,82L-IMPORT PAYROLL,,HJ,,155,-390.42
2300,4/30/2021,4/30/2021,43021,82L-IMPORT PAYROLL,,HJ,,209.48,-599.9
2300,4/30/2021,4/30/2021,43021,82L-IMPORT PAYROLL,,HJ,,377.08,-976.98
2300,4/30/2021,4/30/2021,43021,82L-IMPORT PAYROLL,,HJ,,579.58,-1556.56
2300,4/30/2021,4/30/2021,43021,82L-IMPORT PAYROLL,,HJ,,928,-2484.56
2300,4/30/2021,4/30/2021,43021,82L-IMPORT PAYROLL,,HJ,,1404.17,-3888.73
2300,4/30/2021,4/30/2021,43021,82L-IMPORT PAYROLL,,HJ,,1727.49,-5616.22
2300,4/30/2021,4/30/2021,43021,82L-IMPORT PAYROLL,,HJ,,2006.38,-7622.6
2300,5/3/2021,5/3/2021,"TAG Resources, LLC",Employee 401k Payment PD04.29,,HJ,7622.6,,0
2300,5/14/2021,5/14/2021,51421,82L-IMPORT PAYROLL,,HJ,,100,-100
2300,5/14/2021,5/14/2021,51421,82L-IMPORT PAYROLL,,HJ,,135.42,-235.42
2300,5/14/2021,5/14/2021,51421,82L-IMPORT PAYROLL,,HJ,,155,-390.42
2300,5/14/2021,5/14/2021,51421,82L-IMPORT PAYROLL,,HJ,,208.52,-598.94
2300,5/14/2021,5/14/2021,51421,82L-IMPORT PAYROLL,,HJ,,377.08,-976.02
2300,5/14/2021,5/14/2021,51421,82L-IMPORT PAYROLL,,HJ,,579.58,-1555.6
2300,5/14/2021,5/14/2021,51421,82L-IMPORT PAYROLL,,HJ,,716.67,-2272.27
2300,5/14/2021,5/14/2021,51421,82L-IMPORT PAYROLL,,HJ,,928,-3200.27
2300,5/14/2021,5/14/2021,51421,82L-IMPORT PAYROLL,,HJ,,1868.49,-5068.76
2300,5/14/2021,5/14/2021,51421,82L-IMPORT PAYROLL,,HJ,,2222.39,-7291.15
2300,5/14/2021,5/14/2021,"TAG Resources, LLC",Employee 401K Payment PD05.13,,HJ,7291.15,,0
2300,5/28/2021,5/28/2021,52821,82L-IMPORT PAYROLL,,HJ,,100,-100
2300,5/28/2021,5/28/2021,52821,82L-IMPORT PAYROLL,,HJ,,135.42,-235.42
2300,5/28/2021,5/28/2021,52821,82L-IMPORT PAYROLL,,HJ,,204.18,-439.6
2300,5/28/2021,5/28/2021,52821,82L-IMPORT PAYROLL,,HJ,,289.13,-728.73
2300,5/28/2021,5/28/2021,52821,82L-IMPORT PAYROLL,,HJ,,377.08,-1105.81
2300,5/28/2021,5/28/2021,52821,82L-IMPORT PAYROLL,,HJ,,579.58,-1685.39
2300,5/28/2021,5/28/2021,52821,82L-IMPORT PAYROLL,,HJ,,716.67,-2402.06
2300,5/28/2021,5/28/2021,52821,82L-IMPORT PAYROLL,,HJ,,928,-3330.06
2300,5/28/2021,5/28/2021,52821,82L-IMPORT PAYROLL,,HJ,,1877.49,-5207.55
2300,5/28/2021,5/28/2021,52821,82L-IMPORT PAYROLL,,HJ,,2222.39,-7429.94
2300,6/1/2021,6/1/2021,"TAG Resources, LLC",Employee 401K Payment PD05.28,,HJ,7429.94,,0
2300,6/15/2021,6/15/2021,61521,82L-IMPORT PAYROLL,,HJ,,100,-100
2300,6/15/2021,6/15/2021,61521,82L-IMPORT PAYROLL,,HJ,,155,-255
2300,6/15/2021,6/15/2021,61521,82L-IMPORT PAYROLL,,HJ,,207.36,-462.36
2300,6/15/2021,6/15/2021,61521,82L-IMPORT PAYROLL,,HJ,,285.42,-747.78
2300,6/15/2021,6/15/2021,61521,82L-IMPORT PAYROLL,,HJ,,377.08,-1124.86
2300,6/15/2021,6/15/2021,61521,82L-IMPORT PAYROLL,,HJ,,579.58,-1704.44
2300,6/15/2021,6/15/2021,61521,82L-IMPORT PAYROLL,,HJ,,716.67,-2421.11
2300,6/15/2021,6/15/2021,61521,82L-IMPORT PAYROLL,,HJ,,928,-3349.11
2300,6/15/2021,6/15/2021,61521,82L-IMPORT PAYROLL,,HJ,,1868.49,-5217.6
2300,6/15/2021,6/15/2021,61521,82L-IMPORT PAYROLL,,HJ,,2222.39,-7439.99
2300,6/15/2021,6/15/2021,"TAG Resources, LLC",Employee 401K Payment PD06.14,,HJ,7439.99,,0
2300,6/30/2021,6/30/2021,63021,82L-IMPORT PAYROLL,,HJ,,205.52,-205.52
2300,6/30/2021,6/30/2021,63021,82L-IMPORT PAYROLL,,HJ,,208.65,-414.17
2300,6/30/2021,6/30/2021,63021,82L-IMPORT PAYROLL,,HJ,,211.91,-626.08
2300,6/30/2021,6/30/2021,63021,82L-IMPORT PAYROLL,,HJ,,263.54,-889.62
2300,6/30/2021,6/30/2021,63021,82L-IMPORT PAYROLL,,HJ,,285.42,-1175.04
2300,6/30/2021,6/30/2021,63021,82L-IMPORT PAYROLL,,HJ,,579.58,-1754.62
2300,6/30/2021,6/30/2021,63021,82L-IMPORT PAYROLL,,HJ,,716.67,-2471.29
2300,6/30/2021,6/30/2021,63021,82L-IMPORT PAYROLL,,HJ,,1003,-3474.29
2300,6/30/2021,6/30/2021,63021,82L-IMPORT PAYROLL,,HJ,,1877.49,-5351.78
2300,6/30/2021,6/30/2021,63021,82L-IMPORT PAYROLL,,HJ,,7937.39,-13289.17
2300, Totals for 2300 - 401k Withheld,,,,,,126655.02,139944.19,-13289.17
2400,2400 - FSA Withholding (Balance forward As of 07/01/2020) ,,,,,,,,-9394.43
2400,7/2/2020,7/2/2020,TASC,TASC withholding-TASC withholding,,HJ,787.98,,-8606.45
2400,7/15/2020,7/15/2020,71520,82L-PRPD-071520 -Import Payroll (GENERL)-Import Payroll,,HJ,,20.83,-8627.28
2400,7/15/2020,7/15/2020,71520,82L-PRPD-071520 -Import Payroll (GENERL)-Import Payroll,,HJ,,83.33,-8710.61
2400,7/15/2020,7/15/2020,71520,82L-PRPD-071520 -Import Payroll (GENERL)-Import Payroll,,HJ,,90,-8800.61
2400,7/15/2020,7/15/2020,71520,82L-PRPD-071520 -Import Payroll (GENERL)-Import Payroll,,HJ,,114.58,-8915.19
2400,7/15/2020,7/15/2020,71520,82L-PRPD-071520 -Import Payroll (GENERL)-Import Payroll,,HJ,,143.75,-9058.94
2400,7/15/2020,7/15/2020,71520,82L-PRPD-071520 -Import Payroll (GENERL)-Import Payroll,,HJ,,322.08,-9381.02
2400,7/15/2020,7/15/2020,71520,To reverse 82L payroll 0715 JE-21-0008-Reverse payroll entry 07152020 IMPORT PAYROLL,,HJ,20.83,,-9360.19
2400,7/15/2020,7/15/2020,71520,To reverse 82L payroll 0715 JE-21-0008-Reverse payroll entry 07152020 IMPORT PAYROLL,,HJ,83.33,,-9276.86
2400,7/15/2020,7/15/2020,71520,To reverse 82L payroll 0715 JE-21-0008-Reverse payroll entry 07152020 IMPORT PAYROLL,,HJ,90,,-9186.86
2400,7/15/2020,7/15/2020,71520,To reverse 82L payroll 0715 JE-21-0008-Reverse payroll entry 07152020 IMPORT PAYROLL,,HJ,114.58,,-9072.28
2400,7/15/2020,7/15/2020,71520,To reverse 82L payroll 0715 JE-21-0008-Reverse payroll entry 07152020 IMPORT PAYROLL,,HJ,143.75,,-8928.53
2400,7/15/2020,7/15/2020,71520,To reverse 82L payroll 0715 JE-21-0008-Reverse payroll entry 07152020 IMPORT PAYROLL,,HJ,322.08,,-8606.45
2400,7/15/2020,7/15/2020,71520,82L-IMPORT PAYROLL-Import Payroll,,HJ,,20.83,-8627.28
2400,7/15/2020,7/15/2020,71520,82L-IMPORT PAYROLL-Import Payroll,,HJ,,80.12,-8707.4
2400,7/15/2020,7/15/2020,71520,82L-IMPORT PAYROLL-Import Payroll,,HJ,,83.33,-8790.73
2400,7/15/2020,7/15/2020,71520,82L-IMPORT PAYROLL-Import Payroll,,HJ,,90,-8880.73
2400,7/15/2020,7/15/2020,71520,82L-IMPORT PAYROLL-Import Payroll,,HJ,,114.58,-8995.31
2400,7/15/2020,7/15/2020,71520,82L-IMPORT PAYROLL-Import Payroll,,HJ,,322.08,-9317.39
2400,7/17/2020,7/17/2020,TASC,TASC Withdraw-TASC Withdraw,,HJ,887.88,,-8429.51
2400,7/31/2020,7/31/2020,73120,82L-PRPD-073120 -Import Payroll-Import Payroll,,HJ,,21.83,-8451.34
2400,7/31/2020,7/31/2020,73120,82L-PRPD-073120 -Import Payroll-Import Payroll,,HJ,,90,-8541.34
2400,7/31/2020,7/31/2020,73120,82L-PRPD-073120 -Import Payroll-Import Payroll,,HJ,,114.58,-8655.92
2400,7/31/2020,7/31/2020,73120,82L-PRPD-073120 -Import Payroll-Import Payroll,,HJ,,158.33,-8814.25
2400,7/31/2020,7/31/2020,73120,82L-PRPD-073120 -Import Payroll-Import Payroll,,HJ,,258.33,-9072.58
2400,7/31/2020,7/31/2020,73120,82L-PRPD-073120 -Import Payroll-Import Payroll,,HJ,,322.08,-9394.66
2400,7/31/2020,7/31/2020,73120,To reverse 82L payroll 73120-To reverse 82L payroll of 73120 JE-21-0003,,HJ,21.83,,-9372.83
2400,7/31/2020,7/31/2020,73120,To reverse 82L payroll 73120-To reverse 82L payroll of 73120 JE-21-0003,,HJ,90,,-9282.83
2400,7/31/2020,7/31/2020,73120,To reverse 82L payroll 73120-To reverse 82L payroll of 73120 JE-21-0003,,HJ,114.58,,-9168.25
2400,7/31/2020,7/31/2020,73120,To reverse 82L payroll 73120-To reverse 82L payroll of 73120 JE-21-0003,,HJ,158.33,,-9009.92
2400,7/31/2020,7/31/2020,73120,To reverse 82L payroll 73120-To reverse 82L payroll of 73120 JE-21-0003,,HJ,258.33,,-8751.59
2400,7/31/2020,7/31/2020,73120,To reverse 82L payroll 73120-To reverse 82L payroll of 73120 JE-21-0003,,HJ,322.08,,-8429.51
2400,7/31/2020,7/31/2020,73120,82L-IMPORT PAYROLL-Import Payroll,,HJ,,21.83,-8451.34
2400,7/31/2020,7/31/2020,73120,82L-IMPORT PAYROLL-Import Payroll,,HJ,,90,-8541.34
2400,7/31/2020,7/31/2020,73120,82L-IMPORT PAYROLL-Import Payroll,,HJ,,158.33,-8699.67
2400,7/31/2020,7/31/2020,73120,82L-IMPORT PAYROLL-Import Payroll,,HJ,,252.89,-8952.56
2400,7/31/2020,7/31/2020,73120,82L-IMPORT PAYROLL-Import Payroll,,HJ,,258.33,-9210.89
2400,7/31/2020,7/31/2020,73120,82L-IMPORT PAYROLL-Import Payroll,,HJ,,322.08,-9532.97
2400,8/14/2020,8/14/2020,81420,82L-IMPORT PAYROLL-Import Payroll,,HJ,,21.83,-9554.8
2400,8/14/2020,8/14/2020,81420,82L-IMPORT PAYROLL-Import Payroll,,HJ,,90,-9644.8
2400,8/14/2020,8/14/2020,81420,82L-IMPORT PAYROLL-Import Payroll,,HJ,,158.33,-9803.13
2400,8/14/2020,8/14/2020,81420,82L-IMPORT PAYROLL-Import Payroll,,HJ,,322.08,-10125.21
2400,8/14/2020,8/14/2020,81420,82L-IMPORT PAYROLL-Import Payroll,,HJ,,427.46,-10552.67
2400,8/14/2020,8/14/2020,82L-PRPD-081520,82L-PRPD-081520 -IMPORT PAYROLL-Import Payroll,,HJ,,21.83,-10574.5
2400,8/14/2020,8/14/2020,82L-PRPD-081520,82L-PRPD-081520 -IMPORT PAYROLL-Import Payroll,,HJ,,90,-10664.5
2400,8/14/2020,8/14/2020,82L-PRPD-081520,82L-PRPD-081520 -IMPORT PAYROLL-Import Payroll,,HJ,,114.58,-10779.08
2400,8/14/2020,8/14/2020,82L-PRPD-081520,82L-PRPD-081520 -IMPORT PAYROLL-Import Payroll,,HJ,,158.33,-10937.41
2400,8/14/2020,8/14/2020,82L-PRPD-081520,82L-PRPD-081520 -IMPORT PAYROLL-Import Payroll,,HJ,,312.88,-11250.29
2400,8/14/2020,8/14/2020,82L-PRPD-081520,82L-PRPD-081520 -IMPORT PAYROLL-Import Payroll,,HJ,,322.08,-11572.37
2400,8/15/2020,8/15/2020,82L-PRPD-081520,To reverse 82L payroll 0815 JE-21-0020-To reverse 82L Payroll of 8152020,,HJ,21.83,,-11550.54
2400,8/15/2020,8/15/2020,82L-PRPD-081520,To reverse 82L payroll 0815 JE-21-0020-To reverse 82L Payroll of 8152020,,HJ,90,,-11460.54
2400,8/15/2020,8/15/2020,82L-PRPD-081520,To reverse 82L payroll 0815 JE-21-0020-To reverse 82L Payroll of 8152020,,HJ,114.58,,-11345.96
2400,8/15/2020,8/15/2020,82L-PRPD-081520,To reverse 82L payroll 0815 JE-21-0020-To reverse 82L Payroll of 8152020,,HJ,158.33,,-11187.63
2400,8/15/2020,8/15/2020,82L-PRPD-081520,To reverse 82L payroll 0815 JE-21-0020-To reverse 82L Payroll of 8152020,,HJ,312.88,,-10874.75
2400,8/15/2020,8/15/2020,82L-PRPD-081520,To reverse 82L payroll 0815 JE-21-0020-To reverse 82L Payroll of 8152020,,HJ,322.08,,-10552.67
2400,8/15/2020,8/15/2020,TASC,To record August FSA-TASC withholding-To record August FSA-TASC withholding,,HJ,2249.81,,-8302.86
2400,8/31/2020,8/31/2020,83120,82L-IMPORT PAYROLL-Import Payroll,,HJ,,21.83,-8324.69
2400,8/31/2020,8/31/2020,83120,82L-IMPORT PAYROLL-Import Payroll,,HJ,,90,-8414.69
2400,8/31/2020,8/31/2020,83120,82L-IMPORT PAYROLL-Import Payroll,,HJ,,114.58,-8529.27
2400,8/31/2020,8/31/2020,83120,82L-IMPORT PAYROLL-Import Payroll,,HJ,,158.33,-8687.6
2400,8/31/2020,8/31/2020,83120,82L-IMPORT PAYROLL-Import Payroll,,HJ,,374.28,-9061.88
2400,8/31/2020,8/31/2020,83120,82L-IMPORT PAYROLL-Import Payroll,,HJ,,644.44,-9706.32
2400,8/31/2020,8/31/2020,82L-PRPD-083120,82L-PRPD-083120 -IMPORT PAYROLL-Import Payroll,,HJ,,21.83,-9728.15
2400,8/31/2020,8/31/2020,82L-PRPD-083120,82L-PRPD-083120 -IMPORT PAYROLL-Import Payroll,,HJ,,90,-9818.15
2400,8/31/2020,8/31/2020,82L-PRPD-083120,82L-PRPD-083120 -IMPORT PAYROLL-Import Payroll,,HJ,,114.58,-9932.73
2400,8/31/2020,8/31/2020,82L-PRPD-083120,82L-PRPD-083120 -IMPORT PAYROLL-Import Payroll,,HJ,,158.33,-10091.06
2400,8/31/2020,8/31/2020,82L-PRPD-083120,82L-PRPD-083120 -IMPORT PAYROLL-Import Payroll,,HJ,,312.88,-10403.94
2400,8/31/2020,8/31/2020,82L-PRPD-083120,82L-PRPD-083120 -IMPORT PAYROLL-Import Payroll,,HJ,,322.08,-10726.02
2400,8/31/2020,8/31/2020,82L-PRPD-083120,Reverse 82L payroll of 83120 JE-21-0021-IMPORT PAYROLL,,HJ,21.83,,-10704.19
2400,8/31/2020,8/31/2020,82L-PRPD-083120,Reverse 82L payroll of 83120 JE-21-0021-IMPORT PAYROLL,,HJ,90,,-10614.19
2400,8/31/2020,8/31/2020,82L-PRPD-083120,Reverse 82L payroll of 83120 JE-21-0021-IMPORT PAYROLL,,HJ,114.58,,-10499.61
2400,8/31/2020,8/31/2020,82L-PRPD-083120,Reverse 82L payroll of 83120 JE-21-0021-IMPORT PAYROLL,,HJ,158.33,,-10341.28
2400,8/31/2020,8/31/2020,82L-PRPD-083120,Reverse 82L payroll of 83120 JE-21-0021-IMPORT PAYROLL,,HJ,312.88,,-10028.4
2400,8/31/2020,8/31/2020,82L-PRPD-083120,Reverse 82L payroll of 83120 JE-21-0021-IMPORT PAYROLL,,HJ,322.08,,-9706.32
2400,8/31/2020,8/31/2020,LUX-PRPD-083120,LUX-PRPD-083120 -Payroll-FSA Withholding -CHI,,HJ,,146.9,-9853.22
2400,9/1/2020,9/1/2020,TASC,Employee TASC withdrawn-Employee TASC withdrawn,,HJ,1360.41,,-8492.81
2400,9/15/2020,9/15/2020,91520,82L-IMPORT PAYROLL-Import Payroll,,HJ,,90,-8582.81
2400,9/15/2020,9/15/2020,91520,82L-IMPORT PAYROLL-Import Payroll,,HJ,,114.58,-8697.39
2400,9/15/2020,9/15/2020,91520,82L-IMPORT PAYROLL-Import Payroll,,HJ,,145.41,-8842.8
2400,9/15/2020,9/15/2020,91520,82L-IMPORT PAYROLL-Import Payroll,,HJ,,158.33,-9001.13
2400,9/15/2020,9/15/2020,91520,82L-IMPORT PAYROLL-Import Payroll,,HJ,,302.2,-9303.33
2400,9/15/2020,9/15/2020,91520,82L-IMPORT PAYROLL-Import Payroll,,HJ,,322.08,-9625.41
2400,9/15/2020,9/15/2020,LUX-PRPD-091520,LUX-PRPD-091520-LUX-PRPD-091520 -Payroll,,HJ,,146.9,-9772.31
2400,9/16/2020,9/16/2020,TASC,Employee TASC withdrawn 9-15-Employee TASC withdrawn 9-15,,HJ,1635.75,,-8136.56
2400,9/30/2020,9/30/2020,93020,82L-IMPORT PAYROLL-Import Payroll,,HJ,,90,-8226.56
2400,9/30/2020,9/30/2020,93020,82L-IMPORT PAYROLL-Import Payroll,,HJ,,114.58,-8341.14
2400,9/30/2020,9/30/2020,93020,82L-IMPORT PAYROLL-Import Payroll,,HJ,,145.41,-8486.55
2400,9/30/2020,9/30/2020,93020,82L-IMPORT PAYROLL-Import Payroll,,HJ,,158.33,-8644.88
2400,9/30/2020,9/30/2020,93020,82L-IMPORT PAYROLL-Import Payroll,,HJ,,322.08,-8966.96
2400,9/30/2020,9/30/2020,93020,82L-IMPORT PAYROLL-Import Payroll,,HJ,,373.63,-9340.59
2400,9/30/2020,9/30/2020,LUX-PRPD-093020,LUX-PRPD-093020-Payroll,,HJ,,147.85,-9488.44
2400,10/2/2020,10/2/2020,TASC,Employee TASC payment-Employee TASC payment,,HJ,377.66,,-9110.78
2400,10/15/2020,10/15/2020,101520,82L-IMPORT PAYROLL-Import Payroll,,HJ,,75,-9185.78
2400,10/15/2020,10/15/2020,101520,82L-IMPORT PAYROLL-Import Payroll,,HJ,,124.58,-9310.36
2400,10/15/2020,10/15/2020,101520,82L-IMPORT PAYROLL-Import Payroll,,HJ,,149.31,-9459.67
2400,10/15/2020,10/15/2020,101520,82L-IMPORT PAYROLL-Import Payroll,,HJ,,186.01,-9645.68
2400,10/15/2020,10/15/2020,101520,82L-IMPORT PAYROLL-Import Payroll,,HJ,,208.33,-9854.01
2400,10/15/2020,10/15/2020,101520,82L-IMPORT PAYROLL-Import Payroll,,HJ,,224.7,-10078.71
2400,10/15/2020,10/15/2020,JE-21-0061,LUX-PRPD-101520-LUX-PRPD-101520,,HJ,,147.85,-10226.56
2400,10/16/2020,10/16/2020,TAG Resources LLC,TASC payment for October-TASC payment for October,,HJ,3186.97,,-7039.59
2400,10/30/2020,10/30/2020,103120,82L-IMPORT PAYROLL-Import Payroll,,HJ,,75,-7114.59
2400,10/30/2020,10/30/2020,103120,82L-IMPORT PAYROLL-Import Payroll,,HJ,,114.58,-7229.17
2400,10/30/2020,10/30/2020,103120,82L-IMPORT PAYROLL-Import Payroll,,HJ,,124.58,-7353.75
2400,10/30/2020,10/30/2020,103120,82L-IMPORT PAYROLL-Import Payroll,,HJ,,208.33,-7562.08
2400,10/30/2020,10/30/2020,103120,82L-IMPORT PAYROLL-Import Payroll,,HJ,,352.08,-7914.16
2400,10/30/2020,10/30/2020,103120,82L-IMPORT PAYROLL-Import Payroll,,HJ,,3404.25,-11318.41
2400,10/31/2020,10/31/2020,JE-21-0062,LUX-PRPD-103120-LUX-PRPD-103120,,HJ,,147.85,-11466.26
2400,11/12/2020,11/12/2020,JE-21-0089,LUX-PRPD-111520-LUX-PRPD-101520,,HJ,,144.8,-11611.06
2400,11/13/2020,11/13/2020,111320,82L-IMPORT PAYROLL-111.60 Adjusted to rec with bank,,HJ,,226.18,-11837.24
2400,11/13/2020,11/13/2020,111320,82L-IMPORT PAYROLL-652.01 Adjusted to rec with bank,,HJ,,1304.02,-13141.26
2400,11/13/2020,11/13/2020,111320,82L-IMPORT PAYROLL-Import Payroll,,HJ,,75,-13216.26
2400,11/13/2020,11/13/2020,111320,82L-IMPORT PAYROLL-Import Payroll,,HJ,,124.58,-13340.84
2400,11/13/2020,11/13/2020,111320,82L-IMPORT PAYROLL-Import Payroll,,HJ,,171.88,-13512.72
2400,11/13/2020,11/13/2020,111320,82L-IMPORT PAYROLL-Import Payroll,,HJ,,208.33,-13721.05
2400,11/13/2020,11/13/2020,111320,82L-IMPORT PAYROLL-Import Payroll,,HJ,,352.08,-14073.13
2400,11/16/2020,11/16/2020,TASC,TASC payment for staff PD 10/30 & PD11/13-TASC payment for staff PD 10/30 & PD11/13,,HJ,4103.73,,-9969.4
2400,11/27/2020,11/27/2020,JE-21-0091,LUX-PRPD-113020-LUX-PRPD-113020,,HJ,,144.8,-10114.2
2400,11/30/2020,11/30/2020,113020,82L-IMPORT PAYROLL-715.35 Adjusted to rec with bank,,HJ,,1518.7,-11632.9
2400,11/30/2020,11/30/2020,113020,82L-IMPORT PAYROLL-Import Payroll,,HJ,,75,-11707.9
2400,11/30/2020,11/30/2020,113020,82L-IMPORT PAYROLL-Import Payroll,,HJ,,114.58,-11822.48
2400,11/30/2020,11/30/2020,113020,82L-IMPORT PAYROLL-Import Payroll,,HJ,,124.58,-11947.06
2400,11/30/2020,11/30/2020,113020,82L-IMPORT PAYROLL-Import Payroll,,HJ,,171.88,-12118.94
2400,11/30/2020,11/30/2020,113020,82L-IMPORT PAYROLL-Import Payroll,,HJ,,208.33,-12327.27
2400,11/30/2020,11/30/2020,113020,82L-IMPORT PAYROLL-Import Payroll,,HJ,,352.08,-12679.35
2400,12/1/2020,12/1/2020,TASC,Payment for TASC for PD 11/30/2020-Payment for TASC for PD 11/30/2020,,HJ,1670.45,,-11008.9
2400,12/15/2020,12/15/2020,121520,82L-IMPORT PAYROLL-ACEVEDO MONIVETT,,HJ,,114.58,-11123.48
2400,12/15/2020,12/15/2020,121520,82L-IMPORT PAYROLL-BASHAM WILLIAM EDWARD,,HJ,,11.36,-11134.84
2400,12/15/2020,12/15/2020,121520,82L-IMPORT PAYROLL-BELLOT GENESIS,,HJ,,114.58,-11249.42
2400,12/15/2020,12/15/2020,121520,82L-IMPORT PAYROLL-BIBB TIFFANI,,HJ,,30,-11279.42
2400,12/15/2020,12/15/2020,121520,82L-IMPORT PAYROLL-CAIN CORY,,HJ,,50,-11329.42
2400,12/15/2020,12/15/2020,121520,82L-IMPORT PAYROLL-CORTEZ MIRANDA A,,HJ,,20.83,-11350.25
2400,12/15/2020,12/15/2020,121520,82L-IMPORT PAYROLL-COVENEY ALLISON,,HJ,,75,-11425.25
2400,12/15/2020,12/15/2020,121520,82L-IMPORT PAYROLL-DADA ARIKPO E,,HJ,,79.17,-11504.42
2400,12/15/2020,12/15/2020,121520,82L-IMPORT PAYROLL-DETONE KYRA MAYA,,HJ,,83.33,-11587.75
2400,12/15/2020,12/15/2020,121520,82L-IMPORT PAYROLL-FISCHABER THOMAS,,HJ,,44.12,-11631.87
2400,12/15/2020,12/15/2020,121520,82L-IMPORT PAYROLL-HENRY GILLIAN,,HJ,,71.43,-11703.3
2400,12/15/2020,12/15/2020,121520,82L-IMPORT PAYROLL-HOLMES JOREL ALEXANDER,,HJ,,25,-11728.3
2400,12/15/2020,12/15/2020,121520,82L-IMPORT PAYROLL-HOLT ADAM,,HJ,,150,-11878.3
2400,12/15/2020,12/15/2020,121520,82L-IMPORT PAYROLL-JACKSON CLAICE M,,HJ,,15,-11893.3
2400,12/15/2020,12/15/2020,121520,82L-IMPORT PAYROLL-KOPSHEVER MELISSA,,HJ,,0.04,-11893.34
2400,12/15/2020,12/15/2020,121520,82L-IMPORT PAYROLL-LIPSCOMB STEPHEN,,HJ,,75,-11968.34
2400,12/15/2020,12/15/2020,121520,82L-IMPORT PAYROLL-MARKS KRISTA,,HJ,,161.76,-12130.1
2400,12/15/2020,12/15/2020,121520,82L-IMPORT PAYROLL-MILNE ROGER,,HJ,,161.76,-12291.86
2400,12/15/2020,12/15/2020,121520,82L-IMPORT PAYROLL-OPUH NDIDI,,HJ,,10,-12301.86
2400,12/15/2020,12/15/2020,121520,82L-IMPORT PAYROLL-PARHAM-GANTT DENISE M,,HJ,,114.58,-12416.44
2400,12/15/2020,12/15/2020,121520,82L-IMPORT PAYROLL-PRAHIN NICOLE M,,HJ,,20,-12436.44
2400,12/15/2020,12/15/2020,121520,82L-IMPORT PAYROLL-SAFRAN ALAN P,,HJ,,171.88,-12608.32
2400,12/15/2020,12/15/2020,121520,82L-IMPORT PAYROLL-STEIN KYLE,,HJ,,12.5,-12620.82
2400,12/15/2020,12/15/2020,121520,82L-IMPORT PAYROLL-TERRENCE-SMITH ZIHIR,,HJ,,50,-12670.82
2400,12/15/2020,12/15/2020,121520,82L-IMPORT PAYROLL-VILLEGAS EVELYN,,HJ,,83.33,-12754.15
2400,12/15/2020,12/15/2020,121520,82L-IMPORT PAYROLL-WALLACE AMENA,,HJ,,50,-12804.15
2400,12/15/2020,12/15/2020,121520,82L-IMPORT PAYROLL-WEINSTOCK EMILY,,HJ,,54.55,-12858.7
2400,12/15/2020,12/15/2020,JE-21-0112,LUX-PRPD-121520-LUX-PRPD-121520,,HJ,,144.8,-13003.5
2400,12/16/2020,12/16/2020,TASC,Payment for TASC for PD 12/15/20-Payment for TASC for PD 12/15/20,,HJ,2018.77,,-10984.73
2400,12/31/2020,12/31/2020,123120,82L-IMPORT PAYROLL-ACEVEDO MONIVETT,,HJ,,114.58,-11099.31
2400,12/31/2020,12/31/2020,123120,82L-IMPORT PAYROLL-BASHAM WILLIAM EDWARD,,HJ,,11.36,-11110.67
2400,12/31/2020,12/31/2020,123120,82L-IMPORT PAYROLL-BELLOT GENESIS,,HJ,,114.58,-11225.25
2400,12/31/2020,12/31/2020,123120,82L-IMPORT PAYROLL-BIBB TIFFANI,,HJ,,30,-11255.25
2400,12/31/2020,12/31/2020,123120,82L-IMPORT PAYROLL-CAIN CORY,,HJ,,50,-11305.25
2400,12/31/2020,12/31/2020,123120,82L-IMPORT PAYROLL-CORTEZ MIRANDA A,,HJ,,20.83,-11326.08
2400,12/31/2020,12/31/2020,123120,82L-IMPORT PAYROLL-COVENEY ALLISON,,HJ,,75,-11401.08
2400,12/31/2020,12/31/2020,123120,82L-IMPORT PAYROLL-DADA ARIKPO E,,HJ,,79.17,-11480.25
2400,12/31/2020,12/31/2020,123120,82L-IMPORT PAYROLL-DETONE KYRA MAYA,,HJ,,83.33,-11563.58
2400,12/31/2020,12/31/2020,123120,82L-IMPORT PAYROLL-FISCHABER THOMAS,,HJ,,44.12,-11607.7
2400,12/31/2020,12/31/2020,123120,82L-IMPORT PAYROLL-HENRY GILLIAN,,HJ,,71.43,-11679.13
2400,12/31/2020,12/31/2020,123120,82L-IMPORT PAYROLL-HOLMES JOREL ALEXANDER,,HJ,,25,-11704.13
2400,12/31/2020,12/31/2020,123120,82L-IMPORT PAYROLL-HOLT ADAM,,HJ,,150,-11854.13
2400,12/31/2020,12/31/2020,123120,82L-IMPORT PAYROLL-JACKSON CLAICE M,,HJ,,15,-11869.13
2400,12/31/2020,12/31/2020,123120,82L-IMPORT PAYROLL-KOPSHEVER MELISSA,,HJ,,0.04,-11869.17
2400,12/31/2020,12/31/2020,123120,82L-IMPORT PAYROLL-LIPSCOMB STEPHEN,,HJ,,75,-11944.17
2400,12/31/2020,12/31/2020,123120,82L-IMPORT PAYROLL-MARKS KRISTA,,HJ,,161.76,-12105.93
2400,12/31/2020,12/31/2020,123120,82L-IMPORT PAYROLL-MILNE ROGER,,HJ,,161.76,-12267.69
2400,12/31/2020,12/31/2020,123120,82L-IMPORT PAYROLL-OPUH NDIDI,,HJ,,10,-12277.69
2400,12/31/2020,12/31/2020,123120,82L-IMPORT PAYROLL-PARHAM-GANTT DENISE M,,HJ,,114.58,-12392.27
2400,12/31/2020,12/31/2020,123120,82L-IMPORT PAYROLL-PRAHIN NICOLE M,,HJ,,20,-12412.27
2400,12/31/2020,12/31/2020,123120,82L-IMPORT PAYROLL-SAFRAN ALAN P,,HJ,,171.88,-12584.15
2400,12/31/2020,12/31/2020,123120,82L-IMPORT PAYROLL-STEIN KYLE,,HJ,,12.5,-12596.65
2400,12/31/2020,12/31/2020,123120,82L-IMPORT PAYROLL-TERRENCE-SMITH ZIHIR,,HJ,,50,-12646.65
2400,12/31/2020,12/31/2020,123120,82L-IMPORT PAYROLL-VILLEGAS EVELYN,,HJ,,83.33,-12729.98
2400,12/31/2020,12/31/2020,123120,82L-IMPORT PAYROLL-WALLACE AMENA,,HJ,,50,-12779.98
2400,12/31/2020,12/31/2020,123120,82L-IMPORT PAYROLL-WEINSTOCK EMILY,,HJ,,54.55,-12834.53
2400,12/31/2020,12/31/2020,JE-21-0113,LUX-PRPD-123120-LUX-PRPD-123120,,HJ,,144.8,-12979.33
2400,1/4/2021,1/4/2021,TASC,Payment for TASC for PD 12/31/20-Payment for TASC for PD 12/31/20,,HJ,1664.95,,-11314.38
2400,1/15/2021,1/15/2021,11521,82L-IMPORT PAYROLL-ACEVEDO MONIVETT,,HJ,,114.58,-11428.96
2400,1/15/2021,1/15/2021,11521,82L-IMPORT PAYROLL-BELLOT GENESIS,,HJ,,114.58,-11543.54
2400,1/15/2021,1/15/2021,11521,82L-IMPORT PAYROLL-BIBB TIFFANI,,HJ,,30,-11573.54
2400,1/15/2021,1/15/2021,11521,82L-IMPORT PAYROLL-CAIN CORY,,HJ,,50,-11623.54
2400,1/15/2021,1/15/2021,11521,82L-IMPORT PAYROLL-CORTEZ MIRANDA A,,HJ,,20.83,-11644.37
2400,1/15/2021,1/15/2021,11521,82L-IMPORT PAYROLL-COVENEY ALLISON,,HJ,,75,-11719.37
2400,1/15/2021,1/15/2021,11521,82L-IMPORT PAYROLL-DADA ARIKPO E,,HJ,,79.17,-11798.54
2400,1/15/2021,1/15/2021,11521,82L-IMPORT PAYROLL-DETONE KYRA MAYA,,HJ,,83.33,-11881.87
2400,1/15/2021,1/15/2021,11521,82L-IMPORT PAYROLL-FEENEY CLAIRE,,HJ,,50,-11931.87
2400,1/15/2021,1/15/2021,11521,82L-IMPORT PAYROLL-FISCHABER THOMAS,,HJ,,44.12,-11975.99
2400,1/15/2021,1/15/2021,11521,82L-IMPORT PAYROLL-HENRY GILLIAN,,HJ,,71.43,-12047.42
2400,1/15/2021,1/15/2021,11521,82L-IMPORT PAYROLL-HOLMES JOREL ALEXANDER,,HJ,,25,-12072.42
2400,1/15/2021,1/15/2021,11521,82L-IMPORT PAYROLL-HOLT ADAM,,HJ,,150,-12222.42
2400,1/15/2021,1/15/2021,11521,82L-IMPORT PAYROLL-JACKSON CLAICE M,,HJ,,15,-12237.42
2400,1/15/2021,1/15/2021,11521,82L-IMPORT PAYROLL-KOPSHEVER MELISSA,,HJ,,0.04,-12237.46
2400,1/15/2021,1/15/2021,11521,82L-IMPORT PAYROLL-LIPSCOMB STEPHEN,,HJ,,75,-12312.46
2400,1/15/2021,1/15/2021,11521,82L-IMPORT PAYROLL-MARKS KRISTA,,HJ,,161.76,-12474.22
2400,1/15/2021,1/15/2021,11521,82L-IMPORT PAYROLL-MILNE ROGER,,HJ,,161.76,-12635.98
2400,1/15/2021,1/15/2021,11521,82L-IMPORT PAYROLL-OPUH NDIDI,,HJ,,10,-12645.98
2400,1/15/2021,1/15/2021,11521,82L-IMPORT PAYROLL-PARHAM-GANTT DENISE M,,HJ,,114.58,-12760.56
2400,1/15/2021,1/15/2021,11521,82L-IMPORT PAYROLL-PRAHIN NICOLE M,,HJ,,20,-12780.56
2400,1/15/2021,1/15/2021,11521,82L-IMPORT PAYROLL-SAFRAN ALAN P,,HJ,,171.88,-12952.44
2400,1/15/2021,1/15/2021,11521,82L-IMPORT PAYROLL-STEIN KYLE,,HJ,,12.5,-12964.94
2400,1/15/2021,1/15/2021,11521,82L-IMPORT PAYROLL-TERRENCE-SMITH ZIHIR,,HJ,,50,-13014.94
2400,1/15/2021,1/15/2021,11521,82L-IMPORT PAYROLL-To Adjust with Bank,,HJ,,6607.62,-19622.56
2400,1/15/2021,1/15/2021,11521,82L-IMPORT PAYROLL-VILLEGAS EVELYN,,HJ,,83.33,-19705.89
2400,1/15/2021,1/15/2021,11521,82L-IMPORT PAYROLL-WALLACE AMENA,,HJ,,50,-19755.89
2400,1/15/2021,1/15/2021,11521,82L-IMPORT PAYROLL-WEINSTOCK EMILY,,HJ,,54.55,-19810.44
2400,1/15/2021,1/15/2021,JE-21-0145,LUX PayrollLUX-PRPPD-01152021-LUX-PRPD-01152021,,HJ,,144.8,-19955.24
2400,1/19/2021,1/19/2021,TASC,Payment for TASC for PD 1/15/21-Payment for TASC for PD 1/15/21,,HJ,2018.77,,-17936.47
2400,1/29/2021,1/29/2021,12921,82L-IMPORT PAYROLL-ACEVEDO MONIVETT,,HJ,,114.58,-18051.05
2400,1/29/2021,1/29/2021,12921,82L-IMPORT PAYROLL-BELLOT GENESIS,,HJ,,114.58,-18165.63
2400,1/29/2021,1/29/2021,12921,82L-IMPORT PAYROLL-BIBB TIFFANI,,HJ,,30,-18195.63
2400,1/29/2021,1/29/2021,12921,82L-IMPORT PAYROLL-CAIN CORY,,HJ,,50,-18245.63
2400,1/29/2021,1/29/2021,12921,82L-IMPORT PAYROLL-CORTEZ MIRANDA A,,HJ,,20.83,-18266.46
2400,1/29/2021,1/29/2021,12921,82L-IMPORT PAYROLL-COVENEY ALLISON,,HJ,,75,-18341.46
2400,1/29/2021,1/29/2021,12921,82L-IMPORT PAYROLL-DADA ARIKPO E,,HJ,,79.17,-18420.63
2400,1/29/2021,1/29/2021,12921,82L-IMPORT PAYROLL-DETONE KYRA MAYA,,HJ,,83.33,-18503.96
2400,1/29/2021,1/29/2021,12921,82L-IMPORT PAYROLL-FEENEY CLAIRE,,HJ,,50,-18553.96
2400,1/29/2021,1/29/2021,12921,82L-IMPORT PAYROLL-FISCHABER THOMAS,,HJ,,44.12,-18598.08
2400,1/29/2021,1/29/2021,12921,82L-IMPORT PAYROLL-HENRY GILLIAN,,HJ,,71.43,-18669.51
2400,1/29/2021,1/29/2021,12921,82L-IMPORT PAYROLL-HOLMES JOREL ALEXANDER,,HJ,,25,-18694.51
2400,1/29/2021,1/29/2021,12921,82L-IMPORT PAYROLL-HOLT ADAM,,HJ,,150,-18844.51
2400,1/29/2021,1/29/2021,12921,82L-IMPORT PAYROLL-JACKSON CLAICE M,,HJ,,15,-18859.51
2400,1/29/2021,1/29/2021,12921,82L-IMPORT PAYROLL-KOPSHEVER MELISSA,,HJ,,0.04,-18859.55
2400,1/29/2021,1/29/2021,12921,82L-IMPORT PAYROLL-LIPSCOMB STEPHEN,,HJ,,75,-18934.55
2400,1/29/2021,1/29/2021,12921,82L-IMPORT PAYROLL-MARKS KRISTA,,HJ,,161.76,-19096.31
2400,1/29/2021,1/29/2021,12921,82L-IMPORT PAYROLL-MILNE ROGER,,HJ,,161.76,-19258.07
2400,1/29/2021,1/29/2021,12921,82L-IMPORT PAYROLL-OPUH NDIDI,,HJ,,10,-19268.07
2400,1/29/2021,1/29/2021,12921,82L-IMPORT PAYROLL-PARHAM-GANTT DENISE M,,HJ,,114.58,-19382.65
2400,1/29/2021,1/29/2021,12921,82L-IMPORT PAYROLL-PIRES MANUEL,,HJ,,65,-19447.65
2400,1/29/2021,1/29/2021,12921,82L-IMPORT PAYROLL-PRAHIN NICOLE M,,HJ,,20,-19467.65
2400,1/29/2021,1/29/2021,12921,82L-IMPORT PAYROLL-SAFRAN ALAN P,,HJ,,171.88,-19639.53
2400,1/29/2021,1/29/2021,12921,82L-IMPORT PAYROLL-STEIN KYLE,,HJ,,12.5,-19652.03
2400,1/29/2021,1/29/2021,12921,82L-IMPORT PAYROLL-TERRENCE-SMITH ZIHIR,,HJ,,50,-19702.03
2400,1/29/2021,1/29/2021,12921,82L-IMPORT PAYROLL-To Adjust with Bank,,HJ,,3940.75,-23642.78
2400,1/29/2021,1/29/2021,12921,82L-IMPORT PAYROLL-VILLEGAS EVELYN,,HJ,,83.33,-23726.11
2400,1/29/2021,1/29/2021,12921,82L-IMPORT PAYROLL-WALLACE AMENA,,HJ,,50,-23776.11
2400,1/29/2021,1/29/2021,12921,82L-IMPORT PAYROLL-WEINSTOCK EMILY,,HJ,,54.55,-23830.66
2400,1/31/2021,1/31/2021,JE-21-0151,LUX PRPD- 013121-LUX-PRPD-013121,,HJ,,144.8,-23975.46
2400,2/1/2021,2/1/2021,TASC,Payment for TASC for PD 1/29/21-Payment for TASC for PD 1/29/21,,HJ,1596.59,,-22378.87
2400,2/12/2021,2/12/2021,21221,82L-IMPORT PAYROLL-ACEVEDO MONIVETT,,HJ,,114.58,-22493.45
2400,2/12/2021,2/12/2021,21221,82L-IMPORT PAYROLL-BELLOT GENESIS,,HJ,,114.58,-22608.03
2400,2/12/2021,2/12/2021,21221,82L-IMPORT PAYROLL-BIBB TIFFANI,,HJ,,30,-22638.03
2400,2/12/2021,2/12/2021,21221,82L-IMPORT PAYROLL-CAIN CORY,,HJ,,50,-22688.03
2400,2/12/2021,2/12/2021,21221,82L-IMPORT PAYROLL-CORTEZ MIRANDA A,,HJ,,20.83,-22708.86
2400,2/12/2021,2/12/2021,21221,82L-IMPORT PAYROLL-COVENEY ALLISON,,HJ,,75,-22783.86
2400,2/12/2021,2/12/2021,21221,82L-IMPORT PAYROLL-DADA ARIKPO E,,HJ,,79.17,-22863.03
2400,2/12/2021,2/12/2021,21221,82L-IMPORT PAYROLL-DETONE KYRA MAYA,,HJ,,83.33,-22946.36
2400,2/12/2021,2/12/2021,21221,82L-IMPORT PAYROLL-FEENEY CLAIRE,,HJ,,50,-22996.36
2400,2/12/2021,2/12/2021,21221,82L-IMPORT PAYROLL-FISCHABER THOMAS,,HJ,,44.12,-23040.48
2400,2/12/2021,2/12/2021,21221,82L-IMPORT PAYROLL-HENRY GILLIAN,,HJ,,71.43,-23111.91
2400,2/12/2021,2/12/2021,21221,82L-IMPORT PAYROLL-HOLMES JOREL ALEXANDER,,HJ,,25,-23136.91
2400,2/12/2021,2/12/2021,21221,82L-IMPORT PAYROLL-HOLT ADAM,,HJ,,150,-23286.91
2400,2/12/2021,2/12/2021,21221,82L-IMPORT PAYROLL-IWASAKI MIKA,,HJ,,20,-23306.91
2400,2/12/2021,2/12/2021,21221,82L-IMPORT PAYROLL-JACKSON CLAICE M,,HJ,,15,-23321.91
2400,2/12/2021,2/12/2021,21221,82L-IMPORT PAYROLL-LIPSCOMB STEPHEN,,HJ,,75,-23396.91
2400,2/12/2021,2/12/2021,21221,82L-IMPORT PAYROLL-MARKS KRISTA,,HJ,,161.76,-23558.67
2400,2/12/2021,2/12/2021,21221,82L-IMPORT PAYROLL-MILNE ROGER,,HJ,,161.76,-23720.43
2400,2/12/2021,2/12/2021,21221,82L-IMPORT PAYROLL-OPUH NDIDI,,HJ,,10,-23730.43
2400,2/12/2021,2/12/2021,21221,82L-IMPORT PAYROLL-PARHAM-GANTT DENISE M,,HJ,,114.58,-23845.01
2400,2/12/2021,2/12/2021,21221,82L-IMPORT PAYROLL-PIRES MANUEL,,HJ,,65,-23910.01
2400,2/12/2021,2/12/2021,21221,82L-IMPORT PAYROLL-PRAHIN NICOLE M,,HJ,,20,-23930.01
2400,2/12/2021,2/12/2021,21221,82L-IMPORT PAYROLL-SAFRAN ALAN P,,HJ,,171.88,-24101.89
2400,2/12/2021,2/12/2021,21221,82L-IMPORT PAYROLL-STEIN KYLE,,HJ,,12.5,-24114.39
2400,2/12/2021,2/12/2021,21221,82L-IMPORT PAYROLL-TERRENCE-SMITH ZIHIR,,HJ,,50,-24164.39
2400,2/12/2021,2/12/2021,21221,82L-IMPORT PAYROLL-To Adjust Liab.,,HJ,,4470.19,-28634.58
2400,2/12/2021,2/12/2021,21221,82L-IMPORT PAYROLL-VILLEGAS EVELYN,,HJ,,83.33,-28717.91
2400,2/12/2021,2/12/2021,21221,82L-IMPORT PAYROLL-VYAS SUNAINA,,HJ,,20.83,-28738.74
2400,2/12/2021,2/12/2021,21221,82L-IMPORT PAYROLL-WALLACE AMENA,,HJ,,50,-28788.74
2400,2/12/2021,2/12/2021,21221,82L-IMPORT PAYROLL-WEINSTOCK EMILY,,HJ,,54.55,-28843.29
2400,2/15/2021,2/15/2021,JE-21-0169,LUX PRPD- 021521-LUX-PRPD-02152021,,HJ,,144.8,-28988.09
2400,2/17/2021,2/17/2021,TASC,Payment for TASC for PD 2/15/21-Payment for TASC for PD 2/15/21,,HJ,1929.83,,-27058.26
2400,2/26/2021,2/26/2021,22621,82L-IMPORT PAYROLL-ACEVEDO MONIVETT,,HJ,,114.58,-27172.84
2400,2/26/2021,2/26/2021,22621,82L-IMPORT PAYROLL-BELLOT GENESIS,,HJ,,114.58,-27287.42
2400,2/26/2021,2/26/2021,22621,82L-IMPORT PAYROLL-BIBB TIFFANI,,HJ,,30,-27317.42
2400,2/26/2021,2/26/2021,22621,82L-IMPORT PAYROLL-CAIN CORY,,HJ,,50,-27367.42
2400,2/26/2021,2/26/2021,22621,82L-IMPORT PAYROLL-CORTEZ MIRANDA A,,HJ,,20.83,-27388.25
2400,2/26/2021,2/26/2021,22621,82L-IMPORT PAYROLL-COVENEY ALLISON,,HJ,,75,-27463.25
2400,2/26/2021,2/26/2021,22621,82L-IMPORT PAYROLL-DADA ARIKPO E,,HJ,,79.17,-27542.42
2400,2/26/2021,2/26/2021,22621,82L-IMPORT PAYROLL-DETONE KYRA MAYA,,HJ,,83.33,-27625.75
2400,2/26/2021,2/26/2021,22621,82L-IMPORT PAYROLL-FEENEY CLAIRE,,HJ,,50,-27675.75
2400,2/26/2021,2/26/2021,22621,82L-IMPORT PAYROLL-FISCHABER THOMAS,,HJ,,44.12,-27719.87
2400,2/26/2021,2/26/2021,22621,82L-IMPORT PAYROLL-HENRY GILLIAN,,HJ,,71.43,-27791.3
2400,2/26/2021,2/26/2021,22621,82L-IMPORT PAYROLL-HOLMES JOREL ALEXANDER,,HJ,,25,-27816.3
2400,2/26/2021,2/26/2021,22621,82L-IMPORT PAYROLL-HOLT ADAM,,HJ,,150,-27966.3
2400,2/26/2021,2/26/2021,22621,82L-IMPORT PAYROLL-IWASAKI MIKA,,HJ,,20,-27986.3
2400,2/26/2021,2/26/2021,22621,82L-IMPORT PAYROLL-JACKSON CLAICE M,,HJ,,15,-28001.3
2400,2/26/2021,2/26/2021,22621,82L-IMPORT PAYROLL-LIPSCOMB STEPHEN,,HJ,,75,-28076.3
2400,2/26/2021,2/26/2021,22621,82L-IMPORT PAYROLL-MARKS KRISTA,,HJ,,161.76,-28238.06
2400,2/26/2021,2/26/2021,22621,82L-IMPORT PAYROLL-MILNE ROGER,,HJ,,161.76,-28399.82
2400,2/26/2021,2/26/2021,22621,82L-IMPORT PAYROLL-OPUH NDIDI,,HJ,,10,-28409.82
2400,2/26/2021,2/26/2021,22621,82L-IMPORT PAYROLL-PARHAM-GANTT DENISE M,,HJ,,114.58,-28524.4
2400,2/26/2021,2/26/2021,22621,82L-IMPORT PAYROLL-PIRES MANUEL,,HJ,,65,-28589.4
2400,2/26/2021,2/26/2021,22621,82L-IMPORT PAYROLL-PRAHIN NICOLE M,,HJ,,20,-28609.4
2400,2/26/2021,2/26/2021,22621,82L-IMPORT PAYROLL-SAFRAN ALAN P,,HJ,,171.88,-28781.28
2400,2/26/2021,2/26/2021,22621,82L-IMPORT PAYROLL-STEIN KYLE,,HJ,,12.5,-28793.78
2400,2/26/2021,2/26/2021,22621,82L-IMPORT PAYROLL-TERRENCE-SMITH ZIHIR,,HJ,,50,-28843.78
2400,2/26/2021,2/26/2021,22621,82L-IMPORT PAYROLL-To adjust with ADP,,HJ,,1770.12,-30613.9
2400,2/26/2021,2/26/2021,22621,82L-IMPORT PAYROLL-VILLEGAS EVELYN,,HJ,,83.33,-30697.23
2400,2/26/2021,2/26/2021,22621,82L-IMPORT PAYROLL-VYAS SUNAINA,,HJ,,20.83,-30718.06
2400,2/26/2021,2/26/2021,22621,82L-IMPORT PAYROLL-WALLACE AMENA,,HJ,,50,-30768.06
2400,2/26/2021,2/26/2021,22621,82L-IMPORT PAYROLL-WEINSTOCK EMILY,,HJ,,54.55,-30822.61
2400,2/28/2021,2/28/2021,JE-21-0175,LUX PRPD -02282021-LUX-PRPD-022821,,HJ,,144.8,-30967.41
2400,3/9/2021,3/9/2021,20210126,Reimbursement for TASC 01.26.2021,,HJ,,3162.35,-34129.76
2400,3/9/2021,3/9/2021,TASC,Payment for TASC in March 2021,,HJ,22.5,,-34107.26
2400,3/9/2021,3/9/2021,TASC,Payment for TASC in March 2021,,HJ,3876.93,,-30230.33
2400,3/12/2021,3/12/2021,JE-21-0187,LUX Payroll -PRPD 031521,,HJ,,144.8,-30375.13
2400,3/15/2021,3/15/2021,31521,82L-IMPORT PAYROLL,,HJ,,10,-30385.13
2400,3/15/2021,3/15/2021,31521,82L-IMPORT PAYROLL,,HJ,,12.5,-30397.63
2400,3/15/2021,3/15/2021,31521,82L-IMPORT PAYROLL,,HJ,,15,-30412.63
2400,3/15/2021,3/15/2021,31521,82L-IMPORT PAYROLL,,HJ,,20,-30432.63
2400,3/15/2021,3/15/2021,31521,82L-IMPORT PAYROLL,,HJ,,20,-30452.63
2400,3/15/2021,3/15/2021,31521,82L-IMPORT PAYROLL,,HJ,,20.83,-30473.46
2400,3/15/2021,3/15/2021,31521,82L-IMPORT PAYROLL,,HJ,,20.83,-30494.29
2400,3/15/2021,3/15/2021,31521,82L-IMPORT PAYROLL,,HJ,,25,-30519.29
2400,3/15/2021,3/15/2021,31521,82L-IMPORT PAYROLL,,HJ,,30,-30549.29
2400,3/15/2021,3/15/2021,31521,82L-IMPORT PAYROLL,,HJ,,44.12,-30593.41
2400,3/15/2021,3/15/2021,31521,82L-IMPORT PAYROLL,,HJ,,50,-30643.41
2400,3/15/2021,3/15/2021,31521,82L-IMPORT PAYROLL,,HJ,,50,-30693.41
2400,3/15/2021,3/15/2021,31521,82L-IMPORT PAYROLL,,HJ,,50,-30743.41
2400,3/15/2021,3/15/2021,31521,82L-IMPORT PAYROLL,,HJ,,50,-30793.41
2400,3/15/2021,3/15/2021,31521,82L-IMPORT PAYROLL,,HJ,,50,-30843.41
2400,3/15/2021,3/15/2021,31521,82L-IMPORT PAYROLL,,HJ,,54.55,-30897.96
2400,3/15/2021,3/15/2021,31521,82L-IMPORT PAYROLL,,HJ,,65,-30962.96
2400,3/15/2021,3/15/2021,31521,82L-IMPORT PAYROLL,,HJ,,71.43,-31034.39
2400,3/15/2021,3/15/2021,31521,82L-IMPORT PAYROLL,,HJ,,75,-31109.39
2400,3/15/2021,3/15/2021,31521,82L-IMPORT PAYROLL,,HJ,,75,-31184.39
2400,3/15/2021,3/15/2021,31521,82L-IMPORT PAYROLL,,HJ,,79.17,-31263.56
2400,3/15/2021,3/15/2021,31521,82L-IMPORT PAYROLL,,HJ,,83.33,-31346.89
2400,3/15/2021,3/15/2021,31521,82L-IMPORT PAYROLL,,HJ,,83.33,-31430.22
2400,3/15/2021,3/15/2021,31521,82L-IMPORT PAYROLL,,HJ,,114.52,-31544.74
2400,3/15/2021,3/15/2021,31521,82L-IMPORT PAYROLL,,HJ,,114.58,-31659.32
2400,3/15/2021,3/15/2021,31521,82L-IMPORT PAYROLL,,HJ,,114.58,-31773.9
2400,3/15/2021,3/15/2021,31521,82L-IMPORT PAYROLL,,HJ,,150,-31923.9
2400,3/15/2021,3/15/2021,31521,82L-IMPORT PAYROLL,,HJ,,161.76,-32085.66
2400,3/15/2021,3/15/2021,31521,82L-IMPORT PAYROLL,,HJ,,161.76,-32247.42
2400,3/15/2021,3/15/2021,31521,82L-IMPORT PAYROLL,,HJ,,171.88,-32419.3
2400,3/15/2021,3/15/2021,31521,82L-IMPORT PAYROLL,,HJ,,2130.57,-34549.87
2400,3/16/2021,3/16/2021,TASC,Payment for TASC in March 2021,,HJ,2694.81,,-31855.06
2400,3/31/2021,3/31/2021,33121,82L-IMPORT PAYROLL,,HJ,,10,-31865.06
2400,3/31/2021,3/31/2021,33121,82L-IMPORT PAYROLL,,HJ,,12.5,-31877.56
2400,3/31/2021,3/31/2021,33121,82L-IMPORT PAYROLL,,HJ,,15,-31892.56
2400,3/31/2021,3/31/2021,33121,82L-IMPORT PAYROLL,,HJ,,20,-31912.56
2400,3/31/2021,3/31/2021,33121,82L-IMPORT PAYROLL,,HJ,,20,-31932.56
2400,3/31/2021,3/31/2021,33121,82L-IMPORT PAYROLL,,HJ,,20.83,-31953.39
2400,3/31/2021,3/31/2021,33121,82L-IMPORT PAYROLL,,HJ,,20.83,-31974.22
2400,3/31/2021,3/31/2021,33121,82L-IMPORT PAYROLL,,HJ,,25,-31999.22
2400,3/31/2021,3/31/2021,33121,82L-IMPORT PAYROLL,,HJ,,30,-32029.22
2400,3/31/2021,3/31/2021,33121,82L-IMPORT PAYROLL,,HJ,,41.35,-32070.57
2400,3/31/2021,3/31/2021,33121,82L-IMPORT PAYROLL,,HJ,,50,-32120.57
2400,3/31/2021,3/31/2021,33121,82L-IMPORT PAYROLL,,HJ,,50,-32170.57
2400,3/31/2021,3/31/2021,33121,82L-IMPORT PAYROLL,,HJ,,50,-32220.57
2400,3/31/2021,3/31/2021,33121,82L-IMPORT PAYROLL,,HJ,,50,-32270.57
2400,3/31/2021,3/31/2021,33121,82L-IMPORT PAYROLL,,HJ,,50,-32320.57
2400,3/31/2021,3/31/2021,33121,82L-IMPORT PAYROLL,,HJ,,54.55,-32375.12
2400,3/31/2021,3/31/2021,33121,82L-IMPORT PAYROLL,,HJ,,65,-32440.12
2400,3/31/2021,3/31/2021,33121,82L-IMPORT PAYROLL,,HJ,,71.43,-32511.55
2400,3/31/2021,3/31/2021,33121,82L-IMPORT PAYROLL,,HJ,,75,-32586.55
2400,3/31/2021,3/31/2021,33121,82L-IMPORT PAYROLL,,HJ,,75,-32661.55
2400,3/31/2021,3/31/2021,33121,82L-IMPORT PAYROLL,,HJ,,79.17,-32740.72
2400,3/31/2021,3/31/2021,33121,82L-IMPORT PAYROLL,,HJ,,83.33,-32824.05
2400,3/31/2021,3/31/2021,33121,82L-IMPORT PAYROLL,,HJ,,83.33,-32907.38
2400,3/31/2021,3/31/2021,33121,82L-IMPORT PAYROLL,,HJ,,114.58,-33021.96
2400,3/31/2021,3/31/2021,33121,82L-IMPORT PAYROLL,,HJ,,114.58,-33136.54
2400,3/31/2021,3/31/2021,33121,82L-IMPORT PAYROLL,,HJ,,114.58,-33251.12
2400,3/31/2021,3/31/2021,33121,82L-IMPORT PAYROLL,,HJ,,150,-33401.12
2400,3/31/2021,3/31/2021,33121,82L-IMPORT PAYROLL,,HJ,,161.76,-33562.88
2400,3/31/2021,3/31/2021,33121,82L-IMPORT PAYROLL,,HJ,,161.76,-33724.64
2400,3/31/2021,3/31/2021,33121,82L-IMPORT PAYROLL,,HJ,,171.88,-33896.52
2400,3/31/2021,3/31/2021,33121,82L-IMPORT PAYROLL,,HJ,,1384.3,-35280.82
2400,3/31/2021,3/31/2021,JE-21-0188,LUX Payroll- PRPD 03312021,,HJ,,144.8,-35425.62
2400,4/1/2021,4/1/2021,TASC,Payment for TASC for PD03.31.2021,,HJ,2157.23,,-33268.39
2400,4/15/2021,4/15/2021,41521,82L-IMPORT PAYROLL,,HJ,,10,-33278.39
2400,4/15/2021,4/15/2021,41521,82L-IMPORT PAYROLL,,HJ,,12.5,-33290.89
2400,4/15/2021,4/15/2021,41521,82L-IMPORT PAYROLL,,HJ,,15,-33305.89
2400,4/15/2021,4/15/2021,41521,82L-IMPORT PAYROLL,,HJ,,20,-33325.89
2400,4/15/2021,4/15/2021,41521,82L-IMPORT PAYROLL,,HJ,,20,-33345.89
2400,4/15/2021,4/15/2021,41521,82L-IMPORT PAYROLL,,HJ,,20.83,-33366.72
2400,4/15/2021,4/15/2021,41521,82L-IMPORT PAYROLL,,HJ,,20.83,-33387.55
2400,4/15/2021,4/15/2021,41521,82L-IMPORT PAYROLL,,HJ,,25,-33412.55
2400,4/15/2021,4/15/2021,41521,82L-IMPORT PAYROLL,,HJ,,30,-33442.55
2400,4/15/2021,4/15/2021,41521,82L-IMPORT PAYROLL,,HJ,,41.35,-33483.9
2400,4/15/2021,4/15/2021,41521,82L-IMPORT PAYROLL,,HJ,,50,-33533.9
2400,4/15/2021,4/15/2021,41521,82L-IMPORT PAYROLL,,HJ,,50,-33583.9
2400,4/15/2021,4/15/2021,41521,82L-IMPORT PAYROLL,,HJ,,50,-33633.9
2400,4/15/2021,4/15/2021,41521,82L-IMPORT PAYROLL,,HJ,,50,-33683.9
2400,4/15/2021,4/15/2021,41521,82L-IMPORT PAYROLL,,HJ,,50,-33733.9
2400,4/15/2021,4/15/2021,41521,82L-IMPORT PAYROLL,,HJ,,54.55,-33788.45
2400,4/15/2021,4/15/2021,41521,82L-IMPORT PAYROLL,,HJ,,65,-33853.45
2400,4/15/2021,4/15/2021,41521,82L-IMPORT PAYROLL,,HJ,,71.43,-33924.88
2400,4/15/2021,4/15/2021,41521,82L-IMPORT PAYROLL,,HJ,,75,-33999.88
2400,4/15/2021,4/15/2021,41521,82L-IMPORT PAYROLL,,HJ,,75,-34074.88
2400,4/15/2021,4/15/2021,41521,82L-IMPORT PAYROLL,,HJ,,79.17,-34154.05
2400,4/15/2021,4/15/2021,41521,82L-IMPORT PAYROLL,,HJ,,83.33,-34237.38
2400,4/15/2021,4/15/2021,41521,82L-IMPORT PAYROLL,,HJ,,83.33,-34320.71
2400,4/15/2021,4/15/2021,41521,82L-IMPORT PAYROLL,,HJ,,114.58,-34435.29
2400,4/15/2021,4/15/2021,41521,82L-IMPORT PAYROLL,,HJ,,114.58,-34549.87
2400,4/15/2021,4/15/2021,41521,82L-IMPORT PAYROLL,,HJ,,114.58,-34664.45
2400,4/15/2021,4/15/2021,41521,82L-IMPORT PAYROLL,,HJ,,150,-34814.45
2400,4/15/2021,4/15/2021,41521,82L-IMPORT PAYROLL,,HJ,,161.76,-34976.21
2400,4/15/2021,4/15/2021,41521,82L-IMPORT PAYROLL,,HJ,,161.76,-35137.97
2400,4/15/2021,4/15/2021,41521,82L-IMPORT PAYROLL,,HJ,,171.88,-35309.85
2400,4/15/2021,4/15/2021,41521,82L-IMPORT PAYROLL,,HJ,338.06,,-34971.79
2400,4/15/2021,4/15/2021,JE-21-0200,LUX PRPD -041521,,HJ,,144.8,-35116.59
2400,4/15/2021,4/15/2021,JE-21-0200,LUX PR 20210415 REV &CORR,,HJ,,144.8,-35261.39
2400,4/15/2021,4/15/2021,JE-21-0200,LUX PR 20210415 REV &CORR,,HJ,144.8,,-35116.59
2400,4/16/2021,4/16/2021,TASC,Payment for TASC for PD04.15.21,,HJ,2428.98,,-32687.61
2400,4/30/2021,4/30/2021,1,To adjust Liabilities booked with Payroll,,HJ,27147.51,,-5540.1
2400,4/30/2021,4/30/2021,43021,82L-IMPORT PAYROLL,,HJ,,10,-5550.1
2400,4/30/2021,4/30/2021,43021,82L-IMPORT PAYROLL,,HJ,,12.5,-5562.6
2400,4/30/2021,4/30/2021,43021,82L-IMPORT PAYROLL,,HJ,,15,-5577.6
2400,4/30/2021,4/30/2021,43021,82L-IMPORT PAYROLL,,HJ,,20,-5597.6
2400,4/30/2021,4/30/2021,43021,82L-IMPORT PAYROLL,,HJ,,20,-5617.6
2400,4/30/2021,4/30/2021,43021,82L-IMPORT PAYROLL,,HJ,,20.83,-5638.43
2400,4/30/2021,4/30/2021,43021,82L-IMPORT PAYROLL,,HJ,,20.83,-5659.26
2400,4/30/2021,4/30/2021,43021,82L-IMPORT PAYROLL,,HJ,,25,-5684.26
2400,4/30/2021,4/30/2021,43021,82L-IMPORT PAYROLL,,HJ,,30,-5714.26
2400,4/30/2021,4/30/2021,43021,82L-IMPORT PAYROLL,,HJ,,41.35,-5755.61
2400,4/30/2021,4/30/2021,43021,82L-IMPORT PAYROLL,,HJ,,50,-5805.61
2400,4/30/2021,4/30/2021,43021,82L-IMPORT PAYROLL,,HJ,,50,-5855.61
2400,4/30/2021,4/30/2021,43021,82L-IMPORT PAYROLL,,HJ,,50,-5905.61
2400,4/30/2021,4/30/2021,43021,82L-IMPORT PAYROLL,,HJ,,50,-5955.61
2400,4/30/2021,4/30/2021,43021,82L-IMPORT PAYROLL,,HJ,,54.55,-6010.16
2400,4/30/2021,4/30/2021,43021,82L-IMPORT PAYROLL,,HJ,,65,-6075.16
2400,4/30/2021,4/30/2021,43021,82L-IMPORT PAYROLL,,HJ,,71.43,-6146.59
2400,4/30/2021,4/30/2021,43021,82L-IMPORT PAYROLL,,HJ,,75,-6221.59
2400,4/30/2021,4/30/2021,43021,82L-IMPORT PAYROLL,,HJ,,75,-6296.59
2400,4/30/2021,4/30/2021,43021,82L-IMPORT PAYROLL,,HJ,,79.17,-6375.76
2400,4/30/2021,4/30/2021,43021,82L-IMPORT PAYROLL,,HJ,,83.33,-6459.09
2400,4/30/2021,4/30/2021,43021,82L-IMPORT PAYROLL,,HJ,,83.33,-6542.42
2400,4/30/2021,4/30/2021,43021,82L-IMPORT PAYROLL,,HJ,,114.58,-6657
2400,4/30/2021,4/30/2021,43021,82L-IMPORT PAYROLL,,HJ,,114.58,-6771.58
2400,4/30/2021,4/30/2021,43021,82L-IMPORT PAYROLL,,HJ,,114.58,-6886.16
2400,4/30/2021,4/30/2021,43021,82L-IMPORT PAYROLL,,HJ,,150,-7036.16
2400,4/30/2021,4/30/2021,43021,82L-IMPORT PAYROLL,,HJ,,161.76,-7197.92
2400,4/30/2021,4/30/2021,43021,82L-IMPORT PAYROLL,,HJ,,161.76,-7359.68
2400,4/30/2021,4/30/2021,43021,82L-IMPORT PAYROLL,,HJ,,171.88,-7531.56
2400,4/30/2021,4/30/2021,43021,82L-IMPORT PAYROLL,,HJ,296.94,,-7234.62
2400,4/30/2021,4/30/2021,JE-21-0204,LUX Payroll 4-30-2021,,HJ,,144.8,-7379.42
2400,4/30/2021,4/30/2021,JE-21-0204,PR LUX 20210430,,HJ,,144.8,-7524.22
2400,4/30/2021,4/30/2021,JE-21-0204,PR LUX 20210430,,HJ,144.8,,-7379.42
2400,5/3/2021,5/3/2021,TASC,TASC Payment for April,,HJ,2142.13,,-5237.29
2400,5/13/2021,5/13/2021,JE-21-0226,LUX Payroll- PRPD 05152021,,HJ,,144.8,-5382.09
2400,5/14/2021,5/14/2021,51421,82L-IMPORT PAYROLL,,HJ,,10,-5392.09
2400,5/14/2021,5/14/2021,51421,82L-IMPORT PAYROLL,,HJ,,12.5,-5404.59
2400,5/14/2021,5/14/2021,51421,82L-IMPORT PAYROLL,,HJ,,15,-5419.59
2400,5/14/2021,5/14/2021,51421,82L-IMPORT PAYROLL,,HJ,,20,-5439.59
2400,5/14/2021,5/14/2021,51421,82L-IMPORT PAYROLL,,HJ,,20,-5459.59
2400,5/14/2021,5/14/2021,51421,82L-IMPORT PAYROLL,,HJ,,20.83,-5480.42
2400,5/14/2021,5/14/2021,51421,82L-IMPORT PAYROLL,,HJ,,20.83,-5501.25
2400,5/14/2021,5/14/2021,51421,82L-IMPORT PAYROLL,,HJ,,25,-5526.25
2400,5/14/2021,5/14/2021,51421,82L-IMPORT PAYROLL,,HJ,,30,-5556.25
2400,5/14/2021,5/14/2021,51421,82L-IMPORT PAYROLL,,HJ,,41.35,-5597.6
2400,5/14/2021,5/14/2021,51421,82L-IMPORT PAYROLL,,HJ,,50,-5647.6
2400,5/14/2021,5/14/2021,51421,82L-IMPORT PAYROLL,,HJ,,50,-5697.6
2400,5/14/2021,5/14/2021,51421,82L-IMPORT PAYROLL,,HJ,,50,-5747.6
2400,5/14/2021,5/14/2021,51421,82L-IMPORT PAYROLL,,HJ,,50,-5797.6
2400,5/14/2021,5/14/2021,51421,82L-IMPORT PAYROLL,,HJ,,54.55,-5852.15
2400,5/14/2021,5/14/2021,51421,82L-IMPORT PAYROLL,,HJ,,65,-5917.15
2400,5/14/2021,5/14/2021,51421,82L-IMPORT PAYROLL,,HJ,,71.43,-5988.58
2400,5/14/2021,5/14/2021,51421,82L-IMPORT PAYROLL,,HJ,,75,-6063.58
2400,5/14/2021,5/14/2021,51421,82L-IMPORT PAYROLL,,HJ,,75,-6138.58
2400,5/14/2021,5/14/2021,51421,82L-IMPORT PAYROLL,,HJ,,79.17,-6217.75
2400,5/14/2021,5/14/2021,51421,82L-IMPORT PAYROLL,,HJ,,83.33,-6301.08
2400,5/14/2021,5/14/2021,51421,82L-IMPORT PAYROLL,,HJ,,83.33,-6384.41
2400,5/14/2021,5/14/2021,51421,82L-IMPORT PAYROLL,,HJ,,114.58,-6498.99
2400,5/14/2021,5/14/2021,51421,82L-IMPORT PAYROLL,,HJ,,114.58,-6613.57
2400,5/14/2021,5/14/2021,51421,82L-IMPORT PAYROLL,,HJ,,114.58,-6728.15
2400,5/14/2021,5/14/2021,51421,82L-IMPORT PAYROLL,,HJ,,150,-6878.15
2400,5/14/2021,5/14/2021,51421,82L-IMPORT PAYROLL,,HJ,,161.76,-7039.91
2400,5/14/2021,5/14/2021,51421,82L-IMPORT PAYROLL,,HJ,,161.76,-7201.67
2400,5/14/2021,5/14/2021,51421,82L-IMPORT PAYROLL,,HJ,,171.88,-7373.55
2400,5/17/2021,5/17/2021,TASC,TASC PD05.14,,HJ,2503.24,,-4870.31
2400,5/27/2021,5/27/2021,JE-21-0227,LUX PAyroll - PRPD 05312021,,HJ,,144.8,-5015.11
2400,5/28/2021,5/28/2021,52821,82L-IMPORT PAYROLL,,HJ,,10,-5025.11
2400,5/28/2021,5/28/2021,52821,82L-IMPORT PAYROLL,,HJ,,12.5,-5037.61
2400,5/28/2021,5/28/2021,52821,82L-IMPORT PAYROLL,,HJ,,15,-5052.61
2400,5/28/2021,5/28/2021,52821,82L-IMPORT PAYROLL,,HJ,,20,-5072.61
2400,5/28/2021,5/28/2021,52821,82L-IMPORT PAYROLL,,HJ,,20,-5092.61
2400,5/28/2021,5/28/2021,52821,82L-IMPORT PAYROLL,,HJ,,20.83,-5113.44
2400,5/28/2021,5/28/2021,52821,82L-IMPORT PAYROLL,,HJ,,20.83,-5134.27
2400,5/28/2021,5/28/2021,52821,82L-IMPORT PAYROLL,,HJ,,25,-5159.27
2400,5/28/2021,5/28/2021,52821,82L-IMPORT PAYROLL,,HJ,,30,-5189.27
2400,5/28/2021,5/28/2021,52821,82L-IMPORT PAYROLL,,HJ,,41.35,-5230.62
2400,5/28/2021,5/28/2021,52821,82L-IMPORT PAYROLL,,HJ,,50,-5280.62
2400,5/28/2021,5/28/2021,52821,82L-IMPORT PAYROLL,,HJ,,50,-5330.62
2400,5/28/2021,5/28/2021,52821,82L-IMPORT PAYROLL,,HJ,,50,-5380.62
2400,5/28/2021,5/28/2021,52821,82L-IMPORT PAYROLL,,HJ,,50,-5430.62
2400,5/28/2021,5/28/2021,52821,82L-IMPORT PAYROLL,,HJ,,54.55,-5485.17
2400,5/28/2021,5/28/2021,52821,82L-IMPORT PAYROLL,,HJ,,65,-5550.17
2400,5/28/2021,5/28/2021,52821,82L-IMPORT PAYROLL,,HJ,,71.43,-5621.6
2400,5/28/2021,5/28/2021,52821,82L-IMPORT PAYROLL,,HJ,,75,-5696.6
2400,5/28/2021,5/28/2021,52821,82L-IMPORT PAYROLL,,HJ,,75,-5771.6
2400,5/28/2021,5/28/2021,52821,82L-IMPORT PAYROLL,,HJ,,79.17,-5850.77
2400,5/28/2021,5/28/2021,52821,82L-IMPORT PAYROLL,,HJ,,83.33,-5934.1
2400,5/28/2021,5/28/2021,52821,82L-IMPORT PAYROLL,,HJ,,83.33,-6017.43
2400,5/28/2021,5/28/2021,52821,82L-IMPORT PAYROLL,,HJ,,114.58,-6132.01
2400,5/28/2021,5/28/2021,52821,82L-IMPORT PAYROLL,,HJ,,114.58,-6246.59
2400,5/28/2021,5/28/2021,52821,82L-IMPORT PAYROLL,,HJ,,114.58,-6361.17
2400,5/28/2021,5/28/2021,52821,82L-IMPORT PAYROLL,,HJ,,125,-6486.17
2400,5/28/2021,5/28/2021,52821,82L-IMPORT PAYROLL,,HJ,,150,-6636.17
2400,5/28/2021,5/28/2021,52821,82L-IMPORT PAYROLL,,HJ,,161.76,-6797.93
2400,5/28/2021,5/28/2021,52821,82L-IMPORT PAYROLL,,HJ,,161.76,-6959.69
2400,5/28/2021,5/28/2021,52821,82L-IMPORT PAYROLL,,HJ,,171.88,-7131.57
2400,6/2/2021,6/2/2021,TASC,Payment for TASC for PD05.31,,HJ,2253.79,,-4877.78
2400,6/14/2021,6/14/2021,JE-21-0238,PRPD 06152021 LUX,,HJ,,144.8,-5022.58
2400,6/15/2021,6/15/2021,61521,82L-IMPORT PAYROLL,,HJ,,10,-5032.58
2400,6/15/2021,6/15/2021,61521,82L-IMPORT PAYROLL,,HJ,,12.5,-5045.08
2400,6/15/2021,6/15/2021,61521,82L-IMPORT PAYROLL,,HJ,,15,-5060.08
2400,6/15/2021,6/15/2021,61521,82L-IMPORT PAYROLL,,HJ,,20,-5080.08
2400,6/15/2021,6/15/2021,61521,82L-IMPORT PAYROLL,,HJ,,20,-5100.08
2400,6/15/2021,6/15/2021,61521,82L-IMPORT PAYROLL,,HJ,,20.83,-5120.91
2400,6/15/2021,6/15/2021,61521,82L-IMPORT PAYROLL,,HJ,,20.83,-5141.74
2400,6/15/2021,6/15/2021,61521,82L-IMPORT PAYROLL,,HJ,,25,-5166.74
2400,6/15/2021,6/15/2021,61521,82L-IMPORT PAYROLL,,HJ,,30,-5196.74
2400,6/15/2021,6/15/2021,61521,82L-IMPORT PAYROLL,,HJ,,41.35,-5238.09
2400,6/15/2021,6/15/2021,61521,82L-IMPORT PAYROLL,,HJ,,50,-5288.09
2400,6/15/2021,6/15/2021,61521,82L-IMPORT PAYROLL,,HJ,,50,-5338.09
2400,6/15/2021,6/15/2021,61521,82L-IMPORT PAYROLL,,HJ,,50,-5388.09
2400,6/15/2021,6/15/2021,61521,82L-IMPORT PAYROLL,,HJ,,50,-5438.09
2400,6/15/2021,6/15/2021,61521,82L-IMPORT PAYROLL,,HJ,,54.55,-5492.64
2400,6/15/2021,6/15/2021,61521,82L-IMPORT PAYROLL,,HJ,,65,-5557.64
2400,6/15/2021,6/15/2021,61521,82L-IMPORT PAYROLL,,HJ,,71.43,-5629.07
2400,6/15/2021,6/15/2021,61521,82L-IMPORT PAYROLL,,HJ,,75,-5704.07
2400,6/15/2021,6/15/2021,61521,82L-IMPORT PAYROLL,,HJ,,75,-5779.07
2400,6/15/2021,6/15/2021,61521,82L-IMPORT PAYROLL,,HJ,,79.17,-5858.24
2400,6/15/2021,6/15/2021,61521,82L-IMPORT PAYROLL,,HJ,,83.33,-5941.57
2400,6/15/2021,6/15/2021,61521,82L-IMPORT PAYROLL,,HJ,,83.33,-6024.9
2400,6/15/2021,6/15/2021,61521,82L-IMPORT PAYROLL,,HJ,,114.58,-6139.48
2400,6/15/2021,6/15/2021,61521,82L-IMPORT PAYROLL,,HJ,,114.58,-6254.06
2400,6/15/2021,6/15/2021,61521,82L-IMPORT PAYROLL,,HJ,,114.58,-6368.64
2400,6/15/2021,6/15/2021,61521,82L-IMPORT PAYROLL,,HJ,,125,-6493.64
2400,6/15/2021,6/15/2021,61521,82L-IMPORT PAYROLL,,HJ,,150,-6643.64
2400,6/15/2021,6/15/2021,61521,82L-IMPORT PAYROLL,,HJ,,161.76,-6805.4
2400,6/15/2021,6/15/2021,61521,82L-IMPORT PAYROLL,,HJ,,161.76,-6967.16
2400,6/15/2021,6/15/2021,61521,82L-IMPORT PAYROLL,,HJ,,171.88,-7139.04
2400,6/16/2021,6/16/2021,TASC,TASC Payment June 2021,,HJ,2668.24,,-4470.8
2400,6/30/2021,6/30/2021,63021,82L-IMPORT PAYROLL,,HJ,,10,-4480.8
2400,6/30/2021,6/30/2021,63021,82L-IMPORT PAYROLL,,HJ,,12.5,-4493.3
2400,6/30/2021,6/30/2021,63021,82L-IMPORT PAYROLL,,HJ,,15,-4508.3
2400,6/30/2021,6/30/2021,63021,82L-IMPORT PAYROLL,,HJ,,20,-4528.3
2400,6/30/2021,6/30/2021,63021,82L-IMPORT PAYROLL,,HJ,,20,-4548.3
2400,6/30/2021,6/30/2021,63021,82L-IMPORT PAYROLL,,HJ,,20.83,-4569.13
2400,6/30/2021,6/30/2021,63021,82L-IMPORT PAYROLL,,HJ,,20.83,-4589.96
2400,6/30/2021,6/30/2021,63021,82L-IMPORT PAYROLL,,HJ,,25,-4614.96
2400,6/30/2021,6/30/2021,63021,82L-IMPORT PAYROLL,,HJ,,30,-4644.96
2400,6/30/2021,6/30/2021,63021,82L-IMPORT PAYROLL,,HJ,,41.35,-4686.31
2400,6/30/2021,6/30/2021,63021,82L-IMPORT PAYROLL,,HJ,,50,-4736.31
2400,6/30/2021,6/30/2021,63021,82L-IMPORT PAYROLL,,HJ,,50,-4786.31
2400,6/30/2021,6/30/2021,63021,82L-IMPORT PAYROLL,,HJ,,50,-4836.31
2400,6/30/2021,6/30/2021,63021,82L-IMPORT PAYROLL,,HJ,,50,-4886.31
2400,6/30/2021,6/30/2021,63021,82L-IMPORT PAYROLL,,HJ,,54.55,-4940.86
2400,6/30/2021,6/30/2021,63021,82L-IMPORT PAYROLL,,HJ,,65,-5005.86
2400,6/30/2021,6/30/2021,63021,82L-IMPORT PAYROLL,,HJ,,71.43,-5077.29
2400,6/30/2021,6/30/2021,63021,82L-IMPORT PAYROLL,,HJ,,75,-5152.29
2400,6/30/2021,6/30/2021,63021,82L-IMPORT PAYROLL,,HJ,,75,-5227.29
2400,6/30/2021,6/30/2021,63021,82L-IMPORT PAYROLL,,HJ,,79.17,-5306.46
2400,6/30/2021,6/30/2021,63021,82L-IMPORT PAYROLL,,HJ,,83.33,-5389.79
2400,6/30/2021,6/30/2021,63021,82L-IMPORT PAYROLL,,HJ,,83.33,-5473.12
2400,6/30/2021,6/30/2021,63021,82L-IMPORT PAYROLL,,HJ,,114.58,-5587.7
2400,6/30/2021,6/30/2021,63021,82L-IMPORT PAYROLL,,HJ,,114.58,-5702.28
2400,6/30/2021,6/30/2021,63021,82L-IMPORT PAYROLL,,HJ,,114.58,-5816.86
2400,6/30/2021,6/30/2021,63021,82L-IMPORT PAYROLL,,HJ,,125,-5941.86
2400,6/30/2021,6/30/2021,63021,82L-IMPORT PAYROLL,,HJ,,150,-6091.86
2400,6/30/2021,6/30/2021,63021,82L-IMPORT PAYROLL,,HJ,,161.76,-6253.62
2400,6/30/2021,6/30/2021,63021,82L-IMPORT PAYROLL,,HJ,,161.76,-6415.38
2400,6/30/2021,6/30/2021,63021,82L-IMPORT PAYROLL,,HJ,,171.88,-6587.26
2400,6/30/2021,6/30/2021,JE-21-0245,LUX PR-PD 20210630,,HJ,,144.8,-6732.06
2400, Totals for 2400 - FSA Withholding,,,,,,78088.63,75426.26,-6732.06
2450,2450 - TRANSIT Withholding (Balance forward As of 07/01/2020) ,,,,,,,,-2588
2450,9/15/2020,9/15/2020,LUX-PRPD-091520,LUX-PRPD-091520-LUX-PRPD-091520 -Payroll,,HJ,,243.75,-2831.75
2450,10/15/2020,10/15/2020,JE-21-0061,LUX-PRPD-101520-LUX-PRPD-101520,,HJ,,212.75,-3044.5
2450,11/12/2020,11/12/2020,JE-21-0089,LUX-PRPD-111520-LUX-PRPD-101520,,HJ,,86.75,-3131.25
2450,12/15/2020,12/15/2020,JE-21-0112,LUX-PRPD-121520-LUX-PRPD-121520,,HJ,,86.75,-3218
2450,1/15/2021,1/15/2021,JE-21-0145,LUX PayrollLUX-PRPPD-01152021-LUX-PRPD-01152021,,HJ,,86.75,-3304.75
2450,2/15/2021,2/15/2021,JE-21-0169,LUX PRPD- 021521-LUX-PRPD-02152021,,HJ,,86.75,-3391.5
2450,3/12/2021,3/12/2021,JE-21-0187,LUX Payroll -PRPD 031521,,HJ,,86.75,-3478.25
2450,4/15/2021,4/15/2021,JE-21-0200,LUX PRPD -041521,,HJ,,86.75,-3565
2450,4/15/2021,4/15/2021,JE-21-0200,LUX PR 20210415 REV &CORR,,HJ,,86.75,-3651.75
2450,4/15/2021,4/15/2021,JE-21-0200,LUX PR 20210415 REV &CORR,,HJ,86.75,,-3565
2450,6/14/2021,6/14/2021,JE-21-0238,PRPD 06152021 LUX,,HJ,,86.75,-3651.75
2450, Totals for 2450 - TRANSIT Withholding,,,,,,86.75,1150.5,-3651.75
2451,2451 - Aflac Benefits Withholdings (Balance forward As of 07/01/2020) ,,,,,,,,0
2451,4/22/2021,4/22/2021,AFLAC,Aflac Insurance Payment April,,HJ,51.36,,51.36
2451,4/22/2021,4/22/2021,AFLAC,Aflac Insurance Payment April,,HJ,66.14,,117.5
2451,4/22/2021,4/22/2021,AFLAC,Aflac Insurance Payment April,,HJ,89.64,,207.14
2451,4/30/2021,4/30/2021,43021,82L-IMPORT PAYROLL,,HJ,,21.2,185.94
2451,4/30/2021,4/30/2021,43021,82L-IMPORT PAYROLL,,HJ,,26.52,159.42
2451,4/30/2021,4/30/2021,43021,82L-IMPORT PAYROLL,,HJ,,26.92,132.5
2451,4/30/2021,4/30/2021,43021,82L-IMPORT PAYROLL,,HJ,,36.2,96.3
2451,4/30/2021,4/30/2021,43021,82L-IMPORT PAYROLL,,HJ,,44.94,51.36
2451,4/30/2021,4/30/2021,43021,82L-IMPORT PAYROLL,,HJ,,51.36,0
2451,5/14/2021,5/14/2021,51421,82L-IMPORT PAYROLL,,HJ,,21.2,-21.2
2451,5/14/2021,5/14/2021,51421,82L-IMPORT PAYROLL,,HJ,,26.52,-47.72
2451,5/14/2021,5/14/2021,51421,82L-IMPORT PAYROLL,,HJ,,26.92,-74.64
2451,5/14/2021,5/14/2021,51421,82L-IMPORT PAYROLL,,HJ,,36.2,-110.84
2451,5/14/2021,5/14/2021,51421,82L-IMPORT PAYROLL,,HJ,,44.94,-155.78
2451,5/14/2021,5/14/2021,51421,82L-IMPORT PAYROLL,,HJ,,51.36,-207.14
2451,5/19/2021,5/19/2021,AFLAC,Aflac Payment,,HJ,51.36,,-155.78
2451,5/19/2021,5/19/2021,AFLAC,Aflac Payment,,HJ,66.14,,-89.64
2451,5/19/2021,5/19/2021,AFLAC,Aflac Payment,,HJ,89.64,,0
2451,5/28/2021,5/28/2021,52821,82L-IMPORT PAYROLL,,HJ,,21.2,-21.2
2451,5/28/2021,5/28/2021,52821,82L-IMPORT PAYROLL,,HJ,,26.52,-47.72
2451,5/28/2021,5/28/2021,52821,82L-IMPORT PAYROLL,,HJ,,26.92,-74.64
2451,5/28/2021,5/28/2021,52821,82L-IMPORT PAYROLL,,HJ,,36.2,-110.84
2451,5/28/2021,5/28/2021,52821,82L-IMPORT PAYROLL,,HJ,,44.94,-155.78
2451,5/28/2021,5/28/2021,52821,82L-IMPORT PAYROLL,,HJ,,51.36,-207.14
2451,6/15/2021,6/15/2021,61521,82L-IMPORT PAYROLL,,HJ,,10.6,-217.74
2451,6/15/2021,6/15/2021,61521,82L-IMPORT PAYROLL,,HJ,,13.26,-231
2451,6/15/2021,6/15/2021,61521,82L-IMPORT PAYROLL,,HJ,,13.46,-244.46
2451,6/15/2021,6/15/2021,61521,82L-IMPORT PAYROLL,,HJ,,18.1,-262.56
2451,6/15/2021,6/15/2021,61521,82L-IMPORT PAYROLL,,HJ,,22.47,-285.03
2451,6/15/2021,6/15/2021,61521,82L-IMPORT PAYROLL,,HJ,,25.68,-310.71
2451,6/18/2021,6/18/2021,AFLAC,Aflec Payment June 2021,,HJ,51.36,,-259.35
2451,6/18/2021,6/18/2021,AFLAC,Aflec Payment June 2021,,HJ,66.14,,-193.21
2451,6/18/2021,6/18/2021,AFLAC,Aflec Payment June 2021,,HJ,89.64,,-103.57
2451,6/30/2021,6/30/2021,63021,82L-IMPORT PAYROLL,,HJ,,10.6,-114.17
2451,6/30/2021,6/30/2021,63021,82L-IMPORT PAYROLL,,HJ,,13.26,-127.43
2451,6/30/2021,6/30/2021,63021,82L-IMPORT PAYROLL,,HJ,,13.46,-140.89
2451,6/30/2021,6/30/2021,63021,82L-IMPORT PAYROLL,,HJ,,18.1,-158.99
2451,6/30/2021,6/30/2021,63021,82L-IMPORT PAYROLL,,HJ,,22.47,-181.46
2451,6/30/2021,6/30/2021,63021,82L-IMPORT PAYROLL,,HJ,,25.68,-207.14
2451, Totals for 2451 - Aflac Benefits Withholdings,,,,,,621.42,828.56,-207.14
2550,2550 - Loan Payable (Balance forward As of 07/01/2020) ,,,,,,,,-164550
2550,10/16/2020,10/16/2020,20201016,PPP loan for Woot Math-PPP loan for Woot Math,,HJ,,188869.3,-353419.3
2550,11/27/2020,11/27/2020,9297247106,Woot Math PPP forgiveness-Woot Math PPP forgiveness,,HJ,188869.3,,-164550
2550,4/3/2021,4/3/2021,JE-21-0194,X Co.  PPP Forgiveness,,HJ,164550,,0
2550, Totals for 2550 - Loan Payable,,,,,,353419.3,188869.3,0
2600,2600 - Funds Held for Others (Balance forward As of 07/01/2020) ,,,,,,,,0
2600,7/24/2020,7/24/2020,CD-20200706-5,To reclass Woot Math operating expenses-Woot Math Reimb for May 16 to May 31 and June 1 to June 30 2020. Op Cost for 3.9 Months,,HJ,,24858.59,-24858.59
2600,7/24/2020,7/24/2020,Woot Math Inc,Bill.Com Import-Woot Math Reimb for May 16 to May 31 and June 1 to June 30 2020. Op Cost for 3.9 Months.,,HJ,24858.59,,0
2600,9/22/2020,9/22/2020,CD-21-0067,To reclass Woot Math operating expenses-Woot Math Reimbursement for August 1st to August 31st Operating Cost,,HJ,,85324.32,-85324.32
2600,9/22/2020,9/22/2020,CD-21-0067,To reclass Woot Math operating expenses-Woot Math Reimbursement for July 1st to July 31st. Operating Cost,,HJ,,52437.74,-137762.06
2600,9/22/2020,9/22/2020,Woot Math Inc,Bill.Com Import-Woot Math Reimbursement for August 1st to August 31st Operating Cost,,HJ,85324.32,,-52437.74
2600,9/22/2020,9/22/2020,Woot Math Inc,Bill.Com Import-Woot Math Reimbursement for July 1st to July 31st. Operating Cost,,HJ,52437.74,,0
2600, Totals for 2600 - Funds Held for Others,,,,,,162620.65,162620.65,0
3000,3000 - Net Assets (Balance forward As of 07/01/2020) ,,,,,,,,-4569420.39
3000,7/1/2020,7/1/2020,20200630,To reverse and release the Gates funding for the Woot transaction-To reverse and release the Gates funding for the Woot transaction,D107,HJ,272360,,-4297060.39
3000,7/1/2020,7/1/2020,ARIF-20200604,To correct OVERDECK fund to FY21-To correct OVERDECK fund to FY21,D107,HJ,52083,,-4244977.39
3000,7/1/2020,7/1/2020,GATES,Record receivable for Gates FY20 and FY21-Gates restricted to FY21,D107,HJ,250000,,-3994977.39
3000,7/1/2020,7/1/2020,20-Jul,To release temporarily resttricted revenue for July-To release temporarily restricted revenue for July,D107,HJ,2083.33,,-3992894.06
3000,7/1/2020,7/1/2020,20-Jul,To release temporarily resttricted revenue for July-To release temporarily restricted revenue for July,D107,HJ,3333.33,,-3989560.73
3000,7/1/2020,7/1/2020,20-Jul,To release temporarily resttricted revenue for July-To release temporarily restricted revenue for July,D107,HJ,4166.67,,-3985394.06
3000,7/1/2020,7/1/2020,20-Jul,To release temporarily resttricted revenue for July-To release temporarily restricted revenue for July,D107,HJ,12500,,-3972894.06
3000,7/1/2020,7/1/2020,20-Jul,To release temporarily resttricted revenue for July-To release temporarily restricted revenue for July,D107,HJ,16666.67,,-3956227.39
3000,7/1/2020,7/1/2020,20-Jul,To release temporarily resttricted revenue for July-To release temporarily restricted revenue for July,D108,HJ,94583.33,,-3861644.06
3000,7/1/2020,7/1/2020,Move G-M&A to FY21,Move funds from FY20 to FY21-Move funds from FY20 to FY21,D107,HJ,40566,,-3821078.06
3000,7/1/2020,7/1/2020,Move G-M&A to FY21,Move funds from FY20 to FY21-Move funds from FY20 to FY21,D107,HJ,95421,,-3725657.06
3000,7/1/2020,7/1/2020,OVERDECK,Record receivable for Overdeck-Overdeck restricted to FY21,D107,HJ,572917,,-3152740.06
3000,7/7/2020,7/7/2020,GATES,To record receivable for Gates-NYC-To record receivable for Gates-NYC-12/31/20-6/30/21,D107,HJ,,600000,-3752740.06
3000,7/7/2020,7/7/2020,GATES,To record receivable for Gates-NYC-To record receivable for Gates-NYC6/30/21-8/30/22,D107,HJ,,1870000,-5622740.06
3000,7/7/2020,7/7/2020,GATES,To correct the source coding-To record receivable for Gates-NYC-12/31/20-6/30/21,D107,HJ,,600000,-6222740.06
3000,7/7/2020,7/7/2020,GATES,To correct the source coding-To record receivable for Gates-NYC-12/31/20-6/30/21,D107,HJ,600000,,-5622740.06
3000,7/7/2020,7/7/2020,GATES,To correct the source coding-To record receivable for Gates-NYC6/30/21-8/30/22,D107,HJ,,1870000,-7492740.06
3000,7/7/2020,7/7/2020,GATES,To correct the source coding-To record receivable for Gates-NYC6/30/21-8/30/22,D107,HJ,1870000,,-5622740.06
3000,8/1/2020,8/1/2020,20-Aug,To release temporarily restricted revenue for August-To release temporarily restricted revenue for August,D107,HJ,2083.33,,-5620656.73
3000,8/1/2020,8/1/2020,20-Aug,To release temporarily restricted revenue for August-To release temporarily restricted revenue for August,D107,HJ,3333.33,,-5617323.4
3000,8/1/2020,8/1/2020,20-Aug,To release temporarily restricted revenue for August-To release temporarily restricted revenue for August,D107,HJ,4166.67,,-5613156.73
3000,8/1/2020,8/1/2020,20-Aug,To release temporarily restricted revenue for August-To release temporarily restricted revenue for August,D107,HJ,12500,,-5600656.73
3000,8/1/2020,8/1/2020,20-Aug,To release temporarily restricted revenue for August-To release temporarily restricted revenue for August,D107,HJ,16666.67,,-5583990.06
3000,8/1/2020,8/1/2020,20-Aug,To release temporarily restricted revenue for August-To release temporarily restricted revenue for August,D108,HJ,94583.33,,-5489406.73
3000,8/31/2020,8/31/2020,WALTON,Walnut Move from FY21 to FY22-Walton Family Foundation Grant #00103777,D107,HJ,,200000,-5689406.73
3000,9/1/2020,9/1/2020,20-Sep,To release temporarily restricted revenue for September-To release temporarily restricted revenue for September,D107,HJ,2083.33,,-5687323.4
3000,9/1/2020,9/1/2020,20-Sep,To release temporarily restricted revenue for September-To release temporarily restricted revenue for September,D107,HJ,3333.33,,-5683990.07
3000,9/1/2020,9/1/2020,20-Sep,To release temporarily restricted revenue for September-To release temporarily restricted revenue for September,D107,HJ,4166.67,,-5679823.4
3000,9/1/2020,9/1/2020,20-Sep,To release temporarily restricted revenue for September-To release temporarily restricted revenue for September,D107,HJ,12500,,-5667323.4
3000,9/1/2020,9/1/2020,20-Sep,To release temporarily restricted revenue for September-To release temporarily restricted revenue for September,D107,HJ,16666.67,,-5650656.73
3000,9/1/2020,9/1/2020,20-Sep,To release temporarily restricted revenue for September-To release temporarily restricted revenue for September,D108,HJ,94583.33,,-5556073.4
3000,10/8/2020,10/8/2020,New Profit Inc.,To reverse and correct the entry for New Profit-To reverse and correct the entry for New Profit,D107,HJ,,750000,-6306073.4
3000,10/9/2020,10/9/2020,GATES,To record G-SSM remaining FY22 receivable-To record G-SSM remaining FY22 receivable,D107,HJ,,202772,-6508845.4
3000,10/31/2020,10/31/2020,20-Oct,To release temporarily restricted revenue for October-To release temporarily resttricted revenue for October 2020,D107,HJ,2083.33,,-6506762.07
3000,10/31/2020,10/31/2020,20-Oct,To release temporarily restricted revenue for October-To release temporarily resttricted revenue for October 2020,D107,HJ,3333.33,,-6503428.74
3000,10/31/2020,10/31/2020,20-Oct,To release temporarily restricted revenue for October-To release temporarily resttricted revenue for October 2020,D107,HJ,4166.67,,-6499262.07
3000,10/31/2020,10/31/2020,20-Oct,To release temporarily restricted revenue for October-To release temporarily resttricted revenue for October 2020,D107,HJ,12500,,-6486762.07
3000,10/31/2020,10/31/2020,20-Oct,To release temporarily restricted revenue for October-To release temporarily resttricted revenue for October 2020,D107,HJ,16666.67,,-6470095.4
3000,10/31/2020,10/31/2020,20-Oct,To release temporarily restricted revenue for October-To release temporarily resttricted revenue for October 2020,D108,HJ,94583.33,,-6375512.07
3000,11/13/2020,11/13/2020,IMCCHI,To record receivable for IMC-To record receivable for IMC retricted to FY22&FY23,D107,HJ,,200000,-6575512.07
3000,11/23/2020,11/23/2020,20201123,To reclass the fund from Unorthodox Philanthropy for FY22-To reclass the fund from Unorthodox Philanthropy for FY22,D107,HJ,,350000,-6925512.07
3000,11/30/2020,11/30/2020,Comcast,To record receivable from Comcast for FY22-To record receivable from Comcast for FY22,D107,HJ,,250000,-7175512.07
3000,11/30/2020,11/30/2020,20-Nov,To release temporarily resttricted revenue for November 2020-To release temporarily resttricted revenue for November 2020,D107,HJ,2083.33,,-7173428.74
3000,11/30/2020,11/30/2020,20-Nov,To release temporarily resttricted revenue for November 2020-To release temporarily resttricted revenue for November 2020,D107,HJ,3333.33,,-7170095.41
3000,11/30/2020,11/30/2020,20-Nov,To release temporarily resttricted revenue for November 2020-To release temporarily resttricted revenue for November 2020,D107,HJ,4166.67,,-7165928.74
3000,11/30/2020,11/30/2020,20-Nov,To release temporarily resttricted revenue for November 2020-To release temporarily resttricted revenue for November 2020,D107,HJ,12500,,-7153428.74
3000,11/30/2020,11/30/2020,20-Nov,To release temporarily resttricted revenue for November 2020-To release temporarily resttricted revenue for November 2020,D107,HJ,16666.67,,-7136762.07
3000,11/30/2020,11/30/2020,20-Nov,To reverse 11.30 releases and correct-To release temporarily restricted revenue for November 2020,D107,HJ,16666.67,,-7120095.4
3000,11/30/2020,11/30/2020,20-Nov,To reverse 11.30 releases and correct-To release temporarily restricted revenue for November 2020,D107,HJ,26666.67,,-7093428.73
3000,11/30/2020,11/30/2020,20-Nov,To reverse 11.30 releases and correct-To release temporarily restricted revenue for November 2020,D107,HJ,33333.33,,-7060095.4
3000,11/30/2020,11/30/2020,20-Nov,To reverse 11.30 releases and correct-To release temporarily restricted revenue for November 2020,D107,HJ,100000,,-6960095.4
3000,11/30/2020,11/30/2020,20-Nov,To reverse 11.30 releases and correct-To release temporarily restricted revenue for November 2020,D107,HJ,133333.32,,-6826762.08
3000,11/30/2020,11/30/2020,20-Nov,To reverse 11.30 releases and correct-To release temporarily resttricted revenue for November 2020,D107,HJ,,2083.33,-6828845.41
3000,11/30/2020,11/30/2020,20-Nov,To reverse 11.30 releases and correct-To release temporarily resttricted revenue for November 2020,D107,HJ,,3333.33,-6832178.74
3000,11/30/2020,11/30/2020,20-Nov,To reverse 11.30 releases and correct-To release temporarily resttricted revenue for November 2020,D107,HJ,,4166.67,-6836345.41
3000,11/30/2020,11/30/2020,20-Nov,To reverse 11.30 releases and correct-To release temporarily resttricted revenue for November 2020,D107,HJ,,12500,-6848845.41
3000,11/30/2020,11/30/2020,20-Nov,To reverse 11.30 releases and correct-To release temporarily resttricted revenue for November 2020,D107,HJ,,16666.67,-6865512.08
3000,11/30/2020,11/30/2020,20-Nov,To release temporarily resttricted revenue for November 2020-To release temporarily resttricted revenue for November 2020,D108,HJ,94583.33,,-6770928.75
3000,11/30/2020,11/30/2020,20-Nov,To reverse 11.30 releases and correct-To release temporarily restricted revenue for November 2020,D108,HJ,94583.33,,-6676345.42
3000,11/30/2020,11/30/2020,20-Nov,To reverse 11.30 releases and correct-To release temporarily resttricted revenue for November 2020,D108,HJ,,94583.33,-6770928.75
3000,12/31/2020,12/31/2020,20-Dec,To Release temporarily restricted revenue for December 2020-To Release temporarily restricted revenue for December 2020,D108,HJ,94583.33,,-6676345.42
3000,1/31/2021,1/31/2021,G-SSM to FY22,To Move G-SSM $500K from FY21 to FY22-To Move G-SSM $500K from FY21 to FY22,D107,HJ,,500000,-7176345.42
3000,1/31/2021,1/31/2021,January Release,Process Recurring Transactions-To Release temporarily restricted revenue for January 2020,D108,HJ,94583.33,,-7081762.09
3000,2/28/2021,2/28/2021,21-Feb,Process Recurring Transactions-To Release temporarily restricted revenue for February 2021,D108,HJ,94583.33,,-6987178.76
3000,3/31/2021,3/31/2021,21-Mar,Process Recurring Transactions,D108,HJ,94583.33,,-6892595.43
3000,4/16/2021,4/16/2021,SERGEY BRIN FAMILY F,Received from Sergey Brin Family foundation,D110,HJ,,3000000,-9892595.43
3000,4/30/2021,4/30/2021,21-Apr,To Release temporarily restricted revenue for April 2021,D108,HJ,94583.33,,-9798012.1
3000,5/7/2021,5/7/2021,ROTTERDAM,Bridge Consulting Invoice,D107,HJ,,6377,-9804389.1
3000,5/13/2021,5/13/2021,"Colegio Anaximenes,",INV21007 - Colegio Anaximenes AC,D109,HJ,,844.2,-9805233.3
3000,5/27/2021,5/27/2021,X Co. NFAMILY,Book Receivable from X Co. n,D107,HJ,,400000,-10205233.3
3000,5/31/2021,5/31/2021,21-May,To Release temporarily restricted fund revenue for May 2021,D108,HJ,94583.33,,-10110649.97
3000,6/8/2021,6/8/2021,Overton Elementary,INV-21008 Overton Elementary,D109,HJ,,484,-10111133.97
3000,6/15/2021,6/15/2021,Osseo Area Schools,INV-22001,D107,HJ,,16808,-10127941.97
3000,6/16/2021,6/16/2021,CMEGROUP,Record 2 Year Award from CME,D107,HJ,,100000,-10227941.97
3000,6/30/2021,6/30/2021,21-Jun,To Release temporarily restricted revenue for June 2021,D108,HJ,94583.33,,-10133358.64
3000, Totals for 3000 - Net Assets,,,,,,5486680.28,11050618.53,-10133358.64
4000,4000 - Individual Donations (Balance forward As of 07/01/2020) ,,,,,,,,0
4000,7/15/2020,7/15/2020,20200715,To record the individual donations for 7/1-7/15/2020-To record the individual donations for 7/1-7/15/2020 QGiv,D107,HJ,,18.16,-18.16
4000,7/22/2020,7/22/2020,20200722,To record individual donations-To record individual donations,D107,HJ,,4.18,-22.34
4000,11/12/2020,11/12/2020,20201112,Individual donation through AmazonSmil-Individual donation through AmazonSmil,D107,HJ,,8.18,-30.52
4000,12/22/2020,12/22/2020,20201222,Received individual donations through QGiv-Received individual donations through QGiv,D107,HJ,,252.07,-282.59
4000,12/24/2020,12/24/2020,20201224,Cash received from The Learning Age via Plooto-on behalf of Krista-Cash received from The Learning Age via Plooto-on behalf of Krista,D107,HJ,,500,-782.59
4000,1/8/2021,1/8/2021,20210108,Donation from Dancing Tides Foundation Inc-Donation from Dancing Tides Foundation Inc,D107,HJ,,10000,-10782.59
4000,1/19/2021,1/19/2021,20210119,Receiving individual donations QGiv-Receiving individual donations QGiv,D107,HJ,,133.14,-10915.73
4000,2/2/2021,2/2/2021,20210202,Receiving or refunding individual donations QGiv-Receiving or refunding individual donations QGiv,D107,HJ,6.06,,-10909.67
4000,2/17/2021,2/17/2021,523596,Donation from The Benevity Community Impact Fund-Donation from The Benevity Community Impact Fund,D107,HJ,,136.65,-11046.32
4000,4/30/2021,4/30/2021,202104,Receiving individual donations QGiv,D107,HJ,,49.19,-11095.51
4000,5/5/2021,5/5/2021,Facebook,Facebook Donations,D107,HJ,,360,-11455.51
4000,5/25/2021,5/25/2021,Amazon Business,Amazon Smile Payment 20210525,D107,HJ,,5,-11460.51
4000,6/22/2021,6/22/2021,Anonymous,Anonymous Donation,D107,HJ,,50,-11510.51
4000,6/28/2021,6/28/2021,Blackbaud GivingFund,Receipt of 25$ Donation,D107,HJ,,25,-11535.51
4000, Totals for 4000 - Individual Donations,,,,,,6.06,11541.57,-11535.51
4010,4010 - Corporate Grants (Balance forward As of 07/01/2020) ,,,,,,,,0
4010,10/8/2020,10/8/2020,New Profit Inc.,Receivable for the New Profit Inc fund-Receivable for the New Profit Inc fund,D107,HJ,,250000,-250000
4010,10/8/2020,10/8/2020,New Profit Inc.,To reverse and correct the entry for New Profit-Receivable for the New Profit Inc fund,D107,HJ,250000,,0
4010,10/8/2020,10/8/2020,New Profit Inc.,To reverse and correct the entry for New Profit-To reverse and correct the entry for New Profit,D107,HJ,,250000,-250000
4010, Totals for 4010 - Corporate Grants,,,,,,250000,500000,-250000
4020,4020 - Foundation Grants (Balance forward As of 07/01/2020) ,,,,,,,,0
4020,7/7/2020,7/7/2020,,"This is to correct the Gates-NYC Receivable. On 9/23/2021 we thought we corrected the Gates-NYC receivable, however the system did not auto generate a reversal. On 9/23/2021 we moved the funds from Funding Sources Gates-NYC to Gates- Online Model to better reflect the funding sources. This was our first correction to the systems historical data. This entry is taking the 870,000 from Gates- NYC so that the Statement of Activity is correct with June 30, 2021.",D108,GJ,870000,,870000
4020,7/7/2020,7/7/2020,,"This is to correct the Gates-NYC Receivable. On 9/23/2021 we thought we corrected the Gates-NYC receivable, however the system did not auto generate a reversal. On 9/23/2021 we moved the funds from Funding Sources Gates-NYC to Gates- Online Model to better reflect the funding sources. This was our first correction to the systems historical data. This entry is taking the 870,000 from Gates- NYC so that the Statement of Activity is correct with June 30, 2021.",D108,GJ,870000,,1740000
4020,7/7/2020,7/7/2020,AR-000020,Invoice - Gates- Online Model: Gates NYC 6/30/2021 to 8/30/2022,D108,ARJ,,870000,870000
4020,7/7/2020,7/7/2020,GATES,To record receivable for Gates-NYC-To record receivable for Gates-NYC-Dec 31 2020,D107,HJ,,2400000,-1530000
4020,7/7/2020,7/7/2020,GATES,To correct the source coding-To record receivable for Gates-NYC-Dec 31 2020,D107,HJ,,2400000,-3930000
4020,7/7/2020,7/7/2020,GATES,To correct the source coding-To record receivable for Gates-NYC-Dec 31 2020,D107,HJ,2400000,,-1530000
4020,7/8/2020,7/8/2020,Reversed - GJ#140,"Reversed -- This is to correct the Gates-NYC Receivable. On 9/23/2021 we thought we corrected the Gates-NYC receivable, however the system did not auto generate a reversal. On 9/23/2021 we moved the funds from Funding Sources Gates-NYC to Gates- Online Model to better reflect the funding sources. This was our first correction to the systems historical data. This entry is taking the 870,000 from Gates- NYC so that the Statement of Activity is correct with June 30, 2021.",D108,GJ,,870000,-2400000
4020,7/10/2020,7/10/2020,Citadel Foundation,To record receivable for Citadel Foundation for FY21-To record receivable for Citadel Foundation for FY21,D108,HJ,,2320000,-4720000
4020,7/10/2020,7/10/2020,Citadel Foundation,To record receivable for Citadel Foundation for FY21-To record receivable for Citadel Foundation for FY21,D108,HJ,,1000000,-5720000
4020,7/13/2020,7/13/2020,BET-CH,To record A Better Chicago receivable FY21-To record A Better Chicago receivable FY21,D107,HJ,,75000,-5795000
4020,8/5/2020,8/5/2020,20200805,Received CME Chicago grant-Received CME Chicago grant,D108,HJ,,50000,-5845000
4020,8/31/2020,8/31/2020,WALTON,Walton Family Foundation Grant #00103777-Walton Family Foundation Grant #00103777,D107,HJ,,200000,-6045000
4020,8/31/2020,8/31/2020,WALTON,Walnut Move from FY21 to FY22-Walton Family Foundation Grant #00103777,D107,HJ,200000,,-5845000
4020,10/15/2020,10/15/2020,20201015,Received the payment from G-SSM-Received the payment from G-SSM,D107,HJ,,1000000,-6845000
4020,11/3/2020,11/3/2020,FINNEGAN,Receivable from Finnegan Family Foundation-Receivable from Finnegan Family Foundation,D107,HJ,,10000,-6855000
4020,11/13/2020,11/13/2020,IMCCHI,To record receivable for IMC-To record receivable for IMC,D107,HJ,,100000,-6955000
4020,11/18/2020,11/18/2020,ANGELLFAMILY,To record the receivable from Paul M. Agnell foundation-To record the receivable from Paul M. Agnell foundation,D107,HJ,,100000,-7055000
4020,11/23/2020,11/23/2020,20201123,To reclass the fund from Unorthodox Philanthropy for FY22-To reclass the fund from Unorthodox Philanthropy for FY22,D107,HJ,350000,,-6705000
4020,11/23/2020,11/23/2020,Unorthodox Philanthr,Unorthodox Philanthropy (UP) Award receivable-Unorthodox Philanthropy (UP) Award receivable,D107,HJ,,350000,-7055000
4020,1/31/2021,1/31/2021,G-SSM to FY22,To Move G-SSM $500K from FY21 to FY22-To Move G-SSM $500K from FY21 to FY22,D107,HJ,500000,,-6555000
4020, Totals for 4020 - Foundation Grants,,,,,,5190000,11745000,-6555000
4030,4030 - Program Income (Balance forward As of 07/01/2020) ,,,,,,,,0
4030,7/30/2020,7/30/2020,Camelot Education,Service income from Camelot Ed-University of CHI EdLabs-Service income from Camelot Ed-University of CHI EdLabs,D107,HJ,,20615,-20615
4030,7/30/2020,7/30/2020,YCCS,Service income from YCCS-University of Chicago EdLabs-Service income from YCCS-University of Chicago EdLabs,D107,HJ,,20615,-41230
4030,9/30/2020,9/30/2020,CPS,CPS September invoicing-CPS September invoicing,D108,HJ,,282000,-323230
4030,10/31/2020,10/31/2020,CPS,Receivable for October service for CPS-Receivable for October service for CPS,D108,HJ,,282000,-605230
4030,11/19/2020,11/19/2020,COLLEGEBOARD,College Board Invoice CB7 - 5/1/2020-8/31/2020-College Board Invoice CB7 - 5/1/2020-8/31/2020,D113,HJ,,72419.35,-677649.35
4030,11/30/2020,11/30/2020,CPS,Receivable for service provided in November for CPS-Receivable for service provided in November for CPS,D108,HJ,,282000,-959649.35
4030,11/30/2020,11/30/2020,CPS,Option Schools Invoice-Option Schools Invoice - 201130-CPS-OPSCH001,D108,HJ,,40310.25,-999959.6
4030,12/31/2020,12/31/2020,CPS,Option school December invoice-Option school December invoice,D108,HJ,,40310.25,-1040269.85
4030,12/31/2020,12/31/2020,CPS,CPS December invoicing-CPS December invoicing,D108,HJ,,282000,-1322269.85
4030,1/21/2021,1/21/2021,Haarlem,January receivable for Haarlem-January receivable for Haarlem,D107,HJ,,6362,-1328631.85
4030,1/26/2021,1/26/2021,Providence PSD,Invoicing Providence Public School District for 12/15/20-8/31/2021-Invoicing Providence Public School District for 12/15/20-8/31/2021,D107,HJ,,18000,-1346631.85
4030,1/31/2021,1/31/2021,CPS,Option School January Invoice-Option school January invoice,D108,HJ,,40310.25,-1386942.1
4030,1/31/2021,1/31/2021,CPS,CPS January Invoice-CPS January invoicing,D108,HJ,,282000,-1668942.1
4030,2/28/2021,2/28/2021,CPS,CPS February Inv CPS26-CPS February invoicing,D108,HJ,,282000,-1950942.1
4030,2/28/2021,2/28/2021,CPS,Option School February Inv-Option school February invoice,D108,HJ,,40310.25,-1991252.35
4030,3/9/2021,3/9/2021,"Broward County, FL","Invoice 210309-001 Broward County, FL",D108,HJ,,600000,-2591252.35
4030,3/22/2021,3/22/2021,Woot Math Acquisiti,Receipt from Pennsylvania Dept of Education,D109,HJ,,58.95,-2591311.3
4030,3/31/2021,3/31/2021,CPS,INV CPS27,D108,HJ,,282000,-2873311.3
4030,3/31/2021,3/31/2021,CPS,Option School Inv 005,D108,HJ,,40310.25,-2913621.55
4030,4/29/2021,4/29/2021,WE SUCCEED,Pre-Pilot Payment - We Succeed,D107,HJ,,1000,-2914621.55
4030,4/30/2021,4/30/2021,CPS,Invoice CPS28,D108,HJ,,282000,-3196621.55
4030,4/30/2021,4/30/2021,CPS,Invoice 20210430-CPS-OPSCH006,D108,HJ,,40310.25,-3236931.8
4030,5/31/2021,5/31/2021,CPS,INV 210531-CPS-OPSCH007,D108,HJ,,40310.25,-3277242.05
4030,5/31/2021,5/31/2021,CPS,INV CPS29,D108,HJ,,282000,-3559242.05
4030,6/2/2021,6/2/2021,Great Oaks Legacy,Receipt of Funds from Great Oaks prior to Invoicing,D107,HJ,,2487.5,-3561729.55
4030,6/10/2021,6/10/2021,Nantahala Schools,INV-21009 Nantahala Schools,D107,HJ,,44.19,-3561773.74
4030,6/28/2021,6/28/2021,CPS,June 2021 CPS Invoice,D108,HJ,,40310.25,-3602083.99
4030,6/28/2021,6/28/2021,CPS,June 2021 CPS Invoice,D108,HJ,,282000,-3884083.99
4030, Totals for 4030 - Program Income,,,,,,0,3884083.99,-3884083.99
4040,4040 - Platform/License Income (Balance forward As of 07/01/2020) ,,,,,,,,0
4040,10/16/2020,10/16/2020,Woot Math Acquisiti,Receivables from WootMath Acquisition-Receivables from WootMath Acquisition,D109,HJ,,2916.77,-2916.77
4040,10/29/2020,10/29/2020,VENTUREFUND,To record receivable from EF+MATH-Receivable from new schools-Woot Math Acquisition,D109,HJ,,200000,-202916.77
4040,12/15/2020,12/15/2020,20201215,Received revenue from Woot Math-Received revenue from Woot Math,D109,HJ,,491.1,-203407.87
4040,12/21/2020,12/21/2020,Glendale Unified Sch,WootMath Student License-WootMath Student License,D109,HJ,,55.6,-203463.47
4040,12/21/2020,12/21/2020,MGSD Online Academy,WootMath Teacher License-WootMath Teacher License,D109,HJ,,188.64,-203652.11
4040,12/21/2020,12/21/2020,Woot Math Acquisiti,To record receivable for Woot Math Products-To record receivable for Woot Math Products,D109,HJ,,244.24,-203896.35
4040,1/11/2021,1/11/2021,20210111,Received revenue from Woot Math-Received revenue from Woot Math,D109,HJ,,455.6,-204351.95
4040,1/21/2021,1/21/2021,Great Oaks Legacy,Receivable from great Oaks Legacy Charter School-Receivable from great Oaks Legacy Charter School,D109,HJ,,4975,-209326.95
4040,2/5/2021,2/5/2021,Woot Math Acquisiti,Received revenue from Woot Math-Received revenue from Woot Math,D109,HJ,,965.25,-210292.2
4040,2/16/2021,2/16/2021,San Leandro Unified,Reversed -- WootMath Student License-WootMath Student License,D109,HJ,349.22,,-209942.98
4040,2/16/2021,2/16/2021,San Leandro Unified,WootMath Student License-WootMath Student License,D109,HJ,,349.22,-210292.2
4040,2/28/2021,2/28/2021,Fullerton School Dis,WootMath School District-WootMath School District,D109,HJ,,353.7,-210645.9
4040,3/1/2021,3/1/2021,Woot Math Acquisiti,Received revenue from Woot Math,D109,HJ,,752.5,-211398.4
4040,3/8/2021,3/8/2021,Unionville- Chadds F,WoothMath Student License,D109,HJ,,363,-211761.4
4040,3/19/2021,3/19/2021,Chillicothe R-II Sch,Woot Math Student Service,D109,HJ,,598.75,-212360.15
4040,3/31/2021,3/31/2021,Great Oaks Legacy,Invoice 21004-GO-S2021 Great Oaks Legacy,D107,HJ,,2487.5,-214847.65
4040,4/30/2021,4/30/2021,Woot Math Acquisiti,Received revenue from Woot Math,D109,HJ,,468.27,-215315.92
4040,5/30/2021,5/30/2021,Woot Math Acquisiti,Received revenue from Woot Math,D109,HJ,,42.61,-215358.53
4040,6/16/2021,6/16/2021,Woot Math Acquisiti,Reverse Duplicate Woot Math Entry,D109,HJ,244.24,,-215114.29
4040,6/23/2021,6/23/2021,Woot Math Acquisiti,Received revenue from Woot Math. June 2021,D109,HJ,,42.61,-215156.9
4040,6/28/2021,6/28/2021,Woot Math Acquisiti,Received revenue from Woot Math. June 2021,D109,HJ,,42.61,-215199.51
4040,6/30/2021,6/30/2021,Woot Math Acquisiti,Received revenue from Woot Math. June 2021,D109,HJ,,42.61,-215242.12
4040,6/30/2021,6/30/2021,Woot Math Acquisiti,Received revenue from Woot Math. June 2021,D109,HJ,,42.61,-215284.73
4040, Totals for 4040 - Platform/License Income,,,,,,593.46,215878.19,-215284.73
4041,4041 - Saga Learn and Connect Platform Income (Balance forward As of 07/01/2020) ,,,,,,,,0
4041,1/27/2021,1/27/2021,Woot Math Acquisiti,Received revenue from Woot Math-Received revenue or paid reimb for Woot Math,D109,HJ,,312.34,-312.34
4041, Totals for 4041 - Saga Learn and Connect Platform Income,,,,,,0,312.34,-312.34
4100,4100 - Federal & SC Grants (Balance forward As of 07/01/2020) ,,,,,,,,0
4100,7/27/2020,7/27/2020,June-2020-(a),Americorps AR and Reimbursement for June-Americorps Reimbursement for June -Booking Revenue,D107,HJ,,38793.06,-38793.06
4100,10/26/2020,10/26/2020,September-2020-(a),Americorp Reimbursement for August & September-Americorps Reimbursement for September -Booking Revenue,D107,HJ,,236773.22,-275566.28
4100,11/20/2020,11/20/2020,October-2020-(a),Americorp Reimbursement for October-Americorps Reimbursement for October -Booking Revenue,D107,HJ,,225122.55,-500688.83
4100,12/15/2020,12/15/2020,November-2020 (a),Americorps Reimbursement for November-Americorps Reimbursement for November -Booking Revenue,D107,HJ,,233374.62,-734063.45
4100,1/13/2021,1/13/2021,20201213,Americorps Reimbursement for December-Americorps Reimbursement for December -Booking Revenue,D107,HJ,,212210.7,-946274.15
4100,2/10/2021,2/10/2021,JE-21-0160,Americorps Reimbursement for January-Americorps Reimbursement for January,D107,HJ,,203784.24,-1150058.39
4100,3/15/2021,3/15/2021,JE-21-0177,Americorp Reimbursement for February,D107,HJ,,204978.73,-1355037.12
4100,4/13/2021,4/13/2021,082476BFD3084543A374,Americorps reimbursement for March,D107,HJ,,202871.76,-1557908.88
4100,5/17/2021,5/17/2021,CD-21-0293,Americorps Reimbursement for April,D107,HJ,,201713.77,-1759622.65
4100,6/14/2021,6/14/2021,ADP retroactiveJUN,Americorp Reimbursement for MAy,D107,HJ,,199848.94,-1959471.59
4100, Totals for 4100 - Federal & SC Grants,,,,,,0,1959471.59,-1959471.59
4150,4150 - Unbilled- Federal & SC Grants (Balance forward As of 07/01/2020) ,,,,,,,,0
4150,7/27/2020,7/27/2020,June-2020-(a),Americorps AR and Reimbursement for June-Americorps Reimbursement for June -Reversing Revenue,D107,HJ,38793.06,,38793.06
4150,9/30/2020,9/30/2020,20-Sep,Americorp Reimbursement for August & September-Americorps Reimbursement for September -Recognizing Revenue,D107,HJ,,236773.22,-197980.16
4150,10/26/2020,10/26/2020,September-2020-(a),Americorp Reimbursement for August & September-Americorps Reimbursement for September -Reversing Revenue,D107,HJ,236773.22,,38793.06
4150,10/31/2020,10/31/2020,20-Oct,Americorp Reimbursement for October-Americorps Reimbursement for October -Recognizing Revenue,D107,HJ,,225122.55,-186329.49
4150,11/20/2020,11/20/2020,October-2020-(a),Americorp Reimbursement for October-Americorps Reimbursement for October -Reversing Revenue,D107,HJ,225122.55,,38793.06
4150,11/30/2020,11/30/2020,20-Nov,Americorps Reimbursement for November-Americorps Reimbursement for November -Recognizing Revenue,D107,HJ,,233374.62,-194581.56
4150,12/15/2020,12/15/2020,November-2020 (a),Americorps Reimbursement for November-Americorps Reimbursement for November -Reversing Revenue,D107,HJ,233374.62,,38793.06
4150,12/31/2020,12/31/2020,JE-21-0120,Americorps Reimbursement for December-Americorps Reimbursement for November -Recognizing Revenue,D107,HJ,,212210.7,-173417.64
4150,1/13/2021,1/13/2021,20201213,Americorps Reimbursement for December-Americorps Reimbursement for December -Reversing Revenue,D107,HJ,,212210.7,-385628.34
4150,1/13/2021,1/13/2021,20201213,Reverse and Correct JE-21-0103-Correct - Americorps Reimbursement for December,D107,HJ,212210.7,,-173417.64
4150,1/13/2021,1/13/2021,20201213,Reverse and Correct JE-21-0103-Reverse - Americorps Reimbursement for December,D107,HJ,212210.7,,38793.06
4150,1/31/2021,1/31/2021,JE-21-0160-2,Americorps Reimbursement for January-Americorps Reimbursement for January -Recognizing Revenue,D107,HJ,,203784.24,-164991.18
4150,2/10/2021,2/10/2021,JE-21-0160,Americorps Reimbursement for January-Americorps Reimbursement for January,D107,HJ,203784.24,,38793.06
4150,2/28/2021,2/28/2021,20200228,Americorp Reimbursement for February-Americorps Reimbursement for February,D107,HJ,,204978.73,-166185.67
4150,3/15/2021,3/15/2021,JE-21-0177,Americorp Reimbursement for February,D107,HJ,204978.73,,38793.06
4150,3/31/2021,3/31/2021,20200331,Americorps reimbursement for March,D107,HJ,,202871.76,-164078.7
4150,4/13/2021,4/13/2021,082476BFD3084543A374,Americorps reimbursement for March,D107,HJ,202871.76,,38793.06
4150,4/30/2021,4/30/2021,20210430,Americorps Reimbursement for April,D107,HJ,,201713.77,-162920.71
4150,5/17/2021,5/17/2021,CD-21-0293,Americorps Reimbursement for April,D107,HJ,201713.77,,38793.06
4150,5/31/2021,5/31/2021,20210531,Americorp Reimbursement for MAy,D107,HJ,,199848.94,-161055.88
4150,6/14/2021,6/14/2021,ADP retroactiveJUN,Americorp Reimbursement for MAy,D107,HJ,199848.94,,38793.06
4150,6/30/2021,6/30/2021,20210630,Americorp Reimb for June,D107,HJ,,281262.9,-242469.84
4150, Totals for 4150 - Unbilled- Federal & SC Grants,,,,,,2171682.29,2414152.13,-242469.84
4250,4250 - Interest and Other Income (Balance forward As of 07/01/2020) ,,,,,,,,0
4250,7/31/2020,7/31/2020,20200731,To record analysis fee and interest earned-To record analysis fee and interest earned,D107,HJ,,38.98,-38.98
4250,8/31/2020,8/31/2020,20200831,Interest earned in August-Interest earned in August,D107,HJ,,2.87,-41.85
4250,9/23/2020,9/23/2020,20200923,To record Goodwill credit interest earned-To record goodwill credit for interest earned,D107,HJ,,77.93,-119.78
4250,9/23/2020,9/23/2020,20200923,To record Goodwill credit interest earned-To record goodwill credit for interest earned,D107,HJ,,122.86,-242.64
4250,11/27/2020,11/27/2020,9297247106,Woot Math PPP forgiveness-Woot Math PPP forgiveness,D107,HJ,,188869.3,-189111.94
4250,12/15/2020,12/15/2020,20201215,Received one cent from Paul M Angell-Received one cent from Paul M Angell,D107,HJ,,0.01,-189111.95
4250,4/3/2021,4/3/2021,JE-21-0194,X Co.  PPP Forgiveness,D107,HJ,,164550,-353661.95
4250, Totals for 4250 - Interest and Other Income,,,,,,0,353661.95,-353661.95
4302,4302 - Release Restriction to Unrestricted Fund (Balance forward As of 07/01/2020) ,,,,,,,,0
4302,7/1/2020,7/1/2020,20200630,To reverse and release the Gates funding for the Woot transaction-To reverse and release the Gates funding for the Woot transaction,D107,HJ,,272360,-272360
4302,7/1/2020,7/1/2020,ARIF-20200604,To correct OVERDECK fund to FY21-To correct OVERDECK fund to FY21,D107,HJ,,52083,-324443
4302,7/1/2020,7/1/2020,GATES,Record receivable for Gates FY20 and FY21-Gates restricted to FY21,D107,HJ,,250000,-574443
4302,7/1/2020,7/1/2020,20-Jul,To release temporarily resttricted revenue for July-To release temporarily restricted revenue for July,D107,HJ,,2083.33,-576526.33
4302,7/1/2020,7/1/2020,20-Jul,To release temporarily resttricted revenue for July-To release temporarily restricted revenue for July,D107,HJ,,3333.33,-579859.66
4302,7/1/2020,7/1/2020,20-Jul,To release temporarily resttricted revenue for July-To release temporarily restricted revenue for July,D107,HJ,,4166.67,-584026.33
4302,7/1/2020,7/1/2020,20-Jul,To release temporarily resttricted revenue for July-To release temporarily restricted revenue for July,D107,HJ,,12500,-596526.33
4302,7/1/2020,7/1/2020,20-Jul,To release temporarily resttricted revenue for July-To release temporarily restricted revenue for July,D107,HJ,,16666.67,-613193
4302,7/1/2020,7/1/2020,20-Jul,To release temporarily resttricted revenue for July-To release temporarily restricted revenue for July,D108,HJ,,94583.33,-707776.33
4302,7/1/2020,7/1/2020,Move G-M&A to FY21,Move funds from FY20 to FY21-Move funds from FY20 to FY21,D107,HJ,,40566,-748342.33
4302,7/1/2020,7/1/2020,Move G-M&A to FY21,Move funds from FY20 to FY21-Move funds from FY20 to FY21,D107,HJ,,95421,-843763.33
4302,7/1/2020,7/1/2020,OVERDECK,Record receivable for Overdeck-Overdeck restricted to FY21,D107,HJ,,572917,-1416680.33
4302,8/1/2020,8/1/2020,20-Aug,To release temporarily restricted revenue for August-To release temporarily restricted revenue for August,D107,HJ,,2083.33,-1418763.66
4302,8/1/2020,8/1/2020,20-Aug,To release temporarily restricted revenue for August-To release temporarily restricted revenue for August,D107,HJ,,3333.33,-1422096.99
4302,8/1/2020,8/1/2020,20-Aug,To release temporarily restricted revenue for August-To release temporarily restricted revenue for August,D107,HJ,,4166.67,-1426263.66
4302,8/1/2020,8/1/2020,20-Aug,To release temporarily restricted revenue for August-To release temporarily restricted revenue for August,D107,HJ,,12500,-1438763.66
4302,8/1/2020,8/1/2020,20-Aug,To release temporarily restricted revenue for August-To release temporarily restricted revenue for August,D107,HJ,,16666.67,-1455430.33
4302,8/1/2020,8/1/2020,20-Aug,To release temporarily restricted revenue for August-To release temporarily restricted revenue for August,D108,HJ,,94583.33,-1550013.66
4302,9/1/2020,9/1/2020,20-Sep,To release temporarily restricted revenue for September-To release temporarily restricted revenue for September,D107,HJ,,2083.33,-1552096.99
4302,9/1/2020,9/1/2020,20-Sep,To release temporarily restricted revenue for September-To release temporarily restricted revenue for September,D107,HJ,,3333.33,-1555430.32
4302,9/1/2020,9/1/2020,20-Sep,To release temporarily restricted revenue for September-To release temporarily restricted revenue for September,D107,HJ,,4166.67,-1559596.99
4302,9/1/2020,9/1/2020,20-Sep,To release temporarily restricted revenue for September-To release temporarily restricted revenue for September,D107,HJ,,12500,-1572096.99
4302,9/1/2020,9/1/2020,20-Sep,To release temporarily restricted revenue for September-To release temporarily restricted revenue for September,D107,HJ,,16666.67,-1588763.66
4302,9/1/2020,9/1/2020,20-Sep,To release temporarily restricted revenue for September-To release temporarily restricted revenue for September,D108,HJ,,94583.33,-1683346.99
4302,10/31/2020,10/31/2020,20-Oct,To release temporarily restricted revenue for October-To release temporarily resttricted revenue for October 2020,D107,HJ,,2083.33,-1685430.32
4302,10/31/2020,10/31/2020,20-Oct,To release temporarily restricted revenue for October-To release temporarily resttricted revenue for October 2020,D107,HJ,,3333.33,-1688763.65
4302,10/31/2020,10/31/2020,20-Oct,To release temporarily restricted revenue for October-To release temporarily resttricted revenue for October 2020,D107,HJ,,4166.67,-1692930.32
4302,10/31/2020,10/31/2020,20-Oct,To release temporarily restricted revenue for October-To release temporarily resttricted revenue for October 2020,D107,HJ,,12500,-1705430.32
4302,10/31/2020,10/31/2020,20-Oct,To release temporarily restricted revenue for October-To release temporarily resttricted revenue for October 2020,D107,HJ,,16666.67,-1722096.99
4302,10/31/2020,10/31/2020,20-Oct,To release temporarily restricted revenue for October-To release temporarily resttricted revenue for October 2020,D108,HJ,,94583.33,-1816680.32
4302,11/30/2020,11/30/2020,20-Nov,To release temporarily resttricted revenue for November 2020-To release temporarily resttricted revenue for November 2020,D107,HJ,,2083.33,-1818763.65
4302,11/30/2020,11/30/2020,20-Nov,To release temporarily resttricted revenue for November 2020-To release temporarily resttricted revenue for November 2020,D107,HJ,,3333.33,-1822096.98
4302,11/30/2020,11/30/2020,20-Nov,To release temporarily resttricted revenue for November 2020-To release temporarily resttricted revenue for November 2020,D107,HJ,,4166.67,-1826263.65
4302,11/30/2020,11/30/2020,20-Nov,To release temporarily resttricted revenue for November 2020-To release temporarily resttricted revenue for November 2020,D107,HJ,,12500,-1838763.65
4302,11/30/2020,11/30/2020,20-Nov,To release temporarily resttricted revenue for November 2020-To release temporarily resttricted revenue for November 2020,D107,HJ,,16666.67,-1855430.32
4302,11/30/2020,11/30/2020,20-Nov,To reverse 11.30 releases and correct-To release temporarily restricted revenue for November 2020,D107,HJ,,16666.67,-1872096.99
4302,11/30/2020,11/30/2020,20-Nov,To reverse 11.30 releases and correct-To release temporarily restricted revenue for November 2020,D107,HJ,,26666.67,-1898763.66
4302,11/30/2020,11/30/2020,20-Nov,To reverse 11.30 releases and correct-To release temporarily restricted revenue for November 2020,D107,HJ,,33333.33,-1932096.99
4302,11/30/2020,11/30/2020,20-Nov,To reverse 11.30 releases and correct-To release temporarily restricted revenue for November 2020,D107,HJ,,100000,-2032096.99
4302,11/30/2020,11/30/2020,20-Nov,To reverse 11.30 releases and correct-To release temporarily restricted revenue for November 2020,D107,HJ,,133333.32,-2165430.31
4302,11/30/2020,11/30/2020,20-Nov,To reverse 11.30 releases and correct-To release temporarily resttricted revenue for November 2020,D107,HJ,2083.33,,-2163346.98
4302,11/30/2020,11/30/2020,20-Nov,To reverse 11.30 releases and correct-To release temporarily resttricted revenue for November 2020,D107,HJ,3333.33,,-2160013.65
4302,11/30/2020,11/30/2020,20-Nov,To reverse 11.30 releases and correct-To release temporarily resttricted revenue for November 2020,D107,HJ,4166.67,,-2155846.98
4302,11/30/2020,11/30/2020,20-Nov,To reverse 11.30 releases and correct-To release temporarily resttricted revenue for November 2020,D107,HJ,12500,,-2143346.98
4302,11/30/2020,11/30/2020,20-Nov,To reverse 11.30 releases and correct-To release temporarily resttricted revenue for November 2020,D107,HJ,16666.67,,-2126680.31
4302,11/30/2020,11/30/2020,20-Nov,To release temporarily resttricted revenue for November 2020-To release temporarily resttricted revenue for November 2020,D108,HJ,,94583.33,-2221263.64
4302,11/30/2020,11/30/2020,20-Nov,To reverse 11.30 releases and correct-To release temporarily restricted revenue for November 2020,D108,HJ,,94583.33,-2315846.97
4302,11/30/2020,11/30/2020,20-Nov,To reverse 11.30 releases and correct-To release temporarily resttricted revenue for November 2020,D108,HJ,94583.33,,-2221263.64
4302,12/1/2020,12/1/2020,20201201,To move revenue and expenses from discontinued grants-To move revenue and expenses from GATES to G-BL,D107,HJ,,250000,-2471263.64
4302,12/1/2020,12/1/2020,20201201,To move revenue and expenses from discontinued grants-To move revenue and expenses from GATES to G-BL,D107,HJ,250000,,-2221263.64
4302,12/31/2020,12/31/2020,20-Dec,To Release temporarily restricted revenue for December 2020-To Release temporarily restricted revenue for December 2020,D108,HJ,,94583.33,-2315846.97
4302,1/31/2021,1/31/2021,January Release,Process Recurring Transactions-To Release temporarily restricted revenue for January 2020,D108,HJ,,94583.33,-2410430.3
4302,2/28/2021,2/28/2021,21-Feb,Process Recurring Transactions-To Release temporarily restricted revenue for February 2021,D108,HJ,,94583.33,-2505013.63
4302,3/31/2021,3/31/2021,21-Mar,Process Recurring Transactions,D108,HJ,,94583.33,-2599596.96
4302,4/30/2021,4/30/2021,21-Apr,To Release temporarily restricted revenue for April 2021,D108,HJ,,94583.33,-2694180.29
4302,5/31/2021,5/31/2021,21-May,To Release temporarily restricted fund revenue for May 2021,D108,HJ,,94583.33,-2788763.62
4302,6/30/2021,6/30/2021,21-Jun,To Release temporarily restricted revenue for June 2021,D108,HJ,,94583.33,-2883346.95
4302, Totals for 4302 - Release Restriction to Unrestricted Fund,,,,,,383333.33,3266680.28,-2883346.95
4350,4350 - Gain on Acquisition (Balance forward As of 07/01/2020) ,,,,,,,,0
4350,10/16/2020,10/16/2020,20201016,PPP loan for Woot Math-PPP loan for Woot Math,D109,HJ,188869.3,,188869.3
4350,10/16/2020,10/16/2020,WM,Cash received from Woot Math Acquisition-Cash received from Woot Math Acquisition,D109,HJ,,306618.17,-117748.87
4350, Totals for 4350 - Gain on Acquisition,,,,,,188869.3,306618.17,-117748.87
6100,6100 - Staff Salaries (Balance forward As of 07/01/2020) ,,,,,,,,0
6100,7/15/2020,7/15/2020,71520,82L-IMPORT PAYROLL-KOPSHEVER MELISSA,D108,HJ,2153.77,,2153.77
6100,7/15/2020,7/15/2020,71520,82L-PRPD-071520 -Import Payroll (GENERL)-AKLESTAD ISABEL,D108,HJ,2073.06,,4226.83
6100,7/15/2020,7/15/2020,71520,82L-PRPD-071520 -Import Payroll (GENERL)-ALLEN KIMBERLY MARY,D108,HJ,2171.78,,6398.61
6100,7/15/2020,7/15/2020,71520,82L-PRPD-071520 -Import Payroll (GENERL)-ANTHONY BETTY S,D108,HJ,2886.52,,9285.13
6100,7/15/2020,7/15/2020,71520,82L-PRPD-071520 -Import Payroll (GENERL)-AUSTIN PERCY,D108,HJ,2653.02,,11938.15
6100,7/15/2020,7/15/2020,71520,82L-PRPD-071520 -Import Payroll (GENERL)-BALASUBRAMANIAN SHARANYA,D108,HJ,2666.67,,14604.82
6100,7/15/2020,7/15/2020,71520,82L-PRPD-071520 -Import Payroll (GENERL)-BANDA STEPHANY,D108,HJ,1161.5,,15766.32
6100,7/15/2020,7/15/2020,71520,82L-PRPD-071520 -Import Payroll (GENERL)-BARTOLD DEANNA MARIE,D108,HJ,3034.5,,18800.82
6100,7/15/2020,7/15/2020,71520,82L-PRPD-071520 -Import Payroll (GENERL)-BAUSH DANIEL,D108,HJ,1750,,20550.82
6100,7/15/2020,7/15/2020,71520,82L-PRPD-071520 -Import Payroll (GENERL)-BAUSH DANIEL,D108,HJ,2762.5,,23313.32
6100,7/15/2020,7/15/2020,71520,82L-PRPD-071520 -Import Payroll (GENERL)-BELLOT GENESIS,D108,HJ,1292.26,,24605.58
6100,7/15/2020,7/15/2020,71520,82L-PRPD-071520 -Import Payroll (GENERL)-BOWMAN HALLEY K,D108,HJ,1500,,26105.58
6100,7/15/2020,7/15/2020,71520,82L-PRPD-071520 -Import Payroll (GENERL)-BOWMAN HALLEY K,D108,HJ,3375,,29480.58
6100,7/15/2020,7/15/2020,71520,82L-PRPD-071520 -Import Payroll (GENERL)-CHAPMAN CLAUDY EARL,D108,HJ,1833.33,,31313.91
6100,7/15/2020,7/15/2020,71520,82L-PRPD-071520 -Import Payroll (GENERL)-CIRKER MIA,D108,HJ,1453.79,,32767.7
6100,7/15/2020,7/15/2020,71520,82L-PRPD-071520 -Import Payroll (GENERL)-COOPER ASHLEE R,D108,HJ,2486.25,,35253.95
6100,7/15/2020,7/15/2020,71520,82L-PRPD-071520 -Import Payroll (GENERL)-CORTEZ MIRANDA A,D108,HJ,895.05,,36149
6100,7/15/2020,7/15/2020,71520,82L-PRPD-071520 -Import Payroll (GENERL)-CORTEZ MIRANDA A,D108,HJ,2635.43,,38784.43
6100,7/15/2020,7/15/2020,71520,82L-PRPD-071520 -Import Payroll (GENERL)-COVENEY ALLISON,D108,HJ,2854.17,,41638.6
6100,7/15/2020,7/15/2020,71520,82L-PRPD-071520 -Import Payroll (GENERL)-DADA ARIKPO E,D108,HJ,2720,,44358.6
6100,7/15/2020,7/15/2020,71520,82L-PRPD-071520 -Import Payroll (GENERL)-DAUGHERTY DEVIN W,D108,HJ,1041.67,,45400.27
6100,7/15/2020,7/15/2020,71520,82L-PRPD-071520 -Import Payroll (GENERL)-DUPUIS CHRISTOPHER M,D108,HJ,4187.5,,49587.77
6100,7/15/2020,7/15/2020,71520,82L-PRPD-071520 -Import Payroll (GENERL)-DZIEDZIC JULIE K,D108,HJ,1250,,50837.77
6100,7/15/2020,7/15/2020,71520,82L-PRPD-071520 -Import Payroll (GENERL)-FEIGHERY JOHN,D108,HJ,1453.79,,52291.56
6100,7/15/2020,7/15/2020,71520,82L-PRPD-071520 -Import Payroll (GENERL)-GARCIA MARILYN,D108,HJ,1480.71,,53772.27
6100,7/15/2020,7/15/2020,71520,82L-PRPD-071520 -Import Payroll (GENERL)-GARNER IVORY,D108,HJ,1680,,55452.27
6100,7/15/2020,7/15/2020,71520,82L-PRPD-071520 -Import Payroll (GENERL)-GORNSTEIN STEVEN,D108,HJ,2708.33,,58160.6
6100,7/15/2020,7/15/2020,71520,82L-PRPD-071520 -Import Payroll (GENERL)-GRAVES KAMIESHIA,D108,HJ,1346.1,,59506.7
6100,7/15/2020,7/15/2020,71520,82L-PRPD-071520 -Import Payroll (GENERL)-GRAVES KIRA B,D108,HJ,2605.83,,62112.53
6100,7/15/2020,7/15/2020,71520,82L-PRPD-071520 -Import Payroll (GENERL)-GRIFFIN ANDREW,D108,HJ,1246.1,,63358.63
6100,7/15/2020,7/15/2020,71520,82L-PRPD-071520 -Import Payroll (GENERL)-GUADARRAMA-ALVAREZ URIEL A,D108,HJ,1300,,64658.63
6100,7/15/2020,7/15/2020,71520,82L-PRPD-071520 -Import Payroll (GENERL)-GUADARRAMA-ALVAREZ URIEL A,D108,HJ,2897.92,,67556.55
6100,7/15/2020,7/15/2020,71520,82L-PRPD-071520 -Import Payroll (GENERL)-GUTHRIE LESLIE,D108,HJ,2458.33,,70014.88
6100,7/15/2020,7/15/2020,71520,82L-PRPD-071520 -Import Payroll (GENERL)-HALLINAN GABRIEL B,D108,HJ,2550,,72564.88
6100,7/15/2020,7/15/2020,71520,82L-PRPD-071520 -Import Payroll (GENERL)-HOLDER LATIVA M,D108,HJ,1400,,73964.88
6100,7/15/2020,7/15/2020,71520,82L-PRPD-071520 -Import Payroll (GENERL)-HOLDER LATIVA M,D108,HJ,3812.5,,77777.38
6100,7/15/2020,7/15/2020,71520,82L-PRPD-071520 -Import Payroll (GENERL)-HOLMES JOREL ALEXANDER,D108,HJ,2329,,80106.38
6100,7/15/2020,7/15/2020,71520,82L-PRPD-071520 -Import Payroll (GENERL)-HOSSAIN MYESHA R,D108,HJ,2486.25,,82592.63
6100,7/15/2020,7/15/2020,71520,82L-PRPD-071520 -Import Payroll (GENERL)-JACKSON CLAICE M,D108,HJ,278.92,,82871.55
6100,7/15/2020,7/15/2020,71520,82L-PRPD-071520 -Import Payroll (GENERL)-JACKSON CLAICE M,D108,HJ,3125,,85996.55
6100,7/15/2020,7/15/2020,71520,82L-PRPD-071520 -Import Payroll (GENERL)-JACKSON TASNIM F,D108,HJ,2291.67,,88288.22
6100,7/15/2020,7/15/2020,71520,82L-PRPD-071520 -Import Payroll (GENERL)-JANG DANIEL,D108,HJ,2750,,91038.22
6100,7/15/2020,7/15/2020,71520,82L-PRPD-071520 -Import Payroll (GENERL)-JORDAN TIFFANY T,D108,HJ,2340,,93378.22
6100,7/15/2020,7/15/2020,71520,82L-PRPD-071520 -Import Payroll (GENERL)-JORDAN TIFFANY T,D108,HJ,3445,,96823.22
6100,7/15/2020,7/15/2020,71520,82L-PRPD-071520 -Import Payroll (GENERL)-KAMYA MIRIAM L,D108,HJ,2916.66,,99739.88
6100,7/15/2020,7/15/2020,71520,82L-PRPD-071520 -Import Payroll (GENERL)-KOPSHEVER MELISSA,D108,HJ,2153.73,,101893.61
6100,7/15/2020,7/15/2020,71520,82L-PRPD-071520 -Import Payroll (GENERL)-LACEY DEQUITA,D108,HJ,2698.75,,104592.36
6100,7/15/2020,7/15/2020,71520,82L-PRPD-071520 -Import Payroll (GENERL)-LANIGAN LISA A,D108,HJ,2115,,106707.36
6100,7/15/2020,7/15/2020,71520,82L-PRPD-071520 -Import Payroll (GENERL)-LANIGAN LISA A,D108,HJ,3113.75,,109821.11
6100,7/15/2020,7/15/2020,71520,82L-PRPD-071520 -Import Payroll (GENERL)-LENEGHAN MARYELLEN B,D108,HJ,212.5,,110033.61
6100,7/15/2020,7/15/2020,71520,82L-PRPD-071520 -Import Payroll (GENERL)-LENEGHAN MARYELLEN B,D108,HJ,1400,,111433.61
6100,7/15/2020,7/15/2020,71520,82L-PRPD-071520 -Import Payroll (GENERL)-LENEGHAN MARYELLEN B,D108,HJ,3812.5,,115246.11
6100,7/15/2020,7/15/2020,71520,82L-PRPD-071520 -Import Payroll (GENERL)-LEVERET LILY A,D108,HJ,1150,,116396.11
6100,7/15/2020,7/15/2020,71520,82L-PRPD-071520 -Import Payroll (GENERL)-LI BELLA,D108,HJ,2486.25,,118882.36
6100,7/15/2020,7/15/2020,71520,82L-PRPD-071520 -Import Payroll (GENERL)-LIPORACE HERNAN LUIS,D108,HJ,1692.24,,120574.6
6100,7/15/2020,7/15/2020,71520,82L-PRPD-071520 -Import Payroll (GENERL)-MCELWEE MELISSA,D108,HJ,1969.16,,122543.76
6100,7/15/2020,7/15/2020,71520,82L-PRPD-071520 -Import Payroll (GENERL)-MCNICHOLAS MARY,D108,HJ,2291.67,,124835.43
6100,7/15/2020,7/15/2020,71520,82L-PRPD-071520 -Import Payroll (GENERL)-MOSELEY ARIELLE,D108,HJ,2752.73,,127588.16
6100,7/15/2020,7/15/2020,71520,82L-PRPD-071520 -Import Payroll (GENERL)-NWAKANMA NANCY,D108,HJ,2918.31,,130506.47
6100,7/15/2020,7/15/2020,71520,82L-PRPD-071520 -Import Payroll (GENERL)-ODONNELL STEPHEN,D108,HJ,1000,,131506.47
6100,7/15/2020,7/15/2020,71520,82L-PRPD-071520 -Import Payroll (GENERL)-ODONNELL STEPHEN,D108,HJ,2707.5,,134213.97
6100,7/15/2020,7/15/2020,71520,82L-PRPD-071520 -Import Payroll (GENERL)-ONICA ANTHONY J,D108,HJ,1338.41,,135552.38
6100,7/15/2020,7/15/2020,71520,82L-PRPD-071520 -Import Payroll (GENERL)-PARHAM-GANTT DENISE M,D108,HJ,3041.67,,138594.05
6100,7/15/2020,7/15/2020,71520,82L-PRPD-071520 -Import Payroll (GENERL)-PEINADO ELIZABETH R,D108,HJ,3749.96,,142344.01
6100,7/15/2020,7/15/2020,71520,82L-PRPD-071520 -Import Payroll (GENERL)-PRAHIN NICOLE M,D108,HJ,1400,,143744.01
6100,7/15/2020,7/15/2020,71520,82L-PRPD-071520 -Import Payroll (GENERL)-PRAHIN NICOLE M,D108,HJ,3812.5,,147556.51
6100,7/15/2020,7/15/2020,71520,82L-PRPD-071520 -Import Payroll (GENERL)-RANDOLPH ALEXANDER,D108,HJ,2221.14,,149777.65
6100,7/15/2020,7/15/2020,71520,82L-PRPD-071520 -Import Payroll (GENERL)-RIVERS QUIONNA DIANE,D108,HJ,2514.3,,152291.95
6100,7/15/2020,7/15/2020,71520,82L-PRPD-071520 -Import Payroll (GENERL)-SALIM YASSER,D108,HJ,2431.94,,154723.89
6100,7/15/2020,7/15/2020,71520,82L-PRPD-071520 -Import Payroll (GENERL)-SEJOUR MAHALIAH,D108,HJ,2500,,157223.89
6100,7/15/2020,7/15/2020,71520,82L-PRPD-071520 -Import Payroll (GENERL)-SHENKMAN OLIVIA,D108,HJ,2000,,159223.89
6100,7/15/2020,7/15/2020,71520,82L-PRPD-071520 -Import Payroll (GENERL)-SKALSKI CHRISTOPHER,D108,HJ,2465,,161688.89
6100,7/15/2020,7/15/2020,71520,82L-PRPD-071520 -Import Payroll (GENERL)-SMITH AKILAH,D108,HJ,1173,,162861.89
6100,7/15/2020,7/15/2020,71520,82L-PRPD-071520 -Import Payroll (GENERL)-TAM CW RYAN,D108,HJ,1213.25,,164075.14
6100,7/15/2020,7/15/2020,71520,82L-PRPD-071520 -Import Payroll (GENERL)-TENESACA VERONICA A,D108,HJ,1219,,165294.14
6100,7/15/2020,7/15/2020,71520,82L-PRPD-071520 -Import Payroll (GENERL)-TILLERY ASIA,D108,HJ,3291.67,,168585.81
6100,7/15/2020,7/15/2020,71520,82L-PRPD-071520 -Import Payroll (GENERL)-TUMENJARGAL ENKHJIN,D108,HJ,2414,,170999.81
6100,7/15/2020,7/15/2020,71520,82L-PRPD-071520 -Import Payroll (GENERL)-VILLEGAS EVELYN,D108,HJ,2817.75,,173817.56
6100,7/15/2020,7/15/2020,71520,82L-PRPD-071520 -Import Payroll (GENERL)-WALLACE AMENA T,D108,HJ,2187.5,,176005.06
6100,7/15/2020,7/15/2020,71520,82L-PRPD-071520 -Import Payroll (GENERL)-WEINSTOCK EMILY,D108,HJ,2833.33,,178838.39
6100,7/15/2020,7/15/2020,71520,82L-PRPD-071520 -Import Payroll (GENERL)-WINANS JENNIFER,D108,HJ,570,,179408.39
6100,7/15/2020,7/15/2020,71520,82L-PRPD-071520 -Import Payroll (GENERL)-WINANS JENNIFER,D108,HJ,2505.63,,181914.02
6100,7/15/2020,7/15/2020,71520,82L-PRPD-071520 -Import Payroll (GENERL)-WOLF ANNA A,D108,HJ,2635,,184549.02
6100,7/15/2020,7/15/2020,71520,82L-PRPD-071520 -Import Payroll (GENERL)-ZARATE JOSEPH M,D108,HJ,2329,,186878.02
6100,7/15/2020,7/15/2020,71520,To reverse 82L payroll 0715 JE-21-0008-Reverse payroll entry 07152020 IMPORT PAYROLL,D108,HJ,,212.5,186665.52
6100,7/15/2020,7/15/2020,71520,To reverse 82L payroll 0715 JE-21-0008-Reverse payroll entry 07152020 IMPORT PAYROLL,D108,HJ,,278.92,186386.6
6100,7/15/2020,7/15/2020,71520,To reverse 82L payroll 0715 JE-21-0008-Reverse payroll entry 07152020 IMPORT PAYROLL,D108,HJ,,570,185816.6
6100,7/15/2020,7/15/2020,71520,To reverse 82L payroll 0715 JE-21-0008-Reverse payroll entry 07152020 IMPORT PAYROLL,D108,HJ,,895.05,184921.55
6100,7/15/2020,7/15/2020,71520,To reverse 82L payroll 0715 JE-21-0008-Reverse payroll entry 07152020 IMPORT PAYROLL,D108,HJ,,1000,183921.55
6100,7/15/2020,7/15/2020,71520,To reverse 82L payroll 0715 JE-21-0008-Reverse payroll entry 07152020 IMPORT PAYROLL,D108,HJ,,1041.67,182879.88
6100,7/15/2020,7/15/2020,71520,To reverse 82L payroll 0715 JE-21-0008-Reverse payroll entry 07152020 IMPORT PAYROLL,D108,HJ,,1150,181729.88
6100,7/15/2020,7/15/2020,71520,To reverse 82L payroll 0715 JE-21-0008-Reverse payroll entry 07152020 IMPORT PAYROLL,D108,HJ,,1161.5,180568.38
6100,7/15/2020,7/15/2020,71520,To reverse 82L payroll 0715 JE-21-0008-Reverse payroll entry 07152020 IMPORT PAYROLL,D108,HJ,,1173,179395.38
6100,7/15/2020,7/15/2020,71520,To reverse 82L payroll 0715 JE-21-0008-Reverse payroll entry 07152020 IMPORT PAYROLL,D108,HJ,,1213.25,178182.13
6100,7/15/2020,7/15/2020,71520,To reverse 82L payroll 0715 JE-21-0008-Reverse payroll entry 07152020 IMPORT PAYROLL,D108,HJ,,1219,176963.13
6100,7/15/2020,7/15/2020,71520,To reverse 82L payroll 0715 JE-21-0008-Reverse payroll entry 07152020 IMPORT PAYROLL,D108,HJ,,1246.1,175717.03
6100,7/15/2020,7/15/2020,71520,To reverse 82L payroll 0715 JE-21-0008-Reverse payroll entry 07152020 IMPORT PAYROLL,D108,HJ,,1250,174467.03
6100,7/15/2020,7/15/2020,71520,To reverse 82L payroll 0715 JE-21-0008-Reverse payroll entry 07152020 IMPORT PAYROLL,D108,HJ,,1292.26,173174.77
6100,7/15/2020,7/15/2020,71520,To reverse 82L payroll 0715 JE-21-0008-Reverse payroll entry 07152020 IMPORT PAYROLL,D108,HJ,,1300,171874.77
6100,7/15/2020,7/15/2020,71520,To reverse 82L payroll 0715 JE-21-0008-Reverse payroll entry 07152020 IMPORT PAYROLL,D108,HJ,,1338.41,170536.36
6100,7/15/2020,7/15/2020,71520,To reverse 82L payroll 0715 JE-21-0008-Reverse payroll entry 07152020 IMPORT PAYROLL,D108,HJ,,1346.1,169190.26
6100,7/15/2020,7/15/2020,71520,To reverse 82L payroll 0715 JE-21-0008-Reverse payroll entry 07152020 IMPORT PAYROLL,D108,HJ,,1400,167790.26
6100,7/15/2020,7/15/2020,71520,To reverse 82L payroll 0715 JE-21-0008-Reverse payroll entry 07152020 IMPORT PAYROLL,D108,HJ,,1400,166390.26
6100,7/15/2020,7/15/2020,71520,To reverse 82L payroll 0715 JE-21-0008-Reverse payroll entry 07152020 IMPORT PAYROLL,D108,HJ,,1400,164990.26
6100,7/15/2020,7/15/2020,71520,To reverse 82L payroll 0715 JE-21-0008-Reverse payroll entry 07152020 IMPORT PAYROLL,D108,HJ,,1453.79,163536.47
6100,7/15/2020,7/15/2020,71520,To reverse 82L payroll 0715 JE-21-0008-Reverse payroll entry 07152020 IMPORT PAYROLL,D108,HJ,,1453.79,162082.68
6100,7/15/2020,7/15/2020,71520,To reverse 82L payroll 0715 JE-21-0008-Reverse payroll entry 07152020 IMPORT PAYROLL,D108,HJ,,1480.71,160601.97
6100,7/15/2020,7/15/2020,71520,To reverse 82L payroll 0715 JE-21-0008-Reverse payroll entry 07152020 IMPORT PAYROLL,D108,HJ,,1500,159101.97
6100,7/15/2020,7/15/2020,71520,To reverse 82L payroll 0715 JE-21-0008-Reverse payroll entry 07152020 IMPORT PAYROLL,D108,HJ,,1680,157421.97
6100,7/15/2020,7/15/2020,71520,To reverse 82L payroll 0715 JE-21-0008-Reverse payroll entry 07152020 IMPORT PAYROLL,D108,HJ,,1692.24,155729.73
6100,7/15/2020,7/15/2020,71520,To reverse 82L payroll 0715 JE-21-0008-Reverse payroll entry 07152020 IMPORT PAYROLL,D108,HJ,,1750,153979.73
6100,7/15/2020,7/15/2020,71520,To reverse 82L payroll 0715 JE-21-0008-Reverse payroll entry 07152020 IMPORT PAYROLL,D108,HJ,,1833.33,152146.4
6100,7/15/2020,7/15/2020,71520,To reverse 82L payroll 0715 JE-21-0008-Reverse payroll entry 07152020 IMPORT PAYROLL,D108,HJ,,1969.16,150177.24
6100,7/15/2020,7/15/2020,71520,To reverse 82L payroll 0715 JE-21-0008-Reverse payroll entry 07152020 IMPORT PAYROLL,D108,HJ,,2000,148177.24
6100,7/15/2020,7/15/2020,71520,To reverse 82L payroll 0715 JE-21-0008-Reverse payroll entry 07152020 IMPORT PAYROLL,D108,HJ,,2073.06,146104.18
6100,7/15/2020,7/15/2020,71520,To reverse 82L payroll 0715 JE-21-0008-Reverse payroll entry 07152020 IMPORT PAYROLL,D108,HJ,,2115,143989.18
6100,7/15/2020,7/15/2020,71520,To reverse 82L payroll 0715 JE-21-0008-Reverse payroll entry 07152020 IMPORT PAYROLL,D108,HJ,,2153.73,141835.45
6100,7/15/2020,7/15/2020,71520,To reverse 82L payroll 0715 JE-21-0008-Reverse payroll entry 07152020 IMPORT PAYROLL,D108,HJ,,2171.78,139663.67
6100,7/15/2020,7/15/2020,71520,To reverse 82L payroll 0715 JE-21-0008-Reverse payroll entry 07152020 IMPORT PAYROLL,D108,HJ,,2187.5,137476.17
6100,7/15/2020,7/15/2020,71520,To reverse 82L payroll 0715 JE-21-0008-Reverse payroll entry 07152020 IMPORT PAYROLL,D108,HJ,,2221.14,135255.03
6100,7/15/2020,7/15/2020,71520,To reverse 82L payroll 0715 JE-21-0008-Reverse payroll entry 07152020 IMPORT PAYROLL,D108,HJ,,2291.67,132963.36
6100,7/15/2020,7/15/2020,71520,To reverse 82L payroll 0715 JE-21-0008-Reverse payroll entry 07152020 IMPORT PAYROLL,D108,HJ,,2291.67,130671.69
6100,7/15/2020,7/15/2020,71520,To reverse 82L payroll 0715 JE-21-0008-Reverse payroll entry 07152020 IMPORT PAYROLL,D108,HJ,,2329,128342.69
6100,7/15/2020,7/15/2020,71520,To reverse 82L payroll 0715 JE-21-0008-Reverse payroll entry 07152020 IMPORT PAYROLL,D108,HJ,,2329,126013.69
6100,7/15/2020,7/15/2020,71520,To reverse 82L payroll 0715 JE-21-0008-Reverse payroll entry 07152020 IMPORT PAYROLL,D108,HJ,,2340,123673.69
6100,7/15/2020,7/15/2020,71520,To reverse 82L payroll 0715 JE-21-0008-Reverse payroll entry 07152020 IMPORT PAYROLL,D108,HJ,,2414,121259.69
6100,7/15/2020,7/15/2020,71520,To reverse 82L payroll 0715 JE-21-0008-Reverse payroll entry 07152020 IMPORT PAYROLL,D108,HJ,,2431.94,118827.75
6100,7/15/2020,7/15/2020,71520,To reverse 82L payroll 0715 JE-21-0008-Reverse payroll entry 07152020 IMPORT PAYROLL,D108,HJ,,2458.33,116369.42
6100,7/15/2020,7/15/2020,71520,To reverse 82L payroll 0715 JE-21-0008-Reverse payroll entry 07152020 IMPORT PAYROLL,D108,HJ,,2465,113904.42
6100,7/15/2020,7/15/2020,71520,To reverse 82L payroll 0715 JE-21-0008-Reverse payroll entry 07152020 IMPORT PAYROLL,D108,HJ,,2486.25,111418.17
6100,7/15/2020,7/15/2020,71520,To reverse 82L payroll 0715 JE-21-0008-Reverse payroll entry 07152020 IMPORT PAYROLL,D108,HJ,,2486.25,108931.92
6100,7/15/2020,7/15/2020,71520,To reverse 82L payroll 0715 JE-21-0008-Reverse payroll entry 07152020 IMPORT PAYROLL,D108,HJ,,2486.25,106445.67
6100,7/15/2020,7/15/2020,71520,To reverse 82L payroll 0715 JE-21-0008-Reverse payroll entry 07152020 IMPORT PAYROLL,D108,HJ,,2500,103945.67
6100,7/15/2020,7/15/2020,71520,To reverse 82L payroll 0715 JE-21-0008-Reverse payroll entry 07152020 IMPORT PAYROLL,D108,HJ,,2505.63,101440.04
6100,7/15/2020,7/15/2020,71520,To reverse 82L payroll 0715 JE-21-0008-Reverse payroll entry 07152020 IMPORT PAYROLL,D108,HJ,,2514.3,98925.74
6100,7/15/2020,7/15/2020,71520,To reverse 82L payroll 0715 JE-21-0008-Reverse payroll entry 07152020 IMPORT PAYROLL,D108,HJ,,2550,96375.74
6100,7/15/2020,7/15/2020,71520,To reverse 82L payroll 0715 JE-21-0008-Reverse payroll entry 07152020 IMPORT PAYROLL,D108,HJ,,2605.83,93769.91
6100,7/15/2020,7/15/2020,71520,To reverse 82L payroll 0715 JE-21-0008-Reverse payroll entry 07152020 IMPORT PAYROLL,D108,HJ,,2635,91134.91
6100,7/15/2020,7/15/2020,71520,To reverse 82L payroll 0715 JE-21-0008-Reverse payroll entry 07152020 IMPORT PAYROLL,D108,HJ,,2635.43,88499.48
6100,7/15/2020,7/15/2020,71520,To reverse 82L payroll 0715 JE-21-0008-Reverse payroll entry 07152020 IMPORT PAYROLL,D108,HJ,,2653.02,85846.46
6100,7/15/2020,7/15/2020,71520,To reverse 82L payroll 0715 JE-21-0008-Reverse payroll entry 07152020 IMPORT PAYROLL,D108,HJ,,2666.67,83179.79
6100,7/15/2020,7/15/2020,71520,To reverse 82L payroll 0715 JE-21-0008-Reverse payroll entry 07152020 IMPORT PAYROLL,D108,HJ,,2698.75,80481.04
6100,7/15/2020,7/15/2020,71520,To reverse 82L payroll 0715 JE-21-0008-Reverse payroll entry 07152020 IMPORT PAYROLL,D108,HJ,,2707.5,77773.54
6100,7/15/2020,7/15/2020,71520,To reverse 82L payroll 0715 JE-21-0008-Reverse payroll entry 07152020 IMPORT PAYROLL,D108,HJ,,2708.33,75065.21
6100,7/15/2020,7/15/2020,71520,To reverse 82L payroll 0715 JE-21-0008-Reverse payroll entry 07152020 IMPORT PAYROLL,D108,HJ,,2720,72345.21
6100,7/15/2020,7/15/2020,71520,To reverse 82L payroll 0715 JE-21-0008-Reverse payroll entry 07152020 IMPORT PAYROLL,D108,HJ,,2750,69595.21
6100,7/15/2020,7/15/2020,71520,To reverse 82L payroll 0715 JE-21-0008-Reverse payroll entry 07152020 IMPORT PAYROLL,D108,HJ,,2752.73,66842.48
6100,7/15/2020,7/15/2020,71520,To reverse 82L payroll 0715 JE-21-0008-Reverse payroll entry 07152020 IMPORT PAYROLL,D108,HJ,,2762.5,64079.98
6100,7/15/2020,7/15/2020,71520,To reverse 82L payroll 0715 JE-21-0008-Reverse payroll entry 07152020 IMPORT PAYROLL,D108,HJ,,2817.75,61262.23
6100,7/15/2020,7/15/2020,71520,To reverse 82L payroll 0715 JE-21-0008-Reverse payroll entry 07152020 IMPORT PAYROLL,D108,HJ,,2833.33,58428.9
6100,7/15/2020,7/15/2020,71520,To reverse 82L payroll 0715 JE-21-0008-Reverse payroll entry 07152020 IMPORT PAYROLL,D108,HJ,,2854.17,55574.73
6100,7/15/2020,7/15/2020,71520,To reverse 82L payroll 0715 JE-21-0008-Reverse payroll entry 07152020 IMPORT PAYROLL,D108,HJ,,2886.52,52688.21
6100,7/15/2020,7/15/2020,71520,To reverse 82L payroll 0715 JE-21-0008-Reverse payroll entry 07152020 IMPORT PAYROLL,D108,HJ,,2897.92,49790.29
6100,7/15/2020,7/15/2020,71520,To reverse 82L payroll 0715 JE-21-0008-Reverse payroll entry 07152020 IMPORT PAYROLL,D108,HJ,,2916.66,46873.63
6100,7/15/2020,7/15/2020,71520,To reverse 82L payroll 0715 JE-21-0008-Reverse payroll entry 07152020 IMPORT PAYROLL,D108,HJ,,2918.31,43955.32
6100,7/15/2020,7/15/2020,71520,To reverse 82L payroll 0715 JE-21-0008-Reverse payroll entry 07152020 IMPORT PAYROLL,D108,HJ,,3034.5,40920.82
6100,7/15/2020,7/15/2020,71520,To reverse 82L payroll 0715 JE-21-0008-Reverse payroll entry 07152020 IMPORT PAYROLL,D108,HJ,,3041.67,37879.15
6100,7/15/2020,7/15/2020,71520,To reverse 82L payroll 0715 JE-21-0008-Reverse payroll entry 07152020 IMPORT PAYROLL,D108,HJ,,3113.75,34765.4
6100,7/15/2020,7/15/2020,71520,To reverse 82L payroll 0715 JE-21-0008-Reverse payroll entry 07152020 IMPORT PAYROLL,D108,HJ,,3125,31640.4
6100,7/15/2020,7/15/2020,71520,To reverse 82L payroll 0715 JE-21-0008-Reverse payroll entry 07152020 IMPORT PAYROLL,D108,HJ,,3291.67,28348.73
6100,7/15/2020,7/15/2020,71520,To reverse 82L payroll 0715 JE-21-0008-Reverse payroll entry 07152020 IMPORT PAYROLL,D108,HJ,,3375,24973.73
6100,7/15/2020,7/15/2020,71520,To reverse 82L payroll 0715 JE-21-0008-Reverse payroll entry 07152020 IMPORT PAYROLL,D108,HJ,,3445,21528.73
6100,7/15/2020,7/15/2020,71520,To reverse 82L payroll 0715 JE-21-0008-Reverse payroll entry 07152020 IMPORT PAYROLL,D108,HJ,,3749.96,17778.77
6100,7/15/2020,7/15/2020,71520,To reverse 82L payroll 0715 JE-21-0008-Reverse payroll entry 07152020 IMPORT PAYROLL,D108,HJ,,3812.5,13966.27
6100,7/15/2020,7/15/2020,71520,To reverse 82L payroll 0715 JE-21-0008-Reverse payroll entry 07152020 IMPORT PAYROLL,D108,HJ,,3812.5,10153.77
6100,7/15/2020,7/15/2020,71520,To reverse 82L payroll 0715 JE-21-0008-Reverse payroll entry 07152020 IMPORT PAYROLL,D108,HJ,,3812.5,6341.27
6100,7/15/2020,7/15/2020,71520,To reverse 82L payroll 0715 JE-21-0008-Reverse payroll entry 07152020 IMPORT PAYROLL,D108,HJ,,4187.5,2153.77
6100,7/15/2020,7/15/2020,71520,82L-IMPORT PAYROLL-ANTHONY BETTY S,D108,HJ,2886.52,,5040.29
6100,7/15/2020,7/15/2020,71520,82L-IMPORT PAYROLL-AUSTIN PERCY,D108,HJ,2653.02,,7693.31
6100,7/15/2020,7/15/2020,71520,82L-IMPORT PAYROLL-BANDA STEPHANY,D108,HJ,1161.5,,8854.81
6100,7/15/2020,7/15/2020,71520,82L-IMPORT PAYROLL-BAUSH DANIEL,D108,HJ,1750,,10604.81
6100,7/15/2020,7/15/2020,71520,82L-IMPORT PAYROLL-BAUSH DANIEL,D108,HJ,2762.5,,13367.31
6100,7/15/2020,7/15/2020,71520,82L-IMPORT PAYROLL-CHAPMAN CLAUDY EARL,D108,HJ,1833.33,,15200.64
6100,7/15/2020,7/15/2020,71520,82L-IMPORT PAYROLL-DADA ARIKPO E,D108,HJ,2720,,17920.64
6100,7/15/2020,7/15/2020,71520,82L-IMPORT PAYROLL-GUTHRIE LESLIE,D108,HJ,2458.33,,20378.97
6100,7/15/2020,7/15/2020,71520,82L-IMPORT PAYROLL-HOLMES JOREL ALEXANDER,D108,HJ,2329,,22707.97
6100,7/15/2020,7/15/2020,71520,82L-IMPORT PAYROLL-JORDAN TIFFANY T,D108,HJ,2340,,25047.97
6100,7/15/2020,7/15/2020,71520,82L-IMPORT PAYROLL-JORDAN TIFFANY T,D108,HJ,3445,,28492.97
6100,7/15/2020,7/15/2020,71520,82L-IMPORT PAYROLL-KAMYA MIRIAM L,D108,HJ,2916.66,,31409.63
6100,7/15/2020,7/15/2020,71520,82L-IMPORT PAYROLL-LANIGAN LISA A,D108,HJ,2115,,33524.63
6100,7/15/2020,7/15/2020,71520,82L-IMPORT PAYROLL-LANIGAN LISA A,D108,HJ,3113.75,,36638.38
6100,7/15/2020,7/15/2020,71520,82L-IMPORT PAYROLL-LEVERET LILY A,D108,HJ,1150,,37788.38
6100,7/15/2020,7/15/2020,71520,82L-IMPORT PAYROLL-MCELWEE MELISSA,D108,HJ,1969.16,,39757.54
6100,7/15/2020,7/15/2020,71520,82L-IMPORT PAYROLL-MCNICHOLAS MARY,D108,HJ,2291.67,,42049.21
6100,7/15/2020,7/15/2020,71520,82L-IMPORT PAYROLL-NWAKANMA NANCY,D108,HJ,2918.31,,44967.52
6100,7/15/2020,7/15/2020,71520,82L-IMPORT PAYROLL-ONICA ANTHONY J,D108,HJ,1338.41,,46305.93
6100,7/15/2020,7/15/2020,71520,82L-IMPORT PAYROLL-PRAHIN NICOLE M,D108,HJ,1400,,47705.93
6100,7/15/2020,7/15/2020,71520,82L-IMPORT PAYROLL-PRAHIN NICOLE M,D108,HJ,3812.5,,51518.43
6100,7/15/2020,7/15/2020,71520,82L-IMPORT PAYROLL-RIVERS QUIONNA DIANE,D108,HJ,2514.3,,54032.73
6100,7/15/2020,7/15/2020,71520,82L-IMPORT PAYROLL-SALIM YASSER,D108,HJ,2431.94,,56464.67
6100,7/15/2020,7/15/2020,71520,82L-IMPORT PAYROLL-SEJOUR MAHALIAH,D108,HJ,2500,,58964.67
6100,7/15/2020,7/15/2020,71520,82L-IMPORT PAYROLL-SKALSKI CHRISTOPHER,D108,HJ,2465,,61429.67
6100,7/15/2020,7/15/2020,71520,82L-IMPORT PAYROLL-SMITH AKILAH,D108,HJ,1173,,62602.67
6100,7/15/2020,7/15/2020,71520,82L-IMPORT PAYROLL-TAM CW RYAN,D108,HJ,1213.25,,63815.92
6100,7/15/2020,7/15/2020,71520,82L-IMPORT PAYROLL-TENESACA VERONICA A,D108,HJ,1219,,65034.92
6100,7/15/2020,7/15/2020,71520,82L-IMPORT PAYROLL-TUMENJARGAL ENKHJIN,D108,HJ,2414,,67448.92
6100,7/15/2020,7/15/2020,71520,82L-IMPORT PAYROLL-VILLEGAS EVELYN,D108,HJ,2817.75,,70266.67
6100,7/15/2020,7/15/2020,71520,82L-IMPORT PAYROLL-WOLF ANNA A,D108,HJ,2635,,72901.67
6100,7/15/2020,7/15/2020,71520,82L-PRPD-071520 -Import Payroll (PPP)-ACEVEDO MONIVETT,D103,HJ,2083.34,,74985.01
6100,7/15/2020,7/15/2020,71520,82L-PRPD-071520 -Import Payroll (PPP)-COOK CATHRYN ANNA,D105,HJ,1763.21,,76748.22
6100,7/15/2020,7/15/2020,71520,82L-PRPD-071520 -Import Payroll (PPP)-DETONE KYRA MAYA,D102,HJ,1458.34,,78206.56
6100,7/15/2020,7/15/2020,71520,82L-PRPD-071520 -Import Payroll (PPP)-DUPUIS CHRISTOPHER M,D108,HJ,2083.34,,80289.9
6100,7/15/2020,7/15/2020,71520,82L-PRPD-071520 -Import Payroll (PPP)-GUTIERREZ ANTONIO J,D102,HJ,2083.34,,82373.24
6100,7/15/2020,7/15/2020,71520,82L-PRPD-071520 -Import Payroll (PPP)-MASON ANGELA,D111,HJ,2083.34,,84456.58
6100,7/15/2020,7/15/2020,71520,82L-PRPD-071520 -Import Payroll (PPP)-POLANCO ODALIS,D103,HJ,1562.48,,86019.06
6100,7/15/2020,7/15/2020,71520,82L-PRPD-071520 -Import Payroll (PPP)-SAFRAN ALAN P,D102,HJ,2083.34,,88102.4
6100,7/15/2020,7/15/2020,71520,82L-PRPD-071520 -Import Payroll (PPP)-SHI GRACE,D103,HJ,418.1,,88520.5
6100,7/15/2020,7/15/2020,71520,82L-PRPD-071520 -Import Payroll (GENERL)-ACEVEDO MONIVETT,D103,HJ,3291.67,,91812.17
6100,7/15/2020,7/15/2020,71520,82L-PRPD-071520 -Import Payroll (GENERL)-COOK CATHRYN ANNA,D105,HJ,1596.9,,93409.07
6100,7/15/2020,7/15/2020,71520,82L-PRPD-071520 -Import Payroll (GENERL)-COOK CATHRYN ANNA,D105,HJ,1763.25,,95172.32
6100,7/15/2020,7/15/2020,71520,82L-PRPD-071520 -Import Payroll (GENERL)-DETONE KYRA MAYA,D102,HJ,1458.34,,96630.66
6100,7/15/2020,7/15/2020,71520,82L-PRPD-071520 -Import Payroll (GENERL)-GUTIERREZ ANTONIO J,D102,HJ,3443.8,,100074.46
6100,7/15/2020,7/15/2020,71520,82L-PRPD-071520 -Import Payroll (GENERL)-MASON ANGELA,D111,HJ,3627.61,,103702.07
6100,7/15/2020,7/15/2020,71520,82L-PRPD-071520 -Import Payroll (GENERL)-POLANCO ODALIS,D103,HJ,1562.48,,105264.55
6100,7/15/2020,7/15/2020,71520,82L-PRPD-071520 -Import Payroll (GENERL)-POLANCO ODALIS,D103,HJ,1875,,107139.55
6100,7/15/2020,7/15/2020,71520,82L-PRPD-071520 -Import Payroll (GENERL)-SAFRAN ALAN P,D102,HJ,5433.55,,112573.1
6100,7/15/2020,7/15/2020,71520,82L-PRPD-071520 -Import Payroll (GENERL)-SHI GRACE,D103,HJ,418.1,,112991.2
6100,7/15/2020,7/15/2020,71520,To reverse 82L payroll 0715 JE-21-0008-Reverse payroll entry 07152020 IMPORT PAYROLL,D102,HJ,,1458.34,111532.86
6100,7/15/2020,7/15/2020,71520,To reverse 82L payroll 0715 JE-21-0008-Reverse payroll entry 07152020 IMPORT PAYROLL,D102,HJ,,3443.8,108089.06
6100,7/15/2020,7/15/2020,71520,To reverse 82L payroll 0715 JE-21-0008-Reverse payroll entry 07152020 IMPORT PAYROLL,D102,HJ,,5433.55,102655.51
6100,7/15/2020,7/15/2020,71520,To reverse 82L payroll 0715 JE-21-0008-Reverse payroll entry 07152020 IMPORT PAYROLL,D103,HJ,,418.1,102237.41
6100,7/15/2020,7/15/2020,71520,To reverse 82L payroll 0715 JE-21-0008-Reverse payroll entry 07152020 IMPORT PAYROLL,D103,HJ,,1562.48,100674.93
6100,7/15/2020,7/15/2020,71520,To reverse 82L payroll 0715 JE-21-0008-Reverse payroll entry 07152020 IMPORT PAYROLL,D103,HJ,,1875,98799.93
6100,7/15/2020,7/15/2020,71520,To reverse 82L payroll 0715 JE-21-0008-Reverse payroll entry 07152020 IMPORT PAYROLL,D103,HJ,,3291.67,95508.26
6100,7/15/2020,7/15/2020,71520,To reverse 82L payroll 0715 JE-21-0008-Reverse payroll entry 07152020 IMPORT PAYROLL,D105,HJ,,1596.9,93911.36
6100,7/15/2020,7/15/2020,71520,To reverse 82L payroll 0715 JE-21-0008-Reverse payroll entry 07152020 IMPORT PAYROLL,D105,HJ,,1763.25,92148.11
6100,7/15/2020,7/15/2020,71520,To reverse 82L payroll 0715 JE-21-0008-Reverse payroll entry 07152020 IMPORT PAYROLL,D111,HJ,,3627.61,88520.5
6100,7/15/2020,7/15/2020,71520,82L-IMPORT PAYROLL-ACEVEDO MONIVETT,D107,HJ,3291.67,,91812.17
6100,7/15/2020,7/15/2020,71520,82L-IMPORT PAYROLL-AKLESTAD ISABEL,D111,HJ,2073.06,,93885.23
6100,7/15/2020,7/15/2020,71520,82L-IMPORT PAYROLL-ALLEN KIMBERLY MARY,D111,HJ,2171.78,,96057.01
6100,7/15/2020,7/15/2020,71520,82L-IMPORT PAYROLL-BOWMAN HALLEY K,D101,HJ,1500,,97557.01
6100,7/15/2020,7/15/2020,71520,82L-IMPORT PAYROLL-BOWMAN HALLEY K,D101,HJ,3375,,100932.01
6100,7/15/2020,7/15/2020,71520,82L-IMPORT PAYROLL-COOK CATHRYN ANNA,D105,HJ,1596.9,,102528.91
6100,7/15/2020,7/15/2020,71520,82L-IMPORT PAYROLL-COOK CATHRYN ANNA,D105,HJ,1763.25,,104292.16
6100,7/15/2020,7/15/2020,71520,82L-IMPORT PAYROLL-COOPER ASHLEE R,D101,HJ,2486.25,,106778.41
6100,7/15/2020,7/15/2020,71520,82L-IMPORT PAYROLL-CORTEZ MIRANDA A,D111,HJ,895.05,,107673.46
6100,7/15/2020,7/15/2020,71520,82L-IMPORT PAYROLL-CORTEZ MIRANDA A,D111,HJ,2635.43,,110308.89
6100,7/15/2020,7/15/2020,71520,82L-IMPORT PAYROLL-DAUGHERTY DEVIN W,D101,HJ,1041.67,,111350.56
6100,7/15/2020,7/15/2020,71520,82L-IMPORT PAYROLL-DETONE KYRA MAYA,D102,HJ,1458.34,,112808.9
6100,7/15/2020,7/15/2020,71520,82L-IMPORT PAYROLL-DUPUIS CHRISTOPHER M,D107,HJ,4187.49,,116996.39
6100,7/15/2020,7/15/2020,71520,82L-IMPORT PAYROLL-DZIEDZIC JULIE K,D101,HJ,1250,,118246.39
6100,7/15/2020,7/15/2020,71520,82L-IMPORT PAYROLL-GORNSTEIN STEVEN,D101,HJ,2708.33,,120954.72
6100,7/15/2020,7/15/2020,71520,82L-IMPORT PAYROLL-GRAVES KAMIESHIA,D101,HJ,1346.1,,122300.82
6100,7/15/2020,7/15/2020,71520,82L-IMPORT PAYROLL-GUADARRAMA-ALVAREZ URIEL A,D105,HJ,1300,,123600.82
6100,7/15/2020,7/15/2020,71520,82L-IMPORT PAYROLL-GUADARRAMA-ALVAREZ URIEL A,D105,HJ,2897.92,,126498.74
6100,7/15/2020,7/15/2020,71520,82L-IMPORT PAYROLL-GUTIERREZ ANTONIO J,D107,HJ,3443.79,,129942.53
6100,7/15/2020,7/15/2020,71520,82L-IMPORT PAYROLL-LACEY DEQUITA,D107,HJ,2698.75,,132641.28
6100,7/15/2020,7/15/2020,71520,82L-IMPORT PAYROLL-LIPORACE HERNAN LUIS,D103,HJ,1692.24,,134333.52
6100,7/15/2020,7/15/2020,71520,82L-IMPORT PAYROLL-MASON ANGELA,D107,HJ,3627.6,,137961.12
6100,7/15/2020,7/15/2020,71520,82L-IMPORT PAYROLL-ODONNELL STEPHEN,D104,HJ,1000,,138961.12
6100,7/15/2020,7/15/2020,71520,82L-IMPORT PAYROLL-ODONNELL STEPHEN,D104,HJ,2707.5,,141668.62
6100,7/15/2020,7/15/2020,71520,82L-IMPORT PAYROLL-PARHAM-GANTT DENISE M,D112,HJ,3041.67,,144710.29
6100,7/15/2020,7/15/2020,71520,82L-IMPORT PAYROLL-PEINADO ELIZABETH R,D111,HJ,3749.96,,148460.25
6100,7/15/2020,7/15/2020,71520,82L-IMPORT PAYROLL-POLANCO ODALIS,D103,HJ,1562.48,,150022.73
6100,7/15/2020,7/15/2020,71520,82L-IMPORT PAYROLL-POLANCO ODALIS,D103,HJ,1875,,151897.73
6100,7/15/2020,7/15/2020,71520,82L-IMPORT PAYROLL-RANDOLPH ALEXANDER,D111,HJ,2221.14,,154118.87
6100,7/15/2020,7/15/2020,71520,82L-IMPORT PAYROLL-SAFRAN ALAN P,D107,HJ,5433.54,,159552.41
6100,7/15/2020,7/15/2020,71520,82L-IMPORT PAYROLL-SHENKMAN OLIVIA,D101,HJ,2000,,161552.41
6100,7/15/2020,7/15/2020,71520,82L-IMPORT PAYROLL-SHI GRACE,D103,HJ,418.09,,161970.5
6100,7/15/2020,7/15/2020,71520,82L-IMPORT PAYROLL-WALLACE AMENA T,D104,HJ,2187.5,,164158
6100,7/15/2020,7/15/2020,71520,82L-IMPORT PAYROLL-WEINSTOCK EMILY,D101,HJ,2833.33,,166991.33
6100,7/15/2020,7/15/2020,71520,82L-IMPORT PAYROLL-WINANS JENNIFER,D111,HJ,570,,167561.33
6100,7/15/2020,7/15/2020,71520,82L-IMPORT PAYROLL-WINANS JENNIFER,D111,HJ,2505.63,,170066.96
6100,7/15/2020,7/15/2020,71520,82L-IMPORT PAYROLL-ZARATE JOSEPH M,D105,HJ,2329,,172395.96
6100,7/15/2020,7/15/2020,71520,82L-IMPORT PAYROLL-BARTOLD DEANNA MARIE,D108,HJ,3034.5,,175430.46
6100,7/15/2020,7/15/2020,71520,82L-IMPORT PAYROLL-BELLOT GENESIS,D108,HJ,1292.26,,176722.72
6100,7/15/2020,7/15/2020,71520,82L-IMPORT PAYROLL-CIRKER MIA,D108,HJ,1453.79,,178176.51
6100,7/15/2020,7/15/2020,71520,82L-IMPORT PAYROLL-FEIGHERY JOHN,D108,HJ,1453.79,,179630.3
6100,7/15/2020,7/15/2020,71520,82L-IMPORT PAYROLL-GARCIA MARILYN,D108,HJ,1480.71,,181111.01
6100,7/15/2020,7/15/2020,71520,82L-IMPORT PAYROLL-GARNER IVORY,D108,HJ,1680,,182791.01
6100,7/15/2020,7/15/2020,71520,82L-IMPORT PAYROLL-GRIFFIN ANDREW,D108,HJ,1246.1,,184037.11
6100,7/15/2020,7/15/2020,71520,82L-IMPORT PAYROLL-HALLINAN GABRIEL B,D108,HJ,2550,,186587.11
6100,7/15/2020,7/15/2020,71520,82L-IMPORT PAYROLL-HOLDER LATIVA M,D108,HJ,1400,,187987.11
6100,7/15/2020,7/15/2020,71520,82L-IMPORT PAYROLL-HOLDER LATIVA M,D108,HJ,3812.5,,191799.61
6100,7/15/2020,7/15/2020,71520,82L-IMPORT PAYROLL-HOSSAIN MYESHA R,D108,HJ,2486.25,,194285.86
6100,7/15/2020,7/15/2020,71520,82L-IMPORT PAYROLL-JACKSON TASNIM F,D108,HJ,2291.67,,196577.53
6100,7/15/2020,7/15/2020,71520,82L-IMPORT PAYROLL-LI BELLA,D108,HJ,2486.25,,199063.78
6100,7/15/2020,7/15/2020,71520,82L-IMPORT PAYROLL-MOSELEY ARIELLE,D108,HJ,2752.73,,201816.51
6100,7/15/2020,7/15/2020,71520,82L-IMPORT PAYROLL-TILLERY ASIA,D108,HJ,3291.67,,205108.18
6100,7/15/2020,7/15/2020,71520,82L-IMPORT PAYROLL-BALASUBRAMANIAN SHARANYA,D108,HJ,2666.67,,207774.85
6100,7/15/2020,7/15/2020,71520,82L-IMPORT PAYROLL-COVENEY ALLISON,D108,HJ,2854.17,,210629.02
6100,7/15/2020,7/15/2020,71520,82L-IMPORT PAYROLL-GRAVES KIRA B,D101,HJ,2605.83,,213234.85
6100,7/15/2020,7/15/2020,71520,82L-IMPORT PAYROLL-JACKSON CLAICE M,D108,HJ,865.35,,214100.2
6100,7/15/2020,7/15/2020,71520,82L-IMPORT PAYROLL-JACKSON CLAICE M,D108,HJ,3125,,217225.2
6100,7/15/2020,7/15/2020,71520,82L-IMPORT PAYROLL-JANG DANIEL,D108,HJ,2750,,219975.2
6100,7/15/2020,7/15/2020,71520,82L-IMPORT PAYROLL-LENEGHAN MARYELLEN B,D108,HJ,212.5,,220187.7
6100,7/15/2020,7/15/2020,71520,82L-IMPORT PAYROLL-LENEGHAN MARYELLEN B,D108,HJ,1400,,221587.7
6100,7/15/2020,7/15/2020,71520,82L-IMPORT PAYROLL-LENEGHAN MARYELLEN B,D108,HJ,3812.5,,225400.2
6100,7/31/2020,7/31/2020,73120,82L-IMPORT PAYROLL-ALVAREZ-MORINE LISIS,D108,HJ,2346.06,,227746.26
6100,7/31/2020,7/31/2020,73120,82L-IMPORT PAYROLL-KOPSHEVER MELISSA,D108,HJ,2916.67,,230662.93
6100,7/31/2020,7/31/2020,73120,82L-IMPORT PAYROLL-LIPSCOMB STEPHEN,D108,HJ,2111.46,,232774.39
6100,7/31/2020,7/31/2020,73120,82L-IMPORT PAYROLL-ROBBINS DEANNA,D108,HJ,2541.67,,235316.06
6100,7/31/2020,7/31/2020,73120,82L-IMPORT PAYROLL-SILVER KELLY,D108,HJ,2346.06,,237662.12
6100,7/31/2020,7/31/2020,73120,82L-PRPD-073120 -Import Payroll-ACEVEDO MONIVETT,D108,HJ,5375,,243037.12
6100,7/31/2020,7/31/2020,73120,82L-PRPD-073120 -Import Payroll-AKLESTAD ISABEL,D108,HJ,1750,,244787.12
6100,7/31/2020,7/31/2020,73120,82L-PRPD-073120 -Import Payroll-ALLEN KIMBERLY MARY,D108,HJ,1833.33,,246620.45
6100,7/31/2020,7/31/2020,73120,82L-PRPD-073120 -Import Payroll-ALVAREZ-MORINE LISIS,D108,HJ,2346.06,,248966.51
6100,7/31/2020,7/31/2020,73120,82L-PRPD-073120 -Import Payroll-ANTHONY BETTY S,D108,HJ,2886.52,,251853.03
6100,7/31/2020,7/31/2020,73120,82L-PRPD-073120 -Import Payroll-ARCHER AUBREYNA,D108,HJ,2750,,254603.03
6100,7/31/2020,7/31/2020,73120,82L-PRPD-073120 -Import Payroll-AUSTIN PERCY,D108,HJ,2653.02,,257256.05
6100,7/31/2020,7/31/2020,73120,82L-PRPD-073120 -Import Payroll-BALASUBRAMANIAN SHARANYA,D108,HJ,2666.67,,259922.72
6100,7/31/2020,7/31/2020,73120,82L-PRPD-073120 -Import Payroll-BANDA STEPHANY,D108,HJ,1253.5,,261176.22
6100,7/31/2020,7/31/2020,73120,82L-PRPD-073120 -Import Payroll-BARTOLD DEANNA MARIE,D108,HJ,3034.5,,264210.72
6100,7/31/2020,7/31/2020,73120,82L-PRPD-073120 -Import Payroll-BAUSH DANIEL,D108,HJ,1750,,265960.72
6100,7/31/2020,7/31/2020,73120,82L-PRPD-073120 -Import Payroll-BAUSH DANIEL,D108,HJ,2762.5,,268723.22
6100,7/31/2020,7/31/2020,73120,82L-PRPD-073120 -Import Payroll-BELLOT GENESIS,D108,HJ,2333.33,,271056.55
6100,7/31/2020,7/31/2020,73120,82L-PRPD-073120 -Import Payroll-BOWMAN HALLEY K,D108,HJ,3437.5,,274494.05
6100,7/31/2020,7/31/2020,73120,82L-PRPD-073120 -Import Payroll-CHAPMAN CLAUDY EARL,D108,HJ,1833.33,,276327.38
6100,7/31/2020,7/31/2020,73120,82L-PRPD-073120 -Import Payroll-CIRKER MIA,D108,HJ,2250,,278577.38
6100,7/31/2020,7/31/2020,73120,82L-PRPD-073120 -Import Payroll-COOK CATHRYN ANNA,D108,HJ,3593.03,,282170.41
6100,7/31/2020,7/31/2020,73120,82L-PRPD-073120 -Import Payroll-COOPER ASHLEE R,D108,HJ,2461.88,,284632.29
6100,7/31/2020,7/31/2020,73120,82L-PRPD-073120 -Import Payroll-CORTEZ MIRANDA A,D108,HJ,2672.72,,287305.01
6100,7/31/2020,7/31/2020,73120,82L-PRPD-073120 -Import Payroll-COVENEY ALLISON,D108,HJ,2854.17,,290159.18
6100,7/31/2020,7/31/2020,73120,82L-PRPD-073120 -Import Payroll-DADA ARIKPO E,D108,HJ,2720,,292879.18
6100,7/31/2020,7/31/2020,73120,82L-PRPD-073120 -Import Payroll-DAUGHERTY DEVIN W,D108,HJ,1041.67,,293920.85
6100,7/31/2020,7/31/2020,73120,82L-PRPD-073120 -Import Payroll-DETONE KYRA MAYA,D108,HJ,2916.67,,296837.52
6100,7/31/2020,7/31/2020,73120,82L-PRPD-073120 -Import Payroll-DUPUIS CHRISTOPHER M,D108,HJ,6270.83,,303108.35
6100,7/31/2020,7/31/2020,73120,82L-PRPD-073120 -Import Payroll-DZIEDZIC JULIE K,D108,HJ,1250,,304358.35
6100,7/31/2020,7/31/2020,73120,82L-PRPD-073120 -Import Payroll-FEIGHERY JOHN,D108,HJ,2250,,306608.35
6100,7/31/2020,7/31/2020,73120,82L-PRPD-073120 -Import Payroll-GARCIA MARILYN,D108,HJ,2291.67,,308900.02
6100,7/31/2020,7/31/2020,73120,82L-PRPD-073120 -Import Payroll-GARNER IVORY,D108,HJ,1824,,310724.02
6100,7/31/2020,7/31/2020,73120,82L-PRPD-073120 -Import Payroll-GORNSTEIN STEVEN,D108,HJ,2708.33,,313432.35
6100,7/31/2020,7/31/2020,73120,82L-PRPD-073120 -Import Payroll-GRAVES KAMIESHIA,D108,HJ,2083.33,,315515.68
6100,7/31/2020,7/31/2020,73120,82L-PRPD-073120 -Import Payroll-GRAVES KIRA B,D108,HJ,481.06,,315996.74
6100,7/31/2020,7/31/2020,73120,82L-PRPD-073120 -Import Payroll-GRIFFIN ANDREW,D108,HJ,2250,,318246.74
6100,7/31/2020,7/31/2020,73120,82L-PRPD-073120 -Import Payroll-GUADARRAMA-ALVAREZ URIEL A,D108,HJ,2897.92,,321144.66
6100,7/31/2020,7/31/2020,73120,82L-PRPD-073120 -Import Payroll-GUTHRIE LESLIE,D108,HJ,2458.33,,323602.99
6100,7/31/2020,7/31/2020,73120,82L-PRPD-073120 -Import Payroll-GUTIERREZ ANTONIO J,D108,HJ,5527.13,,329130.12
6100,7/31/2020,7/31/2020,73120,82L-PRPD-073120 -Import Payroll-HALLINAN GABRIEL B,D108,HJ,2550,,331680.12
6100,7/31/2020,7/31/2020,73120,82L-PRPD-073120 -Import Payroll-HESTER TYLER CONRAD,D108,HJ,176.92,,331857.04
6100,7/31/2020,7/31/2020,73120,82L-PRPD-073120 -Import Payroll-HESTER TYLER CONRAD,D108,HJ,1916.67,,333773.71
6100,7/31/2020,7/31/2020,73120,82L-PRPD-073120 -Import Payroll-HOLDER LATIVA M,D108,HJ,3812.5,,337586.21
6100,7/31/2020,7/31/2020,73120,82L-PRPD-073120 -Import Payroll-HOLMES JOREL ALEXANDER,D108,HJ,2329,,339915.21
6100,7/31/2020,7/31/2020,73120,82L-PRPD-073120 -Import Payroll-HOSSAIN MYESHA R,D108,HJ,2437.5,,342352.71
6100,7/31/2020,7/31/2020,73120,82L-PRPD-073120 -Import Payroll-JACKSON CLAICE M,D108,HJ,3125,,345477.71
6100,7/31/2020,7/31/2020,73120,82L-PRPD-073120 -Import Payroll-JACKSON TASNIM F,D108,HJ,2291.67,,347769.38
6100,7/31/2020,7/31/2020,73120,82L-PRPD-073120 -Import Payroll-JANG DANIEL,D108,HJ,2750,,350519.38
6100,7/31/2020,7/31/2020,73120,82L-PRPD-073120 -Import Payroll-JORDAN TIFFANY T,D108,HJ,3445,,353964.38
6100,7/31/2020,7/31/2020,73120,82L-PRPD-073120 -Import Payroll-KALOKOH BAINDU,D108,HJ,1307.64,,355272.02
6100,7/31/2020,7/31/2020,73120,82L-PRPD-073120 -Import Payroll-KOPSHEVER MELISSA,D108,HJ,2916.67,,358188.69
6100,7/31/2020,7/31/2020,73120,82L-PRPD-073120 -Import Payroll-LACEY DEQUITA,D108,HJ,2698.75,,360887.44
6100,7/31/2020,7/31/2020,73120,82L-PRPD-073120 -Import Payroll-LANIGAN LISA A,D108,HJ,3113.75,,364001.19
6100,7/31/2020,7/31/2020,73120,82L-PRPD-073120 -Import Payroll-LENEGHAN MARYELLEN B,D108,HJ,3812.5,,367813.69
6100,7/31/2020,7/31/2020,73120,82L-PRPD-073120 -Import Payroll-LEVERET LILY A,D108,HJ,1253.5,,369067.19
6100,7/31/2020,7/31/2020,73120,82L-PRPD-073120 -Import Payroll-LI BELLA,D108,HJ,2486.25,,371553.44
6100,7/31/2020,7/31/2020,73120,82L-PRPD-073120 -Import Payroll-LIPORACE HERNAN LUIS,D108,HJ,2291.67,,373845.11
6100,7/31/2020,7/31/2020,73120,82L-PRPD-073120 -Import Payroll-LIPSCOMB STEPHEN,D108,HJ,2111.46,,375956.57
6100,7/31/2020,7/31/2020,73120,82L-PRPD-073120 -Import Payroll-MASON ANGELA,D108,HJ,5710.94,,381667.51
6100,7/31/2020,7/31/2020,73120,82L-PRPD-073120 -Import Payroll-MCELWEE MELISSA,D108,HJ,2666.67,,384334.18
6100,7/31/2020,7/31/2020,73120,82L-PRPD-073120 -Import Payroll-MCNICHOLAS MARY,D108,HJ,2291.67,,386625.85
6100,7/31/2020,7/31/2020,73120,82L-PRPD-073120 -Import Payroll-MOSELEY ARIELLE,D108,HJ,2752.73,,389378.58
6100,7/31/2020,7/31/2020,73120,82L-PRPD-073120 -Import Payroll-NWAKANMA NANCY,D108,HJ,2918.31,,392296.89
6100,7/31/2020,7/31/2020,73120,82L-PRPD-073120 -Import Payroll-ODONNELL STEPHEN,D108,HJ,2749.17,,395046.06
6100,7/31/2020,7/31/2020,73120,82L-PRPD-073120 -Import Payroll-ONICA ANTHONY J,D108,HJ,2416.67,,397462.73
6100,7/31/2020,7/31/2020,73120,82L-PRPD-073120 -Import Payroll-PARETS MALLORY GRACE,D108,HJ,523.06,,397985.79
6100,7/31/2020,7/31/2020,73120,82L-PRPD-073120 -Import Payroll-PARETS MALLORY GRACE,D108,HJ,2833.33,,400819.12
6100,7/31/2020,7/31/2020,73120,82L-PRPD-073120 -Import Payroll-PARHAM-GANTT DENISE M,D108,HJ,3041.67,,403860.79
6100,7/31/2020,7/31/2020,73120,82L-PRPD-073120 -Import Payroll-PEINADO ELIZABETH R,D108,HJ,3749.96,,407610.75
6100,7/31/2020,7/31/2020,73120,82L-PRPD-073120 -Import Payroll-POLANCO ODALIS,D108,HJ,3124.96,,410735.71
6100,7/31/2020,7/31/2020,73120,82L-PRPD-073120 -Import Payroll-PRAHIN NICOLE M,D108,HJ,3812.5,,414548.21
6100,7/31/2020,7/31/2020,73120,82L-PRPD-073120 -Import Payroll-RANDOLPH ALEXANDER,D108,HJ,1875,,416423.21
6100,7/31/2020,7/31/2020,73120,82L-PRPD-073120 -Import Payroll-RIVERS QUIONNA DIANE,D108,HJ,2514.3,,418937.51
6100,7/31/2020,7/31/2020,73120,82L-PRPD-073120 -Import Payroll-ROBBINS DEANNA,D108,HJ,2541.67,,421479.18
6100,7/31/2020,7/31/2020,73120,82L-PRPD-073120 -Import Payroll-SAFRAN ALAN P,D108,HJ,7378.57,,428857.75
6100,7/31/2020,7/31/2020,73120,82L-PRPD-073120 -Import Payroll-SALIM YASSER,D108,HJ,2431.94,,431289.69
6100,7/31/2020,7/31/2020,73120,82L-PRPD-073120 -Import Payroll-SEJOUR MAHALIAH,D108,HJ,2500,,433789.69
6100,7/31/2020,7/31/2020,73120,82L-PRPD-073120 -Import Payroll-SHENKMAN OLIVIA,D108,HJ,2000,,435789.69
6100,7/31/2020,7/31/2020,73120,82L-PRPD-073120 -Import Payroll-SHI GRACE,D108,HJ,875,,436664.69
6100,7/31/2020,7/31/2020,73120,82L-PRPD-073120 -Import Payroll-SILVER KELLY,D108,HJ,2346.06,,439010.75
6100,7/31/2020,7/31/2020,73120,82L-PRPD-073120 -Import Payroll-SKALSKI CHRISTOPHER,D108,HJ,2465,,441475.75
6100,7/31/2020,7/31/2020,73120,82L-PRPD-073120 -Import Payroll-SMITH AKILAH,D108,HJ,1385.75,,442861.5
6100,7/31/2020,7/31/2020,73120,82L-PRPD-073120 -Import Payroll-TAM CW RYAN,D108,HJ,1477.75,,444339.25
6100,7/31/2020,7/31/2020,73120,82L-PRPD-073120 -Import Payroll-TENESACA VERONICA A,D108,HJ,1322.5,,445661.75
6100,7/31/2020,7/31/2020,73120,82L-PRPD-073120 -Import Payroll-TILLERY ASIA,D108,HJ,3291.67,,448953.42
6100,7/31/2020,7/31/2020,73120,82L-PRPD-073120 -Import Payroll-TUMENJARGAL ENKHJIN,D108,HJ,2414,,451367.42
6100,7/31/2020,7/31/2020,73120,82L-PRPD-073120 -Import Payroll-VILLEGAS EVELYN,D108,HJ,2817.75,,454185.17
6100,7/31/2020,7/31/2020,73120,82L-PRPD-073120 -Import Payroll-WALLACE AMENA T,D108,HJ,2187.5,,456372.67
6100,7/31/2020,7/31/2020,73120,82L-PRPD-073120 -Import Payroll-WEINSTOCK EMILY,D108,HJ,2833.33,,459206
6100,7/31/2020,7/31/2020,73120,82L-PRPD-073120 -Import Payroll-WINANS JENNIFER,D108,HJ,2505.63,,461711.63
6100,7/31/2020,7/31/2020,73120,82L-PRPD-073120 -Import Payroll-WOLF ANNA A,D108,HJ,2635,,464346.63
6100,7/31/2020,7/31/2020,73120,82L-PRPD-073120 -Import Payroll-ZARATE JOSEPH M,D108,HJ,2150,,466496.63
6100,7/31/2020,7/31/2020,73120,To reverse 82L payroll 73120-To reverse 82L payroll of 73120 JE-21-0003,D108,HJ,,176.92,466319.71
6100,7/31/2020,7/31/2020,73120,To reverse 82L payroll 73120-To reverse 82L payroll of 73120 JE-21-0003,D108,HJ,,481.06,465838.65
6100,7/31/2020,7/31/2020,73120,To reverse 82L payroll 73120-To reverse 82L payroll of 73120 JE-21-0003,D108,HJ,,523.06,465315.59
6100,7/31/2020,7/31/2020,73120,To reverse 82L payroll 73120-To reverse 82L payroll of 73120 JE-21-0003,D108,HJ,,875,464440.59
6100,7/31/2020,7/31/2020,73120,To reverse 82L payroll 73120-To reverse 82L payroll of 73120 JE-21-0003,D108,HJ,,1041.67,463398.92
6100,7/31/2020,7/31/2020,73120,To reverse 82L payroll 73120-To reverse 82L payroll of 73120 JE-21-0003,D108,HJ,,1250,462148.92
6100,7/31/2020,7/31/2020,73120,To reverse 82L payroll 73120-To reverse 82L payroll of 73120 JE-21-0003,D108,HJ,,1253.5,460895.42
6100,7/31/2020,7/31/2020,73120,To reverse 82L payroll 73120-To reverse 82L payroll of 73120 JE-21-0003,D108,HJ,,1253.5,459641.92
6100,7/31/2020,7/31/2020,73120,To reverse 82L payroll 73120-To reverse 82L payroll of 73120 JE-21-0003,D108,HJ,,1307.64,458334.28
6100,7/31/2020,7/31/2020,73120,To reverse 82L payroll 73120-To reverse 82L payroll of 73120 JE-21-0003,D108,HJ,,1322.5,457011.78
6100,7/31/2020,7/31/2020,73120,To reverse 82L payroll 73120-To reverse 82L payroll of 73120 JE-21-0003,D108,HJ,,1385.75,455626.03
6100,7/31/2020,7/31/2020,73120,To reverse 82L payroll 73120-To reverse 82L payroll of 73120 JE-21-0003,D108,HJ,,1477.75,454148.28
6100,7/31/2020,7/31/2020,73120,To reverse 82L payroll 73120-To reverse 82L payroll of 73120 JE-21-0003,D108,HJ,,1750,452398.28
6100,7/31/2020,7/31/2020,73120,To reverse 82L payroll 73120-To reverse 82L payroll of 73120 JE-21-0003,D108,HJ,,1750,450648.28
6100,7/31/2020,7/31/2020,73120,To reverse 82L payroll 73120-To reverse 82L payroll of 73120 JE-21-0003,D108,HJ,,1824,448824.28
6100,7/31/2020,7/31/2020,73120,To reverse 82L payroll 73120-To reverse 82L payroll of 73120 JE-21-0003,D108,HJ,,1833.33,446990.95
6100,7/31/2020,7/31/2020,73120,To reverse 82L payroll 73120-To reverse 82L payroll of 73120 JE-21-0003,D108,HJ,,1833.33,445157.62
6100,7/31/2020,7/31/2020,73120,To reverse 82L payroll 73120-To reverse 82L payroll of 73120 JE-21-0003,D108,HJ,,1875,443282.62
6100,7/31/2020,7/31/2020,73120,To reverse 82L payroll 73120-To reverse 82L payroll of 73120 JE-21-0003,D108,HJ,,1916.67,441365.95
6100,7/31/2020,7/31/2020,73120,To reverse 82L payroll 73120-To reverse 82L payroll of 73120 JE-21-0003,D108,HJ,,2000,439365.95
6100,7/31/2020,7/31/2020,73120,To reverse 82L payroll 73120-To reverse 82L payroll of 73120 JE-21-0003,D108,HJ,,2083.33,437282.62
6100,7/31/2020,7/31/2020,73120,To reverse 82L payroll 73120-To reverse 82L payroll of 73120 JE-21-0003,D108,HJ,,2111.46,435171.16
6100,7/31/2020,7/31/2020,73120,To reverse 82L payroll 73120-To reverse 82L payroll of 73120 JE-21-0003,D108,HJ,,2150,433021.16
6100,7/31/2020,7/31/2020,73120,To reverse 82L payroll 73120-To reverse 82L payroll of 73120 JE-21-0003,D108,HJ,,2187.5,430833.66
6100,7/31/2020,7/31/2020,73120,To reverse 82L payroll 73120-To reverse 82L payroll of 73120 JE-21-0003,D108,HJ,,2250,428583.66
6100,7/31/2020,7/31/2020,73120,To reverse 82L payroll 73120-To reverse 82L payroll of 73120 JE-21-0003,D108,HJ,,2250,426333.66
6100,7/31/2020,7/31/2020,73120,To reverse 82L payroll 73120-To reverse 82L payroll of 73120 JE-21-0003,D108,HJ,,2250,424083.66
6100,7/31/2020,7/31/2020,73120,To reverse 82L payroll 73120-To reverse 82L payroll of 73120 JE-21-0003,D108,HJ,,2291.67,421791.99
6100,7/31/2020,7/31/2020,73120,To reverse 82L payroll 73120-To reverse 82L payroll of 73120 JE-21-0003,D108,HJ,,2291.67,419500.32
6100,7/31/2020,7/31/2020,73120,To reverse 82L payroll 73120-To reverse 82L payroll of 73120 JE-21-0003,D108,HJ,,2291.67,417208.65
6100,7/31/2020,7/31/2020,73120,To reverse 82L payroll 73120-To reverse 82L payroll of 73120 JE-21-0003,D108,HJ,,2291.67,414916.98
6100,7/31/2020,7/31/2020,73120,To reverse 82L payroll 73120-To reverse 82L payroll of 73120 JE-21-0003,D108,HJ,,2329,412587.98
6100,7/31/2020,7/31/2020,73120,To reverse 82L payroll 73120-To reverse 82L payroll of 73120 JE-21-0003,D108,HJ,,2333.33,410254.65
6100,7/31/2020,7/31/2020,73120,To reverse 82L payroll 73120-To reverse 82L payroll of 73120 JE-21-0003,D108,HJ,,2346.06,407908.59
6100,7/31/2020,7/31/2020,73120,To reverse 82L payroll 73120-To reverse 82L payroll of 73120 JE-21-0003,D108,HJ,,2346.06,405562.53
6100,7/31/2020,7/31/2020,73120,To reverse 82L payroll 73120-To reverse 82L payroll of 73120 JE-21-0003,D108,HJ,,2414,403148.53
6100,7/31/2020,7/31/2020,73120,To reverse 82L payroll 73120-To reverse 82L payroll of 73120 JE-21-0003,D108,HJ,,2416.67,400731.86
6100,7/31/2020,7/31/2020,73120,To reverse 82L payroll 73120-To reverse 82L payroll of 73120 JE-21-0003,D108,HJ,,2431.94,398299.92
6100,7/31/2020,7/31/2020,73120,To reverse 82L payroll 73120-To reverse 82L payroll of 73120 JE-21-0003,D108,HJ,,2437.5,395862.42
6100,7/31/2020,7/31/2020,73120,To reverse 82L payroll 73120-To reverse 82L payroll of 73120 JE-21-0003,D108,HJ,,2458.33,393404.09
6100,7/31/2020,7/31/2020,73120,To reverse 82L payroll 73120-To reverse 82L payroll of 73120 JE-21-0003,D108,HJ,,2461.88,390942.21
6100,7/31/2020,7/31/2020,73120,To reverse 82L payroll 73120-To reverse 82L payroll of 73120 JE-21-0003,D108,HJ,,2465,388477.21
6100,7/31/2020,7/31/2020,73120,To reverse 82L payroll 73120-To reverse 82L payroll of 73120 JE-21-0003,D108,HJ,,2486.25,385990.96
6100,7/31/2020,7/31/2020,73120,To reverse 82L payroll 73120-To reverse 82L payroll of 73120 JE-21-0003,D108,HJ,,2500,383490.96
6100,7/31/2020,7/31/2020,73120,To reverse 82L payroll 73120-To reverse 82L payroll of 73120 JE-21-0003,D108,HJ,,2505.63,380985.33
6100,7/31/2020,7/31/2020,73120,To reverse 82L payroll 73120-To reverse 82L payroll of 73120 JE-21-0003,D108,HJ,,2514.3,378471.03
6100,7/31/2020,7/31/2020,73120,To reverse 82L payroll 73120-To reverse 82L payroll of 73120 JE-21-0003,D108,HJ,,2541.67,375929.36
6100,7/31/2020,7/31/2020,73120,To reverse 82L payroll 73120-To reverse 82L payroll of 73120 JE-21-0003,D108,HJ,,2550,373379.36
6100,7/31/2020,7/31/2020,73120,To reverse 82L payroll 73120-To reverse 82L payroll of 73120 JE-21-0003,D108,HJ,,2635,370744.36
6100,7/31/2020,7/31/2020,73120,To reverse 82L payroll 73120-To reverse 82L payroll of 73120 JE-21-0003,D108,HJ,,2653.02,368091.34
6100,7/31/2020,7/31/2020,73120,To reverse 82L payroll 73120-To reverse 82L payroll of 73120 JE-21-0003,D108,HJ,,2666.67,365424.67
6100,7/31/2020,7/31/2020,73120,To reverse 82L payroll 73120-To reverse 82L payroll of 73120 JE-21-0003,D108,HJ,,2666.67,362758
6100,7/31/2020,7/31/2020,73120,To reverse 82L payroll 73120-To reverse 82L payroll of 73120 JE-21-0003,D108,HJ,,2672.72,360085.28
6100,7/31/2020,7/31/2020,73120,To reverse 82L payroll 73120-To reverse 82L payroll of 73120 JE-21-0003,D108,HJ,,2698.75,357386.53
6100,7/31/2020,7/31/2020,73120,To reverse 82L payroll 73120-To reverse 82L payroll of 73120 JE-21-0003,D108,HJ,,2708.33,354678.2
6100,7/31/2020,7/31/2020,73120,To reverse 82L payroll 73120-To reverse 82L payroll of 73120 JE-21-0003,D108,HJ,,2720,351958.2
6100,7/31/2020,7/31/2020,73120,To reverse 82L payroll 73120-To reverse 82L payroll of 73120 JE-21-0003,D108,HJ,,2749.17,349209.03
6100,7/31/2020,7/31/2020,73120,To reverse 82L payroll 73120-To reverse 82L payroll of 73120 JE-21-0003,D108,HJ,,2750,346459.03
6100,7/31/2020,7/31/2020,73120,To reverse 82L payroll 73120-To reverse 82L payroll of 73120 JE-21-0003,D108,HJ,,2750,343709.03
6100,7/31/2020,7/31/2020,73120,To reverse 82L payroll 73120-To reverse 82L payroll of 73120 JE-21-0003,D108,HJ,,2752.73,340956.3
6100,7/31/2020,7/31/2020,73120,To reverse 82L payroll 73120-To reverse 82L payroll of 73120 JE-21-0003,D108,HJ,,2762.5,338193.8
6100,7/31/2020,7/31/2020,73120,To reverse 82L payroll 73120-To reverse 82L payroll of 73120 JE-21-0003,D108,HJ,,2817.75,335376.05
6100,7/31/2020,7/31/2020,73120,To reverse 82L payroll 73120-To reverse 82L payroll of 73120 JE-21-0003,D108,HJ,,2833.33,332542.72
6100,7/31/2020,7/31/2020,73120,To reverse 82L payroll 73120-To reverse 82L payroll of 73120 JE-21-0003,D108,HJ,,2833.33,329709.39
6100,7/31/2020,7/31/2020,73120,To reverse 82L payroll 73120-To reverse 82L payroll of 73120 JE-21-0003,D108,HJ,,2854.17,326855.22
6100,7/31/2020,7/31/2020,73120,To reverse 82L payroll 73120-To reverse 82L payroll of 73120 JE-21-0003,D108,HJ,,2886.52,323968.7
6100,7/31/2020,7/31/2020,73120,To reverse 82L payroll 73120-To reverse 82L payroll of 73120 JE-21-0003,D108,HJ,,2897.92,321070.78
6100,7/31/2020,7/31/2020,73120,To reverse 82L payroll 73120-To reverse 82L payroll of 73120 JE-21-0003,D108,HJ,,2916.67,318154.11
6100,7/31/2020,7/31/2020,73120,To reverse 82L payroll 73120-To reverse 82L payroll of 73120 JE-21-0003,D108,HJ,,2916.67,315237.44
6100,7/31/2020,7/31/2020,73120,To reverse 82L payroll 73120-To reverse 82L payroll of 73120 JE-21-0003,D108,HJ,,2918.31,312319.13
6100,7/31/2020,7/31/2020,73120,To reverse 82L payroll 73120-To reverse 82L payroll of 73120 JE-21-0003,D108,HJ,,3034.5,309284.63
6100,7/31/2020,7/31/2020,73120,To reverse 82L payroll 73120-To reverse 82L payroll of 73120 JE-21-0003,D108,HJ,,3041.67,306242.96
6100,7/31/2020,7/31/2020,73120,To reverse 82L payroll 73120-To reverse 82L payroll of 73120 JE-21-0003,D108,HJ,,3113.75,303129.21
6100,7/31/2020,7/31/2020,73120,To reverse 82L payroll 73120-To reverse 82L payroll of 73120 JE-21-0003,D108,HJ,,3124.96,300004.25
6100,7/31/2020,7/31/2020,73120,To reverse 82L payroll 73120-To reverse 82L payroll of 73120 JE-21-0003,D108,HJ,,3125,296879.25
6100,7/31/2020,7/31/2020,73120,To reverse 82L payroll 73120-To reverse 82L payroll of 73120 JE-21-0003,D108,HJ,,3291.67,293587.58
6100,7/31/2020,7/31/2020,73120,To reverse 82L payroll 73120-To reverse 82L payroll of 73120 JE-21-0003,D108,HJ,,3437.5,290150.08
6100,7/31/2020,7/31/2020,73120,To reverse 82L payroll 73120-To reverse 82L payroll of 73120 JE-21-0003,D108,HJ,,3445,286705.08
6100,7/31/2020,7/31/2020,73120,To reverse 82L payroll 73120-To reverse 82L payroll of 73120 JE-21-0003,D108,HJ,,3593.03,283112.05
6100,7/31/2020,7/31/2020,73120,To reverse 82L payroll 73120-To reverse 82L payroll of 73120 JE-21-0003,D108,HJ,,3749.96,279362.09
6100,7/31/2020,7/31/2020,73120,To reverse 82L payroll 73120-To reverse 82L payroll of 73120 JE-21-0003,D108,HJ,,3812.5,275549.59
6100,7/31/2020,7/31/2020,73120,To reverse 82L payroll 73120-To reverse 82L payroll of 73120 JE-21-0003,D108,HJ,,3812.5,271737.09
6100,7/31/2020,7/31/2020,73120,To reverse 82L payroll 73120-To reverse 82L payroll of 73120 JE-21-0003,D108,HJ,,3812.5,267924.59
6100,7/31/2020,7/31/2020,73120,To reverse 82L payroll 73120-To reverse 82L payroll of 73120 JE-21-0003,D108,HJ,,5375,262549.59
6100,7/31/2020,7/31/2020,73120,To reverse 82L payroll 73120-To reverse 82L payroll of 73120 JE-21-0003,D108,HJ,,5527.13,257022.46
6100,7/31/2020,7/31/2020,73120,To reverse 82L payroll 73120-To reverse 82L payroll of 73120 JE-21-0003,D108,HJ,,5710.94,251311.52
6100,7/31/2020,7/31/2020,73120,To reverse 82L payroll 73120-To reverse 82L payroll of 73120 JE-21-0003,D108,HJ,,6270.83,245040.69
6100,7/31/2020,7/31/2020,73120,To reverse 82L payroll 73120-To reverse 82L payroll of 73120 JE-21-0003,D108,HJ,,7378.57,237662.12
6100,7/31/2020,7/31/2020,73120,82L-IMPORT PAYROLL-ANTHONY BETTY S,D108,HJ,2886.52,,240548.64
6100,7/31/2020,7/31/2020,73120,82L-IMPORT PAYROLL-AUSTIN PERCY,D108,HJ,2653.02,,243201.66
6100,7/31/2020,7/31/2020,73120,82L-IMPORT PAYROLL-BANDA STEPHANY,D108,HJ,1253.5,,244455.16
6100,7/31/2020,7/31/2020,73120,82L-IMPORT PAYROLL-BAUSH DANIEL,D108,HJ,1750,,246205.16
6100,7/31/2020,7/31/2020,73120,82L-IMPORT PAYROLL-BAUSH DANIEL,D108,HJ,2762.5,,248967.66
6100,7/31/2020,7/31/2020,73120,82L-IMPORT PAYROLL-CHAPMAN CLAUDY EARL,D108,HJ,1833.33,,250800.99
6100,7/31/2020,7/31/2020,73120,82L-IMPORT PAYROLL-DADA ARIKPO E,D108,HJ,2720,,253520.99
6100,7/31/2020,7/31/2020,73120,82L-IMPORT PAYROLL-GUTHRIE LESLIE,D108,HJ,2458.33,,255979.32
6100,7/31/2020,7/31/2020,73120,82L-IMPORT PAYROLL-HOLMES JOREL ALEXANDER,D108,HJ,2329,,258308.32
6100,7/31/2020,7/31/2020,73120,82L-IMPORT PAYROLL-JORDAN TIFFANY T,D108,HJ,3445,,261753.32
6100,7/31/2020,7/31/2020,73120,82L-IMPORT PAYROLL-LANIGAN LISA A,D108,HJ,3113.75,,264867.07
6100,7/31/2020,7/31/2020,73120,82L-IMPORT PAYROLL-LEVERET LILY A,D108,HJ,1253.5,,266120.57
6100,7/31/2020,7/31/2020,73120,82L-IMPORT PAYROLL-MCELWEE MELISSA,D108,HJ,2666.67,,268787.24
6100,7/31/2020,7/31/2020,73120,82L-IMPORT PAYROLL-MCNICHOLAS MARY,D108,HJ,2291.67,,271078.91
6100,7/31/2020,7/31/2020,73120,82L-IMPORT PAYROLL-NWAKANMA NANCY,D108,HJ,2918.31,,273997.22
6100,7/31/2020,7/31/2020,73120,82L-IMPORT PAYROLL-ONICA ANTHONY J,D108,HJ,2416.67,,276413.89
6100,7/31/2020,7/31/2020,73120,82L-IMPORT PAYROLL-PRAHIN NICOLE M,D108,HJ,3812.5,,280226.39
6100,7/31/2020,7/31/2020,73120,82L-IMPORT PAYROLL-RIVERS QUIONNA DIANE,D108,HJ,2514.3,,282740.69
6100,7/31/2020,7/31/2020,73120,82L-IMPORT PAYROLL-SALIM YASSER,D108,HJ,2431.94,,285172.63
6100,7/31/2020,7/31/2020,73120,82L-IMPORT PAYROLL-SEJOUR MAHALIAH,D108,HJ,2500,,287672.63
6100,7/31/2020,7/31/2020,73120,82L-IMPORT PAYROLL-SKALSKI CHRISTOPHER,D108,HJ,2465,,290137.63
6100,7/31/2020,7/31/2020,73120,82L-IMPORT PAYROLL-SMITH AKILAH,D108,HJ,1385.75,,291523.38
6100,7/31/2020,7/31/2020,73120,82L-IMPORT PAYROLL-TAM CW RYAN,D108,HJ,1477.75,,293001.13
6100,7/31/2020,7/31/2020,73120,82L-IMPORT PAYROLL-TENESACA VERONICA A,D108,HJ,1322.5,,294323.63
6100,7/31/2020,7/31/2020,73120,82L-IMPORT PAYROLL-TUMENJARGAL ENKHJIN,D108,HJ,2414,,296737.63
6100,7/31/2020,7/31/2020,73120,82L-IMPORT PAYROLL-VILLEGAS EVELYN,D108,HJ,2817.75,,299555.38
6100,7/31/2020,7/31/2020,73120,82L-IMPORT PAYROLL-WOLF ANNA A,D108,HJ,2635,,302190.38
6100,7/31/2020,7/31/2020,73120,82L-IMPORT PAYROLL-ACEVEDO MONIVETT,D107,HJ,2203.75,,304394.13
6100,7/31/2020,7/31/2020,73120,82L-IMPORT PAYROLL-ACEVEDO MONIVETT,D107,HJ,3171.25,,307565.38
6100,7/31/2020,7/31/2020,73120,82L-IMPORT PAYROLL-AKLESTAD ISABEL,D111,HJ,1750,,309315.38
6100,7/31/2020,7/31/2020,73120,82L-IMPORT PAYROLL-ALLEN KIMBERLY MARY,D111,HJ,1833.33,,311148.71
6100,7/31/2020,7/31/2020,73120,82L-IMPORT PAYROLL-BOWMAN HALLEY K,D101,HJ,3437.5,,314586.21
6100,7/31/2020,7/31/2020,73120,82L-IMPORT PAYROLL-COOK CATHRYN ANNA,D105,HJ,3593.03,,318179.24
6100,7/31/2020,7/31/2020,73120,82L-IMPORT PAYROLL-COOPER ASHLEE R,D101,HJ,2461.88,,320641.12
6100,7/31/2020,7/31/2020,73120,82L-IMPORT PAYROLL-CORTEZ MIRANDA A,D111,HJ,2672.72,,323313.84
6100,7/31/2020,7/31/2020,73120,82L-IMPORT PAYROLL-DAUGHERTY DEVIN W,D101,HJ,1041.67,,324355.51
6100,7/31/2020,7/31/2020,73120,82L-IMPORT PAYROLL-DETONE KYRA MAYA,D102,HJ,2916.67,,327272.18
6100,7/31/2020,7/31/2020,73120,82L-IMPORT PAYROLL-DUPUIS CHRISTOPHER M,D107,HJ,3072.7,,330344.88
6100,7/31/2020,7/31/2020,73120,82L-IMPORT PAYROLL-DUPUIS CHRISTOPHER M,D107,HJ,3198.13,,333543.01
6100,7/31/2020,7/31/2020,73120,82L-IMPORT PAYROLL-DZIEDZIC JULIE K,D101,HJ,1250,,334793.01
6100,7/31/2020,7/31/2020,73120,82L-IMPORT PAYROLL-GORNSTEIN STEVEN,D101,HJ,2708.33,,337501.34
6100,7/31/2020,7/31/2020,73120,82L-IMPORT PAYROLL-GRAVES KAMIESHIA,D101,HJ,2083.33,,339584.67
6100,7/31/2020,7/31/2020,73120,82L-IMPORT PAYROLL-GUADARRAMA-ALVAREZ URIEL A,D105,HJ,2897.92,,342482.59
6100,7/31/2020,7/31/2020,73120,82L-IMPORT PAYROLL-GUTIERREZ ANTONIO J,D107,HJ,5527.13,,348009.72
6100,7/31/2020,7/31/2020,73120,82L-IMPORT PAYROLL-HESTER TYLER CONRAD,D105,HJ,176.92,,348186.64
6100,7/31/2020,7/31/2020,73120,82L-IMPORT PAYROLL-HESTER TYLER CONRAD,D105,HJ,1916.67,,350103.31
6100,7/31/2020,7/31/2020,73120,82L-IMPORT PAYROLL-LACEY DEQUITA,D107,HJ,2698.75,,352802.06
6100,7/31/2020,7/31/2020,73120,82L-IMPORT PAYROLL-LIPORACE HERNAN LUIS,D103,HJ,2291.67,,355093.73
6100,7/31/2020,7/31/2020,73120,82L-IMPORT PAYROLL-MASON ANGELA,D107,HJ,5710.94,,360804.67
6100,7/31/2020,7/31/2020,73120,82L-IMPORT PAYROLL-ODONNELL STEPHEN,D104,HJ,2749.17,,363553.84
6100,7/31/2020,7/31/2020,73120,82L-IMPORT PAYROLL-PARETS MALLORY GRACE,D101,HJ,523.06,,364076.9
6100,7/31/2020,7/31/2020,73120,82L-IMPORT PAYROLL-PARETS MALLORY GRACE,D101,HJ,2833.33,,366910.23
6100,7/31/2020,7/31/2020,73120,82L-IMPORT PAYROLL-PARHAM-GANTT DENISE M,D112,HJ,3041.67,,369951.9
6100,7/31/2020,7/31/2020,73120,82L-IMPORT PAYROLL-PEINADO ELIZABETH R,D111,HJ,3749.96,,373701.86
6100,7/31/2020,7/31/2020,73120,82L-IMPORT PAYROLL-POLANCO ODALIS,D103,HJ,3124.96,,376826.82
6100,7/31/2020,7/31/2020,73120,82L-IMPORT PAYROLL-RANDOLPH ALEXANDER,D111,HJ,1875,,378701.82
6100,7/31/2020,7/31/2020,73120,82L-IMPORT PAYROLL-SAFRAN ALAN P,D107,HJ,601.36,,379303.18
6100,7/31/2020,7/31/2020,73120,82L-IMPORT PAYROLL-SAFRAN ALAN P,D107,HJ,6915.52,,386218.7
6100,7/31/2020,7/31/2020,73120,82L-IMPORT PAYROLL-SHENKMAN OLIVIA,D101,HJ,2000,,388218.7
6100,7/31/2020,7/31/2020,73120,82L-IMPORT PAYROLL-SHI GRACE,D103,HJ,875,,389093.7
6100,7/31/2020,7/31/2020,73120,82L-IMPORT PAYROLL-WALLACE AMENA T,D104,HJ,2187.5,,391281.2
6100,7/31/2020,7/31/2020,73120,82L-IMPORT PAYROLL-WEINSTOCK EMILY,D101,HJ,2833.33,,394114.53
6100,7/31/2020,7/31/2020,73120,82L-IMPORT PAYROLL-WINANS JENNIFER,D111,HJ,2505.63,,396620.16
6100,7/31/2020,7/31/2020,73120,82L-IMPORT PAYROLL-ZARATE JOSEPH M,D105,HJ,2150,,398770.16
6100,7/31/2020,7/31/2020,73120,82L-IMPORT PAYROLL-ARCHER AUBREYNA,D108,HJ,2750,,401520.16
6100,7/31/2020,7/31/2020,73120,82L-IMPORT PAYROLL-BARTOLD DEANNA MARIE,D108,HJ,3034.5,,404554.66
6100,7/31/2020,7/31/2020,73120,82L-IMPORT PAYROLL-BELLOT GENESIS,D108,HJ,2333.33,,406887.99
6100,7/31/2020,7/31/2020,73120,82L-IMPORT PAYROLL-CIRKER MIA,D108,HJ,2250,,409137.99
6100,7/31/2020,7/31/2020,73120,82L-IMPORT PAYROLL-FEIGHERY JOHN,D108,HJ,2250,,411387.99
6100,7/31/2020,7/31/2020,73120,82L-IMPORT PAYROLL-GARCIA MARILYN,D108,HJ,2291.67,,413679.66
6100,7/31/2020,7/31/2020,73120,82L-IMPORT PAYROLL-GARNER IVORY,D108,HJ,1824,,415503.66
6100,7/31/2020,7/31/2020,73120,82L-IMPORT PAYROLL-GRIFFIN ANDREW,D108,HJ,2250,,417753.66
6100,7/31/2020,7/31/2020,73120,82L-IMPORT PAYROLL-HALLINAN GABRIEL B,D108,HJ,2550,,420303.66
6100,7/31/2020,7/31/2020,73120,82L-IMPORT PAYROLL-HOLDER LATIVA M,D108,HJ,3812.5,,424116.16
6100,7/31/2020,7/31/2020,73120,82L-IMPORT PAYROLL-HOSSAIN MYESHA R,D108,HJ,2437.5,,426553.66
6100,7/31/2020,7/31/2020,73120,82L-IMPORT PAYROLL-JACKSON TASNIM F,D108,HJ,2291.67,,428845.33
6100,7/31/2020,7/31/2020,73120,82L-IMPORT PAYROLL-KALOKOH BAINDU,D108,HJ,1307.64,,430152.97
6100,7/31/2020,7/31/2020,73120,82L-IMPORT PAYROLL-LI BELLA,D108,HJ,2486.25,,432639.22
6100,7/31/2020,7/31/2020,73120,82L-IMPORT PAYROLL-MOSELEY ARIELLE,D108,HJ,2752.73,,435391.95
6100,7/31/2020,7/31/2020,73120,82L-IMPORT PAYROLL-TILLERY ASIA,D108,HJ,3291.67,,438683.62
6100,7/31/2020,7/31/2020,73120,82L-IMPORT PAYROLL-BALASUBRAMANIAN SHARANYA,D108,HJ,2666.67,,441350.29
6100,7/31/2020,7/31/2020,73120,82L-IMPORT PAYROLL-COVENEY ALLISON,D108,HJ,2854.17,,444204.46
6100,7/31/2020,7/31/2020,73120,82L-IMPORT PAYROLL-GRAVES KIRA B,D101,HJ,481.06,,444685.52
6100,7/31/2020,7/31/2020,73120,82L-IMPORT PAYROLL-JACKSON CLAICE M,D108,HJ,3125,,447810.52
6100,7/31/2020,7/31/2020,73120,82L-IMPORT PAYROLL-JANG DANIEL,D108,HJ,2750,,450560.52
6100,7/31/2020,7/31/2020,73120,82L-IMPORT PAYROLL-LENEGHAN MARYELLEN B,D108,HJ,1830,,452390.52
6100,7/31/2020,7/31/2020,73120,82L-IMPORT PAYROLL-LENEGHAN MARYELLEN B,D108,HJ,1982.5,,454373.02
6100,7/31/2020,7/31/2020,Reallocation to GM3 - ACY2,To reallocate Salaraies to GM3 - ACY2-To reallocate Salaries to GM3 - ACY2 ( Lacey Dequita Stephen Odonell Wallace Amena),D104,HJ,1000,,455373.02
6100,7/31/2020,7/31/2020,Reallocation to GM3 - ACY2,To reallocate Salaraies to GM3 - ACY2-To reallocate Salaries to GM3 - ACY2 ( Lacey Dequita Stephen Odonell Wallace Amena),D104,HJ,15229.17,,470602.19
6100,7/31/2020,7/31/2020,Reallocation to GM3 - ACY2,To reallocate Salaraies to GM3 - ACY2-To reallocate Salaries to GM3 - ACY2 ( Lacey Dequita Stephen Odonell Wallace Amena),D104,HJ,,17405.09,453197.1
6100,7/31/2020,7/31/2020,Reallocation to GM3 - ACY2,To Reverse JE-21-0052-To reallocate Salaries to GM3 - ACY2 ( Lacey Dequita Stephen Odonell Wallace Amena),D104,HJ,,1000,452197.1
6100,7/31/2020,7/31/2020,Reallocation to GM3 - ACY2,To Reverse JE-21-0052-To reallocate Salaries to GM3 - ACY2 ( Lacey Dequita Stephen Odonell Wallace Amena),D104,HJ,,15229.17,436967.93
6100,7/31/2020,7/31/2020,Reallocation to GM3 - ACY2,To Reverse JE-21-0052-To reallocate Salaries to GM3 - ACY2 ( Lacey Dequita Stephen Odonell Wallace Amena),D104,HJ,17405.09,,454373.02
6100,8/14/2020,8/14/2020,81420,82L-IMPORT PAYROLL-ALVAREZ-MORINE LISIS,D108,HJ,2541.67,,456914.69
6100,8/14/2020,8/14/2020,81420,82L-IMPORT PAYROLL-ALWARDT CALEB,D108,HJ,1047.62,,457962.31
6100,8/14/2020,8/14/2020,81420,82L-IMPORT PAYROLL-BARTHELEMY RACHALIE,D108,HJ,1047.62,,459009.93
6100,8/14/2020,8/14/2020,81420,82L-IMPORT PAYROLL-BOHLSEN GRACE,D108,HJ,1047.62,,460057.55
6100,8/14/2020,8/14/2020,81420,82L-IMPORT PAYROLL-BORCHART SPENCER,D108,HJ,1047.62,,461105.17
6100,8/14/2020,8/14/2020,81420,82L-IMPORT PAYROLL-BREEDLOVE JOHNDEE L,D108,HJ,1047.62,,462152.79
6100,8/14/2020,8/14/2020,81420,82L-IMPORT PAYROLL-BROWN ISAAC,D108,HJ,1047.62,,463200.41
6100,8/14/2020,8/14/2020,81420,82L-IMPORT PAYROLL-BURKE MARIAH,D108,HJ,1047.62,,464248.03
6100,8/14/2020,8/14/2020,81420,82L-IMPORT PAYROLL-CHAVOUS MILFORD,D108,HJ,1047.62,,465295.65
6100,8/14/2020,8/14/2020,81420,82L-IMPORT PAYROLL-CHEN LING,D108,HJ,1047.62,,466343.27
6100,8/14/2020,8/14/2020,81420,82L-IMPORT PAYROLL-DARKO OLIVIA,D108,HJ,1047.62,,467390.89
6100,8/14/2020,8/14/2020,81420,82L-IMPORT PAYROLL-DAWSON JAMIL NAFAYE-BEYAH,D108,HJ,1047.62,,468438.51
6100,8/14/2020,8/14/2020,81420,82L-IMPORT PAYROLL-GILES SHAYLA,D108,HJ,1047.62,,469486.13
6100,8/14/2020,8/14/2020,81420,82L-IMPORT PAYROLL-JONES JORDAN,D108,HJ,1047.62,,470533.75
6100,8/14/2020,8/14/2020,81420,82L-IMPORT PAYROLL-KHAN HUDA,D108,HJ,1047.62,,471581.37
6100,8/14/2020,8/14/2020,81420,82L-IMPORT PAYROLL-KING IRIS,D108,HJ,483.5,,472064.87
6100,8/14/2020,8/14/2020,81420,82L-IMPORT PAYROLL-KLOHR TIMOTHY JORDAN,D108,HJ,1476.86,,473541.73
6100,8/14/2020,8/14/2020,81420,82L-IMPORT PAYROLL-KOPSHEVER MELISSA,D108,HJ,2916.67,,476458.4
6100,8/14/2020,8/14/2020,81420,82L-IMPORT PAYROLL-LI SEN YUAN,D108,HJ,1047.62,,477506.02
6100,8/14/2020,8/14/2020,81420,82L-IMPORT PAYROLL-LIPSCOMB STEPHEN,D108,HJ,2541.67,,480047.69
6100,8/14/2020,8/14/2020,81420,82L-IMPORT PAYROLL-MCLAUGHLIN MARA,D108,HJ,1047.62,,481095.31
6100,8/14/2020,8/14/2020,81420,82L-IMPORT PAYROLL-MEJIA CARLOS MANUEL,D108,HJ,1047.62,,482142.93
6100,8/14/2020,8/14/2020,81420,82L-IMPORT PAYROLL-MONROY-MEJIA JASON,D108,HJ,1047.62,,483190.55
6100,8/14/2020,8/14/2020,81420,82L-IMPORT PAYROLL-O'FLYNN-PRUITT NATHAN COLYAR,D108,HJ,1047.62,,484238.17
6100,8/14/2020,8/14/2020,81420,82L-IMPORT PAYROLL-PATTERSON STEVE,D108,HJ,1047.62,,485285.79
6100,8/14/2020,8/14/2020,81420,82L-IMPORT PAYROLL-ROBBINS DEANNA,D108,HJ,2541.67,,487827.46
6100,8/14/2020,8/14/2020,81420,82L-IMPORT PAYROLL-SCOTT KIRK DONOVAN,D108,HJ,1047.62,,488875.08
6100,8/14/2020,8/14/2020,81420,82L-IMPORT PAYROLL-SILVER KELLY,D108,HJ,2541.67,,491416.75
6100,8/14/2020,8/14/2020,81420,82L-IMPORT PAYROLL-SOLIMAN MARK,D108,HJ,1047.62,,492464.37
6100,8/14/2020,8/14/2020,81420,82L-IMPORT PAYROLL-STROUD DAVID,D108,HJ,1047.62,,493511.99
6100,8/14/2020,8/14/2020,81420,82L-IMPORT PAYROLL-VALCIN SABRINA JEMIMAH,D108,HJ,1047.62,,494559.61
6100,8/14/2020,8/14/2020,81420,82L-IMPORT PAYROLL-WILLIAMS MACK ANTHONY,D108,HJ,1047.62,,495607.23
6100,8/14/2020,8/14/2020,81420,82L-IMPORT PAYROLL-WILLIAMS MIL'YONTA,D108,HJ,1047.62,,496654.85
6100,8/14/2020,8/14/2020,81420,82L-IMPORT PAYROLL-ANTHONY BETTY S,D108,HJ,2886.52,,499541.37
6100,8/14/2020,8/14/2020,81420,82L-IMPORT PAYROLL-AUSTIN PERCY,D108,HJ,2653.02,,502194.39
6100,8/14/2020,8/14/2020,81420,82L-IMPORT PAYROLL-BAUSH DANIEL,D108,HJ,2762.5,,504956.89
6100,8/14/2020,8/14/2020,81420,82L-IMPORT PAYROLL-CHAPMAN CLAUDY EARL,D108,HJ,1833.33,,506790.22
6100,8/14/2020,8/14/2020,81420,82L-IMPORT PAYROLL-DADA ARIKPO E,D108,HJ,2720,,509510.22
6100,8/14/2020,8/14/2020,81420,82L-IMPORT PAYROLL-GUTHRIE LESLIE,D108,HJ,2458.33,,511968.55
6100,8/14/2020,8/14/2020,81420,82L-IMPORT PAYROLL-HOLMES JOREL ALEXANDER,D108,HJ,2329,,514297.55
6100,8/14/2020,8/14/2020,81420,82L-IMPORT PAYROLL-JORDAN TIFFANY T,D108,HJ,3445,,517742.55
6100,8/14/2020,8/14/2020,81420,82L-IMPORT PAYROLL-LANIGAN LISA A,D108,HJ,3113.75,,520856.3
6100,8/14/2020,8/14/2020,81420,82L-IMPORT PAYROLL-MCELWEE MELISSA,D108,HJ,2666.67,,523522.97
6100,8/14/2020,8/14/2020,81420,82L-IMPORT PAYROLL-MCNICHOLAS MARY,D108,HJ,2291.67,,525814.64
6100,8/14/2020,8/14/2020,81420,82L-IMPORT PAYROLL-NWAKANMA NANCY,D108,HJ,2918.31,,528732.95
6100,8/14/2020,8/14/2020,81420,82L-IMPORT PAYROLL-ONICA ANTHONY J,D108,HJ,2416.67,,531149.62
6100,8/14/2020,8/14/2020,81420,82L-IMPORT PAYROLL-PRAHIN NICOLE M,D108,HJ,3812.5,,534962.12
6100,8/14/2020,8/14/2020,81420,82L-IMPORT PAYROLL-RIVERS QUIONNA DIANE,D108,HJ,2514.3,,537476.42
6100,8/14/2020,8/14/2020,81420,82L-IMPORT PAYROLL-SALIM YASSER,D108,HJ,2431.94,,539908.36
6100,8/14/2020,8/14/2020,81420,82L-IMPORT PAYROLL-SEJOUR MAHALIAH,D108,HJ,2500,,542408.36
6100,8/14/2020,8/14/2020,81420,82L-IMPORT PAYROLL-SKALSKI CHRISTOPHER,D108,HJ,2465,,544873.36
6100,8/14/2020,8/14/2020,81420,82L-IMPORT PAYROLL-TUMENJARGAL ENKHJIN,D108,HJ,2414,,547287.36
6100,8/14/2020,8/14/2020,81420,82L-IMPORT PAYROLL-VILLEGAS EVELYN,D108,HJ,2817.75,,550105.11
6100,8/14/2020,8/14/2020,81420,82L-IMPORT PAYROLL-WOLF ANNA A,D108,HJ,2635,,552740.11
6100,8/14/2020,8/14/2020,81420,82L-IMPORT PAYROLL-ACEVEDO MONIVETT,D107,HJ,5375,,558115.11
6100,8/14/2020,8/14/2020,81420,82L-IMPORT PAYROLL-AKLESTAD ISABEL,D111,HJ,1750,,559865.11
6100,8/14/2020,8/14/2020,81420,82L-IMPORT PAYROLL-ALLEN KIMBERLY MARY,D111,HJ,1833.33,,561698.44
6100,8/14/2020,8/14/2020,81420,82L-IMPORT PAYROLL-BOWMAN HALLEY K,D101,HJ,3437.5,,565135.94
6100,8/14/2020,8/14/2020,81420,82L-IMPORT PAYROLL-COOK CATHRYN ANNA,D105,HJ,3593.03,,568728.97
6100,8/14/2020,8/14/2020,81420,82L-IMPORT PAYROLL-COOPER ASHLEE R,D101,HJ,2461.88,,571190.85
6100,8/14/2020,8/14/2020,81420,82L-IMPORT PAYROLL-CORTEZ MIRANDA A,D111,HJ,2672.72,,573863.57
6100,8/14/2020,8/14/2020,81420,82L-IMPORT PAYROLL-DAUGHERTY DEVIN W,D101,HJ,1041.67,,574905.24
6100,8/14/2020,8/14/2020,81420,82L-IMPORT PAYROLL-DETONE KYRA MAYA,D102,HJ,2916.67,,577821.91
6100,8/14/2020,8/14/2020,81420,82L-IMPORT PAYROLL-DUPUIS CHRISTOPHER M,D107,HJ,841.02,,578662.93
6100,8/14/2020,8/14/2020,81420,82L-IMPORT PAYROLL-DUPUIS CHRISTOPHER M,D107,HJ,1372.2,,580035.13
6100,8/14/2020,8/14/2020,81420,82L-IMPORT PAYROLL-DZIEDZIC JULIE K,D101,HJ,1250,,581285.13
6100,8/14/2020,8/14/2020,81420,82L-IMPORT PAYROLL-GORNSTEIN STEVEN,D101,HJ,2708.33,,583993.46
6100,8/14/2020,8/14/2020,81420,82L-IMPORT PAYROLL-GRAVES KAMIESHIA,D101,HJ,2083.33,,586076.79
6100,8/14/2020,8/14/2020,81420,82L-IMPORT PAYROLL-GUADARRAMA-ALVAREZ URIEL A,D105,HJ,2897.92,,588974.71
6100,8/14/2020,8/14/2020,81420,82L-IMPORT PAYROLL-GUTIERREZ ANTONIO J,D107,HJ,1105.43,,590080.14
6100,8/14/2020,8/14/2020,81420,82L-IMPORT PAYROLL-GUTIERREZ ANTONIO J,D107,HJ,4421.7,,594501.84
6100,8/14/2020,8/14/2020,81420,82L-IMPORT PAYROLL-HESTER TYLER CONRAD,D105,HJ,1916.67,,596418.51
6100,8/14/2020,8/14/2020,81420,82L-IMPORT PAYROLL-LACEY DEQUITA,D107,HJ,2698.75,,599117.26
6100,8/14/2020,8/14/2020,81420,82L-IMPORT PAYROLL-LIPORACE HERNAN LUIS,D103,HJ,2291.67,,601408.93
6100,8/14/2020,8/14/2020,81420,82L-IMPORT PAYROLL-MASON ANGELA,D107,HJ,5710.94,,607119.87
6100,8/14/2020,8/14/2020,81420,82L-IMPORT PAYROLL-ODONNELL STEPHEN,D104,HJ,2707.5,,609827.37
6100,8/14/2020,8/14/2020,81420,82L-IMPORT PAYROLL-PARETS MALLORY GRACE,D101,HJ,2833.33,,612660.7
6100,8/14/2020,8/14/2020,81420,82L-IMPORT PAYROLL-PARHAM-GANTT DENISE M,D112,HJ,3041.67,,615702.37
6100,8/14/2020,8/14/2020,81420,82L-IMPORT PAYROLL-PEINADO ELIZABETH R,D111,HJ,3749.96,,619452.33
6100,8/14/2020,8/14/2020,81420,82L-IMPORT PAYROLL-POLANCO ODALIS,D103,HJ,3124.96,,622577.29
6100,8/14/2020,8/14/2020,81420,82L-IMPORT PAYROLL-QUINTAS JASHIVE,D105,HJ,1916.67,,624493.96
6100,8/14/2020,8/14/2020,81420,82L-IMPORT PAYROLL-RANDOLPH ALEXANDER,D111,HJ,1875,,626368.96
6100,8/14/2020,8/14/2020,81420,82L-IMPORT PAYROLL-SAFRAN ALAN P,D107,HJ,751.69,,627120.65
6100,8/14/2020,8/14/2020,81420,82L-IMPORT PAYROLL-SAFRAN ALAN P,D107,HJ,6765.19,,633885.84
6100,8/14/2020,8/14/2020,81420,82L-IMPORT PAYROLL-SHENKMAN OLIVIA,D101,HJ,2000,,635885.84
6100,8/14/2020,8/14/2020,81420,82L-IMPORT PAYROLL-SHI GRACE,D103,HJ,875,,636760.84
6100,8/14/2020,8/14/2020,81420,82L-IMPORT PAYROLL-WALLACE AMENA T,D104,HJ,2187.5,,638948.34
6100,8/14/2020,8/14/2020,81420,82L-IMPORT PAYROLL-WEINSTOCK EMILY,D101,HJ,2833.33,,641781.67
6100,8/14/2020,8/14/2020,81420,82L-IMPORT PAYROLL-WINANS JENNIFER,D111,HJ,2505.63,,644287.3
6100,8/14/2020,8/14/2020,81420,82L-IMPORT PAYROLL-ZARATE JOSEPH M,D105,HJ,2150,,646437.3
6100,8/14/2020,8/14/2020,81420,82L-IMPORT PAYROLL-ARCHER AUBREYNA,D108,HJ,2750,,649187.3
6100,8/14/2020,8/14/2020,81420,82L-IMPORT PAYROLL-BARTOLD DEANNA MARIE,D108,HJ,3034.5,,652221.8
6100,8/14/2020,8/14/2020,81420,82L-IMPORT PAYROLL-BELLOT GENESIS,D108,HJ,2333.33,,654555.13
6100,8/14/2020,8/14/2020,81420,82L-IMPORT PAYROLL-CIRKER MIA,D108,HJ,2250,,656805.13
6100,8/14/2020,8/14/2020,81420,82L-IMPORT PAYROLL-FEIGHERY JOHN,D108,HJ,2250,,659055.13
6100,8/14/2020,8/14/2020,81420,82L-IMPORT PAYROLL-GARCIA MARILYN,D108,HJ,2291.67,,661346.8
6100,8/14/2020,8/14/2020,81420,82L-IMPORT PAYROLL-GRIFFIN ANDREW,D108,HJ,2250,,663596.8
6100,8/14/2020,8/14/2020,81420,82L-IMPORT PAYROLL-HALLINAN GABRIEL B,D108,HJ,2550,,666146.8
6100,8/14/2020,8/14/2020,81420,82L-IMPORT PAYROLL-HOLDER LATIVA M,D108,HJ,3812.5,,669959.3
6100,8/14/2020,8/14/2020,81420,82L-IMPORT PAYROLL-HOSSAIN MYESHA R,D108,HJ,2437.5,,672396.8
6100,8/14/2020,8/14/2020,81420,82L-IMPORT PAYROLL-JACKSON TASNIM F,D108,HJ,2291.67,,674688.47
6100,8/14/2020,8/14/2020,81420,82L-IMPORT PAYROLL-LI BELLA,D108,HJ,2486.25,,677174.72
6100,8/14/2020,8/14/2020,81420,82L-IMPORT PAYROLL-MOSELEY ARIELLE,D108,HJ,2752.73,,679927.45
6100,8/14/2020,8/14/2020,81420,82L-IMPORT PAYROLL-TILLERY ASIA,D108,HJ,3291.67,,683219.12
6100,8/14/2020,8/14/2020,81420,82L-IMPORT PAYROLL-BALASUBRAMANIAN SHARANYA,D108,HJ,2666.67,,685885.79
6100,8/14/2020,8/14/2020,81420,82L-IMPORT PAYROLL-COVENEY ALLISON,D108,HJ,2854.17,,688739.96
6100,8/14/2020,8/14/2020,81420,82L-IMPORT PAYROLL-JACKSON CLAICE M,D108,HJ,3125,,691864.96
6100,8/14/2020,8/14/2020,81420,82L-IMPORT PAYROLL-JANG DANIEL,D108,HJ,2750,,694614.96
6100,8/14/2020,8/14/2020,81420,82L-IMPORT PAYROLL-LENEGHAN MARYELLEN B,D108,HJ,1525,,696139.96
6100,8/14/2020,8/14/2020,81420,82L-IMPORT PAYROLL-LENEGHAN MARYELLEN B,D108,HJ,2287.5,,698427.46
6100,8/14/2020,8/14/2020,82L-PRPD-081520,82L-PRPD-081520 -IMPORT PAYROLL-ALLEN KIMBERLY MARY,D108,HJ,1833.33,,700260.79
6100,8/14/2020,8/14/2020,82L-PRPD-081520,82L-PRPD-081520 -IMPORT PAYROLL-ANTHONY BETTY S,D108,HJ,2886.52,,703147.31
6100,8/14/2020,8/14/2020,82L-PRPD-081520,82L-PRPD-081520 -IMPORT PAYROLL-AUSTIN PERCY,D108,HJ,2653.02,,705800.33
6100,8/14/2020,8/14/2020,82L-PRPD-081520,82L-PRPD-081520 -IMPORT PAYROLL-BAUSH DANIEL,D108,HJ,2762.5,,708562.83
6100,8/14/2020,8/14/2020,82L-PRPD-081520,82L-PRPD-081520 -IMPORT PAYROLL-CHAPMAN CLAUDY EARL,D108,HJ,1833.33,,710396.16
6100,8/14/2020,8/14/2020,82L-PRPD-081520,82L-PRPD-081520 -IMPORT PAYROLL-DADA ARIKPO E,D108,HJ,2720,,713116.16
6100,8/14/2020,8/14/2020,82L-PRPD-081520,82L-PRPD-081520 -IMPORT PAYROLL-GUTHRIE LESLIE,D108,HJ,2458.33,,715574.49
6100,8/14/2020,8/14/2020,82L-PRPD-081520,82L-PRPD-081520 -IMPORT PAYROLL-HOLMES JOREL ALEXANDER,D108,HJ,2329,,717903.49
6100,8/14/2020,8/14/2020,82L-PRPD-081520,82L-PRPD-081520 -IMPORT PAYROLL-JORDAN TIFFANY T,D108,HJ,3445,,721348.49
6100,8/14/2020,8/14/2020,82L-PRPD-081520,82L-PRPD-081520 -IMPORT PAYROLL-LANIGAN LISA A,D108,HJ,3113.75,,724462.24
6100,8/14/2020,8/14/2020,82L-PRPD-081520,82L-PRPD-081520 -IMPORT PAYROLL-MCELWEE MELISSA,D108,HJ,2666.67,,727128.91
6100,8/14/2020,8/14/2020,82L-PRPD-081520,82L-PRPD-081520 -IMPORT PAYROLL-MCNICHOLAS MARY,D108,HJ,2291.67,,729420.58
6100,8/14/2020,8/14/2020,82L-PRPD-081520,82L-PRPD-081520 -IMPORT PAYROLL-NWAKANMA NANCY,D108,HJ,2918.31,,732338.89
6100,8/14/2020,8/14/2020,82L-PRPD-081520,82L-PRPD-081520 -IMPORT PAYROLL-ONICA ANTHONY J,D108,HJ,2416.67,,734755.56
6100,8/14/2020,8/14/2020,82L-PRPD-081520,82L-PRPD-081520 -IMPORT PAYROLL-PRAHIN NICOLE M,D108,HJ,3812.5,,738568.06
6100,8/14/2020,8/14/2020,82L-PRPD-081520,82L-PRPD-081520 -IMPORT PAYROLL-RIVERS QUIONNA DIANE,D108,HJ,2514.3,,741082.36
6100,8/14/2020,8/14/2020,82L-PRPD-081520,82L-PRPD-081520 -IMPORT PAYROLL-SALIM YASSER,D108,HJ,2431.94,,743514.3
6100,8/14/2020,8/14/2020,82L-PRPD-081520,82L-PRPD-081520 -IMPORT PAYROLL-SEJOUR MAHALIAH,D108,HJ,2500,,746014.3
6100,8/14/2020,8/14/2020,82L-PRPD-081520,82L-PRPD-081520 -IMPORT PAYROLL-SKALSKI CHRISTOPHER,D108,HJ,2465,,748479.3
6100,8/14/2020,8/14/2020,82L-PRPD-081520,82L-PRPD-081520 -IMPORT PAYROLL-TUMENJARGAL ENKHJIN,D108,HJ,2414,,750893.3
6100,8/14/2020,8/14/2020,82L-PRPD-081520,82L-PRPD-081520 -IMPORT PAYROLL-VILLEGAS EVELYN,D108,HJ,2817.75,,753711.05
6100,8/14/2020,8/14/2020,82L-PRPD-081520,82L-PRPD-081520 -IMPORT PAYROLL-WALLACE AMENA T,D108,HJ,2187.5,,755898.55
6100,8/14/2020,8/14/2020,82L-PRPD-081520,82L-PRPD-081520 -IMPORT PAYROLL-WINANS JENNIFER,D111,HJ,2505.63,,758404.18
6100,8/14/2020,8/14/2020,82L-PRPD-081520,82L-PRPD-081520 -IMPORT PAYROLL-WOLF ANNA A,D108,HJ,2635,,761039.18
6100,8/14/2020,8/14/2020,82L-PRPD-081520,82L-PRPD-081520 -IMPORT PAYROLL-ACEVEDO MONIVETT,D103,HJ,5375,,766414.18
6100,8/14/2020,8/14/2020,82L-PRPD-081520,82L-PRPD-081520 -IMPORT PAYROLL-AKLESTAD ISABEL,D107,HJ,1750,,768164.18
6100,8/14/2020,8/14/2020,82L-PRPD-081520,82L-PRPD-081520 -IMPORT PAYROLL-ALVAREZ-MORINE LISIS,D107,HJ,2541.67,,770705.85
6100,8/14/2020,8/14/2020,82L-PRPD-081520,82L-PRPD-081520 -IMPORT PAYROLL-ALWARDT CALEB,D107,HJ,1047.62,,771753.47
6100,8/14/2020,8/14/2020,82L-PRPD-081520,82L-PRPD-081520 -IMPORT PAYROLL-BARTHELEMY RACHALIE,D107,HJ,1047.62,,772801.09
6100,8/14/2020,8/14/2020,82L-PRPD-081520,82L-PRPD-081520 -IMPORT PAYROLL-BOHLSEN GRACE,D107,HJ,1047.62,,773848.71
6100,8/14/2020,8/14/2020,82L-PRPD-081520,82L-PRPD-081520 -IMPORT PAYROLL-BORCHART SPENCER,D107,HJ,1047.62,,774896.33
6100,8/14/2020,8/14/2020,82L-PRPD-081520,82L-PRPD-081520 -IMPORT PAYROLL-BOWMAN HALLEY K,D107,HJ,3437.5,,778333.83
6100,8/14/2020,8/14/2020,82L-PRPD-081520,82L-PRPD-081520 -IMPORT PAYROLL-BREEDLOVE JOHNDEE L,D107,HJ,1047.62,,779381.45
6100,8/14/2020,8/14/2020,82L-PRPD-081520,82L-PRPD-081520 -IMPORT PAYROLL-BROWN ISAAC,D107,HJ,1047.62,,780429.07
6100,8/14/2020,8/14/2020,82L-PRPD-081520,82L-PRPD-081520 -IMPORT PAYROLL-BURKE MARIAH,D107,HJ,1047.62,,781476.69
6100,8/14/2020,8/14/2020,82L-PRPD-081520,82L-PRPD-081520 -IMPORT PAYROLL-CHAVOUS MILFORD,D107,HJ,1047.62,,782524.31
6100,8/14/2020,8/14/2020,82L-PRPD-081520,82L-PRPD-081520 -IMPORT PAYROLL-CHEN LING,D107,HJ,1047.62,,783571.93
6100,8/14/2020,8/14/2020,82L-PRPD-081520,82L-PRPD-081520 -IMPORT PAYROLL-COOK CATHRYN ANNA,D107,HJ,3593.03,,787164.96
6100,8/14/2020,8/14/2020,82L-PRPD-081520,82L-PRPD-081520 -IMPORT PAYROLL-COOPER ASHLEE R,D107,HJ,2461.88,,789626.84
6100,8/14/2020,8/14/2020,82L-PRPD-081520,82L-PRPD-081520 -IMPORT PAYROLL-DARKO OLIVIA,D107,HJ,1047.62,,790674.46
6100,8/14/2020,8/14/2020,82L-PRPD-081520,82L-PRPD-081520 -IMPORT PAYROLL-DAUGHERTY DEVIN W,D107,HJ,1041.67,,791716.13
6100,8/14/2020,8/14/2020,82L-PRPD-081520,82L-PRPD-081520 -IMPORT PAYROLL-DAWSON JAMIL NAFAYE-BEYAH,D107,HJ,1047.62,,792763.75
6100,8/14/2020,8/14/2020,82L-PRPD-081520,82L-PRPD-081520 -IMPORT PAYROLL-DETONE KYRA MAYA,D102,HJ,2916.67,,795680.42
6100,8/14/2020,8/14/2020,82L-PRPD-081520,82L-PRPD-081520 -IMPORT PAYROLL-DUPUIS CHRISTOPHER M,D107,HJ,2213.22,,797893.64
6100,8/14/2020,8/14/2020,82L-PRPD-081520,82L-PRPD-081520 -IMPORT PAYROLL-DZIEDZIC JULIE K,D107,HJ,1250,,799143.64
6100,8/14/2020,8/14/2020,82L-PRPD-081520,82L-PRPD-081520 -IMPORT PAYROLL-GILES SHAYLA,D107,HJ,1047.62,,800191.26
6100,8/14/2020,8/14/2020,82L-PRPD-081520,82L-PRPD-081520 -IMPORT PAYROLL-GORNSTEIN STEVEN,D107,HJ,2708.33,,802899.59
6100,8/14/2020,8/14/2020,82L-PRPD-081520,82L-PRPD-081520 -IMPORT PAYROLL-GRAVES KAMIESHIA,D107,HJ,2083.33,,804982.92
6100,8/14/2020,8/14/2020,82L-PRPD-081520,82L-PRPD-081520 -IMPORT PAYROLL-GUADARRAMA-ALVAREZ URIEL A,D107,HJ,2897.92,,807880.84
6100,8/14/2020,8/14/2020,82L-PRPD-081520,82L-PRPD-081520 -IMPORT PAYROLL-GUTIERREZ ANTONIO J,D102,HJ,5527.13,,813407.97
6100,8/14/2020,8/14/2020,82L-PRPD-081520,82L-PRPD-081520 -IMPORT PAYROLL-HESTER TYLER CONRAD,D107,HJ,1916.67,,815324.64
6100,8/14/2020,8/14/2020,82L-PRPD-081520,82L-PRPD-081520 -IMPORT PAYROLL-JONES JORDAN,D107,HJ,1047.62,,816372.26
6100,8/14/2020,8/14/2020,82L-PRPD-081520,82L-PRPD-081520 -IMPORT PAYROLL-KHAN HUDA,D107,HJ,1047.62,,817419.88
6100,8/14/2020,8/14/2020,82L-PRPD-081520,82L-PRPD-081520 -IMPORT PAYROLL-KING IRIS,D107,HJ,483.5,,817903.38
6100,8/14/2020,8/14/2020,82L-PRPD-081520,82L-PRPD-081520 -IMPORT PAYROLL-KLOHR TIMOTHY JORDAN,D107,HJ,1476.86,,819380.24
6100,8/14/2020,8/14/2020,82L-PRPD-081520,82L-PRPD-081520 -IMPORT PAYROLL-KOPSHEVER MELISSA,D107,HJ,2916.67,,822296.91
6100,8/14/2020,8/14/2020,82L-PRPD-081520,82L-PRPD-081520 -IMPORT PAYROLL-LACEY DEQUITA,D108,HJ,2698.75,,824995.66
6100,8/14/2020,8/14/2020,82L-PRPD-081520,82L-PRPD-081520 -IMPORT PAYROLL-LI SEN YUAN,D107,HJ,1047.62,,826043.28
6100,8/14/2020,8/14/2020,82L-PRPD-081520,82L-PRPD-081520 -IMPORT PAYROLL-LIPORACE HERNAN LUIS,D103,HJ,2291.67,,828334.95
6100,8/14/2020,8/14/2020,82L-PRPD-081520,82L-PRPD-081520 -IMPORT PAYROLL-LIPSCOMB STEPHEN,D107,HJ,2541.67,,830876.62
6100,8/14/2020,8/14/2020,82L-PRPD-081520,82L-PRPD-081520 -IMPORT PAYROLL-MASON ANGELA,D107,HJ,5710.94,,836587.56
6100,8/14/2020,8/14/2020,82L-PRPD-081520,82L-PRPD-081520 -IMPORT PAYROLL-MCLAUGHLIN MARA,D107,HJ,1047.62,,837635.18
6100,8/14/2020,8/14/2020,82L-PRPD-081520,82L-PRPD-081520 -IMPORT PAYROLL-MEJIA CARLOS MANUEL,D107,HJ,1047.62,,838682.8
6100,8/14/2020,8/14/2020,82L-PRPD-081520,82L-PRPD-081520 -IMPORT PAYROLL-MONROY-MEJIA JASON,D107,HJ,1047.62,,839730.42
6100,8/14/2020,8/14/2020,82L-PRPD-081520,82L-PRPD-081520 -IMPORT PAYROLL-O'FLYNN-PRUITT NATHAN COLYAR,D107,HJ,1047.62,,840778.04
6100,8/14/2020,8/14/2020,82L-PRPD-081520,82L-PRPD-081520 -IMPORT PAYROLL-ODONNELL STEPHEN,D107,HJ,2707.5,,843485.54
6100,8/14/2020,8/14/2020,82L-PRPD-081520,82L-PRPD-081520 -IMPORT PAYROLL-PARETS MALLORY GRACE,D107,HJ,2833.33,,846318.87
6100,8/14/2020,8/14/2020,82L-PRPD-081520,82L-PRPD-081520 -IMPORT PAYROLL-PARHAM-GANTT DENISE M,D108,HJ,3041.67,,849360.54
6100,8/14/2020,8/14/2020,82L-PRPD-081520,82L-PRPD-081520 -IMPORT PAYROLL-PATTERSON STEVE,D107,HJ,1047.62,,850408.16
6100,8/14/2020,8/14/2020,82L-PRPD-081520,82L-PRPD-081520 -IMPORT PAYROLL-PEINADO ELIZABETH R,D107,HJ,3749.96,,854158.12
6100,8/14/2020,8/14/2020,82L-PRPD-081520,82L-PRPD-081520 -IMPORT PAYROLL-POLANCO ODALIS,D103,HJ,3124.96,,857283.08
6100,8/14/2020,8/14/2020,82L-PRPD-081520,82L-PRPD-081520 -IMPORT PAYROLL-QUINTAS JASHIVE,D107,HJ,1916.67,,859199.75
6100,8/14/2020,8/14/2020,82L-PRPD-081520,82L-PRPD-081520 -IMPORT PAYROLL-RANDOLPH ALEXANDER,D107,HJ,1875,,861074.75
6100,8/14/2020,8/14/2020,82L-PRPD-081520,82L-PRPD-081520 -IMPORT PAYROLL-ROBBINS DEANNA,D107,HJ,2541.67,,863616.42
6100,8/14/2020,8/14/2020,82L-PRPD-081520,82L-PRPD-081520 -IMPORT PAYROLL-SAFRAN ALAN P,D102,HJ,7516.88,,871133.3
6100,8/14/2020,8/14/2020,82L-PRPD-081520,82L-PRPD-081520 -IMPORT PAYROLL-SCOTT KIRK DONOVAN,D107,HJ,1047.62,,872180.92
6100,8/14/2020,8/14/2020,82L-PRPD-081520,82L-PRPD-081520 -IMPORT PAYROLL-SHENKMAN OLIVIA,D107,HJ,2000,,874180.92
6100,8/14/2020,8/14/2020,82L-PRPD-081520,82L-PRPD-081520 -IMPORT PAYROLL-SHI GRACE,D103,HJ,875,,875055.92
6100,8/14/2020,8/14/2020,82L-PRPD-081520,82L-PRPD-081520 -IMPORT PAYROLL-SILVER KELLY,D107,HJ,2541.67,,877597.59
6100,8/14/2020,8/14/2020,82L-PRPD-081520,82L-PRPD-081520 -IMPORT PAYROLL-SOLIMAN MARK,D107,HJ,1047.62,,878645.21
6100,8/14/2020,8/14/2020,82L-PRPD-081520,82L-PRPD-081520 -IMPORT PAYROLL-STROUD DAVID,D107,HJ,1047.62,,879692.83
6100,8/14/2020,8/14/2020,82L-PRPD-081520,82L-PRPD-081520 -IMPORT PAYROLL-VALCIN SABRINA JEMIMAH,D107,HJ,1047.62,,880740.45
6100,8/14/2020,8/14/2020,82L-PRPD-081520,82L-PRPD-081520 -IMPORT PAYROLL-WEINSTOCK EMILY,D107,HJ,2833.33,,883573.78
6100,8/14/2020,8/14/2020,82L-PRPD-081520,82L-PRPD-081520 -IMPORT PAYROLL-WILLIAMS MACK ANTHONY,D107,HJ,1047.62,,884621.4
6100,8/14/2020,8/14/2020,82L-PRPD-081520,82L-PRPD-081520 -IMPORT PAYROLL-WILLIAMS MIL'YONTA,D107,HJ,1047.62,,885669.02
6100,8/14/2020,8/14/2020,82L-PRPD-081520,82L-PRPD-081520 -IMPORT PAYROLL-ZARATE JOSEPH M,D107,HJ,2150,,887819.02
6100,8/14/2020,8/14/2020,82L-PRPD-081520,82L-PRPD-081520 -IMPORT PAYROLL-ARCHER AUBREYNA,D108,HJ,2750,,890569.02
6100,8/14/2020,8/14/2020,82L-PRPD-081520,82L-PRPD-081520 -IMPORT PAYROLL-BARTOLD DEANNA MARIE,D108,HJ,3034.5,,893603.52
6100,8/14/2020,8/14/2020,82L-PRPD-081520,82L-PRPD-081520 -IMPORT PAYROLL-BELLOT GENESIS,D108,HJ,2333.33,,895936.85
6100,8/14/2020,8/14/2020,82L-PRPD-081520,82L-PRPD-081520 -IMPORT PAYROLL-CIRKER MIA,D108,HJ,2250,,898186.85
6100,8/14/2020,8/14/2020,82L-PRPD-081520,82L-PRPD-081520 -IMPORT PAYROLL-CORTEZ MIRANDA A,D111,HJ,2672.72,,900859.57
6100,8/14/2020,8/14/2020,82L-PRPD-081520,82L-PRPD-081520 -IMPORT PAYROLL-FEIGHERY JOHN,D108,HJ,2250,,903109.57
6100,8/14/2020,8/14/2020,82L-PRPD-081520,82L-PRPD-081520 -IMPORT PAYROLL-GARCIA MARILYN,D108,HJ,2291.67,,905401.24
6100,8/14/2020,8/14/2020,82L-PRPD-081520,82L-PRPD-081520 -IMPORT PAYROLL-GRIFFIN ANDREW,D108,HJ,2250,,907651.24
6100,8/14/2020,8/14/2020,82L-PRPD-081520,82L-PRPD-081520 -IMPORT PAYROLL-HALLINAN GABRIEL B,D108,HJ,2550,,910201.24
6100,8/14/2020,8/14/2020,82L-PRPD-081520,82L-PRPD-081520 -IMPORT PAYROLL-HOLDER LATIVA M,D108,HJ,3812.5,,914013.74
6100,8/14/2020,8/14/2020,82L-PRPD-081520,82L-PRPD-081520 -IMPORT PAYROLL-HOSSAIN MYESHA R,D108,HJ,2437.5,,916451.24
6100,8/14/2020,8/14/2020,82L-PRPD-081520,82L-PRPD-081520 -IMPORT PAYROLL-JACKSON TASNIM F,D108,HJ,2291.67,,918742.91
6100,8/14/2020,8/14/2020,82L-PRPD-081520,82L-PRPD-081520 -IMPORT PAYROLL-LI BELLA,D108,HJ,2486.25,,921229.16
6100,8/14/2020,8/14/2020,82L-PRPD-081520,82L-PRPD-081520 -IMPORT PAYROLL-MOSELEY ARIELLE,D108,HJ,2752.73,,923981.89
6100,8/14/2020,8/14/2020,82L-PRPD-081520,82L-PRPD-081520 -IMPORT PAYROLL-TILLERY ASIA,D108,HJ,3291.67,,927273.56
6100,8/14/2020,8/14/2020,82L-PRPD-081520,82L-PRPD-081520 -IMPORT PAYROLL-BALASUBRAMANIAN SHARANYA,D108,HJ,2666.67,,929940.23
6100,8/14/2020,8/14/2020,82L-PRPD-081520,82L-PRPD-081520 -IMPORT PAYROLL-COVENEY ALLISON,D108,HJ,2854.17,,932794.4
6100,8/14/2020,8/14/2020,82L-PRPD-081520,82L-PRPD-081520 -IMPORT PAYROLL-JACKSON CLAICE M,D108,HJ,3125,,935919.4
6100,8/14/2020,8/14/2020,82L-PRPD-081520,82L-PRPD-081520 -IMPORT PAYROLL-JANG DANIEL,D108,HJ,2750,,938669.4
6100,8/14/2020,8/14/2020,82L-PRPD-081520,82L-PRPD-081520 -IMPORT PAYROLL-LENEGHAN MARYELLEN B,D108,HJ,3812.5,,942481.9
6100,8/15/2020,8/15/2020,82L-PRPD-081520,To reverse 82L payroll 0815 JE-21-0020-To reverse 82L Payroll of 8152020,D108,HJ,,1833.33,940648.57
6100,8/15/2020,8/15/2020,82L-PRPD-081520,To reverse 82L payroll 0815 JE-21-0020-To reverse 82L Payroll of 8152020,D108,HJ,,1833.33,938815.24
6100,8/15/2020,8/15/2020,82L-PRPD-081520,To reverse 82L payroll 0815 JE-21-0020-To reverse 82L Payroll of 8152020,D108,HJ,,2187.5,936627.74
6100,8/15/2020,8/15/2020,82L-PRPD-081520,To reverse 82L payroll 0815 JE-21-0020-To reverse 82L Payroll of 8152020,D108,HJ,,2291.67,934336.07
6100,8/15/2020,8/15/2020,82L-PRPD-081520,To reverse 82L payroll 0815 JE-21-0020-To reverse 82L Payroll of 8152020,D108,HJ,,2329,932007.07
6100,8/15/2020,8/15/2020,82L-PRPD-081520,To reverse 82L payroll 0815 JE-21-0020-To reverse 82L Payroll of 8152020,D108,HJ,,2414,929593.07
6100,8/15/2020,8/15/2020,82L-PRPD-081520,To reverse 82L payroll 0815 JE-21-0020-To reverse 82L Payroll of 8152020,D108,HJ,,2416.67,927176.4
6100,8/15/2020,8/15/2020,82L-PRPD-081520,To reverse 82L payroll 0815 JE-21-0020-To reverse 82L Payroll of 8152020,D108,HJ,,2431.94,924744.46
6100,8/15/2020,8/15/2020,82L-PRPD-081520,To reverse 82L payroll 0815 JE-21-0020-To reverse 82L Payroll of 8152020,D108,HJ,,2458.33,922286.13
6100,8/15/2020,8/15/2020,82L-PRPD-081520,To reverse 82L payroll 0815 JE-21-0020-To reverse 82L Payroll of 8152020,D108,HJ,,2465,919821.13
6100,8/15/2020,8/15/2020,82L-PRPD-081520,To reverse 82L payroll 0815 JE-21-0020-To reverse 82L Payroll of 8152020,D108,HJ,,2500,917321.13
6100,8/15/2020,8/15/2020,82L-PRPD-081520,To reverse 82L payroll 0815 JE-21-0020-To reverse 82L Payroll of 8152020,D108,HJ,,2514.3,914806.83
6100,8/15/2020,8/15/2020,82L-PRPD-081520,To reverse 82L payroll 0815 JE-21-0020-To reverse 82L Payroll of 8152020,D108,HJ,,2635,912171.83
6100,8/15/2020,8/15/2020,82L-PRPD-081520,To reverse 82L payroll 0815 JE-21-0020-To reverse 82L Payroll of 8152020,D108,HJ,,2653.02,909518.81
6100,8/15/2020,8/15/2020,82L-PRPD-081520,To reverse 82L payroll 0815 JE-21-0020-To reverse 82L Payroll of 8152020,D108,HJ,,2666.67,906852.14
6100,8/15/2020,8/15/2020,82L-PRPD-081520,To reverse 82L payroll 0815 JE-21-0020-To reverse 82L Payroll of 8152020,D108,HJ,,2720,904132.14
6100,8/15/2020,8/15/2020,82L-PRPD-081520,To reverse 82L payroll 0815 JE-21-0020-To reverse 82L Payroll of 8152020,D108,HJ,,2762.5,901369.64
6100,8/15/2020,8/15/2020,82L-PRPD-081520,To reverse 82L payroll 0815 JE-21-0020-To reverse 82L Payroll of 8152020,D108,HJ,,2817.75,898551.89
6100,8/15/2020,8/15/2020,82L-PRPD-081520,To reverse 82L payroll 0815 JE-21-0020-To reverse 82L Payroll of 8152020,D108,HJ,,2886.52,895665.37
6100,8/15/2020,8/15/2020,82L-PRPD-081520,To reverse 82L payroll 0815 JE-21-0020-To reverse 82L Payroll of 8152020,D108,HJ,,2918.31,892747.06
6100,8/15/2020,8/15/2020,82L-PRPD-081520,To reverse 82L payroll 0815 JE-21-0020-To reverse 82L Payroll of 8152020,D108,HJ,,3113.75,889633.31
6100,8/15/2020,8/15/2020,82L-PRPD-081520,To reverse 82L payroll 0815 JE-21-0020-To reverse 82L Payroll of 8152020,D108,HJ,,3445,886188.31
6100,8/15/2020,8/15/2020,82L-PRPD-081520,To reverse 82L payroll 0815 JE-21-0020-To reverse 82L Payroll of 8152020,D108,HJ,,3812.5,882375.81
6100,8/15/2020,8/15/2020,82L-PRPD-081520,To reverse 82L payroll 0815 JE-21-0020-To reverse 82L Payroll of 8152020,D111,HJ,,2505.63,879870.18
6100,8/15/2020,8/15/2020,82L-PRPD-081520,To reverse 82L payroll 0815 JE-21-0020-To reverse 82L Payroll of 8152020,D102,HJ,,2916.67,876953.51
6100,8/15/2020,8/15/2020,82L-PRPD-081520,To reverse 82L payroll 0815 JE-21-0020-To reverse 82L Payroll of 8152020,D102,HJ,,5527.13,871426.38
6100,8/15/2020,8/15/2020,82L-PRPD-081520,To reverse 82L payroll 0815 JE-21-0020-To reverse 82L Payroll of 8152020,D102,HJ,,7516.88,863909.5
6100,8/15/2020,8/15/2020,82L-PRPD-081520,To reverse 82L payroll 0815 JE-21-0020-To reverse 82L Payroll of 8152020,D103,HJ,,875,863034.5
6100,8/15/2020,8/15/2020,82L-PRPD-081520,To reverse 82L payroll 0815 JE-21-0020-To reverse 82L Payroll of 8152020,D103,HJ,,2291.67,860742.83
6100,8/15/2020,8/15/2020,82L-PRPD-081520,To reverse 82L payroll 0815 JE-21-0020-To reverse 82L Payroll of 8152020,D103,HJ,,3124.96,857617.87
6100,8/15/2020,8/15/2020,82L-PRPD-081520,To reverse 82L payroll 0815 JE-21-0020-To reverse 82L Payroll of 8152020,D103,HJ,,5375,852242.87
6100,8/15/2020,8/15/2020,82L-PRPD-081520,To reverse 82L payroll 0815 JE-21-0020-To reverse 82L Payroll of 8152020,D107,HJ,,483.5,851759.37
6100,8/15/2020,8/15/2020,82L-PRPD-081520,To reverse 82L payroll 0815 JE-21-0020-To reverse 82L Payroll of 8152020,D107,HJ,,1041.67,850717.7
6100,8/15/2020,8/15/2020,82L-PRPD-081520,To reverse 82L payroll 0815 JE-21-0020-To reverse 82L Payroll of 8152020,D107,HJ,,1047.62,849670.08
6100,8/15/2020,8/15/2020,82L-PRPD-081520,To reverse 82L payroll 0815 JE-21-0020-To reverse 82L Payroll of 8152020,D107,HJ,,1047.62,848622.46
6100,8/15/2020,8/15/2020,82L-PRPD-081520,To reverse 82L payroll 0815 JE-21-0020-To reverse 82L Payroll of 8152020,D107,HJ,,1047.62,847574.84
6100,8/15/2020,8/15/2020,82L-PRPD-081520,To reverse 82L payroll 0815 JE-21-0020-To reverse 82L Payroll of 8152020,D107,HJ,,1047.62,846527.22
6100,8/15/2020,8/15/2020,82L-PRPD-081520,To reverse 82L payroll 0815 JE-21-0020-To reverse 82L Payroll of 8152020,D107,HJ,,1047.62,845479.6
6100,8/15/2020,8/15/2020,82L-PRPD-081520,To reverse 82L payroll 0815 JE-21-0020-To reverse 82L Payroll of 8152020,D107,HJ,,1047.62,844431.98
6100,8/15/2020,8/15/2020,82L-PRPD-081520,To reverse 82L payroll 0815 JE-21-0020-To reverse 82L Payroll of 8152020,D107,HJ,,1047.62,843384.36
6100,8/15/2020,8/15/2020,82L-PRPD-081520,To reverse 82L payroll 0815 JE-21-0020-To reverse 82L Payroll of 8152020,D107,HJ,,1047.62,842336.74
6100,8/15/2020,8/15/2020,82L-PRPD-081520,To reverse 82L payroll 0815 JE-21-0020-To reverse 82L Payroll of 8152020,D107,HJ,,1047.62,841289.12
6100,8/15/2020,8/15/2020,82L-PRPD-081520,To reverse 82L payroll 0815 JE-21-0020-To reverse 82L Payroll of 8152020,D107,HJ,,1047.62,840241.5
6100,8/15/2020,8/15/2020,82L-PRPD-081520,To reverse 82L payroll 0815 JE-21-0020-To reverse 82L Payroll of 8152020,D107,HJ,,1047.62,839193.88
6100,8/15/2020,8/15/2020,82L-PRPD-081520,To reverse 82L payroll 0815 JE-21-0020-To reverse 82L Payroll of 8152020,D107,HJ,,1047.62,838146.26
6100,8/15/2020,8/15/2020,82L-PRPD-081520,To reverse 82L payroll 0815 JE-21-0020-To reverse 82L Payroll of 8152020,D107,HJ,,1047.62,837098.64
6100,8/15/2020,8/15/2020,82L-PRPD-081520,To reverse 82L payroll 0815 JE-21-0020-To reverse 82L Payroll of 8152020,D107,HJ,,1047.62,836051.02
6100,8/15/2020,8/15/2020,82L-PRPD-081520,To reverse 82L payroll 0815 JE-21-0020-To reverse 82L Payroll of 8152020,D107,HJ,,1047.62,835003.4
6100,8/15/2020,8/15/2020,82L-PRPD-081520,To reverse 82L payroll 0815 JE-21-0020-To reverse 82L Payroll of 8152020,D107,HJ,,1047.62,833955.78
6100,8/15/2020,8/15/2020,82L-PRPD-081520,To reverse 82L payroll 0815 JE-21-0020-To reverse 82L Payroll of 8152020,D107,HJ,,1047.62,832908.16
6100,8/15/2020,8/15/2020,82L-PRPD-081520,To reverse 82L payroll 0815 JE-21-0020-To reverse 82L Payroll of 8152020,D107,HJ,,1047.62,831860.54
6100,8/15/2020,8/15/2020,82L-PRPD-081520,To reverse 82L payroll 0815 JE-21-0020-To reverse 82L Payroll of 8152020,D107,HJ,,1047.62,830812.92
6100,8/15/2020,8/15/2020,82L-PRPD-081520,To reverse 82L payroll 0815 JE-21-0020-To reverse 82L Payroll of 8152020,D107,HJ,,1047.62,829765.3
6100,8/15/2020,8/15/2020,82L-PRPD-081520,To reverse 82L payroll 0815 JE-21-0020-To reverse 82L Payroll of 8152020,D107,HJ,,1047.62,828717.68
6100,8/15/2020,8/15/2020,82L-PRPD-081520,To reverse 82L payroll 0815 JE-21-0020-To reverse 82L Payroll of 8152020,D107,HJ,,1047.62,827670.06
6100,8/15/2020,8/15/2020,82L-PRPD-081520,To reverse 82L payroll 0815 JE-21-0020-To reverse 82L Payroll of 8152020,D107,HJ,,1047.62,826622.44
6100,8/15/2020,8/15/2020,82L-PRPD-081520,To reverse 82L payroll 0815 JE-21-0020-To reverse 82L Payroll of 8152020,D107,HJ,,1047.62,825574.82
6100,8/15/2020,8/15/2020,82L-PRPD-081520,To reverse 82L payroll 0815 JE-21-0020-To reverse 82L Payroll of 8152020,D107,HJ,,1047.62,824527.2
6100,8/15/2020,8/15/2020,82L-PRPD-081520,To reverse 82L payroll 0815 JE-21-0020-To reverse 82L Payroll of 8152020,D107,HJ,,1047.62,823479.58
6100,8/15/2020,8/15/2020,82L-PRPD-081520,To reverse 82L payroll 0815 JE-21-0020-To reverse 82L Payroll of 8152020,D107,HJ,,1250,822229.58
6100,8/15/2020,8/15/2020,82L-PRPD-081520,To reverse 82L payroll 0815 JE-21-0020-To reverse 82L Payroll of 8152020,D107,HJ,,1476.86,820752.72
6100,8/15/2020,8/15/2020,82L-PRPD-081520,To reverse 82L payroll 0815 JE-21-0020-To reverse 82L Payroll of 8152020,D107,HJ,,1750,819002.72
6100,8/15/2020,8/15/2020,82L-PRPD-081520,To reverse 82L payroll 0815 JE-21-0020-To reverse 82L Payroll of 8152020,D107,HJ,,1875,817127.72
6100,8/15/2020,8/15/2020,82L-PRPD-081520,To reverse 82L payroll 0815 JE-21-0020-To reverse 82L Payroll of 8152020,D107,HJ,,1916.67,815211.05
6100,8/15/2020,8/15/2020,82L-PRPD-081520,To reverse 82L payroll 0815 JE-21-0020-To reverse 82L Payroll of 8152020,D107,HJ,,1916.67,813294.38
6100,8/15/2020,8/15/2020,82L-PRPD-081520,To reverse 82L payroll 0815 JE-21-0020-To reverse 82L Payroll of 8152020,D107,HJ,,2000,811294.38
6100,8/15/2020,8/15/2020,82L-PRPD-081520,To reverse 82L payroll 0815 JE-21-0020-To reverse 82L Payroll of 8152020,D107,HJ,,2083.33,809211.05
6100,8/15/2020,8/15/2020,82L-PRPD-081520,To reverse 82L payroll 0815 JE-21-0020-To reverse 82L Payroll of 8152020,D107,HJ,,2150,807061.05
6100,8/15/2020,8/15/2020,82L-PRPD-081520,To reverse 82L payroll 0815 JE-21-0020-To reverse 82L Payroll of 8152020,D107,HJ,,2213.22,804847.83
6100,8/15/2020,8/15/2020,82L-PRPD-081520,To reverse 82L payroll 0815 JE-21-0020-To reverse 82L Payroll of 8152020,D107,HJ,,2461.88,802385.95
6100,8/15/2020,8/15/2020,82L-PRPD-081520,To reverse 82L payroll 0815 JE-21-0020-To reverse 82L Payroll of 8152020,D107,HJ,,2541.67,799844.28
6100,8/15/2020,8/15/2020,82L-PRPD-081520,To reverse 82L payroll 0815 JE-21-0020-To reverse 82L Payroll of 8152020,D107,HJ,,2541.67,797302.61
6100,8/15/2020,8/15/2020,82L-PRPD-081520,To reverse 82L payroll 0815 JE-21-0020-To reverse 82L Payroll of 8152020,D107,HJ,,2541.67,794760.94
6100,8/15/2020,8/15/2020,82L-PRPD-081520,To reverse 82L payroll 0815 JE-21-0020-To reverse 82L Payroll of 8152020,D107,HJ,,2541.67,792219.27
6100,8/15/2020,8/15/2020,82L-PRPD-081520,To reverse 82L payroll 0815 JE-21-0020-To reverse 82L Payroll of 8152020,D107,HJ,,2707.5,789511.77
6100,8/15/2020,8/15/2020,82L-PRPD-081520,To reverse 82L payroll 0815 JE-21-0020-To reverse 82L Payroll of 8152020,D107,HJ,,2708.33,786803.44
6100,8/15/2020,8/15/2020,82L-PRPD-081520,To reverse 82L payroll 0815 JE-21-0020-To reverse 82L Payroll of 8152020,D107,HJ,,2833.33,783970.11
6100,8/15/2020,8/15/2020,82L-PRPD-081520,To reverse 82L payroll 0815 JE-21-0020-To reverse 82L Payroll of 8152020,D107,HJ,,2833.33,781136.78
6100,8/15/2020,8/15/2020,82L-PRPD-081520,To reverse 82L payroll 0815 JE-21-0020-To reverse 82L Payroll of 8152020,D107,HJ,,2897.92,778238.86
6100,8/15/2020,8/15/2020,82L-PRPD-081520,To reverse 82L payroll 0815 JE-21-0020-To reverse 82L Payroll of 8152020,D107,HJ,,2916.67,775322.19
6100,8/15/2020,8/15/2020,82L-PRPD-081520,To reverse 82L payroll 0815 JE-21-0020-To reverse 82L Payroll of 8152020,D107,HJ,,3437.5,771884.69
6100,8/15/2020,8/15/2020,82L-PRPD-081520,To reverse 82L payroll 0815 JE-21-0020-To reverse 82L Payroll of 8152020,D107,HJ,,3593.03,768291.66
6100,8/15/2020,8/15/2020,82L-PRPD-081520,To reverse 82L payroll 0815 JE-21-0020-To reverse 82L Payroll of 8152020,D107,HJ,,3749.96,764541.7
6100,8/15/2020,8/15/2020,82L-PRPD-081520,To reverse 82L payroll 0815 JE-21-0020-To reverse 82L Payroll of 8152020,D107,HJ,,5710.94,758830.76
6100,8/15/2020,8/15/2020,82L-PRPD-081520,To reverse 82L payroll 0815 JE-21-0020-To reverse 82L Payroll of 8152020,D108,HJ,,2698.75,756132.01
6100,8/15/2020,8/15/2020,82L-PRPD-081520,To reverse 82L payroll 0815 JE-21-0020-To reverse 82L Payroll of 8152020,D108,HJ,,3041.67,753090.34
6100,8/15/2020,8/15/2020,82L-PRPD-081520,To reverse 82L payroll 0815 JE-21-0020-To reverse 82L Payroll of 8152020,D108,HJ,,2250,750840.34
6100,8/15/2020,8/15/2020,82L-PRPD-081520,To reverse 82L payroll 0815 JE-21-0020-To reverse 82L Payroll of 8152020,D108,HJ,,2250,748590.34
6100,8/15/2020,8/15/2020,82L-PRPD-081520,To reverse 82L payroll 0815 JE-21-0020-To reverse 82L Payroll of 8152020,D108,HJ,,2250,746340.34
6100,8/15/2020,8/15/2020,82L-PRPD-081520,To reverse 82L payroll 0815 JE-21-0020-To reverse 82L Payroll of 8152020,D108,HJ,,2291.67,744048.67
6100,8/15/2020,8/15/2020,82L-PRPD-081520,To reverse 82L payroll 0815 JE-21-0020-To reverse 82L Payroll of 8152020,D108,HJ,,2291.67,741757
6100,8/15/2020,8/15/2020,82L-PRPD-081520,To reverse 82L payroll 0815 JE-21-0020-To reverse 82L Payroll of 8152020,D108,HJ,,2333.33,739423.67
6100,8/15/2020,8/15/2020,82L-PRPD-081520,To reverse 82L payroll 0815 JE-21-0020-To reverse 82L Payroll of 8152020,D108,HJ,,2437.5,736986.17
6100,8/15/2020,8/15/2020,82L-PRPD-081520,To reverse 82L payroll 0815 JE-21-0020-To reverse 82L Payroll of 8152020,D108,HJ,,2486.25,734499.92
6100,8/15/2020,8/15/2020,82L-PRPD-081520,To reverse 82L payroll 0815 JE-21-0020-To reverse 82L Payroll of 8152020,D108,HJ,,2550,731949.92
6100,8/15/2020,8/15/2020,82L-PRPD-081520,To reverse 82L payroll 0815 JE-21-0020-To reverse 82L Payroll of 8152020,D108,HJ,,2750,729199.92
6100,8/15/2020,8/15/2020,82L-PRPD-081520,To reverse 82L payroll 0815 JE-21-0020-To reverse 82L Payroll of 8152020,D108,HJ,,2752.73,726447.19
6100,8/15/2020,8/15/2020,82L-PRPD-081520,To reverse 82L payroll 0815 JE-21-0020-To reverse 82L Payroll of 8152020,D108,HJ,,3034.5,723412.69
6100,8/15/2020,8/15/2020,82L-PRPD-081520,To reverse 82L payroll 0815 JE-21-0020-To reverse 82L Payroll of 8152020,D108,HJ,,3291.67,720121.02
6100,8/15/2020,8/15/2020,82L-PRPD-081520,To reverse 82L payroll 0815 JE-21-0020-To reverse 82L Payroll of 8152020,D108,HJ,,3812.5,716308.52
6100,8/15/2020,8/15/2020,82L-PRPD-081520,To reverse 82L payroll 0815 JE-21-0020-To reverse 82L Payroll of 8152020,D111,HJ,,2672.72,713635.8
6100,8/15/2020,8/15/2020,82L-PRPD-081520,To reverse 82L payroll 0815 JE-21-0020-To reverse 82L Payroll of 8152020,D108,HJ,,2666.67,710969.13
6100,8/15/2020,8/15/2020,82L-PRPD-081520,To reverse 82L payroll 0815 JE-21-0020-To reverse 82L Payroll of 8152020,D108,HJ,,2750,708219.13
6100,8/15/2020,8/15/2020,82L-PRPD-081520,To reverse 82L payroll 0815 JE-21-0020-To reverse 82L Payroll of 8152020,D108,HJ,,2854.17,705364.96
6100,8/15/2020,8/15/2020,82L-PRPD-081520,To reverse 82L payroll 0815 JE-21-0020-To reverse 82L Payroll of 8152020,D108,HJ,,3125,702239.96
6100,8/15/2020,8/15/2020,82L-PRPD-081520,To reverse 82L payroll 0815 JE-21-0020-To reverse 82L Payroll of 8152020,D108,HJ,,3812.5,698427.46
6100,8/31/2020,8/31/2020,83120,82L-IMPORT PAYROLL-ALVAREZ-MORINE LISIS,D108,HJ,2541.67,,700969.13
6100,8/31/2020,8/31/2020,83120,82L-IMPORT PAYROLL-ALWARDT CALEB,D108,HJ,1047.62,,702016.75
6100,8/31/2020,8/31/2020,83120,82L-IMPORT PAYROLL-BARTHELEMY RACHALIE,D108,HJ,1047.62,,703064.37
6100,8/31/2020,8/31/2020,83120,82L-IMPORT PAYROLL-BASHAM WILLIAM EDWARD,D108,HJ,1047.62,,704111.99
6100,8/31/2020,8/31/2020,83120,82L-IMPORT PAYROLL-BOHLSEN GRACE,D108,HJ,1047.62,,705159.61
6100,8/31/2020,8/31/2020,83120,82L-IMPORT PAYROLL-BORCHART SPENCER,D108,HJ,1047.62,,706207.23
6100,8/31/2020,8/31/2020,83120,82L-IMPORT PAYROLL-BREEDLOVE JOHNDEE L,D108,HJ,1047.62,,707254.85
6100,8/31/2020,8/31/2020,83120,82L-IMPORT PAYROLL-BROWN ISAAC,D108,HJ,1047.62,,708302.47
6100,8/31/2020,8/31/2020,83120,82L-IMPORT PAYROLL-BURKE MARIAH,D108,HJ,1047.62,,709350.09
6100,8/31/2020,8/31/2020,83120,82L-IMPORT PAYROLL-CASSADY JOSHUA LEWIS,D108,HJ,1047.62,,710397.71
6100,8/31/2020,8/31/2020,83120,82L-IMPORT PAYROLL-CHAVOUS MILFORD,D108,HJ,1047.62,,711445.33
6100,8/31/2020,8/31/2020,83120,82L-IMPORT PAYROLL-CHEN LING,D108,HJ,1047.62,,712492.95
6100,8/31/2020,8/31/2020,83120,82L-IMPORT PAYROLL-DARKO OLIVIA,D108,HJ,1047.62,,713540.57
6100,8/31/2020,8/31/2020,83120,82L-IMPORT PAYROLL-DAWSON JAMIL NAFAYE-BEYAH,D108,HJ,1047.62,,714588.19
6100,8/31/2020,8/31/2020,83120,82L-IMPORT PAYROLL-ESCAMILLA OLGA,D108,HJ,1047.62,,715635.81
6100,8/31/2020,8/31/2020,83120,82L-IMPORT PAYROLL-GARCIA SANTIAGO,D108,HJ,2042,,717677.81
6100,8/31/2020,8/31/2020,83120,82L-IMPORT PAYROLL-GILES SHAYLA,D108,HJ,1047.62,,718725.43
6100,8/31/2020,8/31/2020,83120,82L-IMPORT PAYROLL-JONES JORDAN,D108,HJ,1047.62,,719773.05
6100,8/31/2020,8/31/2020,83120,82L-IMPORT PAYROLL-KHAN HUDA,D108,HJ,1047.62,,720820.67
6100,8/31/2020,8/31/2020,83120,82L-IMPORT PAYROLL-KLOHR TIMOTHY JORDAN,D108,HJ,2000,,722820.67
6100,8/31/2020,8/31/2020,83120,82L-IMPORT PAYROLL-KOPSHEVER MELISSA,D108,HJ,2916.67,,725737.34
6100,8/31/2020,8/31/2020,83120,82L-IMPORT PAYROLL-LI SEN YUAN,D108,HJ,1047.62,,726784.96
6100,8/31/2020,8/31/2020,83120,82L-IMPORT PAYROLL-LIPSCOMB STEPHEN,D108,HJ,2541.67,,729326.63
6100,8/31/2020,8/31/2020,83120,82L-IMPORT PAYROLL-MALLECK JESSICA R,D108,HJ,1047.62,,730374.25
6100,8/31/2020,8/31/2020,83120,82L-IMPORT PAYROLL-MCLAUGHLIN MARA,D108,HJ,1047.62,,731421.87
6100,8/31/2020,8/31/2020,83120,82L-IMPORT PAYROLL-MEJIA CARLOS MANUEL,D108,HJ,1047.62,,732469.49
6100,8/31/2020,8/31/2020,83120,82L-IMPORT PAYROLL-MONROY-MEJIA JASON,D108,HJ,1047.62,,733517.11
6100,8/31/2020,8/31/2020,83120,82L-IMPORT PAYROLL-O'FLYNN-PRUITT NATHAN COLYAR,D108,HJ,1047.62,,734564.73
6100,8/31/2020,8/31/2020,83120,82L-IMPORT PAYROLL-PATTERSON STEVE,D108,HJ,1047.62,,735612.35
6100,8/31/2020,8/31/2020,83120,82L-IMPORT PAYROLL-ROBBINS DEANNA,D108,HJ,1173.03,,736785.38
6100,8/31/2020,8/31/2020,83120,82L-IMPORT PAYROLL-SCHMIESS RACHEL JOY,D108,HJ,2095.24,,738880.62
6100,8/31/2020,8/31/2020,83120,82L-IMPORT PAYROLL-SCOTT KIRK DONOVAN,D108,HJ,1047.62,,739928.24
6100,8/31/2020,8/31/2020,83120,82L-IMPORT PAYROLL-SILVER KELLY,D108,HJ,2541.67,,742469.91
6100,8/31/2020,8/31/2020,83120,82L-IMPORT PAYROLL-SOLIMAN MARK,D108,HJ,1047.62,,743517.53
6100,8/31/2020,8/31/2020,83120,82L-IMPORT PAYROLL-STROUD DAVID,D108,HJ,1047.62,,744565.15
6100,8/31/2020,8/31/2020,83120,82L-IMPORT PAYROLL-VALCIN SABRINA JEMIMAH,D108,HJ,1047.62,,745612.77
6100,8/31/2020,8/31/2020,83120,82L-IMPORT PAYROLL-VALDES ERNEST L,D108,HJ,2095.24,,747708.01
6100,8/31/2020,8/31/2020,83120,82L-IMPORT PAYROLL-WILLIAMS MACK ANTHONY,D108,HJ,1047.62,,748755.63
6100,8/31/2020,8/31/2020,83120,82L-IMPORT PAYROLL-WILLIAMS MIL'YONTA,D108,HJ,1047.62,,749803.25
6100,8/31/2020,8/31/2020,83120,82L-IMPORT PAYROLL-ANTHONY BETTY S,D108,HJ,2886.52,,752689.77
6100,8/31/2020,8/31/2020,83120,82L-IMPORT PAYROLL-AUSTIN PERCY,D108,HJ,2653.02,,755342.79
6100,8/31/2020,8/31/2020,83120,82L-IMPORT PAYROLL-BAUSH DANIEL,D108,HJ,500,,755842.79
6100,8/31/2020,8/31/2020,83120,82L-IMPORT PAYROLL-BAUSH DANIEL,D108,HJ,2762.5,,758605.29
6100,8/31/2020,8/31/2020,83120,82L-IMPORT PAYROLL-CHAPMAN CLAUDY EARL,D108,HJ,1833.33,,760438.62
6100,8/31/2020,8/31/2020,83120,82L-IMPORT PAYROLL-DADA ARIKPO E,D108,HJ,500,,760938.62
6100,8/31/2020,8/31/2020,83120,82L-IMPORT PAYROLL-DADA ARIKPO E,D108,HJ,2720,,763658.62
6100,8/31/2020,8/31/2020,83120,82L-IMPORT PAYROLL-GUTHRIE LESLIE,D108,HJ,2458.33,,766116.95
6100,8/31/2020,8/31/2020,83120,82L-IMPORT PAYROLL-HOLMES JOREL ALEXANDER,D108,HJ,2329,,768445.95
6100,8/31/2020,8/31/2020,83120,82L-IMPORT PAYROLL-JORDAN TIFFANY T,D108,HJ,3445,,771890.95
6100,8/31/2020,8/31/2020,83120,82L-IMPORT PAYROLL-LANIGAN LISA A,D108,HJ,3113.75,,775004.7
6100,8/31/2020,8/31/2020,83120,82L-IMPORT PAYROLL-MCELWEE MELISSA,D108,HJ,2666.67,,777671.37
6100,8/31/2020,8/31/2020,83120,82L-IMPORT PAYROLL-MCNICHOLAS MARY,D108,HJ,2291.67,,779963.04
6100,8/31/2020,8/31/2020,83120,82L-IMPORT PAYROLL-NWAKANMA NANCY,D108,HJ,500,,780463.04
6100,8/31/2020,8/31/2020,83120,82L-IMPORT PAYROLL-NWAKANMA NANCY,D108,HJ,2918.31,,783381.35
6100,8/31/2020,8/31/2020,83120,82L-IMPORT PAYROLL-ONICA ANTHONY J,D108,HJ,2416.67,,785798.02
6100,8/31/2020,8/31/2020,83120,82L-IMPORT PAYROLL-PRAHIN NICOLE M,D108,HJ,3812.5,,789610.52
6100,8/31/2020,8/31/2020,83120,82L-IMPORT PAYROLL-RIVERS QUIONNA DIANE,D108,HJ,500,,790110.52
6100,8/31/2020,8/31/2020,83120,82L-IMPORT PAYROLL-RIVERS QUIONNA DIANE,D108,HJ,2514.3,,792624.82
6100,8/31/2020,8/31/2020,83120,82L-IMPORT PAYROLL-SALIM YASSER,D108,HJ,2431.94,,795056.76
6100,8/31/2020,8/31/2020,83120,82L-IMPORT PAYROLL-SEJOUR MAHALIAH,D108,HJ,2500,,797556.76
6100,8/31/2020,8/31/2020,83120,82L-IMPORT PAYROLL-SKALSKI CHRISTOPHER,D108,HJ,2465,,800021.76
6100,8/31/2020,8/31/2020,83120,82L-IMPORT PAYROLL-TUMENJARGAL ENKHJIN,D108,HJ,2414,,802435.76
6100,8/31/2020,8/31/2020,83120,82L-IMPORT PAYROLL-VILLEGAS EVELYN,D108,HJ,500,,802935.76
6100,8/31/2020,8/31/2020,83120,82L-IMPORT PAYROLL-VILLEGAS EVELYN,D108,HJ,2817.75,,805753.51
6100,8/31/2020,8/31/2020,83120,82L-IMPORT PAYROLL-WOLF ANNA A,D108,HJ,2635,,808388.51
6100,8/31/2020,8/31/2020,83120,82L-IMPORT PAYROLL-ACEVEDO MONIVETT,D107,HJ,5375,,813763.51
6100,8/31/2020,8/31/2020,83120,82L-IMPORT PAYROLL-AKLESTAD ISABEL,D111,HJ,1750,,815513.51
6100,8/31/2020,8/31/2020,83120,82L-IMPORT PAYROLL-ALLEN KIMBERLY MARY,D111,HJ,1833.33,,817346.84
6100,8/31/2020,8/31/2020,83120,82L-IMPORT PAYROLL-BOWMAN HALLEY K,D101,HJ,3437.5,,820784.34
6100,8/31/2020,8/31/2020,83120,82L-IMPORT PAYROLL-COOK CATHRYN ANNA,D105,HJ,3593.03,,824377.37
6100,8/31/2020,8/31/2020,83120,82L-IMPORT PAYROLL-COOPER ASHLEE R,D101,HJ,2461.88,,826839.25
6100,8/31/2020,8/31/2020,83120,82L-IMPORT PAYROLL-CORTEZ MIRANDA A,D111,HJ,2672.72,,829511.97
6100,8/31/2020,8/31/2020,83120,82L-IMPORT PAYROLL-DAUGHERTY DEVIN W,D101,HJ,1041.67,,830553.64
6100,8/31/2020,8/31/2020,83120,82L-IMPORT PAYROLL-DETONE KYRA MAYA,D102,HJ,2916.67,,833470.31
6100,8/31/2020,8/31/2020,83120,82L-IMPORT PAYROLL-DUPUIS CHRISTOPHER M,D107,HJ,2633.75,,836104.06
6100,8/31/2020,8/31/2020,83120,82L-IMPORT PAYROLL-DUPUIS CHRISTOPHER M,D107,HJ,3637.08,,839741.14
6100,8/31/2020,8/31/2020,83120,82L-IMPORT PAYROLL-DZIEDZIC JULIE K,D101,HJ,1250,,840991.14
6100,8/31/2020,8/31/2020,83120,82L-IMPORT PAYROLL-GORNSTEIN STEVEN,D101,HJ,2708.33,,843699.47
6100,8/31/2020,8/31/2020,83120,82L-IMPORT PAYROLL-GRAVES KAMIESHIA,D101,HJ,2083.33,,845782.8
6100,8/31/2020,8/31/2020,83120,82L-IMPORT PAYROLL-GUADARRAMA-ALVAREZ URIEL A,D105,HJ,2897.92,,848680.72
6100,8/31/2020,8/31/2020,83120,82L-IMPORT PAYROLL-GUTIERREZ ANTONIO J,D107,HJ,5527.13,,854207.85
6100,8/31/2020,8/31/2020,83120,82L-IMPORT PAYROLL-HENRY GILLIAN,D102,HJ,480.8,,854688.65
6100,8/31/2020,8/31/2020,83120,82L-IMPORT PAYROLL-HESTER TYLER CONRAD,D105,HJ,1916.67,,856605.32
6100,8/31/2020,8/31/2020,83120,82L-IMPORT PAYROLL-LACEY DEQUITA,D107,HJ,2698.75,,859304.07
6100,8/31/2020,8/31/2020,83120,82L-IMPORT PAYROLL-LIPORACE HERNAN LUIS,D103,HJ,2291.67,,861595.74
6100,8/31/2020,8/31/2020,83120,82L-IMPORT PAYROLL-MASON ANGELA,D107,HJ,5710.94,,867306.68
6100,8/31/2020,8/31/2020,83120,82L-IMPORT PAYROLL-ODONNELL STEPHEN,D104,HJ,2707.5,,870014.18
6100,8/31/2020,8/31/2020,83120,82L-IMPORT PAYROLL-PARETS MALLORY GRACE,D101,HJ,2833.33,,872847.51
6100,8/31/2020,8/31/2020,83120,82L-IMPORT PAYROLL-PARHAM-GANTT DENISE M,D112,HJ,3041.67,,875889.18
6100,8/31/2020,8/31/2020,83120,82L-IMPORT PAYROLL-PEINADO ELIZABETH R,D111,HJ,3749.96,,879639.14
6100,8/31/2020,8/31/2020,83120,82L-IMPORT PAYROLL-POLANCO ODALIS,D103,HJ,3124.96,,882764.1
6100,8/31/2020,8/31/2020,83120,82L-IMPORT PAYROLL-QUINTAS JASHIVE,D105,HJ,1916.67,,884680.77
6100,8/31/2020,8/31/2020,83120,82L-IMPORT PAYROLL-RANDOLPH ALEXANDER,D111,HJ,1875,,886555.77
6100,8/31/2020,8/31/2020,83120,82L-IMPORT PAYROLL-SAFRAN ALAN P,D107,HJ,601.35,,887157.12
6100,8/31/2020,8/31/2020,83120,82L-IMPORT PAYROLL-SAFRAN ALAN P,D107,HJ,6915.53,,894072.65
6100,8/31/2020,8/31/2020,83120,82L-IMPORT PAYROLL-SHENKMAN OLIVIA,D101,HJ,2000,,896072.65
6100,8/31/2020,8/31/2020,83120,82L-IMPORT PAYROLL-SHI GRACE,D103,HJ,875,,896947.65
6100,8/31/2020,8/31/2020,83120,82L-IMPORT PAYROLL-WALLACE AMENA,D104,HJ,2187.5,,899135.15
6100,8/31/2020,8/31/2020,83120,82L-IMPORT PAYROLL-WEINSTOCK EMILY,D101,HJ,2833.33,,901968.48
6100,8/31/2020,8/31/2020,83120,82L-IMPORT PAYROLL-WINANS JENNIFER,D111,HJ,2505.63,,904474.11
6100,8/31/2020,8/31/2020,83120,82L-IMPORT PAYROLL-ZARATE JOSEPH M,D105,HJ,2150,,906624.11
6100,8/31/2020,8/31/2020,83120,82L-IMPORT PAYROLL-AGUANNO JOSEPH,D108,HJ,1119.05,,907743.16
6100,8/31/2020,8/31/2020,83120,82L-IMPORT PAYROLL-AKESODE FEHINTOLA,D108,HJ,1119.05,,908862.21
6100,8/31/2020,8/31/2020,83120,82L-IMPORT PAYROLL-ARCHER AUBREYNA,D108,HJ,761.51,,909623.72
6100,8/31/2020,8/31/2020,83120,82L-IMPORT PAYROLL-BARTOLD DEANNA MARIE,D108,HJ,3034.5,,912658.22
6100,8/31/2020,8/31/2020,83120,82L-IMPORT PAYROLL-BELLOT GENESIS,D108,HJ,2333.33,,914991.55
6100,8/31/2020,8/31/2020,83120,82L-IMPORT PAYROLL-BENNETT JAMES H,D108,HJ,1119.05,,916110.6
6100,8/31/2020,8/31/2020,83120,82L-IMPORT PAYROLL-BURRELL RUSSELL,D108,HJ,1119.05,,917229.65
6100,8/31/2020,8/31/2020,83120,82L-IMPORT PAYROLL-CHUI KENT,D108,HJ,1119.05,,918348.7
6100,8/31/2020,8/31/2020,83120,82L-IMPORT PAYROLL-CIRKER MIA,D108,HJ,2250,,920598.7
6100,8/31/2020,8/31/2020,83120,82L-IMPORT PAYROLL-COUGHLIN ABIGAIL,D108,HJ,1119.05,,921717.75
6100,8/31/2020,8/31/2020,83120,82L-IMPORT PAYROLL-DEFREITAS NOEL,D108,HJ,516.46,,922234.21
6100,8/31/2020,8/31/2020,83120,82L-IMPORT PAYROLL-DIETZ MARY,D108,HJ,1119.05,,923353.26
6100,8/31/2020,8/31/2020,83120,82L-IMPORT PAYROLL-DOMINIQUE PRINCESSA,D108,HJ,1119.05,,924472.31
6100,8/31/2020,8/31/2020,83120,82L-IMPORT PAYROLL-DONNELLY HOME,D108,HJ,1119.05,,925591.36
6100,8/31/2020,8/31/2020,83120,82L-IMPORT PAYROLL-FEIGHERY JOHN,D108,HJ,2250,,927841.36
6100,8/31/2020,8/31/2020,83120,82L-IMPORT PAYROLL-GARCIA MARILYN,D108,HJ,2291.67,,930133.03
6100,8/31/2020,8/31/2020,83120,82L-IMPORT PAYROLL-GARNER IVORY,D108,HJ,1632,,931765.03
6100,8/31/2020,8/31/2020,83120,82L-IMPORT PAYROLL-GILL JULIA,D108,HJ,1119.05,,932884.08
6100,8/31/2020,8/31/2020,83120,82L-IMPORT PAYROLL-GREENE BROOKE,D108,HJ,1119.05,,934003.13
6100,8/31/2020,8/31/2020,83120,82L-IMPORT PAYROLL-GRIFFIN ANDREW,D108,HJ,2250,,936253.13
6100,8/31/2020,8/31/2020,83120,82L-IMPORT PAYROLL-GROSS EMILY,D108,HJ,1119.05,,937372.18
6100,8/31/2020,8/31/2020,83120,82L-IMPORT PAYROLL-GUERRERO LUIS,D108,HJ,1119.05,,938491.23
6100,8/31/2020,8/31/2020,83120,82L-IMPORT PAYROLL-HALLINAN GABRIEL B,D108,HJ,2550,,941041.23
6100,8/31/2020,8/31/2020,83120,82L-IMPORT PAYROLL-HAMERSLY WILLIAM,D108,HJ,2500,,943541.23
6100,8/31/2020,8/31/2020,83120,82L-IMPORT PAYROLL-HEYMANN DANIEL A,D108,HJ,1119.05,,944660.28
6100,8/31/2020,8/31/2020,83120,82L-IMPORT PAYROLL-HOLDER LATIVA M,D108,HJ,3812.5,,948472.78
6100,8/31/2020,8/31/2020,83120,82L-IMPORT PAYROLL-HOSSAIN MYESHA R,D108,HJ,2437.5,,950910.28
6100,8/31/2020,8/31/2020,83120,82L-IMPORT PAYROLL-JACKSON TASNIM F,D108,HJ,2291.67,,953201.95
6100,8/31/2020,8/31/2020,83120,82L-IMPORT PAYROLL-KERKHOFF HARPER FAITH,D108,HJ,1119.05,,954321
6100,8/31/2020,8/31/2020,83120,82L-IMPORT PAYROLL-LEARY AUBREY,D108,HJ,1119.05,,955440.05
6100,8/31/2020,8/31/2020,83120,82L-IMPORT PAYROLL-LI BELLA,D108,HJ,2486.25,,957926.3
6100,8/31/2020,8/31/2020,83120,82L-IMPORT PAYROLL-LOUIE JORDAN,D108,HJ,1119.05,,959045.35
6100,8/31/2020,8/31/2020,83120,82L-IMPORT PAYROLL-MELCHOR OSBEIDY,D108,HJ,1119.05,,960164.4
6100,8/31/2020,8/31/2020,83120,82L-IMPORT PAYROLL-MORRIS ZAKIYA,D108,HJ,1119.05,,961283.45
6100,8/31/2020,8/31/2020,83120,82L-IMPORT PAYROLL-MORSELETTO RAFAEL,D108,HJ,1119.05,,962402.5
6100,8/31/2020,8/31/2020,83120,82L-IMPORT PAYROLL-OBI TOBECHUKWU,D108,HJ,1119.05,,963521.55
6100,8/31/2020,8/31/2020,83120,82L-IMPORT PAYROLL-OPUH NDIDI,D108,HJ,3094.5,,966616.05
6100,8/31/2020,8/31/2020,83120,82L-IMPORT PAYROLL-PAULINO THAIRI,D108,HJ,1119.05,,967735.1
6100,8/31/2020,8/31/2020,83120,82L-IMPORT PAYROLL-RICE DELASIA,D108,HJ,309.88,,968044.98
6100,8/31/2020,8/31/2020,83120,82L-IMPORT PAYROLL-ROSENBAUM MURRAY,D108,HJ,1119.05,,969164.03
6100,8/31/2020,8/31/2020,83120,82L-IMPORT PAYROLL-SCHWETTMANN CLAIRE,D108,HJ,1119.05,,970283.08
6100,8/31/2020,8/31/2020,83120,82L-IMPORT PAYROLL-SOBELMAN JUSTIN,D108,HJ,1119.05,,971402.13
6100,8/31/2020,8/31/2020,83120,82L-IMPORT PAYROLL-TERRENCE-SMITH ZI,D108,HJ,1119.05,,972521.18
6100,8/31/2020,8/31/2020,83120,82L-IMPORT PAYROLL-TILLERY ASIA,D108,HJ,3291.67,,975812.85
6100,8/31/2020,8/31/2020,83120,82L-IMPORT PAYROLL-WILLIAMS- MASSEY BRIANNA M,D108,HJ,1119.05,,976931.9
6100,8/31/2020,8/31/2020,83120,82L-IMPORT PAYROLL-XIAO CHENGYAO,D108,HJ,1119.05,,978050.95
6100,8/31/2020,8/31/2020,83120,82L-IMPORT PAYROLL-ZIAUDDIN ABUTAHER M,D108,HJ,1119.05,,979170
6100,8/31/2020,8/31/2020,83120,82L-IMPORT PAYROLL-BALASUBRAMANIAN SHARANYA,D108,HJ,2666.67,,981836.67
6100,8/31/2020,8/31/2020,83120,82L-IMPORT PAYROLL-COVENEY ALLISON,D108,HJ,2854.17,,984690.84
6100,8/31/2020,8/31/2020,83120,82L-IMPORT PAYROLL-JACKSON CLAICE M,D108,HJ,3125,,987815.84
6100,8/31/2020,8/31/2020,83120,82L-IMPORT PAYROLL-JANG DANIEL,D108,HJ,2750,,990565.84
6100,8/31/2020,8/31/2020,83120,82L-IMPORT PAYROLL-LENEGHAN MARYELLEN,D108,HJ,1029.37,,991595.21
6100,8/31/2020,8/31/2020,83120,82L-IMPORT PAYROLL-LENEGHAN MARYELLEN,D108,HJ,2783.13,,994378.34
6100,8/31/2020,8/31/2020,82L-PRPD-083120,82L-PRPD-083120 -IMPORT PAYROLL-ALLEN KIMBERLY MARY,D108,HJ,1833.33,,996211.67
6100,8/31/2020,8/31/2020,82L-PRPD-083120,82L-PRPD-083120 -IMPORT PAYROLL-ANTHONY BETTY S,D108,HJ,2886.52,,999098.19
6100,8/31/2020,8/31/2020,82L-PRPD-083120,82L-PRPD-083120 -IMPORT PAYROLL-AUSTIN PERCY,D108,HJ,2653.02,,1001751.21
6100,8/31/2020,8/31/2020,82L-PRPD-083120,82L-PRPD-083120 -IMPORT PAYROLL-BAUSH DANIEL,D108,HJ,2762.5,,1004513.71
6100,8/31/2020,8/31/2020,82L-PRPD-083120,82L-PRPD-083120 -IMPORT PAYROLL-CHAPMAN CLAUDY EARL,D108,HJ,1833.33,,1006347.04
6100,8/31/2020,8/31/2020,82L-PRPD-083120,82L-PRPD-083120 -IMPORT PAYROLL-DADA ARIKPO E,D108,HJ,2720,,1009067.04
6100,8/31/2020,8/31/2020,82L-PRPD-083120,82L-PRPD-083120 -IMPORT PAYROLL-GUTHRIE LESLIE,D108,HJ,2458.33,,1011525.37
6100,8/31/2020,8/31/2020,82L-PRPD-083120,82L-PRPD-083120 -IMPORT PAYROLL-HOLMES JOREL ALEXANDER,D108,HJ,2329,,1013854.37
6100,8/31/2020,8/31/2020,82L-PRPD-083120,82L-PRPD-083120 -IMPORT PAYROLL-JORDAN TIFFANY T,D108,HJ,3445,,1017299.37
6100,8/31/2020,8/31/2020,82L-PRPD-083120,82L-PRPD-083120 -IMPORT PAYROLL-LANIGAN LISA A,D108,HJ,3113.75,,1020413.12
6100,8/31/2020,8/31/2020,82L-PRPD-083120,82L-PRPD-083120 -IMPORT PAYROLL-MCELWEE MELISSA,D108,HJ,2666.67,,1023079.79
6100,8/31/2020,8/31/2020,82L-PRPD-083120,82L-PRPD-083120 -IMPORT PAYROLL-MCNICHOLAS MARY,D108,HJ,2291.67,,1025371.46
6100,8/31/2020,8/31/2020,82L-PRPD-083120,82L-PRPD-083120 -IMPORT PAYROLL-NWAKANMA NANCY,D108,HJ,2918.31,,1028289.77
6100,8/31/2020,8/31/2020,82L-PRPD-083120,82L-PRPD-083120 -IMPORT PAYROLL-ONICA ANTHONY J,D108,HJ,2416.67,,1030706.44
6100,8/31/2020,8/31/2020,82L-PRPD-083120,82L-PRPD-083120 -IMPORT PAYROLL-PRAHIN NICOLE M,D108,HJ,3812.5,,1034518.94
6100,8/31/2020,8/31/2020,82L-PRPD-083120,82L-PRPD-083120 -IMPORT PAYROLL-RIVERS QUIONNA DIANE,D108,HJ,2514.3,,1037033.24
6100,8/31/2020,8/31/2020,82L-PRPD-083120,82L-PRPD-083120 -IMPORT PAYROLL-SALIM YASSER,D108,HJ,2431.94,,1039465.18
6100,8/31/2020,8/31/2020,82L-PRPD-083120,82L-PRPD-083120 -IMPORT PAYROLL-SEJOUR MAHALIAH,D108,HJ,2500,,1041965.18
6100,8/31/2020,8/31/2020,82L-PRPD-083120,82L-PRPD-083120 -IMPORT PAYROLL-SKALSKI CHRISTOPHER,D108,HJ,2465,,1044430.18
6100,8/31/2020,8/31/2020,82L-PRPD-083120,82L-PRPD-083120 -IMPORT PAYROLL-TUMENJARGAL ENKHJIN,D108,HJ,2414,,1046844.18
6100,8/31/2020,8/31/2020,82L-PRPD-083120,82L-PRPD-083120 -IMPORT PAYROLL-VILLEGAS EVELYN,D108,HJ,2817.75,,1049661.93
6100,8/31/2020,8/31/2020,82L-PRPD-083120,82L-PRPD-083120 -IMPORT PAYROLL-WALLACE AMENA T,D108,HJ,2187.5,,1051849.43
6100,8/31/2020,8/31/2020,82L-PRPD-083120,82L-PRPD-083120 -IMPORT PAYROLL-WINANS JENNIFER,D111,HJ,2505.63,,1054355.06
6100,8/31/2020,8/31/2020,82L-PRPD-083120,82L-PRPD-083120 -IMPORT PAYROLL-WOLF ANNA A,D108,HJ,2635,,1056990.06
6100,8/31/2020,8/31/2020,82L-PRPD-083120,Reverse 82L payroll of 83120 JE-21-0021-IMPORT PAYROLL,D108,HJ,,1833.33,1055156.73
6100,8/31/2020,8/31/2020,82L-PRPD-083120,Reverse 82L payroll of 83120 JE-21-0021-IMPORT PAYROLL,D108,HJ,,1833.33,1053323.4
6100,8/31/2020,8/31/2020,82L-PRPD-083120,Reverse 82L payroll of 83120 JE-21-0021-IMPORT PAYROLL,D108,HJ,,2187.5,1051135.9
6100,8/31/2020,8/31/2020,82L-PRPD-083120,Reverse 82L payroll of 83120 JE-21-0021-IMPORT PAYROLL,D108,HJ,,2291.67,1048844.23
6100,8/31/2020,8/31/2020,82L-PRPD-083120,Reverse 82L payroll of 83120 JE-21-0021-IMPORT PAYROLL,D108,HJ,,2329,1046515.23
6100,8/31/2020,8/31/2020,82L-PRPD-083120,Reverse 82L payroll of 83120 JE-21-0021-IMPORT PAYROLL,D108,HJ,,2414,1044101.23
6100,8/31/2020,8/31/2020,82L-PRPD-083120,Reverse 82L payroll of 83120 JE-21-0021-IMPORT PAYROLL,D108,HJ,,2416.67,1041684.56
6100,8/31/2020,8/31/2020,82L-PRPD-083120,Reverse 82L payroll of 83120 JE-21-0021-IMPORT PAYROLL,D108,HJ,,2431.94,1039252.62
6100,8/31/2020,8/31/2020,82L-PRPD-083120,Reverse 82L payroll of 83120 JE-21-0021-IMPORT PAYROLL,D108,HJ,,2458.33,1036794.29
6100,8/31/2020,8/31/2020,82L-PRPD-083120,Reverse 82L payroll of 83120 JE-21-0021-IMPORT PAYROLL,D108,HJ,,2465,1034329.29
6100,8/31/2020,8/31/2020,82L-PRPD-083120,Reverse 82L payroll of 83120 JE-21-0021-IMPORT PAYROLL,D108,HJ,,2500,1031829.29
6100,8/31/2020,8/31/2020,82L-PRPD-083120,Reverse 82L payroll of 83120 JE-21-0021-IMPORT PAYROLL,D108,HJ,,2514.3,1029314.99
6100,8/31/2020,8/31/2020,82L-PRPD-083120,Reverse 82L payroll of 83120 JE-21-0021-IMPORT PAYROLL,D108,HJ,,2635,1026679.99
6100,8/31/2020,8/31/2020,82L-PRPD-083120,Reverse 82L payroll of 83120 JE-21-0021-IMPORT PAYROLL,D108,HJ,,2653.02,1024026.97
6100,8/31/2020,8/31/2020,82L-PRPD-083120,Reverse 82L payroll of 83120 JE-21-0021-IMPORT PAYROLL,D108,HJ,,2666.67,1021360.3
6100,8/31/2020,8/31/2020,82L-PRPD-083120,Reverse 82L payroll of 83120 JE-21-0021-IMPORT PAYROLL,D108,HJ,,2720,1018640.3
6100,8/31/2020,8/31/2020,82L-PRPD-083120,Reverse 82L payroll of 83120 JE-21-0021-IMPORT PAYROLL,D108,HJ,,2762.5,1015877.8
6100,8/31/2020,8/31/2020,82L-PRPD-083120,Reverse 82L payroll of 83120 JE-21-0021-IMPORT PAYROLL,D108,HJ,,2817.75,1013060.05
6100,8/31/2020,8/31/2020,82L-PRPD-083120,Reverse 82L payroll of 83120 JE-21-0021-IMPORT PAYROLL,D108,HJ,,2886.52,1010173.53
6100,8/31/2020,8/31/2020,82L-PRPD-083120,Reverse 82L payroll of 83120 JE-21-0021-IMPORT PAYROLL,D108,HJ,,2918.31,1007255.22
6100,8/31/2020,8/31/2020,82L-PRPD-083120,Reverse 82L payroll of 83120 JE-21-0021-IMPORT PAYROLL,D108,HJ,,3113.75,1004141.47
6100,8/31/2020,8/31/2020,82L-PRPD-083120,Reverse 82L payroll of 83120 JE-21-0021-IMPORT PAYROLL,D108,HJ,,3445,1000696.47
6100,8/31/2020,8/31/2020,82L-PRPD-083120,Reverse 82L payroll of 83120 JE-21-0021-IMPORT PAYROLL,D108,HJ,,3812.5,996883.97
6100,8/31/2020,8/31/2020,82L-PRPD-083120,Reverse 82L payroll of 83120 JE-21-0021-IMPORT PAYROLL,D111,HJ,,2505.63,994378.34
6100,8/31/2020,8/31/2020,82L-PRPD-083120,82L-PRPD-083120 -IMPORT PAYROLL-ACEVEDO MONIVETT,D103,HJ,5375,,999753.34
6100,8/31/2020,8/31/2020,82L-PRPD-083120,82L-PRPD-083120 -IMPORT PAYROLL-AKLESTAD ISABEL,D107,HJ,1750,,1001503.34
6100,8/31/2020,8/31/2020,82L-PRPD-083120,82L-PRPD-083120 -IMPORT PAYROLL-ALVAREZ-MORINE LISIS,D107,HJ,2541.67,,1004045.01
6100,8/31/2020,8/31/2020,82L-PRPD-083120,82L-PRPD-083120 -IMPORT PAYROLL-ALWARDT CALEB,D107,HJ,1047.62,,1005092.63
6100,8/31/2020,8/31/2020,82L-PRPD-083120,82L-PRPD-083120 -IMPORT PAYROLL-BARTHELEMY RACHALIE,D107,HJ,1047.62,,1006140.25
6100,8/31/2020,8/31/2020,82L-PRPD-083120,82L-PRPD-083120 -IMPORT PAYROLL-BOHLSEN GRACE,D107,HJ,1047.62,,1007187.87
6100,8/31/2020,8/31/2020,82L-PRPD-083120,82L-PRPD-083120 -IMPORT PAYROLL-BORCHART SPENCER,D107,HJ,1047.62,,1008235.49
6100,8/31/2020,8/31/2020,82L-PRPD-083120,82L-PRPD-083120 -IMPORT PAYROLL-BOWMAN HALLEY K,D107,HJ,3437.5,,1011672.99
6100,8/31/2020,8/31/2020,82L-PRPD-083120,82L-PRPD-083120 -IMPORT PAYROLL-BREEDLOVE JOHNDEE L,D107,HJ,1047.62,,1012720.61
6100,8/31/2020,8/31/2020,82L-PRPD-083120,82L-PRPD-083120 -IMPORT PAYROLL-BROWN ISAAC,D107,HJ,1047.62,,1013768.23
6100,8/31/2020,8/31/2020,82L-PRPD-083120,82L-PRPD-083120 -IMPORT PAYROLL-BURKE MARIAH,D107,HJ,1047.62,,1014815.85
6100,8/31/2020,8/31/2020,82L-PRPD-083120,82L-PRPD-083120 -IMPORT PAYROLL-CHAVOUS MILFORD,D107,HJ,1047.62,,1015863.47
6100,8/31/2020,8/31/2020,82L-PRPD-083120,82L-PRPD-083120 -IMPORT PAYROLL-CHEN LING,D107,HJ,1047.62,,1016911.09
6100,8/31/2020,8/31/2020,82L-PRPD-083120,82L-PRPD-083120 -IMPORT PAYROLL-COOK CATHRYN ANNA,D107,HJ,3593.03,,1020504.12
6100,8/31/2020,8/31/2020,82L-PRPD-083120,82L-PRPD-083120 -IMPORT PAYROLL-COOPER ASHLEE R,D107,HJ,2461.88,,1022966
6100,8/31/2020,8/31/2020,82L-PRPD-083120,82L-PRPD-083120 -IMPORT PAYROLL-DARKO OLIVIA,D107,HJ,1047.62,,1024013.62
6100,8/31/2020,8/31/2020,82L-PRPD-083120,82L-PRPD-083120 -IMPORT PAYROLL-DAUGHERTY DEVIN W,D107,HJ,1041.67,,1025055.29
6100,8/31/2020,8/31/2020,82L-PRPD-083120,82L-PRPD-083120 -IMPORT PAYROLL-DAWSON JAMIL NAFAYE-BEYAH,D107,HJ,1047.62,,1026102.91
6100,8/31/2020,8/31/2020,82L-PRPD-083120,82L-PRPD-083120 -IMPORT PAYROLL-DETONE KYRA MAYA,D102,HJ,2916.67,,1029019.58
6100,8/31/2020,8/31/2020,82L-PRPD-083120,82L-PRPD-083120 -IMPORT PAYROLL-DUPUIS CHRISTOPHER M,D107,HJ,6270.83,,1035290.41
6100,8/31/2020,8/31/2020,82L-PRPD-083120,82L-PRPD-083120 -IMPORT PAYROLL-DZIEDZIC JULIE K,D107,HJ,1250,,1036540.41
6100,8/31/2020,8/31/2020,82L-PRPD-083120,82L-PRPD-083120 -IMPORT PAYROLL-GILES SHAYLA,D107,HJ,1047.62,,1037588.03
6100,8/31/2020,8/31/2020,82L-PRPD-083120,82L-PRPD-083120 -IMPORT PAYROLL-GORNSTEIN STEVEN,D107,HJ,2708.33,,1040296.36
6100,8/31/2020,8/31/2020,82L-PRPD-083120,82L-PRPD-083120 -IMPORT PAYROLL-GRAVES KAMIESHIA,D107,HJ,2083.33,,1042379.69
6100,8/31/2020,8/31/2020,82L-PRPD-083120,82L-PRPD-083120 -IMPORT PAYROLL-GUADARRAMA-ALVAREZ URIEL A,D107,HJ,2897.92,,1045277.61
6100,8/31/2020,8/31/2020,82L-PRPD-083120,82L-PRPD-083120 -IMPORT PAYROLL-GUTIERREZ ANTONIO J,D102,HJ,5527.13,,1050804.74
6100,8/31/2020,8/31/2020,82L-PRPD-083120,82L-PRPD-083120 -IMPORT PAYROLL-HESTER TYLER CONRAD,D107,HJ,1916.67,,1052721.41
6100,8/31/2020,8/31/2020,82L-PRPD-083120,82L-PRPD-083120 -IMPORT PAYROLL-JONES JORDAN,D107,HJ,1047.62,,1053769.03
6100,8/31/2020,8/31/2020,82L-PRPD-083120,82L-PRPD-083120 -IMPORT PAYROLL-KHAN HUDA,D107,HJ,1047.62,,1054816.65
6100,8/31/2020,8/31/2020,82L-PRPD-083120,82L-PRPD-083120 -IMPORT PAYROLL-KING IRIS,D107,HJ,483.5,,1055300.15
6100,8/31/2020,8/31/2020,82L-PRPD-083120,82L-PRPD-083120 -IMPORT PAYROLL-KLOHR TIMOTHY JORDAN,D107,HJ,1476.86,,1056777.01
6100,8/31/2020,8/31/2020,82L-PRPD-083120,82L-PRPD-083120 -IMPORT PAYROLL-KOPSHEVER MELISSA,D107,HJ,2916.67,,1059693.68
6100,8/31/2020,8/31/2020,82L-PRPD-083120,82L-PRPD-083120 -IMPORT PAYROLL-LACEY DEQUITA,D108,HJ,2698.75,,1062392.43
6100,8/31/2020,8/31/2020,82L-PRPD-083120,82L-PRPD-083120 -IMPORT PAYROLL-LI SEN YUAN,D107,HJ,1047.62,,1063440.05
6100,8/31/2020,8/31/2020,82L-PRPD-083120,82L-PRPD-083120 -IMPORT PAYROLL-LIPORACE HERNAN LUIS,D103,HJ,2291.67,,1065731.72
6100,8/31/2020,8/31/2020,82L-PRPD-083120,82L-PRPD-083120 -IMPORT PAYROLL-LIPSCOMB STEPHEN,D107,HJ,2541.67,,1068273.39
6100,8/31/2020,8/31/2020,82L-PRPD-083120,82L-PRPD-083120 -IMPORT PAYROLL-MASON ANGELA,D107,HJ,5710.94,,1073984.33
6100,8/31/2020,8/31/2020,82L-PRPD-083120,82L-PRPD-083120 -IMPORT PAYROLL-MCLAUGHLIN MARA,D107,HJ,1047.62,,1075031.95
6100,8/31/2020,8/31/2020,82L-PRPD-083120,82L-PRPD-083120 -IMPORT PAYROLL-MEJIA CARLOS MANUEL,D107,HJ,1047.62,,1076079.57
6100,8/31/2020,8/31/2020,82L-PRPD-083120,82L-PRPD-083120 -IMPORT PAYROLL-MONROY-MEJIA JASON,D107,HJ,1047.62,,1077127.19
6100,8/31/2020,8/31/2020,82L-PRPD-083120,82L-PRPD-083120 -IMPORT PAYROLL-O'FLYNN-PRUITT NATHAN COLYAR,D107,HJ,1047.62,,1078174.81
6100,8/31/2020,8/31/2020,82L-PRPD-083120,82L-PRPD-083120 -IMPORT PAYROLL-ODONNELL STEPHEN,D107,HJ,2707.5,,1080882.31
6100,8/31/2020,8/31/2020,82L-PRPD-083120,82L-PRPD-083120 -IMPORT PAYROLL-PARETS MALLORY GRACE,D107,HJ,2833.33,,1083715.64
6100,8/31/2020,8/31/2020,82L-PRPD-083120,82L-PRPD-083120 -IMPORT PAYROLL-PARHAM-GANTT DENISE M,D108,HJ,3041.67,,1086757.31
6100,8/31/2020,8/31/2020,82L-PRPD-083120,82L-PRPD-083120 -IMPORT PAYROLL-PATTERSON STEVE,D107,HJ,1047.62,,1087804.93
6100,8/31/2020,8/31/2020,82L-PRPD-083120,82L-PRPD-083120 -IMPORT PAYROLL-PEINADO ELIZABETH R,D107,HJ,3749.96,,1091554.89
6100,8/31/2020,8/31/2020,82L-PRPD-083120,82L-PRPD-083120 -IMPORT PAYROLL-POLANCO ODALIS,D103,HJ,3124.96,,1094679.85
6100,8/31/2020,8/31/2020,82L-PRPD-083120,82L-PRPD-083120 -IMPORT PAYROLL-QUINTAS JASHIVE,D107,HJ,1916.67,,1096596.52
6100,8/31/2020,8/31/2020,82L-PRPD-083120,82L-PRPD-083120 -IMPORT PAYROLL-RANDOLPH ALEXANDER,D107,HJ,1875,,1098471.52
6100,8/31/2020,8/31/2020,82L-PRPD-083120,82L-PRPD-083120 -IMPORT PAYROLL-ROBBINS DEANNA,D107,HJ,2541.67,,1101013.19
6100,8/31/2020,8/31/2020,82L-PRPD-083120,82L-PRPD-083120 -IMPORT PAYROLL-SAFRAN ALAN P,D102,HJ,7516.88,,1108530.07
6100,8/31/2020,8/31/2020,82L-PRPD-083120,82L-PRPD-083120 -IMPORT PAYROLL-SCOTT KIRK DONOVAN,D107,HJ,1047.62,,1109577.69
6100,8/31/2020,8/31/2020,82L-PRPD-083120,82L-PRPD-083120 -IMPORT PAYROLL-SHENKMAN OLIVIA,D107,HJ,2000,,1111577.69
6100,8/31/2020,8/31/2020,82L-PRPD-083120,82L-PRPD-083120 -IMPORT PAYROLL-SHI GRACE,D103,HJ,875,,1112452.69
6100,8/31/2020,8/31/2020,82L-PRPD-083120,82L-PRPD-083120 -IMPORT PAYROLL-SILVER KELLY,D107,HJ,2541.67,,1114994.36
6100,8/31/2020,8/31/2020,82L-PRPD-083120,82L-PRPD-083120 -IMPORT PAYROLL-SOLIMAN MARK,D107,HJ,1047.62,,1116041.98
6100,8/31/2020,8/31/2020,82L-PRPD-083120,82L-PRPD-083120 -IMPORT PAYROLL-STROUD DAVID,D107,HJ,1047.62,,1117089.6
6100,8/31/2020,8/31/2020,82L-PRPD-083120,82L-PRPD-083120 -IMPORT PAYROLL-VALCIN SABRINA JEMIMAH,D107,HJ,1047.62,,1118137.22
6100,8/31/2020,8/31/2020,82L-PRPD-083120,82L-PRPD-083120 -IMPORT PAYROLL-WEINSTOCK EMILY,D107,HJ,2833.33,,1120970.55
6100,8/31/2020,8/31/2020,82L-PRPD-083120,82L-PRPD-083120 -IMPORT PAYROLL-WILLIAMS MACK ANTHONY,D107,HJ,1047.62,,1122018.17
6100,8/31/2020,8/31/2020,82L-PRPD-083120,82L-PRPD-083120 -IMPORT PAYROLL-WILLIAMS MIL'YONTA,D107,HJ,1047.62,,1123065.79
6100,8/31/2020,8/31/2020,82L-PRPD-083120,82L-PRPD-083120 -IMPORT PAYROLL-Wage Pay increase place holder,D107,HJ,53000.33,,1176066.12
6100,8/31/2020,8/31/2020,82L-PRPD-083120,82L-PRPD-083120 -IMPORT PAYROLL-ZARATE JOSEPH M,D107,HJ,2150,,1178216.12
6100,8/31/2020,8/31/2020,82L-PRPD-083120,Reverse 82L payroll of 83120 JE-21-0021-IMPORT PAYROLL,D102,HJ,,2916.67,1175299.45
6100,8/31/2020,8/31/2020,82L-PRPD-083120,Reverse 82L payroll of 83120 JE-21-0021-IMPORT PAYROLL,D102,HJ,,5527.13,1169772.32
6100,8/31/2020,8/31/2020,82L-PRPD-083120,Reverse 82L payroll of 83120 JE-21-0021-IMPORT PAYROLL,D102,HJ,,7516.88,1162255.44
6100,8/31/2020,8/31/2020,82L-PRPD-083120,Reverse 82L payroll of 83120 JE-21-0021-IMPORT PAYROLL,D103,HJ,,875,1161380.44
6100,8/31/2020,8/31/2020,82L-PRPD-083120,Reverse 82L payroll of 83120 JE-21-0021-IMPORT PAYROLL,D103,HJ,,2291.67,1159088.77
6100,8/31/2020,8/31/2020,82L-PRPD-083120,Reverse 82L payroll of 83120 JE-21-0021-IMPORT PAYROLL,D103,HJ,,3124.96,1155963.81
6100,8/31/2020,8/31/2020,82L-PRPD-083120,Reverse 82L payroll of 83120 JE-21-0021-IMPORT PAYROLL,D103,HJ,,5375,1150588.81
6100,8/31/2020,8/31/2020,82L-PRPD-083120,Reverse 82L payroll of 83120 JE-21-0021-IMPORT PAYROLL,D107,HJ,,483.5,1150105.31
6100,8/31/2020,8/31/2020,82L-PRPD-083120,Reverse 82L payroll of 83120 JE-21-0021-IMPORT PAYROLL,D107,HJ,,1041.67,1149063.64
6100,8/31/2020,8/31/2020,82L-PRPD-083120,Reverse 82L payroll of 83120 JE-21-0021-IMPORT PAYROLL,D107,HJ,,1047.62,1148016.02
6100,8/31/2020,8/31/2020,82L-PRPD-083120,Reverse 82L payroll of 83120 JE-21-0021-IMPORT PAYROLL,D107,HJ,,1047.62,1146968.4
6100,8/31/2020,8/31/2020,82L-PRPD-083120,Reverse 82L payroll of 83120 JE-21-0021-IMPORT PAYROLL,D107,HJ,,1047.62,1145920.78
6100,8/31/2020,8/31/2020,82L-PRPD-083120,Reverse 82L payroll of 83120 JE-21-0021-IMPORT PAYROLL,D107,HJ,,1047.62,1144873.16
6100,8/31/2020,8/31/2020,82L-PRPD-083120,Reverse 82L payroll of 83120 JE-21-0021-IMPORT PAYROLL,D107,HJ,,1047.62,1143825.54
6100,8/31/2020,8/31/2020,82L-PRPD-083120,Reverse 82L payroll of 83120 JE-21-0021-IMPORT PAYROLL,D107,HJ,,1047.62,1142777.92
6100,8/31/2020,8/31/2020,82L-PRPD-083120,Reverse 82L payroll of 83120 JE-21-0021-IMPORT PAYROLL,D107,HJ,,1047.62,1141730.3
6100,8/31/2020,8/31/2020,82L-PRPD-083120,Reverse 82L payroll of 83120 JE-21-0021-IMPORT PAYROLL,D107,HJ,,1047.62,1140682.68
6100,8/31/2020,8/31/2020,82L-PRPD-083120,Reverse 82L payroll of 83120 JE-21-0021-IMPORT PAYROLL,D107,HJ,,1047.62,1139635.06
6100,8/31/2020,8/31/2020,82L-PRPD-083120,Reverse 82L payroll of 83120 JE-21-0021-IMPORT PAYROLL,D107,HJ,,1047.62,1138587.44
6100,8/31/2020,8/31/2020,82L-PRPD-083120,Reverse 82L payroll of 83120 JE-21-0021-IMPORT PAYROLL,D107,HJ,,1047.62,1137539.82
6100,8/31/2020,8/31/2020,82L-PRPD-083120,Reverse 82L payroll of 83120 JE-21-0021-IMPORT PAYROLL,D107,HJ,,1047.62,1136492.2
6100,8/31/2020,8/31/2020,82L-PRPD-083120,Reverse 82L payroll of 83120 JE-21-0021-IMPORT PAYROLL,D107,HJ,,1047.62,1135444.58
6100,8/31/2020,8/31/2020,82L-PRPD-083120,Reverse 82L payroll of 83120 JE-21-0021-IMPORT PAYROLL,D107,HJ,,1047.62,1134396.96
6100,8/31/2020,8/31/2020,82L-PRPD-083120,Reverse 82L payroll of 83120 JE-21-0021-IMPORT PAYROLL,D107,HJ,,1047.62,1133349.34
6100,8/31/2020,8/31/2020,82L-PRPD-083120,Reverse 82L payroll of 83120 JE-21-0021-IMPORT PAYROLL,D107,HJ,,1047.62,1132301.72
6100,8/31/2020,8/31/2020,82L-PRPD-083120,Reverse 82L payroll of 83120 JE-21-0021-IMPORT PAYROLL,D107,HJ,,1047.62,1131254.1
6100,8/31/2020,8/31/2020,82L-PRPD-083120,Reverse 82L payroll of 83120 JE-21-0021-IMPORT PAYROLL,D107,HJ,,1047.62,1130206.48
6100,8/31/2020,8/31/2020,82L-PRPD-083120,Reverse 82L payroll of 83120 JE-21-0021-IMPORT PAYROLL,D107,HJ,,1047.62,1129158.86
6100,8/31/2020,8/31/2020,82L-PRPD-083120,Reverse 82L payroll of 83120 JE-21-0021-IMPORT PAYROLL,D107,HJ,,1047.62,1128111.24
6100,8/31/2020,8/31/2020,82L-PRPD-083120,Reverse 82L payroll of 83120 JE-21-0021-IMPORT PAYROLL,D107,HJ,,1047.62,1127063.62
6100,8/31/2020,8/31/2020,82L-PRPD-083120,Reverse 82L payroll of 83120 JE-21-0021-IMPORT PAYROLL,D107,HJ,,1047.62,1126016
6100,8/31/2020,8/31/2020,82L-PRPD-083120,Reverse 82L payroll of 83120 JE-21-0021-IMPORT PAYROLL,D107,HJ,,1047.62,1124968.38
6100,8/31/2020,8/31/2020,82L-PRPD-083120,Reverse 82L payroll of 83120 JE-21-0021-IMPORT PAYROLL,D107,HJ,,1047.62,1123920.76
6100,8/31/2020,8/31/2020,82L-PRPD-083120,Reverse 82L payroll of 83120 JE-21-0021-IMPORT PAYROLL,D107,HJ,,1047.62,1122873.14
6100,8/31/2020,8/31/2020,82L-PRPD-083120,Reverse 82L payroll of 83120 JE-21-0021-IMPORT PAYROLL,D107,HJ,,1047.62,1121825.52
6100,8/31/2020,8/31/2020,82L-PRPD-083120,Reverse 82L payroll of 83120 JE-21-0021-IMPORT PAYROLL,D107,HJ,,1250,1120575.52
6100,8/31/2020,8/31/2020,82L-PRPD-083120,Reverse 82L payroll of 83120 JE-21-0021-IMPORT PAYROLL,D107,HJ,,1476.86,1119098.66
6100,8/31/2020,8/31/2020,82L-PRPD-083120,Reverse 82L payroll of 83120 JE-21-0021-IMPORT PAYROLL,D107,HJ,,1750,1117348.66
6100,8/31/2020,8/31/2020,82L-PRPD-083120,Reverse 82L payroll of 83120 JE-21-0021-IMPORT PAYROLL,D107,HJ,,1875,1115473.66
6100,8/31/2020,8/31/2020,82L-PRPD-083120,Reverse 82L payroll of 83120 JE-21-0021-IMPORT PAYROLL,D107,HJ,,1916.67,1113556.99
6100,8/31/2020,8/31/2020,82L-PRPD-083120,Reverse 82L payroll of 83120 JE-21-0021-IMPORT PAYROLL,D107,HJ,,1916.67,1111640.32
6100,8/31/2020,8/31/2020,82L-PRPD-083120,Reverse 82L payroll of 83120 JE-21-0021-IMPORT PAYROLL,D107,HJ,,2000,1109640.32
6100,8/31/2020,8/31/2020,82L-PRPD-083120,Reverse 82L payroll of 83120 JE-21-0021-IMPORT PAYROLL,D107,HJ,,2083.33,1107556.99
6100,8/31/2020,8/31/2020,82L-PRPD-083120,Reverse 82L payroll of 83120 JE-21-0021-IMPORT PAYROLL,D107,HJ,,2150,1105406.99
6100,8/31/2020,8/31/2020,82L-PRPD-083120,Reverse 82L payroll of 83120 JE-21-0021-IMPORT PAYROLL,D107,HJ,,2461.88,1102945.11
6100,8/31/2020,8/31/2020,82L-PRPD-083120,Reverse 82L payroll of 83120 JE-21-0021-IMPORT PAYROLL,D107,HJ,,2541.67,1100403.44
6100,8/31/2020,8/31/2020,82L-PRPD-083120,Reverse 82L payroll of 83120 JE-21-0021-IMPORT PAYROLL,D107,HJ,,2541.67,1097861.77
6100,8/31/2020,8/31/2020,82L-PRPD-083120,Reverse 82L payroll of 83120 JE-21-0021-IMPORT PAYROLL,D107,HJ,,2541.67,1095320.1
6100,8/31/2020,8/31/2020,82L-PRPD-083120,Reverse 82L payroll of 83120 JE-21-0021-IMPORT PAYROLL,D107,HJ,,2541.67,1092778.43
6100,8/31/2020,8/31/2020,82L-PRPD-083120,Reverse 82L payroll of 83120 JE-21-0021-IMPORT PAYROLL,D107,HJ,,2707.5,1090070.93
6100,8/31/2020,8/31/2020,82L-PRPD-083120,Reverse 82L payroll of 83120 JE-21-0021-IMPORT PAYROLL,D107,HJ,,2708.33,1087362.6
6100,8/31/2020,8/31/2020,82L-PRPD-083120,Reverse 82L payroll of 83120 JE-21-0021-IMPORT PAYROLL,D107,HJ,,2833.33,1084529.27
6100,8/31/2020,8/31/2020,82L-PRPD-083120,Reverse 82L payroll of 83120 JE-21-0021-IMPORT PAYROLL,D107,HJ,,2833.33,1081695.94
6100,8/31/2020,8/31/2020,82L-PRPD-083120,Reverse 82L payroll of 83120 JE-21-0021-IMPORT PAYROLL,D107,HJ,,2897.92,1078798.02
6100,8/31/2020,8/31/2020,82L-PRPD-083120,Reverse 82L payroll of 83120 JE-21-0021-IMPORT PAYROLL,D107,HJ,,2916.67,1075881.35
6100,8/31/2020,8/31/2020,82L-PRPD-083120,Reverse 82L payroll of 83120 JE-21-0021-IMPORT PAYROLL,D107,HJ,,3437.5,1072443.85
6100,8/31/2020,8/31/2020,82L-PRPD-083120,Reverse 82L payroll of 83120 JE-21-0021-IMPORT PAYROLL,D107,HJ,,3593.03,1068850.82
6100,8/31/2020,8/31/2020,82L-PRPD-083120,Reverse 82L payroll of 83120 JE-21-0021-IMPORT PAYROLL,D107,HJ,,3749.96,1065100.86
6100,8/31/2020,8/31/2020,82L-PRPD-083120,Reverse 82L payroll of 83120 JE-21-0021-IMPORT PAYROLL,D107,HJ,,5710.94,1059389.92
6100,8/31/2020,8/31/2020,82L-PRPD-083120,Reverse 82L payroll of 83120 JE-21-0021-IMPORT PAYROLL,D107,HJ,,6270.83,1053119.09
6100,8/31/2020,8/31/2020,82L-PRPD-083120,Reverse 82L payroll of 83120 JE-21-0021-IMPORT PAYROLL,D107,HJ,,53000.33,1000118.76
6100,8/31/2020,8/31/2020,82L-PRPD-083120,Reverse 82L payroll of 83120 JE-21-0021-IMPORT PAYROLL,D108,HJ,,2698.75,997420.01
6100,8/31/2020,8/31/2020,82L-PRPD-083120,Reverse 82L payroll of 83120 JE-21-0021-IMPORT PAYROLL,D108,HJ,,3041.67,994378.34
6100,8/31/2020,8/31/2020,82L-PRPD-083120,82L-PRPD-083120 -IMPORT PAYROLL-ARCHER AUBREYNA,D108,HJ,2750,,997128.34
6100,8/31/2020,8/31/2020,82L-PRPD-083120,82L-PRPD-083120 -IMPORT PAYROLL-BARTOLD DEANNA MARIE,D108,HJ,3034.5,,1000162.84
6100,8/31/2020,8/31/2020,82L-PRPD-083120,82L-PRPD-083120 -IMPORT PAYROLL-BELLOT GENESIS,D108,HJ,2333.33,,1002496.17
6100,8/31/2020,8/31/2020,82L-PRPD-083120,82L-PRPD-083120 -IMPORT PAYROLL-CIRKER MIA,D108,HJ,2250,,1004746.17
6100,8/31/2020,8/31/2020,82L-PRPD-083120,82L-PRPD-083120 -IMPORT PAYROLL-CORTEZ MIRANDA A,D111,HJ,2672.72,,1007418.89
6100,8/31/2020,8/31/2020,82L-PRPD-083120,82L-PRPD-083120 -IMPORT PAYROLL-FEIGHERY JOHN,D108,HJ,2250,,1009668.89
6100,8/31/2020,8/31/2020,82L-PRPD-083120,82L-PRPD-083120 -IMPORT PAYROLL-GARCIA MARILYN,D108,HJ,2291.67,,1011960.56
6100,8/31/2020,8/31/2020,82L-PRPD-083120,82L-PRPD-083120 -IMPORT PAYROLL-GRIFFIN ANDREW,D108,HJ,2250,,1014210.56
6100,8/31/2020,8/31/2020,82L-PRPD-083120,82L-PRPD-083120 -IMPORT PAYROLL-HALLINAN GABRIEL B,D108,HJ,2550,,1016760.56
6100,8/31/2020,8/31/2020,82L-PRPD-083120,82L-PRPD-083120 -IMPORT PAYROLL-HOLDER LATIVA M,D108,HJ,3812.5,,1020573.06
6100,8/31/2020,8/31/2020,82L-PRPD-083120,82L-PRPD-083120 -IMPORT PAYROLL-HOSSAIN MYESHA R,D108,HJ,2437.5,,1023010.56
6100,8/31/2020,8/31/2020,82L-PRPD-083120,82L-PRPD-083120 -IMPORT PAYROLL-JACKSON TASNIM F,D108,HJ,2291.67,,1025302.23
6100,8/31/2020,8/31/2020,82L-PRPD-083120,82L-PRPD-083120 -IMPORT PAYROLL-LI BELLA,D108,HJ,2486.25,,1027788.48
6100,8/31/2020,8/31/2020,82L-PRPD-083120,82L-PRPD-083120 -IMPORT PAYROLL-MOSELEY ARIELLE,D108,HJ,2752.73,,1030541.21
6100,8/31/2020,8/31/2020,82L-PRPD-083120,82L-PRPD-083120 -IMPORT PAYROLL-TILLERY ASIA,D108,HJ,3291.67,,1033832.88
6100,8/31/2020,8/31/2020,82L-PRPD-083120,Reverse 82L payroll of 83120 JE-21-0021-IMPORT PAYROLL,D108,HJ,,2250,1031582.88
6100,8/31/2020,8/31/2020,82L-PRPD-083120,Reverse 82L payroll of 83120 JE-21-0021-IMPORT PAYROLL,D108,HJ,,2250,1029332.88
6100,8/31/2020,8/31/2020,82L-PRPD-083120,Reverse 82L payroll of 83120 JE-21-0021-IMPORT PAYROLL,D108,HJ,,2250,1027082.88
6100,8/31/2020,8/31/2020,82L-PRPD-083120,Reverse 82L payroll of 83120 JE-21-0021-IMPORT PAYROLL,D108,HJ,,2291.67,1024791.21
6100,8/31/2020,8/31/2020,82L-PRPD-083120,Reverse 82L payroll of 83120 JE-21-0021-IMPORT PAYROLL,D108,HJ,,2291.67,1022499.54
6100,8/31/2020,8/31/2020,82L-PRPD-083120,Reverse 82L payroll of 83120 JE-21-0021-IMPORT PAYROLL,D108,HJ,,2333.33,1020166.21
6100,8/31/2020,8/31/2020,82L-PRPD-083120,Reverse 82L payroll of 83120 JE-21-0021-IMPORT PAYROLL,D108,HJ,,2437.5,1017728.71
6100,8/31/2020,8/31/2020,82L-PRPD-083120,Reverse 82L payroll of 83120 JE-21-0021-IMPORT PAYROLL,D108,HJ,,2486.25,1015242.46
6100,8/31/2020,8/31/2020,82L-PRPD-083120,Reverse 82L payroll of 83120 JE-21-0021-IMPORT PAYROLL,D108,HJ,,2550,1012692.46
6100,8/31/2020,8/31/2020,82L-PRPD-083120,Reverse 82L payroll of 83120 JE-21-0021-IMPORT PAYROLL,D108,HJ,,2750,1009942.46
6100,8/31/2020,8/31/2020,82L-PRPD-083120,Reverse 82L payroll of 83120 JE-21-0021-IMPORT PAYROLL,D108,HJ,,2752.73,1007189.73
6100,8/31/2020,8/31/2020,82L-PRPD-083120,Reverse 82L payroll of 83120 JE-21-0021-IMPORT PAYROLL,D108,HJ,,3034.5,1004155.23
6100,8/31/2020,8/31/2020,82L-PRPD-083120,Reverse 82L payroll of 83120 JE-21-0021-IMPORT PAYROLL,D108,HJ,,3291.67,1000863.56
6100,8/31/2020,8/31/2020,82L-PRPD-083120,Reverse 82L payroll of 83120 JE-21-0021-IMPORT PAYROLL,D108,HJ,,3812.5,997051.06
6100,8/31/2020,8/31/2020,82L-PRPD-083120,Reverse 82L payroll of 83120 JE-21-0021-IMPORT PAYROLL,D111,HJ,,2672.72,994378.34
6100,8/31/2020,8/31/2020,82L-PRPD-083120,82L-PRPD-083120 -IMPORT PAYROLL-BALASUBRAMANIAN SHARANYA,D108,HJ,2666.67,,997045.01
6100,8/31/2020,8/31/2020,82L-PRPD-083120,82L-PRPD-083120 -IMPORT PAYROLL-COVENEY ALLISON,D108,HJ,2854.17,,999899.18
6100,8/31/2020,8/31/2020,82L-PRPD-083120,82L-PRPD-083120 -IMPORT PAYROLL-JACKSON CLAICE M,D108,HJ,3125,,1003024.18
6100,8/31/2020,8/31/2020,82L-PRPD-083120,82L-PRPD-083120 -IMPORT PAYROLL-JANG DANIEL,D108,HJ,2750,,1005774.18
6100,8/31/2020,8/31/2020,82L-PRPD-083120,82L-PRPD-083120 -IMPORT PAYROLL-LENEGHAN MARYELLEN B,D108,HJ,3812.5,,1009586.68
6100,8/31/2020,8/31/2020,82L-PRPD-083120,Reverse 82L payroll of 83120 JE-21-0021-IMPORT PAYROLL,D108,HJ,,2666.67,1006920.01
6100,8/31/2020,8/31/2020,82L-PRPD-083120,Reverse 82L payroll of 83120 JE-21-0021-IMPORT PAYROLL,D108,HJ,,2750,1004170.01
6100,8/31/2020,8/31/2020,82L-PRPD-083120,Reverse 82L payroll of 83120 JE-21-0021-IMPORT PAYROLL,D108,HJ,,2854.17,1001315.84
6100,8/31/2020,8/31/2020,82L-PRPD-083120,Reverse 82L payroll of 83120 JE-21-0021-IMPORT PAYROLL,D108,HJ,,3125,998190.84
6100,8/31/2020,8/31/2020,82L-PRPD-083120,Reverse 82L payroll of 83120 JE-21-0021-IMPORT PAYROLL,D108,HJ,,3812.5,994378.34
6100,8/31/2020,8/31/2020,Reallocation to GM3 - ACY2,To reallocate Salaraies to GM3 - ACY2-To reallocate salaries to GM3 - ACY2 ( Wallace Stephen Odonells Lacey Dequita),D104,HJ,15187.5,,1009565.84
6100,8/31/2020,8/31/2020,Reallocation to GM3 - ACY2,To reallocate Salaraies to GM3 - ACY2-To reallocate salaries to GM3 - ACY2 ( Wallace Stephen Odonells Lacey Dequita),D104,HJ,,16283.74,993282.1
6100,8/31/2020,8/31/2020,Reallocation to GM3 - ACY2,To reverse JE-21-0053-To reverse reallocation of salaries to GM3 - ACY2,D104,HJ,,15187.5,978094.6
6100,8/31/2020,8/31/2020,Reallocation to GM3 - ACY2,To reverse JE-21-0053-To reverse reallocation of salaries to GM3 - ACY2,D104,HJ,16283.74,,994378.34
6100,8/31/2020,8/31/2020,To NYC OM Wage,LUX-PRPD-083120 -Payroll (Reclassification of GL)-To NYC OM Wage to GL 6110,D108,HJ,1119.05,,995497.39
6100,9/15/2020,9/15/2020,91520,82L-IMPORT PAYROLL-ALVAREZ-MORINE LISIS,D108,HJ,2541.67,,998039.06
6100,9/15/2020,9/15/2020,91520,82L-IMPORT PAYROLL-ALWARDT CALEB,D108,HJ,1047.62,,999086.68
6100,9/15/2020,9/15/2020,91520,82L-IMPORT PAYROLL-BARTHELEMY RACHALIE,D108,HJ,1047.62,,1000134.3
6100,9/15/2020,9/15/2020,91520,82L-IMPORT PAYROLL-BASHAM WILLIAM EDWARD,D108,HJ,1047.62,,1001181.92
6100,9/15/2020,9/15/2020,91520,82L-IMPORT PAYROLL-BOHLSEN GRACE,D108,HJ,1047.62,,1002229.54
6100,9/15/2020,9/15/2020,91520,82L-IMPORT PAYROLL-BORCHART SPENCER,D108,HJ,1047.62,,1003277.16
6100,9/15/2020,9/15/2020,91520,82L-IMPORT PAYROLL-BROWN ISAAC,D108,HJ,1047.62,,1004324.78
6100,9/15/2020,9/15/2020,91520,82L-IMPORT PAYROLL-BURKE MARIAH,D108,HJ,1047.62,,1005372.4
6100,9/15/2020,9/15/2020,91520,82L-IMPORT PAYROLL-CASSADY JOSHUA LEWIS,D108,HJ,1047.62,,1006420.02
6100,9/15/2020,9/15/2020,91520,82L-IMPORT PAYROLL-CHAVOUS MILFORD,D108,HJ,1047.62,,1007467.64
6100,9/15/2020,9/15/2020,91520,82L-IMPORT PAYROLL-CHEN LING,D108,HJ,290.1,,1007757.74
6100,9/15/2020,9/15/2020,91520,82L-IMPORT PAYROLL-DARKO OLIVIA,D108,HJ,1047.62,,1008805.36
6100,9/15/2020,9/15/2020,91520,82L-IMPORT PAYROLL-DAWSON JAMIL NAFAYE-BEYAH,D108,HJ,1047.62,,1009852.98
6100,9/15/2020,9/15/2020,91520,82L-IMPORT PAYROLL-ESCAMILLA OLGA,D108,HJ,1047.62,,1010900.6
6100,9/15/2020,9/15/2020,91520,82L-IMPORT PAYROLL-GARCIA SANTIAGO,D108,HJ,2042,,1012942.6
6100,9/15/2020,9/15/2020,91520,82L-IMPORT PAYROLL-GILES SHAYLA,D108,HJ,1047.62,,1013990.22
6100,9/15/2020,9/15/2020,91520,82L-IMPORT PAYROLL-IKUNIKA FUNMILAYO,D108,HJ,2083.33,,1016073.55
6100,9/15/2020,9/15/2020,91520,82L-IMPORT PAYROLL-JONES JORDAN,D108,HJ,1047.62,,1017121.17
6100,9/15/2020,9/15/2020,91520,82L-IMPORT PAYROLL-KHAN HUDA,D108,HJ,1047.62,,1018168.79
6100,9/15/2020,9/15/2020,91520,82L-IMPORT PAYROLL-KLOHR TIMOTHY JORDAN,D108,HJ,2000,,1020168.79
6100,9/15/2020,9/15/2020,91520,82L-IMPORT PAYROLL-KOPSHEVER MELISSA,D108,HJ,2916.67,,1023085.46
6100,9/15/2020,9/15/2020,91520,82L-IMPORT PAYROLL-LI SEN,D108,HJ,1047.62,,1024133.08
6100,9/15/2020,9/15/2020,91520,82L-IMPORT PAYROLL-LIPSCOMB STEPHEN,D108,HJ,2541.67,,1026674.75
6100,9/15/2020,9/15/2020,91520,82L-IMPORT PAYROLL-MALLECK JESSICA R,D108,HJ,1047.62,,1027722.37
6100,9/15/2020,9/15/2020,91520,82L-IMPORT PAYROLL-MCLAUGHLIN MARA,D108,HJ,1047.62,,1028769.99
6100,9/15/2020,9/15/2020,91520,82L-IMPORT PAYROLL-MEJIA CARLOS MANUEL,D108,HJ,1047.62,,1029817.61
6100,9/15/2020,9/15/2020,91520,82L-IMPORT PAYROLL-MONROY-MEJIA JASON,D108,HJ,1047.62,,1030865.23
6100,9/15/2020,9/15/2020,91520,82L-IMPORT PAYROLL-O'FLYNN-PRUITT NATHAN COLYAR,D108,HJ,1047.62,,1031912.85
6100,9/15/2020,9/15/2020,91520,82L-IMPORT PAYROLL-PATTERSON STEVE,D108,HJ,1047.62,,1032960.47
6100,9/15/2020,9/15/2020,91520,82L-IMPORT PAYROLL-SCHMIESS RACHEL JOY,D108,HJ,1047.62,,1034008.09
6100,9/15/2020,9/15/2020,91520,82L-IMPORT PAYROLL-SCOTT KIRK,D108,HJ,1047.62,,1035055.71
6100,9/15/2020,9/15/2020,91520,82L-IMPORT PAYROLL-SILVER KELLY,D108,HJ,2541.67,,1037597.38
6100,9/15/2020,9/15/2020,91520,82L-IMPORT PAYROLL-SOLIMAN MARK,D108,HJ,1047.62,,1038645
6100,9/15/2020,9/15/2020,91520,82L-IMPORT PAYROLL-STEIN KYLE,D108,HJ,1538.16,,1040183.16
6100,9/15/2020,9/15/2020,91520,82L-IMPORT PAYROLL-STROUD DAVID,D108,HJ,1047.62,,1041230.78
6100,9/15/2020,9/15/2020,91520,82L-IMPORT PAYROLL-VALCIN SABRINA JEMIMAH,D108,HJ,1047.62,,1042278.4
6100,9/15/2020,9/15/2020,91520,82L-IMPORT PAYROLL-VALDES ERNEST L,D108,HJ,1047.62,,1043326.02
6100,9/15/2020,9/15/2020,91520,82L-IMPORT PAYROLL-WILLIAMS MACK,D108,HJ,1047.62,,1044373.64
6100,9/15/2020,9/15/2020,91520,82L-IMPORT PAYROLL-WILLIAMS MIL'YONTA,D108,HJ,1047.62,,1045421.26
6100,9/15/2020,9/15/2020,91520,82L-IMPORT PAYROLL-ANTHONY BETTY,D108,HJ,2886.52,,1048307.78
6100,9/15/2020,9/15/2020,91520,82L-IMPORT PAYROLL-AUSTIN PERCY,D108,HJ,2653.02,,1050960.8
6100,9/15/2020,9/15/2020,91520,82L-IMPORT PAYROLL-BUHMANN JAY,D108,HJ,2271,,1053231.8
6100,9/15/2020,9/15/2020,91520,82L-IMPORT PAYROLL-CHAPMAN CLAUDY EARL,D108,HJ,1833.33,,1055065.13
6100,9/15/2020,9/15/2020,91520,82L-IMPORT PAYROLL-DADA ARIKPO,D108,HJ,2720,,1057785.13
6100,9/15/2020,9/15/2020,91520,82L-IMPORT PAYROLL-GUTHRIE LESLIE,D108,HJ,2458.33,,1060243.46
6100,9/15/2020,9/15/2020,91520,82L-IMPORT PAYROLL-HOLMES JOREL ALEXANDER,D108,HJ,2329,,1062572.46
6100,9/15/2020,9/15/2020,91520,82L-IMPORT PAYROLL-IMPORT PAYROLL -ADP WAGE PAY DES:WAGE PAY ID:25005811449882L on 9.16.20,D108,HJ,3333.21,,1065905.67
6100,9/15/2020,9/15/2020,91520,82L-IMPORT PAYROLL-JORDAN TIFFANY T,D108,HJ,3445,,1069350.67
6100,9/15/2020,9/15/2020,91520,82L-IMPORT PAYROLL-LANIGAN LISA A,D108,HJ,3113.75,,1072464.42
6100,9/15/2020,9/15/2020,91520,82L-IMPORT PAYROLL-MCELWEE MELISSA,D108,HJ,2666.67,,1075131.09
6100,9/15/2020,9/15/2020,91520,82L-IMPORT PAYROLL-MCNICHOLAS MARY,D108,HJ,2291.67,,1077422.76
6100,9/15/2020,9/15/2020,91520,82L-IMPORT PAYROLL-NWAKANMA NANCY,D108,HJ,2918.31,,1080341.07
6100,9/15/2020,9/15/2020,91520,82L-IMPORT PAYROLL-ONICA ANTHONY J,D108,HJ,2416.67,,1082757.74
6100,9/15/2020,9/15/2020,91520,82L-IMPORT PAYROLL-PRAHIN NICOLE M,D108,HJ,1677.5,,1084435.24
6100,9/15/2020,9/15/2020,91520,82L-IMPORT PAYROLL-PRAHIN NICOLE M,D108,HJ,2135,,1086570.24
6100,9/15/2020,9/15/2020,91520,82L-IMPORT PAYROLL-RIVERS QUIONNA DIANE,D108,HJ,2514.3,,1089084.54
6100,9/15/2020,9/15/2020,91520,82L-IMPORT PAYROLL-SALIM YASSER,D108,HJ,2431.94,,1091516.48
6100,9/15/2020,9/15/2020,91520,82L-IMPORT PAYROLL-SEJOUR MAHALIAH,D108,HJ,2500,,1094016.48
6100,9/15/2020,9/15/2020,91520,82L-IMPORT PAYROLL-SKALSKI CHRISTOPHER,D108,HJ,2465,,1096481.48
6100,9/15/2020,9/15/2020,91520,82L-IMPORT PAYROLL-TUMENJARGAL ENKHJIN,D108,HJ,2414,,1098895.48
6100,9/15/2020,9/15/2020,91520,82L-IMPORT PAYROLL-VILLEGAS EVELYN,D108,HJ,2817.75,,1101713.23
6100,9/15/2020,9/15/2020,91520,82L-IMPORT PAYROLL-WOLF ANNA A,D108,HJ,2635,,1104348.23
6100,9/15/2020,9/15/2020,91520,82L-IMPORT PAYROLL-ACEVEDO MONIVETT,D107,HJ,5375,,1109723.23
6100,9/15/2020,9/15/2020,91520,82L-IMPORT PAYROLL-AKLESTAD ISABEL,D111,HJ,1750,,1111473.23
6100,9/15/2020,9/15/2020,91520,82L-IMPORT PAYROLL-ALLEN KIMBERLY,D111,HJ,1833.33,,1113306.56
6100,9/15/2020,9/15/2020,91520,82L-IMPORT PAYROLL-BIBB TIFFANI,D104,HJ,2146.07,,1115452.63
6100,9/15/2020,9/15/2020,91520,82L-IMPORT PAYROLL-BOWMAN HALLEY,D101,HJ,3437.5,,1118890.13
6100,9/15/2020,9/15/2020,91520,82L-IMPORT PAYROLL-COOK CATHRYN ANNA,D105,HJ,3593.03,,1122483.16
6100,9/15/2020,9/15/2020,91520,82L-IMPORT PAYROLL-COOPER ASHLEE R,D101,HJ,2461.88,,1124945.04
6100,9/15/2020,9/15/2020,91520,82L-IMPORT PAYROLL-CORTEZ MIRANDA A,D111,HJ,2672.72,,1127617.76
6100,9/15/2020,9/15/2020,91520,82L-IMPORT PAYROLL-DAUGHERTY DEVIN W,D101,HJ,1057.78,,1128675.54
6100,9/15/2020,9/15/2020,91520,82L-IMPORT PAYROLL-DETONE KYRA MAYA,D102,HJ,379.17,,1129054.71
6100,9/15/2020,9/15/2020,91520,82L-IMPORT PAYROLL-DETONE KYRA MAYA,D102,HJ,2537.5,,1131592.21
6100,9/15/2020,9/15/2020,91520,82L-IMPORT PAYROLL-DUPUIS CHRISTOPHER M,D107,HJ,2194.79,,1133787
6100,9/15/2020,9/15/2020,91520,82L-IMPORT PAYROLL-DUPUIS CHRISTOPHER M,D107,HJ,4076.04,,1137863.04
6100,9/15/2020,9/15/2020,91520,82L-IMPORT PAYROLL-DZIEDZIC JULIE K,D101,HJ,1250,,1139113.04
6100,9/15/2020,9/15/2020,91520,82L-IMPORT PAYROLL-GORNSTEIN STEVEN,D101,HJ,243.75,,1139356.79
6100,9/15/2020,9/15/2020,91520,82L-IMPORT PAYROLL-GORNSTEIN STEVEN,D101,HJ,2464.58,,1141821.37
6100,9/15/2020,9/15/2020,91520,82L-IMPORT PAYROLL-GUADARRAMA-ALVAREZ URIEL A,D105,HJ,2897.92,,1144719.29
6100,9/15/2020,9/15/2020,91520,82L-IMPORT PAYROLL-GUTIERREZ ANTONIO J,D107,HJ,1989.77,,1146709.06
6100,9/15/2020,9/15/2020,91520,82L-IMPORT PAYROLL-GUTIERREZ ANTONIO J,D107,HJ,3537.36,,1150246.42
6100,9/15/2020,9/15/2020,91520,82L-IMPORT PAYROLL-HENRY GILLIAN,D102,HJ,1041.67,,1151288.09
6100,9/15/2020,9/15/2020,91520,82L-IMPORT PAYROLL-HENRY GILLIAN,D102,HJ,1041.67,,1152329.76
6100,9/15/2020,9/15/2020,91520,82L-IMPORT PAYROLL-HERMAN ADAM,D102,HJ,1378.37,,1153708.13
6100,9/15/2020,9/15/2020,91520,82L-IMPORT PAYROLL-HESTER TYLER CONRAD,D105,HJ,1916.67,,1155624.8
6100,9/15/2020,9/15/2020,91520,82L-IMPORT PAYROLL-Import Payroll,D107,HJ,326.04,,1155950.84
6100,9/15/2020,9/15/2020,91520,82L-IMPORT PAYROLL-Import Payroll,D107,HJ,735.21,,1156686.05
6100,9/15/2020,9/15/2020,91520,82L-IMPORT PAYROLL-LACEY DEQUITA,D104,HJ,2698.75,,1159384.8
6100,9/15/2020,9/15/2020,91520,82L-IMPORT PAYROLL-LIPORACE HERNAN LUIS,D103,HJ,2291.67,,1161676.47
6100,9/15/2020,9/15/2020,91520,82L-IMPORT PAYROLL-MASON ANGELA,D107,HJ,1027.97,,1162704.44
6100,9/15/2020,9/15/2020,91520,82L-IMPORT PAYROLL-MASON ANGELA,D107,HJ,4682.97,,1167387.41
6100,9/15/2020,9/15/2020,91520,82L-IMPORT PAYROLL-O'DONNELL STEPHEN,D104,HJ,2707.5,,1170094.91
6100,9/15/2020,9/15/2020,91520,82L-IMPORT PAYROLL-PARETS MALLORY GRACE,D101,HJ,2833.33,,1172928.24
6100,9/15/2020,9/15/2020,91520,82L-IMPORT PAYROLL-PARHAM-GANTT DENISE M,D112,HJ,3041.67,,1175969.91
6100,9/15/2020,9/15/2020,91520,82L-IMPORT PAYROLL-PEINADO ELIZABETH R,D111,HJ,3749.96,,1179719.87
6100,9/15/2020,9/15/2020,91520,82L-IMPORT PAYROLL-POLANCO ODALIS,D103,HJ,3124.96,,1182844.83
6100,9/15/2020,9/15/2020,91520,82L-IMPORT PAYROLL-QUINTAS JASHIVE,D105,HJ,1916.67,,1184761.5
6100,9/15/2020,9/15/2020,91520,82L-IMPORT PAYROLL-RANDOLPH ALEXANDER,D111,HJ,1875,,1186636.5
6100,9/15/2020,9/15/2020,91520,82L-IMPORT PAYROLL-RUBI PERLA,D101,HJ,1250,,1187886.5
6100,9/15/2020,9/15/2020,91520,82L-IMPORT PAYROLL-SAFRAN ALAN P,D107,HJ,676.52,,1188563.02
6100,9/15/2020,9/15/2020,91520,82L-IMPORT PAYROLL-SAFRAN ALAN P,D107,HJ,6840.36,,1195403.38
6100,9/15/2020,9/15/2020,91520,82L-IMPORT PAYROLL-SHENKMAN OLIVIA,D101,HJ,2000,,1197403.38
6100,9/15/2020,9/15/2020,91520,82L-IMPORT PAYROLL-SHI GRACE,D103,HJ,875,,1198278.38
6100,9/15/2020,9/15/2020,91520,82L-IMPORT PAYROLL-WALLACE AMENA,D104,HJ,2187.5,,1200465.88
6100,9/15/2020,9/15/2020,91520,82L-IMPORT PAYROLL-WEINSTOCK EMILY,D101,HJ,2833.33,,1203299.21
6100,9/15/2020,9/15/2020,91520,82L-IMPORT PAYROLL-WINANS JENNIFER,D111,HJ,2505.63,,1205804.84
6100,9/15/2020,9/15/2020,91520,82L-IMPORT PAYROLL-ZARATE JOSEPH M,D105,HJ,2150,,1207954.84
6100,9/15/2020,9/15/2020,91520,82L-IMPORT PAYROLL-AGUANNO JOSEPH,D108,HJ,1119.05,,1209073.89
6100,9/15/2020,9/15/2020,91520,82L-IMPORT PAYROLL-AKESODE FEHINTOLA,D108,HJ,1119.05,,1210192.94
6100,9/15/2020,9/15/2020,91520,82L-IMPORT PAYROLL-BARTOLD DEANNA MARIE,D108,HJ,3034.5,,1213227.44
6100,9/15/2020,9/15/2020,91520,82L-IMPORT PAYROLL-BELLOT GENESIS,D108,HJ,2500,,1215727.44
6100,9/15/2020,9/15/2020,91520,82L-IMPORT PAYROLL-BENNETT JAMES H,D108,HJ,1119.05,,1216846.49
6100,9/15/2020,9/15/2020,91520,82L-IMPORT PAYROLL-BOWMAN ABIGAIL,D108,HJ,1119.05,,1217965.54
6100,9/15/2020,9/15/2020,91520,82L-IMPORT PAYROLL-BURRELL RUSSELL,D108,HJ,1119.05,,1219084.59
6100,9/15/2020,9/15/2020,91520,82L-IMPORT PAYROLL-CHUI KENT,D108,HJ,1119.05,,1220203.64
6100,9/15/2020,9/15/2020,91520,82L-IMPORT PAYROLL-CIRKER MIA,D108,HJ,2250,,1222453.64
6100,9/15/2020,9/15/2020,91520,82L-IMPORT PAYROLL-DIETZ MARY,D108,HJ,1119.05,,1223572.69
6100,9/15/2020,9/15/2020,91520,82L-IMPORT PAYROLL-DOMINIQUE PRINCESSA,D108,HJ,1119.05,,1224691.74
6100,9/15/2020,9/15/2020,91520,82L-IMPORT PAYROLL-DONNELLY HOME,D108,HJ,1119.05,,1225810.79
6100,9/15/2020,9/15/2020,91520,82L-IMPORT PAYROLL-FEIGHERY JOHN,D108,HJ,2250,,1228060.79
6100,9/15/2020,9/15/2020,91520,82L-IMPORT PAYROLL-FORTH KYLE,D108,HJ,1119.05,,1229179.84
6100,9/15/2020,9/15/2020,91520,82L-IMPORT PAYROLL-GARCIA MARILYN,D108,HJ,2291.67,,1231471.51
6100,9/15/2020,9/15/2020,91520,82L-IMPORT PAYROLL-GREENE BROOKE,D108,HJ,1119.05,,1232590.56
6100,9/15/2020,9/15/2020,91520,82L-IMPORT PAYROLL-GRIFFIN ANDREW,D108,HJ,2250,,1234840.56
6100,9/15/2020,9/15/2020,91520,82L-IMPORT PAYROLL-GROSS EMILY,D108,HJ,1119.05,,1235959.61
6100,9/15/2020,9/15/2020,91520,82L-IMPORT PAYROLL-GUERRERO LUIS,D108,HJ,1119.05,,1237078.66
6100,9/15/2020,9/15/2020,91520,82L-IMPORT PAYROLL-HALLINAN GABRIEL B,D108,HJ,2550,,1239628.66
6100,9/15/2020,9/15/2020,91520,82L-IMPORT PAYROLL-HAMERSLY WILLIAM,D108,HJ,2500,,1242128.66
6100,9/15/2020,9/15/2020,91520,82L-IMPORT PAYROLL-HOLDER LATIVA M,D108,HJ,3812.5,,1245941.16
6100,9/15/2020,9/15/2020,91520,82L-IMPORT PAYROLL-HOSSAIN MYESHA R,D108,HJ,2437.5,,1248378.66
6100,9/15/2020,9/15/2020,91520,82L-IMPORT PAYROLL-JACKSON TASNIM,D108,HJ,2291.67,,1250670.33
6100,9/15/2020,9/15/2020,91520,82L-IMPORT PAYROLL-KERKHOFF HARPER FAITH,D108,HJ,1119.05,,1251789.38
6100,9/15/2020,9/15/2020,91520,82L-IMPORT PAYROLL-LEARY AUBREY,D108,HJ,1119.05,,1252908.43
6100,9/15/2020,9/15/2020,91520,82L-IMPORT PAYROLL-LI BELLA,D108,HJ,2486.25,,1255394.68
6100,9/15/2020,9/15/2020,91520,82L-IMPORT PAYROLL-LOUIE JORDAN,D108,HJ,1119.05,,1256513.73
6100,9/15/2020,9/15/2020,91520,82L-IMPORT PAYROLL-MELCHOR OSBEIDY,D108,HJ,1119.05,,1257632.78
6100,9/15/2020,9/15/2020,91520,82L-IMPORT PAYROLL-MITTLEMAN ROBERT,D108,HJ,1119.05,,1258751.83
6100,9/15/2020,9/15/2020,91520,82L-IMPORT PAYROLL-MORRIS ZAKIYA,D108,HJ,1119.05,,1259870.88
6100,9/15/2020,9/15/2020,91520,82L-IMPORT PAYROLL-MORSELETTO RAFAEL,D108,HJ,1119.05,,1260989.93
6100,9/15/2020,9/15/2020,91520,82L-IMPORT PAYROLL-OBI TOBECHUKWU,D108,HJ,1119.05,,1262108.98
6100,9/15/2020,9/15/2020,91520,82L-IMPORT PAYROLL-OPUH NDIDI,D108,HJ,2833,,1264941.98
6100,9/15/2020,9/15/2020,91520,82L-IMPORT PAYROLL-PAULINO THAIRI,D108,HJ,1119.05,,1266061.03
6100,9/15/2020,9/15/2020,91520,82L-IMPORT PAYROLL-ROSENBAUM MURRAY,D108,HJ,1119.05,,1267180.08
6100,9/15/2020,9/15/2020,91520,82L-IMPORT PAYROLL-SCHWETTMANN CLAIRE,D108,HJ,1119.05,,1268299.13
6100,9/15/2020,9/15/2020,91520,82L-IMPORT PAYROLL-SOBELMAN JUSTIN,D108,HJ,1119.05,,1269418.18
6100,9/15/2020,9/15/2020,91520,82L-IMPORT PAYROLL-TERRENCE-SMITH ZIHIR UNIQUE,D108,HJ,1119.05,,1270537.23
6100,9/15/2020,9/15/2020,91520,82L-IMPORT PAYROLL-TILLERY ASIA,D108,HJ,3291.67,,1273828.9
6100,9/15/2020,9/15/2020,91520,82L-IMPORT PAYROLL-WILLIAMS- MASSEY BRIANNA M,D108,HJ,1119.05,,1274947.95
6100,9/15/2020,9/15/2020,91520,82L-IMPORT PAYROLL-XIAO CHENGYAO,D108,HJ,1119.05,,1276067
6100,9/15/2020,9/15/2020,91520,82L-IMPORT PAYROLL-ZIAUDDIN ABUTAHER M,D108,HJ,1119.05,,1277186.05
6100,9/15/2020,9/15/2020,91520,82L-IMPORT PAYROLL-BALASUBRAMANIAN SHARANYA,D108,HJ,2666.67,,1279852.72
6100,9/15/2020,9/15/2020,91520,82L-IMPORT PAYROLL-COVENEY ALLISON,D108,HJ,2854.17,,1282706.89
6100,9/15/2020,9/15/2020,91520,82L-IMPORT PAYROLL-JACKSON CLAICE,D108,HJ,3125,,1285831.89
6100,9/15/2020,9/15/2020,91520,82L-IMPORT PAYROLL-JANG DANIEL,D108,HJ,2750,,1288581.89
6100,9/15/2020,9/15/2020,91520,82L-IMPORT PAYROLL-LENEGHAN MARYELLEN,D108,HJ,1715.62,,1290297.51
6100,9/15/2020,9/15/2020,91520,82L-IMPORT PAYROLL-LENEGHAN MARYELLEN,D108,HJ,2096.88,,1292394.39
6100,9/30/2020,9/30/2020,93020,82L-IMPORT PAYROLL-ALVAREZ-MORINE LISIS,D108,HJ,2541.67,,1294936.06
6100,9/30/2020,9/30/2020,93020,82L-IMPORT PAYROLL-ALWARDT CALEB,D108,HJ,1047.62,,1295983.68
6100,9/30/2020,9/30/2020,93020,82L-IMPORT PAYROLL-BARTHELEMY RACHALIE,D108,HJ,1047.62,,1297031.3
6100,9/30/2020,9/30/2020,93020,82L-IMPORT PAYROLL-BASHAM WILLIAM EDWARD,D108,HJ,1047.62,,1298078.92
6100,9/30/2020,9/30/2020,93020,82L-IMPORT PAYROLL-BOHLSEN GRACE,D108,HJ,1047.62,,1299126.54
6100,9/30/2020,9/30/2020,93020,82L-IMPORT PAYROLL-BORCHART SPENCER,D108,HJ,1047.62,,1300174.16
6100,9/30/2020,9/30/2020,93020,82L-IMPORT PAYROLL-BROWN ISAAC,D108,HJ,1047.62,,1301221.78
6100,9/30/2020,9/30/2020,93020,82L-IMPORT PAYROLL-BURKE MARIAH,D108,HJ,1047.62,,1302269.4
6100,9/30/2020,9/30/2020,93020,82L-IMPORT PAYROLL-CASSADY JOSHUA LEWIS,D108,HJ,1047.62,,1303317.02
6100,9/30/2020,9/30/2020,93020,82L-IMPORT PAYROLL-CHAVOUS MILFORD,D108,HJ,1047.62,,1304364.64
6100,9/30/2020,9/30/2020,93020,82L-IMPORT PAYROLL-DARKO OLIVIA,D108,HJ,1047.62,,1305412.26
6100,9/30/2020,9/30/2020,93020,82L-IMPORT PAYROLL-DAWSON JAMIL NAFAYE-BEYAH,D108,HJ,1047.62,,1306459.88
6100,9/30/2020,9/30/2020,93020,82L-IMPORT PAYROLL-ESCAMILLA OLGA,D108,HJ,1047.62,,1307507.5
6100,9/30/2020,9/30/2020,93020,82L-IMPORT PAYROLL-GARCIA SANTIAGO,D108,HJ,2042,,1309549.5
6100,9/30/2020,9/30/2020,93020,82L-IMPORT PAYROLL-GILES SHAYLA,D108,HJ,1047.62,,1310597.12
6100,9/30/2020,9/30/2020,93020,82L-IMPORT PAYROLL-IKUNIKA FUNMILAYO,D108,HJ,2083,,1312680.12
6100,9/30/2020,9/30/2020,93020,82L-IMPORT PAYROLL-JONES JORDAN,D108,HJ,1047.62,,1313727.74
6100,9/30/2020,9/30/2020,93020,82L-IMPORT PAYROLL-KHAN HUDA,D108,HJ,1047.62,,1314775.36
6100,9/30/2020,9/30/2020,93020,82L-IMPORT PAYROLL-KLOHR TIMOTHY JORDAN,D108,HJ,2000,,1316775.36
6100,9/30/2020,9/30/2020,93020,82L-IMPORT PAYROLL-KNOWLIN ZYLIA,D108,HJ,2111.73,,1318887.09
6100,9/30/2020,9/30/2020,93020,82L-IMPORT PAYROLL-KOPSHEVER MELISSA,D108,HJ,2916.67,,1321803.76
6100,9/30/2020,9/30/2020,93020,82L-IMPORT PAYROLL-LI SEN,D108,HJ,1047.62,,1322851.38
6100,9/30/2020,9/30/2020,93020,82L-IMPORT PAYROLL-LIPSCOMB STEPHEN,D108,HJ,2541.67,,1325393.05
6100,9/30/2020,9/30/2020,93020,82L-IMPORT PAYROLL-MALLECK JESSICA R,D108,HJ,1047.62,,1326440.67
6100,9/30/2020,9/30/2020,93020,82L-IMPORT PAYROLL-MCLAUGHLIN MARA,D108,HJ,1047.62,,1327488.29
6100,9/30/2020,9/30/2020,93020,82L-IMPORT PAYROLL-MEJIA CARLOS MANUEL,D108,HJ,1047.62,,1328535.91
6100,9/30/2020,9/30/2020,93020,82L-IMPORT PAYROLL-MONROY-MEJIA JASON,D108,HJ,1047.62,,1329583.53
6100,9/30/2020,9/30/2020,93020,82L-IMPORT PAYROLL-O'FLYNN-PRUITT NATHAN COLYAR,D108,HJ,1047.62,,1330631.15
6100,9/30/2020,9/30/2020,93020,82L-IMPORT PAYROLL-PATTERSON STEVE,D108,HJ,1047.62,,1331678.77
6100,9/30/2020,9/30/2020,93020,82L-IMPORT PAYROLL-SCHMIESS RACHEL JOY,D108,HJ,1047.62,,1332726.39
6100,9/30/2020,9/30/2020,93020,82L-IMPORT PAYROLL-SCOTT KIRK,D108,HJ,1047.62,,1333774.01
6100,9/30/2020,9/30/2020,93020,82L-IMPORT PAYROLL-SILVER KELLY,D108,HJ,2541.67,,1336315.68
6100,9/30/2020,9/30/2020,93020,82L-IMPORT PAYROLL-SOLIMAN MARK,D108,HJ,1047.62,,1337363.3
6100,9/30/2020,9/30/2020,93020,82L-IMPORT PAYROLL-STEIN KYLE,D108,HJ,2083,,1339446.3
6100,9/30/2020,9/30/2020,93020,82L-IMPORT PAYROLL-STROUD DAVID,D108,HJ,1047.62,,1340493.92
6100,9/30/2020,9/30/2020,93020,82L-IMPORT PAYROLL-VALCIN SABRINA JEMIMAH,D108,HJ,1047.62,,1341541.54
6100,9/30/2020,9/30/2020,93020,82L-IMPORT PAYROLL-VALDES ERNEST L,D108,HJ,1047.62,,1342589.16
6100,9/30/2020,9/30/2020,93020,82L-IMPORT PAYROLL-WILLIAMS MACK,D108,HJ,1047.62,,1343636.78
6100,9/30/2020,9/30/2020,93020,82L-IMPORT PAYROLL-WILLIAMS MIL'YONTA,D108,HJ,1047.62,,1344684.4
6100,9/30/2020,9/30/2020,93020,82L-IMPORT PAYROLL-ANTHONY BETTY,D108,HJ,2886.52,,1347570.92
6100,9/30/2020,9/30/2020,93020,82L-IMPORT PAYROLL-AUSTIN PERCY,D108,HJ,2653.02,,1350223.94
6100,9/30/2020,9/30/2020,93020,82L-IMPORT PAYROLL-BUHMANN JAY,D108,HJ,2271,,1352494.94
6100,9/30/2020,9/30/2020,93020,82L-IMPORT PAYROLL-CHAPMAN CLAUDY EARL,D108,HJ,1833.33,,1354328.27
6100,9/30/2020,9/30/2020,93020,82L-IMPORT PAYROLL-DADA ARIKPO,D108,HJ,2720,,1357048.27
6100,9/30/2020,9/30/2020,93020,82L-IMPORT PAYROLL-GUTHRIE LESLIE,D108,HJ,2458.33,,1359506.6
6100,9/30/2020,9/30/2020,93020,82L-IMPORT PAYROLL-HOLMES JOREL ALEXANDER,D108,HJ,2329,,1361835.6
6100,9/30/2020,9/30/2020,93020,82L-IMPORT PAYROLL-JORDAN TIFFANY T,D108,HJ,3445,,1365280.6
6100,9/30/2020,9/30/2020,93020,82L-IMPORT PAYROLL-LANIGAN LISA A,D108,HJ,3113.75,,1368394.35
6100,9/30/2020,9/30/2020,93020,82L-IMPORT PAYROLL-MCELWEE MELISSA,D108,HJ,2666.67,,1371061.02
6100,9/30/2020,9/30/2020,93020,82L-IMPORT PAYROLL-MCNICHOLAS MARY,D108,HJ,2291.67,,1373352.69
6100,9/30/2020,9/30/2020,93020,82L-IMPORT PAYROLL-NWAKANMA NANCY,D108,HJ,2953.85,,1376306.54
6100,9/30/2020,9/30/2020,93020,82L-IMPORT PAYROLL-ONICA ANTHONY J,D108,HJ,2416.67,,1378723.21
6100,9/30/2020,9/30/2020,93020,82L-IMPORT PAYROLL-PRAHIN NICOLE M,D108,HJ,1039.77,,1379762.98
6100,9/30/2020,9/30/2020,93020,82L-IMPORT PAYROLL-PRAHIN NICOLE M,D108,HJ,2772.73,,1382535.71
6100,9/30/2020,9/30/2020,93020,82L-IMPORT PAYROLL-RIVERS QUIONNA DIANE,D108,HJ,2568.03,,1385103.74
6100,9/30/2020,9/30/2020,93020,82L-IMPORT PAYROLL-SALIM YASSER,D108,HJ,2431.94,,1387535.68
6100,9/30/2020,9/30/2020,93020,82L-IMPORT PAYROLL-SEJOUR MAHALIAH,D108,HJ,2500,,1390035.68
6100,9/30/2020,9/30/2020,93020,82L-IMPORT PAYROLL-SKALSKI CHRISTOPHER,D108,HJ,2465,,1392500.68
6100,9/30/2020,9/30/2020,93020,82L-IMPORT PAYROLL-TUMENJARGAL ENKHJIN,D108,HJ,2414,,1394914.68
6100,9/30/2020,9/30/2020,93020,82L-IMPORT PAYROLL-VILLEGAS EVELYN,D108,HJ,2817.75,,1397732.43
6100,9/30/2020,9/30/2020,93020,82L-IMPORT PAYROLL-WOLF ANNA A,D108,HJ,2635,,1400367.43
6100,9/30/2020,9/30/2020,93020,82L-IMPORT PAYROLL-ACEVEDO MONIVETT,D107,HJ,5375,,1405742.43
6100,9/30/2020,9/30/2020,93020,82L-IMPORT PAYROLL-AKLESTAD ISABEL,D111,HJ,1750,,1407492.43
6100,9/30/2020,9/30/2020,93020,82L-IMPORT PAYROLL-ALLEN KIMBERLY,D111,HJ,1833.33,,1409325.76
6100,9/30/2020,9/30/2020,93020,82L-IMPORT PAYROLL-BIBB TIFFANI,D104,HJ,3875,,1413200.76
6100,9/30/2020,9/30/2020,93020,82L-IMPORT PAYROLL-Bowman Halley,D101,HJ,3437.5,,1416638.26
6100,9/30/2020,9/30/2020,93020,82L-IMPORT PAYROLL-COOK CATHRYN ANNA,D105,HJ,3593.03,,1420231.29
6100,9/30/2020,9/30/2020,93020,82L-IMPORT PAYROLL-COOPER ASHLEE R,D101,HJ,2461.88,,1422693.17
6100,9/30/2020,9/30/2020,93020,82L-IMPORT PAYROLL-CORTEZ MIRANDA A,D111,HJ,2672.72,,1425365.89
6100,9/30/2020,9/30/2020,93020,82L-IMPORT PAYROLL-DAUGHERTY DEVIN W,D101,HJ,1041.67,,1426407.56
6100,9/30/2020,9/30/2020,93020,82L-IMPORT PAYROLL-DETONE KYRA MAYA,D102,HJ,188.17,,1426595.73
6100,9/30/2020,9/30/2020,93020,82L-IMPORT PAYROLL-DETONE KYRA MAYA,D102,HJ,2728.5,,1429324.23
6100,9/30/2020,9/30/2020,93020,82L-IMPORT PAYROLL-DUPUIS CHRISTOPHER M,D107,HJ,3064.16,,1432388.39
6100,9/30/2020,9/30/2020,93020,82L-IMPORT PAYROLL-DUPUIS CHRISTOPHER M,D107,HJ,3206.67,,1435595.06
6100,9/30/2020,9/30/2020,93020,82L-IMPORT PAYROLL-DZIEDZIC JULIE K,D101,HJ,1250,,1436845.06
6100,9/30/2020,9/30/2020,93020,82L-IMPORT PAYROLL-GORNSTEIN STEVEN,D101,HJ,2708.33,,1439553.39
6100,9/30/2020,9/30/2020,93020,82L-IMPORT PAYROLL-GUADARRAMA-ALVAREZ URIEL A,D105,HJ,2897.92,,1442451.31
6100,9/30/2020,9/30/2020,93020,82L-IMPORT PAYROLL-GUTIERREZ ANTONIO J,D107,HJ,2512.33,,1444963.64
6100,9/30/2020,9/30/2020,93020,82L-IMPORT PAYROLL-GUTIERREZ ANTONIO J,D107,HJ,3014.8,,1447978.44
6100,9/30/2020,9/30/2020,93020,82L-IMPORT PAYROLL-HENRY GILLIAN,D102,HJ,757.58,,1448736.02
6100,9/30/2020,9/30/2020,93020,82L-IMPORT PAYROLL-HENRY GILLIAN,D102,HJ,1325.76,,1450061.78
6100,9/30/2020,9/30/2020,93020,82L-IMPORT PAYROLL-HERMAN ADAM,D102,HJ,1958.33,,1452020.11
6100,9/30/2020,9/30/2020,93020,82L-IMPORT PAYROLL-HESTER TYLER CONRAD,D105,HJ,1916.67,,1453936.78
6100,9/30/2020,9/30/2020,93020,82L-IMPORT PAYROLL-LACEY DEQUITA,D104,HJ,996.42,,1454933.2
6100,9/30/2020,9/30/2020,93020,82L-IMPORT PAYROLL-LIPORACE HERNAN LUIS,D103,HJ,2291.67,,1457224.87
6100,9/30/2020,9/30/2020,93020,82L-IMPORT PAYROLL-MASON ANGELA,D107,HJ,1557.53,,1458782.4
6100,9/30/2020,9/30/2020,93020,82L-IMPORT PAYROLL-MASON ANGELA,D107,HJ,4153.41,,1462935.81
6100,9/30/2020,9/30/2020,93020,82L-IMPORT PAYROLL-O'DONNELL STEPHEN,D104,HJ,2707.5,,1465643.31
6100,9/30/2020,9/30/2020,93020,82L-IMPORT PAYROLL-PARETS MALLORY GRACE,D101,HJ,2833.33,,1468476.64
6100,9/30/2020,9/30/2020,93020,82L-IMPORT PAYROLL-PARHAM-GANTT DENISE M,D112,HJ,3041.67,,1471518.31
6100,9/30/2020,9/30/2020,93020,82L-IMPORT PAYROLL-PEINADO ELIZABETH R,D111,HJ,3749.96,,1475268.27
6100,9/30/2020,9/30/2020,93020,82L-IMPORT PAYROLL-POLANCO ODALIS,D103,HJ,3124.96,,1478393.23
6100,9/30/2020,9/30/2020,93020,82L-IMPORT PAYROLL-QUINTAS JASHIVE,D105,HJ,1916.67,,1480309.9
6100,9/30/2020,9/30/2020,93020,82L-IMPORT PAYROLL-RANDOLPH ALEXANDER,D111,HJ,1875,,1482184.9
6100,9/30/2020,9/30/2020,93020,82L-IMPORT PAYROLL-RUBI PERLA,D101,HJ,1250,,1483434.9
6100,9/30/2020,9/30/2020,93020,82L-IMPORT PAYROLL-SAFRAN ALAN P,D107,HJ,683.35,,1484118.25
6100,9/30/2020,9/30/2020,93020,82L-IMPORT PAYROLL-SAFRAN ALAN P,D107,HJ,6833.53,,1490951.78
6100,9/30/2020,9/30/2020,93020,82L-IMPORT PAYROLL-SHENKMAN OLIVIA,D101,HJ,2000,,1492951.78
6100,9/30/2020,9/30/2020,93020,82L-IMPORT PAYROLL-SHI GRACE,D103,HJ,875,,1493826.78
6100,9/30/2020,9/30/2020,93020,82L-IMPORT PAYROLL-WALLACE AMENA,D104,HJ,2187.5,,1496014.28
6100,9/30/2020,9/30/2020,93020,82L-IMPORT PAYROLL-WEINSTOCK EMILY,D101,HJ,2833.33,,1498847.61
6100,9/30/2020,9/30/2020,93020,82L-IMPORT PAYROLL-WINANS JENNIFER,D111,HJ,2505.63,,1501353.24
6100,9/30/2020,9/30/2020,93020,82L-IMPORT PAYROLL-ZARATE JOSEPH M,D105,HJ,2150,,1503503.24
6100,9/30/2020,9/30/2020,93020,82L-IMPORT PAYROLL-AGUANNO JOSEPH,D108,HJ,1119.05,,1504622.29
6100,9/30/2020,9/30/2020,93020,82L-IMPORT PAYROLL-AKESODE FEHINTOLA,D108,HJ,1119.05,,1505741.34
6100,9/30/2020,9/30/2020,93020,82L-IMPORT PAYROLL-BARTOLD DEANNA MARIE,D108,HJ,3034.5,,1508775.84
6100,9/30/2020,9/30/2020,93020,82L-IMPORT PAYROLL-BELLOT GENESIS,D108,HJ,2500,,1511275.84
6100,9/30/2020,9/30/2020,93020,82L-IMPORT PAYROLL-BENNETT JAMES H,D108,HJ,1119.05,,1512394.89
6100,9/30/2020,9/30/2020,93020,82L-IMPORT PAYROLL-BOWMAN ABIGAIL,D108,HJ,1119.05,,1513513.94
6100,9/30/2020,9/30/2020,93020,82L-IMPORT PAYROLL-BURRELL RUSSELL,D108,HJ,1119.05,,1514632.99
6100,9/30/2020,9/30/2020,93020,82L-IMPORT PAYROLL-CHUI KENT,D108,HJ,1119.05,,1515752.04
6100,9/30/2020,9/30/2020,93020,82L-IMPORT PAYROLL-CIRKER MIA,D108,HJ,2250,,1518002.04
6100,9/30/2020,9/30/2020,93020,82L-IMPORT PAYROLL-DIETZ MARY,D108,HJ,1119.05,,1519121.09
6100,9/30/2020,9/30/2020,93020,82L-IMPORT PAYROLL-DOMINIQUE PRINCESSA,D108,HJ,1119.05,,1520240.14
6100,9/30/2020,9/30/2020,93020,82L-IMPORT PAYROLL-DONNELLY HOME,D108,HJ,1119.05,,1521359.19
6100,9/30/2020,9/30/2020,93020,82L-IMPORT PAYROLL-FEIGHERY JOHN,D108,HJ,2250,,1523609.19
6100,9/30/2020,9/30/2020,93020,82L-IMPORT PAYROLL-FORTH KYLE,D108,HJ,1119.05,,1524728.24
6100,9/30/2020,9/30/2020,93020,82L-IMPORT PAYROLL-GARCIA MARILYN,D108,HJ,2291.67,,1527019.91
6100,9/30/2020,9/30/2020,93020,82L-IMPORT PAYROLL-GREENE BROOKE,D108,HJ,1119.05,,1528138.96
6100,9/30/2020,9/30/2020,93020,82L-IMPORT PAYROLL-GRIFFIN ANDREW,D108,HJ,2250,,1530388.96
6100,9/30/2020,9/30/2020,93020,82L-IMPORT PAYROLL-GROSS EMILY,D108,HJ,1119.05,,1531508.01
6100,9/30/2020,9/30/2020,93020,82L-IMPORT PAYROLL-GUERRERO LUIS,D108,HJ,1119.05,,1532627.06
6100,9/30/2020,9/30/2020,93020,82L-IMPORT PAYROLL-HALLINAN GABRIEL B,D108,HJ,2550,,1535177.06
6100,9/30/2020,9/30/2020,93020,82L-IMPORT PAYROLL-HAMERSLY WILLIAM,D108,HJ,2500,,1537677.06
6100,9/30/2020,9/30/2020,93020,82L-IMPORT PAYROLL-HOLDER LATIVA M,D108,HJ,3812.5,,1541489.56
6100,9/30/2020,9/30/2020,93020,82L-IMPORT PAYROLL-HOSSAIN MYESHA R,D108,HJ,2437.5,,1543927.06
6100,9/30/2020,9/30/2020,93020,82L-IMPORT PAYROLL-JACKSON TASNIM,D108,HJ,2291.67,,1546218.73
6100,9/30/2020,9/30/2020,93020,82L-IMPORT PAYROLL-KERKHOFF HARPER FAITH,D108,HJ,1119.05,,1547337.78
6100,9/30/2020,9/30/2020,93020,82L-IMPORT PAYROLL-LEARY AUBREY,D108,HJ,1119.05,,1548456.83
6100,9/30/2020,9/30/2020,93020,82L-IMPORT PAYROLL-LI BELLA,D108,HJ,2486.25,,1550943.08
6100,9/30/2020,9/30/2020,93020,82L-IMPORT PAYROLL-LOUIE JORDAN,D108,HJ,1119.05,,1552062.13
6100,9/30/2020,9/30/2020,93020,82L-IMPORT PAYROLL-MELCHOR OSBEIDY,D108,HJ,1119.05,,1553181.18
6100,9/30/2020,9/30/2020,93020,82L-IMPORT PAYROLL-MITTLEMAN ROBERT,D108,HJ,1119.05,,1554300.23
6100,9/30/2020,9/30/2020,93020,82L-IMPORT PAYROLL-MORRIS ZAKIYA,D108,HJ,1119.05,,1555419.28
6100,9/30/2020,9/30/2020,93020,82L-IMPORT PAYROLL-OBI TOBECHUKWU,D108,HJ,1119.05,,1556538.33
6100,9/30/2020,9/30/2020,93020,82L-IMPORT PAYROLL-OPUH NDIDI,D108,HJ,2833,,1559371.33
6100,9/30/2020,9/30/2020,93020,82L-IMPORT PAYROLL-PAULINO THAIRI,D108,HJ,1119.05,,1560490.38
6100,9/30/2020,9/30/2020,93020,82L-IMPORT PAYROLL-ROSENBAUM MURRAY,D108,HJ,1119.05,,1561609.43
6100,9/30/2020,9/30/2020,93020,82L-IMPORT PAYROLL-SCHWETTMANN CLAIRE,D108,HJ,1119.05,,1562728.48
6100,9/30/2020,9/30/2020,93020,82L-IMPORT PAYROLL-SOBELMAN JUSTIN,D108,HJ,1119.05,,1563847.53
6100,9/30/2020,9/30/2020,93020,82L-IMPORT PAYROLL-TERRENCE-SMITH ZIHIR UNIQUE,D108,HJ,1119.05,,1564966.58
6100,9/30/2020,9/30/2020,93020,82L-IMPORT PAYROLL-TILLERY ASIA,D108,HJ,3291.67,,1568258.25
6100,9/30/2020,9/30/2020,93020,82L-IMPORT PAYROLL-WILLIAMS- MASSEY BRIANNA M,D108,HJ,1119.05,,1569377.3
6100,9/30/2020,9/30/2020,93020,82L-IMPORT PAYROLL-XIAO CHENGYAO,D108,HJ,1119.05,,1570496.35
6100,9/30/2020,9/30/2020,93020,82L-IMPORT PAYROLL-ZIAUDDIN ABUTAHER M,D108,HJ,1119.05,,1571615.4
6100,9/30/2020,9/30/2020,93020,82L-IMPORT PAYROLL-BALASUBRAMANIAN SHARANYA,D108,HJ,2666.67,,1574282.07
6100,9/30/2020,9/30/2020,93020,82L-IMPORT PAYROLL-COVENEY ALLISON,D108,HJ,2854.17,,1577136.24
6100,9/30/2020,9/30/2020,93020,82L-IMPORT PAYROLL-JACKSON CLAICE,D108,HJ,3125,,1580261.24
6100,9/30/2020,9/30/2020,93020,82L-IMPORT PAYROLL-JANG DANIEL,D108,HJ,2750,,1583011.24
6100,9/30/2020,9/30/2020,93020,82L-IMPORT PAYROLL-LENEGHAN MARYELLEN,D108,HJ,940.71,,1583951.95
6100,9/30/2020,9/30/2020,93020,82L-IMPORT PAYROLL-LENEGHAN MARYELLEN,D108,HJ,1732.95,,1585684.9
6100,9/30/2020,9/30/2020,93020,82L-IMPORT PAYROLL-LENEGHAN MARYELLEN,D108,HJ,2079.55,,1587764.45
6100,9/30/2020,9/30/2020,202009,Adj to reallocate Salaries FICA and benefits from GM3 - ACY2 to G-BL-To reallocate Amena Wallance from GM3 - ACY2 to G-BL,D104,HJ,,4375,1583389.45
6100,9/30/2020,9/30/2020,202009,Adj to reallocate Salaries FICA and benefits from GM3 - ACY2 to G-BL-To reallocate Amena Wallance from GM3 - ACY2 to G-BL,D104,HJ,4375,,1587764.45
6100,9/30/2020,9/30/2020,202009,Adj to reallocate Salaries FICA and benefits from GM3 - ACY2 to G-BL-To reallocate Lacey Dequita and T.Bibb salary from GM3 - ACY2 to G-BL,D104,HJ,,9716.24,1578048.21
6100,9/30/2020,9/30/2020,202009,Adj to reallocate Salaries FICA and benefits from GM3 - ACY2 to G-BL-To reallocate Lacey Dequita and T.Bibb salary from GM3 - ACY2 to G-BL,D104,HJ,9716.24,,1587764.45
6100,10/15/2020,10/15/2020,101520,82L-IMPORT PAYROLL-ALVAREZ-MORINE LISIS,D108,HJ,1642.24,,1589406.69
6100,10/15/2020,10/15/2020,101520,82L-IMPORT PAYROLL-ALWARDT CALEB,D108,HJ,1047.62,,1590454.31
6100,10/15/2020,10/15/2020,101520,82L-IMPORT PAYROLL-BARTHELEMY RACHALIE,D108,HJ,1047.62,,1591501.93
6100,10/15/2020,10/15/2020,101520,82L-IMPORT PAYROLL-BASHAM WILLIAM EDWARD,D108,HJ,1047.62,,1592549.55
6100,10/15/2020,10/15/2020,101520,82L-IMPORT PAYROLL-BOHLSEN GRACE,D108,HJ,1047.62,,1593597.17
6100,10/15/2020,10/15/2020,101520,82L-IMPORT PAYROLL-BOLIVAR ANDREA,D108,HJ,229.89,,1593827.06
6100,10/15/2020,10/15/2020,101520,82L-IMPORT PAYROLL-BOLIVAR ANDREA,D108,HJ,2961.52,,1596788.58
6100,10/15/2020,10/15/2020,101520,82L-IMPORT PAYROLL-BORCHART SPENCER,D108,HJ,1047.62,,1597836.2
6100,10/15/2020,10/15/2020,101520,82L-IMPORT PAYROLL-BROWN ISAAC,D108,HJ,1047.62,,1598883.82
6100,10/15/2020,10/15/2020,101520,82L-IMPORT PAYROLL-BURKE MARIAH,D108,HJ,1047.62,,1599931.44
6100,10/15/2020,10/15/2020,101520,82L-IMPORT PAYROLL-CASSADY JOSHUA LEWIS,D108,HJ,1047.62,,1600979.06
6100,10/15/2020,10/15/2020,101520,82L-IMPORT PAYROLL-DARKO OLIVIA,D108,HJ,1047.62,,1602026.68
6100,10/15/2020,10/15/2020,101520,82L-IMPORT PAYROLL-DAWSON JAMIL NAFAYE-BEYAH,D108,HJ,1047.62,,1603074.3
6100,10/15/2020,10/15/2020,101520,82L-IMPORT PAYROLL-ESCAMILLA OLGA,D108,HJ,1047.62,,1604121.92
6100,10/15/2020,10/15/2020,101520,82L-IMPORT PAYROLL-GARCIA SANTIAGO,D108,HJ,187.77,,1604309.69
6100,10/15/2020,10/15/2020,101520,82L-IMPORT PAYROLL-GARCIA SANTIAGO,D108,HJ,2042,,1606351.69
6100,10/15/2020,10/15/2020,101520,82L-IMPORT PAYROLL-GILES SHAYLA,D108,HJ,1047.62,,1607399.31
6100,10/15/2020,10/15/2020,101520,82L-IMPORT PAYROLL-IKUNIKA FUNMILAYO,D108,HJ,191.54,,1607590.85
6100,10/15/2020,10/15/2020,101520,82L-IMPORT PAYROLL-IKUNIKA FUNMILAYO,D108,HJ,2659.81,,1610250.66
6100,10/15/2020,10/15/2020,101520,82L-IMPORT PAYROLL-JONES JORDAN,D108,HJ,1047.62,,1611298.28
6100,10/15/2020,10/15/2020,101520,82L-IMPORT PAYROLL-KHAN HUDA,D108,HJ,1047.62,,1612345.9
6100,10/15/2020,10/15/2020,101520,82L-IMPORT PAYROLL-KLOHR TIMOTHY JORDAN,D108,HJ,183.91,,1612529.81
6100,10/15/2020,10/15/2020,101520,82L-IMPORT PAYROLL-KLOHR TIMOTHY JORDAN,D108,HJ,2000,,1614529.81
6100,10/15/2020,10/15/2020,101520,82L-IMPORT PAYROLL-KNOWLIN ZYLIA,D108,HJ,233.74,,1614763.55
6100,10/15/2020,10/15/2020,101520,82L-IMPORT PAYROLL-KNOWLIN ZYLIA,D108,HJ,2542,,1617305.55
6100,10/15/2020,10/15/2020,101520,82L-IMPORT PAYROLL-KOPSHEVER MELISSA,D108,HJ,268.2,,1617573.75
6100,10/15/2020,10/15/2020,101520,82L-IMPORT PAYROLL-KOPSHEVER MELISSA,D108,HJ,2916.67,,1620490.42
6100,10/15/2020,10/15/2020,101520,82L-IMPORT PAYROLL-LI SEN,D108,HJ,1047.62,,1621538.04
6100,10/15/2020,10/15/2020,101520,82L-IMPORT PAYROLL-LIPSCOMB STEPHEN,D108,HJ,233.72,,1621771.76
6100,10/15/2020,10/15/2020,101520,82L-IMPORT PAYROLL-LIPSCOMB STEPHEN,D108,HJ,2541.67,,1624313.43
6100,10/15/2020,10/15/2020,101520,82L-IMPORT PAYROLL-MALLECK JESSICA R,D108,HJ,1047.62,,1625361.05
6100,10/15/2020,10/15/2020,101520,82L-IMPORT PAYROLL-MCLAUGHLIN MARA,D108,HJ,1047.62,,1626408.67
6100,10/15/2020,10/15/2020,101520,82L-IMPORT PAYROLL-MEJIA CARLOS MANUEL,D108,HJ,1047.62,,1627456.29
6100,10/15/2020,10/15/2020,101520,82L-IMPORT PAYROLL-MONROY-MEJIA JASON,D108,HJ,1047.62,,1628503.91
6100,10/15/2020,10/15/2020,101520,82L-IMPORT PAYROLL-O'FLYNN-PRUITT NATHAN COLYAR,D108,HJ,1047.62,,1629551.53
6100,10/15/2020,10/15/2020,101520,82L-IMPORT PAYROLL-PATTERSON STEVE,D108,HJ,1047.62,,1630599.15
6100,10/15/2020,10/15/2020,101520,82L-IMPORT PAYROLL-SCHMIESS RACHEL JOY,D108,HJ,1047.62,,1631646.77
6100,10/15/2020,10/15/2020,101520,82L-IMPORT PAYROLL-SCOTT KIRK,D108,HJ,1047.62,,1632694.39
6100,10/15/2020,10/15/2020,101520,82L-IMPORT PAYROLL-SILVER KELLY,D108,HJ,233.72,,1632928.11
6100,10/15/2020,10/15/2020,101520,82L-IMPORT PAYROLL-SILVER KELLY,D108,HJ,2541.67,,1635469.78
6100,10/15/2020,10/15/2020,101520,82L-IMPORT PAYROLL-SOLIMAN MARK,D108,HJ,1047.62,,1636517.4
6100,10/15/2020,10/15/2020,101520,82L-IMPORT PAYROLL-STEIN KYLE,D108,HJ,191.54,,1636708.94
6100,10/15/2020,10/15/2020,101520,82L-IMPORT PAYROLL-STEIN KYLE,D108,HJ,2083,,1638791.94
6100,10/15/2020,10/15/2020,101520,82L-IMPORT PAYROLL-STROUD DAVID,D108,HJ,1047.62,,1639839.56
6100,10/15/2020,10/15/2020,101520,82L-IMPORT PAYROLL-VALCIN SABRINA JEMIMAH,D108,HJ,1047.62,,1640887.18
6100,10/15/2020,10/15/2020,101520,82L-IMPORT PAYROLL-VALDES ERNEST L,D108,HJ,1047.62,,1641934.8
6100,10/15/2020,10/15/2020,101520,82L-IMPORT PAYROLL-WILLIAMS MACK,D108,HJ,1047.62,,1642982.42
6100,10/15/2020,10/15/2020,101520,82L-IMPORT PAYROLL-WILLIAMS MIL'YONTA,D108,HJ,1047.62,,1644030.04
6100,10/15/2020,10/15/2020,101520,82L-IMPORT PAYROLL-ANTHONY BETTY,D108,HJ,2886.52,,1646916.56
6100,10/15/2020,10/15/2020,101520,82L-IMPORT PAYROLL-APULI LINDSAY,D108,HJ,2500,,1649416.56
6100,10/15/2020,10/15/2020,101520,82L-IMPORT PAYROLL-AUSTIN PERCY,D108,HJ,2653.02,,1652069.58
6100,10/15/2020,10/15/2020,101520,82L-IMPORT PAYROLL-BUHMANN JAY,D108,HJ,2271,,1654340.58
6100,10/15/2020,10/15/2020,101520,82L-IMPORT PAYROLL-CAIN CORY,D108,HJ,2500,,1656840.58
6100,10/15/2020,10/15/2020,101520,82L-IMPORT PAYROLL-CHAPMAN CLAUDY EARL,D108,HJ,1833.33,,1658673.91
6100,10/15/2020,10/15/2020,101520,82L-IMPORT PAYROLL-DADA ARIKPO,D108,HJ,2720,,1661393.91
6100,10/15/2020,10/15/2020,101520,82L-IMPORT PAYROLL-GUTHRIE LESLIE,D108,HJ,2458.33,,1663852.24
6100,10/15/2020,10/15/2020,101520,82L-IMPORT PAYROLL-HOLMES JOREL ALEXANDER,D108,HJ,2329,,1666181.24
6100,10/15/2020,10/15/2020,101520,82L-IMPORT PAYROLL-JORDAN TIFFANY T,D108,HJ,3445,,1669626.24
6100,10/15/2020,10/15/2020,101520,82L-IMPORT PAYROLL-LANIGAN LISA A,D108,HJ,3113.75,,1672739.99
6100,10/15/2020,10/15/2020,101520,82L-IMPORT PAYROLL-MCELWEE MELISSA,D108,HJ,2666.67,,1675406.66
6100,10/15/2020,10/15/2020,101520,82L-IMPORT PAYROLL-MCNICHOLAS MARY,D108,HJ,2291.67,,1677698.33
6100,10/15/2020,10/15/2020,101520,82L-IMPORT PAYROLL-NWAKANMA NANCY,D108,HJ,2000,,1679698.33
6100,10/15/2020,10/15/2020,101520,82L-IMPORT PAYROLL-NWAKANMA NANCY,D108,HJ,3046.67,,1682745
6100,10/15/2020,10/15/2020,101520,82L-IMPORT PAYROLL-ONICA ANTHONY J,D108,HJ,2416.67,,1685161.67
6100,10/15/2020,10/15/2020,101520,82L-IMPORT PAYROLL-PRAHIN NICOLE M,D108,HJ,1715.62,,1686877.29
6100,10/15/2020,10/15/2020,101520,82L-IMPORT PAYROLL-PRAHIN NICOLE M,D108,HJ,2096.88,,1688974.17
6100,10/15/2020,10/15/2020,101520,82L-IMPORT PAYROLL-RIVERS QUIONNA DIANE,D108,HJ,2000,,1690974.17
6100,10/15/2020,10/15/2020,101520,82L-IMPORT PAYROLL-RIVERS QUIONNA DIANE,D108,HJ,2708.34,,1693682.51
6100,10/15/2020,10/15/2020,101520,82L-IMPORT PAYROLL-SALIM YASSER,D108,HJ,2431.94,,1696114.45
6100,10/15/2020,10/15/2020,101520,82L-IMPORT PAYROLL-SEJOUR MAHALIAH,D108,HJ,2500,,1698614.45
6100,10/15/2020,10/15/2020,101520,82L-IMPORT PAYROLL-SKALSKI CHRISTOPHER,D108,HJ,2465,,1701079.45
6100,10/15/2020,10/15/2020,101520,82L-IMPORT PAYROLL-TUMENJARGAL ENKHJIN,D108,HJ,2414,,1703493.45
6100,10/15/2020,10/15/2020,101520,82L-IMPORT PAYROLL-VILLEGAS EVELYN,D108,HJ,2817.75,,1706311.2
6100,10/15/2020,10/15/2020,101520,82L-IMPORT PAYROLL-WOLF ANNA A,D108,HJ,2635,,1708946.2
6100,10/15/2020,10/15/2020,101520,82L-IMPORT PAYROLL-ACEVEDO MONIVETT,D107,HJ,5375,,1714321.2
6100,10/15/2020,10/15/2020,101520,82L-IMPORT PAYROLL-AKLESTAD ISABEL,D111,HJ,1750,,1716071.2
6100,10/15/2020,10/15/2020,101520,82L-IMPORT PAYROLL-ALLEN KIMBERLY,D111,HJ,1833.33,,1717904.53
6100,10/15/2020,10/15/2020,101520,82L-IMPORT PAYROLL-BIBB TIFFANI,D104,HJ,3875,,1721779.53
6100,10/15/2020,10/15/2020,101520,82L-IMPORT PAYROLL-Bowman Halley,D101,HJ,3172.95,,1724952.48
6100,10/15/2020,10/15/2020,101520,82L-IMPORT PAYROLL-COOK CATHRYN ANNA,D105,HJ,3593.03,,1728545.51
6100,10/15/2020,10/15/2020,101520,82L-IMPORT PAYROLL-COOPER ASHLEE R,D101,HJ,2461.88,,1731007.39
6100,10/15/2020,10/15/2020,101520,82L-IMPORT PAYROLL-CORTEZ MIRANDA A,D111,HJ,2672.72,,1733680.11
6100,10/15/2020,10/15/2020,101520,82L-IMPORT PAYROLL-DAUGHERTY DEVIN W,D101,HJ,1041.67,,1734721.78
6100,10/15/2020,10/15/2020,101520,82L-IMPORT PAYROLL-DETONE KYRA MAYA,D102,HJ,204.16,,1734925.94
6100,10/15/2020,10/15/2020,101520,82L-IMPORT PAYROLL-DETONE KYRA MAYA,D102,HJ,2712.51,,1737638.45
6100,10/15/2020,10/15/2020,101520,82L-IMPORT PAYROLL-DUPUIS CHRISTOPHER M,D107,HJ,2445.62,,1740084.07
6100,10/15/2020,10/15/2020,101520,82L-IMPORT PAYROLL-DUPUIS CHRISTOPHER M,D107,HJ,3825.21,,1743909.28
6100,10/15/2020,10/15/2020,101520,82L-IMPORT PAYROLL-DZIEDZIC JULIE K,D101,HJ,1250,,1745159.28
6100,10/15/2020,10/15/2020,101520,82L-IMPORT PAYROLL-GORNSTEIN STEVEN,D101,HJ,2708.33,,1747867.61
6100,10/15/2020,10/15/2020,101520,82L-IMPORT PAYROLL-GUADARRAMA-ALVAREZ URIEL A,D105,HJ,2897.92,,1750765.53
6100,10/15/2020,10/15/2020,101520,82L-IMPORT PAYROLL-GUTIERREZ ANTONIO J,D107,HJ,2487.21,,1753252.74
6100,10/15/2020,10/15/2020,101520,82L-IMPORT PAYROLL-GUTIERREZ ANTONIO J,D107,HJ,3039.92,,1756292.66
6100,10/15/2020,10/15/2020,101520,82L-IMPORT PAYROLL-HENRY GILLIAN,D102,HJ,187.5,,1756480.16
6100,10/15/2020,10/15/2020,101520,82L-IMPORT PAYROLL-HENRY GILLIAN,D102,HJ,1895.84,,1758376
6100,10/15/2020,10/15/2020,101520,82L-IMPORT PAYROLL-HERMAN ADAM,D102,HJ,1958.33,,1760334.33
6100,10/15/2020,10/15/2020,101520,82L-IMPORT PAYROLL-HESTER TYLER CONRAD,D105,HJ,1916.67,,1762251
6100,10/15/2020,10/15/2020,101520,82L-IMPORT PAYROLL-LIPORACE HERNAN LUIS,D103,HJ,2291.67,,1764542.67
6100,10/15/2020,10/15/2020,101520,82L-IMPORT PAYROLL-MASON ANGELA,D107,HJ,1541.95,,1766084.62
6100,10/15/2020,10/15/2020,101520,82L-IMPORT PAYROLL-MASON ANGELA,D107,HJ,4168.99,,1770253.61
6100,10/15/2020,10/15/2020,101520,82L-IMPORT PAYROLL-O'DONNELL STEPHEN,D104,HJ,2707.5,,1772961.11
6100,10/15/2020,10/15/2020,101520,82L-IMPORT PAYROLL-PARETS MALLORY GRACE,D101,HJ,2833.33,,1775794.44
6100,10/15/2020,10/15/2020,101520,82L-IMPORT PAYROLL-PARHAM-GANTT DENISE M,D112,HJ,3041.67,,1778836.11
6100,10/15/2020,10/15/2020,101520,82L-IMPORT PAYROLL-PEINADO ELIZABETH R,D111,HJ,3749.96,,1782586.07
6100,10/15/2020,10/15/2020,101520,82L-IMPORT PAYROLL-POLANCO ODALIS,D103,HJ,3124.96,,1785711.03
6100,10/15/2020,10/15/2020,101520,82L-IMPORT PAYROLL-QUINTAS JASHIVE,D105,HJ,172.5,,1785883.53
6100,10/15/2020,10/15/2020,101520,82L-IMPORT PAYROLL-QUINTAS JASHIVE,D105,HJ,1744.17,,1787627.7
6100,10/15/2020,10/15/2020,101520,82L-IMPORT PAYROLL-RANDOLPH ALEXANDER,D111,HJ,1875,,1789502.7
6100,10/15/2020,10/15/2020,101520,82L-IMPORT PAYROLL-RUBI PERLA,D101,HJ,1250,,1790752.7
6100,10/15/2020,10/15/2020,101520,82L-IMPORT PAYROLL-SAFRAN ALAN P,D107,HJ,676.52,,1791429.22
6100,10/15/2020,10/15/2020,101520,82L-IMPORT PAYROLL-SAFRAN ALAN P,D107,HJ,6840.36,,1798269.58
6100,10/15/2020,10/15/2020,101520,82L-IMPORT PAYROLL-SHENKMAN OLIVIA,D101,HJ,2000,,1800269.58
6100,10/15/2020,10/15/2020,101520,82L-IMPORT PAYROLL-SHI GRACE,D103,HJ,875,,1801144.58
6100,10/15/2020,10/15/2020,101520,82L-IMPORT PAYROLL-WALLACE AMENA,D104,HJ,2187.5,,1803332.08
6100,10/15/2020,10/15/2020,101520,82L-IMPORT PAYROLL-WEINSTOCK EMILY,D101,HJ,2833.33,,1806165.41
6100,10/15/2020,10/15/2020,101520,82L-IMPORT PAYROLL-WINANS JENNIFER,D111,HJ,2505.63,,1808671.04
6100,10/15/2020,10/15/2020,101520,82L-IMPORT PAYROLL-ZARATE JOSEPH M,D105,HJ,2150,,1810821.04
6100,10/15/2020,10/15/2020,101520,82L-IMPORT PAYROLL-AGUANNO JOSEPH,D108,HJ,1119.05,,1811940.09
6100,10/15/2020,10/15/2020,101520,82L-IMPORT PAYROLL-AKESODE FEHINTOLA,D108,HJ,1119.05,,1813059.14
6100,10/15/2020,10/15/2020,101520,82L-IMPORT PAYROLL-BARTOLD DEANNA MARIE,D108,HJ,3034.5,,1816093.64
6100,10/15/2020,10/15/2020,101520,82L-IMPORT PAYROLL-BELLOT GENESIS,D108,HJ,2500,,1818593.64
6100,10/15/2020,10/15/2020,101520,82L-IMPORT PAYROLL-BENNETT JAMES H,D108,HJ,1119.05,,1819712.69
6100,10/15/2020,10/15/2020,101520,82L-IMPORT PAYROLL-BOWMAN ABIGAIL,D108,HJ,1119.05,,1820831.74
6100,10/15/2020,10/15/2020,101520,82L-IMPORT PAYROLL-BURRELL RUSSELL,D108,HJ,1119.05,,1821950.79
6100,10/15/2020,10/15/2020,101520,82L-IMPORT PAYROLL-CHUI KENT,D108,HJ,1119.05,,1823069.84
6100,10/15/2020,10/15/2020,101520,82L-IMPORT PAYROLL-CIRKER MIA,D108,HJ,2250,,1825319.84
6100,10/15/2020,10/15/2020,101520,82L-IMPORT PAYROLL-DEWS CAMERYN,D108,HJ,2926.68,,1828246.52
6100,10/15/2020,10/15/2020,101520,82L-IMPORT PAYROLL-DIETZ MARY,D108,HJ,1119.05,,1829365.57
6100,10/15/2020,10/15/2020,101520,82L-IMPORT PAYROLL-DOMINIQUE PRINCESSA,D108,HJ,1119.05,,1830484.62
6100,10/15/2020,10/15/2020,101520,82L-IMPORT PAYROLL-DONNELLY HOME,D108,HJ,1119.05,,1831603.67
6100,10/15/2020,10/15/2020,101520,82L-IMPORT PAYROLL-FEIGHERY JOHN,D108,HJ,2250,,1833853.67
6100,10/15/2020,10/15/2020,101520,82L-IMPORT PAYROLL-FORTH KYLE,D108,HJ,1119.05,,1834972.72
6100,10/15/2020,10/15/2020,101520,82L-IMPORT PAYROLL-GARCIA MARILYN,D108,HJ,2291.67,,1837264.39
6100,10/15/2020,10/15/2020,101520,82L-IMPORT PAYROLL-GREENE BROOKE,D108,HJ,1119.05,,1838383.44
6100,10/15/2020,10/15/2020,101520,82L-IMPORT PAYROLL-GRIFFIN ANDREW,D108,HJ,2250,,1840633.44
6100,10/15/2020,10/15/2020,101520,82L-IMPORT PAYROLL-GROSS EMILY,D108,HJ,1119.05,,1841752.49
6100,10/15/2020,10/15/2020,101520,82L-IMPORT PAYROLL-GUERRERO LUIS,D108,HJ,1119.05,,1842871.54
6100,10/15/2020,10/15/2020,101520,82L-IMPORT PAYROLL-HALLINAN GABRIEL B,D108,HJ,2550,,1845421.54
6100,10/15/2020,10/15/2020,101520,82L-IMPORT PAYROLL-HAMERSLY WILLIAM,D108,HJ,2500,,1847921.54
6100,10/15/2020,10/15/2020,101520,82L-IMPORT PAYROLL-HOLDER LATIVA M,D108,HJ,3812.5,,1851734.04
6100,10/15/2020,10/15/2020,101520,82L-IMPORT PAYROLL-HOSSAIN MYESHA R,D108,HJ,2437.5,,1854171.54
6100,10/15/2020,10/15/2020,101520,82L-IMPORT PAYROLL-JACKSON TASNIM,D108,HJ,2291.67,,1856463.21
6100,10/15/2020,10/15/2020,101520,82L-IMPORT PAYROLL-KERKHOFF HARPER FAITH,D108,HJ,1119.05,,1857582.26
6100,10/15/2020,10/15/2020,101520,82L-IMPORT PAYROLL-LEARY AUBREY,D108,HJ,1119.05,,1858701.31
6100,10/15/2020,10/15/2020,101520,82L-IMPORT PAYROLL-LI BELLA,D108,HJ,2486.25,,1861187.56
6100,10/15/2020,10/15/2020,101520,82L-IMPORT PAYROLL-LOUIE JORDAN,D108,HJ,1119.05,,1862306.61
6100,10/15/2020,10/15/2020,101520,82L-IMPORT PAYROLL-MELCHOR OSBEIDY,D108,HJ,1119.05,,1863425.66
6100,10/15/2020,10/15/2020,101520,82L-IMPORT PAYROLL-MITTLEMAN ROBERT,D108,HJ,1119.05,,1864544.71
6100,10/15/2020,10/15/2020,101520,82L-IMPORT PAYROLL-MORRIS ZAKIYA,D108,HJ,1119.05,,1865663.76
6100,10/15/2020,10/15/2020,101520,82L-IMPORT PAYROLL-MORSELETTO RAFAEL,D108,HJ,723.05,,1866386.81
6100,10/15/2020,10/15/2020,101520,82L-IMPORT PAYROLL-OBI TOBECHUKWU,D108,HJ,1119.05,,1867505.86
6100,10/15/2020,10/15/2020,101520,82L-IMPORT PAYROLL-OPUH NDIDI,D108,HJ,2833,,1870338.86
6100,10/15/2020,10/15/2020,101520,82L-IMPORT PAYROLL-PAULINO THAIRI,D108,HJ,1119.05,,1871457.91
6100,10/15/2020,10/15/2020,101520,82L-IMPORT PAYROLL-ROSENBAUM MURRAY,D108,HJ,1119.05,,1872576.96
6100,10/15/2020,10/15/2020,101520,82L-IMPORT PAYROLL-SCHWETTMANN CLAIRE,D108,HJ,1119.05,,1873696.01
6100,10/15/2020,10/15/2020,101520,82L-IMPORT PAYROLL-SOBELMAN JUSTIN,D108,HJ,1119.05,,1874815.06
6100,10/15/2020,10/15/2020,101520,82L-IMPORT PAYROLL-TERRENCE-SMITH ZIHIR UNIQUE,D108,HJ,1119.05,,1875934.11
6100,10/15/2020,10/15/2020,101520,82L-IMPORT PAYROLL-TILLERY ASIA,D108,HJ,3291.67,,1879225.78
6100,10/15/2020,10/15/2020,101520,82L-IMPORT PAYROLL-WILLIAMS- MASSEY BRIANNA M,D108,HJ,1119.05,,1880344.83
6100,10/15/2020,10/15/2020,101520,82L-IMPORT PAYROLL-XIAO CHENGYAO,D108,HJ,1119.05,,1881463.88
6100,10/15/2020,10/15/2020,101520,82L-IMPORT PAYROLL-ZIAUDDIN ABUTAHER M,D108,HJ,1119.05,,1882582.93
6100,10/15/2020,10/15/2020,101520,82L-IMPORT PAYROLL-BALASUBRAMANIAN SHARANYA,D108,HJ,2666.67,,1885249.6
6100,10/15/2020,10/15/2020,101520,82L-IMPORT PAYROLL-COVENEY ALLISON,D108,HJ,2854.17,,1888103.77
6100,10/15/2020,10/15/2020,101520,82L-IMPORT PAYROLL-JACKSON CLAICE,D108,HJ,3125,,1891228.77
6100,10/15/2020,10/15/2020,101520,82L-IMPORT PAYROLL-JANG DANIEL,D108,HJ,2750,,1893978.77
6100,10/15/2020,10/15/2020,101520,82L-IMPORT PAYROLL-LENEGHAN MARYELLEN,D108,HJ,940.71,,1894919.48
6100,10/15/2020,10/15/2020,101520,82L-IMPORT PAYROLL-LENEGHAN MARYELLEN,D108,HJ,1715.63,,1896635.11
6100,10/15/2020,10/15/2020,101520,82L-IMPORT PAYROLL-LENEGHAN MARYELLEN,D108,HJ,2096.87,,1898731.98
6100,10/30/2020,10/30/2020,103120,82L-IMPORT PAYROLL-ALWARDT CALEB,D108,HJ,290.1,,1899022.08
6100,10/30/2020,10/30/2020,103120,82L-IMPORT PAYROLL-BARTHELEMY RACHALIE,D108,HJ,1047.62,,1900069.7
6100,10/30/2020,10/30/2020,103120,82L-IMPORT PAYROLL-BASHAM WILLIAM EDWARD,D108,HJ,1047.62,,1901117.32
6100,10/30/2020,10/30/2020,103120,82L-IMPORT PAYROLL-BOHLSEN GRACE ISABELLE,D108,HJ,1047.62,,1902164.94
6100,10/30/2020,10/30/2020,103120,82L-IMPORT PAYROLL-BOLIVAR ANDREA,D108,HJ,2500,,1904664.94
6100,10/30/2020,10/30/2020,103120,82L-IMPORT PAYROLL-BORCHART SPENCER,D108,HJ,1047.62,,1905712.56
6100,10/30/2020,10/30/2020,103120,82L-IMPORT PAYROLL-BROWN ISAAC,D108,HJ,1047.62,,1906760.18
6100,10/30/2020,10/30/2020,103120,82L-IMPORT PAYROLL-BURKE MARIAH,D108,HJ,1047.62,,1907807.8
6100,10/30/2020,10/30/2020,103120,82L-IMPORT PAYROLL-CASSADY JOSHUA LEWIS,D108,HJ,1047.62,,1908855.42
6100,10/30/2020,10/30/2020,103120,82L-IMPORT PAYROLL-DARKO OLIVIA,D108,HJ,1047.62,,1909903.04
6100,10/30/2020,10/30/2020,103120,82L-IMPORT PAYROLL-DAWSON JAMIL NAFAYE-BEYAH,D108,HJ,1047.62,,1910950.66
6100,10/30/2020,10/30/2020,103120,82L-IMPORT PAYROLL-ESCAMILLA OLGA,D108,HJ,1047.62,,1911998.28
6100,10/30/2020,10/30/2020,103120,82L-IMPORT PAYROLL-GARCIA SANTIAGO,D108,HJ,2042,,1914040.28
6100,10/30/2020,10/30/2020,103120,82L-IMPORT PAYROLL-GILES SHAYLA,D108,HJ,1047.62,,1915087.9
6100,10/30/2020,10/30/2020,103120,82L-IMPORT PAYROLL-IKUNIKA FUNMILAYO,D108,HJ,2083,,1917170.9
6100,10/30/2020,10/30/2020,103120,82L-IMPORT PAYROLL-JONES JORDAN,D108,HJ,1047.62,,1918218.52
6100,10/30/2020,10/30/2020,103120,82L-IMPORT PAYROLL-KHAN HUDA,D108,HJ,1047.62,,1919266.14
6100,10/30/2020,10/30/2020,103120,82L-IMPORT PAYROLL-KLOHR TIMOTHY JORDAN,D108,HJ,2000,,1921266.14
6100,10/30/2020,10/30/2020,103120,82L-IMPORT PAYROLL-KNOWLIN ZYLIA,D108,HJ,2542,,1923808.14
6100,10/30/2020,10/30/2020,103120,82L-IMPORT PAYROLL-KOPSHEVER MELISSA,D108,HJ,2916.67,,1926724.81
6100,10/30/2020,10/30/2020,103120,82L-IMPORT PAYROLL-LI SEN YUAN,D108,HJ,1047.62,,1927772.43
6100,10/30/2020,10/30/2020,103120,82L-IMPORT PAYROLL-LIPSCOMB STEPHEN,D108,HJ,2541.67,,1930314.1
6100,10/30/2020,10/30/2020,103120,82L-IMPORT PAYROLL-MALLECK JESSICA R,D108,HJ,1047.62,,1931361.72
6100,10/30/2020,10/30/2020,103120,82L-IMPORT PAYROLL-MCLAUGHLIN MARA,D108,HJ,1047.62,,1932409.34
6100,10/30/2020,10/30/2020,103120,82L-IMPORT PAYROLL-MEJIA ROSO CARLOS,D108,HJ,1047.62,,1933456.96
6100,10/30/2020,10/30/2020,103120,82L-IMPORT PAYROLL-MONROY-MEJIA JASON,D108,HJ,1047.62,,1934504.58
6100,10/30/2020,10/30/2020,103120,82L-IMPORT PAYROLL-O'FLYNN-PRUITT NATHAN COLYAR,D108,HJ,1047.62,,1935552.2
6100,10/30/2020,10/30/2020,103120,82L-IMPORT PAYROLL-PATTERSON STEVE,D108,HJ,1047.62,,1936599.82
6100,10/30/2020,10/30/2020,103120,82L-IMPORT PAYROLL-SCHMIESS RACHEL JOY,D108,HJ,1047.62,,1937647.44
6100,10/30/2020,10/30/2020,103120,82L-IMPORT PAYROLL-SCOTT KIRK DONOVAN,D108,HJ,1047.62,,1938695.06
6100,10/30/2020,10/30/2020,103120,82L-IMPORT PAYROLL-SILVER KELLY,D108,HJ,2541.67,,1941236.73
6100,10/30/2020,10/30/2020,103120,82L-IMPORT PAYROLL-SOLIMAN MARK,D108,HJ,1047.62,,1942284.35
6100,10/30/2020,10/30/2020,103120,82L-IMPORT PAYROLL-STEIN KYLE,D108,HJ,2083,,1944367.35
6100,10/30/2020,10/30/2020,103120,82L-IMPORT PAYROLL-STROUD DAVID,D108,HJ,1047.62,,1945414.97
6100,10/30/2020,10/30/2020,103120,82L-IMPORT PAYROLL-VALCIN SABRINA JEMIMAH,D108,HJ,1047.62,,1946462.59
6100,10/30/2020,10/30/2020,103120,82L-IMPORT PAYROLL-VALDES ERNEST L,D108,HJ,1047.62,,1947510.21
6100,10/30/2020,10/30/2020,103120,82L-IMPORT PAYROLL-WILLIAMS MACK ANTHONY,D108,HJ,1047.62,,1948557.83
6100,10/30/2020,10/30/2020,103120,82L-IMPORT PAYROLL-WILLIAMS MIL'YONTA,D108,HJ,1047.62,,1949605.45
6100,10/30/2020,10/30/2020,103120,82L-IMPORT PAYROLL-ANTHONY BETTY S,D108,HJ,2886.52,,1952491.97
6100,10/30/2020,10/30/2020,103120,82L-IMPORT PAYROLL-APULI LINDSAY,D108,HJ,2500,,1954991.97
6100,10/30/2020,10/30/2020,103120,82L-IMPORT PAYROLL-AUSTIN PERCY ANTONIO,D108,HJ,2653.02,,1957644.99
6100,10/30/2020,10/30/2020,103120,82L-IMPORT PAYROLL-BUHMANN JAY,D108,HJ,2271,,1959915.99
6100,10/30/2020,10/30/2020,103120,82L-IMPORT PAYROLL-CAIN CORY,D108,HJ,2500,,1962415.99
6100,10/30/2020,10/30/2020,103120,82L-IMPORT PAYROLL-CHAPMAN CLAUDY EARL,D108,HJ,1833.33,,1964249.32
6100,10/30/2020,10/30/2020,103120,82L-IMPORT PAYROLL-DADA ARIKPO E,D108,HJ,2720,,1966969.32
6100,10/30/2020,10/30/2020,103120,82L-IMPORT PAYROLL-GUTHRIE LESLIE,D108,HJ,2458.33,,1969427.65
6100,10/30/2020,10/30/2020,103120,82L-IMPORT PAYROLL-HOLMES JOREL ALEXANDER,D108,HJ,2329,,1971756.65
6100,10/30/2020,10/30/2020,103120,82L-IMPORT PAYROLL-JORDAN TIFFANY T,D108,HJ,3445,,1975201.65
6100,10/30/2020,10/30/2020,103120,82L-IMPORT PAYROLL-LANIGAN LISA A,D108,HJ,3113.75,,1978315.4
6100,10/30/2020,10/30/2020,103120,82L-IMPORT PAYROLL-MCELWEE MELISSA,D108,HJ,2666.67,,1980982.07
6100,10/30/2020,10/30/2020,103120,82L-IMPORT PAYROLL-MCNICHOLAS MARY,D108,HJ,2291.67,,1983273.74
6100,10/30/2020,10/30/2020,103120,82L-IMPORT PAYROLL-NWAKANMA NANCY,D108,HJ,3046.67,,1986320.41
6100,10/30/2020,10/30/2020,103120,82L-IMPORT PAYROLL-ONICA ANTHONY J,D108,HJ,2416.67,,1988737.08
6100,10/30/2020,10/30/2020,103120,82L-IMPORT PAYROLL-PRAHIN NICOLE M,D108,HJ,1029.38,,1989766.46
6100,10/30/2020,10/30/2020,103120,82L-IMPORT PAYROLL-PRAHIN NICOLE M,D108,HJ,2783.12,,1992549.58
6100,10/30/2020,10/30/2020,103120,82L-IMPORT PAYROLL-RIVERS QUIONNA DIANE,D108,HJ,2708.34,,1995257.92
6100,10/30/2020,10/30/2020,103120,82L-IMPORT PAYROLL-SALIM YASSER,D108,HJ,2431.94,,1997689.86
6100,10/30/2020,10/30/2020,103120,82L-IMPORT PAYROLL-SEJOUR MAHALIAH,D108,HJ,2500,,2000189.86
6100,10/30/2020,10/30/2020,103120,82L-IMPORT PAYROLL-SKALSKI CHRISTOPHER,D108,HJ,2465,,2002654.86
6100,10/30/2020,10/30/2020,103120,82L-IMPORT PAYROLL-TUMENJARGAL ENKHJIN,D108,HJ,2414,,2005068.86
6100,10/30/2020,10/30/2020,103120,82L-IMPORT PAYROLL-VILLEGAS EVELYN,D108,HJ,2817.75,,2007886.61
6100,10/30/2020,10/30/2020,103120,82L-IMPORT PAYROLL-WOLF ANNA A,D108,HJ,2635,,2010521.61
6100,10/30/2020,10/30/2020,103120,82L-IMPORT PAYROLL-ACEVEDO MONIVETT,D107,HJ,977.27,,2011498.88
6100,10/30/2020,10/30/2020,103120,82L-IMPORT PAYROLL-ACEVEDO MONIVETT,D107,HJ,4397.73,,2015896.61
6100,10/30/2020,10/30/2020,103120,82L-IMPORT PAYROLL-AKLESTAD ISABEL,D111,HJ,1750,,2017646.61
6100,10/30/2020,10/30/2020,103120,82L-IMPORT PAYROLL-ALLEN KIMBERLY MARY,D111,HJ,1833.33,,2019479.94
6100,10/30/2020,10/30/2020,103120,82L-IMPORT PAYROLL-BIBB TIFFANI,D104,HJ,1046.25,,2020526.19
6100,10/30/2020,10/30/2020,103120,82L-IMPORT PAYROLL-BIBB TIFFANI,D104,HJ,2828.75,,2023354.94
6100,10/30/2020,10/30/2020,103120,82L-IMPORT PAYROLL-BOWMAN HALLEY K,D101,HJ,2815.99,,2026170.93
6100,10/30/2020,10/30/2020,103120,82L-IMPORT PAYROLL-COOK CATHRYN ANNA,D105,HJ,3593.03,,2029763.96
6100,10/30/2020,10/30/2020,103120,82L-IMPORT PAYROLL-COOPER ASHLEE R,D101,HJ,2461.88,,2032225.84
6100,10/30/2020,10/30/2020,103120,82L-IMPORT PAYROLL-CORTEZ MIRANDA A,D111,HJ,2672.72,,2034898.56
6100,10/30/2020,10/30/2020,103120,82L-IMPORT PAYROLL-DAUGHERTY DEVIN W,D101,HJ,1041.67,,2035940.23
6100,10/30/2020,10/30/2020,103120,82L-IMPORT PAYROLL-DETONE KYRA MAYA,D102,HJ,58.33,,2035998.56
6100,10/30/2020,10/30/2020,103120,82L-IMPORT PAYROLL-DETONE KYRA MAYA,D102,HJ,2858.34,,2038856.9
6100,10/30/2020,10/30/2020,103120,82L-IMPORT PAYROLL-DUPUIS CHRISTOPHER M,D107,HJ,2947.29,,2041804.19
6100,10/30/2020,10/30/2020,103120,82L-IMPORT PAYROLL-DUPUIS CHRISTOPHER M,D107,HJ,3323.54,,2045127.73
6100,10/30/2020,10/30/2020,103120,82L-IMPORT PAYROLL-DZIEDZIC JULIE K,D101,HJ,1250,,2046377.73
6100,10/30/2020,10/30/2020,103120,82L-IMPORT PAYROLL-FISCHABER THOMAS,D109,HJ,5417,,2051794.73
6100,10/30/2020,10/30/2020,103120,82L-IMPORT PAYROLL-FISCHABER THOMAS,D109,HJ,10000,,2061794.73
6100,10/30/2020,10/30/2020,103120,82L-IMPORT PAYROLL-FLORY MEGAN,D109,HJ,1500,,2063294.73
6100,10/30/2020,10/30/2020,103120,82L-IMPORT PAYROLL-GORNSTEIN STEVEN,D101,HJ,2708.33,,2066003.06
6100,10/30/2020,10/30/2020,103120,82L-IMPORT PAYROLL-GUADARRAMA-ALVAREZ URIEL A,D105,HJ,2897.92,,2068900.98
6100,10/30/2020,10/30/2020,103120,82L-IMPORT PAYROLL-GUTIERREZ ANTONIO J,D107,HJ,1989.77,,2070890.75
6100,10/30/2020,10/30/2020,103120,82L-IMPORT PAYROLL-GUTIERREZ ANTONIO J,D107,HJ,3537.36,,2074428.11
6100,10/30/2020,10/30/2020,103120,82L-IMPORT PAYROLL-HENRY GILLIAN,D102,HJ,2083.34,,2076511.45
6100,10/30/2020,10/30/2020,103120,82L-IMPORT PAYROLL-HERMAN ADAM,D102,HJ,1958.33,,2078469.78
6100,10/30/2020,10/30/2020,103120,82L-IMPORT PAYROLL-HESTER TYLER CONRAD,D105,HJ,1916.67,,2080386.45
6100,10/30/2020,10/30/2020,103120,82L-IMPORT PAYROLL-HOLT ADAM,D109,HJ,4167,,2084553.45
6100,10/30/2020,10/30/2020,103120,82L-IMPORT PAYROLL-KELLY SEAN,D109,HJ,5417,,2089970.45
6100,10/30/2020,10/30/2020,103120,82L-IMPORT PAYROLL-KELLY SEAN,D109,HJ,10000,,2099970.45
6100,10/30/2020,10/30/2020,103120,82L-IMPORT PAYROLL-KRUGER MARK,D109,HJ,5000,,2104970.45
6100,10/30/2020,10/30/2020,103120,82L-IMPORT PAYROLL-LIPORACE HERNAN LUIS,D103,HJ,2291.67,,2107262.12
6100,10/30/2020,10/30/2020,103120,82L-IMPORT PAYROLL-MARKS KRISTA,D109,HJ,5417,,2112679.12
6100,10/30/2020,10/30/2020,103120,82L-IMPORT PAYROLL-MASON ANGELA,D107,HJ,1541.95,,2114221.07
6100,10/30/2020,10/30/2020,103120,82L-IMPORT PAYROLL-MASON ANGELA,D107,HJ,4168.99,,2118390.06
6100,10/30/2020,10/30/2020,103120,82L-IMPORT PAYROLL-MILNE ROGER,D109,HJ,5417,,2123807.06
6100,10/30/2020,10/30/2020,103120,82L-IMPORT PAYROLL-MILNE ROGER,D109,HJ,10000,,2133807.06
6100,10/30/2020,10/30/2020,103120,82L-IMPORT PAYROLL-MOSTAFAVI YASAMAN,D109,HJ,528,,2134335.06
6100,10/30/2020,10/30/2020,103120,82L-IMPORT PAYROLL-O'DONNELL STEPHEN,D104,HJ,2707.5,,2137042.56
6100,10/30/2020,10/30/2020,103120,82L-IMPORT PAYROLL-PARETS MALLORY GRACE,D101,HJ,2833.33,,2139875.89
6100,10/30/2020,10/30/2020,103120,82L-IMPORT PAYROLL-PARHAM-GANTT DENISE M,D112,HJ,3041.67,,2142917.56
6100,10/30/2020,10/30/2020,103120,82L-IMPORT PAYROLL-PEINADO ELIZABETH R,D111,HJ,3749.96,,2146667.52
6100,10/30/2020,10/30/2020,103120,82L-IMPORT PAYROLL-PERNIA JEFFREY,D109,HJ,3875,,2150542.52
6100,10/30/2020,10/30/2020,103120,82L-IMPORT PAYROLL-POLANCO ODALIS,D103,HJ,3124.96,,2153667.48
6100,10/30/2020,10/30/2020,103120,82L-IMPORT PAYROLL-QUINTAS JASHIVE,D105,HJ,1916.67,,2155584.15
6100,10/30/2020,10/30/2020,103120,82L-IMPORT PAYROLL-RANDOLPH ALEXANDER,D111,HJ,1875,,2157459.15
6100,10/30/2020,10/30/2020,103120,82L-IMPORT PAYROLL-RUBI PERLA,D101,HJ,1250,,2158709.15
6100,10/30/2020,10/30/2020,103120,82L-IMPORT PAYROLL-SAFRAN ALAN P,D107,HJ,676.51,,2159385.66
6100,10/30/2020,10/30/2020,103120,82L-IMPORT PAYROLL-SAFRAN ALAN P,D107,HJ,6840.35,,2166226.01
6100,10/30/2020,10/30/2020,103120,82L-IMPORT PAYROLL-SHENKMAN OLIVIA,D101,HJ,2000,,2168226.01
6100,10/30/2020,10/30/2020,103120,82L-IMPORT PAYROLL-SHI GRACE,D103,HJ,875,,2169101.01
6100,10/30/2020,10/30/2020,103120,82L-IMPORT PAYROLL-WALLACE AMENA,D104,HJ,2187.5,,2171288.51
6100,10/30/2020,10/30/2020,103120,82L-IMPORT PAYROLL-WARD JEFFREY,D109,HJ,5417,,2176705.51
6100,10/30/2020,10/30/2020,103120,82L-IMPORT PAYROLL-WARD JEFFREY,D109,HJ,10000,,2186705.51
6100,10/30/2020,10/30/2020,103120,82L-IMPORT PAYROLL-WARD JENNIFER,D109,HJ,926.91,,2187632.42
6100,10/30/2020,10/30/2020,103120,82L-IMPORT PAYROLL-WEINSTOCK EMILY,D101,HJ,2833.33,,2190465.75
6100,10/30/2020,10/30/2020,103120,82L-IMPORT PAYROLL-WINANS JENNIFER,D111,HJ,2505.63,,2192971.38
6100,10/30/2020,10/30/2020,103120,82L-IMPORT PAYROLL-ZARATE JOSEPH M,D105,HJ,2150,,2195121.38
6100,10/30/2020,10/30/2020,103120,82L-IMPORT PAYROLL-AGUANNO JOSEPH,D108,HJ,1119.05,,2196240.43
6100,10/30/2020,10/30/2020,103120,82L-IMPORT PAYROLL-AKESODE FEHINTOLA,D108,HJ,1119.05,,2197359.48
6100,10/30/2020,10/30/2020,103120,82L-IMPORT PAYROLL-BARTOLD DEANNA MARIE,D108,HJ,3034.5,,2200393.98
6100,10/30/2020,10/30/2020,103120,82L-IMPORT PAYROLL-BELLOT GENESIS,D108,HJ,2500,,2202893.98
6100,10/30/2020,10/30/2020,103120,82L-IMPORT PAYROLL-BENNETT JAMES H,D108,HJ,1119.05,,2204013.03
6100,10/30/2020,10/30/2020,103120,82L-IMPORT PAYROLL-BOWMAN ABIGAIL,D108,HJ,1119.05,,2205132.08
6100,10/30/2020,10/30/2020,103120,82L-IMPORT PAYROLL-BURRELL RUSSELL,D108,HJ,1119.05,,2206251.13
6100,10/30/2020,10/30/2020,103120,82L-IMPORT PAYROLL-CHUI KENT,D108,HJ,1119.05,,2207370.18
6100,10/30/2020,10/30/2020,103120,82L-IMPORT PAYROLL-CIRKER MIA,D108,HJ,2250,,2209620.18
6100,10/30/2020,10/30/2020,103120,82L-IMPORT PAYROLL-DEWS CAMERYN,D108,HJ,2292,,2211912.18
6100,10/30/2020,10/30/2020,103120,82L-IMPORT PAYROLL-DIETZ MARY,D108,HJ,1119.05,,2213031.23
6100,10/30/2020,10/30/2020,103120,82L-IMPORT PAYROLL-DOMINIQUE PRINCESSA,D108,HJ,1119.05,,2214150.28
6100,10/30/2020,10/30/2020,103120,82L-IMPORT PAYROLL-DONNELLY MARCUS,D108,HJ,1119.05,,2215269.33
6100,10/30/2020,10/30/2020,103120,82L-IMPORT PAYROLL-FEIGHERY JOHN,D108,HJ,2250,,2217519.33
6100,10/30/2020,10/30/2020,103120,82L-IMPORT PAYROLL-FORTH KYLE,D108,HJ,1119.05,,2218638.38
6100,10/30/2020,10/30/2020,103120,82L-IMPORT PAYROLL-GARCIA MARILYN,D108,HJ,2291.67,,2220930.05
6100,10/30/2020,10/30/2020,103120,82L-IMPORT PAYROLL-GREENE BROOKE,D108,HJ,1119.05,,2222049.1
6100,10/30/2020,10/30/2020,103120,82L-IMPORT PAYROLL-GRIFFIN ANDREW,D108,HJ,2250,,2224299.1
6100,10/30/2020,10/30/2020,103120,82L-IMPORT PAYROLL-GROSS EMILY,D108,HJ,1119.05,,2225418.15
6100,10/30/2020,10/30/2020,103120,82L-IMPORT PAYROLL-GUERRERO LUIS,D108,HJ,1119.05,,2226537.2
6100,10/30/2020,10/30/2020,103120,82L-IMPORT PAYROLL-HALLINAN GABRIEL,D108,HJ,2550,,2229087.2
6100,10/30/2020,10/30/2020,103120,82L-IMPORT PAYROLL-HAMERSLY WILLIAM,D108,HJ,2500,,2231587.2
6100,10/30/2020,10/30/2020,103120,82L-IMPORT PAYROLL-HOLDER LATIVA M,D108,HJ,3812.5,,2235399.7
6100,10/30/2020,10/30/2020,103120,82L-IMPORT PAYROLL-HOSSAIN MYESHA,D108,HJ,2437.5,,2237837.2
6100,10/30/2020,10/30/2020,103120,82L-IMPORT PAYROLL-JACKSON TASNIM F,D108,HJ,2291.67,,2240128.87
6100,10/30/2020,10/30/2020,103120,82L-IMPORT PAYROLL-KERKHOFF HARPER FAITH,D108,HJ,1119.05,,2241247.92
6100,10/30/2020,10/30/2020,103120,82L-IMPORT PAYROLL-LEARY AUBREY,D108,HJ,1119.05,,2242366.97
6100,10/30/2020,10/30/2020,103120,82L-IMPORT PAYROLL-LI BELLA,D108,HJ,2486.25,,2244853.22
6100,10/30/2020,10/30/2020,103120,82L-IMPORT PAYROLL-LOUIE JORDAN,D108,HJ,1119.05,,2245972.27
6100,10/30/2020,10/30/2020,103120,82L-IMPORT PAYROLL-MELCHOR OSBEIDY,D108,HJ,1119.05,,2247091.32
6100,10/30/2020,10/30/2020,103120,82L-IMPORT PAYROLL-MITTLEMAN ROBERT,D108,HJ,929.64,,2248020.96
6100,10/30/2020,10/30/2020,103120,82L-IMPORT PAYROLL-MORRIS ZAKIYA,D108,HJ,1119.05,,2249140.01
6100,10/30/2020,10/30/2020,103120,82L-IMPORT PAYROLL-MORSELETTO RAFAEL,D108,HJ,1119.05,,2250259.06
6100,10/30/2020,10/30/2020,103120,82L-IMPORT PAYROLL-OBI TOBECHUKWU,D108,HJ,1119.05,,2251378.11
6100,10/30/2020,10/30/2020,103120,82L-IMPORT PAYROLL-OPUH NDIDI,D108,HJ,2833,,2254211.11
6100,10/30/2020,10/30/2020,103120,82L-IMPORT PAYROLL-PAULINO THAIRI,D108,HJ,1119.05,,2255330.16
6100,10/30/2020,10/30/2020,103120,82L-IMPORT PAYROLL-ROSENBAUM MURRAY,D108,HJ,1119.05,,2256449.21
6100,10/30/2020,10/30/2020,103120,82L-IMPORT PAYROLL-SCHWETTMANN CLAIRE,D108,HJ,1119.05,,2257568.26
6100,10/30/2020,10/30/2020,103120,82L-IMPORT PAYROLL-SOBELMAN JUSTIN,D108,HJ,1119.05,,2258687.31
6100,10/30/2020,10/30/2020,103120,82L-IMPORT PAYROLL-TERRENCE-SMITH ZIHIR,D108,HJ,1119.05,,2259806.36
6100,10/30/2020,10/30/2020,103120,82L-IMPORT PAYROLL-TILLERY ASIA,D108,HJ,3291.67,,2263098.03
6100,10/30/2020,10/30/2020,103120,82L-IMPORT PAYROLL-WILLIAMS-MASSEY BRIANNA,D108,HJ,1119.05,,2264217.08
6100,10/30/2020,10/30/2020,103120,82L-IMPORT PAYROLL-XIAO CHENGYAO,D108,HJ,1119.05,,2265336.13
6100,10/30/2020,10/30/2020,103120,82L-IMPORT PAYROLL-ZIAUDDIN ABUTAHER,D108,HJ,1119.05,,2266455.18
6100,10/30/2020,10/30/2020,103120,82L-IMPORT PAYROLL-BALASUBRAMANIAN SHARANYA,D108,HJ,2666.67,,2269121.85
6100,10/30/2020,10/30/2020,103120,82L-IMPORT PAYROLL-COVENEY ALLISON,D108,HJ,2854.17,,2271976.02
6100,10/30/2020,10/30/2020,103120,82L-IMPORT PAYROLL-JACKSON CLAICE M,D108,HJ,3125,,2275101.02
6100,10/30/2020,10/30/2020,103120,82L-IMPORT PAYROLL-JANG DANIEL,D108,HJ,2750,,2277851.02
6100,10/30/2020,10/30/2020,103120,82L-IMPORT PAYROLL-LENEGHAN MARYELLEN,D108,HJ,940.71,,2278791.73
6100,10/30/2020,10/30/2020,103120,82L-IMPORT PAYROLL-LENEGHAN MARYELLEN,D108,HJ,1448.75,,2280240.48
6100,10/30/2020,10/30/2020,103120,82L-IMPORT PAYROLL-LENEGHAN MARYELLEN,D108,HJ,2363.75,,2282604.23
6100,10/31/2020,10/31/2020,202010,Adj to reallocate Salaries FICA and benefits from GM3 - ACY2 to G-BL-To reallocate Amena Wallance from GM3 - ACY2 to G-BL,D104,HJ,,4375,2278229.23
6100,10/31/2020,10/31/2020,202010,Adj to reallocate Salaries FICA and benefits from GM3 - ACY2 to G-BL-To reallocate Amena Wallance from GM3 - ACY2 to G-BL,D104,HJ,4375,,2282604.23
6100,10/31/2020,10/31/2020,202010,Adj to reallocate Salaries FICA and benefits from GM3 - ACY2 to G-BL-To reallocate J.Messing and T.Bibb salary from GM3 - ACY2 to G-BL,D104,HJ,,7750,2274854.23
6100,10/31/2020,10/31/2020,202010,Adj to reallocate Salaries FICA and benefits from GM3 - ACY2 to G-BL-To reallocate J.Messing and T.Bibb salary from GM3 - ACY2 to G-BL,D104,HJ,7750,,2282604.23
6100,11/13/2020,11/13/2020,111320,82L-IMPORT PAYROLL-BARTHELEMY RACHALIE,D108,HJ,1047.62,,2283651.85
6100,11/13/2020,11/13/2020,111320,82L-IMPORT PAYROLL-BASHAM WILLIAM EDWARD,D108,HJ,1047.62,,2284699.47
6100,11/13/2020,11/13/2020,111320,82L-IMPORT PAYROLL-BOHLSEN GRACE ISABELLE,D108,HJ,1047.62,,2285747.09
6100,11/13/2020,11/13/2020,111320,82L-IMPORT PAYROLL-BOLIVAR ANDREA,D108,HJ,2500,,2288247.09
6100,11/13/2020,11/13/2020,111320,82L-IMPORT PAYROLL-BORCHART SPENCER,D108,HJ,1047.62,,2289294.71
6100,11/13/2020,11/13/2020,111320,82L-IMPORT PAYROLL-BROWN ISAAC,D108,HJ,1047.62,,2290342.33
6100,11/13/2020,11/13/2020,111320,82L-IMPORT PAYROLL-BURKE MARIAH,D108,HJ,1047.62,,2291389.95
6100,11/13/2020,11/13/2020,111320,82L-IMPORT PAYROLL-CASSADY JOSHUA LEWIS,D108,HJ,1047.62,,2292437.57
6100,11/13/2020,11/13/2020,111320,82L-IMPORT PAYROLL-DARKO OLIVIA,D108,HJ,1047.62,,2293485.19
6100,11/13/2020,11/13/2020,111320,82L-IMPORT PAYROLL-DAWSON JAMIL NAFAYE-BEYAH,D108,HJ,1047.62,,2294532.81
6100,11/13/2020,11/13/2020,111320,82L-IMPORT PAYROLL-ESCAMILLA OLGA,D108,HJ,1047.62,,2295580.43
6100,11/13/2020,11/13/2020,111320,82L-IMPORT PAYROLL-GARCIA SANTIAGO,D108,HJ,2041.67,,2297622.1
6100,11/13/2020,11/13/2020,111320,82L-IMPORT PAYROLL-GILES SHAYLA,D108,HJ,1047.62,,2298669.72
6100,11/13/2020,11/13/2020,111320,82L-IMPORT PAYROLL-IKUNIKA FUNMILAYO,D108,HJ,2083.33,,2300753.05
6100,11/13/2020,11/13/2020,111320,82L-IMPORT PAYROLL-JONES JORDAN,D108,HJ,1047.62,,2301800.67
6100,11/13/2020,11/13/2020,111320,82L-IMPORT PAYROLL-KHAN HUDA,D108,HJ,1047.62,,2302848.29
6100,11/13/2020,11/13/2020,111320,82L-IMPORT PAYROLL-KLOHR TIMOTHY JORDAN,D108,HJ,2000,,2304848.29
6100,11/13/2020,11/13/2020,111320,82L-IMPORT PAYROLL-KNOWLIN ZYLIA,D108,HJ,2541.67,,2307389.96
6100,11/13/2020,11/13/2020,111320,82L-IMPORT PAYROLL-KOPSHEVER MELISSA,D108,HJ,2916.67,,2310306.63
6100,11/13/2020,11/13/2020,111320,82L-IMPORT PAYROLL-LENEGHAN MARYELLEN,D108,HJ,940.71,,2311247.34
6100,11/13/2020,11/13/2020,111320,82L-IMPORT PAYROLL-LENEGHAN MARYELLEN,D108,HJ,1906.25,,2313153.59
6100,11/13/2020,11/13/2020,111320,82L-IMPORT PAYROLL-LI SEN YUAN,D108,HJ,1047.62,,2314201.21
6100,11/13/2020,11/13/2020,111320,82L-IMPORT PAYROLL-LIPSCOMB STEPHEN,D108,HJ,2541.67,,2316742.88
6100,11/13/2020,11/13/2020,111320,82L-IMPORT PAYROLL-MALLECK JESSICA R,D108,HJ,1047.62,,2317790.5
6100,11/13/2020,11/13/2020,111320,82L-IMPORT PAYROLL-MCLAUGHLIN MARA,D108,HJ,1047.62,,2318838.12
6100,11/13/2020,11/13/2020,111320,82L-IMPORT PAYROLL-MEJIA ROSO CARLOS,D108,HJ,1047.62,,2319885.74
6100,11/13/2020,11/13/2020,111320,82L-IMPORT PAYROLL-MONROY-MEJIA JASON,D108,HJ,1047.62,,2320933.36
6100,11/13/2020,11/13/2020,111320,82L-IMPORT PAYROLL-O'FLYNN-PRUITT NATHAN COLYAR,D108,HJ,1047.62,,2321980.98
6100,11/13/2020,11/13/2020,111320,82L-IMPORT PAYROLL-PATTERSON STEVE,D108,HJ,1047.62,,2323028.6
6100,11/13/2020,11/13/2020,111320,82L-IMPORT PAYROLL-SCHMIESS RACHEL JOY,D108,HJ,1047.62,,2324076.22
6100,11/13/2020,11/13/2020,111320,82L-IMPORT PAYROLL-SCOTT KIRK DONOVAN,D108,HJ,1047.62,,2325123.84
6100,11/13/2020,11/13/2020,111320,82L-IMPORT PAYROLL-SILVER KELLY,D108,HJ,2541.67,,2327665.51
6100,11/13/2020,11/13/2020,111320,82L-IMPORT PAYROLL-SOLIMAN MARK,D108,HJ,1047.62,,2328713.13
6100,11/13/2020,11/13/2020,111320,82L-IMPORT PAYROLL-STEIN KYLE,D108,HJ,2083.33,,2330796.46
6100,11/13/2020,11/13/2020,111320,82L-IMPORT PAYROLL-STROUD DAVID,D108,HJ,1047.62,,2331844.08
6100,11/13/2020,11/13/2020,111320,82L-IMPORT PAYROLL-VALCIN SABRINA JEMIMAH,D108,HJ,1047.62,,2332891.7
6100,11/13/2020,11/13/2020,111320,82L-IMPORT PAYROLL-VALDES ERNEST L,D108,HJ,1047.62,,2333939.32
6100,11/13/2020,11/13/2020,111320,82L-IMPORT PAYROLL-WILLIAMS MACK ANTHONY,D108,HJ,1047.62,,2334986.94
6100,11/13/2020,11/13/2020,111320,82L-IMPORT PAYROLL-WILLIAMS MIL'YONTA,D108,HJ,1047.62,,2336034.56
6100,11/13/2020,11/13/2020,111320,82L-IMPORT PAYROLL-ANTHONY BETTY S,D108,HJ,2886.52,,2338921.08
6100,11/13/2020,11/13/2020,111320,82L-IMPORT PAYROLL-APULI LINDSAY,D108,HJ,2500,,2341421.08
6100,11/13/2020,11/13/2020,111320,82L-IMPORT PAYROLL-AUSTIN PERCY ANTONIO,D108,HJ,2653.02,,2344074.1
6100,11/13/2020,11/13/2020,111320,82L-IMPORT PAYROLL-BUHMANN JENNIFER,D108,HJ,2270.83,,2346344.93
6100,11/13/2020,11/13/2020,111320,82L-IMPORT PAYROLL-CAIN CORY,D108,HJ,416.66,,2346761.59
6100,11/13/2020,11/13/2020,111320,82L-IMPORT PAYROLL-CAIN CORY,D108,HJ,2708.33,,2349469.92
6100,11/13/2020,11/13/2020,111320,82L-IMPORT PAYROLL-CHAPMAN CLAUDY EARL,D108,HJ,1833.33,,2351303.25
6100,11/13/2020,11/13/2020,111320,82L-IMPORT PAYROLL-DADA ARIKPO E,D108,HJ,2720,,2354023.25
6100,11/13/2020,11/13/2020,111320,82L-IMPORT PAYROLL-GUTHRIE LESLIE,D108,HJ,2458.33,,2356481.58
6100,11/13/2020,11/13/2020,111320,82L-IMPORT PAYROLL-HOLMES JOREL ALEXANDER,D108,HJ,2329,,2358810.58
6100,11/13/2020,11/13/2020,111320,82L-IMPORT PAYROLL-JORDAN TIFFANY T,D108,HJ,3445,,2362255.58
6100,11/13/2020,11/13/2020,111320,82L-IMPORT PAYROLL-LANIGAN LISA A,D108,HJ,3113.75,,2365369.33
6100,11/13/2020,11/13/2020,111320,82L-IMPORT PAYROLL-MCELWEE MELISSA,D108,HJ,2666.67,,2368036
6100,11/13/2020,11/13/2020,111320,82L-IMPORT PAYROLL-MCNICHOLAS MARY,D108,HJ,2291.67,,2370327.67
6100,11/13/2020,11/13/2020,111320,82L-IMPORT PAYROLL-NWAKANMA NANCY,D108,HJ,3046.67,,2373374.34
6100,11/13/2020,11/13/2020,111320,82L-IMPORT PAYROLL-ONICA ANTHONY J,D108,HJ,2416.67,,2375791.01
6100,11/13/2020,11/13/2020,111320,82L-IMPORT PAYROLL-PRAHIN NICOLE M,D108,HJ,1525,,2377316.01
6100,11/13/2020,11/13/2020,111320,82L-IMPORT PAYROLL-PRAHIN NICOLE M,D108,HJ,2287.5,,2379603.51
6100,11/13/2020,11/13/2020,111320,82L-IMPORT PAYROLL-RIVERS QUIONNA DIANE,D108,HJ,2708.34,,2382311.85
6100,11/13/2020,11/13/2020,111320,82L-IMPORT PAYROLL-SALIM YASSER,D108,HJ,2431.94,,2384743.79
6100,11/13/2020,11/13/2020,111320,82L-IMPORT PAYROLL-SEJOUR MAHALIAH,D108,HJ,2500,,2387243.79
6100,11/13/2020,11/13/2020,111320,82L-IMPORT PAYROLL-SKALSKI CHRISTOPHER,D108,HJ,2465,,2389708.79
6100,11/13/2020,11/13/2020,111320,82L-IMPORT PAYROLL-TUMENJARGAL ENKHJIN,D108,HJ,2414,,2392122.79
6100,11/13/2020,11/13/2020,111320,82L-IMPORT PAYROLL-VILLEGAS EVELYN,D108,HJ,2817.75,,2394940.54
6100,11/13/2020,11/13/2020,111320,82L-IMPORT PAYROLL-WOLF ANNA A,D108,HJ,2635,,2397575.54
6100,11/13/2020,11/13/2020,111320,82L-IMPORT PAYROLL-ACEVEDO MONIVETT,D107,HJ,5375,,2402950.54
6100,11/13/2020,11/13/2020,111320,82L-IMPORT PAYROLL-AKLESTAD ISABEL,D111,HJ,1750,,2404700.54
6100,11/13/2020,11/13/2020,111320,82L-IMPORT PAYROLL-ALLEN KIMBERLY MARY,D111,HJ,846.12,,2405546.66
6100,11/13/2020,11/13/2020,111320,82L-IMPORT PAYROLL-BIBB TIFFANI,D104,HJ,3875,,2409421.66
6100,11/13/2020,11/13/2020,111320,82L-IMPORT PAYROLL-BOWMAN HALLEY K,D101,HJ,2406.29,,2411827.95
6100,11/13/2020,11/13/2020,111320,82L-IMPORT PAYROLL-COOK CATHRYN ANNA,D105,HJ,3593.03,,2415420.98
6100,11/13/2020,11/13/2020,111320,82L-IMPORT PAYROLL-COOPER ASHLEE R,D101,HJ,2461.88,,2417882.86
6100,11/13/2020,11/13/2020,111320,82L-IMPORT PAYROLL-CORTEZ MIRANDA A,D111,HJ,2672.72,,2420555.58
6100,11/13/2020,11/13/2020,111320,82L-IMPORT PAYROLL-DAUGHERTY DEVIN W,D101,HJ,1041.67,,2421597.25
6100,11/13/2020,11/13/2020,111320,82L-IMPORT PAYROLL-DETONE KYRA MAYA,D102,HJ,262.5,,2421859.75
6100,11/13/2020,11/13/2020,111320,82L-IMPORT PAYROLL-DETONE KYRA MAYA,D102,HJ,2654.17,,2424513.92
6100,11/13/2020,11/13/2020,111320,82L-IMPORT PAYROLL-DUPUIS CHRISTOPHER M,D107,HJ,2508.33,,2427022.25
6100,11/13/2020,11/13/2020,111320,82L-IMPORT PAYROLL-DUPUIS CHRISTOPHER M,D107,HJ,3762.5,,2430784.75
6100,11/13/2020,11/13/2020,111320,82L-IMPORT PAYROLL-DZIEDZIC JULIE K,D101,HJ,1250,,2432034.75
6100,11/13/2020,11/13/2020,111320,82L-IMPORT PAYROLL-FISCHABER THOMAS,D109,HJ,439.65,,2432474.4
6100,11/13/2020,11/13/2020,111320,82L-IMPORT PAYROLL-FISCHABER THOMAS,D109,HJ,5416.67,,2437891.07
6100,11/13/2020,11/13/2020,111320,82L-IMPORT PAYROLL-FLORY MEGAN,D109,HJ,1500,,2439391.07
6100,11/13/2020,11/13/2020,111320,82L-IMPORT PAYROLL-GORNSTEIN STEVEN,D101,HJ,2708.33,,2442099.4
6100,11/13/2020,11/13/2020,111320,82L-IMPORT PAYROLL-GUADARRAMA-ALVAREZ URIEL A,D105,HJ,2897.92,,2444997.32
6100,11/13/2020,11/13/2020,111320,82L-IMPORT PAYROLL-GUTIERREZ ANTONIO J,D107,HJ,2763.56,,2447760.88
6100,11/13/2020,11/13/2020,111320,82L-IMPORT PAYROLL-GUTIERREZ ANTONIO J,D107,HJ,2763.57,,2450524.45
6100,11/13/2020,11/13/2020,111320,82L-IMPORT PAYROLL-HENRY GILLIAN,D102,HJ,2083.34,,2452607.79
6100,11/13/2020,11/13/2020,111320,82L-IMPORT PAYROLL-HERMAN ADAM,D102,HJ,1958.33,,2454566.12
6100,11/13/2020,11/13/2020,111320,82L-IMPORT PAYROLL-HESTER TYLER CONRAD,D105,HJ,1916.67,,2456482.79
6100,11/13/2020,11/13/2020,111320,82L-IMPORT PAYROLL-HOLT ADAM,D109,HJ,153.33,,2456636.12
6100,11/13/2020,11/13/2020,111320,82L-IMPORT PAYROLL-HOLT ADAM,D109,HJ,4166.67,,2460802.79
6100,11/13/2020,11/13/2020,111320,82L-IMPORT PAYROLL-KELLY SEAN,D109,HJ,5416.67,,2466219.46
6100,11/13/2020,11/13/2020,111320,82L-IMPORT PAYROLL-KRUGER MARK,D109,HJ,5000,,2471219.46
6100,11/13/2020,11/13/2020,111320,82L-IMPORT PAYROLL-LIPORACE HERNAN LUIS,D103,HJ,2291.67,,2473511.13
6100,11/13/2020,11/13/2020,111320,82L-IMPORT PAYROLL-MARKS KRISTA,D109,HJ,153.53,,2473664.66
6100,11/13/2020,11/13/2020,111320,82L-IMPORT PAYROLL-MARKS KRISTA,D109,HJ,5416.67,,2479081.33
6100,11/13/2020,11/13/2020,111320,82L-IMPORT PAYROLL-MASON ANGELA,D107,HJ,1541.95,,2480623.28
6100,11/13/2020,11/13/2020,111320,82L-IMPORT PAYROLL-MASON ANGELA,D107,HJ,4168.99,,2484792.27
6100,11/13/2020,11/13/2020,111320,82L-IMPORT PAYROLL-MELVIN DARNELL,D109,HJ,4000,,2488792.27
6100,11/13/2020,11/13/2020,111320,82L-IMPORT PAYROLL-MESSING JENNIFER,D104,HJ,2500,,2491292.27
6100,11/13/2020,11/13/2020,111320,82L-IMPORT PAYROLL-MILNE ROGER,D109,HJ,325,,2491617.27
6100,11/13/2020,11/13/2020,111320,82L-IMPORT PAYROLL-MILNE ROGER,D109,HJ,5091.67,,2496708.94
6100,11/13/2020,11/13/2020,111320,82L-IMPORT PAYROLL-MOSTAFAVI YASAMAN,D109,HJ,264,,2496972.94
6100,11/13/2020,11/13/2020,111320,82L-IMPORT PAYROLL-O'DONNELL STEPHEN,D104,HJ,2707.5,,2499680.44
6100,11/13/2020,11/13/2020,111320,82L-IMPORT PAYROLL-PARETS MALLORY GRACE,D101,HJ,2833.33,,2502513.77
6100,11/13/2020,11/13/2020,111320,82L-IMPORT PAYROLL-PARHAM-GANTT DENISE M,D112,HJ,3041.67,,2505555.44
6100,11/13/2020,11/13/2020,111320,82L-IMPORT PAYROLL-PEINADO ELIZABETH R,D111,HJ,3749.96,,2509305.4
6100,11/13/2020,11/13/2020,111320,82L-IMPORT PAYROLL-PERNIA JEFFREY,D109,HJ,3875,,2513180.4
6100,11/13/2020,11/13/2020,111320,82L-IMPORT PAYROLL-POLANCO ODALIS,D103,HJ,3124.96,,2516305.36
6100,11/13/2020,11/13/2020,111320,82L-IMPORT PAYROLL-QUINTAS JASHIVE,D105,HJ,1916.67,,2518222.03
6100,11/13/2020,11/13/2020,111320,82L-IMPORT PAYROLL-RANDOLPH ALEXANDER,D111,HJ,1875,,2520097.03
6100,11/13/2020,11/13/2020,111320,82L-IMPORT PAYROLL-RUBI PERLA,D101,HJ,1250,,2521347.03
6100,11/13/2020,11/13/2020,111320,82L-IMPORT PAYROLL-SAFRAN ALAN P,D107,HJ,751.69,,2522098.72
6100,11/13/2020,11/13/2020,111320,82L-IMPORT PAYROLL-SAFRAN ALAN P,D107,HJ,6765.19,,2528863.91
6100,11/13/2020,11/13/2020,111320,82L-IMPORT PAYROLL-SHENKMAN OLIVIA,D101,HJ,2000,,2530863.91
6100,11/13/2020,11/13/2020,111320,82L-IMPORT PAYROLL-SHI GRACE,D103,HJ,875,,2531738.91
6100,11/13/2020,11/13/2020,111320,82L-IMPORT PAYROLL-WALLACE AMENA,D104,HJ,2187.5,,2533926.41
6100,11/13/2020,11/13/2020,111320,82L-IMPORT PAYROLL-WARD JEFFREY,D109,HJ,439.65,,2534366.06
6100,11/13/2020,11/13/2020,111320,82L-IMPORT PAYROLL-WARD JEFFREY,D109,HJ,5416.67,,2539782.73
6100,11/13/2020,11/13/2020,111320,82L-IMPORT PAYROLL-WARD JENNIFER,D109,HJ,526.5,,2540309.23
6100,11/13/2020,11/13/2020,111320,82L-IMPORT PAYROLL-WEINSTOCK EMILY,D101,HJ,2833.33,,2543142.56
6100,11/13/2020,11/13/2020,111320,82L-IMPORT PAYROLL-WINANS JENNIFER,D111,HJ,2505.63,,2545648.19
6100,11/13/2020,11/13/2020,111320,82L-IMPORT PAYROLL-ZARATE JOSEPH M,D105,HJ,2150,,2547798.19
6100,11/13/2020,11/13/2020,111320,82L-IMPORT PAYROLL-AGUANNO JOSEPH,D108,HJ,1119.05,,2548917.24
6100,11/13/2020,11/13/2020,111320,82L-IMPORT PAYROLL-AKESODE FEHINTOLA,D108,HJ,1119.05,,2550036.29
6100,11/13/2020,11/13/2020,111320,82L-IMPORT PAYROLL-BARTOLD DEANNA MARIE,D108,HJ,3034.5,,2553070.79
6100,11/13/2020,11/13/2020,111320,82L-IMPORT PAYROLL-BELLOT GENESIS,D108,HJ,2500,,2555570.79
6100,11/13/2020,11/13/2020,111320,82L-IMPORT PAYROLL-BENNETT JAMES H,D108,HJ,1119.05,,2556689.84
6100,11/13/2020,11/13/2020,111320,82L-IMPORT PAYROLL-BOWMAN ABIGAIL,D108,HJ,1119.05,,2557808.89
6100,11/13/2020,11/13/2020,111320,82L-IMPORT PAYROLL-BURRELL RUSSELL,D108,HJ,1119.05,,2558927.94
6100,11/13/2020,11/13/2020,111320,82L-IMPORT PAYROLL-CHUI KENT,D108,HJ,1119.05,,2560046.99
6100,11/13/2020,11/13/2020,111320,82L-IMPORT PAYROLL-CIRKER MIA,D108,HJ,2250,,2562296.99
6100,11/13/2020,11/13/2020,111320,82L-IMPORT PAYROLL-DEWS CAMERYN,D108,HJ,2291.67,,2564588.66
6100,11/13/2020,11/13/2020,111320,82L-IMPORT PAYROLL-DIETZ MARY,D108,HJ,1119.05,,2565707.71
6100,11/13/2020,11/13/2020,111320,82L-IMPORT PAYROLL-DOMINIQUE PRINCESSA,D108,HJ,1119.05,,2566826.76
6100,11/13/2020,11/13/2020,111320,82L-IMPORT PAYROLL-DONNELLY MARCUS,D108,HJ,1119.05,,2567945.81
6100,11/13/2020,11/13/2020,111320,82L-IMPORT PAYROLL-FEIGHERY JOHN,D108,HJ,2250,,2570195.81
6100,11/13/2020,11/13/2020,111320,82L-IMPORT PAYROLL-FORTH KYLE,D108,HJ,1119.05,,2571314.86
6100,11/13/2020,11/13/2020,111320,82L-IMPORT PAYROLL-GARCIA MARILYN,D108,HJ,2291.67,,2573606.53
6100,11/13/2020,11/13/2020,111320,82L-IMPORT PAYROLL-GREENE BROOKE,D108,HJ,1119.05,,2574725.58
6100,11/13/2020,11/13/2020,111320,82L-IMPORT PAYROLL-GRIFFIN ANDREW,D108,HJ,2250,,2576975.58
6100,11/13/2020,11/13/2020,111320,82L-IMPORT PAYROLL-GROSS EMILY,D108,HJ,1119.05,,2578094.63
6100,11/13/2020,11/13/2020,111320,82L-IMPORT PAYROLL-GUERRERO LUIS,D108,HJ,1119.05,,2579213.68
6100,11/13/2020,11/13/2020,111320,82L-IMPORT PAYROLL-HALLINAN GABRIEL,D108,HJ,2550,,2581763.68
6100,11/13/2020,11/13/2020,111320,82L-IMPORT PAYROLL-HAMERSLY WILLIAM,D108,HJ,2500,,2584263.68
6100,11/13/2020,11/13/2020,111320,82L-IMPORT PAYROLL-HOLDER LATIVA M,D108,HJ,3812.5,,2588076.18
6100,11/13/2020,11/13/2020,111320,82L-IMPORT PAYROLL-HOSSAIN MYESHA,D108,HJ,2437.5,,2590513.68
6100,11/13/2020,11/13/2020,111320,82L-IMPORT PAYROLL-JACKSON TASNIM F,D108,HJ,2291.67,,2592805.35
6100,11/13/2020,11/13/2020,111320,82L-IMPORT PAYROLL-KERKHOFF HARPER FAITH,D108,HJ,1119.05,,2593924.4
6100,11/13/2020,11/13/2020,111320,82L-IMPORT PAYROLL-LEARY AUBREY,D108,HJ,1119.05,,2595043.45
6100,11/13/2020,11/13/2020,111320,82L-IMPORT PAYROLL-LI BELLA,D108,HJ,2486.25,,2597529.7
6100,11/13/2020,11/13/2020,111320,82L-IMPORT PAYROLL-LOUIE JORDAN,D108,HJ,1119.05,,2598648.75
6100,11/13/2020,11/13/2020,111320,82L-IMPORT PAYROLL-MELCHOR OSBEIDY,D108,HJ,1119.05,,2599767.8
6100,11/13/2020,11/13/2020,111320,82L-IMPORT PAYROLL-MORRIS ZAKIYA,D108,HJ,1119.05,,2600886.85
6100,11/13/2020,11/13/2020,111320,82L-IMPORT PAYROLL-MORSELETTO RAFAEL,D108,HJ,1119.05,,2602005.9
6100,11/13/2020,11/13/2020,111320,82L-IMPORT PAYROLL-OBI TOBECHUKWU,D108,HJ,1119.05,,2603124.95
6100,11/13/2020,11/13/2020,111320,82L-IMPORT PAYROLL-OPUH NDIDI,D108,HJ,2833.33,,2605958.28
6100,11/13/2020,11/13/2020,111320,82L-IMPORT PAYROLL-PAULINO THAIRI,D108,HJ,1119.05,,2607077.33
6100,11/13/2020,11/13/2020,111320,82L-IMPORT PAYROLL-ROSENBAUM MURRAY,D108,HJ,1119.05,,2608196.38
6100,11/13/2020,11/13/2020,111320,82L-IMPORT PAYROLL-SCHWETTMANN CLAIRE,D108,HJ,1119.05,,2609315.43
6100,11/13/2020,11/13/2020,111320,82L-IMPORT PAYROLL-SOBELMAN JUSTIN,D108,HJ,1119.05,,2610434.48
6100,11/13/2020,11/13/2020,111320,82L-IMPORT PAYROLL-TERRENCE-SMITH ZIHIR,D108,HJ,1119.05,,2611553.53
6100,11/13/2020,11/13/2020,111320,82L-IMPORT PAYROLL-TILLERY ASIA,D108,HJ,3291.67,,2614845.2
6100,11/13/2020,11/13/2020,111320,82L-IMPORT PAYROLL-WILLIAMS-MASSEY BRIANNA,D108,HJ,1119.05,,2615964.25
6100,11/13/2020,11/13/2020,111320,82L-IMPORT PAYROLL-XIAO CHENGYAO,D108,HJ,1119.05,,2617083.3
6100,11/13/2020,11/13/2020,111320,82L-IMPORT PAYROLL-ZIAUDDIN ABUTAHER,D108,HJ,1119.05,,2618202.35
6100,11/13/2020,11/13/2020,111320,82L-IMPORT PAYROLL-BALASUBRAMANIAN SHARANYA,D108,HJ,2666.67,,2620869.02
6100,11/13/2020,11/13/2020,111320,82L-IMPORT PAYROLL-COVENEY ALLISON,D108,HJ,2854.17,,2623723.19
6100,11/13/2020,11/13/2020,111320,82L-IMPORT PAYROLL-JACKSON CLAICE M,D108,HJ,3125,,2626848.19
6100,11/13/2020,11/13/2020,111320,82L-IMPORT PAYROLL-JANG DANIEL,D108,HJ,2750,,2629598.19
6100,11/13/2020,11/13/2020,111320,82L-IMPORT PAYROLL-LENEGHAN MARYELLEN,D108,HJ,1906.25,,2631504.44
6100,11/30/2020,11/30/2020,113020,82L-IMPORT PAYROLL-BARTHELEMY RACHALIE,D108,HJ,1047.62,,2632552.06
6100,11/30/2020,11/30/2020,113020,82L-IMPORT PAYROLL-BASHAM WILLIAM EDWARD,D108,HJ,1047.62,,2633599.68
6100,11/30/2020,11/30/2020,113020,82L-IMPORT PAYROLL-BOHLSEN GRACE ISABELLE,D108,HJ,1047.62,,2634647.3
6100,11/30/2020,11/30/2020,113020,82L-IMPORT PAYROLL-BOLIVAR ANDREA,D108,HJ,2500,,2637147.3
6100,11/30/2020,11/30/2020,113020,82L-IMPORT PAYROLL-BORCHART SPENCER,D108,HJ,1047.62,,2638194.92
6100,11/30/2020,11/30/2020,113020,82L-IMPORT PAYROLL-BROWN ISAAC,D108,HJ,1047.62,,2639242.54
6100,11/30/2020,11/30/2020,113020,82L-IMPORT PAYROLL-BURKE MARIAH,D108,HJ,1047.62,,2640290.16
6100,11/30/2020,11/30/2020,113020,82L-IMPORT PAYROLL-CASSADY JOSHUA LEWIS,D108,HJ,1047.62,,2641337.78
6100,11/30/2020,11/30/2020,113020,82L-IMPORT PAYROLL-DARKO OLIVIA,D108,HJ,1047.62,,2642385.4
6100,11/30/2020,11/30/2020,113020,82L-IMPORT PAYROLL-DAWSON JAMIL NAFAYE-BEYAH,D108,HJ,1047.62,,2643433.02
6100,11/30/2020,11/30/2020,113020,82L-IMPORT PAYROLL-ESCAMILLA OLGA,D108,HJ,1047.62,,2644480.64
6100,11/30/2020,11/30/2020,113020,82L-IMPORT PAYROLL-GARCIA SANTIAGO,D108,HJ,2041.67,,2646522.31
6100,11/30/2020,11/30/2020,113020,82L-IMPORT PAYROLL-GILES SHAYLA,D108,HJ,1047.62,,2647569.93
6100,11/30/2020,11/30/2020,113020,82L-IMPORT PAYROLL-IKUNIKA FUNMILAYO,D108,HJ,2083.33,,2649653.26
6100,11/30/2020,11/30/2020,113020,82L-IMPORT PAYROLL-JONES JORDAN,D108,HJ,1047.62,,2650700.88
6100,11/30/2020,11/30/2020,113020,82L-IMPORT PAYROLL-KHAN HUDA,D108,HJ,1047.62,,2651748.5
6100,11/30/2020,11/30/2020,113020,82L-IMPORT PAYROLL-KLOHR TIMOTHY JORDAN,D108,HJ,2000,,2653748.5
6100,11/30/2020,11/30/2020,113020,82L-IMPORT PAYROLL-KNOWLIN ZYLIA,D108,HJ,2541.67,,2656290.17
6100,11/30/2020,11/30/2020,113020,82L-IMPORT PAYROLL-KOPSHEVER MELISSA,D108,HJ,2916.67,,2659206.84
6100,11/30/2020,11/30/2020,113020,82L-IMPORT PAYROLL-LI SEN YUAN,D108,HJ,1047.62,,2660254.46
6100,11/30/2020,11/30/2020,113020,82L-IMPORT PAYROLL-LIPSCOMB STEPHEN,D108,HJ,2541.67,,2662796.13
6100,11/30/2020,11/30/2020,113020,82L-IMPORT PAYROLL-MALLECK JESSICA R,D108,HJ,1047.62,,2663843.75
6100,11/30/2020,11/30/2020,113020,82L-IMPORT PAYROLL-MCLAUGHLIN MARA,D108,HJ,1047.62,,2664891.37
6100,11/30/2020,11/30/2020,113020,82L-IMPORT PAYROLL-MEJIA ROSO CARLOS,D108,HJ,1047.62,,2665938.99
6100,11/30/2020,11/30/2020,113020,82L-IMPORT PAYROLL-MONROY-MEJIA JASON,D108,HJ,1047.62,,2666986.61
6100,11/30/2020,11/30/2020,113020,82L-IMPORT PAYROLL-O'FLYNN-PRUITT NATHAN COLYAR,D108,HJ,1047.62,,2668034.23
6100,11/30/2020,11/30/2020,113020,82L-IMPORT PAYROLL-PATTERSON STEVE,D108,HJ,1047.62,,2669081.85
6100,11/30/2020,11/30/2020,113020,82L-IMPORT PAYROLL-SCHMIESS RACHEL JOY,D108,HJ,1047.62,,2670129.47
6100,11/30/2020,11/30/2020,113020,82L-IMPORT PAYROLL-SCOTT KIRK DONOVAN,D108,HJ,1047.62,,2671177.09
6100,11/30/2020,11/30/2020,113020,82L-IMPORT PAYROLL-SILVER KELLY,D108,HJ,2541.67,,2673718.76
6100,11/30/2020,11/30/2020,113020,82L-IMPORT PAYROLL-SOLIMAN MARK,D108,HJ,1047.62,,2674766.38
6100,11/30/2020,11/30/2020,113020,82L-IMPORT PAYROLL-STEIN KYLE,D108,HJ,2083.33,,2676849.71
6100,11/30/2020,11/30/2020,113020,82L-IMPORT PAYROLL-STROUD DAVID,D108,HJ,1047.62,,2677897.33
6100,11/30/2020,11/30/2020,113020,82L-IMPORT PAYROLL-VALCIN SABRINA JEMIMAH,D108,HJ,1047.62,,2678944.95
6100,11/30/2020,11/30/2020,113020,82L-IMPORT PAYROLL-VALDES ERNEST L,D108,HJ,1047.62,,2679992.57
6100,11/30/2020,11/30/2020,113020,82L-IMPORT PAYROLL-WILLIAMS MACK ANTHONY,D108,HJ,1047.62,,2681040.19
6100,11/30/2020,11/30/2020,113020,82L-IMPORT PAYROLL-WILLIAMS MIL'YONTA,D108,HJ,1047.62,,2682087.81
6100,11/30/2020,11/30/2020,113020,82L-IMPORT PAYROLL-ANTHONY BETTY S,D108,HJ,2886.52,,2684974.33
6100,11/30/2020,11/30/2020,113020,82L-IMPORT PAYROLL-APULI LINDSAY,D108,HJ,2500,,2687474.33
6100,11/30/2020,11/30/2020,113020,82L-IMPORT PAYROLL-AUSTIN PERCY ANTONIO,D108,HJ,2653.02,,2690127.35
6100,11/30/2020,11/30/2020,113020,82L-IMPORT PAYROLL-BUHMANN JENNIFER,D108,HJ,2270.83,,2692398.18
6100,11/30/2020,11/30/2020,113020,82L-IMPORT PAYROLL-CAIN CORY,D108,HJ,2708.33,,2695106.51
6100,11/30/2020,11/30/2020,113020,82L-IMPORT PAYROLL-CHAPMAN CLAUDY EARL,D108,HJ,1833.33,,2696939.84
6100,11/30/2020,11/30/2020,113020,82L-IMPORT PAYROLL-DADA ARIKPO E,D108,HJ,2720,,2699659.84
6100,11/30/2020,11/30/2020,113020,82L-IMPORT PAYROLL-GUTHRIE LESLIE,D108,HJ,2458.33,,2702118.17
6100,11/30/2020,11/30/2020,113020,82L-IMPORT PAYROLL-HOLMES JOREL ALEXANDER,D108,HJ,2329,,2704447.17
6100,11/30/2020,11/30/2020,113020,82L-IMPORT PAYROLL-JORDAN TIFFANY T,D108,HJ,3445,,2707892.17
6100,11/30/2020,11/30/2020,113020,82L-IMPORT PAYROLL-LANIGAN LISA A,D108,HJ,3113.75,,2711005.92
6100,11/30/2020,11/30/2020,113020,82L-IMPORT PAYROLL-MCELWEE MELISSA,D108,HJ,2666.67,,2713672.59
6100,11/30/2020,11/30/2020,113020,82L-IMPORT PAYROLL-MCNICHOLAS MARY,D108,HJ,2291.67,,2715964.26
6100,11/30/2020,11/30/2020,113020,82L-IMPORT PAYROLL-NWAKANMA NANCY,D108,HJ,3046.67,,2719010.93
6100,11/30/2020,11/30/2020,113020,82L-IMPORT PAYROLL-ONICA ANTHONY J,D108,HJ,2416.67,,2721427.6
6100,11/30/2020,11/30/2020,113020,82L-IMPORT PAYROLL-PRAHIN NICOLE M,D108,HJ,686.25,,2722113.85
6100,11/30/2020,11/30/2020,113020,82L-IMPORT PAYROLL-PRAHIN NICOLE M,D108,HJ,3126.25,,2725240.1
6100,11/30/2020,11/30/2020,113020,82L-IMPORT PAYROLL-RIVERS QUIONNA DIANE,D108,HJ,2708.34,,2727948.44
6100,11/30/2020,11/30/2020,113020,82L-IMPORT PAYROLL-SALIM YASSER,D108,HJ,2431.94,,2730380.38
6100,11/30/2020,11/30/2020,113020,82L-IMPORT PAYROLL-SEJOUR MAHALIAH,D108,HJ,2500,,2732880.38
6100,11/30/2020,11/30/2020,113020,82L-IMPORT PAYROLL-SKALSKI CHRISTOPHER,D108,HJ,2465,,2735345.38
6100,11/30/2020,11/30/2020,113020,82L-IMPORT PAYROLL-TUMENJARGAL ENKHJIN,D108,HJ,2414,,2737759.38
6100,11/30/2020,11/30/2020,113020,82L-IMPORT PAYROLL-VILLEGAS EVELYN,D108,HJ,2817.75,,2740577.13
6100,11/30/2020,11/30/2020,113020,82L-IMPORT PAYROLL-WOLF ANNA A,D108,HJ,2635,,2743212.13
6100,11/30/2020,11/30/2020,113020,82L-IMPORT PAYROLL-ACEVEDO MONIVETT,D107,HJ,967.5,,2744179.63
6100,11/30/2020,11/30/2020,113020,82L-IMPORT PAYROLL-ACEVEDO MONIVETT,D107,HJ,4407.5,,2748587.13
6100,11/30/2020,11/30/2020,113020,82L-IMPORT PAYROLL-AKLESTAD ISABEL,D111,HJ,250,,2748837.13
6100,11/30/2020,11/30/2020,113020,82L-IMPORT PAYROLL-AKLESTAD ISABEL,D111,HJ,1750,,2750587.13
6100,11/30/2020,11/30/2020,113020,82L-IMPORT PAYROLL-BIBB TIFFANI,D104,HJ,3875,,2754462.13
6100,11/30/2020,11/30/2020,113020,82L-IMPORT PAYROLL-BOWMAN HALLEY K,D101,HJ,3202.55,,2757664.68
6100,11/30/2020,11/30/2020,113020,82L-IMPORT PAYROLL-COOK CATHRYN ANNA,D105,HJ,646.74,,2758311.42
6100,11/30/2020,11/30/2020,113020,82L-IMPORT PAYROLL-COOK CATHRYN ANNA,D105,HJ,2946.29,,2761257.71
6100,11/30/2020,11/30/2020,113020,82L-IMPORT PAYROLL-COOPER ASHLEE R,D101,HJ,2461.88,,2763719.59
6100,11/30/2020,11/30/2020,113020,82L-IMPORT PAYROLL-CORTEZ MIRANDA A,D111,HJ,250,,2763969.59
6100,11/30/2020,11/30/2020,113020,82L-IMPORT PAYROLL-CORTEZ MIRANDA A,D111,HJ,2672.72,,2766642.31
6100,11/30/2020,11/30/2020,113020,82L-IMPORT PAYROLL-DAUGHERTY DEVIN W,D101,HJ,1041.67,,2767683.98
6100,11/30/2020,11/30/2020,113020,82L-IMPORT PAYROLL-DETONE KYRA MAYA,D102,HJ,262.5,,2767946.48
6100,11/30/2020,11/30/2020,113020,82L-IMPORT PAYROLL-DETONE KYRA MAYA,D102,HJ,2654.17,,2770600.65
6100,11/30/2020,11/30/2020,113020,82L-IMPORT PAYROLL-DUPUIS CHRISTOPHER M,D107,HJ,2257.5,,2772858.15
6100,11/30/2020,11/30/2020,113020,82L-IMPORT PAYROLL-DUPUIS CHRISTOPHER M,D107,HJ,4013.33,,2776871.48
6100,11/30/2020,11/30/2020,113020,82L-IMPORT PAYROLL-DZIEDZIC JULIE K,D101,HJ,1250,,2778121.48
6100,11/30/2020,11/30/2020,113020,82L-IMPORT PAYROLL-FISCHABER THOMAS,D109,HJ,439.65,,2778561.13
6100,11/30/2020,11/30/2020,113020,82L-IMPORT PAYROLL-FISCHABER THOMAS,D109,HJ,5416.67,,2783977.8
6100,11/30/2020,11/30/2020,113020,82L-IMPORT PAYROLL-FLORY MEGAN,D109,HJ,1500,,2785477.8
6100,11/30/2020,11/30/2020,113020,82L-IMPORT PAYROLL-GORNSTEIN STEVEN,D101,HJ,2708.33,,2788186.13
6100,11/30/2020,11/30/2020,113020,82L-IMPORT PAYROLL-GUADARRAMA-ALVAREZ URIEL A,D105,HJ,2897.92,,2791084.05
6100,11/30/2020,11/30/2020,113020,82L-IMPORT PAYROLL-GUTIERREZ ANTONIO J,D107,HJ,994.88,,2792078.93
6100,11/30/2020,11/30/2020,113020,82L-IMPORT PAYROLL-GUTIERREZ ANTONIO J,D107,HJ,4532.25,,2796611.18
6100,11/30/2020,11/30/2020,113020,82L-IMPORT PAYROLL-HENRY GILLIAN,D102,HJ,187.5,,2796798.68
6100,11/30/2020,11/30/2020,113020,82L-IMPORT PAYROLL-HENRY GILLIAN,D102,HJ,1895.84,,2798694.52
6100,11/30/2020,11/30/2020,113020,82L-IMPORT PAYROLL-HERMAN ADAM,D102,HJ,1958.33,,2800652.85
6100,11/30/2020,11/30/2020,113020,82L-IMPORT PAYROLL-HESTER TYLER CONRAD,D105,HJ,1916.67,,2802569.52
6100,11/30/2020,11/30/2020,113020,82L-IMPORT PAYROLL-HOLT ADAM,D109,HJ,153.53,,2802723.05
6100,11/30/2020,11/30/2020,113020,82L-IMPORT PAYROLL-HOLT ADAM,D109,HJ,4166.67,,2806889.72
6100,11/30/2020,11/30/2020,113020,82L-IMPORT PAYROLL-KELLY SEAN,D109,HJ,5416.67,,2812306.39
6100,11/30/2020,11/30/2020,113020,82L-IMPORT PAYROLL-KRUGER MARK,D109,HJ,5000,,2817306.39
6100,11/30/2020,11/30/2020,113020,82L-IMPORT PAYROLL-LIPORACE HERNAN LUIS,D103,HJ,2291.67,,2819598.06
6100,11/30/2020,11/30/2020,113020,82L-IMPORT PAYROLL-MARKS KRISTA,D109,HJ,153.53,,2819751.59
6100,11/30/2020,11/30/2020,113020,82L-IMPORT PAYROLL-MARKS KRISTA,D109,HJ,5416.67,,2825168.26
6100,11/30/2020,11/30/2020,113020,82L-IMPORT PAYROLL-MELVIN DARNELL KEVIN,D109,HJ,4000,,2829168.26
6100,11/30/2020,11/30/2020,113020,82L-IMPORT PAYROLL-MESSING JENNIFER,D104,HJ,2500,,2831668.26
6100,11/30/2020,11/30/2020,113020,82L-IMPORT PAYROLL-MILNE ROGER,D109,HJ,150.66,,2831818.92
6100,11/30/2020,11/30/2020,113020,82L-IMPORT PAYROLL-MILNE ROGER,D109,HJ,325,,2832143.92
6100,11/30/2020,11/30/2020,113020,82L-IMPORT PAYROLL-MILNE ROGER,D109,HJ,5091.67,,2837235.59
6100,11/30/2020,11/30/2020,113020,82L-IMPORT PAYROLL-MOSTAFAVI YASAMAN,D109,HJ,352,,2837587.59
6100,11/30/2020,11/30/2020,113020,82L-IMPORT PAYROLL-O'DONNELL STEPHEN,D104,HJ,2707.5,,2840295.09
6100,11/30/2020,11/30/2020,113020,82L-IMPORT PAYROLL-PARETS MALLORY GRACE,D101,HJ,2833.33,,2843128.42
6100,11/30/2020,11/30/2020,113020,82L-IMPORT PAYROLL-PARHAM-GANTT DENISE M,D112,HJ,3041.67,,2846170.09
6100,11/30/2020,11/30/2020,113020,82L-IMPORT PAYROLL-PEINADO ELIZABETH R,D111,HJ,250,,2846420.09
6100,11/30/2020,11/30/2020,113020,82L-IMPORT PAYROLL-PEINADO ELIZABETH R,D111,HJ,3749.96,,2850170.05
6100,11/30/2020,11/30/2020,113020,82L-IMPORT PAYROLL-PERNIA JEFFREY,D109,HJ,146.72,,2850316.77
6100,11/30/2020,11/30/2020,113020,82L-IMPORT PAYROLL-PERNIA JEFFREY,D109,HJ,3875,,2854191.77
6100,11/30/2020,11/30/2020,113020,82L-IMPORT PAYROLL-POLANCO ODALIS,D103,HJ,3124.96,,2857316.73
6100,11/30/2020,11/30/2020,113020,82L-IMPORT PAYROLL-QUINTAS JASHIVE,D105,HJ,1916.67,,2859233.4
6100,11/30/2020,11/30/2020,113020,82L-IMPORT PAYROLL-RANDOLPH ALEXANDER,D111,HJ,250,,2859483.4
6100,11/30/2020,11/30/2020,113020,82L-IMPORT PAYROLL-RANDOLPH ALEXANDER,D111,HJ,1875,,2861358.4
6100,11/30/2020,11/30/2020,113020,82L-IMPORT PAYROLL-RUBI PERLA,D101,HJ,1250,,2862608.4
6100,11/30/2020,11/30/2020,113020,82L-IMPORT PAYROLL-SAFRAN ALAN P,D107,HJ,1353.04,,2863961.44
6100,11/30/2020,11/30/2020,113020,82L-IMPORT PAYROLL-SAFRAN ALAN P,D107,HJ,6163.84,,2870125.28
6100,11/30/2020,11/30/2020,113020,82L-IMPORT PAYROLL-SHENKMAN OLIVIA,D101,HJ,2000,,2872125.28
6100,11/30/2020,11/30/2020,113020,82L-IMPORT PAYROLL-SHI GRACE,D103,HJ,875,,2873000.28
6100,11/30/2020,11/30/2020,113020,82L-IMPORT PAYROLL-WALLACE AMENA,D104,HJ,2187.5,,2875187.78
6100,11/30/2020,11/30/2020,113020,82L-IMPORT PAYROLL-WARD JEFFREY,D109,HJ,439.65,,2875627.43
6100,11/30/2020,11/30/2020,113020,82L-IMPORT PAYROLL-WARD JEFFREY,D109,HJ,5416.67,,2881044.1
6100,11/30/2020,11/30/2020,113020,82L-IMPORT PAYROLL-WARD JENNIFER,D109,HJ,1300.59,,2882344.69
6100,11/30/2020,11/30/2020,113020,82L-IMPORT PAYROLL-WEINSTOCK EMILY,D101,HJ,2833.33,,2885178.02
6100,11/30/2020,11/30/2020,113020,82L-IMPORT PAYROLL-WINANS JENNIFER,D111,HJ,250,,2885428.02
6100,11/30/2020,11/30/2020,113020,82L-IMPORT PAYROLL-WINANS JENNIFER,D111,HJ,2505.63,,2887933.65
6100,11/30/2020,11/30/2020,113020,82L-IMPORT PAYROLL-ZARATE JOSEPH M,D105,HJ,2150,,2890083.65
6100,11/30/2020,11/30/2020,113020,82L-IMPORT PAYROLL-AGUANNO JOSEPH,D108,HJ,1119.05,,2891202.7
6100,11/30/2020,11/30/2020,113020,82L-IMPORT PAYROLL-AKESODE FEHINTOLA,D108,HJ,1119.05,,2892321.75
6100,11/30/2020,11/30/2020,113020,82L-IMPORT PAYROLL-BARTOLD DEANNA MARIE,D108,HJ,3034.5,,2895356.25
6100,11/30/2020,11/30/2020,113020,82L-IMPORT PAYROLL-BELLOT GENESIS,D108,HJ,2500,,2897856.25
6100,11/30/2020,11/30/2020,113020,82L-IMPORT PAYROLL-BENNETT JAMES H,D108,HJ,1119.05,,2898975.3
6100,11/30/2020,11/30/2020,113020,82L-IMPORT PAYROLL-BOWMAN ABIGAIL,D108,HJ,1119.05,,2900094.35
6100,11/30/2020,11/30/2020,113020,82L-IMPORT PAYROLL-BURRELL RUSSELL,D108,HJ,1119.05,,2901213.4
6100,11/30/2020,11/30/2020,113020,82L-IMPORT PAYROLL-CHUI KENT,D108,HJ,1119.05,,2902332.45
6100,11/30/2020,11/30/2020,113020,82L-IMPORT PAYROLL-CIRKER MIA,D108,HJ,2250,,2904582.45
6100,11/30/2020,11/30/2020,113020,82L-IMPORT PAYROLL-DEWS CAMERYN,D108,HJ,2291.67,,2906874.12
6100,11/30/2020,11/30/2020,113020,82L-IMPORT PAYROLL-DIETZ MARY,D108,HJ,1119.05,,2907993.17
6100,11/30/2020,11/30/2020,113020,82L-IMPORT PAYROLL-DOMINIQUE PRINCESSA,D108,HJ,1119.05,,2909112.22
6100,11/30/2020,11/30/2020,113020,82L-IMPORT PAYROLL-DONNELLY MARCUS,D108,HJ,1119.05,,2910231.27
6100,11/30/2020,11/30/2020,113020,82L-IMPORT PAYROLL-FEIGHERY JOHN,D108,HJ,2250,,2912481.27
6100,11/30/2020,11/30/2020,113020,82L-IMPORT PAYROLL-FORTH KYLE,D108,HJ,1119.05,,2913600.32
6100,11/30/2020,11/30/2020,113020,82L-IMPORT PAYROLL-GARCIA MARILYN,D108,HJ,2291.67,,2915891.99
6100,11/30/2020,11/30/2020,113020,82L-IMPORT PAYROLL-GREENE BROOKE,D108,HJ,1119.05,,2917011.04
6100,11/30/2020,11/30/2020,113020,82L-IMPORT PAYROLL-GRIFFIN ANDREW,D108,HJ,2250,,2919261.04
6100,11/30/2020,11/30/2020,113020,82L-IMPORT PAYROLL-GROSS EMILY,D108,HJ,1119.05,,2920380.09
6100,11/30/2020,11/30/2020,113020,82L-IMPORT PAYROLL-GUERRERO LUIS,D108,HJ,1119.05,,2921499.14
6100,11/30/2020,11/30/2020,113020,82L-IMPORT PAYROLL-HALLINAN GABRIEL,D108,HJ,2550,,2924049.14
6100,11/30/2020,11/30/2020,113020,82L-IMPORT PAYROLL-HAMERSLY WILLIAM,D108,HJ,2500,,2926549.14
6100,11/30/2020,11/30/2020,113020,82L-IMPORT PAYROLL-HOLDER LATIVA M,D108,HJ,3812.5,,2930361.64
6100,11/30/2020,11/30/2020,113020,82L-IMPORT PAYROLL-HOSSAIN MYESHA,D108,HJ,2437.5,,2932799.14
6100,11/30/2020,11/30/2020,113020,82L-IMPORT PAYROLL-JACKSON TASNIM F,D108,HJ,2291.67,,2935090.81
6100,11/30/2020,11/30/2020,113020,82L-IMPORT PAYROLL-KERKHOFF HARPER FAITH,D108,HJ,1119.05,,2936209.86
6100,11/30/2020,11/30/2020,113020,82L-IMPORT PAYROLL-LEARY AUBREY,D108,HJ,1119.05,,2937328.91
6100,11/30/2020,11/30/2020,113020,82L-IMPORT PAYROLL-LI BELLA,D108,HJ,2486.25,,2939815.16
6100,11/30/2020,11/30/2020,113020,82L-IMPORT PAYROLL-LOUIE JORDAN,D108,HJ,1119.05,,2940934.21
6100,11/30/2020,11/30/2020,113020,82L-IMPORT PAYROLL-MELCHOR OSBEIDY,D108,HJ,1119.05,,2942053.26
6100,11/30/2020,11/30/2020,113020,82L-IMPORT PAYROLL-MORRIS ZAKIYA,D108,HJ,1119.05,,2943172.31
6100,11/30/2020,11/30/2020,113020,82L-IMPORT PAYROLL-MORSELETTO RAFAEL,D108,HJ,1119.05,,2944291.36
6100,11/30/2020,11/30/2020,113020,82L-IMPORT PAYROLL-OBI TOBECHUKWU,D108,HJ,1119.05,,2945410.41
6100,11/30/2020,11/30/2020,113020,82L-IMPORT PAYROLL-OPUH NDIDI,D108,HJ,2833.33,,2948243.74
6100,11/30/2020,11/30/2020,113020,82L-IMPORT PAYROLL-PAULINO THAIRI,D108,HJ,1119.05,,2949362.79
6100,11/30/2020,11/30/2020,113020,82L-IMPORT PAYROLL-ROSENBAUM MURRAY,D108,HJ,1119.05,,2950481.84
6100,11/30/2020,11/30/2020,113020,82L-IMPORT PAYROLL-SCHWETTMANN CLAIRE,D108,HJ,1119.05,,2951600.89
6100,11/30/2020,11/30/2020,113020,82L-IMPORT PAYROLL-SOBELMAN JUSTIN,D108,HJ,1119.05,,2952719.94
6100,11/30/2020,11/30/2020,113020,82L-IMPORT PAYROLL-TERRENCE-SMITH ZIHIR,D108,HJ,1119.05,,2953838.99
6100,11/30/2020,11/30/2020,113020,82L-IMPORT PAYROLL-TILLERY ASIA,D108,HJ,3291.67,,2957130.66
6100,11/30/2020,11/30/2020,113020,82L-IMPORT PAYROLL-WILLIAMS-MASSEY BRIANNA,D108,HJ,1119.05,,2958249.71
6100,11/30/2020,11/30/2020,113020,82L-IMPORT PAYROLL-XIAO CHENGYAO,D108,HJ,1119.05,,2959368.76
6100,11/30/2020,11/30/2020,113020,82L-IMPORT PAYROLL-ZIAUDDIN ABUTAHER,D108,HJ,1119.05,,2960487.81
6100,11/30/2020,11/30/2020,113020,82L-IMPORT PAYROLL-BALASUBRAMANIAN SHARANYA,D108,HJ,2666.67,,2963154.48
6100,11/30/2020,11/30/2020,113020,82L-IMPORT PAYROLL-COVENEY ALLISON,D108,HJ,2854.17,,2966008.65
6100,11/30/2020,11/30/2020,113020,82L-IMPORT PAYROLL-JACKSON CLAICE M,D108,HJ,1125,,2967133.65
6100,11/30/2020,11/30/2020,113020,82L-IMPORT PAYROLL-JACKSON CLAICE M,D108,HJ,2000,,2969133.65
6100,11/30/2020,11/30/2020,113020,82L-IMPORT PAYROLL-JANG DANIEL,D108,HJ,2750,,2971883.65
6100,11/30/2020,11/30/2020,113020,82L-IMPORT PAYROLL-LENEGHAN MARYELLEN,D108,HJ,940.71,,2972824.36
6100,11/30/2020,11/30/2020,113020,82L-IMPORT PAYROLL-LENEGHAN MARYELLEN,D108,HJ,1372.5,,2974196.86
6100,11/30/2020,11/30/2020,113020,82L-IMPORT PAYROLL-LENEGHAN MARYELLEN,D108,HJ,2440,,2976636.86
6100,11/30/2020,11/30/2020,202011,Adj to reallocate Salaries FICA and benefits from GM3 - ACY2 to G-BL-To reallocate Amena Wallance from GM3 - ACY2 to G-BL,D104,HJ,,4375,2972261.86
6100,11/30/2020,11/30/2020,202011,Adj to reallocate Salaries FICA and benefits from GM3 - ACY2 to G-BL-To reallocate Amena Wallance from GM3 - ACY2 to G-BL,D104,HJ,4375,,2976636.86
6100,11/30/2020,11/30/2020,202011,Adj to reallocate Salaries FICA and benefits from GM3 - ACY2 to G-BL-To reallocate J.Messing and T.Bibb salary from GM3 - ACY2 to G-BL,D104,HJ,,12750,2963886.86
6100,11/30/2020,11/30/2020,202011,Adj to reallocate Salaries FICA and benefits from GM3 - ACY2 to G-BL-To reallocate J.Messing and T.Bibb salary from GM3 - ACY2 to G-BL,D104,HJ,12750,,2976636.86
6100,12/15/2020,12/15/2020,121520,82L-IMPORT PAYROLL-BARTHELEMY RACHALIE,D108,HJ,1047.62,,2977684.48
6100,12/15/2020,12/15/2020,121520,82L-IMPORT PAYROLL-BASHAM WILLIAM EDWARD,D108,HJ,1047.62,,2978732.1
6100,12/15/2020,12/15/2020,121520,82L-IMPORT PAYROLL-BOHLSEN GRACE ISABELLE,D108,HJ,1047.62,,2979779.72
6100,12/15/2020,12/15/2020,121520,82L-IMPORT PAYROLL-BOLIVAR ANDREA,D108,HJ,2500,,2982279.72
6100,12/15/2020,12/15/2020,121520,82L-IMPORT PAYROLL-BORCHART SPENCER,D108,HJ,1047.62,,2983327.34
6100,12/15/2020,12/15/2020,121520,82L-IMPORT PAYROLL-BROWN ISAAC,D108,HJ,1047.62,,2984374.96
6100,12/15/2020,12/15/2020,121520,82L-IMPORT PAYROLL-BURKE MARIAH,D108,HJ,1047.62,,2985422.58
6100,12/15/2020,12/15/2020,121520,82L-IMPORT PAYROLL-CASSADY JOSHUA LEWIS,D108,HJ,1047.62,,2986470.2
6100,12/15/2020,12/15/2020,121520,82L-IMPORT PAYROLL-DARKO OLIVIA,D108,HJ,1047.62,,2987517.82
6100,12/15/2020,12/15/2020,121520,82L-IMPORT PAYROLL-DAWSON JAMIL NAFAYE-BEYAH,D108,HJ,1047.62,,2988565.44
6100,12/15/2020,12/15/2020,121520,82L-IMPORT PAYROLL-ESCAMILLA OLGA,D108,HJ,1047.62,,2989613.06
6100,12/15/2020,12/15/2020,121520,82L-IMPORT PAYROLL-GARCIA SANTIAGO,D108,HJ,2041.67,,2991654.73
6100,12/15/2020,12/15/2020,121520,82L-IMPORT PAYROLL-GILES SHAYLA,D108,HJ,1047.62,,2992702.35
6100,12/15/2020,12/15/2020,121520,82L-IMPORT PAYROLL-IKUNIKA FUNMILAYO,D108,HJ,2083.33,,2994785.68
6100,12/15/2020,12/15/2020,121520,82L-IMPORT PAYROLL-JONES JORDAN,D108,HJ,1047.62,,2995833.3
6100,12/15/2020,12/15/2020,121520,82L-IMPORT PAYROLL-KHAN HUDA,D108,HJ,1047.62,,2996880.92
6100,12/15/2020,12/15/2020,121520,82L-IMPORT PAYROLL-KLOHR TIMOTHY JORDAN,D108,HJ,2000,,2998880.92
6100,12/15/2020,12/15/2020,121520,82L-IMPORT PAYROLL-KNOWLIN ZYLIA,D108,HJ,2541.67,,3001422.59
6100,12/15/2020,12/15/2020,121520,82L-IMPORT PAYROLL-KOPSHEVER MELISSA,D108,HJ,2916.67,,3004339.26
6100,12/15/2020,12/15/2020,121520,82L-IMPORT PAYROLL-LI SEN YUAN,D108,HJ,1047.62,,3005386.88
6100,12/15/2020,12/15/2020,121520,82L-IMPORT PAYROLL-LIPSCOMB STEPHEN,D108,HJ,2541.67,,3007928.55
6100,12/15/2020,12/15/2020,121520,82L-IMPORT PAYROLL-MALLECK JESSICA R,D108,HJ,1047.62,,3008976.17
6100,12/15/2020,12/15/2020,121520,82L-IMPORT PAYROLL-MCLAUGHLIN MARA,D108,HJ,1047.62,,3010023.79
6100,12/15/2020,12/15/2020,121520,82L-IMPORT PAYROLL-MEJIA ROSO CARLOS,D108,HJ,1047.62,,3011071.41
6100,12/15/2020,12/15/2020,121520,82L-IMPORT PAYROLL-MONROY-MEJIA JASON,D108,HJ,1047.62,,3012119.03
6100,12/15/2020,12/15/2020,121520,82L-IMPORT PAYROLL-O'FLYNN-PRUITT NATHAN COLYAR,D108,HJ,1047.62,,3013166.65
6100,12/15/2020,12/15/2020,121520,82L-IMPORT PAYROLL-PATTERSON STEVE,D108,HJ,1047.62,,3014214.27
6100,12/15/2020,12/15/2020,121520,82L-IMPORT PAYROLL-SCHMIESS RACHEL JOY,D108,HJ,1047.62,,3015261.89
6100,12/15/2020,12/15/2020,121520,82L-IMPORT PAYROLL-SCOTT KIRK DONOVAN,D108,HJ,1047.62,,3016309.51
6100,12/15/2020,12/15/2020,121520,82L-IMPORT PAYROLL-SILVER KELLY,D108,HJ,2541.67,,3018851.18
6100,12/15/2020,12/15/2020,121520,82L-IMPORT PAYROLL-SOLIMAN MARK,D108,HJ,1047.62,,3019898.8
6100,12/15/2020,12/15/2020,121520,82L-IMPORT PAYROLL-STEIN KYLE,D108,HJ,2083.33,,3021982.13
6100,12/15/2020,12/15/2020,121520,82L-IMPORT PAYROLL-STROUD DAVID,D108,HJ,1047.62,,3023029.75
6100,12/15/2020,12/15/2020,121520,82L-IMPORT PAYROLL-VALCIN SABRINA JEMIMAH,D108,HJ,1047.62,,3024077.37
6100,12/15/2020,12/15/2020,121520,82L-IMPORT PAYROLL-VALDES ERNEST L,D108,HJ,1047.62,,3025124.99
6100,12/15/2020,12/15/2020,121520,82L-IMPORT PAYROLL-WILLIAMS MACK ANTHONY,D108,HJ,1047.62,,3026172.61
6100,12/15/2020,12/15/2020,121520,82L-IMPORT PAYROLL-WILLIAMS MIL'YONTA,D108,HJ,1047.62,,3027220.23
6100,12/15/2020,12/15/2020,121520,82L-IMPORT PAYROLL-ANTHONY BETTY S,D108,HJ,2886.52,,3030106.75
6100,12/15/2020,12/15/2020,121520,82L-IMPORT PAYROLL-APULI LINDSAY,D108,HJ,2500,,3032606.75
6100,12/15/2020,12/15/2020,121520,82L-IMPORT PAYROLL-AUSTIN PERCY ANTONIO,D108,HJ,2653.02,,3035259.77
6100,12/15/2020,12/15/2020,121520,82L-IMPORT PAYROLL-BUHMANN JENNIFER,D108,HJ,2270.83,,3037530.6
6100,12/15/2020,12/15/2020,121520,82L-IMPORT PAYROLL-CAIN CORY,D108,HJ,2708.33,,3040238.93
6100,12/15/2020,12/15/2020,121520,82L-IMPORT PAYROLL-CHAPMAN CLAUDY EARL,D108,HJ,2291.67,,3042530.6
6100,12/15/2020,12/15/2020,121520,82L-IMPORT PAYROLL-CHAPMAN CLAUDY EARL,D108,HJ,4583.4,,3047114
6100,12/15/2020,12/15/2020,121520,82L-IMPORT PAYROLL-DADA ARIKPO E,D108,HJ,2720,,3049834
6100,12/15/2020,12/15/2020,121520,82L-IMPORT PAYROLL-GUTHRIE LESLIE,D108,HJ,2458.33,,3052292.33
6100,12/15/2020,12/15/2020,121520,82L-IMPORT PAYROLL-HOLMES JOREL ALEXANDER,D108,HJ,2329,,3054621.33
6100,12/15/2020,12/15/2020,121520,82L-IMPORT PAYROLL-JORDAN TIFFANY T,D108,HJ,3445,,3058066.33
6100,12/15/2020,12/15/2020,121520,82L-IMPORT PAYROLL-LANIGAN LISA A,D108,HJ,3113.75,,3061180.08
6100,12/15/2020,12/15/2020,121520,82L-IMPORT PAYROLL-MCELWEE MELISSA,D108,HJ,2666.67,,3063846.75
6100,12/15/2020,12/15/2020,121520,82L-IMPORT PAYROLL-MCNICHOLAS MARY,D108,HJ,2291.67,,3066138.42
6100,12/15/2020,12/15/2020,121520,82L-IMPORT PAYROLL-NWAKANMA NANCY,D108,HJ,3046.67,,3069185.09
6100,12/15/2020,12/15/2020,121520,82L-IMPORT PAYROLL-ONICA ANTHONY J,D108,HJ,2416.67,,3071601.76
6100,12/15/2020,12/15/2020,121520,82L-IMPORT PAYROLL-PRAHIN NICOLE M,D108,HJ,3812.5,,3075414.26
6100,12/15/2020,12/15/2020,121520,82L-IMPORT PAYROLL-RIVERS QUIONNA DIANE,D108,HJ,2708.34,,3078122.6
6100,12/15/2020,12/15/2020,121520,82L-IMPORT PAYROLL-SALIM YASSER,D108,HJ,2431.94,,3080554.54
6100,12/15/2020,12/15/2020,121520,82L-IMPORT PAYROLL-SEJOUR MAHALIAH,D108,HJ,2500,,3083054.54
6100,12/15/2020,12/15/2020,121520,82L-IMPORT PAYROLL-SKALSKI CHRISTOPHER,D108,HJ,2465,,3085519.54
6100,12/15/2020,12/15/2020,121520,82L-IMPORT PAYROLL-TUMENJARGAL ENKHJIN,D108,HJ,2414,,3087933.54
6100,12/15/2020,12/15/2020,121520,82L-IMPORT PAYROLL-VILLEGAS EVELYN,D108,HJ,2817.75,,3090751.29
6100,12/15/2020,12/15/2020,121520,82L-IMPORT PAYROLL-WOLF ANNA A,D108,HJ,2635,,3093386.29
6100,12/15/2020,12/15/2020,121520,82L-IMPORT PAYROLL-ACEVEDO MONIVETT,D107,HJ,488.64,,3093874.93
6100,12/15/2020,12/15/2020,121520,82L-IMPORT PAYROLL-ACEVEDO MONIVETT,D107,HJ,4886.36,,3098761.29
6100,12/15/2020,12/15/2020,121520,82L-IMPORT PAYROLL-AKLESTAD ISABEL,D111,HJ,1750,,3100511.29
6100,12/15/2020,12/15/2020,121520,82L-IMPORT PAYROLL-BIBB TIFFANI,D104,HJ,3875,,3104386.29
6100,12/15/2020,12/15/2020,121520,82L-IMPORT PAYROLL-BOWMAN HALLEY K,D101,HJ,3222.38,,3107608.67
6100,12/15/2020,12/15/2020,121520,82L-IMPORT PAYROLL-COOK CATHRYN ANNA,D105,HJ,3593.03,,3111201.7
6100,12/15/2020,12/15/2020,121520,82L-IMPORT PAYROLL-COOPER ASHLEE R,D101,HJ,2461.88,,3113663.58
6100,12/15/2020,12/15/2020,121520,82L-IMPORT PAYROLL-CORTEZ MIRANDA A,D111,HJ,2672.72,,3116336.3
6100,12/15/2020,12/15/2020,121520,82L-IMPORT PAYROLL-DAUGHERTY DEVIN W,D101,HJ,1041.67,,3117377.97
6100,12/15/2020,12/15/2020,121520,82L-IMPORT PAYROLL-DETONE KYRA MAYA,D102,HJ,2916.67,,3120294.64
6100,12/15/2020,12/15/2020,121520,82L-IMPORT PAYROLL-DUPUIS CHRISTOPHER M,D107,HJ,2850.38,,3123145.02
6100,12/15/2020,12/15/2020,121520,82L-IMPORT PAYROLL-DUPUIS CHRISTOPHER M,D107,HJ,3420.45,,3126565.47
6100,12/15/2020,12/15/2020,121520,82L-IMPORT PAYROLL-DZIEDZIC JULIE K,D101,HJ,1250,,3127815.47
6100,12/15/2020,12/15/2020,121520,82L-IMPORT PAYROLL-FISCHABER THOMAS,D109,HJ,439.65,,3128255.12
6100,12/15/2020,12/15/2020,121520,82L-IMPORT PAYROLL-FISCHABER THOMAS,D109,HJ,5416.67,,3133671.79
6100,12/15/2020,12/15/2020,121520,82L-IMPORT PAYROLL-FLORY MEGAN,D109,HJ,1500,,3135171.79
6100,12/15/2020,12/15/2020,121520,82L-IMPORT PAYROLL-GORNSTEIN STEVEN,D101,HJ,2708.33,,3137880.12
6100,12/15/2020,12/15/2020,121520,82L-IMPORT PAYROLL-GUADARRAMA-ALVAREZ URIEL A,D105,HJ,2897.92,,3140778.04
6100,12/15/2020,12/15/2020,121520,82L-IMPORT PAYROLL-GUTIERREZ ANTONIO J,D107,HJ,1658.14,,3142436.18
6100,12/15/2020,12/15/2020,121520,82L-IMPORT PAYROLL-GUTIERREZ ANTONIO J,D107,HJ,2070.16,,3144506.34
6100,12/15/2020,12/15/2020,121520,82L-IMPORT PAYROLL-GUTIERREZ ANTONIO J,D107,HJ,3622.78,,3148129.12
6100,12/15/2020,12/15/2020,121520,82L-IMPORT PAYROLL-GUTIERREZ ANTONIO J,D107,HJ,9285.57,,3157414.69
6100,12/15/2020,12/15/2020,121520,82L-IMPORT PAYROLL-HENRY GILLIAN,D102,HJ,2083.34,,3159498.03
6100,12/15/2020,12/15/2020,121520,82L-IMPORT PAYROLL-HERMAN ADAM,D102,HJ,1958.33,,3161456.36
6100,12/15/2020,12/15/2020,121520,82L-IMPORT PAYROLL-HESTER TYLER CONRAD,D105,HJ,1916.67,,3163373.03
6100,12/15/2020,12/15/2020,121520,82L-IMPORT PAYROLL-HOLT ADAM,D109,HJ,153.53,,3163526.56
6100,12/15/2020,12/15/2020,121520,82L-IMPORT PAYROLL-HOLT ADAM,D109,HJ,4166.67,,3167693.23
6100,12/15/2020,12/15/2020,121520,82L-IMPORT PAYROLL-KELLY SEAN,D109,HJ,5416.67,,3173109.9
6100,12/15/2020,12/15/2020,121520,82L-IMPORT PAYROLL-KRUGER MARK,D109,HJ,5000,,3178109.9
6100,12/15/2020,12/15/2020,121520,82L-IMPORT PAYROLL-LIPORACE HERNAN LUIS,D103,HJ,2291.67,,3180401.57
6100,12/15/2020,12/15/2020,121520,82L-IMPORT PAYROLL-MARKS KRISTA,D109,HJ,153.53,,3180555.1
6100,12/15/2020,12/15/2020,121520,82L-IMPORT PAYROLL-MARKS KRISTA,D109,HJ,5416.67,,3185971.77
6100,12/15/2020,12/15/2020,121520,82L-IMPORT PAYROLL-MELVIN DARNELL KEVIN,D109,HJ,4000,,3189971.77
6100,12/15/2020,12/15/2020,121520,82L-IMPORT PAYROLL-MESSING JENNIFER,D109,HJ,2500,,3192471.77
6100,12/15/2020,12/15/2020,121520,82L-IMPORT PAYROLL-MILNE ROGER,D109,HJ,150.66,,3192622.43
6100,12/15/2020,12/15/2020,121520,82L-IMPORT PAYROLL-MILNE ROGER,D109,HJ,5416.67,,3198039.1
6100,12/15/2020,12/15/2020,121520,82L-IMPORT PAYROLL-MOSTAFAVI YASAMAN,D109,HJ,808.5,,3198847.6
6100,12/15/2020,12/15/2020,121520,82L-IMPORT PAYROLL-O'DONNELL STEPHEN,D104,HJ,2707.5,,3201555.1
6100,12/15/2020,12/15/2020,121520,82L-IMPORT PAYROLL-PARETS MALLORY GRACE,D101,HJ,2833.33,,3204388.43
6100,12/15/2020,12/15/2020,121520,82L-IMPORT PAYROLL-PARHAM-GANTT DENISE M,D112,HJ,3041.67,,3207430.1
6100,12/15/2020,12/15/2020,121520,82L-IMPORT PAYROLL-PEINADO ELIZABETH R,D111,HJ,3749.96,,3211180.06
6100,12/15/2020,12/15/2020,121520,82L-IMPORT PAYROLL-PERNIA JEFFREY,D109,HJ,146.72,,3211326.78
6100,12/15/2020,12/15/2020,121520,82L-IMPORT PAYROLL-PERNIA JEFFREY,D109,HJ,3875,,3215201.78
6100,12/15/2020,12/15/2020,121520,82L-IMPORT PAYROLL-POLANCO ODALIS,D103,HJ,3124.96,,3218326.74
6100,12/15/2020,12/15/2020,121520,82L-IMPORT PAYROLL-QUINTAS JASHIVE,D105,HJ,1916.67,,3220243.41
6100,12/15/2020,12/15/2020,121520,82L-IMPORT PAYROLL-RANDOLPH ALEXANDER,D111,HJ,1875,,3222118.41
6100,12/15/2020,12/15/2020,121520,82L-IMPORT PAYROLL-RUBI PERLA,D101,HJ,326.85,,3222445.26
6100,12/15/2020,12/15/2020,121520,82L-IMPORT PAYROLL-RUBI PERLA,D101,HJ,923.15,,3223368.41
6100,12/15/2020,12/15/2020,121520,82L-IMPORT PAYROLL-SAFRAN ALAN P,D107,HJ,703.85,,3224072.26
6100,12/15/2020,12/15/2020,121520,82L-IMPORT PAYROLL-SAFRAN ALAN P,D107,HJ,2255.06,,3226327.32
6100,12/15/2020,12/15/2020,121520,82L-IMPORT PAYROLL-SAFRAN ALAN P,D107,HJ,7038.54,,3233365.86
6100,12/15/2020,12/15/2020,121520,82L-IMPORT PAYROLL-SAFRAN ALAN P,D107,HJ,12628.35,,3245994.21
6100,12/15/2020,12/15/2020,121520,82L-IMPORT PAYROLL-SHENKMAN OLIVIA,D101,HJ,2000,,3247994.21
6100,12/15/2020,12/15/2020,121520,82L-IMPORT PAYROLL-SHI GRACE,D103,HJ,875,,3248869.21
6100,12/15/2020,12/15/2020,121520,82L-IMPORT PAYROLL-WALLACE AMENA,D104,HJ,2187.5,,3251056.71
6100,12/15/2020,12/15/2020,121520,82L-IMPORT PAYROLL-WARD JEFFREY,D109,HJ,439.65,,3251496.36
6100,12/15/2020,12/15/2020,121520,82L-IMPORT PAYROLL-WARD JEFFREY,D109,HJ,5416.67,,3256913.03
6100,12/15/2020,12/15/2020,121520,82L-IMPORT PAYROLL-WARD JENNIFER,D109,HJ,1057.59,,3257970.62
6100,12/15/2020,12/15/2020,121520,82L-IMPORT PAYROLL-WEINSTOCK EMILY,D101,HJ,2833.33,,3260803.95
6100,12/15/2020,12/15/2020,121520,82L-IMPORT PAYROLL-WINANS JENNIFER,D111,HJ,2505.63,,3263309.58
6100,12/15/2020,12/15/2020,121520,82L-IMPORT PAYROLL-ZARATE JOSEPH M,D105,HJ,2150,,3265459.58
6100,12/15/2020,12/15/2020,121520,82L-IMPORT PAYROLL-AGUANNO JOSEPH,D108,HJ,1119.05,,3266578.63
6100,12/15/2020,12/15/2020,121520,82L-IMPORT PAYROLL-AKESODE FEHINTOLA,D108,HJ,1119.05,,3267697.68
6100,12/15/2020,12/15/2020,121520,82L-IMPORT PAYROLL-BARTOLD DEANNA MARIE,D108,HJ,3034.5,,3270732.18
6100,12/15/2020,12/15/2020,121520,82L-IMPORT PAYROLL-BELLOT GENESIS,D108,HJ,2500,,3273232.18
6100,12/15/2020,12/15/2020,121520,82L-IMPORT PAYROLL-BENNETT JAMES H,D108,HJ,1119.05,,3274351.23
6100,12/15/2020,12/15/2020,121520,82L-IMPORT PAYROLL-BOWMAN ABIGAIL,D108,HJ,1119.05,,3275470.28
6100,12/15/2020,12/15/2020,121520,82L-IMPORT PAYROLL-BURRELL RUSSELL,D108,HJ,1119.05,,3276589.33
6100,12/15/2020,12/15/2020,121520,82L-IMPORT PAYROLL-CHUI KENT,D108,HJ,1119.05,,3277708.38
6100,12/15/2020,12/15/2020,121520,82L-IMPORT PAYROLL-CIRKER MIA,D108,HJ,2250,,3279958.38
6100,12/15/2020,12/15/2020,121520,82L-IMPORT PAYROLL-DEWS CAMERYN,D108,HJ,2291.67,,3282250.05
6100,12/15/2020,12/15/2020,121520,82L-IMPORT PAYROLL-DIETZ MARY,D108,HJ,1119.05,,3283369.1
6100,12/15/2020,12/15/2020,121520,82L-IMPORT PAYROLL-DOMINIQUE PRINCESSA,D108,HJ,1119.05,,3284488.15
6100,12/15/2020,12/15/2020,121520,82L-IMPORT PAYROLL-DONNELLY HOME,D108,HJ,1119.05,,3285607.2
6100,12/15/2020,12/15/2020,121520,82L-IMPORT PAYROLL-FEIGHERY JOHN,D108,HJ,2250,,3287857.2
6100,12/15/2020,12/15/2020,121520,82L-IMPORT PAYROLL-FORTH KYLE,D108,HJ,1119.05,,3288976.25
6100,12/15/2020,12/15/2020,121520,82L-IMPORT PAYROLL-GARCIA MARILYN,D108,HJ,2291.67,,3291267.92
6100,12/15/2020,12/15/2020,121520,82L-IMPORT PAYROLL-GREENE BROOKE,D108,HJ,1119.05,,3292386.97
6100,12/15/2020,12/15/2020,121520,82L-IMPORT PAYROLL-GRIFFIN ANDREW,D108,HJ,2250,,3294636.97
6100,12/15/2020,12/15/2020,121520,82L-IMPORT PAYROLL-GROSS EMILY,D108,HJ,1119.05,,3295756.02
6100,12/15/2020,12/15/2020,121520,82L-IMPORT PAYROLL-GUERRERO LUIS,D108,HJ,1119.05,,3296875.07
6100,12/15/2020,12/15/2020,121520,82L-IMPORT PAYROLL-HALLINAN GABRIEL,D108,HJ,2550,,3299425.07
6100,12/15/2020,12/15/2020,121520,82L-IMPORT PAYROLL-HAMERSLY WILLIAM,D108,HJ,2500,,3301925.07
6100,12/15/2020,12/15/2020,121520,82L-IMPORT PAYROLL-HOSSAIN MYESHA,D108,HJ,2437.5,,3304362.57
6100,12/15/2020,12/15/2020,121520,82L-IMPORT PAYROLL-JACKSON TASNIM F,D108,HJ,2291.67,,3306654.24
6100,12/15/2020,12/15/2020,121520,82L-IMPORT PAYROLL-KERKHOFF HARPER FAITH,D108,HJ,1119.05,,3307773.29
6100,12/15/2020,12/15/2020,121520,82L-IMPORT PAYROLL-LEARY AUBREY,D108,HJ,1119.05,,3308892.34
6100,12/15/2020,12/15/2020,121520,82L-IMPORT PAYROLL-LI BELLA,D108,HJ,2486.25,,3311378.59
6100,12/15/2020,12/15/2020,121520,82L-IMPORT PAYROLL-LOUIE JORDAN,D108,HJ,1119.05,,3312497.64
6100,12/15/2020,12/15/2020,121520,82L-IMPORT PAYROLL-MELCHOR OSBEIDY,D108,HJ,1119.05,,3313616.69
6100,12/15/2020,12/15/2020,121520,82L-IMPORT PAYROLL-MORRIS ZAKIYA,D108,HJ,1119.05,,3314735.74
6100,12/15/2020,12/15/2020,121520,82L-IMPORT PAYROLL-MORSELETTO RAFAEL,D108,HJ,1119.05,,3315854.79
6100,12/15/2020,12/15/2020,121520,82L-IMPORT PAYROLL-OBI TOBECHUKWU,D108,HJ,1119.05,,3316973.84
6100,12/15/2020,12/15/2020,121520,82L-IMPORT PAYROLL-OPUH NDIDI,D108,HJ,2833.33,,3319807.17
6100,12/15/2020,12/15/2020,121520,82L-IMPORT PAYROLL-PAULINO THAIRI,D108,HJ,1119.05,,3320926.22
6100,12/15/2020,12/15/2020,121520,82L-IMPORT PAYROLL-REYES LATIVA M,D108,HJ,2463.37,,3323389.59
6100,12/15/2020,12/15/2020,121520,82L-IMPORT PAYROLL-ROSENBAUM MURRAY,D108,HJ,1119.05,,3324508.64
6100,12/15/2020,12/15/2020,121520,82L-IMPORT PAYROLL-SCHWETTMANN CLAIRE,D108,HJ,1119.05,,3325627.69
6100,12/15/2020,12/15/2020,121520,82L-IMPORT PAYROLL-SOBELMAN JUSTIN,D108,HJ,1119.05,,3326746.74
6100,12/15/2020,12/15/2020,121520,82L-IMPORT PAYROLL-TERRENCE-SMITH ZIHIR,D108,HJ,1119.05,,3327865.79
6100,12/15/2020,12/15/2020,121520,82L-IMPORT PAYROLL-TILLERY ASIA,D108,HJ,3291.67,,3331157.46
6100,12/15/2020,12/15/2020,121520,82L-IMPORT PAYROLL-WILLIAMS-MASSEY BRIANNA,D108,HJ,1119.05,,3332276.51
6100,12/15/2020,12/15/2020,121520,82L-IMPORT PAYROLL-XIAO CHENGYAO,D108,HJ,1119.05,,3333395.56
6100,12/15/2020,12/15/2020,121520,82L-IMPORT PAYROLL-ZIAUDDIN ABUTAHER,D108,HJ,1119.05,,3334514.61
6100,12/15/2020,12/15/2020,121520,82L-IMPORT PAYROLL-BALASUBRAMANIAN SHARANYA,D108,HJ,2666.67,,3337181.28
6100,12/15/2020,12/15/2020,121520,82L-IMPORT PAYROLL-COVENEY ALLISON,D108,HJ,2854.17,,3340035.45
6100,12/15/2020,12/15/2020,121520,82L-IMPORT PAYROLL-JACKSON CLAICE M,D108,HJ,3125,,3343160.45
6100,12/15/2020,12/15/2020,121520,82L-IMPORT PAYROLL-JANG DANIEL,D108,HJ,2750,,3345910.45
6100,12/15/2020,12/15/2020,121520,82L-IMPORT PAYROLL-LENEGHAN MARYELLEN,D108,HJ,940.71,,3346851.16
6100,12/15/2020,12/15/2020,121520,82L-IMPORT PAYROLL-LENEGHAN MARYELLEN,D108,HJ,1732.95,,3348584.11
6100,12/15/2020,12/15/2020,121520,82L-IMPORT PAYROLL-LENEGHAN MARYELLEN,D108,HJ,2079.55,,3350663.66
6100,12/31/2020,12/31/2020,123120,82L-IMPORT PAYROLL-BARTHELEMY RACHALIE,D108,HJ,250,,3350913.66
6100,12/31/2020,12/31/2020,123120,82L-IMPORT PAYROLL-BARTHELEMY RACHALIE,D108,HJ,1047.62,,3351961.28
6100,12/31/2020,12/31/2020,123120,82L-IMPORT PAYROLL-BASHAM WILLIAM EDWARD,D108,HJ,1047.62,,3353008.9
6100,12/31/2020,12/31/2020,123120,82L-IMPORT PAYROLL-BOHLSEN GRACE ISABELLE,D108,HJ,1047.62,,3354056.52
6100,12/31/2020,12/31/2020,123120,82L-IMPORT PAYROLL-BOLIVAR ANDREA,D108,HJ,2500,,3356556.52
6100,12/31/2020,12/31/2020,123120,82L-IMPORT PAYROLL-BORCHART SPENCER,D108,HJ,1047.62,,3357604.14
6100,12/31/2020,12/31/2020,123120,82L-IMPORT PAYROLL-BROWN ISAAC,D108,HJ,1047.62,,3358651.76
6100,12/31/2020,12/31/2020,123120,82L-IMPORT PAYROLL-BURKE MARIAH,D108,HJ,1047.62,,3359699.38
6100,12/31/2020,12/31/2020,123120,82L-IMPORT PAYROLL-CASSADY JOSHUA LEWIS,D108,HJ,1047.62,,3360747
6100,12/31/2020,12/31/2020,123120,82L-IMPORT PAYROLL-DARKO OLIVIA,D108,HJ,250,,3360997
6100,12/31/2020,12/31/2020,123120,82L-IMPORT PAYROLL-DARKO OLIVIA,D108,HJ,1047.62,,3362044.62
6100,12/31/2020,12/31/2020,123120,82L-IMPORT PAYROLL-DAWSON JAMIL NAFAYE-BEYAH,D108,HJ,1047.62,,3363092.24
6100,12/31/2020,12/31/2020,123120,82L-IMPORT PAYROLL-ESCAMILLA OLGA,D108,HJ,1047.62,,3364139.86
6100,12/31/2020,12/31/2020,123120,82L-IMPORT PAYROLL-GARCIA SANTIAGO,D108,HJ,2041.67,,3366181.53
6100,12/31/2020,12/31/2020,123120,82L-IMPORT PAYROLL-GILES SHAYLA,D108,HJ,1047.62,,3367229.15
6100,12/31/2020,12/31/2020,123120,82L-IMPORT PAYROLL-IKUNIKA FUNMILAYO,D108,HJ,2083.33,,3369312.48
6100,12/31/2020,12/31/2020,123120,82L-IMPORT PAYROLL-JONES JORDAN,D108,HJ,1047.62,,3370360.1
6100,12/31/2020,12/31/2020,123120,82L-IMPORT PAYROLL-KHAN HUDA,D108,HJ,250,,3370610.1
6100,12/31/2020,12/31/2020,123120,82L-IMPORT PAYROLL-KHAN HUDA,D108,HJ,1047.62,,3371657.72
6100,12/31/2020,12/31/2020,123120,82L-IMPORT PAYROLL-KLOHR TIMOTHY JORDAN,D108,HJ,2000,,3373657.72
6100,12/31/2020,12/31/2020,123120,82L-IMPORT PAYROLL-KNOWLIN ZYLIA,D108,HJ,2541.67,,3376199.39
6100,12/31/2020,12/31/2020,123120,82L-IMPORT PAYROLL-KOPSHEVER MELISSA,D108,HJ,1666.66,,3377866.05
6100,12/31/2020,12/31/2020,123120,82L-IMPORT PAYROLL-KOPSHEVER MELISSA,D108,HJ,2916.67,,3380782.72
6100,12/31/2020,12/31/2020,123120,82L-IMPORT PAYROLL-LI SEN YUAN,D108,HJ,1047.62,,3381830.34
6100,12/31/2020,12/31/2020,123120,82L-IMPORT PAYROLL-LIPSCOMB STEPHEN,D108,HJ,2541.67,,3384372.01
6100,12/31/2020,12/31/2020,123120,82L-IMPORT PAYROLL-MALLECK JESSICA R,D108,HJ,1047.62,,3385419.63
6100,12/31/2020,12/31/2020,123120,82L-IMPORT PAYROLL-MCLAUGHLIN MARA,D108,HJ,1047.62,,3386467.25
6100,12/31/2020,12/31/2020,123120,82L-IMPORT PAYROLL-MEJIA ROSO CARLOS,D108,HJ,1047.62,,3387514.87
6100,12/31/2020,12/31/2020,123120,82L-IMPORT PAYROLL-MONROY-MEJIA JASON,D108,HJ,1047.62,,3388562.49
6100,12/31/2020,12/31/2020,123120,82L-IMPORT PAYROLL-O'FLYNN-PRUITT NATHAN COLYAR,D108,HJ,1047.62,,3389610.11
6100,12/31/2020,12/31/2020,123120,82L-IMPORT PAYROLL-PATTERSON STEVE,D108,HJ,250,,3389860.11
6100,12/31/2020,12/31/2020,123120,82L-IMPORT PAYROLL-PATTERSON STEVE,D108,HJ,1047.62,,3390907.73
6100,12/31/2020,12/31/2020,123120,82L-IMPORT PAYROLL-SCHMIESS RACHEL JOY,D108,HJ,250,,3391157.73
6100,12/31/2020,12/31/2020,123120,82L-IMPORT PAYROLL-SCHMIESS RACHEL JOY,D108,HJ,1047.62,,3392205.35
6100,12/31/2020,12/31/2020,123120,82L-IMPORT PAYROLL-SCOTT KIRK DONOVAN,D108,HJ,1047.62,,3393252.97
6100,12/31/2020,12/31/2020,123120,82L-IMPORT PAYROLL-SILVER KELLY,D108,HJ,2541.67,,3395794.64
6100,12/31/2020,12/31/2020,123120,82L-IMPORT PAYROLL-SOLIMAN MARK,D108,HJ,1047.62,,3396842.26
6100,12/31/2020,12/31/2020,123120,82L-IMPORT PAYROLL-STEIN KYLE,D108,HJ,2083.33,,3398925.59
6100,12/31/2020,12/31/2020,123120,82L-IMPORT PAYROLL-STROUD DAVID,D108,HJ,250,,3399175.59
6100,12/31/2020,12/31/2020,123120,82L-IMPORT PAYROLL-STROUD DAVID,D108,HJ,1047.62,,3400223.21
6100,12/31/2020,12/31/2020,123120,82L-IMPORT PAYROLL-VALCIN SABRINA JEMIMAH,D108,HJ,1047.62,,3401270.83
6100,12/31/2020,12/31/2020,123120,82L-IMPORT PAYROLL-VALDES ERNEST L,D108,HJ,1047.62,,3402318.45
6100,12/31/2020,12/31/2020,123120,82L-IMPORT PAYROLL-WILLIAMS MACK ANTHONY,D108,HJ,1047.62,,3403366.07
6100,12/31/2020,12/31/2020,123120,82L-IMPORT PAYROLL-WILLIAMS MIL'YONTA,D108,HJ,1047.62,,3404413.69
6100,12/31/2020,12/31/2020,123120,82L-IMPORT PAYROLL-ANTHONY BETTY S,D108,HJ,2886.52,,3407300.21
6100,12/31/2020,12/31/2020,123120,82L-IMPORT PAYROLL-APULI LINDSAY,D108,HJ,2500,,3409800.21
6100,12/31/2020,12/31/2020,123120,82L-IMPORT PAYROLL-AUSTIN PERCY ANTONIO,D108,HJ,2653.02,,3412453.23
6100,12/31/2020,12/31/2020,123120,82L-IMPORT PAYROLL-BUHMANN JENNIFER,D108,HJ,2270.83,,3414724.06
6100,12/31/2020,12/31/2020,123120,82L-IMPORT PAYROLL-CAIN CORY,D108,HJ,2708.33,,3417432.39
6100,12/31/2020,12/31/2020,123120,82L-IMPORT PAYROLL-CHAPMAN CLAUDY EARL,D108,HJ,2291.67,,3419724.06
6100,12/31/2020,12/31/2020,123120,82L-IMPORT PAYROLL-DADA ARIKPO E,D108,HJ,2720,,3422444.06
6100,12/31/2020,12/31/2020,123120,82L-IMPORT PAYROLL-GUTHRIE LESLIE,D108,HJ,2458.33,,3424902.39
6100,12/31/2020,12/31/2020,123120,82L-IMPORT PAYROLL-HOLMES JOREL ALEXANDER,D108,HJ,2329,,3427231.39
6100,12/31/2020,12/31/2020,123120,82L-IMPORT PAYROLL-JORDAN TIFFANY T,D108,HJ,3445,,3430676.39
6100,12/31/2020,12/31/2020,123120,82L-IMPORT PAYROLL-LANIGAN LISA A,D108,HJ,3113.75,,3433790.14
6100,12/31/2020,12/31/2020,123120,82L-IMPORT PAYROLL-MCELWEE MELISSA,D108,HJ,2666.67,,3436456.81
6100,12/31/2020,12/31/2020,123120,82L-IMPORT PAYROLL-MCNICHOLAS MARY,D108,HJ,2291.67,,3438748.48
6100,12/31/2020,12/31/2020,123120,82L-IMPORT PAYROLL-NWAKANMA NANCY,D108,HJ,3046.67,,3441795.15
6100,12/31/2020,12/31/2020,123120,82L-IMPORT PAYROLL-ONICA ANTHONY J,D108,HJ,2416.67,,3444211.82
6100,12/31/2020,12/31/2020,123120,82L-IMPORT PAYROLL-PRAHIN NICOLE M,D108,HJ,3812.5,,3448024.32
6100,12/31/2020,12/31/2020,123120,82L-IMPORT PAYROLL-RIVERS QUIONNA DIANE,D108,HJ,2708.34,,3450732.66
6100,12/31/2020,12/31/2020,123120,82L-IMPORT PAYROLL-SALIM YASSER,D108,HJ,2431.94,,3453164.6
6100,12/31/2020,12/31/2020,123120,82L-IMPORT PAYROLL-SEJOUR MAHALIAH,D108,HJ,2500,,3455664.6
6100,12/31/2020,12/31/2020,123120,82L-IMPORT PAYROLL-SKALSKI CHRISTOPHER,D108,HJ,2465,,3458129.6
6100,12/31/2020,12/31/2020,123120,82L-IMPORT PAYROLL-TUMENJARGAL ENKHJIN,D108,HJ,2414,,3460543.6
6100,12/31/2020,12/31/2020,123120,82L-IMPORT PAYROLL-VILLEGAS EVELYN,D108,HJ,2817.75,,3463361.35
6100,12/31/2020,12/31/2020,123120,82L-IMPORT PAYROLL-WOLF ANNA A,D108,HJ,2635,,3465996.35
6100,12/31/2020,12/31/2020,123120,82L-IMPORT PAYROLL-ACEVEDO MONIVETT,D107,HJ,430,,3466426.35
6100,12/31/2020,12/31/2020,123120,82L-IMPORT PAYROLL-ACEVEDO MONIVETT,D107,HJ,4945,,3471371.35
6100,12/31/2020,12/31/2020,123120,82L-IMPORT PAYROLL-AKLESTAD ISABEL,D111,HJ,50,,3471421.35
6100,12/31/2020,12/31/2020,123120,82L-IMPORT PAYROLL-AKLESTAD ISABEL,D111,HJ,1750,,3473171.35
6100,12/31/2020,12/31/2020,123120,82L-IMPORT PAYROLL-BIBB TIFFANI,D104,HJ,3875,,3477046.35
6100,12/31/2020,12/31/2020,123120,82L-IMPORT PAYROLL-BOWMAN HALLEY K,D101,HJ,4402.26,,3481448.61
6100,12/31/2020,12/31/2020,123120,82L-IMPORT PAYROLL-COOK CATHRYN ANNA,D105,HJ,3593.03,,3485041.64
6100,12/31/2020,12/31/2020,123120,82L-IMPORT PAYROLL-COOPER ASHLEE R,D101,HJ,2461.88,,3487503.52
6100,12/31/2020,12/31/2020,123120,82L-IMPORT PAYROLL-CORTEZ MIRANDA A,D111,HJ,50,,3487553.52
6100,12/31/2020,12/31/2020,123120,82L-IMPORT PAYROLL-CORTEZ MIRANDA A,D111,HJ,2672.72,,3490226.24
6100,12/31/2020,12/31/2020,123120,82L-IMPORT PAYROLL-DAUGHERTY DEVIN W,D101,HJ,1041.67,,3491267.91
6100,12/31/2020,12/31/2020,123120,82L-IMPORT PAYROLL-DETONE KYRA MAYA,D102,HJ,2916.67,,3494184.58
6100,12/31/2020,12/31/2020,123120,82L-IMPORT PAYROLL-DUPUIS CHRISTOPHER M,D107,HJ,1505,,3495689.58
6100,12/31/2020,12/31/2020,123120,82L-IMPORT PAYROLL-DUPUIS CHRISTOPHER M,D107,HJ,4765.83,,3500455.41
6100,12/31/2020,12/31/2020,123120,82L-IMPORT PAYROLL-DZIEDZIC JULIE K,D101,HJ,1250,,3501705.41
6100,12/31/2020,12/31/2020,123120,82L-IMPORT PAYROLL-FISCHABER THOMAS,D109,HJ,439.65,,3502145.06
6100,12/31/2020,12/31/2020,123120,82L-IMPORT PAYROLL-FISCHABER THOMAS,D109,HJ,5416.67,,3507561.73
6100,12/31/2020,12/31/2020,123120,82L-IMPORT PAYROLL-FLORY MEGAN,D109,HJ,1500,,3509061.73
6100,12/31/2020,12/31/2020,123120,82L-IMPORT PAYROLL-GORNSTEIN STEVEN,D101,HJ,2708.33,,3511770.06
6100,12/31/2020,12/31/2020,123120,82L-IMPORT PAYROLL-GUADARRAMA-ALVAREZ URIEL A,D105,HJ,2897.92,,3514667.98
6100,12/31/2020,12/31/2020,123120,82L-IMPORT PAYROLL-GUTIERREZ ANTONIO J,D107,HJ,5692.94,,3520360.92
6100,12/31/2020,12/31/2020,123120,82L-IMPORT PAYROLL-HENRY GILLIAN,D102,HJ,2083.34,,3522444.26
6100,12/31/2020,12/31/2020,123120,82L-IMPORT PAYROLL-HERMAN ADAM,D102,HJ,1958.33,,3524402.59
6100,12/31/2020,12/31/2020,123120,82L-IMPORT PAYROLL-HESTER TYLER CONRAD,D105,HJ,1916.67,,3526319.26
6100,12/31/2020,12/31/2020,123120,82L-IMPORT PAYROLL-HOLT ADAM,D109,HJ,153.53,,3526472.79
6100,12/31/2020,12/31/2020,123120,82L-IMPORT PAYROLL-HOLT ADAM,D109,HJ,4166.67,,3530639.46
6100,12/31/2020,12/31/2020,123120,82L-IMPORT PAYROLL-KELLY SEAN,D109,HJ,5416.67,,3536056.13
6100,12/31/2020,12/31/2020,123120,82L-IMPORT PAYROLL-KRUGER MARK,D109,HJ,5000,,3541056.13
6100,12/31/2020,12/31/2020,123120,82L-IMPORT PAYROLL-LIPORACE HERNAN LUIS,D103,HJ,2291.67,,3543347.8
6100,12/31/2020,12/31/2020,123120,82L-IMPORT PAYROLL-MARKS KRISTA,D109,HJ,153.53,,3543501.33
6100,12/31/2020,12/31/2020,123120,82L-IMPORT PAYROLL-MARKS KRISTA,D109,HJ,5416.67,,3548918
6100,12/31/2020,12/31/2020,123120,82L-IMPORT PAYROLL-MELVIN DARNELL KEVIN,D109,HJ,4000,,3552918
6100,12/31/2020,12/31/2020,123120,82L-IMPORT PAYROLL-MESSING JENNIFER,D109,HJ,2500,,3555418
6100,12/31/2020,12/31/2020,123120,82L-IMPORT PAYROLL-MILNE ROGER,D109,HJ,150.66,,3555568.66
6100,12/31/2020,12/31/2020,123120,82L-IMPORT PAYROLL-MILNE ROGER,D109,HJ,5416.67,,3560985.33
6100,12/31/2020,12/31/2020,123120,82L-IMPORT PAYROLL-MOSTAFAVI YASAMAN,D109,HJ,616,,3561601.33
6100,12/31/2020,12/31/2020,123120,82L-IMPORT PAYROLL-O'DONNELL STEPHEN,D104,HJ,2707.5,,3564308.83
6100,12/31/2020,12/31/2020,123120,82L-IMPORT PAYROLL-PARETS MALLORY GRACE,D101,HJ,2833.33,,3567142.16
6100,12/31/2020,12/31/2020,123120,82L-IMPORT PAYROLL-PARHAM-GANTT DENISE M,D112,HJ,3041.67,,3570183.83
6100,12/31/2020,12/31/2020,123120,82L-IMPORT PAYROLL-PEINADO ELIZABETH R,D111,HJ,50,,3570233.83
6100,12/31/2020,12/31/2020,123120,82L-IMPORT PAYROLL-PEINADO ELIZABETH R,D111,HJ,3749.96,,3573983.79
6100,12/31/2020,12/31/2020,123120,82L-IMPORT PAYROLL-PERNIA JEFFREY,D109,HJ,146.72,,3574130.51
6100,12/31/2020,12/31/2020,123120,82L-IMPORT PAYROLL-PERNIA JEFFREY,D109,HJ,3875,,3578005.51
6100,12/31/2020,12/31/2020,123120,82L-IMPORT PAYROLL-POLANCO ODALIS,D103,HJ,3124.96,,3581130.47
6100,12/31/2020,12/31/2020,123120,82L-IMPORT PAYROLL-QUINTAS JASHIVE,D105,HJ,1916.67,,3583047.14
6100,12/31/2020,12/31/2020,123120,82L-IMPORT PAYROLL-RANDOLPH ALEXANDER,D111,HJ,50,,3583097.14
6100,12/31/2020,12/31/2020,123120,82L-IMPORT PAYROLL-RANDOLPH ALEXANDER,D111,HJ,1875,,3584972.14
6100,12/31/2020,12/31/2020,123120,82L-IMPORT PAYROLL-RUBI PERLA,D101,HJ,1250,,3586222.14
6100,12/31/2020,12/31/2020,123120,82L-IMPORT PAYROLL-SAFRAN ALAN P,D107,HJ,619.39,,3586841.53
6100,12/31/2020,12/31/2020,123120,82L-IMPORT PAYROLL-SAFRAN ALAN P,D107,HJ,7123,,3593964.53
6100,12/31/2020,12/31/2020,123120,82L-IMPORT PAYROLL-SHENKMAN OLIVIA,D101,HJ,2000,,3595964.53
6100,12/31/2020,12/31/2020,123120,82L-IMPORT PAYROLL-SHI GRACE,D103,HJ,875,,3596839.53
6100,12/31/2020,12/31/2020,123120,82L-IMPORT PAYROLL-WALLACE AMENA,D104,HJ,2187.5,,3599027.03
6100,12/31/2020,12/31/2020,123120,82L-IMPORT PAYROLL-WARD JEFFREY,D109,HJ,439.65,,3599466.68
6100,12/31/2020,12/31/2020,123120,82L-IMPORT PAYROLL-WARD JEFFREY,D109,HJ,5416.67,,3604883.35
6100,12/31/2020,12/31/2020,123120,82L-IMPORT PAYROLL-WARD JENNIFER,D109,HJ,1064.34,,3605947.69
6100,12/31/2020,12/31/2020,123120,82L-IMPORT PAYROLL-WEINSTOCK EMILY,D101,HJ,2833.33,,3608781.02
6100,12/31/2020,12/31/2020,123120,82L-IMPORT PAYROLL-WINANS JENNIFER,D111,HJ,50,,3608831.02
6100,12/31/2020,12/31/2020,123120,82L-IMPORT PAYROLL-WINANS JENNIFER,D111,HJ,2505.63,,3611336.65
6100,12/31/2020,12/31/2020,123120,82L-IMPORT PAYROLL-ZARATE JOSEPH M,D105,HJ,2150,,3613486.65
6100,12/31/2020,12/31/2020,123120,82L-IMPORT PAYROLL-AGUANNO JOSEPH,D108,HJ,250,,3613736.65
6100,12/31/2020,12/31/2020,123120,82L-IMPORT PAYROLL-AGUANNO JOSEPH,D108,HJ,1119.05,,3614855.7
6100,12/31/2020,12/31/2020,123120,82L-IMPORT PAYROLL-AKESODE FEHINTOLA,D108,HJ,250,,3615105.7
6100,12/31/2020,12/31/2020,123120,82L-IMPORT PAYROLL-AKESODE FEHINTOLA,D108,HJ,1119.05,,3616224.75
6100,12/31/2020,12/31/2020,123120,82L-IMPORT PAYROLL-BARTOLD DEANNA MARIE,D108,HJ,3034.5,,3619259.25
6100,12/31/2020,12/31/2020,123120,82L-IMPORT PAYROLL-BELLOT GENESIS,D108,HJ,2500,,3621759.25
6100,12/31/2020,12/31/2020,123120,82L-IMPORT PAYROLL-BENNETT JAMES H,D108,HJ,250,,3622009.25
6100,12/31/2020,12/31/2020,123120,82L-IMPORT PAYROLL-BENNETT JAMES H,D108,HJ,1119.05,,3623128.3
6100,12/31/2020,12/31/2020,123120,82L-IMPORT PAYROLL-BOWMAN ABIGAIL,D108,HJ,250,,3623378.3
6100,12/31/2020,12/31/2020,123120,82L-IMPORT PAYROLL-BOWMAN ABIGAIL,D108,HJ,1119.05,,3624497.35
6100,12/31/2020,12/31/2020,123120,82L-IMPORT PAYROLL-BURRELL RUSSELL,D108,HJ,250,,3624747.35
6100,12/31/2020,12/31/2020,123120,82L-IMPORT PAYROLL-BURRELL RUSSELL,D108,HJ,1119.05,,3625866.4
6100,12/31/2020,12/31/2020,123120,82L-IMPORT PAYROLL-CHUI KENT,D108,HJ,250,,3626116.4
6100,12/31/2020,12/31/2020,123120,82L-IMPORT PAYROLL-CHUI KENT,D108,HJ,1119.05,,3627235.45
6100,12/31/2020,12/31/2020,123120,82L-IMPORT PAYROLL-CIRKER MIA,D108,HJ,2250,,3629485.45
6100,12/31/2020,12/31/2020,123120,82L-IMPORT PAYROLL-DEWS CAMERYN,D108,HJ,1500,,3630985.45
6100,12/31/2020,12/31/2020,123120,82L-IMPORT PAYROLL-DEWS CAMERYN,D108,HJ,2291.67,,3633277.12
6100,12/31/2020,12/31/2020,123120,82L-IMPORT PAYROLL-DIETZ MARY,D108,HJ,1119.05,,3634396.17
6100,12/31/2020,12/31/2020,123120,82L-IMPORT PAYROLL-DOMINIQUE PRINCESSA,D108,HJ,250,,3634646.17
6100,12/31/2020,12/31/2020,123120,82L-IMPORT PAYROLL-DOMINIQUE PRINCESSA,D108,HJ,1119.05,,3635765.22
6100,12/31/2020,12/31/2020,123120,82L-IMPORT PAYROLL-DONNELLY HOME,D108,HJ,1119.05,,3636884.27
6100,12/31/2020,12/31/2020,123120,82L-IMPORT PAYROLL-FEIGHERY JOHN,D108,HJ,2250,,3639134.27
6100,12/31/2020,12/31/2020,123120,82L-IMPORT PAYROLL-FORTH KYLE,D108,HJ,250,,3639384.27
6100,12/31/2020,12/31/2020,123120,82L-IMPORT PAYROLL-FORTH KYLE,D108,HJ,1119.05,,3640503.32
6100,12/31/2020,12/31/2020,123120,82L-IMPORT PAYROLL-GARCIA MARILYN,D108,HJ,2291.67,,3642794.99
6100,12/31/2020,12/31/2020,123120,82L-IMPORT PAYROLL-GREENE BROOKE,D108,HJ,1119.05,,3643914.04
6100,12/31/2020,12/31/2020,123120,82L-IMPORT PAYROLL-GRIFFIN ANDREW,D108,HJ,2250,,3646164.04
6100,12/31/2020,12/31/2020,123120,82L-IMPORT PAYROLL-GROSS EMILY,D108,HJ,250,,3646414.04
6100,12/31/2020,12/31/2020,123120,82L-IMPORT PAYROLL-GROSS EMILY,D108,HJ,1119.05,,3647533.09
6100,12/31/2020,12/31/2020,123120,82L-IMPORT PAYROLL-GUERRERO LUIS,D108,HJ,1119.05,,3648652.14
6100,12/31/2020,12/31/2020,123120,82L-IMPORT PAYROLL-HALLINAN GABRIEL,D108,HJ,2550,,3651202.14
6100,12/31/2020,12/31/2020,123120,82L-IMPORT PAYROLL-HAMERSLY WILLIAM,D108,HJ,2500,,3653702.14
6100,12/31/2020,12/31/2020,123120,82L-IMPORT PAYROLL-HOSSAIN MYESHA,D108,HJ,2437.5,,3656139.64
6100,12/31/2020,12/31/2020,123120,82L-IMPORT PAYROLL-JACKSON TASNIM F,D108,HJ,2291.67,,3658431.31
6100,12/31/2020,12/31/2020,123120,82L-IMPORT PAYROLL-KERKHOFF HARPER FAITH,D108,HJ,1119.05,,3659550.36
6100,12/31/2020,12/31/2020,123120,82L-IMPORT PAYROLL-LEARY AUBREY,D108,HJ,1119.05,,3660669.41
6100,12/31/2020,12/31/2020,123120,82L-IMPORT PAYROLL-LI BELLA,D108,HJ,2486.25,,3663155.66
6100,12/31/2020,12/31/2020,123120,82L-IMPORT PAYROLL-LOUIE JORDAN,D108,HJ,250,,3663405.66
6100,12/31/2020,12/31/2020,123120,82L-IMPORT PAYROLL-LOUIE JORDAN,D108,HJ,1119.05,,3664524.71
6100,12/31/2020,12/31/2020,123120,82L-IMPORT PAYROLL-MELCHOR OSBEIDY,D108,HJ,250,,3664774.71
6100,12/31/2020,12/31/2020,123120,82L-IMPORT PAYROLL-MELCHOR OSBEIDY,D108,HJ,1119.05,,3665893.76
6100,12/31/2020,12/31/2020,123120,82L-IMPORT PAYROLL-MORRIS ZAKIYA,D108,HJ,250,,3666143.76
6100,12/31/2020,12/31/2020,123120,82L-IMPORT PAYROLL-MORRIS ZAKIYA,D108,HJ,1119.05,,3667262.81
6100,12/31/2020,12/31/2020,123120,82L-IMPORT PAYROLL-MORSELETTO RAFAEL,D108,HJ,1119.05,,3668381.86
6100,12/31/2020,12/31/2020,123120,82L-IMPORT PAYROLL-OBI TOBECHUKWU,D108,HJ,250,,3668631.86
6100,12/31/2020,12/31/2020,123120,82L-IMPORT PAYROLL-OBI TOBECHUKWU,D108,HJ,1119.05,,3669750.91
6100,12/31/2020,12/31/2020,123120,82L-IMPORT PAYROLL-OPUH NDIDI,D108,HJ,2833.33,,3672584.24
6100,12/31/2020,12/31/2020,123120,82L-IMPORT PAYROLL-PAULINO THAIRI,D108,HJ,250,,3672834.24
6100,12/31/2020,12/31/2020,123120,82L-IMPORT PAYROLL-PAULINO THAIRI,D108,HJ,1119.05,,3673953.29
6100,12/31/2020,12/31/2020,123120,82L-IMPORT PAYROLL-REYES LATIVA M,D108,HJ,2111.46,,3676064.75
6100,12/31/2020,12/31/2020,123120,82L-IMPORT PAYROLL-ROSENBAUM MURRAY,D108,HJ,250,,3676314.75
6100,12/31/2020,12/31/2020,123120,82L-IMPORT PAYROLL-ROSENBAUM MURRAY,D108,HJ,1119.05,,3677433.8
6100,12/31/2020,12/31/2020,123120,82L-IMPORT PAYROLL-SCHWETTMANN CLAIRE,D108,HJ,250,,3677683.8
6100,12/31/2020,12/31/2020,123120,82L-IMPORT PAYROLL-SCHWETTMANN CLAIRE,D108,HJ,1119.05,,3678802.85
6100,12/31/2020,12/31/2020,123120,82L-IMPORT PAYROLL-SOBELMAN JUSTIN,D108,HJ,1119.05,,3679921.9
6100,12/31/2020,12/31/2020,123120,82L-IMPORT PAYROLL-TERRENCE-SMITH ZIHIR,D108,HJ,250,,3680171.9
6100,12/31/2020,12/31/2020,123120,82L-IMPORT PAYROLL-TERRENCE-SMITH ZIHIR,D108,HJ,1119.05,,3681290.95
6100,12/31/2020,12/31/2020,123120,82L-IMPORT PAYROLL-TILLERY ASIA,D108,HJ,3291.67,,3684582.62
6100,12/31/2020,12/31/2020,123120,82L-IMPORT PAYROLL-WILLIAMS-MASSEY BRIANNA,D108,HJ,1119.05,,3685701.67
6100,12/31/2020,12/31/2020,123120,82L-IMPORT PAYROLL-XIAO CHENGYAO,D108,HJ,250,,3685951.67
6100,12/31/2020,12/31/2020,123120,82L-IMPORT PAYROLL-XIAO CHENGYAO,D108,HJ,1119.05,,3687070.72
6100,12/31/2020,12/31/2020,123120,82L-IMPORT PAYROLL-ZIAUDDIN ABUTAHER,D108,HJ,250,,3687320.72
6100,12/31/2020,12/31/2020,123120,82L-IMPORT PAYROLL-ZIAUDDIN ABUTAHER,D108,HJ,1119.05,,3688439.77
6100,12/31/2020,12/31/2020,123120,82L-IMPORT PAYROLL-BALASUBRAMANIAN SHARANYA,D108,HJ,2666.67,,3691106.44
6100,12/31/2020,12/31/2020,123120,82L-IMPORT PAYROLL-COVENEY ALLISON,D108,HJ,2854.17,,3693960.61
6100,12/31/2020,12/31/2020,123120,82L-IMPORT PAYROLL-JACKSON CLAICE M,D108,HJ,3125,,3697085.61
6100,12/31/2020,12/31/2020,123120,82L-IMPORT PAYROLL-JANG DANIEL,D108,HJ,2750,,3699835.61
6100,12/31/2020,12/31/2020,123120,82L-IMPORT PAYROLL-LENEGHAN MARYELLEN,D108,HJ,940.71,,3700776.32
6100,12/31/2020,12/31/2020,123120,82L-IMPORT PAYROLL-LENEGHAN MARYELLEN,D108,HJ,3812.5,,3704588.82
6100,1/15/2021,1/15/2021,11521,82L-IMPORT PAYROLL-BARTHELEMY RACHALIE,D108,HJ,1047.62,,3705636.44
6100,1/15/2021,1/15/2021,11521,82L-IMPORT PAYROLL-BASHAM WILLIAM EDWARD,D108,HJ,580.2,,3706216.64
6100,1/15/2021,1/15/2021,11521,82L-IMPORT PAYROLL-BOHLSEN GRACE ISABELLE,D108,HJ,1047.62,,3707264.26
6100,1/15/2021,1/15/2021,11521,82L-IMPORT PAYROLL-BOLIVAR ANDREA,D108,HJ,2500,,3709764.26
6100,1/15/2021,1/15/2021,11521,82L-IMPORT PAYROLL-BORCHART SPENCER,D108,HJ,1047.62,,3710811.88
6100,1/15/2021,1/15/2021,11521,82L-IMPORT PAYROLL-BROWN ISAAC,D108,HJ,1047.62,,3711859.5
6100,1/15/2021,1/15/2021,11521,82L-IMPORT PAYROLL-BURKE MARIAH,D108,HJ,1047.62,,3712907.12
6100,1/15/2021,1/15/2021,11521,82L-IMPORT PAYROLL-CASSADY JOSHUA LEWIS,D108,HJ,1047.62,,3713954.74
6100,1/15/2021,1/15/2021,11521,82L-IMPORT PAYROLL-DARKO OLIVIA,D108,HJ,1047.62,,3715002.36
6100,1/15/2021,1/15/2021,11521,82L-IMPORT PAYROLL-DAWSON JAMIL NAFAYE-BEYAH,D108,HJ,967,,3715969.36
6100,1/15/2021,1/15/2021,11521,82L-IMPORT PAYROLL-ESCAMILLA OLGA,D108,HJ,1047.62,,3717016.98
6100,1/15/2021,1/15/2021,11521,82L-IMPORT PAYROLL-GARCIA SANTIAGO,D108,HJ,2041.67,,3719058.65
6100,1/15/2021,1/15/2021,11521,82L-IMPORT PAYROLL-GILES SHAYLA,D108,HJ,1047.62,,3720106.27
6100,1/15/2021,1/15/2021,11521,82L-IMPORT PAYROLL-IKUNIKA FUNMILAYO,D108,HJ,2083.33,,3722189.6
6100,1/15/2021,1/15/2021,11521,82L-IMPORT PAYROLL-JONES JORDAN,D108,HJ,1047.62,,3723237.22
6100,1/15/2021,1/15/2021,11521,82L-IMPORT PAYROLL-KHAN HUDA,D108,HJ,1047.62,,3724284.84
6100,1/15/2021,1/15/2021,11521,82L-IMPORT PAYROLL-KLOHR TIMOTHY JORDAN,D108,HJ,2000,,3726284.84
6100,1/15/2021,1/15/2021,11521,82L-IMPORT PAYROLL-KNOWLIN ZYLIA,D108,HJ,2541.67,,3728826.51
6100,1/15/2021,1/15/2021,11521,82L-IMPORT PAYROLL-KOPSHEVER MELISSA,D108,HJ,2916.67,,3731743.18
6100,1/15/2021,1/15/2021,11521,82L-IMPORT PAYROLL-LAI GRADY,D108,HJ,516.46,,3732259.64
6100,1/15/2021,1/15/2021,11521,82L-IMPORT PAYROLL-LI SEN YUAN,D108,HJ,1047.62,,3733307.26
6100,1/15/2021,1/15/2021,11521,82L-IMPORT PAYROLL-LIPSCOMB STEPHEN,D108,HJ,2541.67,,3735848.93
6100,1/15/2021,1/15/2021,11521,82L-IMPORT PAYROLL-MALLECK JESSICA R,D108,HJ,1047.62,,3736896.55
6100,1/15/2021,1/15/2021,11521,82L-IMPORT PAYROLL-MCLAUGHLIN MARA,D108,HJ,580.2,,3737476.75
6100,1/15/2021,1/15/2021,11521,82L-IMPORT PAYROLL-MEJIA ROSO CARLOS,D108,HJ,1047.62,,3738524.37
6100,1/15/2021,1/15/2021,11521,82L-IMPORT PAYROLL-MONROY-MEJIA JASON,D108,HJ,1047.62,,3739571.99
6100,1/15/2021,1/15/2021,11521,82L-IMPORT PAYROLL-O'FLYNN-PRUITT NATHAN COLYAR,D108,HJ,1047.62,,3740619.61
6100,1/15/2021,1/15/2021,11521,82L-IMPORT PAYROLL-OKRAH JULIAN O,D108,HJ,1032.93,,3741652.54
6100,1/15/2021,1/15/2021,11521,82L-IMPORT PAYROLL-PATTERSON STEVE,D108,HJ,1047.62,,3742700.16
6100,1/15/2021,1/15/2021,11521,82L-IMPORT PAYROLL-SCHMIESS RACHEL JOY,D108,HJ,1047.62,,3743747.78
6100,1/15/2021,1/15/2021,11521,82L-IMPORT PAYROLL-SCOTT KIRK DONOVAN,D108,HJ,1047.62,,3744795.4
6100,1/15/2021,1/15/2021,11521,82L-IMPORT PAYROLL-SILVER KELLY,D108,HJ,2541.67,,3747337.07
6100,1/15/2021,1/15/2021,11521,82L-IMPORT PAYROLL-SOLIMAN MARK,D108,HJ,1047.62,,3748384.69
6100,1/15/2021,1/15/2021,11521,82L-IMPORT PAYROLL-STEIN KYLE,D108,HJ,2083.33,,3750468.02
6100,1/15/2021,1/15/2021,11521,82L-IMPORT PAYROLL-STROUD DAVID,D108,HJ,1047.62,,3751515.64
6100,1/15/2021,1/15/2021,11521,82L-IMPORT PAYROLL-VALCIN SABRINA JEMIMAH,D108,HJ,1047.62,,3752563.26
6100,1/15/2021,1/15/2021,11521,82L-IMPORT PAYROLL-VALDES ERNEST L,D108,HJ,1047.62,,3753610.88
6100,1/15/2021,1/15/2021,11521,82L-IMPORT PAYROLL-WILLIAMS MACK ANTHONY,D108,HJ,1047.62,,3754658.5
6100,1/15/2021,1/15/2021,11521,82L-IMPORT PAYROLL-WILLIAMS MIL'YONTA,D108,HJ,1047.62,,3755706.12
6100,1/15/2021,1/15/2021,11521,82L-IMPORT PAYROLL-ANTHONY BETTY S,D108,HJ,2886.52,,3758592.64
6100,1/15/2021,1/15/2021,11521,82L-IMPORT PAYROLL-APULI LINDSAY,D108,HJ,2500,,3761092.64
6100,1/15/2021,1/15/2021,11521,82L-IMPORT PAYROLL-AUSTIN PERCY ANTONIO,D108,HJ,2653.02,,3763745.66
6100,1/15/2021,1/15/2021,11521,82L-IMPORT PAYROLL-BUHMANN JENNIFER,D108,HJ,2270.83,,3766016.49
6100,1/15/2021,1/15/2021,11521,82L-IMPORT PAYROLL-CAIN CORY,D108,HJ,2708.33,,3768724.82
6100,1/15/2021,1/15/2021,11521,82L-IMPORT PAYROLL-CHAPMAN CLAUDY EARL,D108,HJ,2291.67,,3771016.49
6100,1/15/2021,1/15/2021,11521,82L-IMPORT PAYROLL-DADA ARIKPO E,D108,HJ,2720,,3773736.49
6100,1/15/2021,1/15/2021,11521,82L-IMPORT PAYROLL-GUTHRIE LESLIE,D108,HJ,2458.33,,3776194.82
6100,1/15/2021,1/15/2021,11521,82L-IMPORT PAYROLL-HOLMES JOREL ALEXANDER,D108,HJ,2329,,3778523.82
6100,1/15/2021,1/15/2021,11521,82L-IMPORT PAYROLL-JORDAN TIFFANY T,D108,HJ,3445,,3781968.82
6100,1/15/2021,1/15/2021,11521,82L-IMPORT PAYROLL-LANIGAN LISA A,D108,HJ,3113.75,,3785082.57
6100,1/15/2021,1/15/2021,11521,82L-IMPORT PAYROLL-MCELWEE MELISSA,D108,HJ,2666.67,,3787749.24
6100,1/15/2021,1/15/2021,11521,82L-IMPORT PAYROLL-MCNICHOLAS MARY,D108,HJ,2291.67,,3790040.91
6100,1/15/2021,1/15/2021,11521,82L-IMPORT PAYROLL-NWAKANMA NANCY,D108,HJ,3046.67,,3793087.58
6100,1/15/2021,1/15/2021,11521,82L-IMPORT PAYROLL-ONICA ANTHONY J,D108,HJ,2416.67,,3795504.25
6100,1/15/2021,1/15/2021,11521,82L-IMPORT PAYROLL-PRAHIN NICOLE M,D108,HJ,3812.5,,3799316.75
6100,1/15/2021,1/15/2021,11521,82L-IMPORT PAYROLL-RIVERS QUIONNA DIANE,D108,HJ,2708.34,,3802025.09
6100,1/15/2021,1/15/2021,11521,82L-IMPORT PAYROLL-SALIM YASSER,D108,HJ,2431.94,,3804457.03
6100,1/15/2021,1/15/2021,11521,82L-IMPORT PAYROLL-SEJOUR MAHALIAH,D108,HJ,1249.09,,3805706.12
6100,1/15/2021,1/15/2021,11521,82L-IMPORT PAYROLL-SEJOUR MAHALIAH,D108,HJ,1250.91,,3806957.03
6100,1/15/2021,1/15/2021,11521,82L-IMPORT PAYROLL-SKALSKI CHRISTOPHER,D108,HJ,2465,,3809422.03
6100,1/15/2021,1/15/2021,11521,82L-IMPORT PAYROLL-TUMENJARGAL ENKHJIN,D108,HJ,2414,,3811836.03
6100,1/15/2021,1/15/2021,11521,82L-IMPORT PAYROLL-VILLEGAS EVELYN,D108,HJ,2817.75,,3814653.78
6100,1/15/2021,1/15/2021,11521,82L-IMPORT PAYROLL-WOLF ANNA A,D108,HJ,341.16,,3814994.94
6100,1/15/2021,1/15/2021,11521,82L-IMPORT PAYROLL-WOLF ANNA A,D108,HJ,1067.44,,3816062.38
6100,1/15/2021,1/15/2021,11521,82L-IMPORT PAYROLL-WOLF ANNA A,D108,HJ,1226.4,,3817288.78
6100,1/15/2021,1/15/2021,11521,82L-IMPORT PAYROLL-ACEVEDO MONIVETT,D107,HJ,2480.67,,3819769.45
6100,1/15/2021,1/15/2021,11521,82L-IMPORT PAYROLL-ACEVEDO MONIVETT,D107,HJ,2894.32,,3822663.77
6100,1/15/2021,1/15/2021,11521,82L-IMPORT PAYROLL-AKLESTAD ISABEL,D111,HJ,1750,,3824413.77
6100,1/15/2021,1/15/2021,11521,82L-IMPORT PAYROLL-BIBB TIFFANI,D104,HJ,3875,,3828288.77
6100,1/15/2021,1/15/2021,11521,82L-IMPORT PAYROLL-BOWMAN HALLEY K,D101,HJ,3490.08,,3831778.85
6100,1/15/2021,1/15/2021,11521,82L-IMPORT PAYROLL-COOK CATHRYN ANNA,D105,HJ,3593.03,,3835371.88
6100,1/15/2021,1/15/2021,11521,82L-IMPORT PAYROLL-COOPER ASHLEE R,D101,HJ,2461.88,,3837833.76
6100,1/15/2021,1/15/2021,11521,82L-IMPORT PAYROLL-CORTEZ MIRANDA A,D111,HJ,2672.72,,3840506.48
6100,1/15/2021,1/15/2021,11521,82L-IMPORT PAYROLL-DAUGHERTY DEVIN W,D101,HJ,1041.67,,3841548.15
6100,1/15/2021,1/15/2021,11521,82L-IMPORT PAYROLL-DETONE KYRA MAYA,D102,HJ,2916.67,,3844464.82
6100,1/15/2021,1/15/2021,11521,82L-IMPORT PAYROLL-DUPUIS CHRISTOPHER M,D107,HJ,2571.04,,3847035.86
6100,1/15/2021,1/15/2021,11521,82L-IMPORT PAYROLL-DUPUIS CHRISTOPHER M,D107,HJ,3699.79,,3850735.65
6100,1/15/2021,1/15/2021,11521,82L-IMPORT PAYROLL-DZIEDZIC JULIE K,D101,HJ,1250,,3851985.65
6100,1/15/2021,1/15/2021,11521,82L-IMPORT PAYROLL-FEENEY CLAIRE,D104,HJ,923.04,,3852908.69
6100,1/15/2021,1/15/2021,11521,82L-IMPORT PAYROLL-FISCHABER THOMAS,D109,HJ,439.65,,3853348.34
6100,1/15/2021,1/15/2021,11521,82L-IMPORT PAYROLL-FISCHABER THOMAS,D109,HJ,5416.67,,3858765.01
6100,1/15/2021,1/15/2021,11521,82L-IMPORT PAYROLL-FLORY MEGAN,D109,HJ,1500,,3860265.01
6100,1/15/2021,1/15/2021,11521,82L-IMPORT PAYROLL-GORNSTEIN STEVEN,D101,HJ,2708.33,,3862973.34
6100,1/15/2021,1/15/2021,11521,82L-IMPORT PAYROLL-GUADARRAMA-ALVAREZ URIEL A,D105,HJ,2897.92,,3865871.26
6100,1/15/2021,1/15/2021,11521,82L-IMPORT PAYROLL-GUTIERREZ ANTONIO J,D107,HJ,2049.46,,3867920.72
6100,1/15/2021,1/15/2021,11521,82L-IMPORT PAYROLL-GUTIERREZ ANTONIO J,D107,HJ,3643.48,,3871564.2
6100,1/15/2021,1/15/2021,11521,82L-IMPORT PAYROLL-HENRY GILLIAN,D102,HJ,2083.34,,3873647.54
6100,1/15/2021,1/15/2021,11521,82L-IMPORT PAYROLL-HERMAN ADAM,D102,HJ,1958.33,,3875605.87
6100,1/15/2021,1/15/2021,11521,82L-IMPORT PAYROLL-HERNANDEZ ANNA,D101,HJ,2499.9,,3878105.77
6100,1/15/2021,1/15/2021,11521,82L-IMPORT PAYROLL-HESTER TYLER CONRAD,D105,HJ,1916.67,,3880022.44
6100,1/15/2021,1/15/2021,11521,82L-IMPORT PAYROLL-HOLT ADAM,D109,HJ,153.53,,3880175.97
6100,1/15/2021,1/15/2021,11521,82L-IMPORT PAYROLL-HOLT ADAM,D109,HJ,4166.67,,3884342.64
6100,1/15/2021,1/15/2021,11521,82L-IMPORT PAYROLL-KELLY SEAN,D109,HJ,5416.67,,3889759.31
6100,1/15/2021,1/15/2021,11521,82L-IMPORT PAYROLL-KRUGER MARK,D109,HJ,5000,,3894759.31
6100,1/15/2021,1/15/2021,11521,82L-IMPORT PAYROLL-LIPORACE HERNAN LUIS,D103,HJ,2291.67,,3897050.98
6100,1/15/2021,1/15/2021,11521,82L-IMPORT PAYROLL-MARKS KRISTA,D109,HJ,153.53,,3897204.51
6100,1/15/2021,1/15/2021,11521,82L-IMPORT PAYROLL-MARKS KRISTA,D109,HJ,5416.67,,3902621.18
6100,1/15/2021,1/15/2021,11521,82L-IMPORT PAYROLL-MELVIN DARNELL KEVIN,D109,HJ,4000,,3906621.18
6100,1/15/2021,1/15/2021,11521,82L-IMPORT PAYROLL-MESSING JENNIFER,D104,HJ,2500,,3909121.18
6100,1/15/2021,1/15/2021,11521,82L-IMPORT PAYROLL-MILNE ROGER,D109,HJ,150.66,,3909271.84
6100,1/15/2021,1/15/2021,11521,82L-IMPORT PAYROLL-MILNE ROGER,D109,HJ,5416.67,,3914688.51
6100,1/15/2021,1/15/2021,11521,82L-IMPORT PAYROLL-MOSTAFAVI YASAMAN,D109,HJ,704,,3915392.51
6100,1/15/2021,1/15/2021,11521,82L-IMPORT PAYROLL-O'DONNELL STEPHEN,D104,HJ,2707.5,,3918100.01
6100,1/15/2021,1/15/2021,11521,82L-IMPORT PAYROLL-PARETS MALLORY GRACE,D101,HJ,2833.33,,3920933.34
6100,1/15/2021,1/15/2021,11521,82L-IMPORT PAYROLL-PARHAM-GANTT DENISE M,D112,HJ,3041.67,,3923975.01
6100,1/15/2021,1/15/2021,11521,82L-IMPORT PAYROLL-PEINADO ELIZABETH R,D111,HJ,3749.96,,3927724.97
6100,1/15/2021,1/15/2021,11521,82L-IMPORT PAYROLL-PERNIA JEFFREY,D109,HJ,146.72,,3927871.69
6100,1/15/2021,1/15/2021,11521,82L-IMPORT PAYROLL-PERNIA JEFFREY,D109,HJ,3875,,3931746.69
6100,1/15/2021,1/15/2021,11521,82L-IMPORT PAYROLL-PIRES MANUEL AM,D103,HJ,2038.38,,3933785.07
6100,1/15/2021,1/15/2021,11521,82L-IMPORT PAYROLL-POLANCO ODALIS,D103,HJ,3124.96,,3936910.03
6100,1/15/2021,1/15/2021,11521,82L-IMPORT PAYROLL-QUINTAS JASHIVE,D105,HJ,1916.67,,3938826.7
6100,1/15/2021,1/15/2021,11521,82L-IMPORT PAYROLL-RANDOLPH ALEXANDER,D111,HJ,1875,,3940701.7
6100,1/15/2021,1/15/2021,11521,82L-IMPORT PAYROLL-RUBI PERLA,D101,HJ,1250,,3941951.7
6100,1/15/2021,1/15/2021,11521,82L-IMPORT PAYROLL-SAFRAN ALAN P,D107,HJ,696.82,,3942648.52
6100,1/15/2021,1/15/2021,11521,82L-IMPORT PAYROLL-SAFRAN ALAN P,D107,HJ,7045.57,,3949694.09
6100,1/15/2021,1/15/2021,11521,82L-IMPORT PAYROLL-SHENKMAN OLIVIA,D101,HJ,2000,,3951694.09
6100,1/15/2021,1/15/2021,11521,82L-IMPORT PAYROLL-SHI GRACE,D103,HJ,875,,3952569.09
6100,1/15/2021,1/15/2021,11521,82L-IMPORT PAYROLL-VYAS SUNAINA,D104,HJ,903.81,,3953472.9
6100,1/15/2021,1/15/2021,11521,82L-IMPORT PAYROLL-WALLACE AMENA,D104,HJ,2187.5,,3955660.4
6100,1/15/2021,1/15/2021,11521,82L-IMPORT PAYROLL-WARD JEFFREY,D109,HJ,439.65,,3956100.05
6100,1/15/2021,1/15/2021,11521,82L-IMPORT PAYROLL-WARD JEFFREY,D109,HJ,5416.67,,3961516.72
6100,1/15/2021,1/15/2021,11521,82L-IMPORT PAYROLL-WARD JENNIFER,D109,HJ,911.25,,3962427.97
6100,1/15/2021,1/15/2021,11521,82L-IMPORT PAYROLL-WEINSTOCK EMILY,D101,HJ,2833.33,,3965261.3
6100,1/15/2021,1/15/2021,11521,82L-IMPORT PAYROLL-WINANS JENNIFER,D111,HJ,2505.63,,3967766.93
6100,1/15/2021,1/15/2021,11521,82L-IMPORT PAYROLL-ZARATE JOSEPH M,D105,HJ,2150,,3969916.93
6100,1/15/2021,1/15/2021,11521,82L-IMPORT PAYROLL-AGUANNO JOSEPH,D108,HJ,1119.05,,3971035.98
6100,1/15/2021,1/15/2021,11521,82L-IMPORT PAYROLL-AKESODE FEHINTOLA,D108,HJ,1119.05,,3972155.03
6100,1/15/2021,1/15/2021,11521,82L-IMPORT PAYROLL-BARTOLD DEANNA MARIE,D108,HJ,3034.5,,3975189.53
6100,1/15/2021,1/15/2021,11521,82L-IMPORT PAYROLL-BELLOT GENESIS,D108,HJ,2500,,3977689.53
6100,1/15/2021,1/15/2021,11521,82L-IMPORT PAYROLL-BENNETT JAMES H,D108,HJ,1119.05,,3978808.58
6100,1/15/2021,1/15/2021,11521,82L-IMPORT PAYROLL-BOWMAN ABIGAIL,D108,HJ,1119.05,,3979927.63
6100,1/15/2021,1/15/2021,11521,82L-IMPORT PAYROLL-BURRELL RUSSELL,D108,HJ,1119.05,,3981046.68
6100,1/15/2021,1/15/2021,11521,82L-IMPORT PAYROLL-CHUI KENT,D108,HJ,1119.05,,3982165.73
6100,1/15/2021,1/15/2021,11521,82L-IMPORT PAYROLL-CIRKER MIA,D108,HJ,2250,,3984415.73
6100,1/15/2021,1/15/2021,11521,82L-IMPORT PAYROLL-DEWS CAMERYN,D108,HJ,2291.67,,3986707.4
6100,1/15/2021,1/15/2021,11521,82L-IMPORT PAYROLL-DIETZ MARY,D108,HJ,1119.05,,3987826.45
6100,1/15/2021,1/15/2021,11521,82L-IMPORT PAYROLL-DOMINIQUE PRINCESSA,D108,HJ,1119.05,,3988945.5
6100,1/15/2021,1/15/2021,11521,82L-IMPORT PAYROLL-DONNELLY HOME,D108,HJ,1119.05,,3990064.55
6100,1/15/2021,1/15/2021,11521,82L-IMPORT PAYROLL-FEIGHERY JOHN,D108,HJ,2250,,3992314.55
6100,1/15/2021,1/15/2021,11521,82L-IMPORT PAYROLL-FORTH KYLE,D108,HJ,1119.05,,3993433.6
6100,1/15/2021,1/15/2021,11521,82L-IMPORT PAYROLL-GARCIA MARILYN,D108,HJ,2291.67,,3995725.27
6100,1/15/2021,1/15/2021,11521,82L-IMPORT PAYROLL-GREENE BROOKE,D108,HJ,1119.05,,3996844.32
6100,1/15/2021,1/15/2021,11521,82L-IMPORT PAYROLL-GRIFFIN ANDREW,D108,HJ,2250,,3999094.32
6100,1/15/2021,1/15/2021,11521,82L-IMPORT PAYROLL-GROSS EMILY,D108,HJ,1119.05,,4000213.37
6100,1/15/2021,1/15/2021,11521,82L-IMPORT PAYROLL-GUERRERO LUIS,D108,HJ,250,,4000463.37
6100,1/15/2021,1/15/2021,11521,82L-IMPORT PAYROLL-GUERRERO LUIS,D108,HJ,1119.05,,4001582.42
6100,1/15/2021,1/15/2021,11521,82L-IMPORT PAYROLL-HALLINAN GABRIEL,D108,HJ,2550,,4004132.42
6100,1/15/2021,1/15/2021,11521,82L-IMPORT PAYROLL-HAMERSLY WILLIAM,D108,HJ,2500,,4006632.42
6100,1/15/2021,1/15/2021,11521,82L-IMPORT PAYROLL-HOSSAIN MYESHA,D108,HJ,2437.5,,4009069.92
6100,1/15/2021,1/15/2021,11521,82L-IMPORT PAYROLL-JACKSON TASNIM F,D108,HJ,2291.67,,4011361.59
6100,1/15/2021,1/15/2021,11521,82L-IMPORT PAYROLL-KERKHOFF HARPER FAITH,D108,HJ,1119.05,,4012480.64
6100,1/15/2021,1/15/2021,11521,82L-IMPORT PAYROLL-LEARY AUBREY,D108,HJ,1119.05,,4013599.69
6100,1/15/2021,1/15/2021,11521,82L-IMPORT PAYROLL-LI BELLA,D108,HJ,2486.25,,4016085.94
6100,1/15/2021,1/15/2021,11521,82L-IMPORT PAYROLL-LOUIE JORDAN,D108,HJ,1119.05,,4017204.99
6100,1/15/2021,1/15/2021,11521,82L-IMPORT PAYROLL-MELCHOR OSBEIDY,D108,HJ,1119.05,,4018324.04
6100,1/15/2021,1/15/2021,11521,82L-IMPORT PAYROLL-MORRIS ZAKIYA,D108,HJ,1119.05,,4019443.09
6100,1/15/2021,1/15/2021,11521,82L-IMPORT PAYROLL-MORSELETTO RAFAEL,D108,HJ,1119.05,,4020562.14
6100,1/15/2021,1/15/2021,11521,82L-IMPORT PAYROLL-OBI TOBECHUKWU,D108,HJ,1119.05,,4021681.19
6100,1/15/2021,1/15/2021,11521,82L-IMPORT PAYROLL-OPUH NDIDI,D108,HJ,2833.33,,4024514.52
6100,1/15/2021,1/15/2021,11521,82L-IMPORT PAYROLL-PAULINO THAIRI,D108,HJ,1119.05,,4025633.57
6100,1/15/2021,1/15/2021,11521,82L-IMPORT PAYROLL-REYES LATIVA M,D108,HJ,1759.55,,4027393.12
6100,1/15/2021,1/15/2021,11521,82L-IMPORT PAYROLL-ROSENBAUM MURRAY,D108,HJ,1119.05,,4028512.17
6100,1/15/2021,1/15/2021,11521,82L-IMPORT PAYROLL-SCHWETTMANN CLAIRE,D108,HJ,1119.05,,4029631.22
6100,1/15/2021,1/15/2021,11521,82L-IMPORT PAYROLL-SOBELMAN JUSTIN,D108,HJ,1119.05,,4030750.27
6100,1/15/2021,1/15/2021,11521,82L-IMPORT PAYROLL-TERRENCE-SMITH ZIHIR,D108,HJ,1119.05,,4031869.32
6100,1/15/2021,1/15/2021,11521,82L-IMPORT PAYROLL-TILLERY ASIA,D108,HJ,455.76,,4032325.08
6100,1/15/2021,1/15/2021,11521,82L-IMPORT PAYROLL-TILLERY ASIA,D108,HJ,3291.67,,4035616.75
6100,1/15/2021,1/15/2021,11521,82L-IMPORT PAYROLL-WILLIAMS-MASSEY BRIANNA,D108,HJ,1119.05,,4036735.8
6100,1/15/2021,1/15/2021,11521,82L-IMPORT PAYROLL-XIAO CHENGYAO,D108,HJ,1119.05,,4037854.85
6100,1/15/2021,1/15/2021,11521,82L-IMPORT PAYROLL-ZIAUDDIN ABUTAHER,D108,HJ,1119.05,,4038973.9
6100,1/15/2021,1/15/2021,11521,82L-IMPORT PAYROLL-BALASUBRAMANIAN SHARANYA,D108,HJ,2666.67,,4041640.57
6100,1/15/2021,1/15/2021,11521,82L-IMPORT PAYROLL-COVENEY ALLISON,D108,HJ,2854.17,,4044494.74
6100,1/15/2021,1/15/2021,11521,82L-IMPORT PAYROLL-JACKSON CLAICE M,D108,HJ,3125,,4047619.74
6100,1/15/2021,1/15/2021,11521,82L-IMPORT PAYROLL-JANG DANIEL,D108,HJ,2750,,4050369.74
6100,1/15/2021,1/15/2021,11521,82L-IMPORT PAYROLL-LENEGHAN MARYELLEN,D108,HJ,940.71,,4051310.45
6100,1/15/2021,1/15/2021,11521,82L-IMPORT PAYROLL-LENEGHAN MARYELLEN,D108,HJ,1715.62,,4053026.07
6100,1/15/2021,1/15/2021,11521,82L-IMPORT PAYROLL-LENEGHAN MARYELLEN,D108,HJ,2096.88,,4055122.95
6100,1/29/2021,1/29/2021,12921,82L-IMPORT PAYROLL-BARTHELEMY RACHALIE,D108,HJ,1047.62,,4056170.57
6100,1/29/2021,1/29/2021,12921,82L-IMPORT PAYROLL-BOHLSEN GRACE ISABELLE,D108,HJ,1047.62,,4057218.19
6100,1/29/2021,1/29/2021,12921,82L-IMPORT PAYROLL-BOLIVAR ANDREA,D108,HJ,2500,,4059718.19
6100,1/29/2021,1/29/2021,12921,82L-IMPORT PAYROLL-BORCHART SPENCER,D108,HJ,1047.62,,4060765.81
6100,1/29/2021,1/29/2021,12921,82L-IMPORT PAYROLL-BROWN ISAAC,D108,HJ,1047.62,,4061813.43
6100,1/29/2021,1/29/2021,12921,82L-IMPORT PAYROLL-BURKE MARIAH,D108,HJ,1047.62,,4062861.05
6100,1/29/2021,1/29/2021,12921,82L-IMPORT PAYROLL-CASSADY JOSHUA LEWIS,D108,HJ,1047.62,,4063908.67
6100,1/29/2021,1/29/2021,12921,82L-IMPORT PAYROLL-DARKO OLIVIA,D108,HJ,1047.62,,4064956.29
6100,1/29/2021,1/29/2021,12921,82L-IMPORT PAYROLL-ESCAMILLA OLGA,D108,HJ,1047.62,,4066003.91
6100,1/29/2021,1/29/2021,12921,82L-IMPORT PAYROLL-GARCIA SANTIAGO,D108,HJ,2041.67,,4068045.58
6100,1/29/2021,1/29/2021,12921,82L-IMPORT PAYROLL-GILES SHAYLA,D108,HJ,1047.62,,4069093.2
6100,1/29/2021,1/29/2021,12921,82L-IMPORT PAYROLL-IKUNIKA FUNMILAYO,D108,HJ,2083.33,,4071176.53
6100,1/29/2021,1/29/2021,12921,82L-IMPORT PAYROLL-JONES JORDAN,D108,HJ,1047.62,,4072224.15
6100,1/29/2021,1/29/2021,12921,82L-IMPORT PAYROLL-KHAN HUDA,D108,HJ,1047.62,,4073271.77
6100,1/29/2021,1/29/2021,12921,82L-IMPORT PAYROLL-KLOHR TIMOTHY JORDAN,D108,HJ,2000,,4075271.77
6100,1/29/2021,1/29/2021,12921,82L-IMPORT PAYROLL-KNOWLIN ZYLIA,D108,HJ,2541.67,,4077813.44
6100,1/29/2021,1/29/2021,12921,82L-IMPORT PAYROLL-KOPSHEVER MELISSA,D108,HJ,2916.67,,4080730.11
6100,1/29/2021,1/29/2021,12921,82L-IMPORT PAYROLL-LAI GRADY,D108,HJ,1047.62,,4081777.73
6100,1/29/2021,1/29/2021,12921,82L-IMPORT PAYROLL-LI SEN YUAN,D108,HJ,1047.62,,4082825.35
6100,1/29/2021,1/29/2021,12921,82L-IMPORT PAYROLL-LIPSCOMB STEPHEN,D108,HJ,2541.67,,4085367.02
6100,1/29/2021,1/29/2021,12921,82L-IMPORT PAYROLL-MALLECK JESSICA R,D108,HJ,1047.62,,4086414.64
6100,1/29/2021,1/29/2021,12921,82L-IMPORT PAYROLL-MEJIA ROSO CARLOS,D108,HJ,1047.62,,4087462.26
6100,1/29/2021,1/29/2021,12921,82L-IMPORT PAYROLL-MONROY-MEJIA JASON,D108,HJ,1047.62,,4088509.88
6100,1/29/2021,1/29/2021,12921,82L-IMPORT PAYROLL-O'FLYNN-PRUITT NATHAN COLYAR,D108,HJ,1047.62,,4089557.5
6100,1/29/2021,1/29/2021,12921,82L-IMPORT PAYROLL-OKRAH JULIAN O,D108,HJ,1047.62,,4090605.12
6100,1/29/2021,1/29/2021,12921,82L-IMPORT PAYROLL-PATTERSON STEVE,D108,HJ,1047.62,,4091652.74
6100,1/29/2021,1/29/2021,12921,82L-IMPORT PAYROLL-SCHMIESS RACHEL JOY,D108,HJ,1047.62,,4092700.36
6100,1/29/2021,1/29/2021,12921,82L-IMPORT PAYROLL-SCOTT KIRK DONOVAN,D108,HJ,1047.62,,4093747.98
6100,1/29/2021,1/29/2021,12921,82L-IMPORT PAYROLL-SILVER KELLY,D108,HJ,2541.67,,4096289.65
6100,1/29/2021,1/29/2021,12921,82L-IMPORT PAYROLL-SOLIMAN MARK,D108,HJ,1047.62,,4097337.27
6100,1/29/2021,1/29/2021,12921,82L-IMPORT PAYROLL-STEIN KYLE,D108,HJ,2083.33,,4099420.6
6100,1/29/2021,1/29/2021,12921,82L-IMPORT PAYROLL-STROUD DAVID,D108,HJ,1047.62,,4100468.22
6100,1/29/2021,1/29/2021,12921,82L-IMPORT PAYROLL-VALCIN SABRINA JEMIMAH,D108,HJ,1047.62,,4101515.84
6100,1/29/2021,1/29/2021,12921,82L-IMPORT PAYROLL-VALDES ERNEST L,D108,HJ,1047.62,,4102563.46
6100,1/29/2021,1/29/2021,12921,82L-IMPORT PAYROLL-WILLIAMS MACK ANTHONY,D108,HJ,1047.62,,4103611.08
6100,1/29/2021,1/29/2021,12921,82L-IMPORT PAYROLL-WILLIAMS MIL'YONTA,D108,HJ,1047.62,,4104658.7
6100,1/29/2021,1/29/2021,12921,82L-IMPORT PAYROLL-ANTHONY BETTY S,D108,HJ,2886.52,,4107545.22
6100,1/29/2021,1/29/2021,12921,82L-IMPORT PAYROLL-APULI LINDSAY,D108,HJ,2500,,4110045.22
6100,1/29/2021,1/29/2021,12921,82L-IMPORT PAYROLL-AUSTIN PERCY ANTONIO,D108,HJ,2653.02,,4112698.24
6100,1/29/2021,1/29/2021,12921,82L-IMPORT PAYROLL-BUHMANN JENNIFER,D108,HJ,2270.83,,4114969.07
6100,1/29/2021,1/29/2021,12921,82L-IMPORT PAYROLL-CAIN CORY,D108,HJ,2708.33,,4117677.4
6100,1/29/2021,1/29/2021,12921,82L-IMPORT PAYROLL-CHAPMAN CLAUDY EARL,D108,HJ,2291.67,,4119969.07
6100,1/29/2021,1/29/2021,12921,82L-IMPORT PAYROLL-DADA ARIKPO E,D108,HJ,2720,,4122689.07
6100,1/29/2021,1/29/2021,12921,82L-IMPORT PAYROLL-GUTHRIE LESLIE,D108,HJ,2458.33,,4125147.4
6100,1/29/2021,1/29/2021,12921,82L-IMPORT PAYROLL-HOLMES JOREL ALEXANDER,D108,HJ,2329,,4127476.4
6100,1/29/2021,1/29/2021,12921,82L-IMPORT PAYROLL-JORDAN TIFFANY T,D108,HJ,3445,,4130921.4
6100,1/29/2021,1/29/2021,12921,82L-IMPORT PAYROLL-LANIGAN LISA A,D108,HJ,3113.75,,4134035.15
6100,1/29/2021,1/29/2021,12921,82L-IMPORT PAYROLL-MCELWEE MELISSA,D108,HJ,2666.67,,4136701.82
6100,1/29/2021,1/29/2021,12921,82L-IMPORT PAYROLL-MCNICHOLAS MARY,D108,HJ,2291.67,,4138993.49
6100,1/29/2021,1/29/2021,12921,82L-IMPORT PAYROLL-NWAKANMA NANCY,D108,HJ,3046.67,,4142040.16
6100,1/29/2021,1/29/2021,12921,82L-IMPORT PAYROLL-ONICA ANTHONY J,D108,HJ,278.13,,4142318.29
6100,1/29/2021,1/29/2021,12921,82L-IMPORT PAYROLL-ONICA ANTHONY J,D108,HJ,2138.54,,4144456.83
6100,1/29/2021,1/29/2021,12921,82L-IMPORT PAYROLL-PRAHIN NICOLE M,D108,HJ,762.5,,4145219.33
6100,1/29/2021,1/29/2021,12921,82L-IMPORT PAYROLL-PRAHIN NICOLE M,D108,HJ,3050,,4148269.33
6100,1/29/2021,1/29/2021,12921,82L-IMPORT PAYROLL-RIVERS QUIONNA DIANE,D108,HJ,2708.34,,4150977.67
6100,1/29/2021,1/29/2021,12921,82L-IMPORT PAYROLL-SALIM YASSER,D108,HJ,2431.94,,4153409.61
6100,1/29/2021,1/29/2021,12921,82L-IMPORT PAYROLL-SEJOUR MAHALIAH,D108,HJ,2500,,4155909.61
6100,1/29/2021,1/29/2021,12921,82L-IMPORT PAYROLL-SKALSKI CHRISTOPHER,D108,HJ,2465,,4158374.61
6100,1/29/2021,1/29/2021,12921,82L-IMPORT PAYROLL-TUMENJARGAL ENKHJIN,D108,HJ,2414,,4160788.61
6100,1/29/2021,1/29/2021,12921,82L-IMPORT PAYROLL-VILLEGAS EVELYN,D108,HJ,2817.75,,4163606.36
6100,1/29/2021,1/29/2021,12921,82L-IMPORT PAYROLL-WOLF ANNA A,D108,HJ,2635,,4166241.36
6100,1/29/2021,1/29/2021,12921,82L-IMPORT PAYROLL-ACEVEDO MONIVETT,D107,HJ,5375,,4171616.36
6100,1/29/2021,1/29/2021,12921,82L-IMPORT PAYROLL-AKLESTAD ISABEL,D111,HJ,50,,4171666.36
6100,1/29/2021,1/29/2021,12921,82L-IMPORT PAYROLL-AKLESTAD ISABEL,D111,HJ,1750,,4173416.36
6100,1/29/2021,1/29/2021,12921,82L-IMPORT PAYROLL-BIBB TIFFANI,D104,HJ,3875,,4177291.36
6100,1/29/2021,1/29/2021,12921,82L-IMPORT PAYROLL-BOWMAN HALLEY K,D101,HJ,3437.5,,4180728.86
6100,1/29/2021,1/29/2021,12921,82L-IMPORT PAYROLL-COOK CATHRYN ANNA,D105,HJ,3593.03,,4184321.89
6100,1/29/2021,1/29/2021,12921,82L-IMPORT PAYROLL-COOPER ASHLEE R,D101,HJ,2461.88,,4186783.77
6100,1/29/2021,1/29/2021,12921,82L-IMPORT PAYROLL-CORTEZ MIRANDA A,D111,HJ,50,,4186833.77
6100,1/29/2021,1/29/2021,12921,82L-IMPORT PAYROLL-CORTEZ MIRANDA A,D111,HJ,2672.72,,4189506.49
6100,1/29/2021,1/29/2021,12921,82L-IMPORT PAYROLL-DAUGHERTY DEVIN W,D101,HJ,1041.67,,4190548.16
6100,1/29/2021,1/29/2021,12921,82L-IMPORT PAYROLL-DETONE KYRA MAYA,D102,HJ,2916.67,,4193464.83
6100,1/29/2021,1/29/2021,12921,82L-IMPORT PAYROLL-DUPUIS CHRISTOPHER M,D107,HJ,3135.41,,4196600.24
6100,1/29/2021,1/29/2021,12921,82L-IMPORT PAYROLL-DUPUIS CHRISTOPHER M,D107,HJ,3135.42,,4199735.66
6100,1/29/2021,1/29/2021,12921,82L-IMPORT PAYROLL-DZIEDZIC JULIE K,D101,HJ,1250,,4200985.66
6100,1/29/2021,1/29/2021,12921,82L-IMPORT PAYROLL-FEENEY CLAIRE,D104,HJ,50,,4201035.66
6100,1/29/2021,1/29/2021,12921,82L-IMPORT PAYROLL-FEENEY CLAIRE,D104,HJ,2000,,4203035.66
6100,1/29/2021,1/29/2021,12921,82L-IMPORT PAYROLL-FISCHABER THOMAS,D109,HJ,439.65,,4203475.31
6100,1/29/2021,1/29/2021,12921,82L-IMPORT PAYROLL-FISCHABER THOMAS,D109,HJ,5416.67,,4208891.98
6100,1/29/2021,1/29/2021,12921,82L-IMPORT PAYROLL-FLORY MEGAN,D109,HJ,1500,,4210391.98
6100,1/29/2021,1/29/2021,12921,82L-IMPORT PAYROLL-GORNSTEIN STEVEN,D101,HJ,2708.33,,4213100.31
6100,1/29/2021,1/29/2021,12921,82L-IMPORT PAYROLL-GUADARRAMA-ALVAREZ URIEL A,D105,HJ,2897.92,,4215998.23
6100,1/29/2021,1/29/2021,12921,82L-IMPORT PAYROLL-GUTIERREZ ANTONIO J,D107,HJ,2277.18,,4218275.41
6100,1/29/2021,1/29/2021,12921,82L-IMPORT PAYROLL-GUTIERREZ ANTONIO J,D107,HJ,3415.76,,4221691.17
6100,1/29/2021,1/29/2021,12921,82L-IMPORT PAYROLL-HENRY GILLIAN,D102,HJ,2083.34,,4223774.51
6100,1/29/2021,1/29/2021,12921,82L-IMPORT PAYROLL-HERMAN ADAM,D102,HJ,1958.33,,4225732.84
6100,1/29/2021,1/29/2021,12921,82L-IMPORT PAYROLL-HERNANDEZ ANNA,D101,HJ,2708.33,,4228441.17
6100,1/29/2021,1/29/2021,12921,82L-IMPORT PAYROLL-HESTER TYLER CONRAD,D105,HJ,1916.67,,4230357.84
6100,1/29/2021,1/29/2021,12921,82L-IMPORT PAYROLL-HOLT ADAM,D109,HJ,153.53,,4230511.37
6100,1/29/2021,1/29/2021,12921,82L-IMPORT PAYROLL-HOLT ADAM,D109,HJ,4166.67,,4234678.04
6100,1/29/2021,1/29/2021,12921,82L-IMPORT PAYROLL-KELLY SEAN,D109,HJ,5416.67,,4240094.71
6100,1/29/2021,1/29/2021,12921,82L-IMPORT PAYROLL-KRUGER MARK,D109,HJ,5000,,4245094.71
6100,1/29/2021,1/29/2021,12921,82L-IMPORT PAYROLL-LIPORACE HERNAN LUIS,D103,HJ,2291.67,,4247386.38
6100,1/29/2021,1/29/2021,12921,82L-IMPORT PAYROLL-MARKS KRISTA,D109,HJ,153.53,,4247539.91
6100,1/29/2021,1/29/2021,12921,82L-IMPORT PAYROLL-MARKS KRISTA,D109,HJ,5416.67,,4252956.58
6100,1/29/2021,1/29/2021,12921,82L-IMPORT PAYROLL-MELVIN DARNELL KEVIN,D109,HJ,4000,,4256956.58
6100,1/29/2021,1/29/2021,12921,82L-IMPORT PAYROLL-MESSING JENNIFER,D104,HJ,2500,,4259456.58
6100,1/29/2021,1/29/2021,12921,82L-IMPORT PAYROLL-MILNE ROGER,D109,HJ,150.66,,4259607.24
6100,1/29/2021,1/29/2021,12921,82L-IMPORT PAYROLL-MILNE ROGER,D109,HJ,5416.67,,4265023.91
6100,1/29/2021,1/29/2021,12921,82L-IMPORT PAYROLL-MOSTAFAVI YASAMAN,D109,HJ,528,,4265551.91
6100,1/29/2021,1/29/2021,12921,82L-IMPORT PAYROLL-O'DONNELL STEPHEN,D104,HJ,2707.5,,4268259.41
6100,1/29/2021,1/29/2021,12921,82L-IMPORT PAYROLL-PARETS MALLORY GRACE,D101,HJ,2833.33,,4271092.74
6100,1/29/2021,1/29/2021,12921,82L-IMPORT PAYROLL-PARHAM-GANTT DENISE M,D112,HJ,3041.67,,4274134.41
6100,1/29/2021,1/29/2021,12921,82L-IMPORT PAYROLL-PEINADO ELIZABETH R,D111,HJ,50,,4274184.41
6100,1/29/2021,1/29/2021,12921,82L-IMPORT PAYROLL-PEINADO ELIZABETH R,D111,HJ,3749.96,,4277934.37
6100,1/29/2021,1/29/2021,12921,82L-IMPORT PAYROLL-PERNIA JEFFREY,D109,HJ,146.72,,4278081.09
6100,1/29/2021,1/29/2021,12921,82L-IMPORT PAYROLL-PERNIA JEFFREY,D109,HJ,3875,,4281956.09
6100,1/29/2021,1/29/2021,12921,82L-IMPORT PAYROLL-PIRES MANUEL,D103,HJ,2208.33,,4284164.42
6100,1/29/2021,1/29/2021,12921,82L-IMPORT PAYROLL-POLANCO ODALIS,D103,HJ,3124.96,,4287289.38
6100,1/29/2021,1/29/2021,12921,82L-IMPORT PAYROLL-QUINTAS JASHIVE,D105,HJ,1916.67,,4289206.05
6100,1/29/2021,1/29/2021,12921,82L-IMPORT PAYROLL-RANDOLPH ALEXANDER,D111,HJ,50,,4289256.05
6100,1/29/2021,1/29/2021,12921,82L-IMPORT PAYROLL-RANDOLPH ALEXANDER,D111,HJ,1875,,4291131.05
6100,1/29/2021,1/29/2021,12921,82L-IMPORT PAYROLL-RUBI PERLA,D101,HJ,1250,,4292381.05
6100,1/29/2021,1/29/2021,12921,82L-IMPORT PAYROLL-SAFRAN ALAN P,D107,HJ,774.24,,4293155.29
6100,1/29/2021,1/29/2021,12921,82L-IMPORT PAYROLL-SAFRAN ALAN P,D107,HJ,6968.15,,4300123.44
6100,1/29/2021,1/29/2021,12921,82L-IMPORT PAYROLL-SHENKMAN OLIVIA,D101,HJ,2000,,4302123.44
6100,1/29/2021,1/29/2021,12921,82L-IMPORT PAYROLL-SHI GRACE,D103,HJ,875,,4302998.44
6100,1/29/2021,1/29/2021,12921,82L-IMPORT PAYROLL-VYAS SUNAINA,D104,HJ,50,,4303048.44
6100,1/29/2021,1/29/2021,12921,82L-IMPORT PAYROLL-VYAS SUNAINA,D104,HJ,1958.33,,4305006.77
6100,1/29/2021,1/29/2021,12921,82L-IMPORT PAYROLL-WALLACE AMENA,D104,HJ,2187.5,,4307194.27
6100,1/29/2021,1/29/2021,12921,82L-IMPORT PAYROLL-WARD JEFFREY,D109,HJ,439.65,,4307633.92
6100,1/29/2021,1/29/2021,12921,82L-IMPORT PAYROLL-WARD JEFFREY,D109,HJ,5416.67,,4313050.59
6100,1/29/2021,1/29/2021,12921,82L-IMPORT PAYROLL-WARD JENNIFER,D109,HJ,1053,,4314103.59
6100,1/29/2021,1/29/2021,12921,82L-IMPORT PAYROLL-WEINSTOCK EMILY,D101,HJ,2833.33,,4316936.92
6100,1/29/2021,1/29/2021,12921,82L-IMPORT PAYROLL-WINANS JENNIFER,D111,HJ,50,,4316986.92
6100,1/29/2021,1/29/2021,12921,82L-IMPORT PAYROLL-WINANS JENNIFER,D111,HJ,2505.63,,4319492.55
6100,1/29/2021,1/29/2021,12921,82L-IMPORT PAYROLL-ZARATE JOSEPH M,D105,HJ,2150,,4321642.55
6100,1/29/2021,1/29/2021,12921,82L-IMPORT PAYROLL-AGUANNO JOSEPH,D108,HJ,1119.05,,4322761.6
6100,1/29/2021,1/29/2021,12921,82L-IMPORT PAYROLL-AKESODE FEHINTOLA,D108,HJ,1119.05,,4323880.65
6100,1/29/2021,1/29/2021,12921,82L-IMPORT PAYROLL-BARTOLD DEANNA MARIE,D108,HJ,3034.5,,4326915.15
6100,1/29/2021,1/29/2021,12921,82L-IMPORT PAYROLL-BELLOT GENESIS,D108,HJ,2500,,4329415.15
6100,1/29/2021,1/29/2021,12921,82L-IMPORT PAYROLL-BENNETT JAMES H,D108,HJ,1119.05,,4330534.2
6100,1/29/2021,1/29/2021,12921,82L-IMPORT PAYROLL-BOWMAN ABIGAIL,D108,HJ,1119.05,,4331653.25
6100,1/29/2021,1/29/2021,12921,82L-IMPORT PAYROLL-BURRELL RUSSELL,D108,HJ,1119.05,,4332772.3
6100,1/29/2021,1/29/2021,12921,82L-IMPORT PAYROLL-CHUI KENT,D108,HJ,1119.05,,4333891.35
6100,1/29/2021,1/29/2021,12921,82L-IMPORT PAYROLL-CIRKER MIA,D108,HJ,2250,,4336141.35
6100,1/29/2021,1/29/2021,12921,82L-IMPORT PAYROLL-DEWS CAMERYN,D108,HJ,2291.67,,4338433.02
6100,1/29/2021,1/29/2021,12921,82L-IMPORT PAYROLL-DIETZ MARY,D108,HJ,1119.05,,4339552.07
6100,1/29/2021,1/29/2021,12921,82L-IMPORT PAYROLL-DOMINIQUE PRINCESSA,D108,HJ,1119.05,,4340671.12
6100,1/29/2021,1/29/2021,12921,82L-IMPORT PAYROLL-DONNELLY HOME,D108,HJ,1119.05,,4341790.17
6100,1/29/2021,1/29/2021,12921,82L-IMPORT PAYROLL-FEIGHERY JOHN,D108,HJ,2250,,4344040.17
6100,1/29/2021,1/29/2021,12921,82L-IMPORT PAYROLL-FORTH KYLE,D108,HJ,1119.05,,4345159.22
6100,1/29/2021,1/29/2021,12921,82L-IMPORT PAYROLL-GARCIA MARILYN,D108,HJ,2291.67,,4347450.89
6100,1/29/2021,1/29/2021,12921,82L-IMPORT PAYROLL-GREENE BROOKE,D108,HJ,1119.05,,4348569.94
6100,1/29/2021,1/29/2021,12921,82L-IMPORT PAYROLL-GRIFFIN ANDREW,D108,HJ,2250,,4350819.94
6100,1/29/2021,1/29/2021,12921,82L-IMPORT PAYROLL-GROSS EMILY,D108,HJ,1119.05,,4351938.99
6100,1/29/2021,1/29/2021,12921,82L-IMPORT PAYROLL-GUERRERO LUIS,D108,HJ,1119.05,,4353058.04
6100,1/29/2021,1/29/2021,12921,82L-IMPORT PAYROLL-HALLINAN GABRIEL,D108,HJ,2550,,4355608.04
6100,1/29/2021,1/29/2021,12921,82L-IMPORT PAYROLL-HAMERSLY WILLIAM,D108,HJ,2500,,4358108.04
6100,1/29/2021,1/29/2021,12921,82L-IMPORT PAYROLL-HOSSAIN MYESHA,D108,HJ,2437.5,,4360545.54
6100,1/29/2021,1/29/2021,12921,82L-IMPORT PAYROLL-JACKSON TASNIM F,D108,HJ,2291.67,,4362837.21
6100,1/29/2021,1/29/2021,12921,82L-IMPORT PAYROLL-KERKHOFF HARPER FAITH,D108,HJ,1119.05,,4363956.26
6100,1/29/2021,1/29/2021,12921,82L-IMPORT PAYROLL-LEARY AUBREY,D108,HJ,1119.05,,4365075.31
6100,1/29/2021,1/29/2021,12921,82L-IMPORT PAYROLL-LI BELLA,D108,HJ,2486.25,,4367561.56
6100,1/29/2021,1/29/2021,12921,82L-IMPORT PAYROLL-LOUIE JORDAN,D108,HJ,1119.05,,4368680.61
6100,1/29/2021,1/29/2021,12921,82L-IMPORT PAYROLL-MELCHOR OSBEIDY,D108,HJ,1119.05,,4369799.66
6100,1/29/2021,1/29/2021,12921,82L-IMPORT PAYROLL-MORRIS ZAKIYA,D108,HJ,1119.05,,4370918.71
6100,1/29/2021,1/29/2021,12921,82L-IMPORT PAYROLL-MORSELETTO RAFAEL,D108,HJ,1119.05,,4372037.76
6100,1/29/2021,1/29/2021,12921,82L-IMPORT PAYROLL-OBI TOBECHUKWU,D108,HJ,1119.05,,4373156.81
6100,1/29/2021,1/29/2021,12921,82L-IMPORT PAYROLL-OPUH NDIDI,D108,HJ,2833.33,,4375990.14
6100,1/29/2021,1/29/2021,12921,82L-IMPORT PAYROLL-PAULINO THAIRI,D108,HJ,1119.05,,4377109.19
6100,1/29/2021,1/29/2021,12921,82L-IMPORT PAYROLL-ROSENBAUM MURRAY,D108,HJ,1119.05,,4378228.24
6100,1/29/2021,1/29/2021,12921,82L-IMPORT PAYROLL-SCHWETTMANN CLAIRE,D108,HJ,1119.05,,4379347.29
6100,1/29/2021,1/29/2021,12921,82L-IMPORT PAYROLL-SOBELMAN JUSTIN,D108,HJ,1119.05,,4380466.34
6100,1/29/2021,1/29/2021,12921,82L-IMPORT PAYROLL-TERRENCE-SMITH ZIHIR,D108,HJ,1119.05,,4381585.39
6100,1/29/2021,1/29/2021,12921,82L-IMPORT PAYROLL-TILLERY ASIA,D108,HJ,455.76,,4382041.15
6100,1/29/2021,1/29/2021,12921,82L-IMPORT PAYROLL-TILLERY ASIA,D108,HJ,3291.67,,4385332.82
6100,1/29/2021,1/29/2021,12921,82L-IMPORT PAYROLL-WILLIAMS-MASSEY BRIANNA,D108,HJ,1119.05,,4386451.87
6100,1/29/2021,1/29/2021,12921,82L-IMPORT PAYROLL-XIAO CHENGYAO,D108,HJ,1119.05,,4387570.92
6100,1/29/2021,1/29/2021,12921,82L-IMPORT PAYROLL-ZIAUDDIN ABUTAHER,D108,HJ,1119.05,,4388689.97
6100,1/29/2021,1/29/2021,12921,82L-IMPORT PAYROLL-BALASUBRAMANIAN SHARANYA,D108,HJ,2666.67,,4391356.64
6100,1/29/2021,1/29/2021,12921,82L-IMPORT PAYROLL-COVENEY ALLISON,D108,HJ,2854.17,,4394210.81
6100,1/29/2021,1/29/2021,12921,82L-IMPORT PAYROLL-JACKSON CLAICE M,D108,HJ,3125,,4397335.81
6100,1/29/2021,1/29/2021,12921,82L-IMPORT PAYROLL-JANG DANIEL,D108,HJ,2750,,4400085.81
6100,1/29/2021,1/29/2021,12921,82L-IMPORT PAYROLL-LENEGHAN MARYELLEN,D108,HJ,940.71,,4401026.52
6100,1/29/2021,1/29/2021,12921,82L-IMPORT PAYROLL-LENEGHAN MARYELLEN,D108,HJ,1906.25,,4402932.77
6100,1/29/2021,1/29/2021,12921,82L-IMPORT PAYROLL-LENEGHAN MARYELLEN,D108,HJ,1906.25,,4404839.02
6100,2/12/2021,2/12/2021,21221,82L-IMPORT PAYROLL-BARTHELEMY RACHALIE,D108,HJ,1047.62,,4405886.64
6100,2/12/2021,2/12/2021,21221,82L-IMPORT PAYROLL-BOHLSEN GRACE ISABELLE,D108,HJ,1047.62,,4406934.26
6100,2/12/2021,2/12/2021,21221,82L-IMPORT PAYROLL-BOLIVAR ANDREA,D108,HJ,2500,,4409434.26
6100,2/12/2021,2/12/2021,21221,82L-IMPORT PAYROLL-BORCHART SPENCER,D108,HJ,1047.62,,4410481.88
6100,2/12/2021,2/12/2021,21221,82L-IMPORT PAYROLL-BRIANTE SAMUEL,D108,HJ,483.5,,4410965.38
6100,2/12/2021,2/12/2021,21221,82L-IMPORT PAYROLL-BROWN ISAAC,D108,HJ,1047.62,,4412013
6100,2/12/2021,2/12/2021,21221,82L-IMPORT PAYROLL-BURKE MARIAH,D108,HJ,676.9,,4412689.9
6100,2/12/2021,2/12/2021,21221,82L-IMPORT PAYROLL-CASSADY JOSHUA LEWIS,D108,HJ,1047.62,,4413737.52
6100,2/12/2021,2/12/2021,21221,82L-IMPORT PAYROLL-DARKO OLIVIA,D108,HJ,1047.62,,4414785.14
6100,2/12/2021,2/12/2021,21221,82L-IMPORT PAYROLL-ESCAMILLA OLGA,D108,HJ,1047.62,,4415832.76
6100,2/12/2021,2/12/2021,21221,82L-IMPORT PAYROLL-GARCIA SANTIAGO,D108,HJ,2041.67,,4417874.43
6100,2/12/2021,2/12/2021,21221,82L-IMPORT PAYROLL-GILES SHAYLA,D108,HJ,1047.62,,4418922.05
6100,2/12/2021,2/12/2021,21221,82L-IMPORT PAYROLL-IKUNIKA FUNMILAYO,D108,HJ,2083.33,,4421005.38
6100,2/12/2021,2/12/2021,21221,82L-IMPORT PAYROLL-JONES JORDAN,D108,HJ,1047.62,,4422053
6100,2/12/2021,2/12/2021,21221,82L-IMPORT PAYROLL-KHAN HUDA,D108,HJ,1047.62,,4423100.62
6100,2/12/2021,2/12/2021,21221,82L-IMPORT PAYROLL-KLOHR TIMOTHY JORDAN,D108,HJ,2000,,4425100.62
6100,2/12/2021,2/12/2021,21221,82L-IMPORT PAYROLL-KNOWLIN ZYLIA,D108,HJ,2541.67,,4427642.29
6100,2/12/2021,2/12/2021,21221,82L-IMPORT PAYROLL-LAI GRADY,D108,HJ,1047.62,,4428689.91
6100,2/12/2021,2/12/2021,21221,82L-IMPORT PAYROLL-LI SEN YUAN,D108,HJ,1047.62,,4429737.53
6100,2/12/2021,2/12/2021,21221,82L-IMPORT PAYROLL-LIPSCOMB STEPHEN,D108,HJ,2541.67,,4432279.2
6100,2/12/2021,2/12/2021,21221,82L-IMPORT PAYROLL-MALLECK JESSICA R,D108,HJ,1047.62,,4433326.82
6100,2/12/2021,2/12/2021,21221,82L-IMPORT PAYROLL-MEJIA ROSO CARLOS,D108,HJ,1047.62,,4434374.44
6100,2/12/2021,2/12/2021,21221,82L-IMPORT PAYROLL-MONROY-MEJIA JASON,D108,HJ,1047.62,,4435422.06
6100,2/12/2021,2/12/2021,21221,82L-IMPORT PAYROLL-O'FLYNN-PRUITT NATHAN COLYAR,D108,HJ,1047.62,,4436469.68
6100,2/12/2021,2/12/2021,21221,82L-IMPORT PAYROLL-OKRAH JULIAN O,D108,HJ,1047.62,,4437517.3
6100,2/12/2021,2/12/2021,21221,82L-IMPORT PAYROLL-PATTERSON STEVE,D108,HJ,1047.62,,4438564.92
6100,2/12/2021,2/12/2021,21221,82L-IMPORT PAYROLL-SAINI BALJIT,D108,HJ,483.5,,4439048.42
6100,2/12/2021,2/12/2021,21221,82L-IMPORT PAYROLL-SCHMIESS RACHEL JOY,D108,HJ,1047.62,,4440096.04
6100,2/12/2021,2/12/2021,21221,82L-IMPORT PAYROLL-SCOTT KIRK DONOVAN,D108,HJ,1047.62,,4441143.66
6100,2/12/2021,2/12/2021,21221,82L-IMPORT PAYROLL-SILVER KELLY,D108,HJ,2541.67,,4443685.33
6100,2/12/2021,2/12/2021,21221,82L-IMPORT PAYROLL-SOLIMAN MARK,D108,HJ,1047.62,,4444732.95
6100,2/12/2021,2/12/2021,21221,82L-IMPORT PAYROLL-STEIN KYLE,D108,HJ,2083.33,,4446816.28
6100,2/12/2021,2/12/2021,21221,82L-IMPORT PAYROLL-STROUD DAVID,D108,HJ,1047.62,,4447863.9
6100,2/12/2021,2/12/2021,21221,82L-IMPORT PAYROLL-VALCIN SABRINA JEMIMAH,D108,HJ,1047.62,,4448911.52
6100,2/12/2021,2/12/2021,21221,82L-IMPORT PAYROLL-VALDES ERNEST L,D108,HJ,1047.62,,4449959.14
6100,2/12/2021,2/12/2021,21221,82L-IMPORT PAYROLL-WILLIAMS MACK ANTHONY,D108,HJ,1047.62,,4451006.76
6100,2/12/2021,2/12/2021,21221,82L-IMPORT PAYROLL-WILLIAMS MIL'YONTA,D108,HJ,1047.62,,4452054.38
6100,2/12/2021,2/12/2021,21221,82L-IMPORT PAYROLL-ANTHONY BETTY S,D108,HJ,2886.52,,4454940.9
6100,2/12/2021,2/12/2021,21221,82L-IMPORT PAYROLL-APULI LINDSAY,D108,HJ,2500,,4457440.9
6100,2/12/2021,2/12/2021,21221,82L-IMPORT PAYROLL-AUSTIN PERCY ANTONIO,D108,HJ,2653.02,,4460093.92
6100,2/12/2021,2/12/2021,21221,82L-IMPORT PAYROLL-BUHMANN JENNIFER,D108,HJ,2270.83,,4462364.75
6100,2/12/2021,2/12/2021,21221,82L-IMPORT PAYROLL-CAIN CORY,D108,HJ,2708.33,,4465073.08
6100,2/12/2021,2/12/2021,21221,82L-IMPORT PAYROLL-CHAPMAN CLAUDY EARL,D108,HJ,2291.67,,4467364.75
6100,2/12/2021,2/12/2021,21221,82L-IMPORT PAYROLL-DADA ARIKPO E,D108,HJ,2720,,4470084.75
6100,2/12/2021,2/12/2021,21221,82L-IMPORT PAYROLL-GUTHRIE LESLIE,D108,HJ,2458.33,,4472543.08
6100,2/12/2021,2/12/2021,21221,82L-IMPORT PAYROLL-HOLMES JOREL ALEXANDER,D108,HJ,2329,,4474872.08
6100,2/12/2021,2/12/2021,21221,82L-IMPORT PAYROLL-JORDAN TIFFANY T,D108,HJ,3445,,4478317.08
6100,2/12/2021,2/12/2021,21221,82L-IMPORT PAYROLL-LANIGAN LISA A,D108,HJ,3113.75,,4481430.83
6100,2/12/2021,2/12/2021,21221,82L-IMPORT PAYROLL-MCELWEE MELISSA,D108,HJ,2666.67,,4484097.5
6100,2/12/2021,2/12/2021,21221,82L-IMPORT PAYROLL-MCNICHOLAS MARY,D108,HJ,2291.67,,4486389.17
6100,2/12/2021,2/12/2021,21221,82L-IMPORT PAYROLL-NWAKANMA NANCY,D108,HJ,3046.67,,4489435.84
6100,2/12/2021,2/12/2021,21221,82L-IMPORT PAYROLL-ONICA ANTHONY J,D108,HJ,2416.67,,4491852.51
6100,2/12/2021,2/12/2021,21221,82L-IMPORT PAYROLL-PRAHIN NICOLE M,D108,HJ,3812.5,,4495665.01
6100,2/12/2021,2/12/2021,21221,82L-IMPORT PAYROLL-RIVERS QUIONNA DIANE,D108,HJ,2708.34,,4498373.35
6100,2/12/2021,2/12/2021,21221,82L-IMPORT PAYROLL-SALIM YASSER,D108,HJ,2431.94,,4500805.29
6100,2/12/2021,2/12/2021,21221,82L-IMPORT PAYROLL-SEJOUR MAHALIAH,D108,HJ,2500,,4503305.29
6100,2/12/2021,2/12/2021,21221,82L-IMPORT PAYROLL-SKALSKI CHRISTOPHER,D108,HJ,2465,,4505770.29
6100,2/12/2021,2/12/2021,21221,82L-IMPORT PAYROLL-TUMENJARGAL ENKHJIN,D108,HJ,2414,,4508184.29
6100,2/12/2021,2/12/2021,21221,82L-IMPORT PAYROLL-VILLEGAS EVELYN,D108,HJ,2817.75,,4511002.04
6100,2/12/2021,2/12/2021,21221,82L-IMPORT PAYROLL-WOLF ANNA A,D108,HJ,2635,,4513637.04
6100,2/12/2021,2/12/2021,21221,82L-IMPORT PAYROLL-ACEVEDO MONIVETT,D107,HJ,5375,,4519012.04
6100,2/12/2021,2/12/2021,21221,82L-IMPORT PAYROLL-AKLESTAD ISABEL,D111,HJ,1750,,4520762.04
6100,2/12/2021,2/12/2021,21221,82L-IMPORT PAYROLL-BIBB TIFFANI,D104,HJ,3875,,4524637.04
6100,2/12/2021,2/12/2021,21221,82L-IMPORT PAYROLL-BOWMAN HALLEY K,D101,HJ,3437.5,,4528074.54
6100,2/12/2021,2/12/2021,21221,82L-IMPORT PAYROLL-COOK CATHRYN ANNA,D105,HJ,3593.03,,4531667.57
6100,2/12/2021,2/12/2021,21221,82L-IMPORT PAYROLL-COOPER ASHLEE R,D101,HJ,2461.88,,4534129.45
6100,2/12/2021,2/12/2021,21221,82L-IMPORT PAYROLL-CORTEZ MIRANDA A,D111,HJ,2672.72,,4536802.17
6100,2/12/2021,2/12/2021,21221,82L-IMPORT PAYROLL-DAUGHERTY DEVIN W,D101,HJ,1562.62,,4538364.79
6100,2/12/2021,2/12/2021,21221,82L-IMPORT PAYROLL-DETONE KYRA MAYA,D102,HJ,2916.67,,4541281.46
6100,2/12/2021,2/12/2021,21221,82L-IMPORT PAYROLL-DUPUIS CHRISTOPHER M,D107,HJ,2821.87,,4544103.33
6100,2/12/2021,2/12/2021,21221,82L-IMPORT PAYROLL-DUPUIS CHRISTOPHER M,D107,HJ,3448.96,,4547552.29
6100,2/12/2021,2/12/2021,21221,82L-IMPORT PAYROLL-DZIEDZIC JULIE K,D101,HJ,1250,,4548802.29
6100,2/12/2021,2/12/2021,21221,82L-IMPORT PAYROLL-FEENEY CLAIRE,D104,HJ,2000,,4550802.29
6100,2/12/2021,2/12/2021,21221,82L-IMPORT PAYROLL-FISCHABER THOMAS,D109,HJ,439.65,,4551241.94
6100,2/12/2021,2/12/2021,21221,82L-IMPORT PAYROLL-FISCHABER THOMAS,D109,HJ,5416.67,,4556658.61
6100,2/12/2021,2/12/2021,21221,82L-IMPORT PAYROLL-FLORY MEGAN,D109,HJ,1500,,4558158.61
6100,2/12/2021,2/12/2021,21221,82L-IMPORT PAYROLL-GORNSTEIN STEVEN,D101,HJ,2708.33,,4560866.94
6100,2/12/2021,2/12/2021,21221,82L-IMPORT PAYROLL-GUADARRAMA-ALVAREZ URIEL A,D105,HJ,2897.92,,4563764.86
6100,2/12/2021,2/12/2021,21221,82L-IMPORT PAYROLL-GUTIERREZ ANTONIO J,D107,HJ,2049.45,,4565814.31
6100,2/12/2021,2/12/2021,21221,82L-IMPORT PAYROLL-GUTIERREZ ANTONIO J,D107,HJ,3643.49,,4569457.8
6100,2/12/2021,2/12/2021,21221,82L-IMPORT PAYROLL-HENRY GILLIAN,D102,HJ,2083.34,,4571541.14
6100,2/12/2021,2/12/2021,21221,82L-IMPORT PAYROLL-HERMAN ADAM,D102,HJ,1958.33,,4573499.47
6100,2/12/2021,2/12/2021,21221,82L-IMPORT PAYROLL-HERNANDEZ ANNA,D101,HJ,2708.33,,4576207.8
6100,2/12/2021,2/12/2021,21221,82L-IMPORT PAYROLL-HESTER TYLER CONRAD,D105,HJ,1916.67,,4578124.47
6100,2/12/2021,2/12/2021,21221,82L-IMPORT PAYROLL-HOLT ADAM,D109,HJ,153.53,,4578278
6100,2/12/2021,2/12/2021,21221,82L-IMPORT PAYROLL-HOLT ADAM,D109,HJ,4166.67,,4582444.67
6100,2/12/2021,2/12/2021,21221,82L-IMPORT PAYROLL-IWASAKI MIKA,D101,HJ,2166.67,,4584611.34
6100,2/12/2021,2/12/2021,21221,82L-IMPORT PAYROLL-KELLY SEAN,D109,HJ,5416.67,,4590028.01
6100,2/12/2021,2/12/2021,21221,82L-IMPORT PAYROLL-KRUGER MARK,D109,HJ,5000,,4595028.01
6100,2/12/2021,2/12/2021,21221,82L-IMPORT PAYROLL-LIPORACE HERNAN LUIS,D103,HJ,2291.67,,4597319.68
6100,2/12/2021,2/12/2021,21221,82L-IMPORT PAYROLL-MARKS KRISTA,D109,HJ,153.53,,4597473.21
6100,2/12/2021,2/12/2021,21221,82L-IMPORT PAYROLL-MARKS KRISTA,D109,HJ,5416.67,,4602889.88
6100,2/12/2021,2/12/2021,21221,82L-IMPORT PAYROLL-MELVIN DARNELL KEVIN,D109,HJ,4000,,4606889.88
6100,2/12/2021,2/12/2021,21221,82L-IMPORT PAYROLL-MESSING JENNIFER,D104,HJ,2500,,4609389.88
6100,2/12/2021,2/12/2021,21221,82L-IMPORT PAYROLL-MILNE ROGER,D109,HJ,150.66,,4609540.54
6100,2/12/2021,2/12/2021,21221,82L-IMPORT PAYROLL-MILNE ROGER,D109,HJ,5416.67,,4614957.21
6100,2/12/2021,2/12/2021,21221,82L-IMPORT PAYROLL-MOSTAFAVI YASAMAN,D109,HJ,528,,4615485.21
6100,2/12/2021,2/12/2021,21221,82L-IMPORT PAYROLL-O'DONNELL STEPHEN,D104,HJ,2707.5,,4618192.71
6100,2/12/2021,2/12/2021,21221,82L-IMPORT PAYROLL-PARETS MALLORY GRACE,D101,HJ,2833.33,,4621026.04
6100,2/12/2021,2/12/2021,21221,82L-IMPORT PAYROLL-PARHAM-GANTT DENISE M,D112,HJ,3041.67,,4624067.71
6100,2/12/2021,2/12/2021,21221,82L-IMPORT PAYROLL-PEINADO ELIZABETH R,D111,HJ,3749.96,,4627817.67
6100,2/12/2021,2/12/2021,21221,82L-IMPORT PAYROLL-PERNIA JEFFREY,D109,HJ,146.72,,4627964.39
6100,2/12/2021,2/12/2021,21221,82L-IMPORT PAYROLL-PERNIA JEFFREY,D109,HJ,3875,,4631839.39
6100,2/12/2021,2/12/2021,21221,82L-IMPORT PAYROLL-PIRES MANUEL,D103,HJ,2208.33,,4634047.72
6100,2/12/2021,2/12/2021,21221,82L-IMPORT PAYROLL-POLANCO ODALIS,D103,HJ,3124.96,,4637172.68
6100,2/12/2021,2/12/2021,21221,82L-IMPORT PAYROLL-QUINTAS JASHIVE,D105,HJ,1916.67,,4639089.35
6100,2/12/2021,2/12/2021,21221,82L-IMPORT PAYROLL-RANDOLPH ALEXANDER,D111,HJ,1875,,4640964.35
6100,2/12/2021,2/12/2021,21221,82L-IMPORT PAYROLL-RUBI PERLA,D101,HJ,1250,,4642214.35
6100,2/12/2021,2/12/2021,21221,82L-IMPORT PAYROLL-SAFRAN ALAN P,D107,HJ,696.81,,4642911.16
6100,2/12/2021,2/12/2021,21221,82L-IMPORT PAYROLL-SAFRAN ALAN P,D107,HJ,7045.58,,4649956.74
6100,2/12/2021,2/12/2021,21221,82L-IMPORT PAYROLL-SHENKMAN OLIVIA,D101,HJ,2000,,4651956.74
6100,2/12/2021,2/12/2021,21221,82L-IMPORT PAYROLL-VYAS SUNAINA,D104,HJ,1958.33,,4653915.07
6100,2/12/2021,2/12/2021,21221,82L-IMPORT PAYROLL-WALLACE AMENA,D104,HJ,2187.5,,4656102.57
6100,2/12/2021,2/12/2021,21221,82L-IMPORT PAYROLL-WARD JEFFREY,D109,HJ,439.65,,4656542.22
6100,2/12/2021,2/12/2021,21221,82L-IMPORT PAYROLL-WARD JEFFREY,D109,HJ,5416.67,,4661958.89
6100,2/12/2021,2/12/2021,21221,82L-IMPORT PAYROLL-WARD JENNIFER,D109,HJ,1003.59,,4662962.48
6100,2/12/2021,2/12/2021,21221,82L-IMPORT PAYROLL-WEINSTOCK EMILY,D101,HJ,2833.33,,4665795.81
6100,2/12/2021,2/12/2021,21221,82L-IMPORT PAYROLL-WINANS JENNIFER,D111,HJ,2505.63,,4668301.44
6100,2/12/2021,2/12/2021,21221,82L-IMPORT PAYROLL-ZARATE JOSEPH M,D105,HJ,2150,,4670451.44
6100,2/12/2021,2/12/2021,21221,82L-IMPORT PAYROLL-AGUANNO JOSEPH,D108,HJ,1119.05,,4671570.49
6100,2/12/2021,2/12/2021,21221,82L-IMPORT PAYROLL-AKESODE FEHINTOLA,D108,HJ,1119.05,,4672689.54
6100,2/12/2021,2/12/2021,21221,82L-IMPORT PAYROLL-BARTOLD DEANNA MARIE,D108,HJ,3034.5,,4675724.04
6100,2/12/2021,2/12/2021,21221,82L-IMPORT PAYROLL-BELLOT GENESIS,D108,HJ,2500,,4678224.04
6100,2/12/2021,2/12/2021,21221,82L-IMPORT PAYROLL-BENNETT JAMES H,D108,HJ,1119.05,,4679343.09
6100,2/12/2021,2/12/2021,21221,82L-IMPORT PAYROLL-BOWMAN ABIGAIL,D108,HJ,1119.05,,4680462.14
6100,2/12/2021,2/12/2021,21221,82L-IMPORT PAYROLL-BURRELL RUSSELL,D108,HJ,1119.05,,4681581.19
6100,2/12/2021,2/12/2021,21221,82L-IMPORT PAYROLL-CHUI KENT,D108,HJ,1119.05,,4682700.24
6100,2/12/2021,2/12/2021,21221,82L-IMPORT PAYROLL-CIRKER MIA,D108,HJ,2250,,4684950.24
6100,2/12/2021,2/12/2021,21221,82L-IMPORT PAYROLL-DEWS CAMERYN,D108,HJ,2291.67,,4687241.91
6100,2/12/2021,2/12/2021,21221,82L-IMPORT PAYROLL-DIETZ MARY,D108,HJ,1119.05,,4688360.96
6100,2/12/2021,2/12/2021,21221,82L-IMPORT PAYROLL-DOMINIQUE PRINCESSA,D108,HJ,1119.05,,4689480.01
6100,2/12/2021,2/12/2021,21221,82L-IMPORT PAYROLL-DONNELLY HOME,D108,HJ,1119.05,,4690599.06
6100,2/12/2021,2/12/2021,21221,82L-IMPORT PAYROLL-FEIGHERY JOHN,D108,HJ,2250,,4692849.06
6100,2/12/2021,2/12/2021,21221,82L-IMPORT PAYROLL-FORTH KYLE,D108,HJ,1119.05,,4693968.11
6100,2/12/2021,2/12/2021,21221,82L-IMPORT PAYROLL-GARCIA MARILYN,D108,HJ,2291.67,,4696259.78
6100,2/12/2021,2/12/2021,21221,82L-IMPORT PAYROLL-GREENE BROOKE,D108,HJ,1119.05,,4697378.83
6100,2/12/2021,2/12/2021,21221,82L-IMPORT PAYROLL-GRIFFIN ANDREW,D108,HJ,2250,,4699628.83
6100,2/12/2021,2/12/2021,21221,82L-IMPORT PAYROLL-GROSS EMILY,D108,HJ,1119.05,,4700747.88
6100,2/12/2021,2/12/2021,21221,82L-IMPORT PAYROLL-GUERRERO LUIS,D108,HJ,1119.05,,4701866.93
6100,2/12/2021,2/12/2021,21221,82L-IMPORT PAYROLL-HALLINAN GABRIEL,D108,HJ,2550,,4704416.93
6100,2/12/2021,2/12/2021,21221,82L-IMPORT PAYROLL-HAMERSLY WILLIAM,D108,HJ,2500,,4706916.93
6100,2/12/2021,2/12/2021,21221,82L-IMPORT PAYROLL-HOSSAIN MYESHA,D108,HJ,2437.5,,4709354.43
6100,2/12/2021,2/12/2021,21221,82L-IMPORT PAYROLL-JACKSON TASNIM F,D108,HJ,2291.67,,4711646.1
6100,2/12/2021,2/12/2021,21221,82L-IMPORT PAYROLL-KERKHOFF HARPER FAITH,D108,HJ,1032.93,,4712679.03
6100,2/12/2021,2/12/2021,21221,82L-IMPORT PAYROLL-LEARY AUBREY,D108,HJ,1119.05,,4713798.08
6100,2/12/2021,2/12/2021,21221,82L-IMPORT PAYROLL-LI BELLA,D108,HJ,2486.25,,4716284.33
6100,2/12/2021,2/12/2021,21221,82L-IMPORT PAYROLL-LOUIE JORDAN,D108,HJ,1119.05,,4717403.38
6100,2/12/2021,2/12/2021,21221,82L-IMPORT PAYROLL-MELCHOR OSBEIDY,D108,HJ,1119.05,,4718522.43
6100,2/12/2021,2/12/2021,21221,82L-IMPORT PAYROLL-MORRIS ZAKIYA,D108,HJ,1119.05,,4719641.48
6100,2/12/2021,2/12/2021,21221,82L-IMPORT PAYROLL-MORSELETTO RAFAEL,D108,HJ,1119.05,,4720760.53
6100,2/12/2021,2/12/2021,21221,82L-IMPORT PAYROLL-OBI TOBECHUKWU,D108,HJ,1119.05,,4721879.58
6100,2/12/2021,2/12/2021,21221,82L-IMPORT PAYROLL-OPUH NDIDI,D108,HJ,2833.33,,4724712.91
6100,2/12/2021,2/12/2021,21221,82L-IMPORT PAYROLL-PAULINO THAIRI,D108,HJ,1119.05,,4725831.96
6100,2/12/2021,2/12/2021,21221,82L-IMPORT PAYROLL-ROSENBAUM MURRAY,D108,HJ,1119.05,,4726951.01
6100,2/12/2021,2/12/2021,21221,82L-IMPORT PAYROLL-SCHWETTMANN CLAIRE,D108,HJ,1119.05,,4728070.06
6100,2/12/2021,2/12/2021,21221,82L-IMPORT PAYROLL-SOBELMAN JUSTIN,D108,HJ,1119.05,,4729189.11
6100,2/12/2021,2/12/2021,21221,82L-IMPORT PAYROLL-TERRENCE-SMITH ZIHIR,D108,HJ,1119.05,,4730308.16
6100,2/12/2021,2/12/2021,21221,82L-IMPORT PAYROLL-TILLERY ASIA,D108,HJ,455.76,,4730763.92
6100,2/12/2021,2/12/2021,21221,82L-IMPORT PAYROLL-TILLERY ASIA,D108,HJ,3291.67,,4734055.59
6100,2/12/2021,2/12/2021,21221,82L-IMPORT PAYROLL-WILLIAMS-MASSEY BRIANNA,D108,HJ,1119.05,,4735174.64
6100,2/12/2021,2/12/2021,21221,82L-IMPORT PAYROLL-XIAO CHENGYAO,D108,HJ,1119.05,,4736293.69
6100,2/12/2021,2/12/2021,21221,82L-IMPORT PAYROLL-ZIAUDDIN ABUTAHER,D108,HJ,1119.05,,4737412.74
6100,2/12/2021,2/12/2021,21221,82L-IMPORT PAYROLL-BALASUBRAMANIAN SHARANYA,D108,HJ,2666.67,,4740079.41
6100,2/12/2021,2/12/2021,21221,82L-IMPORT PAYROLL-COVENEY ALLISON,D108,HJ,2854.17,,4742933.58
6100,2/12/2021,2/12/2021,21221,82L-IMPORT PAYROLL-JACKSON CLAICE M,D108,HJ,3125,,4746058.58
6100,2/12/2021,2/12/2021,21221,82L-IMPORT PAYROLL-JANG DANIEL,D108,HJ,2750,,4748808.58
6100,2/12/2021,2/12/2021,21221,82L-IMPORT PAYROLL-LENEGHAN MARYELLEN,D108,HJ,686.25,,4749494.83
6100,2/12/2021,2/12/2021,21221,82L-IMPORT PAYROLL-LENEGHAN MARYELLEN,D108,HJ,1087.5,,4750582.33
6100,2/12/2021,2/12/2021,21221,82L-IMPORT PAYROLL-LENEGHAN MARYELLEN,D108,HJ,3126.25,,4753708.58
6100,2/26/2021,2/26/2021,22621,82L-IMPORT PAYROLL-BARTHELEMY RACHALIE,D108,HJ,1047.62,,4754756.2
6100,2/26/2021,2/26/2021,22621,82L-IMPORT PAYROLL-BOHLSEN GRACE ISABELLE,D108,HJ,1047.62,,4755803.82
6100,2/26/2021,2/26/2021,22621,82L-IMPORT PAYROLL-BOLIVAR ANDREA,D108,HJ,2500,,4758303.82
6100,2/26/2021,2/26/2021,22621,82L-IMPORT PAYROLL-BORCHART SPENCER,D108,HJ,1047.62,,4759351.44
6100,2/26/2021,2/26/2021,22621,82L-IMPORT PAYROLL-BRIANTE SAMUEL,D108,HJ,1047.62,,4760399.06
6100,2/26/2021,2/26/2021,22621,82L-IMPORT PAYROLL-BROWN ISAAC,D108,HJ,1047.62,,4761446.68
6100,2/26/2021,2/26/2021,22621,82L-IMPORT PAYROLL-CASSADY JOSHUA LEWIS,D108,HJ,1047.62,,4762494.3
6100,2/26/2021,2/26/2021,22621,82L-IMPORT PAYROLL-DARKO OLIVIA,D108,HJ,1047.62,,4763541.92
6100,2/26/2021,2/26/2021,22621,82L-IMPORT PAYROLL-ESCAMILLA OLGA,D108,HJ,25.38,,4763567.3
6100,2/26/2021,2/26/2021,22621,82L-IMPORT PAYROLL-ESCAMILLA OLGA,D108,HJ,1047.62,,4764614.92
6100,2/26/2021,2/26/2021,22621,82L-IMPORT PAYROLL-GARCIA SANTIAGO,D108,HJ,2041.67,,4766656.59
6100,2/26/2021,2/26/2021,22621,82L-IMPORT PAYROLL-GILES SHAYLA,D108,HJ,40.43,,4766697.02
6100,2/26/2021,2/26/2021,22621,82L-IMPORT PAYROLL-GILES SHAYLA,D108,HJ,1047.62,,4767744.64
6100,2/26/2021,2/26/2021,22621,82L-IMPORT PAYROLL-IKUNIKA FUNMILAYO,D108,HJ,2083.33,,4769827.97
6100,2/26/2021,2/26/2021,22621,82L-IMPORT PAYROLL-JONES JORDAN,D108,HJ,1047.62,,4770875.59
6100,2/26/2021,2/26/2021,22621,82L-IMPORT PAYROLL-KHAN HUDA,D108,HJ,1047.62,,4771923.21
6100,2/26/2021,2/26/2021,22621,82L-IMPORT PAYROLL-KLOHR TIMOTHY JORDAN,D108,HJ,2000,,4773923.21
6100,2/26/2021,2/26/2021,22621,82L-IMPORT PAYROLL-KNOWLIN ZYLIA,D108,HJ,2541.67,,4776464.88
6100,2/26/2021,2/26/2021,22621,82L-IMPORT PAYROLL-LAI GRADY,D108,HJ,12.69,,4776477.57
6100,2/26/2021,2/26/2021,22621,82L-IMPORT PAYROLL-LAI GRADY,D108,HJ,1047.62,,4777525.19
6100,2/26/2021,2/26/2021,22621,82L-IMPORT PAYROLL-LI SEN YUAN,D108,HJ,1047.62,,4778572.81
6100,2/26/2021,2/26/2021,22621,82L-IMPORT PAYROLL-LIPSCOMB STEPHEN,D108,HJ,2541.67,,4781114.48
6100,2/26/2021,2/26/2021,22621,82L-IMPORT PAYROLL-MALLECK JESSICA R,D108,HJ,1047.62,,4782162.1
6100,2/26/2021,2/26/2021,22621,82L-IMPORT PAYROLL-MEJIA ROSO CARLOS,D108,HJ,1047.62,,4783209.72
6100,2/26/2021,2/26/2021,22621,82L-IMPORT PAYROLL-MONROY-MEJIA JASON,D108,HJ,1047.62,,4784257.34
6100,2/26/2021,2/26/2021,22621,82L-IMPORT PAYROLL-O'FLYNN-PRUITT NATHAN COLYAR,D108,HJ,1047.62,,4785304.96
6100,2/26/2021,2/26/2021,22621,82L-IMPORT PAYROLL-OKRAH JULIAN O,D108,HJ,1047.62,,4786352.58
6100,2/26/2021,2/26/2021,22621,82L-IMPORT PAYROLL-PATTERSON STEVE,D108,HJ,1047.62,,4787400.2
6100,2/26/2021,2/26/2021,22621,82L-IMPORT PAYROLL-SCHMIESS RACHEL JOY,D108,HJ,1047.62,,4788447.82
6100,2/26/2021,2/26/2021,22621,82L-IMPORT PAYROLL-SCOTT KIRK DONOVAN,D108,HJ,1047.62,,4789495.44
6100,2/26/2021,2/26/2021,22621,82L-IMPORT PAYROLL-SILVER KELLY,D108,HJ,2541.67,,4792037.11
6100,2/26/2021,2/26/2021,22621,82L-IMPORT PAYROLL-SOLIMAN MARK,D108,HJ,1047.62,,4793084.73
6100,2/26/2021,2/26/2021,22621,82L-IMPORT PAYROLL-STEIN KYLE,D108,HJ,2083.33,,4795168.06
6100,2/26/2021,2/26/2021,22621,82L-IMPORT PAYROLL-STROUD DAVID,D108,HJ,1047.62,,4796215.68
6100,2/26/2021,2/26/2021,22621,82L-IMPORT PAYROLL-VALCIN SABRINA JEMIMAH,D108,HJ,1047.62,,4797263.3
6100,2/26/2021,2/26/2021,22621,82L-IMPORT PAYROLL-VALDES ERNEST L,D108,HJ,1047.62,,4798310.92
6100,2/26/2021,2/26/2021,22621,82L-IMPORT PAYROLL-WILLIAMS MACK ANTHONY,D108,HJ,90.66,,4798401.58
6100,2/26/2021,2/26/2021,22621,82L-IMPORT PAYROLL-WILLIAMS MACK ANTHONY,D108,HJ,1047.62,,4799449.2
6100,2/26/2021,2/26/2021,22621,82L-IMPORT PAYROLL-WILLIAMS MIL'YONTA,D108,HJ,1047.62,,4800496.82
6100,2/26/2021,2/26/2021,22621,82L-IMPORT PAYROLL-ANTHONY BETTY S,D108,HJ,2886.52,,4803383.34
6100,2/26/2021,2/26/2021,22621,82L-IMPORT PAYROLL-APULI LINDSAY,D108,HJ,2500,,4805883.34
6100,2/26/2021,2/26/2021,22621,82L-IMPORT PAYROLL-AUSTIN PERCY,D108,HJ,2653.02,,4808536.36
6100,2/26/2021,2/26/2021,22621,82L-IMPORT PAYROLL-BUHMANN JENNIFER,D108,HJ,2270.83,,4810807.19
6100,2/26/2021,2/26/2021,22621,82L-IMPORT PAYROLL-CAIN CORY,D108,HJ,2708.33,,4813515.52
6100,2/26/2021,2/26/2021,22621,82L-IMPORT PAYROLL-CHAPMAN CLAUDY EARL,D108,HJ,2291.67,,4815807.19
6100,2/26/2021,2/26/2021,22621,82L-IMPORT PAYROLL-DADA ARIKPO E,D108,HJ,2720,,4818527.19
6100,2/26/2021,2/26/2021,22621,82L-IMPORT PAYROLL-GUTHRIE LESLIE,D108,HJ,2458.33,,4820985.52
6100,2/26/2021,2/26/2021,22621,82L-IMPORT PAYROLL-HOLMES JOREL ALEXANDER,D108,HJ,2329,,4823314.52
6100,2/26/2021,2/26/2021,22621,82L-IMPORT PAYROLL-JORDAN TIFFANY T,D108,HJ,3445,,4826759.52
6100,2/26/2021,2/26/2021,22621,82L-IMPORT PAYROLL-LANIGAN LISA A,D108,HJ,3113.75,,4829873.27
6100,2/26/2021,2/26/2021,22621,82L-IMPORT PAYROLL-MCELWEE MELISSA,D108,HJ,2666.67,,4832539.94
6100,2/26/2021,2/26/2021,22621,82L-IMPORT PAYROLL-MCNICHOLAS MARY,D108,HJ,2291.67,,4834831.61
6100,2/26/2021,2/26/2021,22621,82L-IMPORT PAYROLL-NWAKANMA NANCY,D108,HJ,3046.67,,4837878.28
6100,2/26/2021,2/26/2021,22621,82L-IMPORT PAYROLL-ONICA ANTHONY J,D108,HJ,2416.67,,4840294.95
6100,2/26/2021,2/26/2021,22621,82L-IMPORT PAYROLL-PRAHIN NICOLE M,D108,HJ,3812.5,,4844107.45
6100,2/26/2021,2/26/2021,22621,82L-IMPORT PAYROLL-RIVERS QUIONNA DIANE,D108,HJ,2708.34,,4846815.79
6100,2/26/2021,2/26/2021,22621,82L-IMPORT PAYROLL-SALIM YASSER,D108,HJ,2431.94,,4849247.73
6100,2/26/2021,2/26/2021,22621,82L-IMPORT PAYROLL-SEJOUR MAHALIAH,D108,HJ,2500,,4851747.73
6100,2/26/2021,2/26/2021,22621,82L-IMPORT PAYROLL-SKALSKI CHRISTOPHER,D108,HJ,2465,,4854212.73
6100,2/26/2021,2/26/2021,22621,82L-IMPORT PAYROLL-TUMENJARGAL ENKHJIN,D108,HJ,2414,,4856626.73
6100,2/26/2021,2/26/2021,22621,82L-IMPORT PAYROLL-VILLEGAS EVELYN,D108,HJ,2817.75,,4859444.48
6100,2/26/2021,2/26/2021,22621,82L-IMPORT PAYROLL-WOLF ANNA A,D108,HJ,2635,,4862079.48
6100,2/26/2021,2/26/2021,22621,82L-IMPORT PAYROLL-ACEVEDO MONIVETT,D107,HJ,5375,,4867454.48
6100,2/26/2021,2/26/2021,22621,82L-IMPORT PAYROLL-AKLESTAD ISABEL,D111,HJ,50,,4867504.48
6100,2/26/2021,2/26/2021,22621,82L-IMPORT PAYROLL-AKLESTAD ISABEL,D111,HJ,1750,,4869254.48
6100,2/26/2021,2/26/2021,22621,82L-IMPORT PAYROLL-BIBB TIFFANI,D104,HJ,3875,,4873129.48
6100,2/26/2021,2/26/2021,22621,82L-IMPORT PAYROLL-BOWMAN HALLEY K,D101,HJ,3437.5,,4876566.98
6100,2/26/2021,2/26/2021,22621,82L-IMPORT PAYROLL-CALVO FERNANDA,D104,HJ,50,,4876616.98
6100,2/26/2021,2/26/2021,22621,82L-IMPORT PAYROLL-CALVO FERNANDA,D104,HJ,961.5,,4877578.48
6100,2/26/2021,2/26/2021,22621,82L-IMPORT PAYROLL-COOK CATHRYN ANNA,D105,HJ,3593.03,,4881171.51
6100,2/26/2021,2/26/2021,22621,82L-IMPORT PAYROLL-COOPER ASHLEE R,D101,HJ,2461.88,,4883633.39
6100,2/26/2021,2/26/2021,22621,82L-IMPORT PAYROLL-CORTEZ MIRANDA A,D111,HJ,50,,4883683.39
6100,2/26/2021,2/26/2021,22621,82L-IMPORT PAYROLL-CORTEZ MIRANDA A,D111,HJ,2672.72,,4886356.11
6100,2/26/2021,2/26/2021,22621,82L-IMPORT PAYROLL-DAUGHERTY DEVIN W,D101,HJ,1562.62,,4887918.73
6100,2/26/2021,2/26/2021,22621,82L-IMPORT PAYROLL-DETONE KYRA MAYA,D102,HJ,2916.67,,4890835.4
6100,2/26/2021,2/26/2021,22621,82L-IMPORT PAYROLL-DUPUIS CHRISTOPHER M,D107,HJ,2759.17,,4893594.57
6100,2/26/2021,2/26/2021,22621,82L-IMPORT PAYROLL-DUPUIS CHRISTOPHER M,D107,HJ,3511.66,,4897106.23
6100,2/26/2021,2/26/2021,22621,82L-IMPORT PAYROLL-DZIEDZIC JULIE K,D101,HJ,1250,,4898356.23
6100,2/26/2021,2/26/2021,22621,82L-IMPORT PAYROLL-FEENEY CLAIRE,D104,HJ,50,,4898406.23
6100,2/26/2021,2/26/2021,22621,82L-IMPORT PAYROLL-FEENEY CLAIRE,D104,HJ,2000,,4900406.23
6100,2/26/2021,2/26/2021,22621,82L-IMPORT PAYROLL-FISCHABER THOMAS,D109,HJ,439.65,,4900845.88
6100,2/26/2021,2/26/2021,22621,82L-IMPORT PAYROLL-FISCHABER THOMAS,D109,HJ,5416.67,,4906262.55
6100,2/26/2021,2/26/2021,22621,82L-IMPORT PAYROLL-FLORY MEGAN,D109,HJ,1500,,4907762.55
6100,2/26/2021,2/26/2021,22621,82L-IMPORT PAYROLL-GORNSTEIN STEVEN,D101,HJ,2708.33,,4910470.88
6100,2/26/2021,2/26/2021,22621,82L-IMPORT PAYROLL-GUADARRAMA-ALVAREZ URIEL A,D105,HJ,2897.92,,4913368.8
6100,2/26/2021,2/26/2021,22621,82L-IMPORT PAYROLL-GUTIERREZ ANTONIO J,D107,HJ,2504.89,,4915873.69
6100,2/26/2021,2/26/2021,22621,82L-IMPORT PAYROLL-GUTIERREZ ANTONIO J,D107,HJ,3188.05,,4919061.74
6100,2/26/2021,2/26/2021,22621,82L-IMPORT PAYROLL-HENRY GILLIAN,D102,HJ,2083.34,,4921145.08
6100,2/26/2021,2/26/2021,22621,82L-IMPORT PAYROLL-HERMAN ADAM,D102,HJ,1958.33,,4923103.41
6100,2/26/2021,2/26/2021,22621,82L-IMPORT PAYROLL-HERNANDEZ ANNA,D101,HJ,2708.33,,4925811.74
6100,2/26/2021,2/26/2021,22621,82L-IMPORT PAYROLL-HESTER TYLER CONRAD,D105,HJ,1916.67,,4927728.41
6100,2/26/2021,2/26/2021,22621,82L-IMPORT PAYROLL-HOLT ADAM,D109,HJ,153.53,,4927881.94
6100,2/26/2021,2/26/2021,22621,82L-IMPORT PAYROLL-HOLT ADAM,D109,HJ,4166.67,,4932048.61
6100,2/26/2021,2/26/2021,22621,82L-IMPORT PAYROLL-IWASAKI MIKA,D101,HJ,2166.67,,4934215.28
6100,2/26/2021,2/26/2021,22621,82L-IMPORT PAYROLL-KELLY SEAN,D109,HJ,5416.67,,4939631.95
6100,2/26/2021,2/26/2021,22621,82L-IMPORT PAYROLL-KRUGER MARK,D109,HJ,5000,,4944631.95
6100,2/26/2021,2/26/2021,22621,82L-IMPORT PAYROLL-LIPORACE HERNAN LUIS,D103,HJ,2291.67,,4946923.62
6100,2/26/2021,2/26/2021,22621,82L-IMPORT PAYROLL-MARKS KRISTA,D109,HJ,153.53,,4947077.15
6100,2/26/2021,2/26/2021,22621,82L-IMPORT PAYROLL-MARKS KRISTA,D109,HJ,5416.67,,4952493.82
6100,2/26/2021,2/26/2021,22621,82L-IMPORT PAYROLL-MELVIN DARNELL KEVIN,D109,HJ,4000,,4956493.82
6100,2/26/2021,2/26/2021,22621,82L-IMPORT PAYROLL-MESSING JENNIFER,D104,HJ,2500,,4958993.82
6100,2/26/2021,2/26/2021,22621,82L-IMPORT PAYROLL-MILNE ROGER,D109,HJ,150.66,,4959144.48
6100,2/26/2021,2/26/2021,22621,82L-IMPORT PAYROLL-MILNE ROGER,D109,HJ,5416.67,,4964561.15
6100,2/26/2021,2/26/2021,22621,82L-IMPORT PAYROLL-MOSTAFAVI YASAMAN,D109,HJ,528,,4965089.15
6100,2/26/2021,2/26/2021,22621,82L-IMPORT PAYROLL-O'DONNELL STEPHEN,D104,HJ,2707.5,,4967796.65
6100,2/26/2021,2/26/2021,22621,82L-IMPORT PAYROLL-PARETS MALLORY GRACE,D101,HJ,2833.33,,4970629.98
6100,2/26/2021,2/26/2021,22621,82L-IMPORT PAYROLL-PARHAM-GANTT DENISE M,D112,HJ,3041.67,,4973671.65
6100,2/26/2021,2/26/2021,22621,82L-IMPORT PAYROLL-PEINADO ELIZABETH R,D111,HJ,50,,4973721.65
6100,2/26/2021,2/26/2021,22621,82L-IMPORT PAYROLL-PEINADO ELIZABETH R,D111,HJ,3749.96,,4977471.61
6100,2/26/2021,2/26/2021,22621,82L-IMPORT PAYROLL-PERNIA JEFFREY,D109,HJ,146.72,,4977618.33
6100,2/26/2021,2/26/2021,22621,82L-IMPORT PAYROLL-PERNIA JEFFREY,D109,HJ,3875,,4981493.33
6100,2/26/2021,2/26/2021,22621,82L-IMPORT PAYROLL-PIRES MANUEL,D103,HJ,2208.33,,4983701.66
6100,2/26/2021,2/26/2021,22621,82L-IMPORT PAYROLL-POLANCO ODALIS,D103,HJ,3124.96,,4986826.62
6100,2/26/2021,2/26/2021,22621,82L-IMPORT PAYROLL-QUINTAS JASHIVE,D105,HJ,1916.67,,4988743.29
6100,2/26/2021,2/26/2021,22621,82L-IMPORT PAYROLL-RANDOLPH ALEXANDER,D111,HJ,50,,4988793.29
6100,2/26/2021,2/26/2021,22621,82L-IMPORT PAYROLL-RANDOLPH ALEXANDER,D111,HJ,2125,,4990918.29
6100,2/26/2021,2/26/2021,22621,82L-IMPORT PAYROLL-RUBI PERLA,D101,HJ,1250,,4992168.29
6100,2/26/2021,2/26/2021,22621,82L-IMPORT PAYROLL-SAFRAN ALAN P,D107,HJ,851.66,,4993019.95
6100,2/26/2021,2/26/2021,22621,82L-IMPORT PAYROLL-SAFRAN ALAN P,D107,HJ,6890.73,,4999910.68
6100,2/26/2021,2/26/2021,22621,82L-IMPORT PAYROLL-SHENKMAN OLIVIA,D101,HJ,2000,,5001910.68
6100,2/26/2021,2/26/2021,22621,82L-IMPORT PAYROLL-VYAS SUNAINA,D104,HJ,50,,5001960.68
6100,2/26/2021,2/26/2021,22621,82L-IMPORT PAYROLL-VYAS SUNAINA,D104,HJ,1958.33,,5003919.01
6100,2/26/2021,2/26/2021,22621,82L-IMPORT PAYROLL-WALLACE AMENA,D104,HJ,2187.5,,5006106.51
6100,2/26/2021,2/26/2021,22621,82L-IMPORT PAYROLL-WARD JEFFREY,D109,HJ,439.65,,5006546.16
6100,2/26/2021,2/26/2021,22621,82L-IMPORT PAYROLL-WARD JEFFREY,D109,HJ,5416.67,,5011962.83
6100,2/26/2021,2/26/2021,22621,82L-IMPORT PAYROLL-WARD JENNIFER,D109,HJ,216,,5012178.83
6100,2/26/2021,2/26/2021,22621,82L-IMPORT PAYROLL-WARD JENNIFER,D109,HJ,870.75,,5013049.58
6100,2/26/2021,2/26/2021,22621,82L-IMPORT PAYROLL-WEINSTOCK EMILY,D101,HJ,2833.33,,5015882.91
6100,2/26/2021,2/26/2021,22621,82L-IMPORT PAYROLL-WINANS JENNIFER,D111,HJ,50,,5015932.91
6100,2/26/2021,2/26/2021,22621,82L-IMPORT PAYROLL-WINANS JENNIFER,D111,HJ,2505.63,,5018438.54
6100,2/26/2021,2/26/2021,22621,82L-IMPORT PAYROLL-ZARATE JOSEPH M,D105,HJ,2150,,5020588.54
6100,2/26/2021,2/26/2021,22621,82L-IMPORT PAYROLL-AGUANNO JOSEPH,D108,HJ,1119.05,,5021707.59
6100,2/26/2021,2/26/2021,22621,82L-IMPORT PAYROLL-AKESODE FEHINTOLA,D108,HJ,1119.05,,5022826.64
6100,2/26/2021,2/26/2021,22621,82L-IMPORT PAYROLL-BARTOLD DEANNA MARIE,D108,HJ,3034.5,,5025861.14
6100,2/26/2021,2/26/2021,22621,82L-IMPORT PAYROLL-BELLOT GENESIS,D108,HJ,2500,,5028361.14
6100,2/26/2021,2/26/2021,22621,82L-IMPORT PAYROLL-BENNETT JAMES H,D108,HJ,1119.05,,5029480.19
6100,2/26/2021,2/26/2021,22621,82L-IMPORT PAYROLL-BOWMAN ABIGAIL,D108,HJ,1119.05,,5030599.24
6100,2/26/2021,2/26/2021,22621,82L-IMPORT PAYROLL-BURRELL RUSSELL,D108,HJ,1119.05,,5031718.29
6100,2/26/2021,2/26/2021,22621,82L-IMPORT PAYROLL-CHUI KENT,D108,HJ,1119.05,,5032837.34
6100,2/26/2021,2/26/2021,22621,82L-IMPORT PAYROLL-CIRKER MIA,D108,HJ,2250,,5035087.34
6100,2/26/2021,2/26/2021,22621,82L-IMPORT PAYROLL-DEWS CAMERYN,D108,HJ,2291.67,,5037379.01
6100,2/26/2021,2/26/2021,22621,82L-IMPORT PAYROLL-DIETZ MARY,D108,HJ,1119.05,,5038498.06
6100,2/26/2021,2/26/2021,22621,82L-IMPORT PAYROLL-DOMINIQUE PRINCESSA,D108,HJ,1119.05,,5039617.11
6100,2/26/2021,2/26/2021,22621,82L-IMPORT PAYROLL-DONNELLY HOME,D108,HJ,1119.05,,5040736.16
6100,2/26/2021,2/26/2021,22621,82L-IMPORT PAYROLL-FEIGHERY JOHN,D108,HJ,2250,,5042986.16
6100,2/26/2021,2/26/2021,22621,82L-IMPORT PAYROLL-FORTH KYLE,D108,HJ,1119.05,,5044105.21
6100,2/26/2021,2/26/2021,22621,82L-IMPORT PAYROLL-GARCIA MARILYN,D108,HJ,2291.67,,5046396.88
6100,2/26/2021,2/26/2021,22621,82L-IMPORT PAYROLL-GREENE BROOKE,D108,HJ,1119.05,,5047515.93
6100,2/26/2021,2/26/2021,22621,82L-IMPORT PAYROLL-GRIFFIN ANDREW,D108,HJ,2250,,5049765.93
6100,2/26/2021,2/26/2021,22621,82L-IMPORT PAYROLL-GROSS EMILY,D108,HJ,1119.05,,5050884.98
6100,2/26/2021,2/26/2021,22621,82L-IMPORT PAYROLL-GUERRERO LUIS,D108,HJ,1119.05,,5052004.03
6100,2/26/2021,2/26/2021,22621,82L-IMPORT PAYROLL-HALLINAN GABRIEL,D108,HJ,2550,,5054554.03
6100,2/26/2021,2/26/2021,22621,82L-IMPORT PAYROLL-HAMERSLY WILLIAM,D108,HJ,2500,,5057054.03
6100,2/26/2021,2/26/2021,22621,82L-IMPORT PAYROLL-HOSSAIN MYESHA,D108,HJ,2437.5,,5059491.53
6100,2/26/2021,2/26/2021,22621,82L-IMPORT PAYROLL-JACKSON TASNIM F,D108,HJ,2291.67,,5061783.2
6100,2/26/2021,2/26/2021,22621,82L-IMPORT PAYROLL-LEARY AUBREY,D108,HJ,1119.05,,5062902.25
6100,2/26/2021,2/26/2021,22621,82L-IMPORT PAYROLL-LI BELLA,D108,HJ,2486.25,,5065388.5
6100,2/26/2021,2/26/2021,22621,82L-IMPORT PAYROLL-LOUIE JORDAN,D108,HJ,1119.05,,5066507.55
6100,2/26/2021,2/26/2021,22621,82L-IMPORT PAYROLL-MELCHOR OSBEIDY,D108,HJ,1119.05,,5067626.6
6100,2/26/2021,2/26/2021,22621,82L-IMPORT PAYROLL-MORRIS ZAKIYA,D108,HJ,1119.05,,5068745.65
6100,2/26/2021,2/26/2021,22621,82L-IMPORT PAYROLL-MORSELETTO RAFAEL,D108,HJ,1119.05,,5069864.7
6100,2/26/2021,2/26/2021,22621,82L-IMPORT PAYROLL-OBI TOBECHUKWU,D108,HJ,1119.05,,5070983.75
6100,2/26/2021,2/26/2021,22621,82L-IMPORT PAYROLL-OPUH NDIDI,D108,HJ,2833.33,,5073817.08
6100,2/26/2021,2/26/2021,22621,82L-IMPORT PAYROLL-PAULINO THAIRI,D108,HJ,1119.05,,5074936.13
6100,2/26/2021,2/26/2021,22621,82L-IMPORT PAYROLL-ROSENBAUM MURRAY,D108,HJ,1119.05,,5076055.18
6100,2/26/2021,2/26/2021,22621,82L-IMPORT PAYROLL-SCHWETTMANN CLAIRE,D108,HJ,1119.05,,5077174.23
6100,2/26/2021,2/26/2021,22621,82L-IMPORT PAYROLL-SOBELMAN JUSTIN,D108,HJ,1119.05,,5078293.28
6100,2/26/2021,2/26/2021,22621,82L-IMPORT PAYROLL-TERRENCE-SMITH ZIHIR,D108,HJ,1119.05,,5079412.33
6100,2/26/2021,2/26/2021,22621,82L-IMPORT PAYROLL-TILLERY ASIA,D108,HJ,455.76,,5079868.09
6100,2/26/2021,2/26/2021,22621,82L-IMPORT PAYROLL-TILLERY ASIA,D108,HJ,3291.67,,5083159.76
6100,2/26/2021,2/26/2021,22621,82L-IMPORT PAYROLL-WILLIAMS-MASSEY BRIANNA,D108,HJ,1119.05,,5084278.81
6100,2/26/2021,2/26/2021,22621,82L-IMPORT PAYROLL-XIAO CHENGYAO,D108,HJ,1119.05,,5085397.86
6100,2/26/2021,2/26/2021,22621,82L-IMPORT PAYROLL-ZIAUDDIN ABUTAHER,D108,HJ,1119.05,,5086516.91
6100,2/26/2021,2/26/2021,22621,82L-IMPORT PAYROLL-BALASUBRAMANIAN SHARANYA,D108,HJ,2666.67,,5089183.58
6100,2/26/2021,2/26/2021,22621,82L-IMPORT PAYROLL-COVENEY ALLISON,D108,HJ,2854.17,,5092037.75
6100,2/26/2021,2/26/2021,22621,82L-IMPORT PAYROLL-JACKSON CLAICE M,D108,HJ,3125,,5095162.75
6100,2/26/2021,2/26/2021,22621,82L-IMPORT PAYROLL-JANG DANIEL,D108,HJ,2750,,5097912.75
6100,2/26/2021,2/26/2021,22621,82L-IMPORT PAYROLL-LENEGHAN MARYELLEN,D108,HJ,1087.5,,5099000.25
6100,2/26/2021,2/26/2021,22621,82L-IMPORT PAYROLL-LENEGHAN MARYELLEN,D108,HJ,1677.5,,5100677.75
6100,2/26/2021,2/26/2021,22621,82L-IMPORT PAYROLL-LENEGHAN MARYELLEN,D108,HJ,2135,,5102812.75
6100,3/15/2021,3/15/2021,31521,82L-IMPORT PAYROLL,D108,HJ,5.44,,5102818.19
6100,3/15/2021,3/15/2021,31521,82L-IMPORT PAYROLL,D108,HJ,5.98,,5102824.17
6100,3/15/2021,3/15/2021,31521,82L-IMPORT PAYROLL,D108,HJ,580.2,,5103404.37
6100,3/15/2021,3/15/2021,31521,82L-IMPORT PAYROLL,D108,HJ,580.2,,5103984.57
6100,3/15/2021,3/15/2021,31521,82L-IMPORT PAYROLL,D108,HJ,580.2,,5104564.77
6100,3/15/2021,3/15/2021,31521,82L-IMPORT PAYROLL,D108,HJ,580.2,,5105144.97
6100,3/15/2021,3/15/2021,31521,82L-IMPORT PAYROLL,D108,HJ,1047.62,,5106192.59
6100,3/15/2021,3/15/2021,31521,82L-IMPORT PAYROLL,D108,HJ,1047.62,,5107240.21
6100,3/15/2021,3/15/2021,31521,82L-IMPORT PAYROLL,D108,HJ,1047.62,,5108287.83
6100,3/15/2021,3/15/2021,31521,82L-IMPORT PAYROLL,D108,HJ,1047.62,,5109335.45
6100,3/15/2021,3/15/2021,31521,82L-IMPORT PAYROLL,D108,HJ,1047.62,,5110383.07
6100,3/15/2021,3/15/2021,31521,82L-IMPORT PAYROLL,D108,HJ,1047.62,,5111430.69
6100,3/15/2021,3/15/2021,31521,82L-IMPORT PAYROLL,D108,HJ,1047.62,,5112478.31
6100,3/15/2021,3/15/2021,31521,82L-IMPORT PAYROLL,D108,HJ,1047.62,,5113525.93
6100,3/15/2021,3/15/2021,31521,82L-IMPORT PAYROLL,D108,HJ,1047.62,,5114573.55
6100,3/15/2021,3/15/2021,31521,82L-IMPORT PAYROLL,D108,HJ,1047.62,,5115621.17
6100,3/15/2021,3/15/2021,31521,82L-IMPORT PAYROLL,D108,HJ,1047.62,,5116668.79
6100,3/15/2021,3/15/2021,31521,82L-IMPORT PAYROLL,D108,HJ,1047.62,,5117716.41
6100,3/15/2021,3/15/2021,31521,82L-IMPORT PAYROLL,D108,HJ,1047.62,,5118764.03
6100,3/15/2021,3/15/2021,31521,82L-IMPORT PAYROLL,D108,HJ,1047.62,,5119811.65
6100,3/15/2021,3/15/2021,31521,82L-IMPORT PAYROLL,D108,HJ,1047.62,,5120859.27
6100,3/15/2021,3/15/2021,31521,82L-IMPORT PAYROLL,D108,HJ,1047.62,,5121906.89
6100,3/15/2021,3/15/2021,31521,82L-IMPORT PAYROLL,D108,HJ,1047.62,,5122954.51
6100,3/15/2021,3/15/2021,31521,82L-IMPORT PAYROLL,D108,HJ,1047.62,,5124002.13
6100,3/15/2021,3/15/2021,31521,82L-IMPORT PAYROLL,D108,HJ,1047.62,,5125049.75
6100,3/15/2021,3/15/2021,31521,82L-IMPORT PAYROLL,D108,HJ,1047.62,,5126097.37
6100,3/15/2021,3/15/2021,31521,82L-IMPORT PAYROLL,D108,HJ,1047.62,,5127144.99
6100,3/15/2021,3/15/2021,31521,82L-IMPORT PAYROLL,D108,HJ,1047.62,,5128192.61
6100,3/15/2021,3/15/2021,31521,82L-IMPORT PAYROLL,D108,HJ,1047.62,,5129240.23
6100,3/15/2021,3/15/2021,31521,82L-IMPORT PAYROLL,D108,HJ,1047.62,,5130287.85
6100,3/15/2021,3/15/2021,31521,82L-IMPORT PAYROLL,D108,HJ,1047.62,,5131335.47
6100,3/15/2021,3/15/2021,31521,82L-IMPORT PAYROLL,D108,HJ,1047.62,,5132383.09
6100,3/15/2021,3/15/2021,31521,82L-IMPORT PAYROLL,D108,HJ,1569.17,,5133952.26
6100,3/15/2021,3/15/2021,31521,82L-IMPORT PAYROLL,D108,HJ,2000,,5135952.26
6100,3/15/2021,3/15/2021,31521,82L-IMPORT PAYROLL,D108,HJ,2041.67,,5137993.93
6100,3/15/2021,3/15/2021,31521,82L-IMPORT PAYROLL,D108,HJ,2083.33,,5140077.26
6100,3/15/2021,3/15/2021,31521,82L-IMPORT PAYROLL,D108,HJ,2083.33,,5142160.59
6100,3/15/2021,3/15/2021,31521,82L-IMPORT PAYROLL,D108,HJ,2500,,5144660.59
6100,3/15/2021,3/15/2021,31521,82L-IMPORT PAYROLL,D108,HJ,2541.67,,5147202.26
6100,3/15/2021,3/15/2021,31521,82L-IMPORT PAYROLL,D108,HJ,2541.67,,5149743.93
6100,3/15/2021,3/15/2021,31521,82L-IMPORT PAYROLL,D108,HJ,2541.67,,5152285.6
6100,3/15/2021,3/15/2021,31521,82L-IMPORT PAYROLL,D108,HJ,2270.83,,5154556.43
6100,3/15/2021,3/15/2021,31521,82L-IMPORT PAYROLL,D108,HJ,2291.67,,5156848.1
6100,3/15/2021,3/15/2021,31521,82L-IMPORT PAYROLL,D108,HJ,2291.67,,5159139.77
6100,3/15/2021,3/15/2021,31521,82L-IMPORT PAYROLL,D108,HJ,2329,,5161468.77
6100,3/15/2021,3/15/2021,31521,82L-IMPORT PAYROLL,D108,HJ,2414,,5163882.77
6100,3/15/2021,3/15/2021,31521,82L-IMPORT PAYROLL,D108,HJ,2416.67,,5166299.44
6100,3/15/2021,3/15/2021,31521,82L-IMPORT PAYROLL,D108,HJ,2431.94,,5168731.38
6100,3/15/2021,3/15/2021,31521,82L-IMPORT PAYROLL,D108,HJ,2458.33,,5171189.71
6100,3/15/2021,3/15/2021,31521,82L-IMPORT PAYROLL,D108,HJ,2465,,5173654.71
6100,3/15/2021,3/15/2021,31521,82L-IMPORT PAYROLL,D108,HJ,2500,,5176154.71
6100,3/15/2021,3/15/2021,31521,82L-IMPORT PAYROLL,D108,HJ,2500,,5178654.71
6100,3/15/2021,3/15/2021,31521,82L-IMPORT PAYROLL,D108,HJ,2635,,5181289.71
6100,3/15/2021,3/15/2021,31521,82L-IMPORT PAYROLL,D108,HJ,2653.02,,5183942.73
6100,3/15/2021,3/15/2021,31521,82L-IMPORT PAYROLL,D108,HJ,2666.67,,5186609.4
6100,3/15/2021,3/15/2021,31521,82L-IMPORT PAYROLL,D108,HJ,2708.33,,5189317.73
6100,3/15/2021,3/15/2021,31521,82L-IMPORT PAYROLL,D108,HJ,2708.34,,5192026.07
6100,3/15/2021,3/15/2021,31521,82L-IMPORT PAYROLL,D108,HJ,2720,,5194746.07
6100,3/15/2021,3/15/2021,31521,82L-IMPORT PAYROLL,D108,HJ,2817.75,,5197563.82
6100,3/15/2021,3/15/2021,31521,82L-IMPORT PAYROLL,D108,HJ,2886.52,,5200450.34
6100,3/15/2021,3/15/2021,31521,82L-IMPORT PAYROLL,D108,HJ,3113.75,,5203564.09
6100,3/15/2021,3/15/2021,31521,82L-IMPORT PAYROLL,D108,HJ,3208.46,,5206772.55
6100,3/15/2021,3/15/2021,31521,82L-IMPORT PAYROLL,D108,HJ,3445,,5210217.55
6100,3/15/2021,3/15/2021,31521,82L-IMPORT PAYROLL,D108,HJ,3812.5,,5214030.05
6100,3/15/2021,3/15/2021,31521,82L-IMPORT PAYROLL,D101,HJ,1250,,5215280.05
6100,3/15/2021,3/15/2021,31521,82L-IMPORT PAYROLL,D101,HJ,1250,,5216530.05
6100,3/15/2021,3/15/2021,31521,82L-IMPORT PAYROLL,D101,HJ,1418.38,,5217948.43
6100,3/15/2021,3/15/2021,31521,82L-IMPORT PAYROLL,D101,HJ,2000,,5219948.43
6100,3/15/2021,3/15/2021,31521,82L-IMPORT PAYROLL,D101,HJ,2166.67,,5222115.1
6100,3/15/2021,3/15/2021,31521,82L-IMPORT PAYROLL,D101,HJ,2461.88,,5224576.98
6100,3/15/2021,3/15/2021,31521,82L-IMPORT PAYROLL,D101,HJ,2708.33,,5227285.31
6100,3/15/2021,3/15/2021,31521,82L-IMPORT PAYROLL,D101,HJ,2708.33,,5229993.64
6100,3/15/2021,3/15/2021,31521,82L-IMPORT PAYROLL,D101,HJ,2833.33,,5232826.97
6100,3/15/2021,3/15/2021,31521,82L-IMPORT PAYROLL,D101,HJ,2833.33,,5235660.3
6100,3/15/2021,3/15/2021,31521,82L-IMPORT PAYROLL,D101,HJ,3437.5,,5239097.8
6100,3/15/2021,3/15/2021,31521,82L-IMPORT PAYROLL,D102,HJ,2041.75,,5241139.55
6100,3/15/2021,3/15/2021,31521,82L-IMPORT PAYROLL,D102,HJ,2166.75,,5243306.3
6100,3/15/2021,3/15/2021,31521,82L-IMPORT PAYROLL,D102,HJ,2916.67,,5246222.97
6100,3/15/2021,3/15/2021,31521,82L-IMPORT PAYROLL,D103,HJ,2208.33,,5248431.3
6100,3/15/2021,3/15/2021,31521,82L-IMPORT PAYROLL,D103,HJ,2291.67,,5250722.97
6100,3/15/2021,3/15/2021,31521,82L-IMPORT PAYROLL,D103,HJ,3124.96,,5253847.93
6100,3/15/2021,3/15/2021,31521,82L-IMPORT PAYROLL,D104,HJ,280.76,,5254128.69
6100,3/15/2021,3/15/2021,31521,82L-IMPORT PAYROLL,D104,HJ,1958.33,,5256087.02
6100,3/15/2021,3/15/2021,31521,82L-IMPORT PAYROLL,D104,HJ,2000,,5258087.02
6100,3/15/2021,3/15/2021,31521,82L-IMPORT PAYROLL,D104,HJ,2083.33,,5260170.35
6100,3/15/2021,3/15/2021,31521,82L-IMPORT PAYROLL,D104,HJ,2187.5,,5262357.85
6100,3/15/2021,3/15/2021,31521,82L-IMPORT PAYROLL,D104,HJ,2500,,5264857.85
6100,3/15/2021,3/15/2021,31521,82L-IMPORT PAYROLL,D104,HJ,2637.89,,5267495.74
6100,3/15/2021,3/15/2021,31521,82L-IMPORT PAYROLL,D104,HJ,2707.5,,5270203.24
6100,3/15/2021,3/15/2021,31521,82L-IMPORT PAYROLL,D104,HJ,3875,,5274078.24
6100,3/15/2021,3/15/2021,31521,82L-IMPORT PAYROLL,D105,HJ,1916.67,,5275994.91
6100,3/15/2021,3/15/2021,31521,82L-IMPORT PAYROLL,D105,HJ,1916.67,,5277911.58
6100,3/15/2021,3/15/2021,31521,82L-IMPORT PAYROLL,D105,HJ,2150,,5280061.58
6100,3/15/2021,3/15/2021,31521,82L-IMPORT PAYROLL,D105,HJ,2897.92,,5282959.5
6100,3/15/2021,3/15/2021,31521,82L-IMPORT PAYROLL,D105,HJ,3593.03,,5286552.53
6100,3/15/2021,3/15/2021,31521,82L-IMPORT PAYROLL,D107,HJ,696.81,,5287249.34
6100,3/15/2021,3/15/2021,31521,82L-IMPORT PAYROLL,D107,HJ,2049.45,,5289298.79
6100,3/15/2021,3/15/2021,31521,82L-IMPORT PAYROLL,D107,HJ,3009.99,,5292308.78
6100,3/15/2021,3/15/2021,31521,82L-IMPORT PAYROLL,D107,HJ,3260.83,,5295569.61
6100,3/15/2021,3/15/2021,31521,82L-IMPORT PAYROLL,D107,HJ,3643.48,,5299213.09
6100,3/15/2021,3/15/2021,31521,82L-IMPORT PAYROLL,D107,HJ,5375,,5304588.09
6100,3/15/2021,3/15/2021,31521,82L-IMPORT PAYROLL,D107,HJ,7045.57,,5311633.66
6100,3/15/2021,3/15/2021,31521,82L-IMPORT PAYROLL,D109,HJ,146.72,,5311780.38
6100,3/15/2021,3/15/2021,31521,82L-IMPORT PAYROLL,D109,HJ,150.66,,5311931.04
6100,3/15/2021,3/15/2021,31521,82L-IMPORT PAYROLL,D109,HJ,153.53,,5312084.57
6100,3/15/2021,3/15/2021,31521,82L-IMPORT PAYROLL,D109,HJ,153.53,,5312238.1
6100,3/15/2021,3/15/2021,31521,82L-IMPORT PAYROLL,D109,HJ,439.65,,5312677.75
6100,3/15/2021,3/15/2021,31521,82L-IMPORT PAYROLL,D109,HJ,439.65,,5313117.4
6100,3/15/2021,3/15/2021,31521,82L-IMPORT PAYROLL,D109,HJ,528,,5313645.4
6100,3/15/2021,3/15/2021,31521,82L-IMPORT PAYROLL,D109,HJ,1217.16,,5314862.56
6100,3/15/2021,3/15/2021,31521,82L-IMPORT PAYROLL,D109,HJ,1500,,5316362.56
6100,3/15/2021,3/15/2021,31521,82L-IMPORT PAYROLL,D109,HJ,3875,,5320237.56
6100,3/15/2021,3/15/2021,31521,82L-IMPORT PAYROLL,D109,HJ,4000,,5324237.56
6100,3/15/2021,3/15/2021,31521,82L-IMPORT PAYROLL,D109,HJ,4166.67,,5328404.23
6100,3/15/2021,3/15/2021,31521,82L-IMPORT PAYROLL,D109,HJ,5000,,5333404.23
6100,3/15/2021,3/15/2021,31521,82L-IMPORT PAYROLL,D109,HJ,5416.67,,5338820.9
6100,3/15/2021,3/15/2021,31521,82L-IMPORT PAYROLL,D109,HJ,5416.67,,5344237.57
6100,3/15/2021,3/15/2021,31521,82L-IMPORT PAYROLL,D109,HJ,5416.67,,5349654.24
6100,3/15/2021,3/15/2021,31521,82L-IMPORT PAYROLL,D109,HJ,5416.67,,5355070.91
6100,3/15/2021,3/15/2021,31521,82L-IMPORT PAYROLL,D109,HJ,5416.67,,5360487.58
6100,3/15/2021,3/15/2021,31521,82L-IMPORT PAYROLL,D111,HJ,1750,,5362237.58
6100,3/15/2021,3/15/2021,31521,82L-IMPORT PAYROLL,D111,HJ,2125,,5364362.58
6100,3/15/2021,3/15/2021,31521,82L-IMPORT PAYROLL,D111,HJ,2505.63,,5366868.21
6100,3/15/2021,3/15/2021,31521,82L-IMPORT PAYROLL,D111,HJ,2672.72,,5369540.93
6100,3/15/2021,3/15/2021,31521,82L-IMPORT PAYROLL,D111,HJ,3749.96,,5373290.89
6100,3/15/2021,3/15/2021,31521,82L-IMPORT PAYROLL,D112,HJ,3041.67,,5376332.56
6100,3/15/2021,3/15/2021,31521,82L-IMPORT PAYROLL,D108,HJ,2.32,,5376334.88
6100,3/15/2021,3/15/2021,31521,82L-IMPORT PAYROLL,D108,HJ,13.56,,5376348.44
6100,3/15/2021,3/15/2021,31521,82L-IMPORT PAYROLL,D108,HJ,455.76,,5376804.2
6100,3/15/2021,3/15/2021,31521,82L-IMPORT PAYROLL,D108,HJ,643.63,,5377447.83
6100,3/15/2021,3/15/2021,31521,82L-IMPORT PAYROLL,D108,HJ,826.34,,5378274.17
6100,3/15/2021,3/15/2021,31521,82L-IMPORT PAYROLL,D108,HJ,1119.05,,5379393.22
6100,3/15/2021,3/15/2021,31521,82L-IMPORT PAYROLL,D108,HJ,1119.05,,5380512.27
6100,3/15/2021,3/15/2021,31521,82L-IMPORT PAYROLL,D108,HJ,1119.05,,5381631.32
6100,3/15/2021,3/15/2021,31521,82L-IMPORT PAYROLL,D108,HJ,1119.05,,5382750.37
6100,3/15/2021,3/15/2021,31521,82L-IMPORT PAYROLL,D108,HJ,1119.05,,5383869.42
6100,3/15/2021,3/15/2021,31521,82L-IMPORT PAYROLL,D108,HJ,1119.05,,5384988.47
6100,3/15/2021,3/15/2021,31521,82L-IMPORT PAYROLL,D108,HJ,1119.05,,5386107.52
6100,3/15/2021,3/15/2021,31521,82L-IMPORT PAYROLL,D108,HJ,1119.05,,5387226.57
6100,3/15/2021,3/15/2021,31521,82L-IMPORT PAYROLL,D108,HJ,1119.05,,5388345.62
6100,3/15/2021,3/15/2021,31521,82L-IMPORT PAYROLL,D108,HJ,1119.05,,5389464.67
6100,3/15/2021,3/15/2021,31521,82L-IMPORT PAYROLL,D108,HJ,1119.05,,5390583.72
6100,3/15/2021,3/15/2021,31521,82L-IMPORT PAYROLL,D108,HJ,1119.05,,5391702.77
6100,3/15/2021,3/15/2021,31521,82L-IMPORT PAYROLL,D108,HJ,1119.05,,5392821.82
6100,3/15/2021,3/15/2021,31521,82L-IMPORT PAYROLL,D108,HJ,1119.05,,5393940.87
6100,3/15/2021,3/15/2021,31521,82L-IMPORT PAYROLL,D108,HJ,1119.05,,5395059.92
6100,3/15/2021,3/15/2021,31521,82L-IMPORT PAYROLL,D108,HJ,1119.05,,5396178.97
6100,3/15/2021,3/15/2021,31521,82L-IMPORT PAYROLL,D108,HJ,1119.05,,5397298.02
6100,3/15/2021,3/15/2021,31521,82L-IMPORT PAYROLL,D108,HJ,1119.05,,5398417.07
6100,3/15/2021,3/15/2021,31521,82L-IMPORT PAYROLL,D108,HJ,1119.05,,5399536.12
6100,3/15/2021,3/15/2021,31521,82L-IMPORT PAYROLL,D108,HJ,1119.05,,5400655.17
6100,3/15/2021,3/15/2021,31521,82L-IMPORT PAYROLL,D108,HJ,1119.05,,5401774.22
6100,3/15/2021,3/15/2021,31521,82L-IMPORT PAYROLL,D108,HJ,1119.05,,5402893.27
6100,3/15/2021,3/15/2021,31521,82L-IMPORT PAYROLL,D108,HJ,1119.05,,5404012.32
6100,3/15/2021,3/15/2021,31521,82L-IMPORT PAYROLL,D108,HJ,1119.05,,5405131.37
6100,3/15/2021,3/15/2021,31521,82L-IMPORT PAYROLL,D108,HJ,1119.05,,5406250.42
6100,3/15/2021,3/15/2021,31521,82L-IMPORT PAYROLL,D108,HJ,1119.05,,5407369.47
6100,3/15/2021,3/15/2021,31521,82L-IMPORT PAYROLL,D108,HJ,2250,,5409619.47
6100,3/15/2021,3/15/2021,31521,82L-IMPORT PAYROLL,D108,HJ,2250,,5411869.47
6100,3/15/2021,3/15/2021,31521,82L-IMPORT PAYROLL,D108,HJ,2250,,5414119.47
6100,3/15/2021,3/15/2021,31521,82L-IMPORT PAYROLL,D108,HJ,2291.67,,5416411.14
6100,3/15/2021,3/15/2021,31521,82L-IMPORT PAYROLL,D108,HJ,2291.67,,5418702.81
6100,3/15/2021,3/15/2021,31521,82L-IMPORT PAYROLL,D108,HJ,2291.67,,5420994.48
6100,3/15/2021,3/15/2021,31521,82L-IMPORT PAYROLL,D108,HJ,2437.5,,5423431.98
6100,3/15/2021,3/15/2021,31521,82L-IMPORT PAYROLL,D108,HJ,2486.25,,5425918.23
6100,3/15/2021,3/15/2021,31521,82L-IMPORT PAYROLL,D108,HJ,2500,,5428418.23
6100,3/15/2021,3/15/2021,31521,82L-IMPORT PAYROLL,D108,HJ,2500,,5430918.23
6100,3/15/2021,3/15/2021,31521,82L-IMPORT PAYROLL,D108,HJ,2550,,5433468.23
6100,3/15/2021,3/15/2021,31521,82L-IMPORT PAYROLL,D108,HJ,2833.33,,5436301.56
6100,3/15/2021,3/15/2021,31521,82L-IMPORT PAYROLL,D108,HJ,3034.5,,5439336.06
6100,3/15/2021,3/15/2021,31521,82L-IMPORT PAYROLL,D108,HJ,3291.67,,5442627.73
6100,3/15/2021,3/15/2021,31521,82L-IMPORT PAYROLL,D108,HJ,1087.5,,5443715.23
6100,3/15/2021,3/15/2021,31521,82L-IMPORT PAYROLL,D108,HJ,2666.67,,5446381.9
6100,3/15/2021,3/15/2021,31521,82L-IMPORT PAYROLL,D108,HJ,2750,,5449131.9
6100,3/15/2021,3/15/2021,31521,82L-IMPORT PAYROLL,D108,HJ,2854.17,,5451986.07
6100,3/15/2021,3/15/2021,31521,82L-IMPORT PAYROLL,D108,HJ,3125,,5455111.07
6100,3/15/2021,3/15/2021,31521,82L-IMPORT PAYROLL,D108,HJ,3812.5,,5458923.57
6100,3/31/2021,3/31/2021,33121,82L-IMPORT PAYROLL,D108,HJ,0.91,,5458924.48
6100,3/31/2021,3/31/2021,33121,82L-IMPORT PAYROLL,D108,HJ,4.53,,5458929.01
6100,3/31/2021,3/31/2021,33121,82L-IMPORT PAYROLL,D108,HJ,6.71,,5458935.72
6100,3/31/2021,3/31/2021,33121,82L-IMPORT PAYROLL,D108,HJ,7.62,,5458943.34
6100,3/31/2021,3/31/2021,33121,82L-IMPORT PAYROLL,D108,HJ,46.23,,5458989.57
6100,3/31/2021,3/31/2021,33121,82L-IMPORT PAYROLL,D108,HJ,57.66,,5459047.23
6100,3/31/2021,3/31/2021,33121,82L-IMPORT PAYROLL,D108,HJ,181.31,,5459228.54
6100,3/31/2021,3/31/2021,33121,82L-IMPORT PAYROLL,D108,HJ,386.8,,5459615.34
6100,3/31/2021,3/31/2021,33121,82L-IMPORT PAYROLL,D108,HJ,1047.62,,5460662.96
6100,3/31/2021,3/31/2021,33121,82L-IMPORT PAYROLL,D108,HJ,1047.62,,5461710.58
6100,3/31/2021,3/31/2021,33121,82L-IMPORT PAYROLL,D108,HJ,1047.62,,5462758.2
6100,3/31/2021,3/31/2021,33121,82L-IMPORT PAYROLL,D108,HJ,1047.62,,5463805.82
6100,3/31/2021,3/31/2021,33121,82L-IMPORT PAYROLL,D108,HJ,1047.62,,5464853.44
6100,3/31/2021,3/31/2021,33121,82L-IMPORT PAYROLL,D108,HJ,1047.62,,5465901.06
6100,3/31/2021,3/31/2021,33121,82L-IMPORT PAYROLL,D108,HJ,1047.62,,5466948.68
6100,3/31/2021,3/31/2021,33121,82L-IMPORT PAYROLL,D108,HJ,1047.62,,5467996.3
6100,3/31/2021,3/31/2021,33121,82L-IMPORT PAYROLL,D108,HJ,1047.62,,5469043.92
6100,3/31/2021,3/31/2021,33121,82L-IMPORT PAYROLL,D108,HJ,1047.62,,5470091.54
6100,3/31/2021,3/31/2021,33121,82L-IMPORT PAYROLL,D108,HJ,1047.62,,5471139.16
6100,3/31/2021,3/31/2021,33121,82L-IMPORT PAYROLL,D108,HJ,1047.62,,5472186.78
6100,3/31/2021,3/31/2021,33121,82L-IMPORT PAYROLL,D108,HJ,1047.62,,5473234.4
6100,3/31/2021,3/31/2021,33121,82L-IMPORT PAYROLL,D108,HJ,1047.62,,5474282.02
6100,3/31/2021,3/31/2021,33121,82L-IMPORT PAYROLL,D108,HJ,1047.62,,5475329.64
6100,3/31/2021,3/31/2021,33121,82L-IMPORT PAYROLL,D108,HJ,1047.62,,5476377.26
6100,3/31/2021,3/31/2021,33121,82L-IMPORT PAYROLL,D108,HJ,1047.62,,5477424.88
6100,3/31/2021,3/31/2021,33121,82L-IMPORT PAYROLL,D108,HJ,1047.62,,5478472.5
6100,3/31/2021,3/31/2021,33121,82L-IMPORT PAYROLL,D108,HJ,1047.62,,5479520.12
6100,3/31/2021,3/31/2021,33121,82L-IMPORT PAYROLL,D108,HJ,1047.62,,5480567.74
6100,3/31/2021,3/31/2021,33121,82L-IMPORT PAYROLL,D108,HJ,1047.62,,5481615.36
6100,3/31/2021,3/31/2021,33121,82L-IMPORT PAYROLL,D108,HJ,1047.62,,5482662.98
6100,3/31/2021,3/31/2021,33121,82L-IMPORT PAYROLL,D108,HJ,1047.62,,5483710.6
6100,3/31/2021,3/31/2021,33121,82L-IMPORT PAYROLL,D108,HJ,1047.62,,5484758.22
6100,3/31/2021,3/31/2021,33121,82L-IMPORT PAYROLL,D108,HJ,1047.62,,5485805.84
6100,3/31/2021,3/31/2021,33121,82L-IMPORT PAYROLL,D108,HJ,1047.62,,5486853.46
6100,3/31/2021,3/31/2021,33121,82L-IMPORT PAYROLL,D108,HJ,1047.62,,5487901.08
6100,3/31/2021,3/31/2021,33121,82L-IMPORT PAYROLL,D108,HJ,1047.62,,5488948.7
6100,3/31/2021,3/31/2021,33121,82L-IMPORT PAYROLL,D108,HJ,1047.62,,5489996.32
6100,3/31/2021,3/31/2021,33121,82L-IMPORT PAYROLL,D108,HJ,2000,,5491996.32
6100,3/31/2021,3/31/2021,33121,82L-IMPORT PAYROLL,D108,HJ,2041.67,,5494037.99
6100,3/31/2021,3/31/2021,33121,82L-IMPORT PAYROLL,D108,HJ,2083.33,,5496121.32
6100,3/31/2021,3/31/2021,33121,82L-IMPORT PAYROLL,D108,HJ,2083.33,,5498204.65
6100,3/31/2021,3/31/2021,33121,82L-IMPORT PAYROLL,D108,HJ,2500,,5500704.65
6100,3/31/2021,3/31/2021,33121,82L-IMPORT PAYROLL,D108,HJ,2541.67,,5503246.32
6100,3/31/2021,3/31/2021,33121,82L-IMPORT PAYROLL,D108,HJ,2541.67,,5505787.99
6100,3/31/2021,3/31/2021,33121,82L-IMPORT PAYROLL,D108,HJ,2541.67,,5508329.66
6100,3/31/2021,3/31/2021,33121,82L-IMPORT PAYROLL,D108,HJ,2833.33,,5511162.99
6100,3/31/2021,3/31/2021,33121,82L-IMPORT PAYROLL,D108,HJ,2270.83,,5513433.82
6100,3/31/2021,3/31/2021,33121,82L-IMPORT PAYROLL,D108,HJ,2291.67,,5515725.49
6100,3/31/2021,3/31/2021,33121,82L-IMPORT PAYROLL,D108,HJ,2291.67,,5518017.16
6100,3/31/2021,3/31/2021,33121,82L-IMPORT PAYROLL,D108,HJ,2329,,5520346.16
6100,3/31/2021,3/31/2021,33121,82L-IMPORT PAYROLL,D108,HJ,2414,,5522760.16
6100,3/31/2021,3/31/2021,33121,82L-IMPORT PAYROLL,D108,HJ,2416.67,,5525176.83
6100,3/31/2021,3/31/2021,33121,82L-IMPORT PAYROLL,D108,HJ,2431.94,,5527608.77
6100,3/31/2021,3/31/2021,33121,82L-IMPORT PAYROLL,D108,HJ,2458.33,,5530067.1
6100,3/31/2021,3/31/2021,33121,82L-IMPORT PAYROLL,D108,HJ,2465,,5532532.1
6100,3/31/2021,3/31/2021,33121,82L-IMPORT PAYROLL,D108,HJ,2500,,5535032.1
6100,3/31/2021,3/31/2021,33121,82L-IMPORT PAYROLL,D108,HJ,2500,,5537532.1
6100,3/31/2021,3/31/2021,33121,82L-IMPORT PAYROLL,D108,HJ,2635,,5540167.1
6100,3/31/2021,3/31/2021,33121,82L-IMPORT PAYROLL,D108,HJ,2653.02,,5542820.12
6100,3/31/2021,3/31/2021,33121,82L-IMPORT PAYROLL,D108,HJ,2666.67,,5545486.79
6100,3/31/2021,3/31/2021,33121,82L-IMPORT PAYROLL,D108,HJ,2708.33,,5548195.12
6100,3/31/2021,3/31/2021,33121,82L-IMPORT PAYROLL,D108,HJ,2708.34,,5550903.46
6100,3/31/2021,3/31/2021,33121,82L-IMPORT PAYROLL,D108,HJ,2720,,5553623.46
6100,3/31/2021,3/31/2021,33121,82L-IMPORT PAYROLL,D108,HJ,2817.75,,5556441.21
6100,3/31/2021,3/31/2021,33121,82L-IMPORT PAYROLL,D108,HJ,2886.52,,5559327.73
6100,3/31/2021,3/31/2021,33121,82L-IMPORT PAYROLL,D108,HJ,3113.75,,5562441.48
6100,3/31/2021,3/31/2021,33121,82L-IMPORT PAYROLL,D108,HJ,3208.46,,5565649.94
6100,3/31/2021,3/31/2021,33121,82L-IMPORT PAYROLL,D108,HJ,3445,,5569094.94
6100,3/31/2021,3/31/2021,33121,82L-IMPORT PAYROLL,D108,HJ,3812.5,,5572907.44
6100,3/31/2021,3/31/2021,33121,82L-IMPORT PAYROLL,D101,HJ,1250,,5574157.44
6100,3/31/2021,3/31/2021,33121,82L-IMPORT PAYROLL,D101,HJ,1250,,5575407.44
6100,3/31/2021,3/31/2021,33121,82L-IMPORT PAYROLL,D101,HJ,2000,,5577407.44
6100,3/31/2021,3/31/2021,33121,82L-IMPORT PAYROLL,D101,HJ,2166.67,,5579574.11
6100,3/31/2021,3/31/2021,33121,82L-IMPORT PAYROLL,D101,HJ,2461.88,,5582035.99
6100,3/31/2021,3/31/2021,33121,82L-IMPORT PAYROLL,D101,HJ,2708.33,,5584744.32
6100,3/31/2021,3/31/2021,33121,82L-IMPORT PAYROLL,D101,HJ,2708.33,,5587452.65
6100,3/31/2021,3/31/2021,33121,82L-IMPORT PAYROLL,D101,HJ,2833.33,,5590285.98
6100,3/31/2021,3/31/2021,33121,82L-IMPORT PAYROLL,D101,HJ,2833.33,,5593119.31
6100,3/31/2021,3/31/2021,33121,82L-IMPORT PAYROLL,D101,HJ,3437.5,,5596556.81
6100,3/31/2021,3/31/2021,33121,82L-IMPORT PAYROLL,D102,HJ,2041.75,,5598598.56
6100,3/31/2021,3/31/2021,33121,82L-IMPORT PAYROLL,D102,HJ,2112.5,,5600711.06
6100,3/31/2021,3/31/2021,33121,82L-IMPORT PAYROLL,D102,HJ,2166.75,,5602877.81
6100,3/31/2021,3/31/2021,33121,82L-IMPORT PAYROLL,D102,HJ,2916.67,,5605794.48
6100,3/31/2021,3/31/2021,33121,82L-IMPORT PAYROLL,D103,HJ,2208.33,,5608002.81
6100,3/31/2021,3/31/2021,33121,82L-IMPORT PAYROLL,D103,HJ,2291.67,,5610294.48
6100,3/31/2021,3/31/2021,33121,82L-IMPORT PAYROLL,D103,HJ,3124.96,,5613419.44
6100,3/31/2021,3/31/2021,33121,82L-IMPORT PAYROLL,D104,HJ,50,,5613469.44
6100,3/31/2021,3/31/2021,33121,82L-IMPORT PAYROLL,D104,HJ,50,,5613519.44
6100,3/31/2021,3/31/2021,33121,82L-IMPORT PAYROLL,D104,HJ,50,,5613569.44
6100,3/31/2021,3/31/2021,33121,82L-IMPORT PAYROLL,D104,HJ,279.69,,5613849.13
6100,3/31/2021,3/31/2021,33121,82L-IMPORT PAYROLL,D104,HJ,1958.33,,5615807.46
6100,3/31/2021,3/31/2021,33121,82L-IMPORT PAYROLL,D104,HJ,2000,,5617807.46
6100,3/31/2021,3/31/2021,33121,82L-IMPORT PAYROLL,D104,HJ,2083.33,,5619890.79
6100,3/31/2021,3/31/2021,33121,82L-IMPORT PAYROLL,D104,HJ,2187.5,,5622078.29
6100,3/31/2021,3/31/2021,33121,82L-IMPORT PAYROLL,D104,HJ,2500,,5624578.29
6100,3/31/2021,3/31/2021,33121,82L-IMPORT PAYROLL,D104,HJ,2707.5,,5627285.79
6100,3/31/2021,3/31/2021,33121,82L-IMPORT PAYROLL,D104,HJ,3041.67,,5630327.46
6100,3/31/2021,3/31/2021,33121,82L-IMPORT PAYROLL,D104,HJ,3041.67,,5633369.13
6100,3/31/2021,3/31/2021,33121,82L-IMPORT PAYROLL,D104,HJ,3875,,5637244.13
6100,3/31/2021,3/31/2021,33121,82L-IMPORT PAYROLL,D105,HJ,1916.67,,5639160.8
6100,3/31/2021,3/31/2021,33121,82L-IMPORT PAYROLL,D105,HJ,1916.67,,5641077.47
6100,3/31/2021,3/31/2021,33121,82L-IMPORT PAYROLL,D105,HJ,2150,,5643227.47
6100,3/31/2021,3/31/2021,33121,82L-IMPORT PAYROLL,D105,HJ,2897.92,,5646125.39
6100,3/31/2021,3/31/2021,33121,82L-IMPORT PAYROLL,D105,HJ,3593.03,,5649718.42
6100,3/31/2021,3/31/2021,33121,82L-IMPORT PAYROLL,D107,HJ,619.39,,5650337.81
6100,3/31/2021,3/31/2021,33121,82L-IMPORT PAYROLL,D107,HJ,2069.37,,5652407.18
6100,3/31/2021,3/31/2021,33121,82L-IMPORT PAYROLL,D107,HJ,2391.03,,5654798.21
6100,3/31/2021,3/31/2021,33121,82L-IMPORT PAYROLL,D107,HJ,3301.9,,5658100.11
6100,3/31/2021,3/31/2021,33121,82L-IMPORT PAYROLL,D107,HJ,4201.45,,5662301.56
6100,3/31/2021,3/31/2021,33121,82L-IMPORT PAYROLL,D107,HJ,5375,,5667676.56
6100,3/31/2021,3/31/2021,33121,82L-IMPORT PAYROLL,D107,HJ,7122.99,,5674799.55
6100,3/31/2021,3/31/2021,33121,82L-IMPORT PAYROLL,D109,HJ,146.72,,5674946.27
6100,3/31/2021,3/31/2021,33121,82L-IMPORT PAYROLL,D109,HJ,150.66,,5675096.93
6100,3/31/2021,3/31/2021,33121,82L-IMPORT PAYROLL,D109,HJ,153.53,,5675250.46
6100,3/31/2021,3/31/2021,33121,82L-IMPORT PAYROLL,D109,HJ,153.53,,5675403.99
6100,3/31/2021,3/31/2021,33121,82L-IMPORT PAYROLL,D109,HJ,439.65,,5675843.64
6100,3/31/2021,3/31/2021,33121,82L-IMPORT PAYROLL,D109,HJ,439.65,,5676283.29
6100,3/31/2021,3/31/2021,33121,82L-IMPORT PAYROLL,D109,HJ,528,,5676811.29
6100,3/31/2021,3/31/2021,33121,82L-IMPORT PAYROLL,D109,HJ,600,,5677411.29
6100,3/31/2021,3/31/2021,33121,82L-IMPORT PAYROLL,D109,HJ,1219.59,,5678630.88
6100,3/31/2021,3/31/2021,33121,82L-IMPORT PAYROLL,D109,HJ,1500,,5680130.88
6100,3/31/2021,3/31/2021,33121,82L-IMPORT PAYROLL,D109,HJ,3875,,5684005.88
6100,3/31/2021,3/31/2021,33121,82L-IMPORT PAYROLL,D109,HJ,4000,,5688005.88
6100,3/31/2021,3/31/2021,33121,82L-IMPORT PAYROLL,D109,HJ,4166.67,,5692172.55
6100,3/31/2021,3/31/2021,33121,82L-IMPORT PAYROLL,D109,HJ,5000,,5697172.55
6100,3/31/2021,3/31/2021,33121,82L-IMPORT PAYROLL,D109,HJ,5416.67,,5702589.22
6100,3/31/2021,3/31/2021,33121,82L-IMPORT PAYROLL,D109,HJ,5416.67,,5708005.89
6100,3/31/2021,3/31/2021,33121,82L-IMPORT PAYROLL,D109,HJ,5416.67,,5713422.56
6100,3/31/2021,3/31/2021,33121,82L-IMPORT PAYROLL,D109,HJ,5416.67,,5718839.23
6100,3/31/2021,3/31/2021,33121,82L-IMPORT PAYROLL,D109,HJ,5416.67,,5724255.9
6100,3/31/2021,3/31/2021,33121,82L-IMPORT PAYROLL,D111,HJ,50,,5724305.9
6100,3/31/2021,3/31/2021,33121,82L-IMPORT PAYROLL,D111,HJ,50,,5724355.9
6100,3/31/2021,3/31/2021,33121,82L-IMPORT PAYROLL,D111,HJ,50,,5724405.9
6100,3/31/2021,3/31/2021,33121,82L-IMPORT PAYROLL,D111,HJ,50,,5724455.9
6100,3/31/2021,3/31/2021,33121,82L-IMPORT PAYROLL,D111,HJ,50,,5724505.9
6100,3/31/2021,3/31/2021,33121,82L-IMPORT PAYROLL,D111,HJ,1750,,5726255.9
6100,3/31/2021,3/31/2021,33121,82L-IMPORT PAYROLL,D111,HJ,2125,,5728380.9
6100,3/31/2021,3/31/2021,33121,82L-IMPORT PAYROLL,D111,HJ,2505.63,,5730886.53
6100,3/31/2021,3/31/2021,33121,82L-IMPORT PAYROLL,D111,HJ,2672.72,,5733559.25
6100,3/31/2021,3/31/2021,33121,82L-IMPORT PAYROLL,D111,HJ,3749.96,,5737309.21
6100,3/31/2021,3/31/2021,33121,82L-IMPORT PAYROLL,D112,HJ,3041.67,,5740350.88
6100,3/31/2021,3/31/2021,33121,82L-IMPORT PAYROLL,D108,HJ,1.36,,5740352.24
6100,3/31/2021,3/31/2021,33121,82L-IMPORT PAYROLL,D108,HJ,7.36,,5740359.6
6100,3/31/2021,3/31/2021,33121,82L-IMPORT PAYROLL,D108,HJ,9.1,,5740368.7
6100,3/31/2021,3/31/2021,33121,82L-IMPORT PAYROLL,D108,HJ,455.76,,5740824.46
6100,3/31/2021,3/31/2021,33121,82L-IMPORT PAYROLL,D108,HJ,1119.05,,5741943.51
6100,3/31/2021,3/31/2021,33121,82L-IMPORT PAYROLL,D108,HJ,1119.05,,5743062.56
6100,3/31/2021,3/31/2021,33121,82L-IMPORT PAYROLL,D108,HJ,1119.05,,5744181.61
6100,3/31/2021,3/31/2021,33121,82L-IMPORT PAYROLL,D108,HJ,1119.05,,5745300.66
6100,3/31/2021,3/31/2021,33121,82L-IMPORT PAYROLL,D108,HJ,1119.05,,5746419.71
6100,3/31/2021,3/31/2021,33121,82L-IMPORT PAYROLL,D108,HJ,1119.05,,5747538.76
6100,3/31/2021,3/31/2021,33121,82L-IMPORT PAYROLL,D108,HJ,1119.05,,5748657.81
6100,3/31/2021,3/31/2021,33121,82L-IMPORT PAYROLL,D108,HJ,1119.05,,5749776.86
6100,3/31/2021,3/31/2021,33121,82L-IMPORT PAYROLL,D108,HJ,1119.05,,5750895.91
6100,3/31/2021,3/31/2021,33121,82L-IMPORT PAYROLL,D108,HJ,1119.05,,5752014.96
6100,3/31/2021,3/31/2021,33121,82L-IMPORT PAYROLL,D108,HJ,1119.05,,5753134.01
6100,3/31/2021,3/31/2021,33121,82L-IMPORT PAYROLL,D108,HJ,1119.05,,5754253.06
6100,3/31/2021,3/31/2021,33121,82L-IMPORT PAYROLL,D108,HJ,1119.05,,5755372.11
6100,3/31/2021,3/31/2021,33121,82L-IMPORT PAYROLL,D108,HJ,1119.05,,5756491.16
6100,3/31/2021,3/31/2021,33121,82L-IMPORT PAYROLL,D108,HJ,1119.05,,5757610.21
6100,3/31/2021,3/31/2021,33121,82L-IMPORT PAYROLL,D108,HJ,1119.05,,5758729.26
6100,3/31/2021,3/31/2021,33121,82L-IMPORT PAYROLL,D108,HJ,1119.05,,5759848.31
6100,3/31/2021,3/31/2021,33121,82L-IMPORT PAYROLL,D108,HJ,1119.05,,5760967.36
6100,3/31/2021,3/31/2021,33121,82L-IMPORT PAYROLL,D108,HJ,1119.05,,5762086.41
6100,3/31/2021,3/31/2021,33121,82L-IMPORT PAYROLL,D108,HJ,1119.05,,5763205.46
6100,3/31/2021,3/31/2021,33121,82L-IMPORT PAYROLL,D108,HJ,1119.05,,5764324.51
6100,3/31/2021,3/31/2021,33121,82L-IMPORT PAYROLL,D108,HJ,1119.05,,5765443.56
6100,3/31/2021,3/31/2021,33121,82L-IMPORT PAYROLL,D108,HJ,1119.05,,5766562.61
6100,3/31/2021,3/31/2021,33121,82L-IMPORT PAYROLL,D108,HJ,1119.05,,5767681.66
6100,3/31/2021,3/31/2021,33121,82L-IMPORT PAYROLL,D108,HJ,1119.05,,5768800.71
6100,3/31/2021,3/31/2021,33121,82L-IMPORT PAYROLL,D108,HJ,1119.05,,5769919.76
6100,3/31/2021,3/31/2021,33121,82L-IMPORT PAYROLL,D108,HJ,2250,,5772169.76
6100,3/31/2021,3/31/2021,33121,82L-IMPORT PAYROLL,D108,HJ,2250,,5774419.76
6100,3/31/2021,3/31/2021,33121,82L-IMPORT PAYROLL,D108,HJ,2250,,5776669.76
6100,3/31/2021,3/31/2021,33121,82L-IMPORT PAYROLL,D108,HJ,2291.67,,5778961.43
6100,3/31/2021,3/31/2021,33121,82L-IMPORT PAYROLL,D108,HJ,2291.67,,5781253.1
6100,3/31/2021,3/31/2021,33121,82L-IMPORT PAYROLL,D108,HJ,2291.67,,5783544.77
6100,3/31/2021,3/31/2021,33121,82L-IMPORT PAYROLL,D108,HJ,2437.5,,5785982.27
6100,3/31/2021,3/31/2021,33121,82L-IMPORT PAYROLL,D108,HJ,2486.25,,5788468.52
6100,3/31/2021,3/31/2021,33121,82L-IMPORT PAYROLL,D108,HJ,2500,,5790968.52
6100,3/31/2021,3/31/2021,33121,82L-IMPORT PAYROLL,D108,HJ,2500,,5793468.52
6100,3/31/2021,3/31/2021,33121,82L-IMPORT PAYROLL,D108,HJ,2550,,5796018.52
6100,3/31/2021,3/31/2021,33121,82L-IMPORT PAYROLL,D108,HJ,2833.33,,5798851.85
6100,3/31/2021,3/31/2021,33121,82L-IMPORT PAYROLL,D108,HJ,3034.5,,5801886.35
6100,3/31/2021,3/31/2021,33121,82L-IMPORT PAYROLL,D108,HJ,3291.67,,5805178.02
6100,3/31/2021,3/31/2021,33121,82L-IMPORT PAYROLL,D108,HJ,3500,,5808678.02
6100,3/31/2021,3/31/2021,33121,82L-IMPORT PAYROLL,D108,HJ,3500,,5812178.02
6100,3/31/2021,3/31/2021,33121,82L-IMPORT PAYROLL,D108,HJ,3500,,5815678.02
6100,3/31/2021,3/31/2021,33121,82L-IMPORT PAYROLL,D108,HJ,4500,,5820178.02
6100,3/31/2021,3/31/2021,33121,82L-IMPORT PAYROLL,D108,HJ,4500,,5824678.02
6100,3/31/2021,3/31/2021,33121,82L-IMPORT PAYROLL,D108,HJ,4500,,5829178.02
6100,3/31/2021,3/31/2021,33121,82L-IMPORT PAYROLL,D108,HJ,1087.5,,5830265.52
6100,3/31/2021,3/31/2021,33121,82L-IMPORT PAYROLL,D108,HJ,2666.67,,5832932.19
6100,3/31/2021,3/31/2021,33121,82L-IMPORT PAYROLL,D108,HJ,2750,,5835682.19
6100,3/31/2021,3/31/2021,33121,82L-IMPORT PAYROLL,D108,HJ,2854.17,,5838536.36
6100,3/31/2021,3/31/2021,33121,82L-IMPORT PAYROLL,D108,HJ,3125,,5841661.36
6100,3/31/2021,3/31/2021,33121,82L-IMPORT PAYROLL,D108,HJ,4291.67,,5845953.03
6100,3/31/2021,3/31/2021,3312021,($56.46) To Reconcile the month of March,D107,HJ,56.46,,5846009.49
6100,4/5/2021,4/5/2021,20210405,82L Special Check Payroll,D108,HJ,,2785.96,5843223.53
6100,4/15/2021,4/15/2021,41521,82L-IMPORT PAYROLL,D108,HJ,36.63,,5843260.16
6100,4/15/2021,4/15/2021,41521,82L-IMPORT PAYROLL,D108,HJ,54.39,,5843314.55
6100,4/15/2021,4/15/2021,41521,82L-IMPORT PAYROLL,D108,HJ,1047.62,,5844362.17
6100,4/15/2021,4/15/2021,41521,82L-IMPORT PAYROLL,D108,HJ,1047.62,,5845409.79
6100,4/15/2021,4/15/2021,41521,82L-IMPORT PAYROLL,D108,HJ,1047.62,,5846457.41
6100,4/15/2021,4/15/2021,41521,82L-IMPORT PAYROLL,D108,HJ,1047.62,,5847505.03
6100,4/15/2021,4/15/2021,41521,82L-IMPORT PAYROLL,D108,HJ,1047.62,,5848552.65
6100,4/15/2021,4/15/2021,41521,82L-IMPORT PAYROLL,D108,HJ,1047.62,,5849600.27
6100,4/15/2021,4/15/2021,41521,82L-IMPORT PAYROLL,D108,HJ,1047.62,,5850647.89
6100,4/15/2021,4/15/2021,41521,82L-IMPORT PAYROLL,D108,HJ,1047.62,,5851695.51
6100,4/15/2021,4/15/2021,41521,82L-IMPORT PAYROLL,D108,HJ,1047.62,,5852743.13
6100,4/15/2021,4/15/2021,41521,82L-IMPORT PAYROLL,D108,HJ,1047.62,,5853790.75
6100,4/15/2021,4/15/2021,41521,82L-IMPORT PAYROLL,D108,HJ,1047.62,,5854838.37
6100,4/15/2021,4/15/2021,41521,82L-IMPORT PAYROLL,D108,HJ,1047.62,,5855885.99
6100,4/15/2021,4/15/2021,41521,82L-IMPORT PAYROLL,D108,HJ,1047.62,,5856933.61
6100,4/15/2021,4/15/2021,41521,82L-IMPORT PAYROLL,D108,HJ,1047.62,,5857981.23
6100,4/15/2021,4/15/2021,41521,82L-IMPORT PAYROLL,D108,HJ,1047.62,,5859028.85
6100,4/15/2021,4/15/2021,41521,82L-IMPORT PAYROLL,D108,HJ,1047.62,,5860076.47
6100,4/15/2021,4/15/2021,41521,82L-IMPORT PAYROLL,D108,HJ,1047.62,,5861124.09
6100,4/15/2021,4/15/2021,41521,82L-IMPORT PAYROLL,D108,HJ,1047.62,,5862171.71
6100,4/15/2021,4/15/2021,41521,82L-IMPORT PAYROLL,D108,HJ,1047.62,,5863219.33
6100,4/15/2021,4/15/2021,41521,82L-IMPORT PAYROLL,D108,HJ,1047.62,,5864266.95
6100,4/15/2021,4/15/2021,41521,82L-IMPORT PAYROLL,D108,HJ,1047.62,,5865314.57
6100,4/15/2021,4/15/2021,41521,82L-IMPORT PAYROLL,D108,HJ,1047.62,,5866362.19
6100,4/15/2021,4/15/2021,41521,82L-IMPORT PAYROLL,D108,HJ,1047.62,,5867409.81
6100,4/15/2021,4/15/2021,41521,82L-IMPORT PAYROLL,D108,HJ,1047.62,,5868457.43
6100,4/15/2021,4/15/2021,41521,82L-IMPORT PAYROLL,D108,HJ,1047.62,,5869505.05
6100,4/15/2021,4/15/2021,41521,82L-IMPORT PAYROLL,D108,HJ,1047.62,,5870552.67
6100,4/15/2021,4/15/2021,41521,82L-IMPORT PAYROLL,D108,HJ,1047.62,,5871600.29
6100,4/15/2021,4/15/2021,41521,82L-IMPORT PAYROLL,D108,HJ,1047.62,,5872647.91
6100,4/15/2021,4/15/2021,41521,82L-IMPORT PAYROLL,D108,HJ,1047.62,,5873695.53
6100,4/15/2021,4/15/2021,41521,82L-IMPORT PAYROLL,D108,HJ,2000,,5875695.53
6100,4/15/2021,4/15/2021,41521,82L-IMPORT PAYROLL,D108,HJ,2041.67,,5877737.2
6100,4/15/2021,4/15/2021,41521,82L-IMPORT PAYROLL,D108,HJ,2083.33,,5879820.53
6100,4/15/2021,4/15/2021,41521,82L-IMPORT PAYROLL,D108,HJ,2083.33,,5881903.86
6100,4/15/2021,4/15/2021,41521,82L-IMPORT PAYROLL,D108,HJ,2500,,5884403.86
6100,4/15/2021,4/15/2021,41521,82L-IMPORT PAYROLL,D108,HJ,2541.67,,5886945.53
6100,4/15/2021,4/15/2021,41521,82L-IMPORT PAYROLL,D108,HJ,2541.67,,5889487.2
6100,4/15/2021,4/15/2021,41521,82L-IMPORT PAYROLL,D108,HJ,2541.67,,5892028.87
6100,4/15/2021,4/15/2021,41521,82L-IMPORT PAYROLL,D108,HJ,2833.33,,5894862.2
6100,4/15/2021,4/15/2021,41521,82L-IMPORT PAYROLL,D108,HJ,1964.1,,5896826.3
6100,4/15/2021,4/15/2021,41521,82L-IMPORT PAYROLL,D108,HJ,2191.18,,5899017.48
6100,4/15/2021,4/15/2021,41521,82L-IMPORT PAYROLL,D108,HJ,2270.83,,5901288.31
6100,4/15/2021,4/15/2021,41521,82L-IMPORT PAYROLL,D108,HJ,2291.67,,5903579.98
6100,4/15/2021,4/15/2021,41521,82L-IMPORT PAYROLL,D108,HJ,2291.67,,5905871.65
6100,4/15/2021,4/15/2021,41521,82L-IMPORT PAYROLL,D108,HJ,2329,,5908200.65
6100,4/15/2021,4/15/2021,41521,82L-IMPORT PAYROLL,D108,HJ,2416.67,,5910617.32
6100,4/15/2021,4/15/2021,41521,82L-IMPORT PAYROLL,D108,HJ,2431.94,,5913049.26
6100,4/15/2021,4/15/2021,41521,82L-IMPORT PAYROLL,D108,HJ,2458.33,,5915507.59
6100,4/15/2021,4/15/2021,41521,82L-IMPORT PAYROLL,D108,HJ,2465,,5917972.59
6100,4/15/2021,4/15/2021,41521,82L-IMPORT PAYROLL,D108,HJ,2500,,5920472.59
6100,4/15/2021,4/15/2021,41521,82L-IMPORT PAYROLL,D108,HJ,2500,,5922972.59
6100,4/15/2021,4/15/2021,41521,82L-IMPORT PAYROLL,D108,HJ,2635,,5925607.59
6100,4/15/2021,4/15/2021,41521,82L-IMPORT PAYROLL,D108,HJ,2653.02,,5928260.61
6100,4/15/2021,4/15/2021,41521,82L-IMPORT PAYROLL,D108,HJ,2666.67,,5930927.28
6100,4/15/2021,4/15/2021,41521,82L-IMPORT PAYROLL,D108,HJ,2708.33,,5933635.61
6100,4/15/2021,4/15/2021,41521,82L-IMPORT PAYROLL,D108,HJ,2708.34,,5936343.95
6100,4/15/2021,4/15/2021,41521,82L-IMPORT PAYROLL,D108,HJ,2720,,5939063.95
6100,4/15/2021,4/15/2021,41521,82L-IMPORT PAYROLL,D108,HJ,2817.75,,5941881.7
6100,4/15/2021,4/15/2021,41521,82L-IMPORT PAYROLL,D108,HJ,2886.52,,5944768.22
6100,4/15/2021,4/15/2021,41521,82L-IMPORT PAYROLL,D108,HJ,3208.46,,5947976.68
6100,4/15/2021,4/15/2021,41521,82L-IMPORT PAYROLL,D108,HJ,3445,,5951421.68
6100,4/15/2021,4/15/2021,41521,82L-IMPORT PAYROLL,D108,HJ,3812.5,,5955234.18
6100,4/15/2021,4/15/2021,41521,82L-IMPORT PAYROLL,D101,HJ,18,,5955252.18
6100,4/15/2021,4/15/2021,41521,82L-IMPORT PAYROLL,D101,HJ,1250,,5956502.18
6100,4/15/2021,4/15/2021,41521,82L-IMPORT PAYROLL,D101,HJ,1250,,5957752.18
6100,4/15/2021,4/15/2021,41521,82L-IMPORT PAYROLL,D101,HJ,2000,,5959752.18
6100,4/15/2021,4/15/2021,41521,82L-IMPORT PAYROLL,D101,HJ,2166.67,,5961918.85
6100,4/15/2021,4/15/2021,41521,82L-IMPORT PAYROLL,D101,HJ,2461.88,,5964380.73
6100,4/15/2021,4/15/2021,41521,82L-IMPORT PAYROLL,D101,HJ,2708.33,,5967089.06
6100,4/15/2021,4/15/2021,41521,82L-IMPORT PAYROLL,D101,HJ,2708.33,,5969797.39
6100,4/15/2021,4/15/2021,41521,82L-IMPORT PAYROLL,D101,HJ,2833.33,,5972630.72
6100,4/15/2021,4/15/2021,41521,82L-IMPORT PAYROLL,D101,HJ,2833.33,,5975464.05
6100,4/15/2021,4/15/2021,41521,82L-IMPORT PAYROLL,D101,HJ,3437.5,,5978901.55
6100,4/15/2021,4/15/2021,41521,82L-IMPORT PAYROLL,D102,HJ,2041.75,,5980943.3
6100,4/15/2021,4/15/2021,41521,82L-IMPORT PAYROLL,D102,HJ,2166.75,,5983110.05
6100,4/15/2021,4/15/2021,41521,82L-IMPORT PAYROLL,D102,HJ,2916.67,,5986026.72
6100,4/15/2021,4/15/2021,41521,82L-IMPORT PAYROLL,D103,HJ,416.71,,5986443.43
6100,4/15/2021,4/15/2021,41521,82L-IMPORT PAYROLL,D103,HJ,2208.33,,5988651.76
6100,4/15/2021,4/15/2021,41521,82L-IMPORT PAYROLL,D103,HJ,2291.67,,5990943.43
6100,4/15/2021,4/15/2021,41521,82L-IMPORT PAYROLL,D103,HJ,3541.67,,5994485.1
6100,4/15/2021,4/15/2021,41521,82L-IMPORT PAYROLL,D104,HJ,1958.33,,5996443.43
6100,4/15/2021,4/15/2021,41521,82L-IMPORT PAYROLL,D104,HJ,2000,,5998443.43
6100,4/15/2021,4/15/2021,41521,82L-IMPORT PAYROLL,D104,HJ,2083.33,,6000526.76
6100,4/15/2021,4/15/2021,41521,82L-IMPORT PAYROLL,D104,HJ,2187.5,,6002714.26
6100,4/15/2021,4/15/2021,41521,82L-IMPORT PAYROLL,D104,HJ,2500,,6005214.26
6100,4/15/2021,4/15/2021,41521,82L-IMPORT PAYROLL,D104,HJ,2707.5,,6007921.76
6100,4/15/2021,4/15/2021,41521,82L-IMPORT PAYROLL,D104,HJ,3041.67,,6010963.43
6100,4/15/2021,4/15/2021,41521,82L-IMPORT PAYROLL,D104,HJ,3041.67,,6014005.1
6100,4/15/2021,4/15/2021,41521,82L-IMPORT PAYROLL,D104,HJ,3875,,6017880.1
6100,4/15/2021,4/15/2021,41521,82L-IMPORT PAYROLL,D105,HJ,1916.67,,6019796.77
6100,4/15/2021,4/15/2021,41521,82L-IMPORT PAYROLL,D105,HJ,1916.67,,6021713.44
6100,4/15/2021,4/15/2021,41521,82L-IMPORT PAYROLL,D105,HJ,2150,,6023863.44
6100,4/15/2021,4/15/2021,41521,82L-IMPORT PAYROLL,D105,HJ,2897.92,,6026761.36
6100,4/15/2021,4/15/2021,41521,82L-IMPORT PAYROLL,D105,HJ,3593.03,,6030354.39
6100,4/15/2021,4/15/2021,41521,82L-IMPORT PAYROLL,D107,HJ,696.82,,6031051.21
6100,4/15/2021,4/15/2021,41521,82L-IMPORT PAYROLL,D107,HJ,2006.67,,6033057.88
6100,4/15/2021,4/15/2021,41521,82L-IMPORT PAYROLL,D107,HJ,2561.83,,6035619.71
6100,4/15/2021,4/15/2021,41521,82L-IMPORT PAYROLL,D107,HJ,3131.11,,6038750.82
6100,4/15/2021,4/15/2021,41521,82L-IMPORT PAYROLL,D107,HJ,4264.16,,6043014.98
6100,4/15/2021,4/15/2021,41521,82L-IMPORT PAYROLL,D107,HJ,5375,,6048389.98
6100,4/15/2021,4/15/2021,41521,82L-IMPORT PAYROLL,D107,HJ,7045.57,,6055435.55
6100,4/15/2021,4/15/2021,41521,82L-IMPORT PAYROLL,D109,HJ,100,,6055535.55
6100,4/15/2021,4/15/2021,41521,82L-IMPORT PAYROLL,D109,HJ,146.72,,6055682.27
6100,4/15/2021,4/15/2021,41521,82L-IMPORT PAYROLL,D109,HJ,150.66,,6055832.93
6100,4/15/2021,4/15/2021,41521,82L-IMPORT PAYROLL,D109,HJ,153.53,,6055986.46
6100,4/15/2021,4/15/2021,41521,82L-IMPORT PAYROLL,D109,HJ,153.53,,6056139.99
6100,4/15/2021,4/15/2021,41521,82L-IMPORT PAYROLL,D109,HJ,439.65,,6056579.64
6100,4/15/2021,4/15/2021,41521,82L-IMPORT PAYROLL,D109,HJ,439.65,,6057019.29
6100,4/15/2021,4/15/2021,41521,82L-IMPORT PAYROLL,D109,HJ,550,,6057569.29
6100,4/15/2021,4/15/2021,41521,82L-IMPORT PAYROLL,D109,HJ,1460.16,,6059029.45
6100,4/15/2021,4/15/2021,41521,82L-IMPORT PAYROLL,D109,HJ,1500,,6060529.45
6100,4/15/2021,4/15/2021,41521,82L-IMPORT PAYROLL,D109,HJ,3875,,6064404.45
6100,4/15/2021,4/15/2021,41521,82L-IMPORT PAYROLL,D109,HJ,4000,,6068404.45
6100,4/15/2021,4/15/2021,41521,82L-IMPORT PAYROLL,D109,HJ,4166.67,,6072571.12
6100,4/15/2021,4/15/2021,41521,82L-IMPORT PAYROLL,D109,HJ,5000,,6077571.12
6100,4/15/2021,4/15/2021,41521,82L-IMPORT PAYROLL,D109,HJ,5416.67,,6082987.79
6100,4/15/2021,4/15/2021,41521,82L-IMPORT PAYROLL,D109,HJ,5416.67,,6088404.46
6100,4/15/2021,4/15/2021,41521,82L-IMPORT PAYROLL,D109,HJ,5416.67,,6093821.13
6100,4/15/2021,4/15/2021,41521,82L-IMPORT PAYROLL,D109,HJ,5416.67,,6099237.8
6100,4/15/2021,4/15/2021,41521,82L-IMPORT PAYROLL,D109,HJ,5416.67,,6104654.47
6100,4/15/2021,4/15/2021,41521,82L-IMPORT PAYROLL,D111,HJ,1750,,6106404.47
6100,4/15/2021,4/15/2021,41521,82L-IMPORT PAYROLL,D111,HJ,2125,,6108529.47
6100,4/15/2021,4/15/2021,41521,82L-IMPORT PAYROLL,D111,HJ,2505.63,,6111035.1
6100,4/15/2021,4/15/2021,41521,82L-IMPORT PAYROLL,D111,HJ,2672.72,,6113707.82
6100,4/15/2021,4/15/2021,41521,82L-IMPORT PAYROLL,D111,HJ,3749.96,,6117457.78
6100,4/15/2021,4/15/2021,41521,82L-IMPORT PAYROLL,D112,HJ,3041.67,,6120499.45
6100,4/15/2021,4/15/2021,41521,82L-IMPORT PAYROLL,D108,HJ,0.39,,6120499.84
6100,4/15/2021,4/15/2021,41521,82L-IMPORT PAYROLL,D108,HJ,1.55,,6120501.39
6100,4/15/2021,4/15/2021,41521,82L-IMPORT PAYROLL,D108,HJ,7.36,,6120508.75
6100,4/15/2021,4/15/2021,41521,82L-IMPORT PAYROLL,D108,HJ,15.11,,6120523.86
6100,4/15/2021,4/15/2021,41521,82L-IMPORT PAYROLL,D108,HJ,300,,6120823.86
6100,4/15/2021,4/15/2021,41521,82L-IMPORT PAYROLL,D108,HJ,455.76,,6121279.62
6100,4/15/2021,4/15/2021,41521,82L-IMPORT PAYROLL,D108,HJ,1119.05,,6122398.67
6100,4/15/2021,4/15/2021,41521,82L-IMPORT PAYROLL,D108,HJ,1119.05,,6123517.72
6100,4/15/2021,4/15/2021,41521,82L-IMPORT PAYROLL,D108,HJ,1119.05,,6124636.77
6100,4/15/2021,4/15/2021,41521,82L-IMPORT PAYROLL,D108,HJ,1119.05,,6125755.82
6100,4/15/2021,4/15/2021,41521,82L-IMPORT PAYROLL,D108,HJ,1119.05,,6126874.87
6100,4/15/2021,4/15/2021,41521,82L-IMPORT PAYROLL,D108,HJ,1119.05,,6127993.92
6100,4/15/2021,4/15/2021,41521,82L-IMPORT PAYROLL,D108,HJ,1119.05,,6129112.97
6100,4/15/2021,4/15/2021,41521,82L-IMPORT PAYROLL,D108,HJ,1119.05,,6130232.02
6100,4/15/2021,4/15/2021,41521,82L-IMPORT PAYROLL,D108,HJ,1119.05,,6131351.07
6100,4/15/2021,4/15/2021,41521,82L-IMPORT PAYROLL,D108,HJ,1119.05,,6132470.12
6100,4/15/2021,4/15/2021,41521,82L-IMPORT PAYROLL,D108,HJ,1119.05,,6133589.17
6100,4/15/2021,4/15/2021,41521,82L-IMPORT PAYROLL,D108,HJ,1119.05,,6134708.22
6100,4/15/2021,4/15/2021,41521,82L-IMPORT PAYROLL,D108,HJ,1119.05,,6135827.27
6100,4/15/2021,4/15/2021,41521,82L-IMPORT PAYROLL,D108,HJ,1119.05,,6136946.32
6100,4/15/2021,4/15/2021,41521,82L-IMPORT PAYROLL,D108,HJ,1119.05,,6138065.37
6100,4/15/2021,4/15/2021,41521,82L-IMPORT PAYROLL,D108,HJ,1119.05,,6139184.42
6100,4/15/2021,4/15/2021,41521,82L-IMPORT PAYROLL,D108,HJ,1119.05,,6140303.47
6100,4/15/2021,4/15/2021,41521,82L-IMPORT PAYROLL,D108,HJ,1119.05,,6141422.52
6100,4/15/2021,4/15/2021,41521,82L-IMPORT PAYROLL,D108,HJ,1119.05,,6142541.57
6100,4/15/2021,4/15/2021,41521,82L-IMPORT PAYROLL,D108,HJ,1119.05,,6143660.62
6100,4/15/2021,4/15/2021,41521,82L-IMPORT PAYROLL,D108,HJ,1119.05,,6144779.67
6100,4/15/2021,4/15/2021,41521,82L-IMPORT PAYROLL,D108,HJ,1119.05,,6145898.72
6100,4/15/2021,4/15/2021,41521,82L-IMPORT PAYROLL,D108,HJ,1119.05,,6147017.77
6100,4/15/2021,4/15/2021,41521,82L-IMPORT PAYROLL,D108,HJ,1119.05,,6148136.82
6100,4/15/2021,4/15/2021,41521,82L-IMPORT PAYROLL,D108,HJ,1119.05,,6149255.87
6100,4/15/2021,4/15/2021,41521,82L-IMPORT PAYROLL,D108,HJ,1119.05,,6150374.92
6100,4/15/2021,4/15/2021,41521,82L-IMPORT PAYROLL,D108,HJ,2250,,6152624.92
6100,4/15/2021,4/15/2021,41521,82L-IMPORT PAYROLL,D108,HJ,2250,,6154874.92
6100,4/15/2021,4/15/2021,41521,82L-IMPORT PAYROLL,D108,HJ,2250,,6157124.92
6100,4/15/2021,4/15/2021,41521,82L-IMPORT PAYROLL,D108,HJ,2291.67,,6159416.59
6100,4/15/2021,4/15/2021,41521,82L-IMPORT PAYROLL,D108,HJ,2291.67,,6161708.26
6100,4/15/2021,4/15/2021,41521,82L-IMPORT PAYROLL,D108,HJ,2291.67,,6163999.93
6100,4/15/2021,4/15/2021,41521,82L-IMPORT PAYROLL,D108,HJ,2437.5,,6166437.43
6100,4/15/2021,4/15/2021,41521,82L-IMPORT PAYROLL,D108,HJ,2486.25,,6168923.68
6100,4/15/2021,4/15/2021,41521,82L-IMPORT PAYROLL,D108,HJ,2500,,6171423.68
6100,4/15/2021,4/15/2021,41521,82L-IMPORT PAYROLL,D108,HJ,2500,,6173923.68
6100,4/15/2021,4/15/2021,41521,82L-IMPORT PAYROLL,D108,HJ,2550,,6176473.68
6100,4/15/2021,4/15/2021,41521,82L-IMPORT PAYROLL,D108,HJ,2833.33,,6179307.01
6100,4/15/2021,4/15/2021,41521,82L-IMPORT PAYROLL,D108,HJ,3034.5,,6182341.51
6100,4/15/2021,4/15/2021,41521,82L-IMPORT PAYROLL,D108,HJ,3291.67,,6185633.18
6100,4/15/2021,4/15/2021,41521,82L-IMPORT PAYROLL,D108,HJ,1080,,6186713.18
6100,4/15/2021,4/15/2021,41521,82L-IMPORT PAYROLL,D108,HJ,2666.67,,6189379.85
6100,4/15/2021,4/15/2021,41521,82L-IMPORT PAYROLL,D108,HJ,2750,,6192129.85
6100,4/15/2021,4/15/2021,41521,82L-IMPORT PAYROLL,D108,HJ,2854.17,,6194984.02
6100,4/15/2021,4/15/2021,41521,82L-IMPORT PAYROLL,D108,HJ,3125,,6198109.02
6100,4/15/2021,4/15/2021,41521,82L-IMPORT PAYROLL,D108,HJ,4291.67,,6202400.69
6100,4/19/2021,4/19/2021,20210419,82L Special Payroll 2021-04-20,D103,HJ,1745.18,,6204145.87
6100,4/23/2021,4/23/2021,20210423,82L Special Payroll 2021-04-23,D104,HJ,740.02,,6204885.89
6100,4/30/2021,4/30/2021,1,ADJ to Reclass funding source,D109,HJ,,15286.56,6189599.33
6100,4/30/2021,4/30/2021,1,ADJ to Reclass funding source,D109,HJ,15286.56,,6204885.89
6100,4/30/2021,4/30/2021,1,ADJ to Reclass funding source,D109,HJ,,10000,6194885.89
6100,4/30/2021,4/30/2021,1,ADJ to Reclass funding source,D109,HJ,10000,,6204885.89
6100,4/30/2021,4/30/2021,1,ADJ to Reclass funding source,D109,HJ,,124524.28,6080361.61
6100,4/30/2021,4/30/2021,1,ADJ to Reclass funding source,D109,HJ,124524.28,,6204885.89
6100,4/30/2021,4/30/2021,43021,82L-IMPORT PAYROLL,D108,HJ,0.54,,6204886.43
6100,4/30/2021,4/30/2021,43021,82L-IMPORT PAYROLL,D108,HJ,154.12,,6205040.55
6100,4/30/2021,4/30/2021,43021,82L-IMPORT PAYROLL,D108,HJ,580.2,,6205620.75
6100,4/30/2021,4/30/2021,43021,82L-IMPORT PAYROLL,D108,HJ,1047.62,,6206668.37
6100,4/30/2021,4/30/2021,43021,82L-IMPORT PAYROLL,D108,HJ,1047.62,,6207715.99
6100,4/30/2021,4/30/2021,43021,82L-IMPORT PAYROLL,D108,HJ,1047.62,,6208763.61
6100,4/30/2021,4/30/2021,43021,82L-IMPORT PAYROLL,D108,HJ,1047.62,,6209811.23
6100,4/30/2021,4/30/2021,43021,82L-IMPORT PAYROLL,D108,HJ,1047.62,,6210858.85
6100,4/30/2021,4/30/2021,43021,82L-IMPORT PAYROLL,D108,HJ,1047.62,,6211906.47
6100,4/30/2021,4/30/2021,43021,82L-IMPORT PAYROLL,D108,HJ,1047.62,,6212954.09
6100,4/30/2021,4/30/2021,43021,82L-IMPORT PAYROLL,D108,HJ,1047.62,,6214001.71
6100,4/30/2021,4/30/2021,43021,82L-IMPORT PAYROLL,D108,HJ,1047.62,,6215049.33
6100,4/30/2021,4/30/2021,43021,82L-IMPORT PAYROLL,D108,HJ,1047.62,,6216096.95
6100,4/30/2021,4/30/2021,43021,82L-IMPORT PAYROLL,D108,HJ,1047.62,,6217144.57
6100,4/30/2021,4/30/2021,43021,82L-IMPORT PAYROLL,D108,HJ,1047.62,,6218192.19
6100,4/30/2021,4/30/2021,43021,82L-IMPORT PAYROLL,D108,HJ,1047.62,,6219239.81
6100,4/30/2021,4/30/2021,43021,82L-IMPORT PAYROLL,D108,HJ,1047.62,,6220287.43
6100,4/30/2021,4/30/2021,43021,82L-IMPORT PAYROLL,D108,HJ,1047.62,,6221335.05
6100,4/30/2021,4/30/2021,43021,82L-IMPORT PAYROLL,D108,HJ,1047.62,,6222382.67
6100,4/30/2021,4/30/2021,43021,82L-IMPORT PAYROLL,D108,HJ,1047.62,,6223430.29
6100,4/30/2021,4/30/2021,43021,82L-IMPORT PAYROLL,D108,HJ,1047.62,,6224477.91
6100,4/30/2021,4/30/2021,43021,82L-IMPORT PAYROLL,D108,HJ,1047.62,,6225525.53
6100,4/30/2021,4/30/2021,43021,82L-IMPORT PAYROLL,D108,HJ,1047.62,,6226573.15
6100,4/30/2021,4/30/2021,43021,82L-IMPORT PAYROLL,D108,HJ,1047.62,,6227620.77
6100,4/30/2021,4/30/2021,43021,82L-IMPORT PAYROLL,D108,HJ,1047.62,,6228668.39
6100,4/30/2021,4/30/2021,43021,82L-IMPORT PAYROLL,D108,HJ,1047.62,,6229716.01
6100,4/30/2021,4/30/2021,43021,82L-IMPORT PAYROLL,D108,HJ,1047.62,,6230763.63
6100,4/30/2021,4/30/2021,43021,82L-IMPORT PAYROLL,D108,HJ,1047.62,,6231811.25
6100,4/30/2021,4/30/2021,43021,82L-IMPORT PAYROLL,D108,HJ,1047.62,,6232858.87
6100,4/30/2021,4/30/2021,43021,82L-IMPORT PAYROLL,D108,HJ,1047.62,,6233906.49
6100,4/30/2021,4/30/2021,43021,82L-IMPORT PAYROLL,D108,HJ,1047.62,,6234954.11
6100,4/30/2021,4/30/2021,43021,82L-IMPORT PAYROLL,D108,HJ,2000,,6236954.11
6100,4/30/2021,4/30/2021,43021,82L-IMPORT PAYROLL,D108,HJ,2041.67,,6238995.78
6100,4/30/2021,4/30/2021,43021,82L-IMPORT PAYROLL,D108,HJ,2083.33,,6241079.11
6100,4/30/2021,4/30/2021,43021,82L-IMPORT PAYROLL,D108,HJ,2083.33,,6243162.44
6100,4/30/2021,4/30/2021,43021,82L-IMPORT PAYROLL,D108,HJ,2500,,6245662.44
6100,4/30/2021,4/30/2021,43021,82L-IMPORT PAYROLL,D108,HJ,2541.67,,6248204.11
6100,4/30/2021,4/30/2021,43021,82L-IMPORT PAYROLL,D108,HJ,2541.67,,6250745.78
6100,4/30/2021,4/30/2021,43021,82L-IMPORT PAYROLL,D108,HJ,2541.67,,6253287.45
6100,4/30/2021,4/30/2021,43021,82L-IMPORT PAYROLL,D108,HJ,2833.33,,6256120.78
6100,4/30/2021,4/30/2021,43021,82L-IMPORT PAYROLL,D108,HJ,600,,6256720.78
6100,4/30/2021,4/30/2021,43021,82L-IMPORT PAYROLL,D108,HJ,682.6,,6257403.38
6100,4/30/2021,4/30/2021,43021,82L-IMPORT PAYROLL,D108,HJ,2270.83,,6259674.21
6100,4/30/2021,4/30/2021,43021,82L-IMPORT PAYROLL,D108,HJ,2291.67,,6261965.88
6100,4/30/2021,4/30/2021,43021,82L-IMPORT PAYROLL,D108,HJ,2291.67,,6264257.55
6100,4/30/2021,4/30/2021,43021,82L-IMPORT PAYROLL,D108,HJ,2329,,6266586.55
6100,4/30/2021,4/30/2021,43021,82L-IMPORT PAYROLL,D108,HJ,2416.67,,6269003.22
6100,4/30/2021,4/30/2021,43021,82L-IMPORT PAYROLL,D108,HJ,2431.94,,6271435.16
6100,4/30/2021,4/30/2021,43021,82L-IMPORT PAYROLL,D108,HJ,2458.33,,6273893.49
6100,4/30/2021,4/30/2021,43021,82L-IMPORT PAYROLL,D108,HJ,2465,,6276358.49
6100,4/30/2021,4/30/2021,43021,82L-IMPORT PAYROLL,D108,HJ,2500,,6278858.49
6100,4/30/2021,4/30/2021,43021,82L-IMPORT PAYROLL,D108,HJ,2500,,6281358.49
6100,4/30/2021,4/30/2021,43021,82L-IMPORT PAYROLL,D108,HJ,2635,,6283993.49
6100,4/30/2021,4/30/2021,43021,82L-IMPORT PAYROLL,D108,HJ,2653.02,,6286646.51
6100,4/30/2021,4/30/2021,43021,82L-IMPORT PAYROLL,D108,HJ,2666.67,,6289313.18
6100,4/30/2021,4/30/2021,43021,82L-IMPORT PAYROLL,D108,HJ,2708.33,,6292021.51
6100,4/30/2021,4/30/2021,43021,82L-IMPORT PAYROLL,D108,HJ,2708.34,,6294729.85
6100,4/30/2021,4/30/2021,43021,82L-IMPORT PAYROLL,D108,HJ,2720,,6297449.85
6100,4/30/2021,4/30/2021,43021,82L-IMPORT PAYROLL,D108,HJ,2817.75,,6300267.6
6100,4/30/2021,4/30/2021,43021,82L-IMPORT PAYROLL,D108,HJ,2886.52,,6303154.12
6100,4/30/2021,4/30/2021,43021,82L-IMPORT PAYROLL,D108,HJ,3208.46,,6306362.58
6100,4/30/2021,4/30/2021,43021,82L-IMPORT PAYROLL,D108,HJ,3445,,6309807.58
6100,4/30/2021,4/30/2021,43021,82L-IMPORT PAYROLL,D108,HJ,3812.5,,6313620.08
6100,4/30/2021,4/30/2021,43021,82L-IMPORT PAYROLL,D101,HJ,9.37,,6313629.45
6100,4/30/2021,4/30/2021,43021,82L-IMPORT PAYROLL,D101,HJ,1250,,6314879.45
6100,4/30/2021,4/30/2021,43021,82L-IMPORT PAYROLL,D101,HJ,1250,,6316129.45
6100,4/30/2021,4/30/2021,43021,82L-IMPORT PAYROLL,D101,HJ,2000,,6318129.45
6100,4/30/2021,4/30/2021,43021,82L-IMPORT PAYROLL,D101,HJ,2166.67,,6320296.12
6100,4/30/2021,4/30/2021,43021,82L-IMPORT PAYROLL,D101,HJ,2461.88,,6322758
6100,4/30/2021,4/30/2021,43021,82L-IMPORT PAYROLL,D101,HJ,2708.33,,6325466.33
6100,4/30/2021,4/30/2021,43021,82L-IMPORT PAYROLL,D101,HJ,2708.33,,6328174.66
6100,4/30/2021,4/30/2021,43021,82L-IMPORT PAYROLL,D101,HJ,2833.33,,6331007.99
6100,4/30/2021,4/30/2021,43021,82L-IMPORT PAYROLL,D101,HJ,2833.33,,6333841.32
6100,4/30/2021,4/30/2021,43021,82L-IMPORT PAYROLL,D101,HJ,3437.5,,6337278.82
6100,4/30/2021,4/30/2021,43021,82L-IMPORT PAYROLL,D102,HJ,53,,6337331.82
6100,4/30/2021,4/30/2021,43021,82L-IMPORT PAYROLL,D102,HJ,321.75,,6337653.57
6100,4/30/2021,4/30/2021,43021,82L-IMPORT PAYROLL,D102,HJ,2041.75,,6339695.32
6100,4/30/2021,4/30/2021,43021,82L-IMPORT PAYROLL,D102,HJ,2166.75,,6341862.07
6100,4/30/2021,4/30/2021,43021,82L-IMPORT PAYROLL,D102,HJ,2916.67,,6344778.74
6100,4/30/2021,4/30/2021,43021,82L-IMPORT PAYROLL,D103,HJ,1115.34,,6345894.08
6100,4/30/2021,4/30/2021,43021,82L-IMPORT PAYROLL,D103,HJ,2208.33,,6348102.41
6100,4/30/2021,4/30/2021,43021,82L-IMPORT PAYROLL,D103,HJ,2291.67,,6350394.08
6100,4/30/2021,4/30/2021,43021,82L-IMPORT PAYROLL,D103,HJ,3541.67,,6353935.75
6100,4/30/2021,4/30/2021,43021,82L-IMPORT PAYROLL,D104,HJ,50,,6353985.75
6100,4/30/2021,4/30/2021,43021,82L-IMPORT PAYROLL,D104,HJ,50,,6354035.75
6100,4/30/2021,4/30/2021,43021,82L-IMPORT PAYROLL,D104,HJ,50,,6354085.75
6100,4/30/2021,4/30/2021,43021,82L-IMPORT PAYROLL,D104,HJ,1958.33,,6356044.08
6100,4/30/2021,4/30/2021,43021,82L-IMPORT PAYROLL,D104,HJ,2000,,6358044.08
6100,4/30/2021,4/30/2021,43021,82L-IMPORT PAYROLL,D104,HJ,2083.33,,6360127.41
6100,4/30/2021,4/30/2021,43021,82L-IMPORT PAYROLL,D104,HJ,2500,,6362627.41
6100,4/30/2021,4/30/2021,43021,82L-IMPORT PAYROLL,D104,HJ,2707.5,,6365334.91
6100,4/30/2021,4/30/2021,43021,82L-IMPORT PAYROLL,D104,HJ,3041.67,,6368376.58
6100,4/30/2021,4/30/2021,43021,82L-IMPORT PAYROLL,D104,HJ,3041.67,,6371418.25
6100,4/30/2021,4/30/2021,43021,82L-IMPORT PAYROLL,D104,HJ,3875,,6375293.25
6100,4/30/2021,4/30/2021,43021,82L-IMPORT PAYROLL,D105,HJ,1916.67,,6377209.92
6100,4/30/2021,4/30/2021,43021,82L-IMPORT PAYROLL,D105,HJ,1916.67,,6379126.59
6100,4/30/2021,4/30/2021,43021,82L-IMPORT PAYROLL,D105,HJ,2150,,6381276.59
6100,4/30/2021,4/30/2021,43021,82L-IMPORT PAYROLL,D105,HJ,2897.92,,6384174.51
6100,4/30/2021,4/30/2021,43021,82L-IMPORT PAYROLL,D105,HJ,3593.03,,6387767.54
6100,4/30/2021,4/30/2021,43021,82L-IMPORT PAYROLL,D107,HJ,696.82,,6388464.36
6100,4/30/2021,4/30/2021,43021,82L-IMPORT PAYROLL,D107,HJ,2257.5,,6390721.86
6100,4/30/2021,4/30/2021,43021,82L-IMPORT PAYROLL,D107,HJ,2561.83,,6393283.69
6100,4/30/2021,4/30/2021,43021,82L-IMPORT PAYROLL,D107,HJ,3131.11,,6396414.8
6100,4/30/2021,4/30/2021,43021,82L-IMPORT PAYROLL,D107,HJ,4013.33,,6400428.13
6100,4/30/2021,4/30/2021,43021,82L-IMPORT PAYROLL,D107,HJ,5375,,6405803.13
6100,4/30/2021,4/30/2021,43021,82L-IMPORT PAYROLL,D107,HJ,7045.57,,6412848.7
6100,4/30/2021,4/30/2021,43021,82L-IMPORT PAYROLL,D109,HJ,100,,6412948.7
6100,4/30/2021,4/30/2021,43021,82L-IMPORT PAYROLL,D109,HJ,146.72,,6413095.42
6100,4/30/2021,4/30/2021,43021,82L-IMPORT PAYROLL,D109,HJ,150.66,,6413246.08
6100,4/30/2021,4/30/2021,43021,82L-IMPORT PAYROLL,D109,HJ,153.53,,6413399.61
6100,4/30/2021,4/30/2021,43021,82L-IMPORT PAYROLL,D109,HJ,153.53,,6413553.14
6100,4/30/2021,4/30/2021,43021,82L-IMPORT PAYROLL,D109,HJ,439.65,,6413992.79
6100,4/30/2021,4/30/2021,43021,82L-IMPORT PAYROLL,D109,HJ,439.65,,6414432.44
6100,4/30/2021,4/30/2021,43021,82L-IMPORT PAYROLL,D109,HJ,594,,6415026.44
6100,4/30/2021,4/30/2021,43021,82L-IMPORT PAYROLL,D109,HJ,1500,,6416526.44
6100,4/30/2021,4/30/2021,43021,82L-IMPORT PAYROLL,D109,HJ,2389.5,,6418915.94
6100,4/30/2021,4/30/2021,43021,82L-IMPORT PAYROLL,D109,HJ,3875,,6422790.94
6100,4/30/2021,4/30/2021,43021,82L-IMPORT PAYROLL,D109,HJ,4000,,6426790.94
6100,4/30/2021,4/30/2021,43021,82L-IMPORT PAYROLL,D109,HJ,4166.67,,6430957.61
6100,4/30/2021,4/30/2021,43021,82L-IMPORT PAYROLL,D109,HJ,5000,,6435957.61
6100,4/30/2021,4/30/2021,43021,82L-IMPORT PAYROLL,D109,HJ,5416.67,,6441374.28
6100,4/30/2021,4/30/2021,43021,82L-IMPORT PAYROLL,D109,HJ,5416.67,,6446790.95
6100,4/30/2021,4/30/2021,43021,82L-IMPORT PAYROLL,D109,HJ,5416.67,,6452207.62
6100,4/30/2021,4/30/2021,43021,82L-IMPORT PAYROLL,D109,HJ,5416.67,,6457624.29
6100,4/30/2021,4/30/2021,43021,82L-IMPORT PAYROLL,D109,HJ,5416.67,,6463040.96
6100,4/30/2021,4/30/2021,43021,82L-IMPORT PAYROLL,D111,HJ,50,,6463090.96
6100,4/30/2021,4/30/2021,43021,82L-IMPORT PAYROLL,D111,HJ,50,,6463140.96
6100,4/30/2021,4/30/2021,43021,82L-IMPORT PAYROLL,D111,HJ,50,,6463190.96
6100,4/30/2021,4/30/2021,43021,82L-IMPORT PAYROLL,D111,HJ,50,,6463240.96
6100,4/30/2021,4/30/2021,43021,82L-IMPORT PAYROLL,D111,HJ,50,,6463290.96
6100,4/30/2021,4/30/2021,43021,82L-IMPORT PAYROLL,D111,HJ,1750,,6465040.96
6100,4/30/2021,4/30/2021,43021,82L-IMPORT PAYROLL,D111,HJ,2125,,6467165.96
6100,4/30/2021,4/30/2021,43021,82L-IMPORT PAYROLL,D111,HJ,2505.63,,6469671.59
6100,4/30/2021,4/30/2021,43021,82L-IMPORT PAYROLL,D111,HJ,2672.72,,6472344.31
6100,4/30/2021,4/30/2021,43021,82L-IMPORT PAYROLL,D111,HJ,3749.96,,6476094.27
6100,4/30/2021,4/30/2021,43021,82L-IMPORT PAYROLL,D112,HJ,3041.67,,6479135.94
6100,4/30/2021,4/30/2021,43021,82L-IMPORT PAYROLL,D108,HJ,0.58,,6479136.52
6100,4/30/2021,4/30/2021,43021,82L-IMPORT PAYROLL,D108,HJ,0.97,,6479137.49
6100,4/30/2021,4/30/2021,43021,82L-IMPORT PAYROLL,D108,HJ,455.76,,6479593.25
6100,4/30/2021,4/30/2021,43021,82L-IMPORT PAYROLL,D108,HJ,500,,6480093.25
6100,4/30/2021,4/30/2021,43021,82L-IMPORT PAYROLL,D108,HJ,600,,6480693.25
6100,4/30/2021,4/30/2021,43021,82L-IMPORT PAYROLL,D108,HJ,1015.76,,6481709.01
6100,4/30/2021,4/30/2021,43021,82L-IMPORT PAYROLL,D108,HJ,1119.05,,6482828.06
6100,4/30/2021,4/30/2021,43021,82L-IMPORT PAYROLL,D108,HJ,1119.05,,6483947.11
6100,4/30/2021,4/30/2021,43021,82L-IMPORT PAYROLL,D108,HJ,1119.05,,6485066.16
6100,4/30/2021,4/30/2021,43021,82L-IMPORT PAYROLL,D108,HJ,1119.05,,6486185.21
6100,4/30/2021,4/30/2021,43021,82L-IMPORT PAYROLL,D108,HJ,1119.05,,6487304.26
6100,4/30/2021,4/30/2021,43021,82L-IMPORT PAYROLL,D108,HJ,1119.05,,6488423.31
6100,4/30/2021,4/30/2021,43021,82L-IMPORT PAYROLL,D108,HJ,1119.05,,6489542.36
6100,4/30/2021,4/30/2021,43021,82L-IMPORT PAYROLL,D108,HJ,1119.05,,6490661.41
6100,4/30/2021,4/30/2021,43021,82L-IMPORT PAYROLL,D108,HJ,1119.05,,6491780.46
6100,4/30/2021,4/30/2021,43021,82L-IMPORT PAYROLL,D108,HJ,1119.05,,6492899.51
6100,4/30/2021,4/30/2021,43021,82L-IMPORT PAYROLL,D108,HJ,1119.05,,6494018.56
6100,4/30/2021,4/30/2021,43021,82L-IMPORT PAYROLL,D108,HJ,1119.05,,6495137.61
6100,4/30/2021,4/30/2021,43021,82L-IMPORT PAYROLL,D108,HJ,1119.05,,6496256.66
6100,4/30/2021,4/30/2021,43021,82L-IMPORT PAYROLL,D108,HJ,1119.05,,6497375.71
6100,4/30/2021,4/30/2021,43021,82L-IMPORT PAYROLL,D108,HJ,1119.05,,6498494.76
6100,4/30/2021,4/30/2021,43021,82L-IMPORT PAYROLL,D108,HJ,1119.05,,6499613.81
6100,4/30/2021,4/30/2021,43021,82L-IMPORT PAYROLL,D108,HJ,1119.05,,6500732.86
6100,4/30/2021,4/30/2021,43021,82L-IMPORT PAYROLL,D108,HJ,1119.05,,6501851.91
6100,4/30/2021,4/30/2021,43021,82L-IMPORT PAYROLL,D108,HJ,1119.05,,6502970.96
6100,4/30/2021,4/30/2021,43021,82L-IMPORT PAYROLL,D108,HJ,1119.05,,6504090.01
6100,4/30/2021,4/30/2021,43021,82L-IMPORT PAYROLL,D108,HJ,1119.05,,6505209.06
6100,4/30/2021,4/30/2021,43021,82L-IMPORT PAYROLL,D108,HJ,1119.05,,6506328.11
6100,4/30/2021,4/30/2021,43021,82L-IMPORT PAYROLL,D108,HJ,1119.05,,6507447.16
6100,4/30/2021,4/30/2021,43021,82L-IMPORT PAYROLL,D108,HJ,1119.05,,6508566.21
6100,4/30/2021,4/30/2021,43021,82L-IMPORT PAYROLL,D108,HJ,1119.05,,6509685.26
6100,4/30/2021,4/30/2021,43021,82L-IMPORT PAYROLL,D108,HJ,2250,,6511935.26
6100,4/30/2021,4/30/2021,43021,82L-IMPORT PAYROLL,D108,HJ,2250,,6514185.26
6100,4/30/2021,4/30/2021,43021,82L-IMPORT PAYROLL,D108,HJ,2250,,6516435.26
6100,4/30/2021,4/30/2021,43021,82L-IMPORT PAYROLL,D108,HJ,2291.67,,6518726.93
6100,4/30/2021,4/30/2021,43021,82L-IMPORT PAYROLL,D108,HJ,2291.67,,6521018.6
6100,4/30/2021,4/30/2021,43021,82L-IMPORT PAYROLL,D108,HJ,2291.67,,6523310.27
6100,4/30/2021,4/30/2021,43021,82L-IMPORT PAYROLL,D108,HJ,2437.5,,6525747.77
6100,4/30/2021,4/30/2021,43021,82L-IMPORT PAYROLL,D108,HJ,2486.25,,6528234.02
6100,4/30/2021,4/30/2021,43021,82L-IMPORT PAYROLL,D108,HJ,2500,,6530734.02
6100,4/30/2021,4/30/2021,43021,82L-IMPORT PAYROLL,D108,HJ,2500,,6533234.02
6100,4/30/2021,4/30/2021,43021,82L-IMPORT PAYROLL,D108,HJ,2550,,6535784.02
6100,4/30/2021,4/30/2021,43021,82L-IMPORT PAYROLL,D108,HJ,2833.33,,6538617.35
6100,4/30/2021,4/30/2021,43021,82L-IMPORT PAYROLL,D108,HJ,3034.5,,6541651.85
6100,4/30/2021,4/30/2021,43021,82L-IMPORT PAYROLL,D108,HJ,3291.67,,6544943.52
6100,4/30/2021,4/30/2021,43021,82L-IMPORT PAYROLL,D108,HJ,600,,6545543.52
6100,4/30/2021,4/30/2021,43021,82L-IMPORT PAYROLL,D108,HJ,1080,,6546623.52
6100,4/30/2021,4/30/2021,43021,82L-IMPORT PAYROLL,D108,HJ,2666.67,,6549290.19
6100,4/30/2021,4/30/2021,43021,82L-IMPORT PAYROLL,D108,HJ,2750,,6552040.19
6100,4/30/2021,4/30/2021,43021,82L-IMPORT PAYROLL,D108,HJ,2854.17,,6554894.36
6100,4/30/2021,4/30/2021,43021,82L-IMPORT PAYROLL,D108,HJ,3125,,6558019.36
6100,4/30/2021,4/30/2021,43021,82L-IMPORT PAYROLL,D108,HJ,4291.67,,6562311.03
6100,5/14/2021,5/14/2021,51421,82L-IMPORT PAYROLL,D108,HJ,90.66,,6562401.69
6100,5/14/2021,5/14/2021,51421,82L-IMPORT PAYROLL,D108,HJ,1047.62,,6563449.31
6100,5/14/2021,5/14/2021,51421,82L-IMPORT PAYROLL,D108,HJ,1047.62,,6564496.93
6100,5/14/2021,5/14/2021,51421,82L-IMPORT PAYROLL,D108,HJ,1047.62,,6565544.55
6100,5/14/2021,5/14/2021,51421,82L-IMPORT PAYROLL,D108,HJ,1047.62,,6566592.17
6100,5/14/2021,5/14/2021,51421,82L-IMPORT PAYROLL,D108,HJ,1047.62,,6567639.79
6100,5/14/2021,5/14/2021,51421,82L-IMPORT PAYROLL,D108,HJ,1047.62,,6568687.41
6100,5/14/2021,5/14/2021,51421,82L-IMPORT PAYROLL,D108,HJ,1047.62,,6569735.03
6100,5/14/2021,5/14/2021,51421,82L-IMPORT PAYROLL,D108,HJ,1047.62,,6570782.65
6100,5/14/2021,5/14/2021,51421,82L-IMPORT PAYROLL,D108,HJ,1047.62,,6571830.27
6100,5/14/2021,5/14/2021,51421,82L-IMPORT PAYROLL,D108,HJ,1047.62,,6572877.89
6100,5/14/2021,5/14/2021,51421,82L-IMPORT PAYROLL,D108,HJ,1047.62,,6573925.51
6100,5/14/2021,5/14/2021,51421,82L-IMPORT PAYROLL,D108,HJ,1047.62,,6574973.13
6100,5/14/2021,5/14/2021,51421,82L-IMPORT PAYROLL,D108,HJ,1047.62,,6576020.75
6100,5/14/2021,5/14/2021,51421,82L-IMPORT PAYROLL,D108,HJ,1047.62,,6577068.37
6100,5/14/2021,5/14/2021,51421,82L-IMPORT PAYROLL,D108,HJ,1047.62,,6578115.99
6100,5/14/2021,5/14/2021,51421,82L-IMPORT PAYROLL,D108,HJ,1047.62,,6579163.61
6100,5/14/2021,5/14/2021,51421,82L-IMPORT PAYROLL,D108,HJ,1047.62,,6580211.23
6100,5/14/2021,5/14/2021,51421,82L-IMPORT PAYROLL,D108,HJ,1047.62,,6581258.85
6100,5/14/2021,5/14/2021,51421,82L-IMPORT PAYROLL,D108,HJ,1047.62,,6582306.47
6100,5/14/2021,5/14/2021,51421,82L-IMPORT PAYROLL,D108,HJ,1047.62,,6583354.09
6100,5/14/2021,5/14/2021,51421,82L-IMPORT PAYROLL,D108,HJ,1047.62,,6584401.71
6100,5/14/2021,5/14/2021,51421,82L-IMPORT PAYROLL,D108,HJ,1047.62,,6585449.33
6100,5/14/2021,5/14/2021,51421,82L-IMPORT PAYROLL,D108,HJ,1047.62,,6586496.95
6100,5/14/2021,5/14/2021,51421,82L-IMPORT PAYROLL,D108,HJ,1047.62,,6587544.57
6100,5/14/2021,5/14/2021,51421,82L-IMPORT PAYROLL,D108,HJ,1047.62,,6588592.19
6100,5/14/2021,5/14/2021,51421,82L-IMPORT PAYROLL,D108,HJ,1047.62,,6589639.81
6100,5/14/2021,5/14/2021,51421,82L-IMPORT PAYROLL,D108,HJ,1047.62,,6590687.43
6100,5/14/2021,5/14/2021,51421,82L-IMPORT PAYROLL,D108,HJ,1047.62,,6591735.05
6100,5/14/2021,5/14/2021,51421,82L-IMPORT PAYROLL,D108,HJ,2000,,6593735.05
6100,5/14/2021,5/14/2021,51421,82L-IMPORT PAYROLL,D108,HJ,2041.67,,6595776.72
6100,5/14/2021,5/14/2021,51421,82L-IMPORT PAYROLL,D108,HJ,2083.33,,6597860.05
6100,5/14/2021,5/14/2021,51421,82L-IMPORT PAYROLL,D108,HJ,2083.33,,6599943.38
6100,5/14/2021,5/14/2021,51421,82L-IMPORT PAYROLL,D108,HJ,2500,,6602443.38
6100,5/14/2021,5/14/2021,51421,82L-IMPORT PAYROLL,D108,HJ,2541.67,,6604985.05
6100,5/14/2021,5/14/2021,51421,82L-IMPORT PAYROLL,D108,HJ,2541.67,,6607526.72
6100,5/14/2021,5/14/2021,51421,82L-IMPORT PAYROLL,D108,HJ,2541.67,,6610068.39
6100,5/14/2021,5/14/2021,51421,82L-IMPORT PAYROLL,D108,HJ,2833.33,,6612901.72
6100,5/14/2021,5/14/2021,51421,82L-IMPORT PAYROLL,D108,HJ,1437.06,,6614338.78
6100,5/14/2021,5/14/2021,51421,82L-IMPORT PAYROLL,D108,HJ,2270.83,,6616609.61
6100,5/14/2021,5/14/2021,51421,82L-IMPORT PAYROLL,D108,HJ,2291.67,,6618901.28
6100,5/14/2021,5/14/2021,51421,82L-IMPORT PAYROLL,D108,HJ,2291.67,,6621192.95
6100,5/14/2021,5/14/2021,51421,82L-IMPORT PAYROLL,D108,HJ,2329,,6623521.95
6100,5/14/2021,5/14/2021,51421,82L-IMPORT PAYROLL,D108,HJ,2416.67,,6625938.62
6100,5/14/2021,5/14/2021,51421,82L-IMPORT PAYROLL,D108,HJ,2431.94,,6628370.56
6100,5/14/2021,5/14/2021,51421,82L-IMPORT PAYROLL,D108,HJ,2458.33,,6630828.89
6100,5/14/2021,5/14/2021,51421,82L-IMPORT PAYROLL,D108,HJ,2465,,6633293.89
6100,5/14/2021,5/14/2021,51421,82L-IMPORT PAYROLL,D108,HJ,2500,,6635793.89
6100,5/14/2021,5/14/2021,51421,82L-IMPORT PAYROLL,D108,HJ,2500,,6638293.89
6100,5/14/2021,5/14/2021,51421,82L-IMPORT PAYROLL,D108,HJ,2562.51,,6640856.4
6100,5/14/2021,5/14/2021,51421,82L-IMPORT PAYROLL,D108,HJ,2635,,6643491.4
6100,5/14/2021,5/14/2021,51421,82L-IMPORT PAYROLL,D108,HJ,2653.02,,6646144.42
6100,5/14/2021,5/14/2021,51421,82L-IMPORT PAYROLL,D108,HJ,2666.67,,6648811.09
6100,5/14/2021,5/14/2021,51421,82L-IMPORT PAYROLL,D108,HJ,2708.33,,6651519.42
6100,5/14/2021,5/14/2021,51421,82L-IMPORT PAYROLL,D108,HJ,2708.34,,6654227.76
6100,5/14/2021,5/14/2021,51421,82L-IMPORT PAYROLL,D108,HJ,2720,,6656947.76
6100,5/14/2021,5/14/2021,51421,82L-IMPORT PAYROLL,D108,HJ,2817.75,,6659765.51
6100,5/14/2021,5/14/2021,51421,82L-IMPORT PAYROLL,D108,HJ,2886.52,,6662652.03
6100,5/14/2021,5/14/2021,51421,82L-IMPORT PAYROLL,D108,HJ,3208.46,,6665860.49
6100,5/14/2021,5/14/2021,51421,82L-IMPORT PAYROLL,D108,HJ,3445,,6669305.49
6100,5/14/2021,5/14/2021,51421,82L-IMPORT PAYROLL,D108,HJ,4666.67,,6673972.16
6100,5/14/2021,5/14/2021,51421,82L-IMPORT PAYROLL,D101,HJ,1.12,,6673973.28
6100,5/14/2021,5/14/2021,51421,82L-IMPORT PAYROLL,D101,HJ,16.66,,6673989.94
6100,5/14/2021,5/14/2021,51421,82L-IMPORT PAYROLL,D101,HJ,1250,,6675239.94
6100,5/14/2021,5/14/2021,51421,82L-IMPORT PAYROLL,D101,HJ,1250,,6676489.94
6100,5/14/2021,5/14/2021,51421,82L-IMPORT PAYROLL,D101,HJ,2166.67,,6678656.61
6100,5/14/2021,5/14/2021,51421,82L-IMPORT PAYROLL,D101,HJ,2291.67,,6680948.28
6100,5/14/2021,5/14/2021,51421,82L-IMPORT PAYROLL,D101,HJ,2461.88,,6683410.16
6100,5/14/2021,5/14/2021,51421,82L-IMPORT PAYROLL,D101,HJ,2708.33,,6686118.49
6100,5/14/2021,5/14/2021,51421,82L-IMPORT PAYROLL,D101,HJ,2708.33,,6688826.82
6100,5/14/2021,5/14/2021,51421,82L-IMPORT PAYROLL,D101,HJ,2833.33,,6691660.15
6100,5/14/2021,5/14/2021,51421,82L-IMPORT PAYROLL,D101,HJ,2833.33,,6694493.48
6100,5/14/2021,5/14/2021,51421,82L-IMPORT PAYROLL,D101,HJ,3437.5,,6697930.98
6100,5/14/2021,5/14/2021,51421,82L-IMPORT PAYROLL,D102,HJ,43.46,,6697974.44
6100,5/14/2021,5/14/2021,51421,82L-IMPORT PAYROLL,D102,HJ,453.38,,6698427.82
6100,5/14/2021,5/14/2021,51421,82L-IMPORT PAYROLL,D102,HJ,2041.75,,6700469.57
6100,5/14/2021,5/14/2021,51421,82L-IMPORT PAYROLL,D102,HJ,2166.75,,6702636.32
6100,5/14/2021,5/14/2021,51421,82L-IMPORT PAYROLL,D102,HJ,2916.67,,6705552.99
6100,5/14/2021,5/14/2021,51421,82L-IMPORT PAYROLL,D103,HJ,2208.33,,6707761.32
6100,5/14/2021,5/14/2021,51421,82L-IMPORT PAYROLL,D103,HJ,2291.67,,6710052.99
6100,5/14/2021,5/14/2021,51421,82L-IMPORT PAYROLL,D103,HJ,2416.67,,6712469.66
6100,5/14/2021,5/14/2021,51421,82L-IMPORT PAYROLL,D103,HJ,3541.67,,6716011.33
6100,5/14/2021,5/14/2021,51421,82L-IMPORT PAYROLL,D104,HJ,8.91,,6716020.24
6100,5/14/2021,5/14/2021,51421,82L-IMPORT PAYROLL,D104,HJ,1949.42,,6717969.66
6100,5/14/2021,5/14/2021,51421,82L-IMPORT PAYROLL,D104,HJ,2000,,6719969.66
6100,5/14/2021,5/14/2021,51421,82L-IMPORT PAYROLL,D104,HJ,2083.33,,6722052.99
6100,5/14/2021,5/14/2021,51421,82L-IMPORT PAYROLL,D104,HJ,2500,,6724552.99
6100,5/14/2021,5/14/2021,51421,82L-IMPORT PAYROLL,D104,HJ,2707.5,,6727260.49
6100,5/14/2021,5/14/2021,51421,82L-IMPORT PAYROLL,D104,HJ,3041.67,,6730302.16
6100,5/14/2021,5/14/2021,51421,82L-IMPORT PAYROLL,D104,HJ,3041.67,,6733343.83
6100,5/14/2021,5/14/2021,51421,82L-IMPORT PAYROLL,D104,HJ,3875,,6737218.83
6100,5/14/2021,5/14/2021,51421,82L-IMPORT PAYROLL,D105,HJ,1916.67,,6739135.5
6100,5/14/2021,5/14/2021,51421,82L-IMPORT PAYROLL,D105,HJ,1916.67,,6741052.17
6100,5/14/2021,5/14/2021,51421,82L-IMPORT PAYROLL,D105,HJ,2150,,6743202.17
6100,5/14/2021,5/14/2021,51421,82L-IMPORT PAYROLL,D105,HJ,2897.92,,6746100.09
6100,5/14/2021,5/14/2021,51421,82L-IMPORT PAYROLL,D105,HJ,3593.03,,6749693.12
6100,5/14/2021,5/14/2021,51421,82L-IMPORT PAYROLL,D107,HJ,774.24,,6750467.36
6100,5/14/2021,5/14/2021,51421,82L-IMPORT PAYROLL,D107,HJ,799.74,,6751267.1
6100,5/14/2021,5/14/2021,51421,82L-IMPORT PAYROLL,D107,HJ,1499.94,,6752767.04
6100,5/14/2021,5/14/2021,51421,82L-IMPORT PAYROLL,D107,HJ,2277.17,,6755044.21
6100,5/14/2021,5/14/2021,51421,82L-IMPORT PAYROLL,D107,HJ,2335.67,,6757379.88
6100,5/14/2021,5/14/2021,51421,82L-IMPORT PAYROLL,D107,HJ,3135.42,,6760515.3
6100,5/14/2021,5/14/2021,51421,82L-IMPORT PAYROLL,D107,HJ,3415.77,,6763931.07
6100,5/14/2021,5/14/2021,51421,82L-IMPORT PAYROLL,D107,HJ,5375,,6769306.07
6100,5/14/2021,5/14/2021,51421,82L-IMPORT PAYROLL,D107,HJ,6968.15,,6776274.22
6100,5/14/2021,5/14/2021,51421,82L-IMPORT PAYROLL,D109,HJ,100,,6776374.22
6100,5/14/2021,5/14/2021,51421,82L-IMPORT PAYROLL,D109,HJ,146.72,,6776520.94
6100,5/14/2021,5/14/2021,51421,82L-IMPORT PAYROLL,D109,HJ,150.66,,6776671.6
6100,5/14/2021,5/14/2021,51421,82L-IMPORT PAYROLL,D109,HJ,153.53,,6776825.13
6100,5/14/2021,5/14/2021,51421,82L-IMPORT PAYROLL,D109,HJ,153.53,,6776978.66
6100,5/14/2021,5/14/2021,51421,82L-IMPORT PAYROLL,D109,HJ,264,,6777242.66
6100,5/14/2021,5/14/2021,51421,82L-IMPORT PAYROLL,D109,HJ,439.65,,6777682.31
6100,5/14/2021,5/14/2021,51421,82L-IMPORT PAYROLL,D109,HJ,439.65,,6778121.96
6100,5/14/2021,5/14/2021,51421,82L-IMPORT PAYROLL,D109,HJ,541.66,,6778663.62
6100,5/14/2021,5/14/2021,51421,82L-IMPORT PAYROLL,D109,HJ,750,,6779413.62
6100,5/14/2021,5/14/2021,51421,82L-IMPORT PAYROLL,D109,HJ,1487.16,,6780900.78
6100,5/14/2021,5/14/2021,51421,82L-IMPORT PAYROLL,D109,HJ,1500,,6782400.78
6100,5/14/2021,5/14/2021,51421,82L-IMPORT PAYROLL,D109,HJ,1557.3,,6783958.08
6100,5/14/2021,5/14/2021,51421,82L-IMPORT PAYROLL,D109,HJ,3859.37,,6787817.45
6100,5/14/2021,5/14/2021,51421,82L-IMPORT PAYROLL,D109,HJ,3875,,6791692.45
6100,5/14/2021,5/14/2021,51421,82L-IMPORT PAYROLL,D109,HJ,4000,,6795692.45
6100,5/14/2021,5/14/2021,51421,82L-IMPORT PAYROLL,D109,HJ,4166.67,,6799859.12
6100,5/14/2021,5/14/2021,51421,82L-IMPORT PAYROLL,D109,HJ,4250,,6804109.12
6100,5/14/2021,5/14/2021,51421,82L-IMPORT PAYROLL,D109,HJ,4875.01,,6808984.13
6100,5/14/2021,5/14/2021,51421,82L-IMPORT PAYROLL,D109,HJ,5416.67,,6814400.8
6100,5/14/2021,5/14/2021,51421,82L-IMPORT PAYROLL,D109,HJ,5416.67,,6819817.47
6100,5/14/2021,5/14/2021,51421,82L-IMPORT PAYROLL,D109,HJ,5416.67,,6825234.14
6100,5/14/2021,5/14/2021,51421,82L-IMPORT PAYROLL,D111,HJ,1750,,6826984.14
6100,5/14/2021,5/14/2021,51421,82L-IMPORT PAYROLL,D111,HJ,2125,,6829109.14
6100,5/14/2021,5/14/2021,51421,82L-IMPORT PAYROLL,D111,HJ,2505.63,,6831614.77
6100,5/14/2021,5/14/2021,51421,82L-IMPORT PAYROLL,D111,HJ,2672.72,,6834287.49
6100,5/14/2021,5/14/2021,51421,82L-IMPORT PAYROLL,D111,HJ,3749.96,,6838037.45
6100,5/14/2021,5/14/2021,51421,82L-IMPORT PAYROLL,D112,HJ,3041.67,,6841079.12
6100,5/14/2021,5/14/2021,51421,82L-IMPORT PAYROLL,D108,HJ,0.39,,6841079.51
6100,5/14/2021,5/14/2021,51421,82L-IMPORT PAYROLL,D108,HJ,0.39,,6841079.9
6100,5/14/2021,5/14/2021,51421,82L-IMPORT PAYROLL,D108,HJ,0.97,,6841080.87
6100,5/14/2021,5/14/2021,51421,82L-IMPORT PAYROLL,D108,HJ,7.75,,6841088.62
6100,5/14/2021,5/14/2021,51421,82L-IMPORT PAYROLL,D108,HJ,455.76,,6841544.38
6100,5/14/2021,5/14/2021,51421,82L-IMPORT PAYROLL,D108,HJ,1119.05,,6842663.43
6100,5/14/2021,5/14/2021,51421,82L-IMPORT PAYROLL,D108,HJ,1119.05,,6843782.48
6100,5/14/2021,5/14/2021,51421,82L-IMPORT PAYROLL,D108,HJ,1119.05,,6844901.53
6100,5/14/2021,5/14/2021,51421,82L-IMPORT PAYROLL,D108,HJ,1119.05,,6846020.58
6100,5/14/2021,5/14/2021,51421,82L-IMPORT PAYROLL,D108,HJ,1119.05,,6847139.63
6100,5/14/2021,5/14/2021,51421,82L-IMPORT PAYROLL,D108,HJ,1119.05,,6848258.68
6100,5/14/2021,5/14/2021,51421,82L-IMPORT PAYROLL,D108,HJ,1119.05,,6849377.73
6100,5/14/2021,5/14/2021,51421,82L-IMPORT PAYROLL,D108,HJ,1119.05,,6850496.78
6100,5/14/2021,5/14/2021,51421,82L-IMPORT PAYROLL,D108,HJ,1119.05,,6851615.83
6100,5/14/2021,5/14/2021,51421,82L-IMPORT PAYROLL,D108,HJ,1119.05,,6852734.88
6100,5/14/2021,5/14/2021,51421,82L-IMPORT PAYROLL,D108,HJ,1119.05,,6853853.93
6100,5/14/2021,5/14/2021,51421,82L-IMPORT PAYROLL,D108,HJ,1119.05,,6854972.98
6100,5/14/2021,5/14/2021,51421,82L-IMPORT PAYROLL,D108,HJ,1119.05,,6856092.03
6100,5/14/2021,5/14/2021,51421,82L-IMPORT PAYROLL,D108,HJ,1119.05,,6857211.08
6100,5/14/2021,5/14/2021,51421,82L-IMPORT PAYROLL,D108,HJ,1119.05,,6858330.13
6100,5/14/2021,5/14/2021,51421,82L-IMPORT PAYROLL,D108,HJ,1119.05,,6859449.18
6100,5/14/2021,5/14/2021,51421,82L-IMPORT PAYROLL,D108,HJ,1119.05,,6860568.23
6100,5/14/2021,5/14/2021,51421,82L-IMPORT PAYROLL,D108,HJ,1119.05,,6861687.28
6100,5/14/2021,5/14/2021,51421,82L-IMPORT PAYROLL,D108,HJ,1119.05,,6862806.33
6100,5/14/2021,5/14/2021,51421,82L-IMPORT PAYROLL,D108,HJ,1119.05,,6863925.38
6100,5/14/2021,5/14/2021,51421,82L-IMPORT PAYROLL,D108,HJ,1119.05,,6865044.43
6100,5/14/2021,5/14/2021,51421,82L-IMPORT PAYROLL,D108,HJ,1119.05,,6866163.48
6100,5/14/2021,5/14/2021,51421,82L-IMPORT PAYROLL,D108,HJ,1119.05,,6867282.53
6100,5/14/2021,5/14/2021,51421,82L-IMPORT PAYROLL,D108,HJ,1119.05,,6868401.58
6100,5/14/2021,5/14/2021,51421,82L-IMPORT PAYROLL,D108,HJ,1119.05,,6869520.63
6100,5/14/2021,5/14/2021,51421,82L-IMPORT PAYROLL,D108,HJ,1119.05,,6870639.68
6100,5/14/2021,5/14/2021,51421,82L-IMPORT PAYROLL,D108,HJ,1119.05,,6871758.73
6100,5/14/2021,5/14/2021,51421,82L-IMPORT PAYROLL,D108,HJ,2250,,6874008.73
6100,5/14/2021,5/14/2021,51421,82L-IMPORT PAYROLL,D108,HJ,2250,,6876258.73
6100,5/14/2021,5/14/2021,51421,82L-IMPORT PAYROLL,D108,HJ,2250,,6878508.73
6100,5/14/2021,5/14/2021,51421,82L-IMPORT PAYROLL,D108,HJ,2291.67,,6880800.4
6100,5/14/2021,5/14/2021,51421,82L-IMPORT PAYROLL,D108,HJ,2291.67,,6883092.07
6100,5/14/2021,5/14/2021,51421,82L-IMPORT PAYROLL,D108,HJ,2291.67,,6885383.74
6100,5/14/2021,5/14/2021,51421,82L-IMPORT PAYROLL,D108,HJ,2437.5,,6887821.24
6100,5/14/2021,5/14/2021,51421,82L-IMPORT PAYROLL,D108,HJ,2486.25,,6890307.49
6100,5/14/2021,5/14/2021,51421,82L-IMPORT PAYROLL,D108,HJ,2500,,6892807.49
6100,5/14/2021,5/14/2021,51421,82L-IMPORT PAYROLL,D108,HJ,2500,,6895307.49
6100,5/14/2021,5/14/2021,51421,82L-IMPORT PAYROLL,D108,HJ,2550,,6897857.49
6100,5/14/2021,5/14/2021,51421,82L-IMPORT PAYROLL,D108,HJ,2833.33,,6900690.82
6100,5/14/2021,5/14/2021,51421,82L-IMPORT PAYROLL,D108,HJ,3034.5,,6903725.32
6100,5/14/2021,5/14/2021,51421,82L-IMPORT PAYROLL,D108,HJ,3291.67,,6907016.99
6100,5/14/2021,5/14/2021,51421,82L-IMPORT PAYROLL,D108,HJ,1290,,6908306.99
6100,5/14/2021,5/14/2021,51421,82L-IMPORT PAYROLL,D108,HJ,2666.67,,6910973.66
6100,5/14/2021,5/14/2021,51421,82L-IMPORT PAYROLL,D108,HJ,2750,,6913723.66
6100,5/14/2021,5/14/2021,51421,82L-IMPORT PAYROLL,D108,HJ,2854.17,,6916577.83
6100,5/14/2021,5/14/2021,51421,82L-IMPORT PAYROLL,D108,HJ,3125,,6919702.83
6100,5/14/2021,5/14/2021,51421,82L-IMPORT PAYROLL,D108,HJ,4291.67,,6923994.5
6100,5/28/2021,5/28/2021,52821,82L-IMPORT PAYROLL,D108,HJ,181.31,,6924175.81
6100,5/28/2021,5/28/2021,52821,82L-IMPORT PAYROLL,D108,HJ,483.5,,6924659.31
6100,5/28/2021,5/28/2021,52821,82L-IMPORT PAYROLL,D108,HJ,1047.62,,6925706.93
6100,5/28/2021,5/28/2021,52821,82L-IMPORT PAYROLL,D108,HJ,1047.62,,6926754.55
6100,5/28/2021,5/28/2021,52821,82L-IMPORT PAYROLL,D108,HJ,1047.62,,6927802.17
6100,5/28/2021,5/28/2021,52821,82L-IMPORT PAYROLL,D108,HJ,1047.62,,6928849.79
6100,5/28/2021,5/28/2021,52821,82L-IMPORT PAYROLL,D108,HJ,1047.62,,6929897.41
6100,5/28/2021,5/28/2021,52821,82L-IMPORT PAYROLL,D108,HJ,1047.62,,6930945.03
6100,5/28/2021,5/28/2021,52821,82L-IMPORT PAYROLL,D108,HJ,1047.62,,6931992.65
6100,5/28/2021,5/28/2021,52821,82L-IMPORT PAYROLL,D108,HJ,1047.62,,6933040.27
6100,5/28/2021,5/28/2021,52821,82L-IMPORT PAYROLL,D108,HJ,1047.62,,6934087.89
6100,5/28/2021,5/28/2021,52821,82L-IMPORT PAYROLL,D108,HJ,1047.62,,6935135.51
6100,5/28/2021,5/28/2021,52821,82L-IMPORT PAYROLL,D108,HJ,1047.62,,6936183.13
6100,5/28/2021,5/28/2021,52821,82L-IMPORT PAYROLL,D108,HJ,1047.62,,6937230.75
6100,5/28/2021,5/28/2021,52821,82L-IMPORT PAYROLL,D108,HJ,1047.62,,6938278.37
6100,5/28/2021,5/28/2021,52821,82L-IMPORT PAYROLL,D108,HJ,1047.62,,6939325.99
6100,5/28/2021,5/28/2021,52821,82L-IMPORT PAYROLL,D108,HJ,1047.62,,6940373.61
6100,5/28/2021,5/28/2021,52821,82L-IMPORT PAYROLL,D108,HJ,1047.62,,6941421.23
6100,5/28/2021,5/28/2021,52821,82L-IMPORT PAYROLL,D108,HJ,1047.62,,6942468.85
6100,5/28/2021,5/28/2021,52821,82L-IMPORT PAYROLL,D108,HJ,1047.62,,6943516.47
6100,5/28/2021,5/28/2021,52821,82L-IMPORT PAYROLL,D108,HJ,1047.62,,6944564.09
6100,5/28/2021,5/28/2021,52821,82L-IMPORT PAYROLL,D108,HJ,1047.62,,6945611.71
6100,5/28/2021,5/28/2021,52821,82L-IMPORT PAYROLL,D108,HJ,1047.62,,6946659.33
6100,5/28/2021,5/28/2021,52821,82L-IMPORT PAYROLL,D108,HJ,1047.62,,6947706.95
6100,5/28/2021,5/28/2021,52821,82L-IMPORT PAYROLL,D108,HJ,1047.62,,6948754.57
6100,5/28/2021,5/28/2021,52821,82L-IMPORT PAYROLL,D108,HJ,1047.62,,6949802.19
6100,5/28/2021,5/28/2021,52821,82L-IMPORT PAYROLL,D108,HJ,1047.62,,6950849.81
6100,5/28/2021,5/28/2021,52821,82L-IMPORT PAYROLL,D108,HJ,1047.62,,6951897.43
6100,5/28/2021,5/28/2021,52821,82L-IMPORT PAYROLL,D108,HJ,1047.62,,6952945.05
6100,5/28/2021,5/28/2021,52821,82L-IMPORT PAYROLL,D108,HJ,2000,,6954945.05
6100,5/28/2021,5/28/2021,52821,82L-IMPORT PAYROLL,D108,HJ,2041.67,,6956986.72
6100,5/28/2021,5/28/2021,52821,82L-IMPORT PAYROLL,D108,HJ,2083.33,,6959070.05
6100,5/28/2021,5/28/2021,52821,82L-IMPORT PAYROLL,D108,HJ,2083.33,,6961153.38
6100,5/28/2021,5/28/2021,52821,82L-IMPORT PAYROLL,D108,HJ,2500,,6963653.38
6100,5/28/2021,5/28/2021,52821,82L-IMPORT PAYROLL,D108,HJ,2541.67,,6966195.05
6100,5/28/2021,5/28/2021,52821,82L-IMPORT PAYROLL,D108,HJ,2541.67,,6968736.72
6100,5/28/2021,5/28/2021,52821,82L-IMPORT PAYROLL,D108,HJ,2541.67,,6971278.39
6100,5/28/2021,5/28/2021,52821,82L-IMPORT PAYROLL,D108,HJ,2833.33,,6974111.72
6100,5/28/2021,5/28/2021,52821,82L-IMPORT PAYROLL,D108,HJ,2270.83,,6976382.55
6100,5/28/2021,5/28/2021,52821,82L-IMPORT PAYROLL,D108,HJ,2291.67,,6978674.22
6100,5/28/2021,5/28/2021,52821,82L-IMPORT PAYROLL,D108,HJ,2291.67,,6980965.89
6100,5/28/2021,5/28/2021,52821,82L-IMPORT PAYROLL,D108,HJ,2329,,6983294.89
6100,5/28/2021,5/28/2021,52821,82L-IMPORT PAYROLL,D108,HJ,2416.67,,6985711.56
6100,5/28/2021,5/28/2021,52821,82L-IMPORT PAYROLL,D108,HJ,2431.94,,6988143.5
6100,5/28/2021,5/28/2021,52821,82L-IMPORT PAYROLL,D108,HJ,2458.33,,6990601.83
6100,5/28/2021,5/28/2021,52821,82L-IMPORT PAYROLL,D108,HJ,2465,,6993066.83
6100,5/28/2021,5/28/2021,52821,82L-IMPORT PAYROLL,D108,HJ,2500,,6995566.83
6100,5/28/2021,5/28/2021,52821,82L-IMPORT PAYROLL,D108,HJ,2500,,6998066.83
6100,5/28/2021,5/28/2021,52821,82L-IMPORT PAYROLL,D108,HJ,2505,,7000571.83
6100,5/28/2021,5/28/2021,52821,82L-IMPORT PAYROLL,D108,HJ,2635,,7003206.83
6100,5/28/2021,5/28/2021,52821,82L-IMPORT PAYROLL,D108,HJ,2653.02,,7005859.85
6100,5/28/2021,5/28/2021,52821,82L-IMPORT PAYROLL,D108,HJ,2666.67,,7008526.52
6100,5/28/2021,5/28/2021,52821,82L-IMPORT PAYROLL,D108,HJ,2708.33,,7011234.85
6100,5/28/2021,5/28/2021,52821,82L-IMPORT PAYROLL,D108,HJ,2708.34,,7013943.19
6100,5/28/2021,5/28/2021,52821,82L-IMPORT PAYROLL,D108,HJ,2720,,7016663.19
6100,5/28/2021,5/28/2021,52821,82L-IMPORT PAYROLL,D108,HJ,2817.75,,7019480.94
6100,5/28/2021,5/28/2021,52821,82L-IMPORT PAYROLL,D108,HJ,2886.52,,7022367.46
6100,5/28/2021,5/28/2021,52821,82L-IMPORT PAYROLL,D108,HJ,3208.46,,7025575.92
6100,5/28/2021,5/28/2021,52821,82L-IMPORT PAYROLL,D108,HJ,3416.67,,7028992.59
6100,5/28/2021,5/28/2021,52821,82L-IMPORT PAYROLL,D108,HJ,3833.34,,7032825.93
6100,5/28/2021,5/28/2021,52821,82L-IMPORT PAYROLL,D108,HJ,4666.67,,7037492.6
6100,5/28/2021,5/28/2021,52821,82L-IMPORT PAYROLL,D101,HJ,4.87,,7037497.47
6100,5/28/2021,5/28/2021,52821,82L-IMPORT PAYROLL,D101,HJ,1250,,7038747.47
6100,5/28/2021,5/28/2021,52821,82L-IMPORT PAYROLL,D101,HJ,1250,,7039997.47
6100,5/28/2021,5/28/2021,52821,82L-IMPORT PAYROLL,D101,HJ,2166.67,,7042164.14
6100,5/28/2021,5/28/2021,52821,82L-IMPORT PAYROLL,D101,HJ,2291.67,,7044455.81
6100,5/28/2021,5/28/2021,52821,82L-IMPORT PAYROLL,D101,HJ,2461.88,,7046917.69
6100,5/28/2021,5/28/2021,52821,82L-IMPORT PAYROLL,D101,HJ,2708.33,,7049626.02
6100,5/28/2021,5/28/2021,52821,82L-IMPORT PAYROLL,D101,HJ,2708.33,,7052334.35
6100,5/28/2021,5/28/2021,52821,82L-IMPORT PAYROLL,D101,HJ,2833.33,,7055167.68
6100,5/28/2021,5/28/2021,52821,82L-IMPORT PAYROLL,D101,HJ,2833.33,,7058001.01
6100,5/28/2021,5/28/2021,52821,82L-IMPORT PAYROLL,D101,HJ,3437.5,,7061438.51
6100,5/28/2021,5/28/2021,52821,82L-IMPORT PAYROLL,D102,HJ,2041.75,,7063480.26
6100,5/28/2021,5/28/2021,52821,82L-IMPORT PAYROLL,D102,HJ,2166.75,,7065647.01
6100,5/28/2021,5/28/2021,52821,82L-IMPORT PAYROLL,D102,HJ,2916.67,,7068563.68
6100,5/28/2021,5/28/2021,52821,82L-IMPORT PAYROLL,D103,HJ,2208.33,,7070772.01
6100,5/28/2021,5/28/2021,52821,82L-IMPORT PAYROLL,D103,HJ,2291.67,,7073063.68
6100,5/28/2021,5/28/2021,52821,82L-IMPORT PAYROLL,D103,HJ,2416.67,,7075480.35
6100,5/28/2021,5/28/2021,52821,82L-IMPORT PAYROLL,D103,HJ,3541.67,,7079022.02
6100,5/28/2021,5/28/2021,52821,82L-IMPORT PAYROLL,D104,HJ,50,,7079072.02
6100,5/28/2021,5/28/2021,52821,82L-IMPORT PAYROLL,D104,HJ,50,,7079122.02
6100,5/28/2021,5/28/2021,52821,82L-IMPORT PAYROLL,D104,HJ,50,,7079172.02
6100,5/28/2021,5/28/2021,52821,82L-IMPORT PAYROLL,D104,HJ,1958.33,,7081130.35
6100,5/28/2021,5/28/2021,52821,82L-IMPORT PAYROLL,D104,HJ,2000,,7083130.35
6100,5/28/2021,5/28/2021,52821,82L-IMPORT PAYROLL,D104,HJ,2083.33,,7085213.68
6100,5/28/2021,5/28/2021,52821,82L-IMPORT PAYROLL,D104,HJ,2500,,7087713.68
6100,5/28/2021,5/28/2021,52821,82L-IMPORT PAYROLL,D104,HJ,2707.5,,7090421.18
6100,5/28/2021,5/28/2021,52821,82L-IMPORT PAYROLL,D104,HJ,3041.67,,7093462.85
6100,5/28/2021,5/28/2021,52821,82L-IMPORT PAYROLL,D104,HJ,3041.67,,7096504.52
6100,5/28/2021,5/28/2021,52821,82L-IMPORT PAYROLL,D104,HJ,3353.25,,7099857.77
6100,5/28/2021,5/28/2021,52821,82L-IMPORT PAYROLL,D104,HJ,3875,,7103732.77
6100,5/28/2021,5/28/2021,52821,82L-IMPORT PAYROLL,D105,HJ,1916.67,,7105649.44
6100,5/28/2021,5/28/2021,52821,82L-IMPORT PAYROLL,D105,HJ,1916.67,,7107566.11
6100,5/28/2021,5/28/2021,52821,82L-IMPORT PAYROLL,D105,HJ,2150,,7109716.11
6100,5/28/2021,5/28/2021,52821,82L-IMPORT PAYROLL,D105,HJ,2897.92,,7112614.03
6100,5/28/2021,5/28/2021,52821,82L-IMPORT PAYROLL,D105,HJ,3593.03,,7116207.06
6100,5/28/2021,5/28/2021,52821,82L-IMPORT PAYROLL,D107,HJ,324.54,,7116531.6
6100,5/28/2021,5/28/2021,52821,82L-IMPORT PAYROLL,D107,HJ,696.81,,7117228.41
6100,5/28/2021,5/28/2021,52821,82L-IMPORT PAYROLL,D107,HJ,2049.45,,7119277.86
6100,5/28/2021,5/28/2021,52821,82L-IMPORT PAYROLL,D107,HJ,2076.84,,7121354.7
6100,5/28/2021,5/28/2021,52821,82L-IMPORT PAYROLL,D107,HJ,2821.87,,7124176.57
6100,5/28/2021,5/28/2021,52821,82L-IMPORT PAYROLL,D107,HJ,3250,,7127426.57
6100,5/28/2021,5/28/2021,52821,82L-IMPORT PAYROLL,D107,HJ,3448.96,,7130875.53
6100,5/28/2021,5/28/2021,52821,82L-IMPORT PAYROLL,D107,HJ,3643.49,,7134519.02
6100,5/28/2021,5/28/2021,52821,82L-IMPORT PAYROLL,D107,HJ,5375,,7139894.02
6100,5/28/2021,5/28/2021,52821,82L-IMPORT PAYROLL,D107,HJ,7045.58,,7146939.6
6100,5/28/2021,5/28/2021,52821,82L-IMPORT PAYROLL,D109,HJ,100,,7147039.6
6100,5/28/2021,5/28/2021,52821,82L-IMPORT PAYROLL,D109,HJ,146.72,,7147186.32
6100,5/28/2021,5/28/2021,52821,82L-IMPORT PAYROLL,D109,HJ,150.66,,7147336.98
6100,5/28/2021,5/28/2021,52821,82L-IMPORT PAYROLL,D109,HJ,153.53,,7147490.51
6100,5/28/2021,5/28/2021,52821,82L-IMPORT PAYROLL,D109,HJ,153.53,,7147644.04
6100,5/28/2021,5/28/2021,52821,82L-IMPORT PAYROLL,D109,HJ,439.65,,7148083.69
6100,5/28/2021,5/28/2021,52821,82L-IMPORT PAYROLL,D109,HJ,439.65,,7148523.34
6100,5/28/2021,5/28/2021,52821,82L-IMPORT PAYROLL,D109,HJ,1083.33,,7149606.67
6100,5/28/2021,5/28/2021,52821,82L-IMPORT PAYROLL,D109,HJ,1233.09,,7150839.76
6100,5/28/2021,5/28/2021,52821,82L-IMPORT PAYROLL,D109,HJ,1408.33,,7152248.09
6100,5/28/2021,5/28/2021,52821,82L-IMPORT PAYROLL,D109,HJ,1500,,7153748.09
6100,5/28/2021,5/28/2021,52821,82L-IMPORT PAYROLL,D109,HJ,2545.84,,7156293.93
6100,5/28/2021,5/28/2021,52821,82L-IMPORT PAYROLL,D109,HJ,2870.83,,7159164.76
6100,5/28/2021,5/28/2021,52821,82L-IMPORT PAYROLL,D109,HJ,3875,,7163039.76
6100,5/28/2021,5/28/2021,52821,82L-IMPORT PAYROLL,D109,HJ,4000,,7167039.76
6100,5/28/2021,5/28/2021,52821,82L-IMPORT PAYROLL,D109,HJ,4008.34,,7171048.1
6100,5/28/2021,5/28/2021,52821,82L-IMPORT PAYROLL,D109,HJ,4166.67,,7175214.77
6100,5/28/2021,5/28/2021,52821,82L-IMPORT PAYROLL,D109,HJ,4333.34,,7179548.11
6100,5/28/2021,5/28/2021,52821,82L-IMPORT PAYROLL,D109,HJ,5000,,7184548.11
6100,5/28/2021,5/28/2021,52821,82L-IMPORT PAYROLL,D109,HJ,5416.67,,7189964.78
6100,5/28/2021,5/28/2021,52821,82L-IMPORT PAYROLL,D109,HJ,5416.67,,7195381.45
6100,5/28/2021,5/28/2021,52821,82L-IMPORT PAYROLL,D111,HJ,50,,7195431.45
6100,5/28/2021,5/28/2021,52821,82L-IMPORT PAYROLL,D111,HJ,50,,7195481.45
6100,5/28/2021,5/28/2021,52821,82L-IMPORT PAYROLL,D111,HJ,50,,7195531.45
6100,5/28/2021,5/28/2021,52821,82L-IMPORT PAYROLL,D111,HJ,50,,7195581.45
6100,5/28/2021,5/28/2021,52821,82L-IMPORT PAYROLL,D111,HJ,50,,7195631.45
6100,5/28/2021,5/28/2021,52821,82L-IMPORT PAYROLL,D111,HJ,1750,,7197381.45
6100,5/28/2021,5/28/2021,52821,82L-IMPORT PAYROLL,D111,HJ,2125,,7199506.45
6100,5/28/2021,5/28/2021,52821,82L-IMPORT PAYROLL,D111,HJ,2505.63,,7202012.08
6100,5/28/2021,5/28/2021,52821,82L-IMPORT PAYROLL,D111,HJ,2672.72,,7204684.8
6100,5/28/2021,5/28/2021,52821,82L-IMPORT PAYROLL,D111,HJ,3749.96,,7208434.76
6100,5/28/2021,5/28/2021,52821,82L-IMPORT PAYROLL,D112,HJ,3041.67,,7211476.43
6100,5/28/2021,5/28/2021,52821,82L-IMPORT PAYROLL,D108,HJ,0.39,,7211476.82
6100,5/28/2021,5/28/2021,52821,82L-IMPORT PAYROLL,D108,HJ,0.39,,7211477.21
6100,5/28/2021,5/28/2021,52821,82L-IMPORT PAYROLL,D108,HJ,0.58,,7211477.79
6100,5/28/2021,5/28/2021,52821,82L-IMPORT PAYROLL,D108,HJ,300,,7211777.79
6100,5/28/2021,5/28/2021,52821,82L-IMPORT PAYROLL,D108,HJ,455.76,,7212233.55
6100,5/28/2021,5/28/2021,52821,82L-IMPORT PAYROLL,D108,HJ,1023.75,,7213257.3
6100,5/28/2021,5/28/2021,52821,82L-IMPORT PAYROLL,D108,HJ,1119.05,,7214376.35
6100,5/28/2021,5/28/2021,52821,82L-IMPORT PAYROLL,D108,HJ,1119.05,,7215495.4
6100,5/28/2021,5/28/2021,52821,82L-IMPORT PAYROLL,D108,HJ,1119.05,,7216614.45
6100,5/28/2021,5/28/2021,52821,82L-IMPORT PAYROLL,D108,HJ,1119.05,,7217733.5
6100,5/28/2021,5/28/2021,52821,82L-IMPORT PAYROLL,D108,HJ,1119.05,,7218852.55
6100,5/28/2021,5/28/2021,52821,82L-IMPORT PAYROLL,D108,HJ,1119.05,,7219971.6
6100,5/28/2021,5/28/2021,52821,82L-IMPORT PAYROLL,D108,HJ,1119.05,,7221090.65
6100,5/28/2021,5/28/2021,52821,82L-IMPORT PAYROLL,D108,HJ,1119.05,,7222209.7
6100,5/28/2021,5/28/2021,52821,82L-IMPORT PAYROLL,D108,HJ,1119.05,,7223328.75
6100,5/28/2021,5/28/2021,52821,82L-IMPORT PAYROLL,D108,HJ,1119.05,,7224447.8
6100,5/28/2021,5/28/2021,52821,82L-IMPORT PAYROLL,D108,HJ,1119.05,,7225566.85
6100,5/28/2021,5/28/2021,52821,82L-IMPORT PAYROLL,D108,HJ,1119.05,,7226685.9
6100,5/28/2021,5/28/2021,52821,82L-IMPORT PAYROLL,D108,HJ,1119.05,,7227804.95
6100,5/28/2021,5/28/2021,52821,82L-IMPORT PAYROLL,D108,HJ,1119.05,,7228924
6100,5/28/2021,5/28/2021,52821,82L-IMPORT PAYROLL,D108,HJ,1119.05,,7230043.05
6100,5/28/2021,5/28/2021,52821,82L-IMPORT PAYROLL,D108,HJ,1119.05,,7231162.1
6100,5/28/2021,5/28/2021,52821,82L-IMPORT PAYROLL,D108,HJ,1119.05,,7232281.15
6100,5/28/2021,5/28/2021,52821,82L-IMPORT PAYROLL,D108,HJ,1119.05,,7233400.2
6100,5/28/2021,5/28/2021,52821,82L-IMPORT PAYROLL,D108,HJ,1119.05,,7234519.25
6100,5/28/2021,5/28/2021,52821,82L-IMPORT PAYROLL,D108,HJ,1119.05,,7235638.3
6100,5/28/2021,5/28/2021,52821,82L-IMPORT PAYROLL,D108,HJ,1119.05,,7236757.35
6100,5/28/2021,5/28/2021,52821,82L-IMPORT PAYROLL,D108,HJ,1119.05,,7237876.4
6100,5/28/2021,5/28/2021,52821,82L-IMPORT PAYROLL,D108,HJ,1119.05,,7238995.45
6100,5/28/2021,5/28/2021,52821,82L-IMPORT PAYROLL,D108,HJ,1119.05,,7240114.5
6100,5/28/2021,5/28/2021,52821,82L-IMPORT PAYROLL,D108,HJ,1119.05,,7241233.55
6100,5/28/2021,5/28/2021,52821,82L-IMPORT PAYROLL,D108,HJ,1119.05,,7242352.6
6100,5/28/2021,5/28/2021,52821,82L-IMPORT PAYROLL,D108,HJ,1119.05,,7243471.65
6100,5/28/2021,5/28/2021,52821,82L-IMPORT PAYROLL,D108,HJ,2250,,7245721.65
6100,5/28/2021,5/28/2021,52821,82L-IMPORT PAYROLL,D108,HJ,2250,,7247971.65
6100,5/28/2021,5/28/2021,52821,82L-IMPORT PAYROLL,D108,HJ,2250,,7250221.65
6100,5/28/2021,5/28/2021,52821,82L-IMPORT PAYROLL,D108,HJ,2291.67,,7252513.32
6100,5/28/2021,5/28/2021,52821,82L-IMPORT PAYROLL,D108,HJ,2291.67,,7254804.99
6100,5/28/2021,5/28/2021,52821,82L-IMPORT PAYROLL,D108,HJ,2291.67,,7257096.66
6100,5/28/2021,5/28/2021,52821,82L-IMPORT PAYROLL,D108,HJ,2486.25,,7259582.91
6100,5/28/2021,5/28/2021,52821,82L-IMPORT PAYROLL,D108,HJ,2486.25,,7262069.16
6100,5/28/2021,5/28/2021,52821,82L-IMPORT PAYROLL,D108,HJ,2500,,7264569.16
6100,5/28/2021,5/28/2021,52821,82L-IMPORT PAYROLL,D108,HJ,2500,,7267069.16
6100,5/28/2021,5/28/2021,52821,82L-IMPORT PAYROLL,D108,HJ,2550,,7269619.16
6100,5/28/2021,5/28/2021,52821,82L-IMPORT PAYROLL,D108,HJ,2833.33,,7272452.49
6100,5/28/2021,5/28/2021,52821,82L-IMPORT PAYROLL,D108,HJ,3291.67,,7275744.16
6100,5/28/2021,5/28/2021,52821,82L-IMPORT PAYROLL,D108,HJ,3541.67,,7279285.83
6100,5/28/2021,5/28/2021,52821,82L-IMPORT PAYROLL,D108,HJ,375,,7279660.83
6100,5/28/2021,5/28/2021,52821,82L-IMPORT PAYROLL,D108,HJ,1290,,7280950.83
6100,5/28/2021,5/28/2021,52821,82L-IMPORT PAYROLL,D108,HJ,2666.67,,7283617.5
6100,5/28/2021,5/28/2021,52821,82L-IMPORT PAYROLL,D108,HJ,2750,,7286367.5
6100,5/28/2021,5/28/2021,52821,82L-IMPORT PAYROLL,D108,HJ,2854.17,,7289221.67
6100,5/28/2021,5/28/2021,52821,82L-IMPORT PAYROLL,D108,HJ,3125,,7292346.67
6100,5/28/2021,5/28/2021,52821,82L-IMPORT PAYROLL,D108,HJ,4291.67,,7296638.34
6100,5/31/2021,5/31/2021,JE-21-0222,ADJ to reclassify funding source,D104,HJ,,0.01,7296638.33
6100,5/31/2021,5/31/2021,JE-21-0222,ADJ to reclassify funding source,D104,HJ,0.01,,7296638.34
6100,5/31/2021,5/31/2021,JE-21-0222,ADJ to reclassify funding source,D107,HJ,,0.01,7296638.33
6100,5/31/2021,5/31/2021,JE-21-0222,ADJ to reclassify funding source,D107,HJ,0.01,,7296638.34
6100,5/31/2021,5/31/2021,JE-21-0222,ADJ to reclassify funding source,D107,HJ,,11438.97,7285199.37
6100,5/31/2021,5/31/2021,JE-21-0222,ADJ to reclassify funding source,D107,HJ,11438.97,,7296638.34
6100,5/31/2021,5/31/2021,JE-21-0222,ADJ to reclassify funding source,D109,HJ,,3692.62,7292945.72
6100,5/31/2021,5/31/2021,JE-21-0222,ADJ to reclassify funding source,D109,HJ,3692.62,,7296638.34
6100,5/31/2021,5/31/2021,JE-21-0222,ADJ to reclassify funding source,D109,HJ,,5108.08,7291530.26
6100,5/31/2021,5/31/2021,JE-21-0222,ADJ to reclassify funding source,D109,HJ,5108.08,,7296638.34
6100,6/1/2021,6/1/2021,1,To reclassify Expenses bet departments,D107,HJ,,46109.03,7250529.31
6100,6/1/2021,6/1/2021,1,To reclassify Expenses bet departments,D107,HJ,46109.03,,7296638.34
6100,6/15/2021,6/15/2021,61521,82L-IMPORT PAYROLL,D108,HJ,250,,7296888.34
6100,6/15/2021,6/15/2021,61521,82L-IMPORT PAYROLL,D108,HJ,250,,7297138.34
6100,6/15/2021,6/15/2021,61521,82L-IMPORT PAYROLL,D108,HJ,1047.62,,7298185.96
6100,6/15/2021,6/15/2021,61521,82L-IMPORT PAYROLL,D108,HJ,1047.62,,7299233.58
6100,6/15/2021,6/15/2021,61521,82L-IMPORT PAYROLL,D108,HJ,1047.62,,7300281.2
6100,6/15/2021,6/15/2021,61521,82L-IMPORT PAYROLL,D108,HJ,1047.62,,7301328.82
6100,6/15/2021,6/15/2021,61521,82L-IMPORT PAYROLL,D108,HJ,1047.62,,7302376.44
6100,6/15/2021,6/15/2021,61521,82L-IMPORT PAYROLL,D108,HJ,1047.62,,7303424.06
6100,6/15/2021,6/15/2021,61521,82L-IMPORT PAYROLL,D108,HJ,1047.62,,7304471.68
6100,6/15/2021,6/15/2021,61521,82L-IMPORT PAYROLL,D108,HJ,1047.62,,7305519.3
6100,6/15/2021,6/15/2021,61521,82L-IMPORT PAYROLL,D108,HJ,1047.62,,7306566.92
6100,6/15/2021,6/15/2021,61521,82L-IMPORT PAYROLL,D108,HJ,1047.62,,7307614.54
6100,6/15/2021,6/15/2021,61521,82L-IMPORT PAYROLL,D108,HJ,1047.62,,7308662.16
6100,6/15/2021,6/15/2021,61521,82L-IMPORT PAYROLL,D108,HJ,1047.62,,7309709.78
6100,6/15/2021,6/15/2021,61521,82L-IMPORT PAYROLL,D108,HJ,1047.62,,7310757.4
6100,6/15/2021,6/15/2021,61521,82L-IMPORT PAYROLL,D108,HJ,1047.62,,7311805.02
6100,6/15/2021,6/15/2021,61521,82L-IMPORT PAYROLL,D108,HJ,1047.62,,7312852.64
6100,6/15/2021,6/15/2021,61521,82L-IMPORT PAYROLL,D108,HJ,1047.62,,7313900.26
6100,6/15/2021,6/15/2021,61521,82L-IMPORT PAYROLL,D108,HJ,1047.62,,7314947.88
6100,6/15/2021,6/15/2021,61521,82L-IMPORT PAYROLL,D108,HJ,1047.62,,7315995.5
6100,6/15/2021,6/15/2021,61521,82L-IMPORT PAYROLL,D108,HJ,1047.62,,7317043.12
6100,6/15/2021,6/15/2021,61521,82L-IMPORT PAYROLL,D108,HJ,1047.62,,7318090.74
6100,6/15/2021,6/15/2021,61521,82L-IMPORT PAYROLL,D108,HJ,1047.62,,7319138.36
6100,6/15/2021,6/15/2021,61521,82L-IMPORT PAYROLL,D108,HJ,1047.62,,7320185.98
6100,6/15/2021,6/15/2021,61521,82L-IMPORT PAYROLL,D108,HJ,1047.62,,7321233.6
6100,6/15/2021,6/15/2021,61521,82L-IMPORT PAYROLL,D108,HJ,1047.62,,7322281.22
6100,6/15/2021,6/15/2021,61521,82L-IMPORT PAYROLL,D108,HJ,1047.62,,7323328.84
6100,6/15/2021,6/15/2021,61521,82L-IMPORT PAYROLL,D108,HJ,1047.62,,7324376.46
6100,6/15/2021,6/15/2021,61521,82L-IMPORT PAYROLL,D108,HJ,1223.62,,7325600.08
6100,6/15/2021,6/15/2021,61521,82L-IMPORT PAYROLL,D108,HJ,1876.85,,7327476.93
6100,6/15/2021,6/15/2021,61521,82L-IMPORT PAYROLL,D108,HJ,2000,,7329476.93
6100,6/15/2021,6/15/2021,61521,82L-IMPORT PAYROLL,D108,HJ,2041.67,,7331518.6
6100,6/15/2021,6/15/2021,61521,82L-IMPORT PAYROLL,D108,HJ,2083.33,,7333601.93
6100,6/15/2021,6/15/2021,61521,82L-IMPORT PAYROLL,D108,HJ,2083.33,,7335685.26
6100,6/15/2021,6/15/2021,61521,82L-IMPORT PAYROLL,D108,HJ,2500,,7338185.26
6100,6/15/2021,6/15/2021,61521,82L-IMPORT PAYROLL,D108,HJ,2541.67,,7340726.93
6100,6/15/2021,6/15/2021,61521,82L-IMPORT PAYROLL,D108,HJ,2541.67,,7343268.6
6100,6/15/2021,6/15/2021,61521,82L-IMPORT PAYROLL,D108,HJ,2833.33,,7346101.93
6100,6/15/2021,6/15/2021,61521,82L-IMPORT PAYROLL,D108,HJ,237.92,,7346339.85
6100,6/15/2021,6/15/2021,61521,82L-IMPORT PAYROLL,D108,HJ,248.86,,7346588.71
6100,6/15/2021,6/15/2021,61521,82L-IMPORT PAYROLL,D108,HJ,2270.83,,7348859.54
6100,6/15/2021,6/15/2021,61521,82L-IMPORT PAYROLL,D108,HJ,2291.67,,7351151.21
6100,6/15/2021,6/15/2021,61521,82L-IMPORT PAYROLL,D108,HJ,2291.67,,7353442.88
6100,6/15/2021,6/15/2021,61521,82L-IMPORT PAYROLL,D108,HJ,2329,,7355771.88
6100,6/15/2021,6/15/2021,61521,82L-IMPORT PAYROLL,D108,HJ,2416.67,,7358188.55
6100,6/15/2021,6/15/2021,61521,82L-IMPORT PAYROLL,D108,HJ,2431.94,,7360620.49
6100,6/15/2021,6/15/2021,61521,82L-IMPORT PAYROLL,D108,HJ,2458.33,,7363078.82
6100,6/15/2021,6/15/2021,61521,82L-IMPORT PAYROLL,D108,HJ,2465,,7365543.82
6100,6/15/2021,6/15/2021,61521,82L-IMPORT PAYROLL,D108,HJ,2500,,7368043.82
6100,6/15/2021,6/15/2021,61521,82L-IMPORT PAYROLL,D108,HJ,2500,,7370543.82
6100,6/15/2021,6/15/2021,61521,82L-IMPORT PAYROLL,D108,HJ,2579.83,,7373123.65
6100,6/15/2021,6/15/2021,61521,82L-IMPORT PAYROLL,D108,HJ,2635,,7375758.65
6100,6/15/2021,6/15/2021,61521,82L-IMPORT PAYROLL,D108,HJ,2653.02,,7378411.67
6100,6/15/2021,6/15/2021,61521,82L-IMPORT PAYROLL,D108,HJ,2666.67,,7381078.34
6100,6/15/2021,6/15/2021,61521,82L-IMPORT PAYROLL,D108,HJ,2708.33,,7383786.67
6100,6/15/2021,6/15/2021,61521,82L-IMPORT PAYROLL,D108,HJ,2708.34,,7386495.01
6100,6/15/2021,6/15/2021,61521,82L-IMPORT PAYROLL,D108,HJ,2720,,7389215.01
6100,6/15/2021,6/15/2021,61521,82L-IMPORT PAYROLL,D108,HJ,2959.6,,7392174.61
6100,6/15/2021,6/15/2021,61521,82L-IMPORT PAYROLL,D108,HJ,3208.34,,7395382.95
6100,6/15/2021,6/15/2021,61521,82L-IMPORT PAYROLL,D108,HJ,3333.33,,7398716.28
6100,6/15/2021,6/15/2021,61521,82L-IMPORT PAYROLL,D108,HJ,3750,,7402466.28
6100,6/15/2021,6/15/2021,61521,82L-IMPORT PAYROLL,D108,HJ,3833.34,,7406299.62
6100,6/15/2021,6/15/2021,61521,82L-IMPORT PAYROLL,D108,HJ,4666.67,,7410966.29
6100,6/15/2021,6/15/2021,61521,82L-IMPORT PAYROLL,D101,HJ,1250,,7412216.29
6100,6/15/2021,6/15/2021,61521,82L-IMPORT PAYROLL,D101,HJ,1250,,7413466.29
6100,6/15/2021,6/15/2021,61521,82L-IMPORT PAYROLL,D101,HJ,2166.67,,7415632.96
6100,6/15/2021,6/15/2021,61521,82L-IMPORT PAYROLL,D101,HJ,2291.67,,7417924.63
6100,6/15/2021,6/15/2021,61521,82L-IMPORT PAYROLL,D101,HJ,2461.88,,7420386.51
6100,6/15/2021,6/15/2021,61521,82L-IMPORT PAYROLL,D101,HJ,2708.33,,7423094.84
6100,6/15/2021,6/15/2021,61521,82L-IMPORT PAYROLL,D101,HJ,2708.33,,7425803.17
6100,6/15/2021,6/15/2021,61521,82L-IMPORT PAYROLL,D101,HJ,2833.33,,7428636.5
6100,6/15/2021,6/15/2021,61521,82L-IMPORT PAYROLL,D101,HJ,2833.33,,7431469.83
6100,6/15/2021,6/15/2021,61521,82L-IMPORT PAYROLL,D101,HJ,3437.5,,7434907.33
6100,6/15/2021,6/15/2021,61521,82L-IMPORT PAYROLL,D102,HJ,31.8,,7434939.13
6100,6/15/2021,6/15/2021,61521,82L-IMPORT PAYROLL,D102,HJ,2041.75,,7436980.88
6100,6/15/2021,6/15/2021,61521,82L-IMPORT PAYROLL,D102,HJ,2166.75,,7439147.63
6100,6/15/2021,6/15/2021,61521,82L-IMPORT PAYROLL,D102,HJ,2916.67,,7442064.3
6100,6/15/2021,6/15/2021,61521,82L-IMPORT PAYROLL,D103,HJ,2208.33,,7444272.63
6100,6/15/2021,6/15/2021,61521,82L-IMPORT PAYROLL,D103,HJ,2291.67,,7446564.3
6100,6/15/2021,6/15/2021,61521,82L-IMPORT PAYROLL,D103,HJ,2416.67,,7448980.97
6100,6/15/2021,6/15/2021,61521,82L-IMPORT PAYROLL,D103,HJ,3125,,7452105.97
6100,6/15/2021,6/15/2021,61521,82L-IMPORT PAYROLL,D103,HJ,3541.67,,7455647.64
6100,6/15/2021,6/15/2021,61521,82L-IMPORT PAYROLL,D104,HJ,1958.33,,7457605.97
6100,6/15/2021,6/15/2021,61521,82L-IMPORT PAYROLL,D104,HJ,2000,,7459605.97
6100,6/15/2021,6/15/2021,61521,82L-IMPORT PAYROLL,D104,HJ,2083.33,,7461689.3
6100,6/15/2021,6/15/2021,61521,82L-IMPORT PAYROLL,D104,HJ,2500,,7464189.3
6100,6/15/2021,6/15/2021,61521,82L-IMPORT PAYROLL,D104,HJ,2707.5,,7466896.8
6100,6/15/2021,6/15/2021,61521,82L-IMPORT PAYROLL,D104,HJ,3041.67,,7469938.47
6100,6/15/2021,6/15/2021,61521,82L-IMPORT PAYROLL,D104,HJ,3041.67,,7472980.14
6100,6/15/2021,6/15/2021,61521,82L-IMPORT PAYROLL,D104,HJ,3875,,7476855.14
6100,6/15/2021,6/15/2021,61521,82L-IMPORT PAYROLL,D105,HJ,1916.67,,7478771.81
6100,6/15/2021,6/15/2021,61521,82L-IMPORT PAYROLL,D105,HJ,1916.67,,7480688.48
6100,6/15/2021,6/15/2021,61521,82L-IMPORT PAYROLL,D105,HJ,2150,,7482838.48
6100,6/15/2021,6/15/2021,61521,82L-IMPORT PAYROLL,D105,HJ,2897.92,,7485736.4
6100,6/15/2021,6/15/2021,61521,82L-IMPORT PAYROLL,D105,HJ,3593.03,,7489329.43
6100,6/15/2021,6/15/2021,61521,82L-IMPORT PAYROLL,D107,HJ,696.82,,7490026.25
6100,6/15/2021,6/15/2021,61521,82L-IMPORT PAYROLL,D107,HJ,901.5,,7490927.75
6100,6/15/2021,6/15/2021,61521,82L-IMPORT PAYROLL,D107,HJ,1024.73,,7491952.48
6100,6/15/2021,6/15/2021,61521,82L-IMPORT PAYROLL,D107,HJ,3135.41,,7495087.89
6100,6/15/2021,6/15/2021,61521,82L-IMPORT PAYROLL,D107,HJ,3135.42,,7498223.31
6100,6/15/2021,6/15/2021,61521,82L-IMPORT PAYROLL,D107,HJ,3250,,7501473.31
6100,6/15/2021,6/15/2021,61521,82L-IMPORT PAYROLL,D107,HJ,3416.67,,7504889.98
6100,6/15/2021,6/15/2021,61521,82L-IMPORT PAYROLL,D107,HJ,4668.21,,7509558.19
6100,6/15/2021,6/15/2021,61521,82L-IMPORT PAYROLL,D107,HJ,5375,,7514933.19
6100,6/15/2021,6/15/2021,61521,82L-IMPORT PAYROLL,D107,HJ,7045.57,,7521978.76
6100,6/15/2021,6/15/2021,61521,82L-IMPORT PAYROLL,D109,HJ,100,,7522078.76
6100,6/15/2021,6/15/2021,61521,82L-IMPORT PAYROLL,D109,HJ,146.72,,7522225.48
6100,6/15/2021,6/15/2021,61521,82L-IMPORT PAYROLL,D109,HJ,150.66,,7522376.14
6100,6/15/2021,6/15/2021,61521,82L-IMPORT PAYROLL,D109,HJ,153.53,,7522529.67
6100,6/15/2021,6/15/2021,61521,82L-IMPORT PAYROLL,D109,HJ,153.53,,7522683.2
6100,6/15/2021,6/15/2021,61521,82L-IMPORT PAYROLL,D109,HJ,422.31,,7523105.51
6100,6/15/2021,6/15/2021,61521,82L-IMPORT PAYROLL,D109,HJ,439.65,,7523545.16
6100,6/15/2021,6/15/2021,61521,82L-IMPORT PAYROLL,D109,HJ,439.65,,7523984.81
6100,6/15/2021,6/15/2021,61521,82L-IMPORT PAYROLL,D109,HJ,487.5,,7524472.31
6100,6/15/2021,6/15/2021,61521,82L-IMPORT PAYROLL,D109,HJ,844.53,,7525316.84
6100,6/15/2021,6/15/2021,61521,82L-IMPORT PAYROLL,D109,HJ,975,,7526291.84
6100,6/15/2021,6/15/2021,61521,82L-IMPORT PAYROLL,D109,HJ,975,,7527266.84
6100,6/15/2021,6/15/2021,61521,82L-IMPORT PAYROLL,D109,HJ,1875,,7529141.84
6100,6/15/2021,6/15/2021,61521,82L-IMPORT PAYROLL,D109,HJ,1875,,7531016.84
6100,6/15/2021,6/15/2021,61521,82L-IMPORT PAYROLL,D109,HJ,3875,,7534891.84
6100,6/15/2021,6/15/2021,61521,82L-IMPORT PAYROLL,D109,HJ,4000,,7538891.84
6100,6/15/2021,6/15/2021,61521,82L-IMPORT PAYROLL,D109,HJ,4166.67,,7543058.51
6100,6/15/2021,6/15/2021,61521,82L-IMPORT PAYROLL,D109,HJ,4441.67,,7547500.18
6100,6/15/2021,6/15/2021,61521,82L-IMPORT PAYROLL,D109,HJ,4441.67,,7551941.85
6100,6/15/2021,6/15/2021,61521,82L-IMPORT PAYROLL,D109,HJ,4929.17,,7556871.02
6100,6/15/2021,6/15/2021,61521,82L-IMPORT PAYROLL,D109,HJ,5000,,7561871.02
6100,6/15/2021,6/15/2021,61521,82L-IMPORT PAYROLL,D109,HJ,5416.67,,7567287.69
6100,6/15/2021,6/15/2021,61521,82L-IMPORT PAYROLL,D109,HJ,5416.67,,7572704.36
6100,6/15/2021,6/15/2021,61521,82L-IMPORT PAYROLL,D111,HJ,1750,,7574454.36
6100,6/15/2021,6/15/2021,61521,82L-IMPORT PAYROLL,D111,HJ,2125,,7576579.36
6100,6/15/2021,6/15/2021,61521,82L-IMPORT PAYROLL,D111,HJ,2505.63,,7579084.99
6100,6/15/2021,6/15/2021,61521,82L-IMPORT PAYROLL,D111,HJ,2672.72,,7581757.71
6100,6/15/2021,6/15/2021,61521,82L-IMPORT PAYROLL,D111,HJ,3749.96,,7585507.67
6100,6/15/2021,6/15/2021,61521,82L-IMPORT PAYROLL,D112,HJ,3041.67,,7588549.34
6100,6/15/2021,6/15/2021,61521,82L-IMPORT PAYROLL,D108,HJ,0.39,,7588549.73
6100,6/15/2021,6/15/2021,61521,82L-IMPORT PAYROLL,D108,HJ,0.58,,7588550.31
6100,6/15/2021,6/15/2021,61521,82L-IMPORT PAYROLL,D108,HJ,2.32,,7588552.63
6100,6/15/2021,6/15/2021,61521,82L-IMPORT PAYROLL,D108,HJ,250,,7588802.63
6100,6/15/2021,6/15/2021,61521,82L-IMPORT PAYROLL,D108,HJ,250,,7589052.63
6100,6/15/2021,6/15/2021,61521,82L-IMPORT PAYROLL,D108,HJ,250,,7589302.63
6100,6/15/2021,6/15/2021,61521,82L-IMPORT PAYROLL,D108,HJ,250,,7589552.63
6100,6/15/2021,6/15/2021,61521,82L-IMPORT PAYROLL,D108,HJ,250,,7589802.63
6100,6/15/2021,6/15/2021,61521,82L-IMPORT PAYROLL,D108,HJ,250,,7590052.63
6100,6/15/2021,6/15/2021,61521,82L-IMPORT PAYROLL,D108,HJ,250,,7590302.63
6100,6/15/2021,6/15/2021,61521,82L-IMPORT PAYROLL,D108,HJ,250,,7590552.63
6100,6/15/2021,6/15/2021,61521,82L-IMPORT PAYROLL,D108,HJ,250,,7590802.63
6100,6/15/2021,6/15/2021,61521,82L-IMPORT PAYROLL,D108,HJ,250,,7591052.63
6100,6/15/2021,6/15/2021,61521,82L-IMPORT PAYROLL,D108,HJ,250,,7591302.63
6100,6/15/2021,6/15/2021,61521,82L-IMPORT PAYROLL,D108,HJ,250,,7591552.63
6100,6/15/2021,6/15/2021,61521,82L-IMPORT PAYROLL,D108,HJ,250,,7591802.63
6100,6/15/2021,6/15/2021,61521,82L-IMPORT PAYROLL,D108,HJ,250,,7592052.63
6100,6/15/2021,6/15/2021,61521,82L-IMPORT PAYROLL,D108,HJ,250,,7592302.63
6100,6/15/2021,6/15/2021,61521,82L-IMPORT PAYROLL,D108,HJ,250,,7592552.63
6100,6/15/2021,6/15/2021,61521,82L-IMPORT PAYROLL,D108,HJ,250,,7592802.63
6100,6/15/2021,6/15/2021,61521,82L-IMPORT PAYROLL,D108,HJ,250,,7593052.63
6100,6/15/2021,6/15/2021,61521,82L-IMPORT PAYROLL,D108,HJ,250,,7593302.63
6100,6/15/2021,6/15/2021,61521,82L-IMPORT PAYROLL,D108,HJ,250,,7593552.63
6100,6/15/2021,6/15/2021,61521,82L-IMPORT PAYROLL,D108,HJ,455.76,,7594008.39
6100,6/15/2021,6/15/2021,61521,82L-IMPORT PAYROLL,D108,HJ,1119.05,,7595127.44
6100,6/15/2021,6/15/2021,61521,82L-IMPORT PAYROLL,D108,HJ,1119.05,,7596246.49
6100,6/15/2021,6/15/2021,61521,82L-IMPORT PAYROLL,D108,HJ,1119.05,,7597365.54
6100,6/15/2021,6/15/2021,61521,82L-IMPORT PAYROLL,D108,HJ,1119.05,,7598484.59
6100,6/15/2021,6/15/2021,61521,82L-IMPORT PAYROLL,D108,HJ,1119.05,,7599603.64
6100,6/15/2021,6/15/2021,61521,82L-IMPORT PAYROLL,D108,HJ,1119.05,,7600722.69
6100,6/15/2021,6/15/2021,61521,82L-IMPORT PAYROLL,D108,HJ,1119.05,,7601841.74
6100,6/15/2021,6/15/2021,61521,82L-IMPORT PAYROLL,D108,HJ,1119.05,,7602960.79
6100,6/15/2021,6/15/2021,61521,82L-IMPORT PAYROLL,D108,HJ,1119.05,,7604079.84
6100,6/15/2021,6/15/2021,61521,82L-IMPORT PAYROLL,D108,HJ,1119.05,,7605198.89
6100,6/15/2021,6/15/2021,61521,82L-IMPORT PAYROLL,D108,HJ,1119.05,,7606317.94
6100,6/15/2021,6/15/2021,61521,82L-IMPORT PAYROLL,D108,HJ,1119.05,,7607436.99
6100,6/15/2021,6/15/2021,61521,82L-IMPORT PAYROLL,D108,HJ,1119.05,,7608556.04
6100,6/15/2021,6/15/2021,61521,82L-IMPORT PAYROLL,D108,HJ,1119.05,,7609675.09
6100,6/15/2021,6/15/2021,61521,82L-IMPORT PAYROLL,D108,HJ,1119.05,,7610794.14
6100,6/15/2021,6/15/2021,61521,82L-IMPORT PAYROLL,D108,HJ,1119.05,,7611913.19
6100,6/15/2021,6/15/2021,61521,82L-IMPORT PAYROLL,D108,HJ,1119.05,,7613032.24
6100,6/15/2021,6/15/2021,61521,82L-IMPORT PAYROLL,D108,HJ,1119.05,,7614151.29
6100,6/15/2021,6/15/2021,61521,82L-IMPORT PAYROLL,D108,HJ,1119.05,,7615270.34
6100,6/15/2021,6/15/2021,61521,82L-IMPORT PAYROLL,D108,HJ,1119.05,,7616389.39
6100,6/15/2021,6/15/2021,61521,82L-IMPORT PAYROLL,D108,HJ,1119.05,,7617508.44
6100,6/15/2021,6/15/2021,61521,82L-IMPORT PAYROLL,D108,HJ,1119.05,,7618627.49
6100,6/15/2021,6/15/2021,61521,82L-IMPORT PAYROLL,D108,HJ,1119.05,,7619746.54
6100,6/15/2021,6/15/2021,61521,82L-IMPORT PAYROLL,D108,HJ,1119.05,,7620865.59
6100,6/15/2021,6/15/2021,61521,82L-IMPORT PAYROLL,D108,HJ,1119.05,,7621984.64
6100,6/15/2021,6/15/2021,61521,82L-IMPORT PAYROLL,D108,HJ,1119.05,,7623103.69
6100,6/15/2021,6/15/2021,61521,82L-IMPORT PAYROLL,D108,HJ,1119.05,,7624222.74
6100,6/15/2021,6/15/2021,61521,82L-IMPORT PAYROLL,D108,HJ,2250,,7626472.74
6100,6/15/2021,6/15/2021,61521,82L-IMPORT PAYROLL,D108,HJ,2250,,7628722.74
6100,6/15/2021,6/15/2021,61521,82L-IMPORT PAYROLL,D108,HJ,2250,,7630972.74
6100,6/15/2021,6/15/2021,61521,82L-IMPORT PAYROLL,D108,HJ,2291.67,,7633264.41
6100,6/15/2021,6/15/2021,61521,82L-IMPORT PAYROLL,D108,HJ,2291.67,,7635556.08
6100,6/15/2021,6/15/2021,61521,82L-IMPORT PAYROLL,D108,HJ,2291.67,,7637847.75
6100,6/15/2021,6/15/2021,61521,82L-IMPORT PAYROLL,D108,HJ,2486.25,,7640334
6100,6/15/2021,6/15/2021,61521,82L-IMPORT PAYROLL,D108,HJ,2486.25,,7642820.25
6100,6/15/2021,6/15/2021,61521,82L-IMPORT PAYROLL,D108,HJ,2500,,7645320.25
6100,6/15/2021,6/15/2021,61521,82L-IMPORT PAYROLL,D108,HJ,2500,,7647820.25
6100,6/15/2021,6/15/2021,61521,82L-IMPORT PAYROLL,D108,HJ,2550,,7650370.25
6100,6/15/2021,6/15/2021,61521,82L-IMPORT PAYROLL,D108,HJ,2833.33,,7653203.58
6100,6/15/2021,6/15/2021,61521,82L-IMPORT PAYROLL,D108,HJ,3291.67,,7656495.25
6100,6/15/2021,6/15/2021,61521,82L-IMPORT PAYROLL,D108,HJ,3541.67,,7660036.92
6100,6/15/2021,6/15/2021,61521,82L-IMPORT PAYROLL,D108,HJ,795,,7660831.92
6100,6/15/2021,6/15/2021,61521,82L-IMPORT PAYROLL,D108,HJ,2666.67,,7663498.59
6100,6/15/2021,6/15/2021,61521,82L-IMPORT PAYROLL,D108,HJ,2750,,7666248.59
6100,6/15/2021,6/15/2021,61521,82L-IMPORT PAYROLL,D108,HJ,2854.17,,7669102.76
6100,6/15/2021,6/15/2021,61521,82L-IMPORT PAYROLL,D108,HJ,2886.52,,7671989.28
6100,6/15/2021,6/15/2021,61521,82L-IMPORT PAYROLL,D108,HJ,3125,,7675114.28
6100,6/15/2021,6/15/2021,61521,82L-IMPORT PAYROLL,D108,HJ,4291.67,,7679405.95
6100,6/30/2021,6/30/2021,63021,82L-IMPORT PAYROLL,D108,HJ,250,,7679655.95
6100,6/30/2021,6/30/2021,63021,82L-IMPORT PAYROLL,D108,HJ,1047.62,,7680703.57
6100,6/30/2021,6/30/2021,63021,82L-IMPORT PAYROLL,D108,HJ,2000,,7682703.57
6100,6/30/2021,6/30/2021,63021,82L-IMPORT PAYROLL,D108,HJ,2000,,7684703.57
6100,6/30/2021,6/30/2021,63021,82L-IMPORT PAYROLL,D108,HJ,2041.67,,7686745.24
6100,6/30/2021,6/30/2021,63021,82L-IMPORT PAYROLL,D108,HJ,2083.33,,7688828.57
6100,6/30/2021,6/30/2021,63021,82L-IMPORT PAYROLL,D108,HJ,2083.33,,7690911.9
6100,6/30/2021,6/30/2021,63021,82L-IMPORT PAYROLL,D108,HJ,2500,,7693411.9
6100,6/30/2021,6/30/2021,63021,82L-IMPORT PAYROLL,D108,HJ,2541.67,,7695953.57
6100,6/30/2021,6/30/2021,63021,82L-IMPORT PAYROLL,D108,HJ,2541.67,,7698495.24
6100,6/30/2021,6/30/2021,63021,82L-IMPORT PAYROLL,D108,HJ,2833.33,,7701328.57
6100,6/30/2021,6/30/2021,63021,82L-IMPORT PAYROLL,D108,HJ,1080,,7702408.57
6100,6/30/2021,6/30/2021,63021,82L-IMPORT PAYROLL,D108,HJ,2270.83,,7704679.4
6100,6/30/2021,6/30/2021,63021,82L-IMPORT PAYROLL,D108,HJ,2291.67,,7706971.07
6100,6/30/2021,6/30/2021,63021,82L-IMPORT PAYROLL,D108,HJ,2291.67,,7709262.74
6100,6/30/2021,6/30/2021,63021,82L-IMPORT PAYROLL,D108,HJ,2329,,7711591.74
6100,6/30/2021,6/30/2021,63021,82L-IMPORT PAYROLL,D108,HJ,2416.67,,7714008.41
6100,6/30/2021,6/30/2021,63021,82L-IMPORT PAYROLL,D108,HJ,2431.94,,7716440.35
6100,6/30/2021,6/30/2021,63021,82L-IMPORT PAYROLL,D108,HJ,2458.33,,7718898.68
6100,6/30/2021,6/30/2021,63021,82L-IMPORT PAYROLL,D108,HJ,2465,,7721363.68
6100,6/30/2021,6/30/2021,63021,82L-IMPORT PAYROLL,D108,HJ,2500,,7723863.68
6100,6/30/2021,6/30/2021,63021,82L-IMPORT PAYROLL,D108,HJ,2500,,7726363.68
6100,6/30/2021,6/30/2021,63021,82L-IMPORT PAYROLL,D108,HJ,2635,,7728998.68
6100,6/30/2021,6/30/2021,63021,82L-IMPORT PAYROLL,D108,HJ,2653.02,,7731651.7
6100,6/30/2021,6/30/2021,63021,82L-IMPORT PAYROLL,D108,HJ,2689.37,,7734341.07
6100,6/30/2021,6/30/2021,63021,82L-IMPORT PAYROLL,D108,HJ,2708.33,,7737049.4
6100,6/30/2021,6/30/2021,63021,82L-IMPORT PAYROLL,D108,HJ,2708.34,,7739757.74
6100,6/30/2021,6/30/2021,63021,82L-IMPORT PAYROLL,D108,HJ,2720,,7742477.74
6100,6/30/2021,6/30/2021,63021,82L-IMPORT PAYROLL,D108,HJ,2817.75,,7745295.49
6100,6/30/2021,6/30/2021,63021,82L-IMPORT PAYROLL,D108,HJ,3208.34,,7748503.83
6100,6/30/2021,6/30/2021,63021,82L-IMPORT PAYROLL,D108,HJ,3208.46,,7751712.29
6100,6/30/2021,6/30/2021,63021,82L-IMPORT PAYROLL,D108,HJ,3333.33,,7755045.62
6100,6/30/2021,6/30/2021,63021,82L-IMPORT PAYROLL,D108,HJ,3750,,7758795.62
6100,6/30/2021,6/30/2021,63021,82L-IMPORT PAYROLL,D108,HJ,3833.34,,7762628.96
6100,6/30/2021,6/30/2021,63021,82L-IMPORT PAYROLL,D108,HJ,4666.67,,7767295.63
6100,6/30/2021,6/30/2021,63021,82L-IMPORT PAYROLL,D101,HJ,1.87,,7767297.5
6100,6/30/2021,6/30/2021,63021,82L-IMPORT PAYROLL,D101,HJ,1250,,7768547.5
6100,6/30/2021,6/30/2021,63021,82L-IMPORT PAYROLL,D101,HJ,1250,,7769797.5
6100,6/30/2021,6/30/2021,63021,82L-IMPORT PAYROLL,D101,HJ,2166.67,,7771964.17
6100,6/30/2021,6/30/2021,63021,82L-IMPORT PAYROLL,D101,HJ,2291.67,,7774255.84
6100,6/30/2021,6/30/2021,63021,82L-IMPORT PAYROLL,D101,HJ,2461.88,,7776717.72
6100,6/30/2021,6/30/2021,63021,82L-IMPORT PAYROLL,D101,HJ,2708.33,,7779426.05
6100,6/30/2021,6/30/2021,63021,82L-IMPORT PAYROLL,D101,HJ,2708.33,,7782134.38
6100,6/30/2021,6/30/2021,63021,82L-IMPORT PAYROLL,D101,HJ,2833.33,,7784967.71
6100,6/30/2021,6/30/2021,63021,82L-IMPORT PAYROLL,D101,HJ,2833.33,,7787801.04
6100,6/30/2021,6/30/2021,63021,82L-IMPORT PAYROLL,D101,HJ,3437.5,,7791238.54
6100,6/30/2021,6/30/2021,63021,82L-IMPORT PAYROLL,D102,HJ,4.88,,7791243.42
6100,6/30/2021,6/30/2021,63021,82L-IMPORT PAYROLL,D102,HJ,13.43,,7791256.85
6100,6/30/2021,6/30/2021,63021,82L-IMPORT PAYROLL,D102,HJ,2041.75,,7793298.6
6100,6/30/2021,6/30/2021,63021,82L-IMPORT PAYROLL,D102,HJ,2166.75,,7795465.35
6100,6/30/2021,6/30/2021,63021,82L-IMPORT PAYROLL,D102,HJ,2916.67,,7798382.02
6100,6/30/2021,6/30/2021,63021,82L-IMPORT PAYROLL,D103,HJ,576.9,,7798958.92
6100,6/30/2021,6/30/2021,63021,82L-IMPORT PAYROLL,D103,HJ,2208.33,,7801167.25
6100,6/30/2021,6/30/2021,63021,82L-IMPORT PAYROLL,D103,HJ,2291.67,,7803458.92
6100,6/30/2021,6/30/2021,63021,82L-IMPORT PAYROLL,D103,HJ,2416.67,,7805875.59
6100,6/30/2021,6/30/2021,63021,82L-IMPORT PAYROLL,D103,HJ,3541.67,,7809417.26
6100,6/30/2021,6/30/2021,63021,82L-IMPORT PAYROLL,D104,HJ,50,,7809467.26
6100,6/30/2021,6/30/2021,63021,82L-IMPORT PAYROLL,D104,HJ,50,,7809517.26
6100,6/30/2021,6/30/2021,63021,82L-IMPORT PAYROLL,D104,HJ,50,,7809567.26
6100,6/30/2021,6/30/2021,63021,82L-IMPORT PAYROLL,D104,HJ,1341.3,,7810908.56
6100,6/30/2021,6/30/2021,63021,82L-IMPORT PAYROLL,D104,HJ,1958.33,,7812866.89
6100,6/30/2021,6/30/2021,63021,82L-IMPORT PAYROLL,D104,HJ,2000,,7814866.89
6100,6/30/2021,6/30/2021,63021,82L-IMPORT PAYROLL,D104,HJ,2083.33,,7816950.22
6100,6/30/2021,6/30/2021,63021,82L-IMPORT PAYROLL,D104,HJ,2500,,7819450.22
6100,6/30/2021,6/30/2021,63021,82L-IMPORT PAYROLL,D104,HJ,2707.5,,7822157.72
6100,6/30/2021,6/30/2021,63021,82L-IMPORT PAYROLL,D104,HJ,3041.67,,7825199.39
6100,6/30/2021,6/30/2021,63021,82L-IMPORT PAYROLL,D104,HJ,3041.67,,7828241.06
6100,6/30/2021,6/30/2021,63021,82L-IMPORT PAYROLL,D104,HJ,3875,,7832116.06
6100,6/30/2021,6/30/2021,63021,82L-IMPORT PAYROLL,D105,HJ,1916.67,,7834032.73
6100,6/30/2021,6/30/2021,63021,82L-IMPORT PAYROLL,D105,HJ,1916.67,,7835949.4
6100,6/30/2021,6/30/2021,63021,82L-IMPORT PAYROLL,D105,HJ,2150,,7838099.4
6100,6/30/2021,6/30/2021,63021,82L-IMPORT PAYROLL,D105,HJ,2897.92,,7840997.32
6100,6/30/2021,6/30/2021,63021,82L-IMPORT PAYROLL,D105,HJ,3593.03,,7844590.35
6100,6/30/2021,6/30/2021,63021,82L-IMPORT PAYROLL,D107,HJ,696.82,,7845287.17
6100,6/30/2021,6/30/2021,63021,82L-IMPORT PAYROLL,D107,HJ,761.51,,7846048.68
6100,6/30/2021,6/30/2021,63021,82L-IMPORT PAYROLL,D107,HJ,2561.82,,7848610.5
6100,6/30/2021,6/30/2021,63021,82L-IMPORT PAYROLL,D107,HJ,2821.87,,7851432.37
6100,6/30/2021,6/30/2021,63021,82L-IMPORT PAYROLL,D107,HJ,3125,,7854557.37
6100,6/30/2021,6/30/2021,63021,82L-IMPORT PAYROLL,D107,HJ,3131.12,,7857688.49
6100,6/30/2021,6/30/2021,63021,82L-IMPORT PAYROLL,D107,HJ,3250,,7860938.49
6100,6/30/2021,6/30/2021,63021,82L-IMPORT PAYROLL,D107,HJ,3416.67,,7864355.16
6100,6/30/2021,6/30/2021,63021,82L-IMPORT PAYROLL,D107,HJ,3448.96,,7867804.12
6100,6/30/2021,6/30/2021,63021,82L-IMPORT PAYROLL,D107,HJ,5375,,7873179.12
6100,6/30/2021,6/30/2021,63021,82L-IMPORT PAYROLL,D107,HJ,7045.57,,7880224.69
6100,6/30/2021,6/30/2021,63021,82L-IMPORT PAYROLL,D109,HJ,100,,7880324.69
6100,6/30/2021,6/30/2021,63021,82L-IMPORT PAYROLL,D109,HJ,146.72,,7880471.41
6100,6/30/2021,6/30/2021,63021,82L-IMPORT PAYROLL,D109,HJ,150.66,,7880622.07
6100,6/30/2021,6/30/2021,63021,82L-IMPORT PAYROLL,D109,HJ,153.53,,7880775.6
6100,6/30/2021,6/30/2021,63021,82L-IMPORT PAYROLL,D109,HJ,153.53,,7880929.13
6100,6/30/2021,6/30/2021,63021,82L-IMPORT PAYROLL,D109,HJ,439.65,,7881368.78
6100,6/30/2021,6/30/2021,63021,82L-IMPORT PAYROLL,D109,HJ,439.65,,7881808.43
6100,6/30/2021,6/30/2021,63021,82L-IMPORT PAYROLL,D109,HJ,1191.67,,7883000.1
6100,6/30/2021,6/30/2021,63021,82L-IMPORT PAYROLL,D109,HJ,1254.96,,7884255.06
6100,6/30/2021,6/30/2021,63021,82L-IMPORT PAYROLL,D109,HJ,1875,,7886130.06
6100,6/30/2021,6/30/2021,63021,82L-IMPORT PAYROLL,D109,HJ,3875,,7890005.06
6100,6/30/2021,6/30/2021,63021,82L-IMPORT PAYROLL,D109,HJ,4000,,7894005.06
6100,6/30/2021,6/30/2021,63021,82L-IMPORT PAYROLL,D109,HJ,4166.67,,7898171.73
6100,6/30/2021,6/30/2021,63021,82L-IMPORT PAYROLL,D109,HJ,4225,,7902396.73
6100,6/30/2021,6/30/2021,63021,82L-IMPORT PAYROLL,D109,HJ,5000,,7907396.73
6100,6/30/2021,6/30/2021,63021,82L-IMPORT PAYROLL,D109,HJ,5416.67,,7912813.4
6100,6/30/2021,6/30/2021,63021,82L-IMPORT PAYROLL,D109,HJ,5416.67,,7918230.07
6100,6/30/2021,6/30/2021,63021,82L-IMPORT PAYROLL,D109,HJ,5416.67,,7923646.74
6100,6/30/2021,6/30/2021,63021,82L-IMPORT PAYROLL,D109,HJ,5416.67,,7929063.41
6100,6/30/2021,6/30/2021,63021,82L-IMPORT PAYROLL,D109,HJ,20000,,7949063.41
6100,6/30/2021,6/30/2021,63021,82L-IMPORT PAYROLL,D109,HJ,20000,,7969063.41
6100,6/30/2021,6/30/2021,63021,82L-IMPORT PAYROLL,D109,HJ,20000,,7989063.41
6100,6/30/2021,6/30/2021,63021,82L-IMPORT PAYROLL,D109,HJ,20000,,8009063.41
6100,6/30/2021,6/30/2021,63021,82L-IMPORT PAYROLL,D111,HJ,50,,8009113.41
6100,6/30/2021,6/30/2021,63021,82L-IMPORT PAYROLL,D111,HJ,50,,8009163.41
6100,6/30/2021,6/30/2021,63021,82L-IMPORT PAYROLL,D111,HJ,50,,8009213.41
6100,6/30/2021,6/30/2021,63021,82L-IMPORT PAYROLL,D111,HJ,50,,8009263.41
6100,6/30/2021,6/30/2021,63021,82L-IMPORT PAYROLL,D111,HJ,50,,8009313.41
6100,6/30/2021,6/30/2021,63021,82L-IMPORT PAYROLL,D111,HJ,1750,,8011063.41
6100,6/30/2021,6/30/2021,63021,82L-IMPORT PAYROLL,D111,HJ,2125,,8013188.41
6100,6/30/2021,6/30/2021,63021,82L-IMPORT PAYROLL,D111,HJ,2505.63,,8015694.04
6100,6/30/2021,6/30/2021,63021,82L-IMPORT PAYROLL,D111,HJ,2672.72,,8018366.76
6100,6/30/2021,6/30/2021,63021,82L-IMPORT PAYROLL,D111,HJ,3749.96,,8022116.72
6100,6/30/2021,6/30/2021,63021,82L-IMPORT PAYROLL,D112,HJ,3041.67,,8025158.39
6100,6/30/2021,6/30/2021,63021,82L-IMPORT PAYROLL,D108,HJ,2.32,,8025160.71
6100,6/30/2021,6/30/2021,63021,82L-IMPORT PAYROLL,D108,HJ,455.76,,8025616.47
6100,6/30/2021,6/30/2021,63021,82L-IMPORT PAYROLL,D108,HJ,1119.05,,8026735.52
6100,6/30/2021,6/30/2021,63021,82L-IMPORT PAYROLL,D108,HJ,1119.05,,8027854.57
6100,6/30/2021,6/30/2021,63021,82L-IMPORT PAYROLL,D108,HJ,1119.05,,8028973.62
6100,6/30/2021,6/30/2021,63021,82L-IMPORT PAYROLL,D108,HJ,1119.05,,8030092.67
6100,6/30/2021,6/30/2021,63021,82L-IMPORT PAYROLL,D108,HJ,1119.05,,8031211.72
6100,6/30/2021,6/30/2021,63021,82L-IMPORT PAYROLL,D108,HJ,1119.05,,8032330.77
6100,6/30/2021,6/30/2021,63021,82L-IMPORT PAYROLL,D108,HJ,1119.05,,8033449.82
6100,6/30/2021,6/30/2021,63021,82L-IMPORT PAYROLL,D108,HJ,1119.05,,8034568.87
6100,6/30/2021,6/30/2021,63021,82L-IMPORT PAYROLL,D108,HJ,1119.05,,8035687.92
6100,6/30/2021,6/30/2021,63021,82L-IMPORT PAYROLL,D108,HJ,1119.05,,8036806.97
6100,6/30/2021,6/30/2021,63021,82L-IMPORT PAYROLL,D108,HJ,1119.05,,8037926.02
6100,6/30/2021,6/30/2021,63021,82L-IMPORT PAYROLL,D108,HJ,1119.05,,8039045.07
6100,6/30/2021,6/30/2021,63021,82L-IMPORT PAYROLL,D108,HJ,1119.05,,8040164.12
6100,6/30/2021,6/30/2021,63021,82L-IMPORT PAYROLL,D108,HJ,1119.05,,8041283.17
6100,6/30/2021,6/30/2021,63021,82L-IMPORT PAYROLL,D108,HJ,1119.05,,8042402.22
6100,6/30/2021,6/30/2021,63021,82L-IMPORT PAYROLL,D108,HJ,1119.05,,8043521.27
6100,6/30/2021,6/30/2021,63021,82L-IMPORT PAYROLL,D108,HJ,1119.05,,8044640.32
6100,6/30/2021,6/30/2021,63021,82L-IMPORT PAYROLL,D108,HJ,1119.05,,8045759.37
6100,6/30/2021,6/30/2021,63021,82L-IMPORT PAYROLL,D108,HJ,1119.05,,8046878.42
6100,6/30/2021,6/30/2021,63021,82L-IMPORT PAYROLL,D108,HJ,1119.05,,8047997.47
6100,6/30/2021,6/30/2021,63021,82L-IMPORT PAYROLL,D108,HJ,1119.05,,8049116.52
6100,6/30/2021,6/30/2021,63021,82L-IMPORT PAYROLL,D108,HJ,1119.05,,8050235.57
6100,6/30/2021,6/30/2021,63021,82L-IMPORT PAYROLL,D108,HJ,1119.05,,8051354.62
6100,6/30/2021,6/30/2021,63021,82L-IMPORT PAYROLL,D108,HJ,1119.05,,8052473.67
6100,6/30/2021,6/30/2021,63021,82L-IMPORT PAYROLL,D108,HJ,1119.05,,8053592.72
6100,6/30/2021,6/30/2021,63021,82L-IMPORT PAYROLL,D108,HJ,1119.05,,8054711.77
6100,6/30/2021,6/30/2021,63021,82L-IMPORT PAYROLL,D108,HJ,1119.05,,8055830.82
6100,6/30/2021,6/30/2021,63021,82L-IMPORT PAYROLL,D108,HJ,1846.08,,8057676.9
6100,6/30/2021,6/30/2021,63021,82L-IMPORT PAYROLL,D108,HJ,2250,,8059926.9
6100,6/30/2021,6/30/2021,63021,82L-IMPORT PAYROLL,D108,HJ,2250,,8062176.9
6100,6/30/2021,6/30/2021,63021,82L-IMPORT PAYROLL,D108,HJ,2250,,8064426.9
6100,6/30/2021,6/30/2021,63021,82L-IMPORT PAYROLL,D108,HJ,2291.67,,8066718.57
6100,6/30/2021,6/30/2021,63021,82L-IMPORT PAYROLL,D108,HJ,2291.67,,8069010.24
6100,6/30/2021,6/30/2021,63021,82L-IMPORT PAYROLL,D108,HJ,2291.67,,8071301.91
6100,6/30/2021,6/30/2021,63021,82L-IMPORT PAYROLL,D108,HJ,2486.25,,8073788.16
6100,6/30/2021,6/30/2021,63021,82L-IMPORT PAYROLL,D108,HJ,2486.25,,8076274.41
6100,6/30/2021,6/30/2021,63021,82L-IMPORT PAYROLL,D108,HJ,2500,,8078774.41
6100,6/30/2021,6/30/2021,63021,82L-IMPORT PAYROLL,D108,HJ,2550,,8081324.41
6100,6/30/2021,6/30/2021,63021,82L-IMPORT PAYROLL,D108,HJ,2833.33,,8084157.74
6100,6/30/2021,6/30/2021,63021,82L-IMPORT PAYROLL,D108,HJ,3218.85,,8087376.59
6100,6/30/2021,6/30/2021,63021,82L-IMPORT PAYROLL,D108,HJ,3291.67,,8090668.26
6100,6/30/2021,6/30/2021,63021,82L-IMPORT PAYROLL,D108,HJ,795,,8091463.26
6100,6/30/2021,6/30/2021,63021,82L-IMPORT PAYROLL,D108,HJ,2666.67,,8094129.93
6100,6/30/2021,6/30/2021,63021,82L-IMPORT PAYROLL,D108,HJ,2750,,8096879.93
6100,6/30/2021,6/30/2021,63021,82L-IMPORT PAYROLL,D108,HJ,2854.17,,8099734.1
6100,6/30/2021,6/30/2021,63021,82L-IMPORT PAYROLL,D108,HJ,2886.52,,8102620.62
6100,6/30/2021,6/30/2021,63021,82L-IMPORT PAYROLL,D108,HJ,3125,,8105745.62
6100,6/30/2021,6/30/2021,63021,82L-IMPORT PAYROLL,D108,HJ,4291.67,,8110037.29
6100,6/30/2021,6/30/2021,Entry to correct the expense amount base,Entry to correct the expense amount based on ADP Timecard using SPARKMATH as activity code,D999,GJ,,2167,8107870.29
6100,6/30/2021,6/30/2021,Entry to correct the expense amount base,Entry to correct the expense amount based on ADP Timecard using SPARKMATH as activity code,D999,GJ,2167,,8110037.29
6100,6/30/2021,6/30/2021,JE-21-0256,Adjust Funding Sources,D107,HJ,,142.26,8109895.03
6100,6/30/2021,6/30/2021,JE-21-0256,Adjust Funding Sources,D107,HJ,142.26,,8110037.29
6100,6/30/2021,6/30/2021,JE-21-0256,Adjust Funding Sources,D107,HJ,,188.21,8109849.08
6100,6/30/2021,6/30/2021,JE-21-0256,Adjust Funding Sources,D107,HJ,188.21,,8110037.29
6100,6/30/2021,6/30/2021,JE-21-0256,Adjust Funding Sources,D107,HJ,,1191.47,8108845.82
6100,6/30/2021,6/30/2021,JE-21-0256,Adjust Funding Sources,D107,HJ,1191.47,,8110037.29
6100,6/30/2021,6/30/2021,JE-21-0256,Adjust Funding Sources,D107,HJ,,2306.71,8107730.58
6100,6/30/2021,6/30/2021,JE-21-0256,Adjust Funding Sources,D107,HJ,2306.71,,8110037.29
6100,6/30/2021,6/30/2021,JE-21-0256,Adjust Funding Sources,D107,HJ,,2372.17,8107665.12
6100,6/30/2021,6/30/2021,JE-21-0256,Adjust Funding Sources,D107,HJ,2372.17,,8110037.29
6100,6/30/2021,6/30/2021,JE-21-0256,Adjust Funding Sources,D107,HJ,,17118.9,8092918.39
6100,6/30/2021,6/30/2021,JE-21-0256,Adjust Funding Sources,D107,HJ,17118.9,,8110037.29
6100,6/30/2021,6/30/2021,JE-21-0256,Adjust Funding Sources,D107,HJ,,43707.46,8066329.83
6100,6/30/2021,6/30/2021,JE-21-0256,Adjust Funding Sources,D107,HJ,43707.46,,8110037.29
6100, Totals for 6100 - Staff Salaries,,,,,,9489820.01,1379782.72,8110037.29
6150,6150 - PR Taxes for Staff Salaries (Balance forward As of 07/01/2020) ,,,,,,,,0
6150,7/15/2020,7/15/2020,71520,82L-IMPORT PAYROLL-KOPSHEVER MELISSA,D108,HJ,31.23,,31.23
6150,7/15/2020,7/15/2020,71520,82L-IMPORT PAYROLL-KOPSHEVER MELISSA,D108,HJ,58.15,,89.38
6150,7/15/2020,7/15/2020,71520,82L-IMPORT PAYROLL-KOPSHEVER MELISSA,D108,HJ,133.53,,222.91
6150,7/15/2020,7/15/2020,71520,82L-PRPD-071520 -Import Payroll (GENERL)-AKLESTAD ISABEL,D108,HJ,27.97,,250.88
6150,7/15/2020,7/15/2020,71520,82L-PRPD-071520 -Import Payroll (GENERL)-AKLESTAD ISABEL,D108,HJ,119.61,,370.49
6150,7/15/2020,7/15/2020,71520,82L-PRPD-071520 -Import Payroll (GENERL)-ALLEN KIMBERLY MARY,D108,HJ,31.49,,401.98
6150,7/15/2020,7/15/2020,71520,82L-PRPD-071520 -Import Payroll (GENERL)-ALLEN KIMBERLY MARY,D108,HJ,134.65,,536.63
6150,7/15/2020,7/15/2020,71520,82L-PRPD-071520 -Import Payroll (GENERL)-ANTHONY BETTY S,D108,HJ,41.85,,578.48
6150,7/15/2020,7/15/2020,71520,82L-PRPD-071520 -Import Payroll (GENERL)-ANTHONY BETTY S,D108,HJ,178.96,,757.44
6150,7/15/2020,7/15/2020,71520,82L-PRPD-071520 -Import Payroll (GENERL)-AUSTIN PERCY,D108,HJ,36.34,,793.78
6150,7/15/2020,7/15/2020,71520,82L-PRPD-071520 -Import Payroll (GENERL)-AUSTIN PERCY,D108,HJ,155.39,,949.17
6150,7/15/2020,7/15/2020,71520,82L-PRPD-071520 -Import Payroll (GENERL)-BALASUBRAMANIAN SHARANYA,D108,HJ,38.67,,987.84
6150,7/15/2020,7/15/2020,71520,82L-PRPD-071520 -Import Payroll (GENERL)-BALASUBRAMANIAN SHARANYA,D108,HJ,93.33,,1081.17
6150,7/15/2020,7/15/2020,71520,82L-PRPD-071520 -Import Payroll (GENERL)-BALASUBRAMANIAN SHARANYA,D108,HJ,165.33,,1246.5
6150,7/15/2020,7/15/2020,71520,82L-PRPD-071520 -Import Payroll (GENERL)-BANDA STEPHANY,D108,HJ,16.84,,1263.34
6150,7/15/2020,7/15/2020,71520,82L-PRPD-071520 -Import Payroll (GENERL)-BANDA STEPHANY,D108,HJ,72.01,,1335.35
6150,7/15/2020,7/15/2020,71520,82L-PRPD-071520 -Import Payroll (GENERL)-BARTOLD DEANNA MARIE,D108,HJ,41.91,,1377.26
6150,7/15/2020,7/15/2020,71520,82L-PRPD-071520 -Import Payroll (GENERL)-BARTOLD DEANNA MARIE,D108,HJ,179.22,,1556.48
6150,7/15/2020,7/15/2020,71520,82L-PRPD-071520 -Import Payroll (GENERL)-BAUSH DANIEL,D108,HJ,63.35,,1619.83
6150,7/15/2020,7/15/2020,71520,82L-PRPD-071520 -Import Payroll (GENERL)-BAUSH DANIEL,D108,HJ,270.86,,1890.69
6150,7/15/2020,7/15/2020,71520,82L-PRPD-071520 -Import Payroll (GENERL)-BELLOT GENESIS,D108,HJ,18.74,,1909.43
6150,7/15/2020,7/15/2020,71520,82L-PRPD-071520 -Import Payroll (GENERL)-BELLOT GENESIS,D108,HJ,80.12,,1989.55
6150,7/15/2020,7/15/2020,71520,82L-PRPD-071520 -Import Payroll (GENERL)-BOWMAN HALLEY K,D108,HJ,70.69,,2060.24
6150,7/15/2020,7/15/2020,71520,82L-PRPD-071520 -Import Payroll (GENERL)-BOWMAN HALLEY K,D108,HJ,302.25,,2362.49
6150,7/15/2020,7/15/2020,71520,82L-PRPD-071520 -Import Payroll (GENERL)-CHAPMAN CLAUDY EARL,D108,HJ,26.56,,2389.05
6150,7/15/2020,7/15/2020,71520,82L-PRPD-071520 -Import Payroll (GENERL)-CHAPMAN CLAUDY EARL,D108,HJ,113.56,,2502.61
6150,7/15/2020,7/15/2020,71520,82L-PRPD-071520 -Import Payroll (GENERL)-CIRKER MIA,D108,HJ,21.08,,2523.69
6150,7/15/2020,7/15/2020,71520,82L-PRPD-071520 -Import Payroll (GENERL)-CIRKER MIA,D108,HJ,90.13,,2613.82
6150,7/15/2020,7/15/2020,71520,82L-PRPD-071520 -Import Payroll (GENERL)-COOPER ASHLEE R,D108,HJ,33.87,,2647.69
6150,7/15/2020,7/15/2020,71520,82L-PRPD-071520 -Import Payroll (GENERL)-COOPER ASHLEE R,D108,HJ,144.81,,2792.5
6150,7/15/2020,7/15/2020,71520,82L-PRPD-071520 -Import Payroll (GENERL)-CORTEZ MIRANDA A,D108,HJ,50.89,,2843.39
6150,7/15/2020,7/15/2020,71520,82L-PRPD-071520 -Import Payroll (GENERL)-CORTEZ MIRANDA A,D108,HJ,217.6,,3060.99
6150,7/15/2020,7/15/2020,71520,82L-PRPD-071520 -Import Payroll (GENERL)-COVENEY ALLISON,D108,HJ,38.07,,3099.06
6150,7/15/2020,7/15/2020,71520,82L-PRPD-071520 -Import Payroll (GENERL)-COVENEY ALLISON,D108,HJ,162.79,,3261.85
6150,7/15/2020,7/15/2020,71520,82L-PRPD-071520 -Import Payroll (GENERL)-DADA ARIKPO E,D108,HJ,30.83,,3292.68
6150,7/15/2020,7/15/2020,71520,82L-PRPD-071520 -Import Payroll (GENERL)-DADA ARIKPO E,D108,HJ,131.84,,3424.52
6150,7/15/2020,7/15/2020,71520,82L-PRPD-071520 -Import Payroll (GENERL)-DAUGHERTY DEVIN W,D108,HJ,15.1,,3439.62
6150,7/15/2020,7/15/2020,71520,82L-PRPD-071520 -Import Payroll (GENERL)-DAUGHERTY DEVIN W,D108,HJ,64.58,,3504.2
6150,7/15/2020,7/15/2020,71520,82L-PRPD-071520 -Import Payroll (GENERL)-DZIEDZIC JULIE K,D108,HJ,18.13,,3522.33
6150,7/15/2020,7/15/2020,71520,82L-PRPD-071520 -Import Payroll (GENERL)-DZIEDZIC JULIE K,D108,HJ,77.5,,3599.83
6150,7/15/2020,7/15/2020,71520,82L-PRPD-071520 -Import Payroll (GENERL)-FEIGHERY JOHN,D108,HJ,19.02,,3618.85
6150,7/15/2020,7/15/2020,71520,82L-PRPD-071520 -Import Payroll (GENERL)-FEIGHERY JOHN,D108,HJ,81.33,,3700.18
6150,7/15/2020,7/15/2020,71520,82L-PRPD-071520 -Import Payroll (GENERL)-GARCIA MARILYN,D108,HJ,21.47,,3721.65
6150,7/15/2020,7/15/2020,71520,82L-PRPD-071520 -Import Payroll (GENERL)-GARCIA MARILYN,D108,HJ,91.8,,3813.45
6150,7/15/2020,7/15/2020,71520,82L-PRPD-071520 -Import Payroll (GENERL)-GARNER IVORY,D108,HJ,24.36,,3837.81
6150,7/15/2020,7/15/2020,71520,82L-PRPD-071520 -Import Payroll (GENERL)-GARNER IVORY,D108,HJ,104.16,,3941.97
6150,7/15/2020,7/15/2020,71520,82L-PRPD-071520 -Import Payroll (GENERL)-GORNSTEIN STEVEN,D108,HJ,39.27,,3981.24
6150,7/15/2020,7/15/2020,71520,82L-PRPD-071520 -Import Payroll (GENERL)-GORNSTEIN STEVEN,D108,HJ,114.45,,4095.69
6150,7/15/2020,7/15/2020,71520,82L-PRPD-071520 -Import Payroll (GENERL)-GORNSTEIN STEVEN,D108,HJ,167.92,,4263.61
6150,7/15/2020,7/15/2020,71520,82L-PRPD-071520 -Import Payroll (GENERL)-GRAVES KAMIESHIA,D108,HJ,15.61,,4279.22
6150,7/15/2020,7/15/2020,71520,82L-PRPD-071520 -Import Payroll (GENERL)-GRAVES KAMIESHIA,D108,HJ,66.75,,4345.97
6150,7/15/2020,7/15/2020,71520,82L-PRPD-071520 -Import Payroll (GENERL)-GRAVES KIRA B,D108,HJ,16.16,,4362.13
6150,7/15/2020,7/15/2020,71520,82L-PRPD-071520 -Import Payroll (GENERL)-GRAVES KIRA B,D108,HJ,35.7,,4397.83
6150,7/15/2020,7/15/2020,71520,82L-PRPD-071520 -Import Payroll (GENERL)-GRAVES KIRA B,D108,HJ,152.64,,4550.47
6150,7/15/2020,7/15/2020,71520,82L-PRPD-071520 -Import Payroll (GENERL)-GRIFFIN ANDREW,D108,HJ,18.07,,4568.54
6150,7/15/2020,7/15/2020,71520,82L-PRPD-071520 -Import Payroll (GENERL)-GRIFFIN ANDREW,D108,HJ,77.26,,4645.8
6150,7/15/2020,7/15/2020,71520,82L-PRPD-071520 -Import Payroll (GENERL)-GUADARRAMA-ALVAREZ URIEL A,D108,HJ,58.78,,4704.58
6150,7/15/2020,7/15/2020,71520,82L-PRPD-071520 -Import Payroll (GENERL)-GUADARRAMA-ALVAREZ URIEL A,D108,HJ,251.35,,4955.93
6150,7/15/2020,7/15/2020,71520,82L-PRPD-071520 -Import Payroll (GENERL)-GUTHRIE LESLIE,D108,HJ,33.42,,4989.35
6150,7/15/2020,7/15/2020,71520,82L-PRPD-071520 -Import Payroll (GENERL)-GUTHRIE LESLIE,D108,HJ,142.9,,5132.25
6150,7/15/2020,7/15/2020,71520,82L-PRPD-071520 -Import Payroll (GENERL)-HALLINAN GABRIEL B,D108,HJ,34.79,,5167.04
6150,7/15/2020,7/15/2020,71520,82L-PRPD-071520 -Import Payroll (GENERL)-HALLINAN GABRIEL B,D108,HJ,148.76,,5315.8
6150,7/15/2020,7/15/2020,71520,82L-PRPD-071520 -Import Payroll (GENERL)-HOLDER LATIVA M,D108,HJ,75.58,,5391.38
6150,7/15/2020,7/15/2020,71520,82L-PRPD-071520 -Import Payroll (GENERL)-HOLDER LATIVA M,D108,HJ,323.18,,5714.56
6150,7/15/2020,7/15/2020,71520,82L-PRPD-071520 -Import Payroll (GENERL)-HOLMES JOREL ALEXANDER,D108,HJ,31.22,,5745.78
6150,7/15/2020,7/15/2020,71520,82L-PRPD-071520 -Import Payroll (GENERL)-HOLMES JOREL ALEXANDER,D108,HJ,133.51,,5879.29
6150,7/15/2020,7/15/2020,71520,82L-PRPD-071520 -Import Payroll (GENERL)-HOSSAIN MYESHA R,D108,HJ,35.81,,5915.1
6150,7/15/2020,7/15/2020,71520,82L-PRPD-071520 -Import Payroll (GENERL)-HOSSAIN MYESHA R,D108,HJ,153.12,,6068.22
6150,7/15/2020,7/15/2020,71520,82L-PRPD-071520 -Import Payroll (GENERL)-JACKSON CLAICE M,D108,HJ,24.74,,6092.96
6150,7/15/2020,7/15/2020,71520,82L-PRPD-071520 -Import Payroll (GENERL)-JACKSON CLAICE M,D108,HJ,55.46,,6148.42
6150,7/15/2020,7/15/2020,71520,82L-PRPD-071520 -Import Payroll (GENERL)-JACKSON CLAICE M,D108,HJ,237.13,,6385.55
6150,7/15/2020,7/15/2020,71520,82L-PRPD-071520 -Import Payroll (GENERL)-JACKSON TASNIM F,D108,HJ,31,,6416.55
6150,7/15/2020,7/15/2020,71520,82L-PRPD-071520 -Import Payroll (GENERL)-JACKSON TASNIM F,D108,HJ,132.56,,6549.11
6150,7/15/2020,7/15/2020,71520,82L-PRPD-071520 -Import Payroll (GENERL)-JANG DANIEL,D108,HJ,37.75,,6586.86
6150,7/15/2020,7/15/2020,71520,82L-PRPD-071520 -Import Payroll (GENERL)-JANG DANIEL,D108,HJ,161.4,,6748.26
6150,7/15/2020,7/15/2020,71520,82L-PRPD-071520 -Import Payroll (GENERL)-JORDAN TIFFANY T,D108,HJ,79.8,,6828.06
6150,7/15/2020,7/15/2020,71520,82L-PRPD-071520 -Import Payroll (GENERL)-JORDAN TIFFANY T,D108,HJ,341.21,,7169.27
6150,7/15/2020,7/15/2020,71520,82L-PRPD-071520 -Import Payroll (GENERL)-KAMYA MIRIAM L,D108,HJ,40.11,,7209.38
6150,7/15/2020,7/15/2020,71520,82L-PRPD-071520 -Import Payroll (GENERL)-KAMYA MIRIAM L,D108,HJ,171.49,,7380.87
6150,7/15/2020,7/15/2020,71520,82L-PRPD-071520 -Import Payroll (GENERL)-KOPSHEVER MELISSA,D108,HJ,31.23,,7412.1
6150,7/15/2020,7/15/2020,71520,82L-PRPD-071520 -Import Payroll (GENERL)-KOPSHEVER MELISSA,D108,HJ,58.15,,7470.25
6150,7/15/2020,7/15/2020,71520,82L-PRPD-071520 -Import Payroll (GENERL)-KOPSHEVER MELISSA,D108,HJ,133.53,,7603.78
6150,7/15/2020,7/15/2020,71520,82L-PRPD-071520 -Import Payroll (GENERL)-LACEY DEQUITA,D108,HJ,35.7,,7639.48
6150,7/15/2020,7/15/2020,71520,82L-PRPD-071520 -Import Payroll (GENERL)-LACEY DEQUITA,D108,HJ,152.64,,7792.12
6150,7/15/2020,7/15/2020,71520,82L-PRPD-071520 -Import Payroll (GENERL)-LANIGAN LISA A,D108,HJ,75.77,,7867.89
6150,7/15/2020,7/15/2020,71520,82L-PRPD-071520 -Import Payroll (GENERL)-LANIGAN LISA A,D108,HJ,323.96,,8191.85
6150,7/15/2020,7/15/2020,71520,82L-PRPD-071520 -Import Payroll (GENERL)-LENEGHAN MARYELLEN B,D108,HJ,33.64,,8225.49
6150,7/15/2020,7/15/2020,71520,82L-PRPD-071520 -Import Payroll (GENERL)-LENEGHAN MARYELLEN B,D108,HJ,76.58,,8302.07
6150,7/15/2020,7/15/2020,71520,82L-PRPD-071520 -Import Payroll (GENERL)-LENEGHAN MARYELLEN B,D108,HJ,327.43,,8629.5
6150,7/15/2020,7/15/2020,71520,82L-PRPD-071520 -Import Payroll (GENERL)-LEVERET LILY A,D108,HJ,16.68,,8646.18
6150,7/15/2020,7/15/2020,71520,82L-PRPD-071520 -Import Payroll (GENERL)-LEVERET LILY A,D108,HJ,71.3,,8717.48
6150,7/15/2020,7/15/2020,71520,82L-PRPD-071520 -Import Payroll (GENERL)-LI BELLA,D108,HJ,33.96,,8751.44
6150,7/15/2020,7/15/2020,71520,82L-PRPD-071520 -Import Payroll (GENERL)-LI BELLA,D108,HJ,145.23,,8896.67
6150,7/15/2020,7/15/2020,71520,82L-PRPD-071520 -Import Payroll (GENERL)-LIPORACE HERNAN LUIS,D108,HJ,24.36,,8921.03
6150,7/15/2020,7/15/2020,71520,82L-PRPD-071520 -Import Payroll (GENERL)-LIPORACE HERNAN LUIS,D108,HJ,45.37,,8966.4
6150,7/15/2020,7/15/2020,71520,82L-PRPD-071520 -Import Payroll (GENERL)-LIPORACE HERNAN LUIS,D108,HJ,104.18,,9070.58
6150,7/15/2020,7/15/2020,71520,82L-PRPD-071520 -Import Payroll (GENERL)-MCELWEE MELISSA,D108,HJ,28.55,,9099.13
6150,7/15/2020,7/15/2020,71520,82L-PRPD-071520 -Import Payroll (GENERL)-MCELWEE MELISSA,D108,HJ,122.09,,9221.22
6150,7/15/2020,7/15/2020,71520,82L-PRPD-071520 -Import Payroll (GENERL)-MCNICHOLAS MARY,D108,HJ,33.23,,9254.45
6150,7/15/2020,7/15/2020,71520,82L-PRPD-071520 -Import Payroll (GENERL)-MCNICHOLAS MARY,D108,HJ,142.08,,9396.53
6150,7/15/2020,7/15/2020,71520,82L-PRPD-071520 -Import Payroll (GENERL)-MOSELEY ARIELLE,D108,HJ,37.83,,9434.36
6150,7/15/2020,7/15/2020,71520,82L-PRPD-071520 -Import Payroll (GENERL)-MOSELEY ARIELLE,D108,HJ,161.75,,9596.11
6150,7/15/2020,7/15/2020,71520,82L-PRPD-071520 -Import Payroll (GENERL)-NWAKANMA NANCY,D108,HJ,42.32,,9638.43
6150,7/15/2020,7/15/2020,71520,82L-PRPD-071520 -Import Payroll (GENERL)-NWAKANMA NANCY,D108,HJ,180.94,,9819.37
6150,7/15/2020,7/15/2020,71520,82L-PRPD-071520 -Import Payroll (GENERL)-ODONNELL STEPHEN,D108,HJ,53.76,,9873.13
6150,7/15/2020,7/15/2020,71520,82L-PRPD-071520 -Import Payroll (GENERL)-ODONNELL STEPHEN,D108,HJ,229.87,,10103
6150,7/15/2020,7/15/2020,71520,82L-PRPD-071520 -Import Payroll (GENERL)-ONICA ANTHONY J,D108,HJ,15.7,,10118.7
6150,7/15/2020,7/15/2020,71520,82L-PRPD-071520 -Import Payroll (GENERL)-ONICA ANTHONY J,D108,HJ,67.13,,10185.83
6150,7/15/2020,7/15/2020,71520,82L-PRPD-071520 -Import Payroll (GENERL)-PARHAM-GANTT DENISE M,D108,HJ,37.96,,10223.79
6150,7/15/2020,7/15/2020,71520,82L-PRPD-071520 -Import Payroll (GENERL)-PARHAM-GANTT DENISE M,D108,HJ,162.32,,10386.11
6150,7/15/2020,7/15/2020,71520,82L-PRPD-071520 -Import Payroll (GENERL)-PEINADO ELIZABETH R,D108,HJ,52.29,,10438.4
6150,7/15/2020,7/15/2020,71520,82L-PRPD-071520 -Import Payroll (GENERL)-PEINADO ELIZABETH R,D108,HJ,223.58,,10661.98
6150,7/15/2020,7/15/2020,71520,82L-PRPD-071520 -Import Payroll (GENERL)-PRAHIN NICOLE M,D108,HJ,73.21,,10735.19
6150,7/15/2020,7/15/2020,71520,82L-PRPD-071520 -Import Payroll (GENERL)-PRAHIN NICOLE M,D108,HJ,313.02,,11048.21
6150,7/15/2020,7/15/2020,71520,82L-PRPD-071520 -Import Payroll (GENERL)-RANDOLPH ALEXANDER,D108,HJ,13.77,,11061.98
6150,7/15/2020,7/15/2020,71520,82L-PRPD-071520 -Import Payroll (GENERL)-RANDOLPH ALEXANDER,D108,HJ,30.12,,11092.1
6150,7/15/2020,7/15/2020,71520,82L-PRPD-071520 -Import Payroll (GENERL)-RANDOLPH ALEXANDER,D108,HJ,59.97,,11152.07
6150,7/15/2020,7/15/2020,71520,82L-PRPD-071520 -Import Payroll (GENERL)-RANDOLPH ALEXANDER,D108,HJ,128.79,,11280.86
6150,7/15/2020,7/15/2020,71520,82L-PRPD-071520 -Import Payroll (GENERL)-RIVERS QUIONNA DIANE,D108,HJ,36.46,,11317.32
6150,7/15/2020,7/15/2020,71520,82L-PRPD-071520 -Import Payroll (GENERL)-RIVERS QUIONNA DIANE,D108,HJ,155.89,,11473.21
6150,7/15/2020,7/15/2020,71520,82L-PRPD-071520 -Import Payroll (GENERL)-SALIM YASSER,D108,HJ,33.1,,11506.31
6150,7/15/2020,7/15/2020,71520,82L-PRPD-071520 -Import Payroll (GENERL)-SALIM YASSER,D108,HJ,141.55,,11647.86
6150,7/15/2020,7/15/2020,71520,82L-PRPD-071520 -Import Payroll (GENERL)-SEJOUR MAHALIAH,D108,HJ,34.07,,11681.93
6150,7/15/2020,7/15/2020,71520,82L-PRPD-071520 -Import Payroll (GENERL)-SEJOUR MAHALIAH,D108,HJ,145.66,,11827.59
6150,7/15/2020,7/15/2020,71520,82L-PRPD-071520 -Import Payroll (GENERL)-SHENKMAN OLIVIA,D108,HJ,29,,11856.59
6150,7/15/2020,7/15/2020,71520,82L-PRPD-071520 -Import Payroll (GENERL)-SHENKMAN OLIVIA,D108,HJ,124,,11980.59
6150,7/15/2020,7/15/2020,71520,82L-PRPD-071520 -Import Payroll (GENERL)-SKALSKI CHRISTOPHER,D108,HJ,33.86,,12014.45
6150,7/15/2020,7/15/2020,71520,82L-PRPD-071520 -Import Payroll (GENERL)-SKALSKI CHRISTOPHER,D108,HJ,144.76,,12159.21
6150,7/15/2020,7/15/2020,71520,82L-PRPD-071520 -Import Payroll (GENERL)-SMITH AKILAH,D108,HJ,16.84,,12176.05
6150,7/15/2020,7/15/2020,71520,82L-PRPD-071520 -Import Payroll (GENERL)-SMITH AKILAH,D108,HJ,71.98,,12248.03
6150,7/15/2020,7/15/2020,71520,82L-PRPD-071520 -Import Payroll (GENERL)-TAM CW RYAN,D108,HJ,16.65,,12264.68
6150,7/15/2020,7/15/2020,71520,82L-PRPD-071520 -Import Payroll (GENERL)-TAM CW RYAN,D108,HJ,71.19,,12335.87
6150,7/15/2020,7/15/2020,71520,82L-PRPD-071520 -Import Payroll (GENERL)-TENESACA VERONICA A,D108,HJ,17.5,,12353.37
6150,7/15/2020,7/15/2020,71520,82L-PRPD-071520 -Import Payroll (GENERL)-TENESACA VERONICA A,D108,HJ,74.84,,12428.21
6150,7/15/2020,7/15/2020,71520,82L-PRPD-071520 -Import Payroll (GENERL)-TILLERY ASIA,D108,HJ,47.73,,12475.94
6150,7/15/2020,7/15/2020,71520,82L-PRPD-071520 -Import Payroll (GENERL)-TILLERY ASIA,D108,HJ,204.08,,12680.02
6150,7/15/2020,7/15/2020,71520,82L-PRPD-071520 -Import Payroll (GENERL)-TUMENJARGAL ENKHJIN,D108,HJ,32.92,,12712.94
6150,7/15/2020,7/15/2020,71520,82L-PRPD-071520 -Import Payroll (GENERL)-TUMENJARGAL ENKHJIN,D108,HJ,140.75,,12853.69
6150,7/15/2020,7/15/2020,71520,82L-PRPD-071520 -Import Payroll (GENERL)-VILLEGAS EVELYN,D108,HJ,33.4,,12887.09
6150,7/15/2020,7/15/2020,71520,82L-PRPD-071520 -Import Payroll (GENERL)-VILLEGAS EVELYN,D108,HJ,142.81,,13029.9
6150,7/15/2020,7/15/2020,71520,82L-PRPD-071520 -Import Payroll (GENERL)-WALLACE AMENA T,D108,HJ,28.93,,13058.83
6150,7/15/2020,7/15/2020,71520,82L-PRPD-071520 -Import Payroll (GENERL)-WALLACE AMENA T,D108,HJ,123.72,,13182.55
6150,7/15/2020,7/15/2020,71520,82L-PRPD-071520 -Import Payroll (GENERL)-WEINSTOCK EMILY,D108,HJ,17.57,,13200.12
6150,7/15/2020,7/15/2020,71520,82L-PRPD-071520 -Import Payroll (GENERL)-WEINSTOCK EMILY,D108,HJ,41.08,,13241.2
6150,7/15/2020,7/15/2020,71520,82L-PRPD-071520 -Import Payroll (GENERL)-WEINSTOCK EMILY,D108,HJ,76.5,,13317.7
6150,7/15/2020,7/15/2020,71520,82L-PRPD-071520 -Import Payroll (GENERL)-WEINSTOCK EMILY,D108,HJ,175.67,,13493.37
6150,7/15/2020,7/15/2020,71520,82L-PRPD-071520 -Import Payroll (GENERL)-WINANS JENNIFER,D108,HJ,44.6,,13537.97
6150,7/15/2020,7/15/2020,71520,82L-PRPD-071520 -Import Payroll (GENERL)-WINANS JENNIFER,D108,HJ,190.69,,13728.66
6150,7/15/2020,7/15/2020,71520,82L-PRPD-071520 -Import Payroll (GENERL)-WOLF ANNA A,D108,HJ,36.3,,13764.96
6150,7/15/2020,7/15/2020,71520,82L-PRPD-071520 -Import Payroll (GENERL)-WOLF ANNA A,D108,HJ,155.19,,13920.15
6150,7/15/2020,7/15/2020,71520,82L-PRPD-071520 -Import Payroll (GENERL)-ZARATE JOSEPH M,D108,HJ,33.77,,13953.92
6150,7/15/2020,7/15/2020,71520,82L-PRPD-071520 -Import Payroll (GENERL)-ZARATE JOSEPH M,D108,HJ,144.4,,14098.32
6150,7/15/2020,7/15/2020,71520,To reverse 82L payroll 0715 JE-21-0008-Reverse payroll entry 07152020 IMPORT PAYROLL,D108,HJ,,13.77,14084.55
6150,7/15/2020,7/15/2020,71520,To reverse 82L payroll 0715 JE-21-0008-Reverse payroll entry 07152020 IMPORT PAYROLL,D108,HJ,,15.1,14069.45
6150,7/15/2020,7/15/2020,71520,To reverse 82L payroll 0715 JE-21-0008-Reverse payroll entry 07152020 IMPORT PAYROLL,D108,HJ,,15.61,14053.84
6150,7/15/2020,7/15/2020,71520,To reverse 82L payroll 0715 JE-21-0008-Reverse payroll entry 07152020 IMPORT PAYROLL,D108,HJ,,15.7,14038.14
6150,7/15/2020,7/15/2020,71520,To reverse 82L payroll 0715 JE-21-0008-Reverse payroll entry 07152020 IMPORT PAYROLL,D108,HJ,,16.16,14021.98
6150,7/15/2020,7/15/2020,71520,To reverse 82L payroll 0715 JE-21-0008-Reverse payroll entry 07152020 IMPORT PAYROLL,D108,HJ,,16.65,14005.33
6150,7/15/2020,7/15/2020,71520,To reverse 82L payroll 0715 JE-21-0008-Reverse payroll entry 07152020 IMPORT PAYROLL,D108,HJ,,16.68,13988.65
6150,7/15/2020,7/15/2020,71520,To reverse 82L payroll 0715 JE-21-0008-Reverse payroll entry 07152020 IMPORT PAYROLL,D108,HJ,,16.84,13971.81
6150,7/15/2020,7/15/2020,71520,To reverse 82L payroll 0715 JE-21-0008-Reverse payroll entry 07152020 IMPORT PAYROLL,D108,HJ,,16.84,13954.97
6150,7/15/2020,7/15/2020,71520,To reverse 82L payroll 0715 JE-21-0008-Reverse payroll entry 07152020 IMPORT PAYROLL,D108,HJ,,17.5,13937.47
6150,7/15/2020,7/15/2020,71520,To reverse 82L payroll 0715 JE-21-0008-Reverse payroll entry 07152020 IMPORT PAYROLL,D108,HJ,,17.57,13919.9
6150,7/15/2020,7/15/2020,71520,To reverse 82L payroll 0715 JE-21-0008-Reverse payroll entry 07152020 IMPORT PAYROLL,D108,HJ,,18.07,13901.83
6150,7/15/2020,7/15/2020,71520,To reverse 82L payroll 0715 JE-21-0008-Reverse payroll entry 07152020 IMPORT PAYROLL,D108,HJ,,18.13,13883.7
6150,7/15/2020,7/15/2020,71520,To reverse 82L payroll 0715 JE-21-0008-Reverse payroll entry 07152020 IMPORT PAYROLL,D108,HJ,,18.74,13864.96
6150,7/15/2020,7/15/2020,71520,To reverse 82L payroll 0715 JE-21-0008-Reverse payroll entry 07152020 IMPORT PAYROLL,D108,HJ,,19.02,13845.94
6150,7/15/2020,7/15/2020,71520,To reverse 82L payroll 0715 JE-21-0008-Reverse payroll entry 07152020 IMPORT PAYROLL,D108,HJ,,21.08,13824.86
6150,7/15/2020,7/15/2020,71520,To reverse 82L payroll 0715 JE-21-0008-Reverse payroll entry 07152020 IMPORT PAYROLL,D108,HJ,,21.47,13803.39
6150,7/15/2020,7/15/2020,71520,To reverse 82L payroll 0715 JE-21-0008-Reverse payroll entry 07152020 IMPORT PAYROLL,D108,HJ,,24.36,13779.03
6150,7/15/2020,7/15/2020,71520,To reverse 82L payroll 0715 JE-21-0008-Reverse payroll entry 07152020 IMPORT PAYROLL,D108,HJ,,24.36,13754.67
6150,7/15/2020,7/15/2020,71520,To reverse 82L payroll 0715 JE-21-0008-Reverse payroll entry 07152020 IMPORT PAYROLL,D108,HJ,,24.74,13729.93
6150,7/15/2020,7/15/2020,71520,To reverse 82L payroll 0715 JE-21-0008-Reverse payroll entry 07152020 IMPORT PAYROLL,D108,HJ,,26.56,13703.37
6150,7/15/2020,7/15/2020,71520,To reverse 82L payroll 0715 JE-21-0008-Reverse payroll entry 07152020 IMPORT PAYROLL,D108,HJ,,27.97,13675.4
6150,7/15/2020,7/15/2020,71520,To reverse 82L payroll 0715 JE-21-0008-Reverse payroll entry 07152020 IMPORT PAYROLL,D108,HJ,,28.55,13646.85
6150,7/15/2020,7/15/2020,71520,To reverse 82L payroll 0715 JE-21-0008-Reverse payroll entry 07152020 IMPORT PAYROLL,D108,HJ,,28.93,13617.92
6150,7/15/2020,7/15/2020,71520,To reverse 82L payroll 0715 JE-21-0008-Reverse payroll entry 07152020 IMPORT PAYROLL,D108,HJ,,29,13588.92
6150,7/15/2020,7/15/2020,71520,To reverse 82L payroll 0715 JE-21-0008-Reverse payroll entry 07152020 IMPORT PAYROLL,D108,HJ,,30.12,13558.8
6150,7/15/2020,7/15/2020,71520,To reverse 82L payroll 0715 JE-21-0008-Reverse payroll entry 07152020 IMPORT PAYROLL,D108,HJ,,30.83,13527.97
6150,7/15/2020,7/15/2020,71520,To reverse 82L payroll 0715 JE-21-0008-Reverse payroll entry 07152020 IMPORT PAYROLL,D108,HJ,,31,13496.97
6150,7/15/2020,7/15/2020,71520,To reverse 82L payroll 0715 JE-21-0008-Reverse payroll entry 07152020 IMPORT PAYROLL,D108,HJ,,31.22,13465.75
6150,7/15/2020,7/15/2020,71520,To reverse 82L payroll 0715 JE-21-0008-Reverse payroll entry 07152020 IMPORT PAYROLL,D108,HJ,,31.23,13434.52
6150,7/15/2020,7/15/2020,71520,To reverse 82L payroll 0715 JE-21-0008-Reverse payroll entry 07152020 IMPORT PAYROLL,D108,HJ,,31.49,13403.03
6150,7/15/2020,7/15/2020,71520,To reverse 82L payroll 0715 JE-21-0008-Reverse payroll entry 07152020 IMPORT PAYROLL,D108,HJ,,32.92,13370.11
6150,7/15/2020,7/15/2020,71520,To reverse 82L payroll 0715 JE-21-0008-Reverse payroll entry 07152020 IMPORT PAYROLL,D108,HJ,,33.1,13337.01
6150,7/15/2020,7/15/2020,71520,To reverse 82L payroll 0715 JE-21-0008-Reverse payroll entry 07152020 IMPORT PAYROLL,D108,HJ,,33.23,13303.78
6150,7/15/2020,7/15/2020,71520,To reverse 82L payroll 0715 JE-21-0008-Reverse payroll entry 07152020 IMPORT PAYROLL,D108,HJ,,33.4,13270.38
6150,7/15/2020,7/15/2020,71520,To reverse 82L payroll 0715 JE-21-0008-Reverse payroll entry 07152020 IMPORT PAYROLL,D108,HJ,,33.42,13236.96
6150,7/15/2020,7/15/2020,71520,To reverse 82L payroll 0715 JE-21-0008-Reverse payroll entry 07152020 IMPORT PAYROLL,D108,HJ,,33.64,13203.32
6150,7/15/2020,7/15/2020,71520,To reverse 82L payroll 0715 JE-21-0008-Reverse payroll entry 07152020 IMPORT PAYROLL,D108,HJ,,33.77,13169.55
6150,7/15/2020,7/15/2020,71520,To reverse 82L payroll 0715 JE-21-0008-Reverse payroll entry 07152020 IMPORT PAYROLL,D108,HJ,,33.86,13135.69
6150,7/15/2020,7/15/2020,71520,To reverse 82L payroll 0715 JE-21-0008-Reverse payroll entry 07152020 IMPORT PAYROLL,D108,HJ,,33.87,13101.82
6150,7/15/2020,7/15/2020,71520,To reverse 82L payroll 0715 JE-21-0008-Reverse payroll entry 07152020 IMPORT PAYROLL,D108,HJ,,33.96,13067.86
6150,7/15/2020,7/15/2020,71520,To reverse 82L payroll 0715 JE-21-0008-Reverse payroll entry 07152020 IMPORT PAYROLL,D108,HJ,,34.07,13033.79
6150,7/15/2020,7/15/2020,71520,To reverse 82L payroll 0715 JE-21-0008-Reverse payroll entry 07152020 IMPORT PAYROLL,D108,HJ,,34.79,12999
6150,7/15/2020,7/15/2020,71520,To reverse 82L payroll 0715 JE-21-0008-Reverse payroll entry 07152020 IMPORT PAYROLL,D108,HJ,,35.7,12963.3
6150,7/15/2020,7/15/2020,71520,To reverse 82L payroll 0715 JE-21-0008-Reverse payroll entry 07152020 IMPORT PAYROLL,D108,HJ,,35.7,12927.6
6150,7/15/2020,7/15/2020,71520,To reverse 82L payroll 0715 JE-21-0008-Reverse payroll entry 07152020 IMPORT PAYROLL,D108,HJ,,35.81,12891.79
6150,7/15/2020,7/15/2020,71520,To reverse 82L payroll 0715 JE-21-0008-Reverse payroll entry 07152020 IMPORT PAYROLL,D108,HJ,,36.3,12855.49
6150,7/15/2020,7/15/2020,71520,To reverse 82L payroll 0715 JE-21-0008-Reverse payroll entry 07152020 IMPORT PAYROLL,D108,HJ,,36.34,12819.15
6150,7/15/2020,7/15/2020,71520,To reverse 82L payroll 0715 JE-21-0008-Reverse payroll entry 07152020 IMPORT PAYROLL,D108,HJ,,36.46,12782.69
6150,7/15/2020,7/15/2020,71520,To reverse 82L payroll 0715 JE-21-0008-Reverse payroll entry 07152020 IMPORT PAYROLL,D108,HJ,,37.75,12744.94
6150,7/15/2020,7/15/2020,71520,To reverse 82L payroll 0715 JE-21-0008-Reverse payroll entry 07152020 IMPORT PAYROLL,D108,HJ,,37.83,12707.11
6150,7/15/2020,7/15/2020,71520,To reverse 82L payroll 0715 JE-21-0008-Reverse payroll entry 07152020 IMPORT PAYROLL,D108,HJ,,37.96,12669.15
6150,7/15/2020,7/15/2020,71520,To reverse 82L payroll 0715 JE-21-0008-Reverse payroll entry 07152020 IMPORT PAYROLL,D108,HJ,,38.07,12631.08
6150,7/15/2020,7/15/2020,71520,To reverse 82L payroll 0715 JE-21-0008-Reverse payroll entry 07152020 IMPORT PAYROLL,D108,HJ,,38.67,12592.41
6150,7/15/2020,7/15/2020,71520,To reverse 82L payroll 0715 JE-21-0008-Reverse payroll entry 07152020 IMPORT PAYROLL,D108,HJ,,39.27,12553.14
6150,7/15/2020,7/15/2020,71520,To reverse 82L payroll 0715 JE-21-0008-Reverse payroll entry 07152020 IMPORT PAYROLL,D108,HJ,,40.11,12513.03
6150,7/15/2020,7/15/2020,71520,To reverse 82L payroll 0715 JE-21-0008-Reverse payroll entry 07152020 IMPORT PAYROLL,D108,HJ,,41.08,12471.95
6150,7/15/2020,7/15/2020,71520,To reverse 82L payroll 0715 JE-21-0008-Reverse payroll entry 07152020 IMPORT PAYROLL,D108,HJ,,41.85,12430.1
6150,7/15/2020,7/15/2020,71520,To reverse 82L payroll 0715 JE-21-0008-Reverse payroll entry 07152020 IMPORT PAYROLL,D108,HJ,,41.91,12388.19
6150,7/15/2020,7/15/2020,71520,To reverse 82L payroll 0715 JE-21-0008-Reverse payroll entry 07152020 IMPORT PAYROLL,D108,HJ,,42.32,12345.87
6150,7/15/2020,7/15/2020,71520,To reverse 82L payroll 0715 JE-21-0008-Reverse payroll entry 07152020 IMPORT PAYROLL,D108,HJ,,44.6,12301.27
6150,7/15/2020,7/15/2020,71520,To reverse 82L payroll 0715 JE-21-0008-Reverse payroll entry 07152020 IMPORT PAYROLL,D108,HJ,,45.37,12255.9
6150,7/15/2020,7/15/2020,71520,To reverse 82L payroll 0715 JE-21-0008-Reverse payroll entry 07152020 IMPORT PAYROLL,D108,HJ,,47.73,12208.17
6150,7/15/2020,7/15/2020,71520,To reverse 82L payroll 0715 JE-21-0008-Reverse payroll entry 07152020 IMPORT PAYROLL,D108,HJ,,50.89,12157.28
6150,7/15/2020,7/15/2020,71520,To reverse 82L payroll 0715 JE-21-0008-Reverse payroll entry 07152020 IMPORT PAYROLL,D108,HJ,,52.29,12104.99
6150,7/15/2020,7/15/2020,71520,To reverse 82L payroll 0715 JE-21-0008-Reverse payroll entry 07152020 IMPORT PAYROLL,D108,HJ,,53.76,12051.23
6150,7/15/2020,7/15/2020,71520,To reverse 82L payroll 0715 JE-21-0008-Reverse payroll entry 07152020 IMPORT PAYROLL,D108,HJ,,55.46,11995.77
6150,7/15/2020,7/15/2020,71520,To reverse 82L payroll 0715 JE-21-0008-Reverse payroll entry 07152020 IMPORT PAYROLL,D108,HJ,,58.15,11937.62
6150,7/15/2020,7/15/2020,71520,To reverse 82L payroll 0715 JE-21-0008-Reverse payroll entry 07152020 IMPORT PAYROLL,D108,HJ,,58.78,11878.84
6150,7/15/2020,7/15/2020,71520,To reverse 82L payroll 0715 JE-21-0008-Reverse payroll entry 07152020 IMPORT PAYROLL,D108,HJ,,59.97,11818.87
6150,7/15/2020,7/15/2020,71520,To reverse 82L payroll 0715 JE-21-0008-Reverse payroll entry 07152020 IMPORT PAYROLL,D108,HJ,,63.35,11755.52
6150,7/15/2020,7/15/2020,71520,To reverse 82L payroll 0715 JE-21-0008-Reverse payroll entry 07152020 IMPORT PAYROLL,D108,HJ,,64.58,11690.94
6150,7/15/2020,7/15/2020,71520,To reverse 82L payroll 0715 JE-21-0008-Reverse payroll entry 07152020 IMPORT PAYROLL,D108,HJ,,66.75,11624.19
6150,7/15/2020,7/15/2020,71520,To reverse 82L payroll 0715 JE-21-0008-Reverse payroll entry 07152020 IMPORT PAYROLL,D108,HJ,,67.13,11557.06
6150,7/15/2020,7/15/2020,71520,To reverse 82L payroll 0715 JE-21-0008-Reverse payroll entry 07152020 IMPORT PAYROLL,D108,HJ,,70.69,11486.37
6150,7/15/2020,7/15/2020,71520,To reverse 82L payroll 0715 JE-21-0008-Reverse payroll entry 07152020 IMPORT PAYROLL,D108,HJ,,71.19,11415.18
6150,7/15/2020,7/15/2020,71520,To reverse 82L payroll 0715 JE-21-0008-Reverse payroll entry 07152020 IMPORT PAYROLL,D108,HJ,,71.3,11343.88
6150,7/15/2020,7/15/2020,71520,To reverse 82L payroll 0715 JE-21-0008-Reverse payroll entry 07152020 IMPORT PAYROLL,D108,HJ,,71.98,11271.9
6150,7/15/2020,7/15/2020,71520,To reverse 82L payroll 0715 JE-21-0008-Reverse payroll entry 07152020 IMPORT PAYROLL,D108,HJ,,72.01,11199.89
6150,7/15/2020,7/15/2020,71520,To reverse 82L payroll 0715 JE-21-0008-Reverse payroll entry 07152020 IMPORT PAYROLL,D108,HJ,,73.21,11126.68
6150,7/15/2020,7/15/2020,71520,To reverse 82L payroll 0715 JE-21-0008-Reverse payroll entry 07152020 IMPORT PAYROLL,D108,HJ,,74.84,11051.84
6150,7/15/2020,7/15/2020,71520,To reverse 82L payroll 0715 JE-21-0008-Reverse payroll entry 07152020 IMPORT PAYROLL,D108,HJ,,75.58,10976.26
6150,7/15/2020,7/15/2020,71520,To reverse 82L payroll 0715 JE-21-0008-Reverse payroll entry 07152020 IMPORT PAYROLL,D108,HJ,,75.77,10900.49
6150,7/15/2020,7/15/2020,71520,To reverse 82L payroll 0715 JE-21-0008-Reverse payroll entry 07152020 IMPORT PAYROLL,D108,HJ,,76.5,10823.99
6150,7/15/2020,7/15/2020,71520,To reverse 82L payroll 0715 JE-21-0008-Reverse payroll entry 07152020 IMPORT PAYROLL,D108,HJ,,76.58,10747.41
6150,7/15/2020,7/15/2020,71520,To reverse 82L payroll 0715 JE-21-0008-Reverse payroll entry 07152020 IMPORT PAYROLL,D108,HJ,,77.26,10670.15
6150,7/15/2020,7/15/2020,71520,To reverse 82L payroll 0715 JE-21-0008-Reverse payroll entry 07152020 IMPORT PAYROLL,D108,HJ,,77.5,10592.65
6150,7/15/2020,7/15/2020,71520,To reverse 82L payroll 0715 JE-21-0008-Reverse payroll entry 07152020 IMPORT PAYROLL,D108,HJ,,79.8,10512.85
6150,7/15/2020,7/15/2020,71520,To reverse 82L payroll 0715 JE-21-0008-Reverse payroll entry 07152020 IMPORT PAYROLL,D108,HJ,,80.12,10432.73
6150,7/15/2020,7/15/2020,71520,To reverse 82L payroll 0715 JE-21-0008-Reverse payroll entry 07152020 IMPORT PAYROLL,D108,HJ,,81.33,10351.4
6150,7/15/2020,7/15/2020,71520,To reverse 82L payroll 0715 JE-21-0008-Reverse payroll entry 07152020 IMPORT PAYROLL,D108,HJ,,90.13,10261.27
6150,7/15/2020,7/15/2020,71520,To reverse 82L payroll 0715 JE-21-0008-Reverse payroll entry 07152020 IMPORT PAYROLL,D108,HJ,,91.8,10169.47
6150,7/15/2020,7/15/2020,71520,To reverse 82L payroll 0715 JE-21-0008-Reverse payroll entry 07152020 IMPORT PAYROLL,D108,HJ,,93.33,10076.14
6150,7/15/2020,7/15/2020,71520,To reverse 82L payroll 0715 JE-21-0008-Reverse payroll entry 07152020 IMPORT PAYROLL,D108,HJ,,104.16,9971.98
6150,7/15/2020,7/15/2020,71520,To reverse 82L payroll 0715 JE-21-0008-Reverse payroll entry 07152020 IMPORT PAYROLL,D108,HJ,,104.18,9867.8
6150,7/15/2020,7/15/2020,71520,To reverse 82L payroll 0715 JE-21-0008-Reverse payroll entry 07152020 IMPORT PAYROLL,D108,HJ,,113.56,9754.24
6150,7/15/2020,7/15/2020,71520,To reverse 82L payroll 0715 JE-21-0008-Reverse payroll entry 07152020 IMPORT PAYROLL,D108,HJ,,114.45,9639.79
6150,7/15/2020,7/15/2020,71520,To reverse 82L payroll 0715 JE-21-0008-Reverse payroll entry 07152020 IMPORT PAYROLL,D108,HJ,,119.61,9520.18
6150,7/15/2020,7/15/2020,71520,To reverse 82L payroll 0715 JE-21-0008-Reverse payroll entry 07152020 IMPORT PAYROLL,D108,HJ,,122.09,9398.09
6150,7/15/2020,7/15/2020,71520,To reverse 82L payroll 0715 JE-21-0008-Reverse payroll entry 07152020 IMPORT PAYROLL,D108,HJ,,123.72,9274.37
6150,7/15/2020,7/15/2020,71520,To reverse 82L payroll 0715 JE-21-0008-Reverse payroll entry 07152020 IMPORT PAYROLL,D108,HJ,,124,9150.37
6150,7/15/2020,7/15/2020,71520,To reverse 82L payroll 0715 JE-21-0008-Reverse payroll entry 07152020 IMPORT PAYROLL,D108,HJ,,128.79,9021.58
6150,7/15/2020,7/15/2020,71520,To reverse 82L payroll 0715 JE-21-0008-Reverse payroll entry 07152020 IMPORT PAYROLL,D108,HJ,,131.84,8889.74
6150,7/15/2020,7/15/2020,71520,To reverse 82L payroll 0715 JE-21-0008-Reverse payroll entry 07152020 IMPORT PAYROLL,D108,HJ,,132.56,8757.18
6150,7/15/2020,7/15/2020,71520,To reverse 82L payroll 0715 JE-21-0008-Reverse payroll entry 07152020 IMPORT PAYROLL,D108,HJ,,133.51,8623.67
6150,7/15/2020,7/15/2020,71520,To reverse 82L payroll 0715 JE-21-0008-Reverse payroll entry 07152020 IMPORT PAYROLL,D108,HJ,,133.53,8490.14
6150,7/15/2020,7/15/2020,71520,To reverse 82L payroll 0715 JE-21-0008-Reverse payroll entry 07152020 IMPORT PAYROLL,D108,HJ,,134.65,8355.49
6150,7/15/2020,7/15/2020,71520,To reverse 82L payroll 0715 JE-21-0008-Reverse payroll entry 07152020 IMPORT PAYROLL,D108,HJ,,140.75,8214.74
6150,7/15/2020,7/15/2020,71520,To reverse 82L payroll 0715 JE-21-0008-Reverse payroll entry 07152020 IMPORT PAYROLL,D108,HJ,,141.55,8073.19
6150,7/15/2020,7/15/2020,71520,To reverse 82L payroll 0715 JE-21-0008-Reverse payroll entry 07152020 IMPORT PAYROLL,D108,HJ,,142.08,7931.11
6150,7/15/2020,7/15/2020,71520,To reverse 82L payroll 0715 JE-21-0008-Reverse payroll entry 07152020 IMPORT PAYROLL,D108,HJ,,142.81,7788.3
6150,7/15/2020,7/15/2020,71520,To reverse 82L payroll 0715 JE-21-0008-Reverse payroll entry 07152020 IMPORT PAYROLL,D108,HJ,,142.9,7645.4
6150,7/15/2020,7/15/2020,71520,To reverse 82L payroll 0715 JE-21-0008-Reverse payroll entry 07152020 IMPORT PAYROLL,D108,HJ,,144.4,7501
6150,7/15/2020,7/15/2020,71520,To reverse 82L payroll 0715 JE-21-0008-Reverse payroll entry 07152020 IMPORT PAYROLL,D108,HJ,,144.76,7356.24
6150,7/15/2020,7/15/2020,71520,To reverse 82L payroll 0715 JE-21-0008-Reverse payroll entry 07152020 IMPORT PAYROLL,D108,HJ,,144.81,7211.43
6150,7/15/2020,7/15/2020,71520,To reverse 82L payroll 0715 JE-21-0008-Reverse payroll entry 07152020 IMPORT PAYROLL,D108,HJ,,145.23,7066.2
6150,7/15/2020,7/15/2020,71520,To reverse 82L payroll 0715 JE-21-0008-Reverse payroll entry 07152020 IMPORT PAYROLL,D108,HJ,,145.66,6920.54
6150,7/15/2020,7/15/2020,71520,To reverse 82L payroll 0715 JE-21-0008-Reverse payroll entry 07152020 IMPORT PAYROLL,D108,HJ,,148.76,6771.78
6150,7/15/2020,7/15/2020,71520,To reverse 82L payroll 0715 JE-21-0008-Reverse payroll entry 07152020 IMPORT PAYROLL,D108,HJ,,152.64,6619.14
6150,7/15/2020,7/15/2020,71520,To reverse 82L payroll 0715 JE-21-0008-Reverse payroll entry 07152020 IMPORT PAYROLL,D108,HJ,,152.64,6466.5
6150,7/15/2020,7/15/2020,71520,To reverse 82L payroll 0715 JE-21-0008-Reverse payroll entry 07152020 IMPORT PAYROLL,D108,HJ,,153.12,6313.38
6150,7/15/2020,7/15/2020,71520,To reverse 82L payroll 0715 JE-21-0008-Reverse payroll entry 07152020 IMPORT PAYROLL,D108,HJ,,155.19,6158.19
6150,7/15/2020,7/15/2020,71520,To reverse 82L payroll 0715 JE-21-0008-Reverse payroll entry 07152020 IMPORT PAYROLL,D108,HJ,,155.39,6002.8
6150,7/15/2020,7/15/2020,71520,To reverse 82L payroll 0715 JE-21-0008-Reverse payroll entry 07152020 IMPORT PAYROLL,D108,HJ,,155.89,5846.91
6150,7/15/2020,7/15/2020,71520,To reverse 82L payroll 0715 JE-21-0008-Reverse payroll entry 07152020 IMPORT PAYROLL,D108,HJ,,161.4,5685.51
6150,7/15/2020,7/15/2020,71520,To reverse 82L payroll 0715 JE-21-0008-Reverse payroll entry 07152020 IMPORT PAYROLL,D108,HJ,,161.75,5523.76
6150,7/15/2020,7/15/2020,71520,To reverse 82L payroll 0715 JE-21-0008-Reverse payroll entry 07152020 IMPORT PAYROLL,D108,HJ,,162.32,5361.44
6150,7/15/2020,7/15/2020,71520,To reverse 82L payroll 0715 JE-21-0008-Reverse payroll entry 07152020 IMPORT PAYROLL,D108,HJ,,162.79,5198.65
6150,7/15/2020,7/15/2020,71520,To reverse 82L payroll 0715 JE-21-0008-Reverse payroll entry 07152020 IMPORT PAYROLL,D108,HJ,,165.33,5033.32
6150,7/15/2020,7/15/2020,71520,To reverse 82L payroll 0715 JE-21-0008-Reverse payroll entry 07152020 IMPORT PAYROLL,D108,HJ,,167.92,4865.4
6150,7/15/2020,7/15/2020,71520,To reverse 82L payroll 0715 JE-21-0008-Reverse payroll entry 07152020 IMPORT PAYROLL,D108,HJ,,171.49,4693.91
6150,7/15/2020,7/15/2020,71520,To reverse 82L payroll 0715 JE-21-0008-Reverse payroll entry 07152020 IMPORT PAYROLL,D108,HJ,,175.67,4518.24
6150,7/15/2020,7/15/2020,71520,To reverse 82L payroll 0715 JE-21-0008-Reverse payroll entry 07152020 IMPORT PAYROLL,D108,HJ,,178.96,4339.28
6150,7/15/2020,7/15/2020,71520,To reverse 82L payroll 0715 JE-21-0008-Reverse payroll entry 07152020 IMPORT PAYROLL,D108,HJ,,179.22,4160.06
6150,7/15/2020,7/15/2020,71520,To reverse 82L payroll 0715 JE-21-0008-Reverse payroll entry 07152020 IMPORT PAYROLL,D108,HJ,,180.94,3979.12
6150,7/15/2020,7/15/2020,71520,To reverse 82L payroll 0715 JE-21-0008-Reverse payroll entry 07152020 IMPORT PAYROLL,D108,HJ,,190.69,3788.43
6150,7/15/2020,7/15/2020,71520,To reverse 82L payroll 0715 JE-21-0008-Reverse payroll entry 07152020 IMPORT PAYROLL,D108,HJ,,204.08,3584.35
6150,7/15/2020,7/15/2020,71520,To reverse 82L payroll 0715 JE-21-0008-Reverse payroll entry 07152020 IMPORT PAYROLL,D108,HJ,,217.6,3366.75
6150,7/15/2020,7/15/2020,71520,To reverse 82L payroll 0715 JE-21-0008-Reverse payroll entry 07152020 IMPORT PAYROLL,D108,HJ,,223.58,3143.17
6150,7/15/2020,7/15/2020,71520,To reverse 82L payroll 0715 JE-21-0008-Reverse payroll entry 07152020 IMPORT PAYROLL,D108,HJ,,229.87,2913.3
6150,7/15/2020,7/15/2020,71520,To reverse 82L payroll 0715 JE-21-0008-Reverse payroll entry 07152020 IMPORT PAYROLL,D108,HJ,,237.13,2676.17
6150,7/15/2020,7/15/2020,71520,To reverse 82L payroll 0715 JE-21-0008-Reverse payroll entry 07152020 IMPORT PAYROLL,D108,HJ,,251.35,2424.82
6150,7/15/2020,7/15/2020,71520,To reverse 82L payroll 0715 JE-21-0008-Reverse payroll entry 07152020 IMPORT PAYROLL,D108,HJ,,270.86,2153.96
6150,7/15/2020,7/15/2020,71520,To reverse 82L payroll 0715 JE-21-0008-Reverse payroll entry 07152020 IMPORT PAYROLL,D108,HJ,,302.25,1851.71
6150,7/15/2020,7/15/2020,71520,To reverse 82L payroll 0715 JE-21-0008-Reverse payroll entry 07152020 IMPORT PAYROLL,D108,HJ,,313.02,1538.69
6150,7/15/2020,7/15/2020,71520,To reverse 82L payroll 0715 JE-21-0008-Reverse payroll entry 07152020 IMPORT PAYROLL,D108,HJ,,323.18,1215.51
6150,7/15/2020,7/15/2020,71520,To reverse 82L payroll 0715 JE-21-0008-Reverse payroll entry 07152020 IMPORT PAYROLL,D108,HJ,,323.96,891.55
6150,7/15/2020,7/15/2020,71520,To reverse 82L payroll 0715 JE-21-0008-Reverse payroll entry 07152020 IMPORT PAYROLL,D108,HJ,,327.43,564.12
6150,7/15/2020,7/15/2020,71520,To reverse 82L payroll 0715 JE-21-0008-Reverse payroll entry 07152020 IMPORT PAYROLL,D108,HJ,,341.21,222.91
6150,7/15/2020,7/15/2020,71520,82L-IMPORT PAYROLL-ANTHONY BETTY S,D108,HJ,41.85,,264.76
6150,7/15/2020,7/15/2020,71520,82L-IMPORT PAYROLL-ANTHONY BETTY S,D108,HJ,178.96,,443.72
6150,7/15/2020,7/15/2020,71520,82L-IMPORT PAYROLL-AUSTIN PERCY,D108,HJ,36.34,,480.06
6150,7/15/2020,7/15/2020,71520,82L-IMPORT PAYROLL-AUSTIN PERCY,D108,HJ,155.39,,635.45
6150,7/15/2020,7/15/2020,71520,82L-IMPORT PAYROLL-BANDA STEPHANY,D108,HJ,16.84,,652.29
6150,7/15/2020,7/15/2020,71520,82L-IMPORT PAYROLL-BANDA STEPHANY,D108,HJ,72.01,,724.3
6150,7/15/2020,7/15/2020,71520,82L-IMPORT PAYROLL-BAUSH DANIEL,D108,HJ,63.35,,787.65
6150,7/15/2020,7/15/2020,71520,82L-IMPORT PAYROLL-BAUSH DANIEL,D108,HJ,270.86,,1058.51
6150,7/15/2020,7/15/2020,71520,82L-IMPORT PAYROLL-CHAPMAN CLAUDY EARL,D108,HJ,26.56,,1085.07
6150,7/15/2020,7/15/2020,71520,82L-IMPORT PAYROLL-CHAPMAN CLAUDY EARL,D108,HJ,113.56,,1198.63
6150,7/15/2020,7/15/2020,71520,82L-IMPORT PAYROLL-DADA ARIKPO E,D108,HJ,30.83,,1229.46
6150,7/15/2020,7/15/2020,71520,82L-IMPORT PAYROLL-DADA ARIKPO E,D108,HJ,131.84,,1361.3
6150,7/15/2020,7/15/2020,71520,82L-IMPORT PAYROLL-GUTHRIE LESLIE,D108,HJ,33.42,,1394.72
6150,7/15/2020,7/15/2020,71520,82L-IMPORT PAYROLL-GUTHRIE LESLIE,D108,HJ,142.9,,1537.62
6150,7/15/2020,7/15/2020,71520,82L-IMPORT PAYROLL-HOLMES JOREL ALEXANDER,D108,HJ,31.22,,1568.84
6150,7/15/2020,7/15/2020,71520,82L-IMPORT PAYROLL-HOLMES JOREL ALEXANDER,D108,HJ,133.51,,1702.35
6150,7/15/2020,7/15/2020,71520,82L-IMPORT PAYROLL-JORDAN TIFFANY T,D108,HJ,79.8,,1782.15
6150,7/15/2020,7/15/2020,71520,82L-IMPORT PAYROLL-JORDAN TIFFANY T,D108,HJ,341.21,,2123.36
6150,7/15/2020,7/15/2020,71520,82L-IMPORT PAYROLL-KAMYA MIRIAM L,D108,HJ,40.11,,2163.47
6150,7/15/2020,7/15/2020,71520,82L-IMPORT PAYROLL-KAMYA MIRIAM L,D108,HJ,171.49,,2334.96
6150,7/15/2020,7/15/2020,71520,82L-IMPORT PAYROLL-LANIGAN LISA A,D108,HJ,75.77,,2410.73
6150,7/15/2020,7/15/2020,71520,82L-IMPORT PAYROLL-LANIGAN LISA A,D108,HJ,323.96,,2734.69
6150,7/15/2020,7/15/2020,71520,82L-IMPORT PAYROLL-LEVERET LILY A,D108,HJ,16.68,,2751.37
6150,7/15/2020,7/15/2020,71520,82L-IMPORT PAYROLL-LEVERET LILY A,D108,HJ,71.3,,2822.67
6150,7/15/2020,7/15/2020,71520,82L-IMPORT PAYROLL-MCELWEE MELISSA,D108,HJ,28.55,,2851.22
6150,7/15/2020,7/15/2020,71520,82L-IMPORT PAYROLL-MCELWEE MELISSA,D108,HJ,122.09,,2973.31
6150,7/15/2020,7/15/2020,71520,82L-IMPORT PAYROLL-MCNICHOLAS MARY,D108,HJ,33.23,,3006.54
6150,7/15/2020,7/15/2020,71520,82L-IMPORT PAYROLL-MCNICHOLAS MARY,D108,HJ,142.08,,3148.62
6150,7/15/2020,7/15/2020,71520,82L-IMPORT PAYROLL-NWAKANMA NANCY,D108,HJ,42.32,,3190.94
6150,7/15/2020,7/15/2020,71520,82L-IMPORT PAYROLL-NWAKANMA NANCY,D108,HJ,180.94,,3371.88
6150,7/15/2020,7/15/2020,71520,82L-IMPORT PAYROLL-ONICA ANTHONY J,D108,HJ,15.7,,3387.58
6150,7/15/2020,7/15/2020,71520,82L-IMPORT PAYROLL-ONICA ANTHONY J,D108,HJ,67.13,,3454.71
6150,7/15/2020,7/15/2020,71520,82L-IMPORT PAYROLL-PRAHIN NICOLE M,D108,HJ,73.21,,3527.92
6150,7/15/2020,7/15/2020,71520,82L-IMPORT PAYROLL-PRAHIN NICOLE M,D108,HJ,313.02,,3840.94
6150,7/15/2020,7/15/2020,71520,82L-IMPORT PAYROLL-RIVERS QUIONNA DIANE,D108,HJ,36.46,,3877.4
6150,7/15/2020,7/15/2020,71520,82L-IMPORT PAYROLL-RIVERS QUIONNA DIANE,D108,HJ,155.89,,4033.29
6150,7/15/2020,7/15/2020,71520,82L-IMPORT PAYROLL-SALIM YASSER,D108,HJ,33.1,,4066.39
6150,7/15/2020,7/15/2020,71520,82L-IMPORT PAYROLL-SALIM YASSER,D108,HJ,141.55,,4207.94
6150,7/15/2020,7/15/2020,71520,82L-IMPORT PAYROLL-SEJOUR MAHALIAH,D108,HJ,34.07,,4242.01
6150,7/15/2020,7/15/2020,71520,82L-IMPORT PAYROLL-SEJOUR MAHALIAH,D108,HJ,145.66,,4387.67
6150,7/15/2020,7/15/2020,71520,82L-IMPORT PAYROLL-SKALSKI CHRISTOPHER,D108,HJ,33.86,,4421.53
6150,7/15/2020,7/15/2020,71520,82L-IMPORT PAYROLL-SKALSKI CHRISTOPHER,D108,HJ,144.76,,4566.29
6150,7/15/2020,7/15/2020,71520,82L-IMPORT PAYROLL-SMITH AKILAH,D108,HJ,16.84,,4583.13
6150,7/15/2020,7/15/2020,71520,82L-IMPORT PAYROLL-SMITH AKILAH,D108,HJ,71.98,,4655.11
6150,7/15/2020,7/15/2020,71520,82L-IMPORT PAYROLL-TAM CW RYAN,D108,HJ,16.65,,4671.76
6150,7/15/2020,7/15/2020,71520,82L-IMPORT PAYROLL-TAM CW RYAN,D108,HJ,71.19,,4742.95
6150,7/15/2020,7/15/2020,71520,82L-IMPORT PAYROLL-TENESACA VERONICA A,D108,HJ,17.5,,4760.45
6150,7/15/2020,7/15/2020,71520,82L-IMPORT PAYROLL-TENESACA VERONICA A,D108,HJ,74.84,,4835.29
6150,7/15/2020,7/15/2020,71520,82L-IMPORT PAYROLL-TUMENJARGAL ENKHJIN,D108,HJ,32.92,,4868.21
6150,7/15/2020,7/15/2020,71520,82L-IMPORT PAYROLL-TUMENJARGAL ENKHJIN,D108,HJ,140.75,,5008.96
6150,7/15/2020,7/15/2020,71520,82L-IMPORT PAYROLL-VILLEGAS EVELYN,D108,HJ,33.4,,5042.36
6150,7/15/2020,7/15/2020,71520,82L-IMPORT PAYROLL-VILLEGAS EVELYN,D108,HJ,142.81,,5185.17
6150,7/15/2020,7/15/2020,71520,82L-IMPORT PAYROLL-WOLF ANNA A,D108,HJ,36.3,,5221.47
6150,7/15/2020,7/15/2020,71520,82L-IMPORT PAYROLL-WOLF ANNA A,D108,HJ,155.19,,5376.66
6150,7/15/2020,7/15/2020,71520,82L-PRPD-071520 -Import Payroll (PPP)-ACEVEDO MONIVETT,D103,HJ,72.42,,5449.08
6150,7/15/2020,7/15/2020,71520,82L-PRPD-071520 -Import Payroll (PPP)-ACEVEDO MONIVETT,D103,HJ,309.64,,5758.72
6150,7/15/2020,7/15/2020,71520,82L-PRPD-071520 -Import Payroll (PPP)-COOK CATHRYN ANNA,D105,HJ,72.06,,5830.78
6150,7/15/2020,7/15/2020,71520,82L-PRPD-071520 -Import Payroll (PPP)-COOK CATHRYN ANNA,D105,HJ,308.13,,6138.91
6150,7/15/2020,7/15/2020,71520,82L-PRPD-071520 -Import Payroll (PPP)-DETONE KYRA MAYA,D102,HJ,39,,6177.91
6150,7/15/2020,7/15/2020,71520,82L-PRPD-071520 -Import Payroll (PPP)-DETONE KYRA MAYA,D102,HJ,166.75,,6344.66
6150,7/15/2020,7/15/2020,71520,82L-PRPD-071520 -Import Payroll (PPP)-DUPUIS CHRISTOPHER M,D108,HJ,88.74,,6433.4
6150,7/15/2020,7/15/2020,71520,82L-PRPD-071520 -Import Payroll (PPP)-DUPUIS CHRISTOPHER M,D108,HJ,379.45,,6812.85
6150,7/15/2020,7/15/2020,71520,82L-PRPD-071520 -Import Payroll (PPP)-GUTIERREZ ANTONIO J,D102,HJ,74.25,,6887.1
6150,7/15/2020,7/15/2020,71520,82L-PRPD-071520 -Import Payroll (PPP)-GUTIERREZ ANTONIO J,D102,HJ,317.48,,7204.58
6150,7/15/2020,7/15/2020,71520,82L-PRPD-071520 -Import Payroll (PPP)-MASON ANGELA,D111,HJ,78.57,,7283.15
6150,7/15/2020,7/15/2020,71520,82L-PRPD-071520 -Import Payroll (PPP)-MASON ANGELA,D111,HJ,335.97,,7619.12
6150,7/15/2020,7/15/2020,71520,82L-PRPD-071520 -Import Payroll (PPP)-POLANCO ODALIS,D103,HJ,70.41,,7689.53
6150,7/15/2020,7/15/2020,71520,82L-PRPD-071520 -Import Payroll (PPP)-POLANCO ODALIS,D103,HJ,301.08,,7990.61
6150,7/15/2020,7/15/2020,71520,82L-PRPD-071520 -Import Payroll (PPP)-SAFRAN ALAN P,D102,HJ,108.43,,8099.04
6150,7/15/2020,7/15/2020,71520,82L-PRPD-071520 -Import Payroll (PPP)-SAFRAN ALAN P,D102,HJ,463.62,,8562.66
6150,7/15/2020,7/15/2020,71520,82L-PRPD-071520 -Import Payroll (PPP)-SHI GRACE,D103,HJ,12.12,,8574.78
6150,7/15/2020,7/15/2020,71520,82L-PRPD-071520 -Import Payroll (PPP)-SHI GRACE,D103,HJ,35.34,,8610.12
6150,7/15/2020,7/15/2020,71520,82L-PRPD-071520 -Import Payroll (PPP)-SHI GRACE,D103,HJ,51.84,,8661.96
6150,7/15/2020,7/15/2020,71520,82L-IMPORT PAYROLL-AKLESTAD ISABEL,D111,HJ,27.97,,8689.93
6150,7/15/2020,7/15/2020,71520,82L-IMPORT PAYROLL-AKLESTAD ISABEL,D111,HJ,119.61,,8809.54
6150,7/15/2020,7/15/2020,71520,82L-IMPORT PAYROLL-ALLEN KIMBERLY MARY,D111,HJ,31.49,,8841.03
6150,7/15/2020,7/15/2020,71520,82L-IMPORT PAYROLL-ALLEN KIMBERLY MARY,D111,HJ,134.65,,8975.68
6150,7/15/2020,7/15/2020,71520,82L-IMPORT PAYROLL-BOWMAN HALLEY K,D101,HJ,70.69,,9046.37
6150,7/15/2020,7/15/2020,71520,82L-IMPORT PAYROLL-BOWMAN HALLEY K,D101,HJ,302.25,,9348.62
6150,7/15/2020,7/15/2020,71520,82L-IMPORT PAYROLL-COOPER ASHLEE R,D101,HJ,33.87,,9382.49
6150,7/15/2020,7/15/2020,71520,82L-IMPORT PAYROLL-COOPER ASHLEE R,D101,HJ,144.81,,9527.3
6150,7/15/2020,7/15/2020,71520,82L-IMPORT PAYROLL-CORTEZ MIRANDA A,D111,HJ,50.89,,9578.19
6150,7/15/2020,7/15/2020,71520,82L-IMPORT PAYROLL-CORTEZ MIRANDA A,D111,HJ,217.6,,9795.79
6150,7/15/2020,7/15/2020,71520,82L-IMPORT PAYROLL-DAUGHERTY DEVIN W,D101,HJ,15.1,,9810.89
6150,7/15/2020,7/15/2020,71520,82L-IMPORT PAYROLL-DAUGHERTY DEVIN W,D101,HJ,64.58,,9875.47
6150,7/15/2020,7/15/2020,71520,82L-IMPORT PAYROLL-DZIEDZIC JULIE K,D101,HJ,18.13,,9893.6
6150,7/15/2020,7/15/2020,71520,82L-IMPORT PAYROLL-DZIEDZIC JULIE K,D101,HJ,77.5,,9971.1
6150,7/15/2020,7/15/2020,71520,82L-IMPORT PAYROLL-GORNSTEIN STEVEN,D101,HJ,39.27,,10010.37
6150,7/15/2020,7/15/2020,71520,82L-IMPORT PAYROLL-GORNSTEIN STEVEN,D101,HJ,114.45,,10124.82
6150,7/15/2020,7/15/2020,71520,82L-IMPORT PAYROLL-GORNSTEIN STEVEN,D101,HJ,167.92,,10292.74
6150,7/15/2020,7/15/2020,71520,82L-IMPORT PAYROLL-GRAVES KAMIESHIA,D101,HJ,15.61,,10308.35
6150,7/15/2020,7/15/2020,71520,82L-IMPORT PAYROLL-GRAVES KAMIESHIA,D101,HJ,66.75,,10375.1
6150,7/15/2020,7/15/2020,71520,82L-IMPORT PAYROLL-GUADARRAMA-ALVAREZ URIEL A,D105,HJ,58.78,,10433.88
6150,7/15/2020,7/15/2020,71520,82L-IMPORT PAYROLL-GUADARRAMA-ALVAREZ URIEL A,D105,HJ,251.35,,10685.23
6150,7/15/2020,7/15/2020,71520,82L-IMPORT PAYROLL-LACEY DEQUITA,D107,HJ,35.7,,10720.93
6150,7/15/2020,7/15/2020,71520,82L-IMPORT PAYROLL-LACEY DEQUITA,D107,HJ,152.64,,10873.57
6150,7/15/2020,7/15/2020,71520,82L-IMPORT PAYROLL-LIPORACE HERNAN LUIS,D103,HJ,24.36,,10897.93
6150,7/15/2020,7/15/2020,71520,82L-IMPORT PAYROLL-LIPORACE HERNAN LUIS,D103,HJ,45.37,,10943.3
6150,7/15/2020,7/15/2020,71520,82L-IMPORT PAYROLL-LIPORACE HERNAN LUIS,D103,HJ,104.18,,11047.48
6150,7/15/2020,7/15/2020,71520,82L-IMPORT PAYROLL-ODONNELL STEPHEN,D104,HJ,53.76,,11101.24
6150,7/15/2020,7/15/2020,71520,82L-IMPORT PAYROLL-ODONNELL STEPHEN,D104,HJ,229.87,,11331.11
6150,7/15/2020,7/15/2020,71520,82L-IMPORT PAYROLL-PARHAM-GANTT DENISE M,D112,HJ,37.96,,11369.07
6150,7/15/2020,7/15/2020,71520,82L-IMPORT PAYROLL-PARHAM-GANTT DENISE M,D112,HJ,162.32,,11531.39
6150,7/15/2020,7/15/2020,71520,82L-IMPORT PAYROLL-PEINADO ELIZABETH R,D111,HJ,52.29,,11583.68
6150,7/15/2020,7/15/2020,71520,82L-IMPORT PAYROLL-PEINADO ELIZABETH R,D111,HJ,223.58,,11807.26
6150,7/15/2020,7/15/2020,71520,82L-IMPORT PAYROLL-RANDOLPH ALEXANDER,D111,HJ,13.77,,11821.03
6150,7/15/2020,7/15/2020,71520,82L-IMPORT PAYROLL-RANDOLPH ALEXANDER,D111,HJ,30.12,,11851.15
6150,7/15/2020,7/15/2020,71520,82L-IMPORT PAYROLL-RANDOLPH ALEXANDER,D111,HJ,59.97,,11911.12
6150,7/15/2020,7/15/2020,71520,82L-IMPORT PAYROLL-RANDOLPH ALEXANDER,D111,HJ,128.79,,12039.91
6150,7/15/2020,7/15/2020,71520,82L-IMPORT PAYROLL-SHENKMAN OLIVIA,D101,HJ,29,,12068.91
6150,7/15/2020,7/15/2020,71520,82L-IMPORT PAYROLL-SHENKMAN OLIVIA,D101,HJ,124,,12192.91
6150,7/15/2020,7/15/2020,71520,82L-IMPORT PAYROLL-WALLACE AMENA T,D104,HJ,28.93,,12221.84
6150,7/15/2020,7/15/2020,71520,82L-IMPORT PAYROLL-WALLACE AMENA T,D104,HJ,123.72,,12345.56
6150,7/15/2020,7/15/2020,71520,82L-IMPORT PAYROLL-WEINSTOCK EMILY,D101,HJ,17.57,,12363.13
6150,7/15/2020,7/15/2020,71520,82L-IMPORT PAYROLL-WEINSTOCK EMILY,D101,HJ,41.08,,12404.21
6150,7/15/2020,7/15/2020,71520,82L-IMPORT PAYROLL-WEINSTOCK EMILY,D101,HJ,76.5,,12480.71
6150,7/15/2020,7/15/2020,71520,82L-IMPORT PAYROLL-WEINSTOCK EMILY,D101,HJ,175.67,,12656.38
6150,7/15/2020,7/15/2020,71520,82L-IMPORT PAYROLL-WINANS JENNIFER,D111,HJ,44.6,,12700.98
6150,7/15/2020,7/15/2020,71520,82L-IMPORT PAYROLL-WINANS JENNIFER,D111,HJ,190.69,,12891.67
6150,7/15/2020,7/15/2020,71520,82L-IMPORT PAYROLL-ZARATE JOSEPH M,D105,HJ,33.77,,12925.44
6150,7/15/2020,7/15/2020,71520,82L-IMPORT PAYROLL-ZARATE JOSEPH M,D105,HJ,144.4,,13069.84
6150,7/15/2020,7/15/2020,71520,82L-IMPORT PAYROLL-BARTOLD DEANNA MARIE,D108,HJ,41.91,,13111.75
6150,7/15/2020,7/15/2020,71520,82L-IMPORT PAYROLL-BARTOLD DEANNA MARIE,D108,HJ,179.22,,13290.97
6150,7/15/2020,7/15/2020,71520,82L-IMPORT PAYROLL-BELLOT GENESIS,D108,HJ,18.74,,13309.71
6150,7/15/2020,7/15/2020,71520,82L-IMPORT PAYROLL-BELLOT GENESIS,D108,HJ,80.12,,13389.83
6150,7/15/2020,7/15/2020,71520,82L-IMPORT PAYROLL-CIRKER MIA,D108,HJ,21.08,,13410.91
6150,7/15/2020,7/15/2020,71520,82L-IMPORT PAYROLL-CIRKER MIA,D108,HJ,90.13,,13501.04
6150,7/15/2020,7/15/2020,71520,82L-IMPORT PAYROLL-FEIGHERY JOHN,D108,HJ,19.02,,13520.06
6150,7/15/2020,7/15/2020,71520,82L-IMPORT PAYROLL-FEIGHERY JOHN,D108,HJ,81.33,,13601.39
6150,7/15/2020,7/15/2020,71520,82L-IMPORT PAYROLL-GARCIA MARILYN,D108,HJ,21.47,,13622.86
6150,7/15/2020,7/15/2020,71520,82L-IMPORT PAYROLL-GARCIA MARILYN,D108,HJ,91.8,,13714.66
6150,7/15/2020,7/15/2020,71520,82L-IMPORT PAYROLL-GARNER IVORY,D108,HJ,24.36,,13739.02
6150,7/15/2020,7/15/2020,71520,82L-IMPORT PAYROLL-GARNER IVORY,D108,HJ,104.16,,13843.18
6150,7/15/2020,7/15/2020,71520,82L-IMPORT PAYROLL-GRIFFIN ANDREW,D108,HJ,18.07,,13861.25
6150,7/15/2020,7/15/2020,71520,82L-IMPORT PAYROLL-GRIFFIN ANDREW,D108,HJ,77.26,,13938.51
6150,7/15/2020,7/15/2020,71520,82L-IMPORT PAYROLL-HALLINAN GABRIEL B,D108,HJ,34.79,,13973.3
6150,7/15/2020,7/15/2020,71520,82L-IMPORT PAYROLL-HALLINAN GABRIEL B,D108,HJ,148.76,,14122.06
6150,7/15/2020,7/15/2020,71520,82L-IMPORT PAYROLL-HOLDER LATIVA M,D108,HJ,75.58,,14197.64
6150,7/15/2020,7/15/2020,71520,82L-IMPORT PAYROLL-HOLDER LATIVA M,D108,HJ,323.18,,14520.82
6150,7/15/2020,7/15/2020,71520,82L-IMPORT PAYROLL-HOSSAIN MYESHA R,D108,HJ,35.81,,14556.63
6150,7/15/2020,7/15/2020,71520,82L-IMPORT PAYROLL-HOSSAIN MYESHA R,D108,HJ,153.12,,14709.75
6150,7/15/2020,7/15/2020,71520,82L-IMPORT PAYROLL-JACKSON TASNIM F,D108,HJ,31,,14740.75
6150,7/15/2020,7/15/2020,71520,82L-IMPORT PAYROLL-JACKSON TASNIM F,D108,HJ,132.56,,14873.31
6150,7/15/2020,7/15/2020,71520,82L-IMPORT PAYROLL-LI BELLA,D108,HJ,33.96,,14907.27
6150,7/15/2020,7/15/2020,71520,82L-IMPORT PAYROLL-LI BELLA,D108,HJ,145.23,,15052.5
6150,7/15/2020,7/15/2020,71520,82L-IMPORT PAYROLL-MOSELEY ARIELLE,D108,HJ,37.83,,15090.33
6150,7/15/2020,7/15/2020,71520,82L-IMPORT PAYROLL-MOSELEY ARIELLE,D108,HJ,161.75,,15252.08
6150,7/15/2020,7/15/2020,71520,82L-IMPORT PAYROLL-TILLERY ASIA,D108,HJ,47.73,,15299.81
6150,7/15/2020,7/15/2020,71520,82L-IMPORT PAYROLL-TILLERY ASIA,D108,HJ,204.08,,15503.89
6150,7/15/2020,7/15/2020,71520,82L-IMPORT PAYROLL-BALASUBRAMANIAN SHARANYA,D108,HJ,38.67,,15542.56
6150,7/15/2020,7/15/2020,71520,82L-IMPORT PAYROLL-BALASUBRAMANIAN SHARANYA,D108,HJ,93.33,,15635.89
6150,7/15/2020,7/15/2020,71520,82L-IMPORT PAYROLL-BALASUBRAMANIAN SHARANYA,D108,HJ,165.33,,15801.22
6150,7/15/2020,7/15/2020,71520,82L-IMPORT PAYROLL-COVENEY ALLISON,D108,HJ,38.07,,15839.29
6150,7/15/2020,7/15/2020,71520,82L-IMPORT PAYROLL-COVENEY ALLISON,D108,HJ,162.79,,16002.08
6150,7/15/2020,7/15/2020,71520,82L-IMPORT PAYROLL-GRAVES KIRA B,D101,HJ,16.16,,16018.24
6150,7/15/2020,7/15/2020,71520,82L-IMPORT PAYROLL-GRAVES KIRA B,D101,HJ,35.7,,16053.94
6150,7/15/2020,7/15/2020,71520,82L-IMPORT PAYROLL-GRAVES KIRA B,D101,HJ,152.64,,16206.58
6150,7/15/2020,7/15/2020,71520,82L-IMPORT PAYROLL-JACKSON CLAICE M,D108,HJ,24.74,,16231.32
6150,7/15/2020,7/15/2020,71520,82L-IMPORT PAYROLL-JACKSON CLAICE M,D108,HJ,55.46,,16286.78
6150,7/15/2020,7/15/2020,71520,82L-IMPORT PAYROLL-JACKSON CLAICE M,D108,HJ,237.13,,16523.91
6150,7/15/2020,7/15/2020,71520,82L-IMPORT PAYROLL-JANG DANIEL,D108,HJ,37.75,,16561.66
6150,7/15/2020,7/15/2020,71520,82L-IMPORT PAYROLL-JANG DANIEL,D108,HJ,161.4,,16723.06
6150,7/15/2020,7/15/2020,71520,82L-IMPORT PAYROLL-LENEGHAN MARYELLEN B,D108,HJ,33.64,,16756.7
6150,7/15/2020,7/15/2020,71520,82L-IMPORT PAYROLL-LENEGHAN MARYELLEN B,D108,HJ,76.58,,16833.28
6150,7/15/2020,7/15/2020,71520,82L-IMPORT PAYROLL-LENEGHAN MARYELLEN B,D108,HJ,327.43,,17160.71
6150,7/31/2020,7/31/2020,73120,82L-IMPORT PAYROLL-ALVAREZ-MORINE LISIS,D108,HJ,34.02,,17194.73
6150,7/31/2020,7/31/2020,73120,82L-IMPORT PAYROLL-ALVAREZ-MORINE LISIS,D108,HJ,63.34,,17258.07
6150,7/31/2020,7/31/2020,73120,82L-IMPORT PAYROLL-ALVAREZ-MORINE LISIS,D108,HJ,145.46,,17403.53
6150,7/31/2020,7/31/2020,73120,82L-IMPORT PAYROLL-KOPSHEVER MELISSA,D108,HJ,42.29,,17445.82
6150,7/31/2020,7/31/2020,73120,82L-IMPORT PAYROLL-KOPSHEVER MELISSA,D108,HJ,78.75,,17524.57
6150,7/31/2020,7/31/2020,73120,82L-IMPORT PAYROLL-KOPSHEVER MELISSA,D108,HJ,180.83,,17705.4
6150,7/31/2020,7/31/2020,73120,82L-IMPORT PAYROLL-LIPSCOMB STEPHEN,D108,HJ,27.34,,17732.74
6150,7/31/2020,7/31/2020,73120,82L-IMPORT PAYROLL-LIPSCOMB STEPHEN,D108,HJ,50.92,,17783.66
6150,7/31/2020,7/31/2020,73120,82L-IMPORT PAYROLL-LIPSCOMB STEPHEN,D108,HJ,116.92,,17900.58
6150,7/31/2020,7/31/2020,73120,82L-IMPORT PAYROLL-ROBBINS DEANNA,D108,HJ,36.85,,17937.43
6150,7/31/2020,7/31/2020,73120,82L-IMPORT PAYROLL-ROBBINS DEANNA,D108,HJ,68.63,,18006.06
6150,7/31/2020,7/31/2020,73120,82L-IMPORT PAYROLL-ROBBINS DEANNA,D108,HJ,157.58,,18163.64
6150,7/31/2020,7/31/2020,73120,82L-IMPORT PAYROLL-SILVER KELLY,D108,HJ,31.79,,18195.43
6150,7/31/2020,7/31/2020,73120,82L-IMPORT PAYROLL-SILVER KELLY,D108,HJ,59.2,,18254.63
6150,7/31/2020,7/31/2020,73120,82L-IMPORT PAYROLL-SILVER KELLY,D108,HJ,135.94,,18390.57
6150,7/31/2020,7/31/2020,73120,82L-PRPD-073120 -Import Payroll-ACEVEDO MONIVETT,D108,HJ,72.42,,18462.99
6150,7/31/2020,7/31/2020,73120,82L-PRPD-073120 -Import Payroll-ACEVEDO MONIVETT,D108,HJ,309.64,,18772.63
6150,7/31/2020,7/31/2020,73120,82L-PRPD-073120 -Import Payroll-AKLESTAD ISABEL,D108,HJ,23.29,,18795.92
6150,7/31/2020,7/31/2020,73120,82L-PRPD-073120 -Import Payroll-AKLESTAD ISABEL,D108,HJ,99.58,,18895.5
6150,7/31/2020,7/31/2020,73120,82L-PRPD-073120 -Import Payroll-ALLEN KIMBERLY MARY,D108,HJ,26.58,,18922.08
6150,7/31/2020,7/31/2020,73120,82L-PRPD-073120 -Import Payroll-ALLEN KIMBERLY MARY,D108,HJ,113.67,,19035.75
6150,7/31/2020,7/31/2020,73120,82L-PRPD-073120 -Import Payroll-ALVAREZ-MORINE LISIS,D108,HJ,34.02,,19069.77
6150,7/31/2020,7/31/2020,73120,82L-PRPD-073120 -Import Payroll-ALVAREZ-MORINE LISIS,D108,HJ,63.34,,19133.11
6150,7/31/2020,7/31/2020,73120,82L-PRPD-073120 -Import Payroll-ALVAREZ-MORINE LISIS,D108,HJ,145.46,,19278.57
6150,7/31/2020,7/31/2020,73120,82L-PRPD-073120 -Import Payroll-ANTHONY BETTY S,D108,HJ,41.85,,19320.42
6150,7/31/2020,7/31/2020,73120,82L-PRPD-073120 -Import Payroll-ANTHONY BETTY S,D108,HJ,178.96,,19499.38
6150,7/31/2020,7/31/2020,73120,82L-PRPD-073120 -Import Payroll-ARCHER AUBREYNA,D108,HJ,39.86,,19539.24
6150,7/31/2020,7/31/2020,73120,82L-PRPD-073120 -Import Payroll-ARCHER AUBREYNA,D108,HJ,170.44,,19709.68
6150,7/31/2020,7/31/2020,73120,82L-PRPD-073120 -Import Payroll-AUSTIN PERCY,D108,HJ,36.34,,19746.02
6150,7/31/2020,7/31/2020,73120,82L-PRPD-073120 -Import Payroll-AUSTIN PERCY,D108,HJ,155.39,,19901.41
6150,7/31/2020,7/31/2020,73120,82L-PRPD-073120 -Import Payroll-BALASUBRAMANIAN SHARANYA,D108,HJ,38.67,,19940.08
6150,7/31/2020,7/31/2020,73120,82L-PRPD-073120 -Import Payroll-BALASUBRAMANIAN SHARANYA,D108,HJ,93.33,,20033.41
6150,7/31/2020,7/31/2020,73120,82L-PRPD-073120 -Import Payroll-BALASUBRAMANIAN SHARANYA,D108,HJ,165.33,,20198.74
6150,7/31/2020,7/31/2020,73120,82L-PRPD-073120 -Import Payroll-BANDA STEPHANY,D108,HJ,18.18,,20216.92
6150,7/31/2020,7/31/2020,73120,82L-PRPD-073120 -Import Payroll-BANDA STEPHANY,D108,HJ,77.72,,20294.64
6150,7/31/2020,7/31/2020,73120,82L-PRPD-073120 -Import Payroll-BARTOLD DEANNA MARIE,D108,HJ,41.91,,20336.55
6150,7/31/2020,7/31/2020,73120,82L-PRPD-073120 -Import Payroll-BARTOLD DEANNA MARIE,D108,HJ,179.22,,20515.77
6150,7/31/2020,7/31/2020,73120,82L-PRPD-073120 -Import Payroll-BAUSH DANIEL,D108,HJ,63.35,,20579.12
6150,7/31/2020,7/31/2020,73120,82L-PRPD-073120 -Import Payroll-BAUSH DANIEL,D108,HJ,270.86,,20849.98
6150,7/31/2020,7/31/2020,73120,82L-PRPD-073120 -Import Payroll-BELLOT GENESIS,D108,HJ,31.93,,20881.91
6150,7/31/2020,7/31/2020,73120,82L-PRPD-073120 -Import Payroll-BELLOT GENESIS,D108,HJ,136.53,,21018.44
6150,7/31/2020,7/31/2020,73120,82L-PRPD-073120 -Import Payroll-BOWMAN HALLEY K,D108,HJ,49.84,,21068.28
6150,7/31/2020,7/31/2020,73120,82L-PRPD-073120 -Import Payroll-BOWMAN HALLEY K,D108,HJ,213.13,,21281.41
6150,7/31/2020,7/31/2020,73120,82L-PRPD-073120 -Import Payroll-CHAPMAN CLAUDY EARL,D108,HJ,26.38,,21307.79
6150,7/31/2020,7/31/2020,73120,82L-PRPD-073120 -Import Payroll-CHAPMAN CLAUDY EARL,D108,HJ,112.81,,21420.6
6150,7/31/2020,7/31/2020,73120,82L-PRPD-073120 -Import Payroll-CIRKER MIA,D108,HJ,32.63,,21453.23
6150,7/31/2020,7/31/2020,73120,82L-PRPD-073120 -Import Payroll-CIRKER MIA,D108,HJ,139.5,,21592.73
6150,7/31/2020,7/31/2020,73120,82L-PRPD-073120 -Import Payroll-COOK CATHRYN ANNA,D108,HJ,49.87,,21642.6
6150,7/31/2020,7/31/2020,73120,82L-PRPD-073120 -Import Payroll-COOK CATHRYN ANNA,D108,HJ,213.25,,21855.85
6150,7/31/2020,7/31/2020,73120,82L-PRPD-073120 -Import Payroll-COOPER ASHLEE R,D108,HJ,33.51,,21889.36
6150,7/31/2020,7/31/2020,73120,82L-PRPD-073120 -Import Payroll-COOPER ASHLEE R,D108,HJ,143.3,,22032.66
6150,7/31/2020,7/31/2020,73120,82L-PRPD-073120 -Import Payroll-CORTEZ MIRANDA A,D108,HJ,38.45,,22071.11
6150,7/31/2020,7/31/2020,73120,82L-PRPD-073120 -Import Payroll-CORTEZ MIRANDA A,D108,HJ,164.42,,22235.53
6150,7/31/2020,7/31/2020,73120,82L-PRPD-073120 -Import Payroll-COVENEY ALLISON,D108,HJ,38.07,,22273.6
6150,7/31/2020,7/31/2020,73120,82L-PRPD-073120 -Import Payroll-COVENEY ALLISON,D108,HJ,162.79,,22436.39
6150,7/31/2020,7/31/2020,73120,82L-PRPD-073120 -Import Payroll-DADA ARIKPO E,D108,HJ,32.04,,22468.43
6150,7/31/2020,7/31/2020,73120,82L-PRPD-073120 -Import Payroll-DADA ARIKPO E,D108,HJ,137,,22605.43
6150,7/31/2020,7/31/2020,73120,82L-PRPD-073120 -Import Payroll-DAUGHERTY DEVIN W,D108,HJ,15.1,,22620.53
6150,7/31/2020,7/31/2020,73120,82L-PRPD-073120 -Import Payroll-DAUGHERTY DEVIN W,D108,HJ,64.58,,22685.11
6150,7/31/2020,7/31/2020,73120,82L-PRPD-073120 -Import Payroll-DETONE KYRA MAYA,D108,HJ,39,,22724.11
6150,7/31/2020,7/31/2020,73120,82L-PRPD-073120 -Import Payroll-DETONE KYRA MAYA,D108,HJ,166.75,,22890.86
6150,7/31/2020,7/31/2020,73120,82L-PRPD-073120 -Import Payroll-DUPUIS CHRISTOPHER M,D108,HJ,88.74,,22979.6
6150,7/31/2020,7/31/2020,73120,82L-PRPD-073120 -Import Payroll-DUPUIS CHRISTOPHER M,D108,HJ,379.45,,23359.05
6150,7/31/2020,7/31/2020,73120,82L-PRPD-073120 -Import Payroll-DZIEDZIC JULIE K,D108,HJ,17.71,,23376.76
6150,7/31/2020,7/31/2020,73120,82L-PRPD-073120 -Import Payroll-DZIEDZIC JULIE K,D108,HJ,75.71,,23452.47
6150,7/31/2020,7/31/2020,73120,82L-PRPD-073120 -Import Payroll-FEIGHERY JOHN,D108,HJ,30.56,,23483.03
6150,7/31/2020,7/31/2020,73120,82L-PRPD-073120 -Import Payroll-FEIGHERY JOHN,D108,HJ,130.69,,23613.72
6150,7/31/2020,7/31/2020,73120,82L-PRPD-073120 -Import Payroll-GARCIA MARILYN,D108,HJ,33.23,,23646.95
6150,7/31/2020,7/31/2020,73120,82L-PRPD-073120 -Import Payroll-GARCIA MARILYN,D108,HJ,142.08,,23789.03
6150,7/31/2020,7/31/2020,73120,82L-PRPD-073120 -Import Payroll-GARNER IVORY,D108,HJ,26.45,,23815.48
6150,7/31/2020,7/31/2020,73120,82L-PRPD-073120 -Import Payroll-GARNER IVORY,D108,HJ,113.09,,23928.57
6150,7/31/2020,7/31/2020,73120,82L-PRPD-073120 -Import Payroll-GORNSTEIN STEVEN,D108,HJ,39.27,,23967.84
6150,7/31/2020,7/31/2020,73120,82L-PRPD-073120 -Import Payroll-GORNSTEIN STEVEN,D108,HJ,114.45,,24082.29
6150,7/31/2020,7/31/2020,73120,82L-PRPD-073120 -Import Payroll-GORNSTEIN STEVEN,D108,HJ,167.92,,24250.21
6150,7/31/2020,7/31/2020,73120,82L-PRPD-073120 -Import Payroll-GRAVES KAMIESHIA,D108,HJ,26.3,,24276.51
6150,7/31/2020,7/31/2020,73120,82L-PRPD-073120 -Import Payroll-GRAVES KAMIESHIA,D108,HJ,112.45,,24388.96
6150,7/31/2020,7/31/2020,73120,82L-PRPD-073120 -Import Payroll-GRAVES KIRA B,D108,HJ,2.98,,24391.94
6150,7/31/2020,7/31/2020,73120,82L-PRPD-073120 -Import Payroll-GRAVES KIRA B,D108,HJ,6.98,,24398.92
6150,7/31/2020,7/31/2020,73120,82L-PRPD-073120 -Import Payroll-GRAVES KIRA B,D108,HJ,29.83,,24428.75
6150,7/31/2020,7/31/2020,73120,82L-PRPD-073120 -Import Payroll-GRIFFIN ANDREW,D108,HJ,30.44,,24459.19
6150,7/31/2020,7/31/2020,73120,82L-PRPD-073120 -Import Payroll-GRIFFIN ANDREW,D108,HJ,130.16,,24589.35
6150,7/31/2020,7/31/2020,73120,82L-PRPD-073120 -Import Payroll-GUADARRAMA-ALVAREZ URIEL A,D108,HJ,39.93,,24629.28
6150,7/31/2020,7/31/2020,73120,82L-PRPD-073120 -Import Payroll-GUADARRAMA-ALVAREZ URIEL A,D108,HJ,170.75,,24800.03
6150,7/31/2020,7/31/2020,73120,82L-PRPD-073120 -Import Payroll-GUTHRIE LESLIE,D108,HJ,33.42,,24833.45
6150,7/31/2020,7/31/2020,73120,82L-PRPD-073120 -Import Payroll-GUTHRIE LESLIE,D108,HJ,142.9,,24976.35
6150,7/31/2020,7/31/2020,73120,82L-PRPD-073120 -Import Payroll-GUTIERREZ ANTONIO J,D108,HJ,74.25,,25050.6
6150,7/31/2020,7/31/2020,73120,82L-PRPD-073120 -Import Payroll-GUTIERREZ ANTONIO J,D108,HJ,317.48,,25368.08
6150,7/31/2020,7/31/2020,73120,82L-PRPD-073120 -Import Payroll-HALLINAN GABRIEL B,D108,HJ,34.79,,25402.87
6150,7/31/2020,7/31/2020,73120,82L-PRPD-073120 -Import Payroll-HALLINAN GABRIEL B,D108,HJ,148.76,,25551.63
6150,7/31/2020,7/31/2020,73120,82L-PRPD-073120 -Import Payroll-HESTER TYLER CONRAD,D108,HJ,30.36,,25581.99
6150,7/31/2020,7/31/2020,73120,82L-PRPD-073120 -Import Payroll-HESTER TYLER CONRAD,D108,HJ,129.8,,25711.79
6150,7/31/2020,7/31/2020,73120,82L-PRPD-073120 -Import Payroll-HOLDER LATIVA M,D108,HJ,55.28,,25767.07
6150,7/31/2020,7/31/2020,73120,82L-PRPD-073120 -Import Payroll-HOLDER LATIVA M,D108,HJ,236.38,,26003.45
6150,7/31/2020,7/31/2020,73120,82L-PRPD-073120 -Import Payroll-HOLMES JOREL ALEXANDER,D108,HJ,31.22,,26034.67
6150,7/31/2020,7/31/2020,73120,82L-PRPD-073120 -Import Payroll-HOLMES JOREL ALEXANDER,D108,HJ,133.51,,26168.18
6150,7/31/2020,7/31/2020,73120,82L-PRPD-073120 -Import Payroll-HOSSAIN MYESHA R,D108,HJ,35.1,,26203.28
6150,7/31/2020,7/31/2020,73120,82L-PRPD-073120 -Import Payroll-HOSSAIN MYESHA R,D108,HJ,150.1,,26353.38
6150,7/31/2020,7/31/2020,73120,82L-PRPD-073120 -Import Payroll-JACKSON CLAICE M,D108,HJ,19.38,,26372.76
6150,7/31/2020,7/31/2020,73120,82L-PRPD-073120 -Import Payroll-JACKSON CLAICE M,D108,HJ,42.91,,26415.67
6150,7/31/2020,7/31/2020,73120,82L-PRPD-073120 -Import Payroll-JACKSON CLAICE M,D108,HJ,183.48,,26599.15
6150,7/31/2020,7/31/2020,73120,82L-PRPD-073120 -Import Payroll-JACKSON TASNIM F,D108,HJ,31,,26630.15
6150,7/31/2020,7/31/2020,73120,82L-PRPD-073120 -Import Payroll-JACKSON TASNIM F,D108,HJ,132.56,,26762.71
6150,7/31/2020,7/31/2020,73120,82L-PRPD-073120 -Import Payroll-JANG DANIEL,D108,HJ,37.75,,26800.46
6150,7/31/2020,7/31/2020,73120,82L-PRPD-073120 -Import Payroll-JANG DANIEL,D108,HJ,161.4,,26961.86
6150,7/31/2020,7/31/2020,73120,82L-PRPD-073120 -Import Payroll-JORDAN TIFFANY T,D108,HJ,45.87,,27007.73
6150,7/31/2020,7/31/2020,73120,82L-PRPD-073120 -Import Payroll-JORDAN TIFFANY T,D108,HJ,196.13,,27203.86
6150,7/31/2020,7/31/2020,73120,82L-PRPD-073120 -Import Payroll-KALOKOH BAINDU,D108,HJ,18.96,,27222.82
6150,7/31/2020,7/31/2020,73120,82L-PRPD-073120 -Import Payroll-KALOKOH BAINDU,D108,HJ,81.07,,27303.89
6150,7/31/2020,7/31/2020,73120,82L-PRPD-073120 -Import Payroll-KOPSHEVER MELISSA,D108,HJ,42.29,,27346.18
6150,7/31/2020,7/31/2020,73120,82L-PRPD-073120 -Import Payroll-KOPSHEVER MELISSA,D108,HJ,78.75,,27424.93
6150,7/31/2020,7/31/2020,73120,82L-PRPD-073120 -Import Payroll-KOPSHEVER MELISSA,D108,HJ,180.83,,27605.76
6150,7/31/2020,7/31/2020,73120,82L-PRPD-073120 -Import Payroll-LACEY DEQUITA,D108,HJ,35.7,,27641.46
6150,7/31/2020,7/31/2020,73120,82L-PRPD-073120 -Import Payroll-LACEY DEQUITA,D108,HJ,152.64,,27794.1
6150,7/31/2020,7/31/2020,73120,82L-PRPD-073120 -Import Payroll-LANIGAN LISA A,D108,HJ,45.1,,27839.2
6150,7/31/2020,7/31/2020,73120,82L-PRPD-073120 -Import Payroll-LANIGAN LISA A,D108,HJ,192.83,,28032.03
6150,7/31/2020,7/31/2020,73120,82L-PRPD-073120 -Import Payroll-LENEGHAN MARYELLEN B,D108,HJ,23.64,,28055.67
6150,7/31/2020,7/31/2020,73120,82L-PRPD-073120 -Import Payroll-LENEGHAN MARYELLEN B,D108,HJ,53.2,,28108.87
6150,7/31/2020,7/31/2020,73120,82L-PRPD-073120 -Import Payroll-LENEGHAN MARYELLEN B,D108,HJ,227.46,,28336.33
6150,7/31/2020,7/31/2020,73120,82L-PRPD-073120 -Import Payroll-LEVERET LILY A,D108,HJ,18.18,,28354.51
6150,7/31/2020,7/31/2020,73120,82L-PRPD-073120 -Import Payroll-LEVERET LILY A,D108,HJ,77.72,,28432.23
6150,7/31/2020,7/31/2020,73120,82L-PRPD-073120 -Import Payroll-LI BELLA,D108,HJ,33.96,,28466.19
6150,7/31/2020,7/31/2020,73120,82L-PRPD-073120 -Import Payroll-LI BELLA,D108,HJ,145.23,,28611.42
6150,7/31/2020,7/31/2020,73120,82L-PRPD-073120 -Import Payroll-LIPORACE HERNAN LUIS,D108,HJ,33.06,,28644.48
6150,7/31/2020,7/31/2020,73120,82L-PRPD-073120 -Import Payroll-LIPORACE HERNAN LUIS,D108,HJ,61.55,,28706.03
6150,7/31/2020,7/31/2020,73120,82L-PRPD-073120 -Import Payroll-LIPORACE HERNAN LUIS,D108,HJ,141.34,,28847.37
6150,7/31/2020,7/31/2020,73120,82L-PRPD-073120 -Import Payroll-LIPSCOMB STEPHEN,D108,HJ,27.34,,28874.71
6150,7/31/2020,7/31/2020,73120,82L-PRPD-073120 -Import Payroll-LIPSCOMB STEPHEN,D108,HJ,50.92,,28925.63
6150,7/31/2020,7/31/2020,73120,82L-PRPD-073120 -Import Payroll-LIPSCOMB STEPHEN,D108,HJ,116.92,,29042.55
6150,7/31/2020,7/31/2020,73120,82L-PRPD-073120 -Import Payroll-MASON ANGELA,D108,HJ,78.57,,29121.12
6150,7/31/2020,7/31/2020,73120,82L-PRPD-073120 -Import Payroll-MASON ANGELA,D108,HJ,335.97,,29457.09
6150,7/31/2020,7/31/2020,73120,82L-PRPD-073120 -Import Payroll-MCELWEE MELISSA,D108,HJ,38.67,,29495.76
6150,7/31/2020,7/31/2020,73120,82L-PRPD-073120 -Import Payroll-MCELWEE MELISSA,D108,HJ,165.33,,29661.09
6150,7/31/2020,7/31/2020,73120,82L-PRPD-073120 -Import Payroll-MCNICHOLAS MARY,D108,HJ,33.23,,29694.32
6150,7/31/2020,7/31/2020,73120,82L-PRPD-073120 -Import Payroll-MCNICHOLAS MARY,D108,HJ,142.08,,29836.4
6150,7/31/2020,7/31/2020,73120,82L-PRPD-073120 -Import Payroll-MOSELEY ARIELLE,D108,HJ,37.83,,29874.23
6150,7/31/2020,7/31/2020,73120,82L-PRPD-073120 -Import Payroll-MOSELEY ARIELLE,D108,HJ,161.75,,30035.98
6150,7/31/2020,7/31/2020,73120,82L-PRPD-073120 -Import Payroll-NWAKANMA NANCY,D108,HJ,42.32,,30078.3
6150,7/31/2020,7/31/2020,73120,82L-PRPD-073120 -Import Payroll-NWAKANMA NANCY,D108,HJ,180.94,,30259.24
6150,7/31/2020,7/31/2020,73120,82L-PRPD-073120 -Import Payroll-ODONNELL STEPHEN,D108,HJ,39.86,,30299.1
6150,7/31/2020,7/31/2020,73120,82L-PRPD-073120 -Import Payroll-ODONNELL STEPHEN,D108,HJ,170.45,,30469.55
6150,7/31/2020,7/31/2020,73120,82L-PRPD-073120 -Import Payroll-ONICA ANTHONY J,D108,HJ,32.86,,30502.41
6150,7/31/2020,7/31/2020,73120,82L-PRPD-073120 -Import Payroll-ONICA ANTHONY J,D108,HJ,140.49,,30642.9
6150,7/31/2020,7/31/2020,73120,82L-PRPD-073120 -Import Payroll-PARETS MALLORY GRACE,D108,HJ,20.81,,30663.71
6150,7/31/2020,7/31/2020,73120,82L-PRPD-073120 -Import Payroll-PARETS MALLORY GRACE,D108,HJ,48.67,,30712.38
6150,7/31/2020,7/31/2020,73120,82L-PRPD-073120 -Import Payroll-PARETS MALLORY GRACE,D108,HJ,90.62,,30803
6150,7/31/2020,7/31/2020,73120,82L-PRPD-073120 -Import Payroll-PARETS MALLORY GRACE,D108,HJ,208.1,,31011.1
6150,7/31/2020,7/31/2020,73120,82L-PRPD-073120 -Import Payroll-PARHAM-GANTT DENISE M,D108,HJ,37.96,,31049.06
6150,7/31/2020,7/31/2020,73120,82L-PRPD-073120 -Import Payroll-PARHAM-GANTT DENISE M,D108,HJ,162.32,,31211.38
6150,7/31/2020,7/31/2020,73120,82L-PRPD-073120 -Import Payroll-PEINADO ELIZABETH R,D108,HJ,52.29,,31263.67
6150,7/31/2020,7/31/2020,73120,82L-PRPD-073120 -Import Payroll-PEINADO ELIZABETH R,D108,HJ,223.58,,31487.25
6150,7/31/2020,7/31/2020,73120,82L-PRPD-073120 -Import Payroll-POLANCO ODALIS,D108,HJ,43.23,,31530.48
6150,7/31/2020,7/31/2020,73120,82L-PRPD-073120 -Import Payroll-POLANCO ODALIS,D108,HJ,184.83,,31715.31
6150,7/31/2020,7/31/2020,73120,82L-PRPD-073120 -Import Payroll-PRAHIN NICOLE M,D108,HJ,52.91,,31768.22
6150,7/31/2020,7/31/2020,73120,82L-PRPD-073120 -Import Payroll-PRAHIN NICOLE M,D108,HJ,226.22,,31994.44
6150,7/31/2020,7/31/2020,73120,82L-PRPD-073120 -Import Payroll-RANDOLPH ALEXANDER,D108,HJ,11.63,,32006.07
6150,7/31/2020,7/31/2020,73120,82L-PRPD-073120 -Import Payroll-RANDOLPH ALEXANDER,D108,HJ,25.1,,32031.17
6150,7/31/2020,7/31/2020,73120,82L-PRPD-073120 -Import Payroll-RANDOLPH ALEXANDER,D108,HJ,50.63,,32081.8
6150,7/31/2020,7/31/2020,73120,82L-PRPD-073120 -Import Payroll-RANDOLPH ALEXANDER,D108,HJ,107.33,,32189.13
6150,7/31/2020,7/31/2020,73120,82L-PRPD-073120 -Import Payroll-RIVERS QUIONNA DIANE,D108,HJ,36.46,,32225.59
6150,7/31/2020,7/31/2020,73120,82L-PRPD-073120 -Import Payroll-RIVERS QUIONNA DIANE,D108,HJ,155.89,,32381.48
6150,7/31/2020,7/31/2020,73120,82L-PRPD-073120 -Import Payroll-ROBBINS DEANNA,D108,HJ,36.85,,32418.33
6150,7/31/2020,7/31/2020,73120,82L-PRPD-073120 -Import Payroll-ROBBINS DEANNA,D108,HJ,68.63,,32486.96
6150,7/31/2020,7/31/2020,73120,82L-PRPD-073120 -Import Payroll-ROBBINS DEANNA,D108,HJ,157.58,,32644.54
6150,7/31/2020,7/31/2020,73120,82L-PRPD-073120 -Import Payroll-SAFRAN ALAN P,D108,HJ,108.43,,32752.97
6150,7/31/2020,7/31/2020,73120,82L-PRPD-073120 -Import Payroll-SAFRAN ALAN P,D108,HJ,463.62,,33216.59
6150,7/31/2020,7/31/2020,73120,82L-PRPD-073120 -Import Payroll-SALIM YASSER,D108,HJ,33.1,,33249.69
6150,7/31/2020,7/31/2020,73120,82L-PRPD-073120 -Import Payroll-SALIM YASSER,D108,HJ,141.55,,33391.24
6150,7/31/2020,7/31/2020,73120,82L-PRPD-073120 -Import Payroll-SEJOUR MAHALIAH,D108,HJ,34.07,,33425.31
6150,7/31/2020,7/31/2020,73120,82L-PRPD-073120 -Import Payroll-SEJOUR MAHALIAH,D108,HJ,145.66,,33570.97
6150,7/31/2020,7/31/2020,73120,82L-PRPD-073120 -Import Payroll-SHENKMAN OLIVIA,D108,HJ,29,,33599.97
6150,7/31/2020,7/31/2020,73120,82L-PRPD-073120 -Import Payroll-SHENKMAN OLIVIA,D108,HJ,124,,33723.97
6150,7/31/2020,7/31/2020,73120,82L-PRPD-073120 -Import Payroll-SHI GRACE,D108,HJ,12.69,,33736.66
6150,7/31/2020,7/31/2020,73120,82L-PRPD-073120 -Import Payroll-SHI GRACE,D108,HJ,36.98,,33773.64
6150,7/31/2020,7/31/2020,73120,82L-PRPD-073120 -Import Payroll-SHI GRACE,D108,HJ,54.25,,33827.89
6150,7/31/2020,7/31/2020,73120,82L-PRPD-073120 -Import Payroll-SILVER KELLY,D108,HJ,31.79,,33859.68
6150,7/31/2020,7/31/2020,73120,82L-PRPD-073120 -Import Payroll-SILVER KELLY,D108,HJ,59.2,,33918.88
6150,7/31/2020,7/31/2020,73120,82L-PRPD-073120 -Import Payroll-SILVER KELLY,D108,HJ,135.94,,34054.82
6150,7/31/2020,7/31/2020,73120,82L-PRPD-073120 -Import Payroll-SKALSKI CHRISTOPHER,D108,HJ,33.86,,34088.68
6150,7/31/2020,7/31/2020,73120,82L-PRPD-073120 -Import Payroll-SKALSKI CHRISTOPHER,D108,HJ,144.76,,34233.44
6150,7/31/2020,7/31/2020,73120,82L-PRPD-073120 -Import Payroll-SMITH AKILAH,D108,HJ,19.92,,34253.36
6150,7/31/2020,7/31/2020,73120,82L-PRPD-073120 -Import Payroll-SMITH AKILAH,D108,HJ,85.17,,34338.53
6150,7/31/2020,7/31/2020,73120,82L-PRPD-073120 -Import Payroll-TAM CW RYAN,D108,HJ,21.4,,34359.93
6150,7/31/2020,7/31/2020,73120,82L-PRPD-073120 -Import Payroll-TAM CW RYAN,D108,HJ,91.51,,34451.44
6150,7/31/2020,7/31/2020,73120,82L-PRPD-073120 -Import Payroll-TENESACA VERONICA A,D108,HJ,19,,34470.44
6150,7/31/2020,7/31/2020,73120,82L-PRPD-073120 -Import Payroll-TENESACA VERONICA A,D108,HJ,81.25,,34551.69
6150,7/31/2020,7/31/2020,73120,82L-PRPD-073120 -Import Payroll-TILLERY ASIA,D108,HJ,47.73,,34599.42
6150,7/31/2020,7/31/2020,73120,82L-PRPD-073120 -Import Payroll-TILLERY ASIA,D108,HJ,204.08,,34803.5
6150,7/31/2020,7/31/2020,73120,82L-PRPD-073120 -Import Payroll-TUMENJARGAL ENKHJIN,D108,HJ,32.92,,34836.42
6150,7/31/2020,7/31/2020,73120,82L-PRPD-073120 -Import Payroll-TUMENJARGAL ENKHJIN,D108,HJ,140.75,,34977.17
6150,7/31/2020,7/31/2020,73120,82L-PRPD-073120 -Import Payroll-VILLEGAS EVELYN,D108,HJ,33.4,,35010.57
6150,7/31/2020,7/31/2020,73120,82L-PRPD-073120 -Import Payroll-VILLEGAS EVELYN,D108,HJ,142.81,,35153.38
6150,7/31/2020,7/31/2020,73120,82L-PRPD-073120 -Import Payroll-WALLACE AMENA T,D108,HJ,28.93,,35182.31
6150,7/31/2020,7/31/2020,73120,82L-PRPD-073120 -Import Payroll-WALLACE AMENA T,D108,HJ,123.72,,35306.03
6150,7/31/2020,7/31/2020,73120,82L-PRPD-073120 -Import Payroll-WEINSTOCK EMILY,D108,HJ,17.57,,35323.6
6150,7/31/2020,7/31/2020,73120,82L-PRPD-073120 -Import Payroll-WEINSTOCK EMILY,D108,HJ,41.08,,35364.68
6150,7/31/2020,7/31/2020,73120,82L-PRPD-073120 -Import Payroll-WEINSTOCK EMILY,D108,HJ,76.5,,35441.18
6150,7/31/2020,7/31/2020,73120,82L-PRPD-073120 -Import Payroll-WEINSTOCK EMILY,D108,HJ,175.67,,35616.85
6150,7/31/2020,7/31/2020,73120,82L-PRPD-073120 -Import Payroll-WINANS JENNIFER,D108,HJ,36.33,,35653.18
6150,7/31/2020,7/31/2020,73120,82L-PRPD-073120 -Import Payroll-WINANS JENNIFER,D108,HJ,155.35,,35808.53
6150,7/31/2020,7/31/2020,73120,82L-PRPD-073120 -Import Payroll-WOLF ANNA A,D108,HJ,36.3,,35844.83
6150,7/31/2020,7/31/2020,73120,82L-PRPD-073120 -Import Payroll-WOLF ANNA A,D108,HJ,155.19,,36000.02
6150,7/31/2020,7/31/2020,73120,82L-PRPD-073120 -Import Payroll-ZARATE JOSEPH M,D108,HJ,31.18,,36031.2
6150,7/31/2020,7/31/2020,73120,82L-PRPD-073120 -Import Payroll-ZARATE JOSEPH M,D108,HJ,133.3,,36164.5
6150,7/31/2020,7/31/2020,73120,To reverse 82L payroll 73120-To reverse 82L payroll of 73120 JE-21-0003,D108,HJ,,2.98,36161.52
6150,7/31/2020,7/31/2020,73120,To reverse 82L payroll 73120-To reverse 82L payroll of 73120 JE-21-0003,D108,HJ,,6.98,36154.54
6150,7/31/2020,7/31/2020,73120,To reverse 82L payroll 73120-To reverse 82L payroll of 73120 JE-21-0003,D108,HJ,,11.63,36142.91
6150,7/31/2020,7/31/2020,73120,To reverse 82L payroll 73120-To reverse 82L payroll of 73120 JE-21-0003,D108,HJ,,12.69,36130.22
6150,7/31/2020,7/31/2020,73120,To reverse 82L payroll 73120-To reverse 82L payroll of 73120 JE-21-0003,D108,HJ,,15.1,36115.12
6150,7/31/2020,7/31/2020,73120,To reverse 82L payroll 73120-To reverse 82L payroll of 73120 JE-21-0003,D108,HJ,,17.57,36097.55
6150,7/31/2020,7/31/2020,73120,To reverse 82L payroll 73120-To reverse 82L payroll of 73120 JE-21-0003,D108,HJ,,17.71,36079.84
6150,7/31/2020,7/31/2020,73120,To reverse 82L payroll 73120-To reverse 82L payroll of 73120 JE-21-0003,D108,HJ,,18.18,36061.66
6150,7/31/2020,7/31/2020,73120,To reverse 82L payroll 73120-To reverse 82L payroll of 73120 JE-21-0003,D108,HJ,,18.18,36043.48
6150,7/31/2020,7/31/2020,73120,To reverse 82L payroll 73120-To reverse 82L payroll of 73120 JE-21-0003,D108,HJ,,18.96,36024.52
6150,7/31/2020,7/31/2020,73120,To reverse 82L payroll 73120-To reverse 82L payroll of 73120 JE-21-0003,D108,HJ,,19,36005.52
6150,7/31/2020,7/31/2020,73120,To reverse 82L payroll 73120-To reverse 82L payroll of 73120 JE-21-0003,D108,HJ,,19.38,35986.14
6150,7/31/2020,7/31/2020,73120,To reverse 82L payroll 73120-To reverse 82L payroll of 73120 JE-21-0003,D108,HJ,,19.92,35966.22
6150,7/31/2020,7/31/2020,73120,To reverse 82L payroll 73120-To reverse 82L payroll of 73120 JE-21-0003,D108,HJ,,20.81,35945.41
6150,7/31/2020,7/31/2020,73120,To reverse 82L payroll 73120-To reverse 82L payroll of 73120 JE-21-0003,D108,HJ,,21.4,35924.01
6150,7/31/2020,7/31/2020,73120,To reverse 82L payroll 73120-To reverse 82L payroll of 73120 JE-21-0003,D108,HJ,,23.29,35900.72
6150,7/31/2020,7/31/2020,73120,To reverse 82L payroll 73120-To reverse 82L payroll of 73120 JE-21-0003,D108,HJ,,23.64,35877.08
6150,7/31/2020,7/31/2020,73120,To reverse 82L payroll 73120-To reverse 82L payroll of 73120 JE-21-0003,D108,HJ,,25.1,35851.98
6150,7/31/2020,7/31/2020,73120,To reverse 82L payroll 73120-To reverse 82L payroll of 73120 JE-21-0003,D108,HJ,,26.3,35825.68
6150,7/31/2020,7/31/2020,73120,To reverse 82L payroll 73120-To reverse 82L payroll of 73120 JE-21-0003,D108,HJ,,26.38,35799.3
6150,7/31/2020,7/31/2020,73120,To reverse 82L payroll 73120-To reverse 82L payroll of 73120 JE-21-0003,D108,HJ,,26.45,35772.85
6150,7/31/2020,7/31/2020,73120,To reverse 82L payroll 73120-To reverse 82L payroll of 73120 JE-21-0003,D108,HJ,,26.58,35746.27
6150,7/31/2020,7/31/2020,73120,To reverse 82L payroll 73120-To reverse 82L payroll of 73120 JE-21-0003,D108,HJ,,27.34,35718.93
6150,7/31/2020,7/31/2020,73120,To reverse 82L payroll 73120-To reverse 82L payroll of 73120 JE-21-0003,D108,HJ,,28.93,35690
6150,7/31/2020,7/31/2020,73120,To reverse 82L payroll 73120-To reverse 82L payroll of 73120 JE-21-0003,D108,HJ,,29,35661
6150,7/31/2020,7/31/2020,73120,To reverse 82L payroll 73120-To reverse 82L payroll of 73120 JE-21-0003,D108,HJ,,29.83,35631.17
6150,7/31/2020,7/31/2020,73120,To reverse 82L payroll 73120-To reverse 82L payroll of 73120 JE-21-0003,D108,HJ,,30.36,35600.81
6150,7/31/2020,7/31/2020,73120,To reverse 82L payroll 73120-To reverse 82L payroll of 73120 JE-21-0003,D108,HJ,,30.44,35570.37
6150,7/31/2020,7/31/2020,73120,To reverse 82L payroll 73120-To reverse 82L payroll of 73120 JE-21-0003,D108,HJ,,30.56,35539.81
6150,7/31/2020,7/31/2020,73120,To reverse 82L payroll 73120-To reverse 82L payroll of 73120 JE-21-0003,D108,HJ,,31,35508.81
6150,7/31/2020,7/31/2020,73120,To reverse 82L payroll 73120-To reverse 82L payroll of 73120 JE-21-0003,D108,HJ,,31.18,35477.63
6150,7/31/2020,7/31/2020,73120,To reverse 82L payroll 73120-To reverse 82L payroll of 73120 JE-21-0003,D108,HJ,,31.22,35446.41
6150,7/31/2020,7/31/2020,73120,To reverse 82L payroll 73120-To reverse 82L payroll of 73120 JE-21-0003,D108,HJ,,31.79,35414.62
6150,7/31/2020,7/31/2020,73120,To reverse 82L payroll 73120-To reverse 82L payroll of 73120 JE-21-0003,D108,HJ,,31.93,35382.69
6150,7/31/2020,7/31/2020,73120,To reverse 82L payroll 73120-To reverse 82L payroll of 73120 JE-21-0003,D108,HJ,,32.04,35350.65
6150,7/31/2020,7/31/2020,73120,To reverse 82L payroll 73120-To reverse 82L payroll of 73120 JE-21-0003,D108,HJ,,32.63,35318.02
6150,7/31/2020,7/31/2020,73120,To reverse 82L payroll 73120-To reverse 82L payroll of 73120 JE-21-0003,D108,HJ,,32.86,35285.16
6150,7/31/2020,7/31/2020,73120,To reverse 82L payroll 73120-To reverse 82L payroll of 73120 JE-21-0003,D108,HJ,,32.92,35252.24
6150,7/31/2020,7/31/2020,73120,To reverse 82L payroll 73120-To reverse 82L payroll of 73120 JE-21-0003,D108,HJ,,33.06,35219.18
6150,7/31/2020,7/31/2020,73120,To reverse 82L payroll 73120-To reverse 82L payroll of 73120 JE-21-0003,D108,HJ,,33.1,35186.08
6150,7/31/2020,7/31/2020,73120,To reverse 82L payroll 73120-To reverse 82L payroll of 73120 JE-21-0003,D108,HJ,,33.23,35152.85
6150,7/31/2020,7/31/2020,73120,To reverse 82L payroll 73120-To reverse 82L payroll of 73120 JE-21-0003,D108,HJ,,33.23,35119.62
6150,7/31/2020,7/31/2020,73120,To reverse 82L payroll 73120-To reverse 82L payroll of 73120 JE-21-0003,D108,HJ,,33.4,35086.22
6150,7/31/2020,7/31/2020,73120,To reverse 82L payroll 73120-To reverse 82L payroll of 73120 JE-21-0003,D108,HJ,,33.42,35052.8
6150,7/31/2020,7/31/2020,73120,To reverse 82L payroll 73120-To reverse 82L payroll of 73120 JE-21-0003,D108,HJ,,33.51,35019.29
6150,7/31/2020,7/31/2020,73120,To reverse 82L payroll 73120-To reverse 82L payroll of 73120 JE-21-0003,D108,HJ,,33.86,34985.43
6150,7/31/2020,7/31/2020,73120,To reverse 82L payroll 73120-To reverse 82L payroll of 73120 JE-21-0003,D108,HJ,,33.96,34951.47
6150,7/31/2020,7/31/2020,73120,To reverse 82L payroll 73120-To reverse 82L payroll of 73120 JE-21-0003,D108,HJ,,34.02,34917.45
6150,7/31/2020,7/31/2020,73120,To reverse 82L payroll 73120-To reverse 82L payroll of 73120 JE-21-0003,D108,HJ,,34.07,34883.38
6150,7/31/2020,7/31/2020,73120,To reverse 82L payroll 73120-To reverse 82L payroll of 73120 JE-21-0003,D108,HJ,,34.79,34848.59
6150,7/31/2020,7/31/2020,73120,To reverse 82L payroll 73120-To reverse 82L payroll of 73120 JE-21-0003,D108,HJ,,35.1,34813.49
6150,7/31/2020,7/31/2020,73120,To reverse 82L payroll 73120-To reverse 82L payroll of 73120 JE-21-0003,D108,HJ,,35.7,34777.79
6150,7/31/2020,7/31/2020,73120,To reverse 82L payroll 73120-To reverse 82L payroll of 73120 JE-21-0003,D108,HJ,,36.3,34741.49
6150,7/31/2020,7/31/2020,73120,To reverse 82L payroll 73120-To reverse 82L payroll of 73120 JE-21-0003,D108,HJ,,36.33,34705.16
6150,7/31/2020,7/31/2020,73120,To reverse 82L payroll 73120-To reverse 82L payroll of 73120 JE-21-0003,D108,HJ,,36.34,34668.82
6150,7/31/2020,7/31/2020,73120,To reverse 82L payroll 73120-To reverse 82L payroll of 73120 JE-21-0003,D108,HJ,,36.46,34632.36
6150,7/31/2020,7/31/2020,73120,To reverse 82L payroll 73120-To reverse 82L payroll of 73120 JE-21-0003,D108,HJ,,36.85,34595.51
6150,7/31/2020,7/31/2020,73120,To reverse 82L payroll 73120-To reverse 82L payroll of 73120 JE-21-0003,D108,HJ,,36.98,34558.53
6150,7/31/2020,7/31/2020,73120,To reverse 82L payroll 73120-To reverse 82L payroll of 73120 JE-21-0003,D108,HJ,,37.75,34520.78
6150,7/31/2020,7/31/2020,73120,To reverse 82L payroll 73120-To reverse 82L payroll of 73120 JE-21-0003,D108,HJ,,37.83,34482.95
6150,7/31/2020,7/31/2020,73120,To reverse 82L payroll 73120-To reverse 82L payroll of 73120 JE-21-0003,D108,HJ,,37.96,34444.99
6150,7/31/2020,7/31/2020,73120,To reverse 82L payroll 73120-To reverse 82L payroll of 73120 JE-21-0003,D108,HJ,,38.07,34406.92
6150,7/31/2020,7/31/2020,73120,To reverse 82L payroll 73120-To reverse 82L payroll of 73120 JE-21-0003,D108,HJ,,38.45,34368.47
6150,7/31/2020,7/31/2020,73120,To reverse 82L payroll 73120-To reverse 82L payroll of 73120 JE-21-0003,D108,HJ,,38.67,34329.8
6150,7/31/2020,7/31/2020,73120,To reverse 82L payroll 73120-To reverse 82L payroll of 73120 JE-21-0003,D108,HJ,,38.67,34291.13
6150,7/31/2020,7/31/2020,73120,To reverse 82L payroll 73120-To reverse 82L payroll of 73120 JE-21-0003,D108,HJ,,39,34252.13
6150,7/31/2020,7/31/2020,73120,To reverse 82L payroll 73120-To reverse 82L payroll of 73120 JE-21-0003,D108,HJ,,39.27,34212.86
6150,7/31/2020,7/31/2020,73120,To reverse 82L payroll 73120-To reverse 82L payroll of 73120 JE-21-0003,D108,HJ,,39.86,34173
6150,7/31/2020,7/31/2020,73120,To reverse 82L payroll 73120-To reverse 82L payroll of 73120 JE-21-0003,D108,HJ,,39.86,34133.14
6150,7/31/2020,7/31/2020,73120,To reverse 82L payroll 73120-To reverse 82L payroll of 73120 JE-21-0003,D108,HJ,,39.93,34093.21
6150,7/31/2020,7/31/2020,73120,To reverse 82L payroll 73120-To reverse 82L payroll of 73120 JE-21-0003,D108,HJ,,41.08,34052.13
6150,7/31/2020,7/31/2020,73120,To reverse 82L payroll 73120-To reverse 82L payroll of 73120 JE-21-0003,D108,HJ,,41.85,34010.28
6150,7/31/2020,7/31/2020,73120,To reverse 82L payroll 73120-To reverse 82L payroll of 73120 JE-21-0003,D108,HJ,,41.91,33968.37
6150,7/31/2020,7/31/2020,73120,To reverse 82L payroll 73120-To reverse 82L payroll of 73120 JE-21-0003,D108,HJ,,42.29,33926.08
6150,7/31/2020,7/31/2020,73120,To reverse 82L payroll 73120-To reverse 82L payroll of 73120 JE-21-0003,D108,HJ,,42.32,33883.76
6150,7/31/2020,7/31/2020,73120,To reverse 82L payroll 73120-To reverse 82L payroll of 73120 JE-21-0003,D108,HJ,,42.91,33840.85
6150,7/31/2020,7/31/2020,73120,To reverse 82L payroll 73120-To reverse 82L payroll of 73120 JE-21-0003,D108,HJ,,43.23,33797.62
6150,7/31/2020,7/31/2020,73120,To reverse 82L payroll 73120-To reverse 82L payroll of 73120 JE-21-0003,D108,HJ,,45.1,33752.52
6150,7/31/2020,7/31/2020,73120,To reverse 82L payroll 73120-To reverse 82L payroll of 73120 JE-21-0003,D108,HJ,,45.87,33706.65
6150,7/31/2020,7/31/2020,73120,To reverse 82L payroll 73120-To reverse 82L payroll of 73120 JE-21-0003,D108,HJ,,47.73,33658.92
6150,7/31/2020,7/31/2020,73120,To reverse 82L payroll 73120-To reverse 82L payroll of 73120 JE-21-0003,D108,HJ,,48.67,33610.25
6150,7/31/2020,7/31/2020,73120,To reverse 82L payroll 73120-To reverse 82L payroll of 73120 JE-21-0003,D108,HJ,,49.84,33560.41
6150,7/31/2020,7/31/2020,73120,To reverse 82L payroll 73120-To reverse 82L payroll of 73120 JE-21-0003,D108,HJ,,49.87,33510.54
6150,7/31/2020,7/31/2020,73120,To reverse 82L payroll 73120-To reverse 82L payroll of 73120 JE-21-0003,D108,HJ,,50.63,33459.91
6150,7/31/2020,7/31/2020,73120,To reverse 82L payroll 73120-To reverse 82L payroll of 73120 JE-21-0003,D108,HJ,,50.92,33408.99
6150,7/31/2020,7/31/2020,73120,To reverse 82L payroll 73120-To reverse 82L payroll of 73120 JE-21-0003,D108,HJ,,52.29,33356.7
6150,7/31/2020,7/31/2020,73120,To reverse 82L payroll 73120-To reverse 82L payroll of 73120 JE-21-0003,D108,HJ,,52.91,33303.79
6150,7/31/2020,7/31/2020,73120,To reverse 82L payroll 73120-To reverse 82L payroll of 73120 JE-21-0003,D108,HJ,,53.2,33250.59
6150,7/31/2020,7/31/2020,73120,To reverse 82L payroll 73120-To reverse 82L payroll of 73120 JE-21-0003,D108,HJ,,54.25,33196.34
6150,7/31/2020,7/31/2020,73120,To reverse 82L payroll 73120-To reverse 82L payroll of 73120 JE-21-0003,D108,HJ,,55.28,33141.06
6150,7/31/2020,7/31/2020,73120,To reverse 82L payroll 73120-To reverse 82L payroll of 73120 JE-21-0003,D108,HJ,,59.2,33081.86
6150,7/31/2020,7/31/2020,73120,To reverse 82L payroll 73120-To reverse 82L payroll of 73120 JE-21-0003,D108,HJ,,61.55,33020.31
6150,7/31/2020,7/31/2020,73120,To reverse 82L payroll 73120-To reverse 82L payroll of 73120 JE-21-0003,D108,HJ,,63.34,32956.97
6150,7/31/2020,7/31/2020,73120,To reverse 82L payroll 73120-To reverse 82L payroll of 73120 JE-21-0003,D108,HJ,,63.35,32893.62
6150,7/31/2020,7/31/2020,73120,To reverse 82L payroll 73120-To reverse 82L payroll of 73120 JE-21-0003,D108,HJ,,64.58,32829.04
6150,7/31/2020,7/31/2020,73120,To reverse 82L payroll 73120-To reverse 82L payroll of 73120 JE-21-0003,D108,HJ,,68.63,32760.41
6150,7/31/2020,7/31/2020,73120,To reverse 82L payroll 73120-To reverse 82L payroll of 73120 JE-21-0003,D108,HJ,,72.42,32687.99
6150,7/31/2020,7/31/2020,73120,To reverse 82L payroll 73120-To reverse 82L payroll of 73120 JE-21-0003,D108,HJ,,74.25,32613.74
6150,7/31/2020,7/31/2020,73120,To reverse 82L payroll 73120-To reverse 82L payroll of 73120 JE-21-0003,D108,HJ,,75.71,32538.03
6150,7/31/2020,7/31/2020,73120,To reverse 82L payroll 73120-To reverse 82L payroll of 73120 JE-21-0003,D108,HJ,,76.5,32461.53
6150,7/31/2020,7/31/2020,73120,To reverse 82L payroll 73120-To reverse 82L payroll of 73120 JE-21-0003,D108,HJ,,77.72,32383.81
6150,7/31/2020,7/31/2020,73120,To reverse 82L payroll 73120-To reverse 82L payroll of 73120 JE-21-0003,D108,HJ,,77.72,32306.09
6150,7/31/2020,7/31/2020,73120,To reverse 82L payroll 73120-To reverse 82L payroll of 73120 JE-21-0003,D108,HJ,,78.57,32227.52
6150,7/31/2020,7/31/2020,73120,To reverse 82L payroll 73120-To reverse 82L payroll of 73120 JE-21-0003,D108,HJ,,78.75,32148.77
6150,7/31/2020,7/31/2020,73120,To reverse 82L payroll 73120-To reverse 82L payroll of 73120 JE-21-0003,D108,HJ,,81.07,32067.7
6150,7/31/2020,7/31/2020,73120,To reverse 82L payroll 73120-To reverse 82L payroll of 73120 JE-21-0003,D108,HJ,,81.25,31986.45
6150,7/31/2020,7/31/2020,73120,To reverse 82L payroll 73120-To reverse 82L payroll of 73120 JE-21-0003,D108,HJ,,85.17,31901.28
6150,7/31/2020,7/31/2020,73120,To reverse 82L payroll 73120-To reverse 82L payroll of 73120 JE-21-0003,D108,HJ,,88.74,31812.54
6150,7/31/2020,7/31/2020,73120,To reverse 82L payroll 73120-To reverse 82L payroll of 73120 JE-21-0003,D108,HJ,,90.62,31721.92
6150,7/31/2020,7/31/2020,73120,To reverse 82L payroll 73120-To reverse 82L payroll of 73120 JE-21-0003,D108,HJ,,91.51,31630.41
6150,7/31/2020,7/31/2020,73120,To reverse 82L payroll 73120-To reverse 82L payroll of 73120 JE-21-0003,D108,HJ,,93.33,31537.08
6150,7/31/2020,7/31/2020,73120,To reverse 82L payroll 73120-To reverse 82L payroll of 73120 JE-21-0003,D108,HJ,,99.58,31437.5
6150,7/31/2020,7/31/2020,73120,To reverse 82L payroll 73120-To reverse 82L payroll of 73120 JE-21-0003,D108,HJ,,107.33,31330.17
6150,7/31/2020,7/31/2020,73120,To reverse 82L payroll 73120-To reverse 82L payroll of 73120 JE-21-0003,D108,HJ,,108.43,31221.74
6150,7/31/2020,7/31/2020,73120,To reverse 82L payroll 73120-To reverse 82L payroll of 73120 JE-21-0003,D108,HJ,,112.45,31109.29
6150,7/31/2020,7/31/2020,73120,To reverse 82L payroll 73120-To reverse 82L payroll of 73120 JE-21-0003,D108,HJ,,112.81,30996.48
6150,7/31/2020,7/31/2020,73120,To reverse 82L payroll 73120-To reverse 82L payroll of 73120 JE-21-0003,D108,HJ,,113.09,30883.39
6150,7/31/2020,7/31/2020,73120,To reverse 82L payroll 73120-To reverse 82L payroll of 73120 JE-21-0003,D108,HJ,,113.67,30769.72
6150,7/31/2020,7/31/2020,73120,To reverse 82L payroll 73120-To reverse 82L payroll of 73120 JE-21-0003,D108,HJ,,114.45,30655.27
6150,7/31/2020,7/31/2020,73120,To reverse 82L payroll 73120-To reverse 82L payroll of 73120 JE-21-0003,D108,HJ,,116.92,30538.35
6150,7/31/2020,7/31/2020,73120,To reverse 82L payroll 73120-To reverse 82L payroll of 73120 JE-21-0003,D108,HJ,,123.72,30414.63
6150,7/31/2020,7/31/2020,73120,To reverse 82L payroll 73120-To reverse 82L payroll of 73120 JE-21-0003,D108,HJ,,124,30290.63
6150,7/31/2020,7/31/2020,73120,To reverse 82L payroll 73120-To reverse 82L payroll of 73120 JE-21-0003,D108,HJ,,129.8,30160.83
6150,7/31/2020,7/31/2020,73120,To reverse 82L payroll 73120-To reverse 82L payroll of 73120 JE-21-0003,D108,HJ,,130.16,30030.67
6150,7/31/2020,7/31/2020,73120,To reverse 82L payroll 73120-To reverse 82L payroll of 73120 JE-21-0003,D108,HJ,,130.69,29899.98
6150,7/31/2020,7/31/2020,73120,To reverse 82L payroll 73120-To reverse 82L payroll of 73120 JE-21-0003,D108,HJ,,132.56,29767.42
6150,7/31/2020,7/31/2020,73120,To reverse 82L payroll 73120-To reverse 82L payroll of 73120 JE-21-0003,D108,HJ,,133.3,29634.12
6150,7/31/2020,7/31/2020,73120,To reverse 82L payroll 73120-To reverse 82L payroll of 73120 JE-21-0003,D108,HJ,,133.51,29500.61
6150,7/31/2020,7/31/2020,73120,To reverse 82L payroll 73120-To reverse 82L payroll of 73120 JE-21-0003,D108,HJ,,135.94,29364.67
6150,7/31/2020,7/31/2020,73120,To reverse 82L payroll 73120-To reverse 82L payroll of 73120 JE-21-0003,D108,HJ,,136.53,29228.14
6150,7/31/2020,7/31/2020,73120,To reverse 82L payroll 73120-To reverse 82L payroll of 73120 JE-21-0003,D108,HJ,,137,29091.14
6150,7/31/2020,7/31/2020,73120,To reverse 82L payroll 73120-To reverse 82L payroll of 73120 JE-21-0003,D108,HJ,,139.5,28951.64
6150,7/31/2020,7/31/2020,73120,To reverse 82L payroll 73120-To reverse 82L payroll of 73120 JE-21-0003,D108,HJ,,140.49,28811.15
6150,7/31/2020,7/31/2020,73120,To reverse 82L payroll 73120-To reverse 82L payroll of 73120 JE-21-0003,D108,HJ,,140.75,28670.4
6150,7/31/2020,7/31/2020,73120,To reverse 82L payroll 73120-To reverse 82L payroll of 73120 JE-21-0003,D108,HJ,,141.34,28529.06
6150,7/31/2020,7/31/2020,73120,To reverse 82L payroll 73120-To reverse 82L payroll of 73120 JE-21-0003,D108,HJ,,141.55,28387.51
6150,7/31/2020,7/31/2020,73120,To reverse 82L payroll 73120-To reverse 82L payroll of 73120 JE-21-0003,D108,HJ,,142.08,28245.43
6150,7/31/2020,7/31/2020,73120,To reverse 82L payroll 73120-To reverse 82L payroll of 73120 JE-21-0003,D108,HJ,,142.08,28103.35
6150,7/31/2020,7/31/2020,73120,To reverse 82L payroll 73120-To reverse 82L payroll of 73120 JE-21-0003,D108,HJ,,142.81,27960.54
6150,7/31/2020,7/31/2020,73120,To reverse 82L payroll 73120-To reverse 82L payroll of 73120 JE-21-0003,D108,HJ,,142.9,27817.64
6150,7/31/2020,7/31/2020,73120,To reverse 82L payroll 73120-To reverse 82L payroll of 73120 JE-21-0003,D108,HJ,,143.3,27674.34
6150,7/31/2020,7/31/2020,73120,To reverse 82L payroll 73120-To reverse 82L payroll of 73120 JE-21-0003,D108,HJ,,144.76,27529.58
6150,7/31/2020,7/31/2020,73120,To reverse 82L payroll 73120-To reverse 82L payroll of 73120 JE-21-0003,D108,HJ,,145.23,27384.35
6150,7/31/2020,7/31/2020,73120,To reverse 82L payroll 73120-To reverse 82L payroll of 73120 JE-21-0003,D108,HJ,,145.46,27238.89
6150,7/31/2020,7/31/2020,73120,To reverse 82L payroll 73120-To reverse 82L payroll of 73120 JE-21-0003,D108,HJ,,145.66,27093.23
6150,7/31/2020,7/31/2020,73120,To reverse 82L payroll 73120-To reverse 82L payroll of 73120 JE-21-0003,D108,HJ,,148.76,26944.47
6150,7/31/2020,7/31/2020,73120,To reverse 82L payroll 73120-To reverse 82L payroll of 73120 JE-21-0003,D108,HJ,,150.1,26794.37
6150,7/31/2020,7/31/2020,73120,To reverse 82L payroll 73120-To reverse 82L payroll of 73120 JE-21-0003,D108,HJ,,152.64,26641.73
6150,7/31/2020,7/31/2020,73120,To reverse 82L payroll 73120-To reverse 82L payroll of 73120 JE-21-0003,D108,HJ,,155.19,26486.54
6150,7/31/2020,7/31/2020,73120,To reverse 82L payroll 73120-To reverse 82L payroll of 73120 JE-21-0003,D108,HJ,,155.35,26331.19
6150,7/31/2020,7/31/2020,73120,To reverse 82L payroll 73120-To reverse 82L payroll of 73120 JE-21-0003,D108,HJ,,155.39,26175.8
6150,7/31/2020,7/31/2020,73120,To reverse 82L payroll 73120-To reverse 82L payroll of 73120 JE-21-0003,D108,HJ,,155.89,26019.91
6150,7/31/2020,7/31/2020,73120,To reverse 82L payroll 73120-To reverse 82L payroll of 73120 JE-21-0003,D108,HJ,,157.58,25862.33
6150,7/31/2020,7/31/2020,73120,To reverse 82L payroll 73120-To reverse 82L payroll of 73120 JE-21-0003,D108,HJ,,161.4,25700.93
6150,7/31/2020,7/31/2020,73120,To reverse 82L payroll 73120-To reverse 82L payroll of 73120 JE-21-0003,D108,HJ,,161.75,25539.18
6150,7/31/2020,7/31/2020,73120,To reverse 82L payroll 73120-To reverse 82L payroll of 73120 JE-21-0003,D108,HJ,,162.32,25376.86
6150,7/31/2020,7/31/2020,73120,To reverse 82L payroll 73120-To reverse 82L payroll of 73120 JE-21-0003,D108,HJ,,162.79,25214.07
6150,7/31/2020,7/31/2020,73120,To reverse 82L payroll 73120-To reverse 82L payroll of 73120 JE-21-0003,D108,HJ,,164.42,25049.65
6150,7/31/2020,7/31/2020,73120,To reverse 82L payroll 73120-To reverse 82L payroll of 73120 JE-21-0003,D108,HJ,,165.33,24884.32
6150,7/31/2020,7/31/2020,73120,To reverse 82L payroll 73120-To reverse 82L payroll of 73120 JE-21-0003,D108,HJ,,165.33,24718.99
6150,7/31/2020,7/31/2020,73120,To reverse 82L payroll 73120-To reverse 82L payroll of 73120 JE-21-0003,D108,HJ,,166.75,24552.24
6150,7/31/2020,7/31/2020,73120,To reverse 82L payroll 73120-To reverse 82L payroll of 73120 JE-21-0003,D108,HJ,,167.92,24384.32
6150,7/31/2020,7/31/2020,73120,To reverse 82L payroll 73120-To reverse 82L payroll of 73120 JE-21-0003,D108,HJ,,170.44,24213.88
6150,7/31/2020,7/31/2020,73120,To reverse 82L payroll 73120-To reverse 82L payroll of 73120 JE-21-0003,D108,HJ,,170.45,24043.43
6150,7/31/2020,7/31/2020,73120,To reverse 82L payroll 73120-To reverse 82L payroll of 73120 JE-21-0003,D108,HJ,,170.75,23872.68
6150,7/31/2020,7/31/2020,73120,To reverse 82L payroll 73120-To reverse 82L payroll of 73120 JE-21-0003,D108,HJ,,175.67,23697.01
6150,7/31/2020,7/31/2020,73120,To reverse 82L payroll 73120-To reverse 82L payroll of 73120 JE-21-0003,D108,HJ,,178.96,23518.05
6150,7/31/2020,7/31/2020,73120,To reverse 82L payroll 73120-To reverse 82L payroll of 73120 JE-21-0003,D108,HJ,,179.22,23338.83
6150,7/31/2020,7/31/2020,73120,To reverse 82L payroll 73120-To reverse 82L payroll of 73120 JE-21-0003,D108,HJ,,180.83,23158
6150,7/31/2020,7/31/2020,73120,To reverse 82L payroll 73120-To reverse 82L payroll of 73120 JE-21-0003,D108,HJ,,180.94,22977.06
6150,7/31/2020,7/31/2020,73120,To reverse 82L payroll 73120-To reverse 82L payroll of 73120 JE-21-0003,D108,HJ,,183.48,22793.58
6150,7/31/2020,7/31/2020,73120,To reverse 82L payroll 73120-To reverse 82L payroll of 73120 JE-21-0003,D108,HJ,,184.83,22608.75
6150,7/31/2020,7/31/2020,73120,To reverse 82L payroll 73120-To reverse 82L payroll of 73120 JE-21-0003,D108,HJ,,192.83,22415.92
6150,7/31/2020,7/31/2020,73120,To reverse 82L payroll 73120-To reverse 82L payroll of 73120 JE-21-0003,D108,HJ,,196.13,22219.79
6150,7/31/2020,7/31/2020,73120,To reverse 82L payroll 73120-To reverse 82L payroll of 73120 JE-21-0003,D108,HJ,,204.08,22015.71
6150,7/31/2020,7/31/2020,73120,To reverse 82L payroll 73120-To reverse 82L payroll of 73120 JE-21-0003,D108,HJ,,208.1,21807.61
6150,7/31/2020,7/31/2020,73120,To reverse 82L payroll 73120-To reverse 82L payroll of 73120 JE-21-0003,D108,HJ,,213.13,21594.48
6150,7/31/2020,7/31/2020,73120,To reverse 82L payroll 73120-To reverse 82L payroll of 73120 JE-21-0003,D108,HJ,,213.25,21381.23
6150,7/31/2020,7/31/2020,73120,To reverse 82L payroll 73120-To reverse 82L payroll of 73120 JE-21-0003,D108,HJ,,223.58,21157.65
6150,7/31/2020,7/31/2020,73120,To reverse 82L payroll 73120-To reverse 82L payroll of 73120 JE-21-0003,D108,HJ,,226.22,20931.43
6150,7/31/2020,7/31/2020,73120,To reverse 82L payroll 73120-To reverse 82L payroll of 73120 JE-21-0003,D108,HJ,,227.46,20703.97
6150,7/31/2020,7/31/2020,73120,To reverse 82L payroll 73120-To reverse 82L payroll of 73120 JE-21-0003,D108,HJ,,236.38,20467.59
6150,7/31/2020,7/31/2020,73120,To reverse 82L payroll 73120-To reverse 82L payroll of 73120 JE-21-0003,D108,HJ,,270.86,20196.73
6150,7/31/2020,7/31/2020,73120,To reverse 82L payroll 73120-To reverse 82L payroll of 73120 JE-21-0003,D108,HJ,,309.64,19887.09
6150,7/31/2020,7/31/2020,73120,To reverse 82L payroll 73120-To reverse 82L payroll of 73120 JE-21-0003,D108,HJ,,317.48,19569.61
6150,7/31/2020,7/31/2020,73120,To reverse 82L payroll 73120-To reverse 82L payroll of 73120 JE-21-0003,D108,HJ,,335.97,19233.64
6150,7/31/2020,7/31/2020,73120,To reverse 82L payroll 73120-To reverse 82L payroll of 73120 JE-21-0003,D108,HJ,,379.45,18854.19
6150,7/31/2020,7/31/2020,73120,To reverse 82L payroll 73120-To reverse 82L payroll of 73120 JE-21-0003,D108,HJ,,463.62,18390.57
6150,7/31/2020,7/31/2020,73120,82L-IMPORT PAYROLL-ANTHONY BETTY S,D108,HJ,41.85,,18432.42
6150,7/31/2020,7/31/2020,73120,82L-IMPORT PAYROLL-ANTHONY BETTY S,D108,HJ,178.96,,18611.38
6150,7/31/2020,7/31/2020,73120,82L-IMPORT PAYROLL-AUSTIN PERCY,D108,HJ,36.34,,18647.72
6150,7/31/2020,7/31/2020,73120,82L-IMPORT PAYROLL-AUSTIN PERCY,D108,HJ,155.39,,18803.11
6150,7/31/2020,7/31/2020,73120,82L-IMPORT PAYROLL-BANDA STEPHANY,D108,HJ,18.18,,18821.29
6150,7/31/2020,7/31/2020,73120,82L-IMPORT PAYROLL-BANDA STEPHANY,D108,HJ,77.72,,18899.01
6150,7/31/2020,7/31/2020,73120,82L-IMPORT PAYROLL-BAUSH DANIEL,D108,HJ,63.35,,18962.36
6150,7/31/2020,7/31/2020,73120,82L-IMPORT PAYROLL-BAUSH DANIEL,D108,HJ,270.86,,19233.22
6150,7/31/2020,7/31/2020,73120,82L-IMPORT PAYROLL-CHAPMAN CLAUDY EARL,D108,HJ,26.38,,19259.6
6150,7/31/2020,7/31/2020,73120,82L-IMPORT PAYROLL-CHAPMAN CLAUDY EARL,D108,HJ,112.81,,19372.41
6150,7/31/2020,7/31/2020,73120,82L-IMPORT PAYROLL-DADA ARIKPO E,D108,HJ,32.04,,19404.45
6150,7/31/2020,7/31/2020,73120,82L-IMPORT PAYROLL-DADA ARIKPO E,D108,HJ,137,,19541.45
6150,7/31/2020,7/31/2020,73120,82L-IMPORT PAYROLL-GUTHRIE LESLIE,D108,HJ,33.42,,19574.87
6150,7/31/2020,7/31/2020,73120,82L-IMPORT PAYROLL-GUTHRIE LESLIE,D108,HJ,142.9,,19717.77
6150,7/31/2020,7/31/2020,73120,82L-IMPORT PAYROLL-HOLMES JOREL ALEXANDER,D108,HJ,31.22,,19748.99
6150,7/31/2020,7/31/2020,73120,82L-IMPORT PAYROLL-HOLMES JOREL ALEXANDER,D108,HJ,133.51,,19882.5
6150,7/31/2020,7/31/2020,73120,82L-IMPORT PAYROLL-JORDAN TIFFANY T,D108,HJ,45.87,,19928.37
6150,7/31/2020,7/31/2020,73120,82L-IMPORT PAYROLL-JORDAN TIFFANY T,D108,HJ,196.13,,20124.5
6150,7/31/2020,7/31/2020,73120,82L-IMPORT PAYROLL-LANIGAN LISA A,D108,HJ,45.1,,20169.6
6150,7/31/2020,7/31/2020,73120,82L-IMPORT PAYROLL-LANIGAN LISA A,D108,HJ,192.83,,20362.43
6150,7/31/2020,7/31/2020,73120,82L-IMPORT PAYROLL-LEVERET LILY A,D108,HJ,18.18,,20380.61
6150,7/31/2020,7/31/2020,73120,82L-IMPORT PAYROLL-LEVERET LILY A,D108,HJ,77.72,,20458.33
6150,7/31/2020,7/31/2020,73120,82L-IMPORT PAYROLL-MCELWEE MELISSA,D108,HJ,38.67,,20497
6150,7/31/2020,7/31/2020,73120,82L-IMPORT PAYROLL-MCELWEE MELISSA,D108,HJ,165.33,,20662.33
6150,7/31/2020,7/31/2020,73120,82L-IMPORT PAYROLL-MCNICHOLAS MARY,D108,HJ,33.23,,20695.56
6150,7/31/2020,7/31/2020,73120,82L-IMPORT PAYROLL-MCNICHOLAS MARY,D108,HJ,142.08,,20837.64
6150,7/31/2020,7/31/2020,73120,82L-IMPORT PAYROLL-NWAKANMA NANCY,D108,HJ,42.32,,20879.96
6150,7/31/2020,7/31/2020,73120,82L-IMPORT PAYROLL-NWAKANMA NANCY,D108,HJ,180.94,,21060.9
6150,7/31/2020,7/31/2020,73120,82L-IMPORT PAYROLL-ONICA ANTHONY J,D108,HJ,32.86,,21093.76
6150,7/31/2020,7/31/2020,73120,82L-IMPORT PAYROLL-ONICA ANTHONY J,D108,HJ,140.49,,21234.25
6150,7/31/2020,7/31/2020,73120,82L-IMPORT PAYROLL-PRAHIN NICOLE M,D108,HJ,52.91,,21287.16
6150,7/31/2020,7/31/2020,73120,82L-IMPORT PAYROLL-PRAHIN NICOLE M,D108,HJ,226.22,,21513.38
6150,7/31/2020,7/31/2020,73120,82L-IMPORT PAYROLL-RIVERS QUIONNA DIANE,D108,HJ,36.46,,21549.84
6150,7/31/2020,7/31/2020,73120,82L-IMPORT PAYROLL-RIVERS QUIONNA DIANE,D108,HJ,155.89,,21705.73
6150,7/31/2020,7/31/2020,73120,82L-IMPORT PAYROLL-SALIM YASSER,D108,HJ,33.1,,21738.83
6150,7/31/2020,7/31/2020,73120,82L-IMPORT PAYROLL-SALIM YASSER,D108,HJ,141.55,,21880.38
6150,7/31/2020,7/31/2020,73120,82L-IMPORT PAYROLL-SEJOUR MAHALIAH,D108,HJ,34.07,,21914.45
6150,7/31/2020,7/31/2020,73120,82L-IMPORT PAYROLL-SEJOUR MAHALIAH,D108,HJ,145.66,,22060.11
6150,7/31/2020,7/31/2020,73120,82L-IMPORT PAYROLL-SKALSKI CHRISTOPHER,D108,HJ,33.86,,22093.97
6150,7/31/2020,7/31/2020,73120,82L-IMPORT PAYROLL-SKALSKI CHRISTOPHER,D108,HJ,144.76,,22238.73
6150,7/31/2020,7/31/2020,73120,82L-IMPORT PAYROLL-SMITH AKILAH,D108,HJ,19.92,,22258.65
6150,7/31/2020,7/31/2020,73120,82L-IMPORT PAYROLL-SMITH AKILAH,D108,HJ,85.17,,22343.82
6150,7/31/2020,7/31/2020,73120,82L-IMPORT PAYROLL-TAM CW RYAN,D108,HJ,21.4,,22365.22
6150,7/31/2020,7/31/2020,73120,82L-IMPORT PAYROLL-TAM CW RYAN,D108,HJ,91.51,,22456.73
6150,7/31/2020,7/31/2020,73120,82L-IMPORT PAYROLL-TENESACA VERONICA A,D108,HJ,19,,22475.73
6150,7/31/2020,7/31/2020,73120,82L-IMPORT PAYROLL-TENESACA VERONICA A,D108,HJ,81.25,,22556.98
6150,7/31/2020,7/31/2020,73120,82L-IMPORT PAYROLL-TUMENJARGAL ENKHJIN,D108,HJ,32.92,,22589.9
6150,7/31/2020,7/31/2020,73120,82L-IMPORT PAYROLL-TUMENJARGAL ENKHJIN,D108,HJ,140.75,,22730.65
6150,7/31/2020,7/31/2020,73120,82L-IMPORT PAYROLL-VILLEGAS EVELYN,D108,HJ,33.4,,22764.05
6150,7/31/2020,7/31/2020,73120,82L-IMPORT PAYROLL-VILLEGAS EVELYN,D108,HJ,142.81,,22906.86
6150,7/31/2020,7/31/2020,73120,82L-IMPORT PAYROLL-WOLF ANNA A,D108,HJ,36.3,,22943.16
6150,7/31/2020,7/31/2020,73120,82L-IMPORT PAYROLL-WOLF ANNA A,D108,HJ,155.19,,23098.35
6150,7/31/2020,7/31/2020,73120,82L-IMPORT PAYROLL-ACEVEDO MONIVETT,D107,HJ,29.69,,23128.04
6150,7/31/2020,7/31/2020,73120,82L-IMPORT PAYROLL-ACEVEDO MONIVETT,D107,HJ,42.73,,23170.77
6150,7/31/2020,7/31/2020,73120,82L-IMPORT PAYROLL-ACEVEDO MONIVETT,D107,HJ,126.95,,23297.72
6150,7/31/2020,7/31/2020,73120,82L-IMPORT PAYROLL-ACEVEDO MONIVETT,D107,HJ,182.69,,23480.41
6150,7/31/2020,7/31/2020,73120,82L-IMPORT PAYROLL-AKLESTAD ISABEL,D111,HJ,23.29,,23503.7
6150,7/31/2020,7/31/2020,73120,82L-IMPORT PAYROLL-AKLESTAD ISABEL,D111,HJ,99.58,,23603.28
6150,7/31/2020,7/31/2020,73120,82L-IMPORT PAYROLL-ALLEN KIMBERLY MARY,D111,HJ,26.58,,23629.86
6150,7/31/2020,7/31/2020,73120,82L-IMPORT PAYROLL-ALLEN KIMBERLY MARY,D111,HJ,113.67,,23743.53
6150,7/31/2020,7/31/2020,73120,82L-IMPORT PAYROLL-BOWMAN HALLEY K,D101,HJ,49.84,,23793.37
6150,7/31/2020,7/31/2020,73120,82L-IMPORT PAYROLL-BOWMAN HALLEY K,D101,HJ,213.13,,24006.5
6150,7/31/2020,7/31/2020,73120,82L-IMPORT PAYROLL-COOK CATHRYN ANNA,D105,HJ,49.87,,24056.37
6150,7/31/2020,7/31/2020,73120,82L-IMPORT PAYROLL-COOK CATHRYN ANNA,D105,HJ,213.25,,24269.62
6150,7/31/2020,7/31/2020,73120,82L-IMPORT PAYROLL-COOPER ASHLEE R,D101,HJ,33.51,,24303.13
6150,7/31/2020,7/31/2020,73120,82L-IMPORT PAYROLL-COOPER ASHLEE R,D101,HJ,143.3,,24446.43
6150,7/31/2020,7/31/2020,73120,82L-IMPORT PAYROLL-CORTEZ MIRANDA A,D111,HJ,38.45,,24484.88
6150,7/31/2020,7/31/2020,73120,82L-IMPORT PAYROLL-CORTEZ MIRANDA A,D111,HJ,164.42,,24649.3
6150,7/31/2020,7/31/2020,73120,82L-IMPORT PAYROLL-DAUGHERTY DEVIN W,D101,HJ,15.1,,24664.4
6150,7/31/2020,7/31/2020,73120,82L-IMPORT PAYROLL-DAUGHERTY DEVIN W,D101,HJ,64.58,,24728.98
6150,7/31/2020,7/31/2020,73120,82L-IMPORT PAYROLL-DETONE KYRA MAYA,D102,HJ,39,,24767.98
6150,7/31/2020,7/31/2020,73120,82L-IMPORT PAYROLL-DETONE KYRA MAYA,D102,HJ,166.75,,24934.73
6150,7/31/2020,7/31/2020,73120,82L-IMPORT PAYROLL-DUPUIS CHRISTOPHER M,D107,HJ,43.48,,24978.21
6150,7/31/2020,7/31/2020,73120,82L-IMPORT PAYROLL-DUPUIS CHRISTOPHER M,D107,HJ,45.26,,25023.47
6150,7/31/2020,7/31/2020,73120,82L-IMPORT PAYROLL-DUPUIS CHRISTOPHER M,D107,HJ,185.93,,25209.4
6150,7/31/2020,7/31/2020,73120,82L-IMPORT PAYROLL-DUPUIS CHRISTOPHER M,D107,HJ,193.52,,25402.92
6150,7/31/2020,7/31/2020,73120,82L-IMPORT PAYROLL-DZIEDZIC JULIE K,D101,HJ,17.71,,25420.63
6150,7/31/2020,7/31/2020,73120,82L-IMPORT PAYROLL-DZIEDZIC JULIE K,D101,HJ,75.71,,25496.34
6150,7/31/2020,7/31/2020,73120,82L-IMPORT PAYROLL-GORNSTEIN STEVEN,D101,HJ,39.27,,25535.61
6150,7/31/2020,7/31/2020,73120,82L-IMPORT PAYROLL-GORNSTEIN STEVEN,D101,HJ,114.45,,25650.06
6150,7/31/2020,7/31/2020,73120,82L-IMPORT PAYROLL-GORNSTEIN STEVEN,D101,HJ,167.92,,25817.98
6150,7/31/2020,7/31/2020,73120,82L-IMPORT PAYROLL-GRAVES KAMIESHIA,D101,HJ,26.3,,25844.28
6150,7/31/2020,7/31/2020,73120,82L-IMPORT PAYROLL-GRAVES KAMIESHIA,D101,HJ,112.45,,25956.73
6150,7/31/2020,7/31/2020,73120,82L-IMPORT PAYROLL-GUADARRAMA-ALVAREZ URIEL A,D105,HJ,39.93,,25996.66
6150,7/31/2020,7/31/2020,73120,82L-IMPORT PAYROLL-GUADARRAMA-ALVAREZ URIEL A,D105,HJ,170.75,,26167.41
6150,7/31/2020,7/31/2020,73120,82L-IMPORT PAYROLL-GUTIERREZ ANTONIO J,D107,HJ,74.25,,26241.66
6150,7/31/2020,7/31/2020,73120,82L-IMPORT PAYROLL-GUTIERREZ ANTONIO J,D107,HJ,317.48,,26559.14
6150,7/31/2020,7/31/2020,73120,82L-IMPORT PAYROLL-HESTER TYLER CONRAD,D105,HJ,30.36,,26589.5
6150,7/31/2020,7/31/2020,73120,82L-IMPORT PAYROLL-HESTER TYLER CONRAD,D105,HJ,129.8,,26719.3
6150,7/31/2020,7/31/2020,73120,82L-IMPORT PAYROLL-LACEY DEQUITA,D107,HJ,35.7,,26755
6150,7/31/2020,7/31/2020,73120,82L-IMPORT PAYROLL-LACEY DEQUITA,D107,HJ,152.64,,26907.64
6150,7/31/2020,7/31/2020,73120,82L-IMPORT PAYROLL-LIPORACE HERNAN LUIS,D103,HJ,33.06,,26940.7
6150,7/31/2020,7/31/2020,73120,82L-IMPORT PAYROLL-LIPORACE HERNAN LUIS,D103,HJ,61.55,,27002.25
6150,7/31/2020,7/31/2020,73120,82L-IMPORT PAYROLL-LIPORACE HERNAN LUIS,D103,HJ,141.34,,27143.59
6150,7/31/2020,7/31/2020,73120,82L-IMPORT PAYROLL-MASON ANGELA,D107,HJ,78.57,,27222.16
6150,7/31/2020,7/31/2020,73120,82L-IMPORT PAYROLL-MASON ANGELA,D107,HJ,335.97,,27558.13
6150,7/31/2020,7/31/2020,73120,82L-IMPORT PAYROLL-ODONNELL STEPHEN,D104,HJ,39.86,,27597.99
6150,7/31/2020,7/31/2020,73120,82L-IMPORT PAYROLL-ODONNELL STEPHEN,D104,HJ,170.45,,27768.44
6150,7/31/2020,7/31/2020,73120,82L-IMPORT PAYROLL-PARETS MALLORY GRACE,D101,HJ,20.81,,27789.25
6150,7/31/2020,7/31/2020,73120,82L-IMPORT PAYROLL-PARETS MALLORY GRACE,D101,HJ,48.67,,27837.92
6150,7/31/2020,7/31/2020,73120,82L-IMPORT PAYROLL-PARETS MALLORY GRACE,D101,HJ,90.62,,27928.54
6150,7/31/2020,7/31/2020,73120,82L-IMPORT PAYROLL-PARETS MALLORY GRACE,D101,HJ,208.1,,28136.64
6150,7/31/2020,7/31/2020,73120,82L-IMPORT PAYROLL-PARHAM-GANTT DENISE M,D112,HJ,37.96,,28174.6
6150,7/31/2020,7/31/2020,73120,82L-IMPORT PAYROLL-PARHAM-GANTT DENISE M,D112,HJ,162.32,,28336.92
6150,7/31/2020,7/31/2020,73120,82L-IMPORT PAYROLL-PEINADO ELIZABETH R,D111,HJ,52.29,,28389.21
6150,7/31/2020,7/31/2020,73120,82L-IMPORT PAYROLL-PEINADO ELIZABETH R,D111,HJ,223.58,,28612.79
6150,7/31/2020,7/31/2020,73120,82L-IMPORT PAYROLL-POLANCO ODALIS,D103,HJ,43.23,,28656.02
6150,7/31/2020,7/31/2020,73120,82L-IMPORT PAYROLL-POLANCO ODALIS,D103,HJ,184.83,,28840.85
6150,7/31/2020,7/31/2020,73120,82L-IMPORT PAYROLL-RANDOLPH ALEXANDER,D111,HJ,11.63,,28852.48
6150,7/31/2020,7/31/2020,73120,82L-IMPORT PAYROLL-RANDOLPH ALEXANDER,D111,HJ,25.1,,28877.58
6150,7/31/2020,7/31/2020,73120,82L-IMPORT PAYROLL-RANDOLPH ALEXANDER,D111,HJ,50.63,,28928.21
6150,7/31/2020,7/31/2020,73120,82L-IMPORT PAYROLL-RANDOLPH ALEXANDER,D111,HJ,107.33,,29035.54
6150,7/31/2020,7/31/2020,73120,82L-IMPORT PAYROLL-SAFRAN ALAN P,D107,HJ,8.68,,29044.22
6150,7/31/2020,7/31/2020,73120,82L-IMPORT PAYROLL-SAFRAN ALAN P,D107,HJ,37.09,,29081.31
6150,7/31/2020,7/31/2020,73120,82L-IMPORT PAYROLL-SAFRAN ALAN P,D107,HJ,99.75,,29181.06
6150,7/31/2020,7/31/2020,73120,82L-IMPORT PAYROLL-SAFRAN ALAN P,D107,HJ,426.53,,29607.59
6150,7/31/2020,7/31/2020,73120,82L-IMPORT PAYROLL-SHENKMAN OLIVIA,D101,HJ,29,,29636.59
6150,7/31/2020,7/31/2020,73120,82L-IMPORT PAYROLL-SHENKMAN OLIVIA,D101,HJ,124,,29760.59
6150,7/31/2020,7/31/2020,73120,82L-IMPORT PAYROLL-SHI GRACE,D103,HJ,12.69,,29773.28
6150,7/31/2020,7/31/2020,73120,82L-IMPORT PAYROLL-SHI GRACE,D103,HJ,36.98,,29810.26
6150,7/31/2020,7/31/2020,73120,82L-IMPORT PAYROLL-SHI GRACE,D103,HJ,54.25,,29864.51
6150,7/31/2020,7/31/2020,73120,82L-IMPORT PAYROLL-WALLACE AMENA T,D104,HJ,28.93,,29893.44
6150,7/31/2020,7/31/2020,73120,82L-IMPORT PAYROLL-WALLACE AMENA T,D104,HJ,123.72,,30017.16
6150,7/31/2020,7/31/2020,73120,82L-IMPORT PAYROLL-WEINSTOCK EMILY,D101,HJ,17.57,,30034.73
6150,7/31/2020,7/31/2020,73120,82L-IMPORT PAYROLL-WEINSTOCK EMILY,D101,HJ,41.08,,30075.81
6150,7/31/2020,7/31/2020,73120,82L-IMPORT PAYROLL-WEINSTOCK EMILY,D101,HJ,76.5,,30152.31
6150,7/31/2020,7/31/2020,73120,82L-IMPORT PAYROLL-WEINSTOCK EMILY,D101,HJ,175.67,,30327.98
6150,7/31/2020,7/31/2020,73120,82L-IMPORT PAYROLL-WINANS JENNIFER,D111,HJ,36.33,,30364.31
6150,7/31/2020,7/31/2020,73120,82L-IMPORT PAYROLL-WINANS JENNIFER,D111,HJ,155.35,,30519.66
6150,7/31/2020,7/31/2020,73120,82L-IMPORT PAYROLL-ZARATE JOSEPH M,D105,HJ,31.18,,30550.84
6150,7/31/2020,7/31/2020,73120,82L-IMPORT PAYROLL-ZARATE JOSEPH M,D105,HJ,133.3,,30684.14
6150,7/31/2020,7/31/2020,73120,82L-IMPORT PAYROLL-ARCHER AUBREYNA,D108,HJ,39.86,,30724
6150,7/31/2020,7/31/2020,73120,82L-IMPORT PAYROLL-ARCHER AUBREYNA,D108,HJ,170.44,,30894.44
6150,7/31/2020,7/31/2020,73120,82L-IMPORT PAYROLL-BARTOLD DEANNA MARIE,D108,HJ,41.91,,30936.35
6150,7/31/2020,7/31/2020,73120,82L-IMPORT PAYROLL-BARTOLD DEANNA MARIE,D108,HJ,179.22,,31115.57
6150,7/31/2020,7/31/2020,73120,82L-IMPORT PAYROLL-BELLOT GENESIS,D108,HJ,31.93,,31147.5
6150,7/31/2020,7/31/2020,73120,82L-IMPORT PAYROLL-BELLOT GENESIS,D108,HJ,136.53,,31284.03
6150,7/31/2020,7/31/2020,73120,82L-IMPORT PAYROLL-CIRKER MIA,D108,HJ,32.63,,31316.66
6150,7/31/2020,7/31/2020,73120,82L-IMPORT PAYROLL-CIRKER MIA,D108,HJ,139.5,,31456.16
6150,7/31/2020,7/31/2020,73120,82L-IMPORT PAYROLL-FEIGHERY JOHN,D108,HJ,30.56,,31486.72
6150,7/31/2020,7/31/2020,73120,82L-IMPORT PAYROLL-FEIGHERY JOHN,D108,HJ,130.69,,31617.41
6150,7/31/2020,7/31/2020,73120,82L-IMPORT PAYROLL-GARCIA MARILYN,D108,HJ,33.23,,31650.64
6150,7/31/2020,7/31/2020,73120,82L-IMPORT PAYROLL-GARCIA MARILYN,D108,HJ,142.08,,31792.72
6150,7/31/2020,7/31/2020,73120,82L-IMPORT PAYROLL-GARNER IVORY,D108,HJ,26.45,,31819.17
6150,7/31/2020,7/31/2020,73120,82L-IMPORT PAYROLL-GARNER IVORY,D108,HJ,113.09,,31932.26
6150,7/31/2020,7/31/2020,73120,82L-IMPORT PAYROLL-GRIFFIN ANDREW,D108,HJ,30.44,,31962.7
6150,7/31/2020,7/31/2020,73120,82L-IMPORT PAYROLL-GRIFFIN ANDREW,D108,HJ,130.16,,32092.86
6150,7/31/2020,7/31/2020,73120,82L-IMPORT PAYROLL-HALLINAN GABRIEL B,D108,HJ,34.79,,32127.65
6150,7/31/2020,7/31/2020,73120,82L-IMPORT PAYROLL-HALLINAN GABRIEL B,D108,HJ,148.76,,32276.41
6150,7/31/2020,7/31/2020,73120,82L-IMPORT PAYROLL-HOLDER LATIVA M,D108,HJ,55.28,,32331.69
6150,7/31/2020,7/31/2020,73120,82L-IMPORT PAYROLL-HOLDER LATIVA M,D108,HJ,236.38,,32568.07
6150,7/31/2020,7/31/2020,73120,82L-IMPORT PAYROLL-HOSSAIN MYESHA R,D108,HJ,35.1,,32603.17
6150,7/31/2020,7/31/2020,73120,82L-IMPORT PAYROLL-HOSSAIN MYESHA R,D108,HJ,150.1,,32753.27
6150,7/31/2020,7/31/2020,73120,82L-IMPORT PAYROLL-JACKSON TASNIM F,D108,HJ,31,,32784.27
6150,7/31/2020,7/31/2020,73120,82L-IMPORT PAYROLL-JACKSON TASNIM F,D108,HJ,132.56,,32916.83
6150,7/31/2020,7/31/2020,73120,82L-IMPORT PAYROLL-KALOKOH BAINDU,D108,HJ,18.96,,32935.79
6150,7/31/2020,7/31/2020,73120,82L-IMPORT PAYROLL-KALOKOH BAINDU,D108,HJ,81.07,,33016.86
6150,7/31/2020,7/31/2020,73120,82L-IMPORT PAYROLL-LI BELLA,D108,HJ,33.96,,33050.82
6150,7/31/2020,7/31/2020,73120,82L-IMPORT PAYROLL-LI BELLA,D108,HJ,145.23,,33196.05
6150,7/31/2020,7/31/2020,73120,82L-IMPORT PAYROLL-MOSELEY ARIELLE,D108,HJ,37.83,,33233.88
6150,7/31/2020,7/31/2020,73120,82L-IMPORT PAYROLL-MOSELEY ARIELLE,D108,HJ,161.75,,33395.63
6150,7/31/2020,7/31/2020,73120,82L-IMPORT PAYROLL-TILLERY ASIA,D108,HJ,47.73,,33443.36
6150,7/31/2020,7/31/2020,73120,82L-IMPORT PAYROLL-TILLERY ASIA,D108,HJ,204.08,,33647.44
6150,7/31/2020,7/31/2020,73120,82L-IMPORT PAYROLL-BALASUBRAMANIAN SHARANYA,D108,HJ,38.67,,33686.11
6150,7/31/2020,7/31/2020,73120,82L-IMPORT PAYROLL-BALASUBRAMANIAN SHARANYA,D108,HJ,93.33,,33779.44
6150,7/31/2020,7/31/2020,73120,82L-IMPORT PAYROLL-BALASUBRAMANIAN SHARANYA,D108,HJ,165.33,,33944.77
6150,7/31/2020,7/31/2020,73120,82L-IMPORT PAYROLL-COVENEY ALLISON,D108,HJ,38.07,,33982.84
6150,7/31/2020,7/31/2020,73120,82L-IMPORT PAYROLL-COVENEY ALLISON,D108,HJ,162.79,,34145.63
6150,7/31/2020,7/31/2020,73120,82L-IMPORT PAYROLL-GRAVES KIRA B,D101,HJ,2.98,,34148.61
6150,7/31/2020,7/31/2020,73120,82L-IMPORT PAYROLL-GRAVES KIRA B,D101,HJ,6.98,,34155.59
6150,7/31/2020,7/31/2020,73120,82L-IMPORT PAYROLL-GRAVES KIRA B,D101,HJ,29.83,,34185.42
6150,7/31/2020,7/31/2020,73120,82L-IMPORT PAYROLL-JACKSON CLAICE M,D108,HJ,19.38,,34204.8
6150,7/31/2020,7/31/2020,73120,82L-IMPORT PAYROLL-JACKSON CLAICE M,D108,HJ,42.91,,34247.71
6150,7/31/2020,7/31/2020,73120,82L-IMPORT PAYROLL-JACKSON CLAICE M,D108,HJ,183.48,,34431.19
6150,7/31/2020,7/31/2020,73120,82L-IMPORT PAYROLL-JANG DANIEL,D108,HJ,37.75,,34468.94
6150,7/31/2020,7/31/2020,73120,82L-IMPORT PAYROLL-JANG DANIEL,D108,HJ,161.4,,34630.34
6150,7/31/2020,7/31/2020,73120,82L-IMPORT PAYROLL-LENEGHAN MARYELLEN B,D108,HJ,23.64,,34653.98
6150,7/31/2020,7/31/2020,73120,82L-IMPORT PAYROLL-LENEGHAN MARYELLEN B,D108,HJ,25.54,,34679.52
6150,7/31/2020,7/31/2020,73120,82L-IMPORT PAYROLL-LENEGHAN MARYELLEN B,D108,HJ,27.66,,34707.18
6150,7/31/2020,7/31/2020,73120,82L-IMPORT PAYROLL-LENEGHAN MARYELLEN B,D108,HJ,109.18,,34816.36
6150,7/31/2020,7/31/2020,73120,82L-IMPORT PAYROLL-LENEGHAN MARYELLEN B,D108,HJ,118.28,,34934.64
6150,7/31/2020,7/31/2020,Reallocation to GM3 - ACY2,To reallocate Salaraies to GM3 - ACY2-To reallocate Salaries to GM3 - ACY2 ( Lacey Dequita Stephen Odonell Wallace Amena),D104,HJ,1175.92,,36110.56
6150,7/31/2020,7/31/2020,Reallocation to GM3 - ACY2,To Reverse JE-21-0052-To reallocate Salaries to GM3 - ACY2 ( Lacey Dequita Stephen Odonell Wallace Amena),D104,HJ,,1175.92,34934.64
6150,8/14/2020,8/14/2020,81420,82L-IMPORT PAYROLL-ALVAREZ-MORINE LISIS,D108,HJ,34.63,,34969.27
6150,8/14/2020,8/14/2020,81420,82L-IMPORT PAYROLL-ALVAREZ-MORINE LISIS,D108,HJ,64.48,,35033.75
6150,8/14/2020,8/14/2020,81420,82L-IMPORT PAYROLL-ALVAREZ-MORINE LISIS,D108,HJ,148.06,,35181.81
6150,8/14/2020,8/14/2020,81420,82L-IMPORT PAYROLL-ALWARDT CALEB,D108,HJ,15.19,,35197
6150,8/14/2020,8/14/2020,81420,82L-IMPORT PAYROLL-ALWARDT CALEB,D108,HJ,64.95,,35261.95
6150,8/14/2020,8/14/2020,81420,82L-IMPORT PAYROLL-BARTHELEMY RACHALIE,D108,HJ,14.01,,35275.96
6150,8/14/2020,8/14/2020,81420,82L-IMPORT PAYROLL-BARTHELEMY RACHALIE,D108,HJ,26.08,,35302.04
6150,8/14/2020,8/14/2020,81420,82L-IMPORT PAYROLL-BARTHELEMY RACHALIE,D108,HJ,59.89,,35361.93
6150,8/14/2020,8/14/2020,81420,82L-IMPORT PAYROLL-BOHLSEN GRACE,D108,HJ,15.19,,35377.12
6150,8/14/2020,8/14/2020,81420,82L-IMPORT PAYROLL-BOHLSEN GRACE,D108,HJ,64.95,,35442.07
6150,8/14/2020,8/14/2020,81420,82L-IMPORT PAYROLL-BORCHART SPENCER,D108,HJ,15.19,,35457.26
6150,8/14/2020,8/14/2020,81420,82L-IMPORT PAYROLL-BORCHART SPENCER,D108,HJ,44.27,,35501.53
6150,8/14/2020,8/14/2020,81420,82L-IMPORT PAYROLL-BORCHART SPENCER,D108,HJ,64.95,,35566.48
6150,8/14/2020,8/14/2020,81420,82L-IMPORT PAYROLL-BREEDLOVE JOHNDEE L,D108,HJ,14.98,,35581.46
6150,8/14/2020,8/14/2020,81420,82L-IMPORT PAYROLL-BREEDLOVE JOHNDEE L,D108,HJ,27.89,,35609.35
6150,8/14/2020,8/14/2020,81420,82L-IMPORT PAYROLL-BREEDLOVE JOHNDEE L,D108,HJ,64.03,,35673.38
6150,8/14/2020,8/14/2020,81420,82L-IMPORT PAYROLL-BROWN ISAAC,D108,HJ,15.19,,35688.57
6150,8/14/2020,8/14/2020,81420,82L-IMPORT PAYROLL-BROWN ISAAC,D108,HJ,20.14,,35708.71
6150,8/14/2020,8/14/2020,81420,82L-IMPORT PAYROLL-BROWN ISAAC,D108,HJ,64.95,,35773.66
6150,8/14/2020,8/14/2020,81420,82L-IMPORT PAYROLL-BURKE MARIAH,D108,HJ,15.19,,35788.85
6150,8/14/2020,8/14/2020,81420,82L-IMPORT PAYROLL-BURKE MARIAH,D108,HJ,64.95,,35853.8
6150,8/14/2020,8/14/2020,81420,82L-IMPORT PAYROLL-CHAVOUS MILFORD,D108,HJ,15.19,,35868.99
6150,8/14/2020,8/14/2020,81420,82L-IMPORT PAYROLL-CHAVOUS MILFORD,D108,HJ,28.29,,35897.28
6150,8/14/2020,8/14/2020,81420,82L-IMPORT PAYROLL-CHAVOUS MILFORD,D108,HJ,64.95,,35962.23
6150,8/14/2020,8/14/2020,81420,82L-IMPORT PAYROLL-CHEN LING,D108,HJ,15.19,,35977.42
6150,8/14/2020,8/14/2020,81420,82L-IMPORT PAYROLL-CHEN LING,D108,HJ,64.95,,36042.37
6150,8/14/2020,8/14/2020,81420,82L-IMPORT PAYROLL-DARKO OLIVIA,D108,HJ,15.19,,36057.56
6150,8/14/2020,8/14/2020,81420,82L-IMPORT PAYROLL-DARKO OLIVIA,D108,HJ,64.95,,36122.51
6150,8/14/2020,8/14/2020,81420,82L-IMPORT PAYROLL-DAWSON JAMIL NAFAYE-BEYAH,D108,HJ,15.19,,36137.7
6150,8/14/2020,8/14/2020,81420,82L-IMPORT PAYROLL-DAWSON JAMIL NAFAYE-BEYAH,D108,HJ,64.95,,36202.65
6150,8/14/2020,8/14/2020,81420,82L-IMPORT PAYROLL-GILES SHAYLA,D108,HJ,15.19,,36217.84
6150,8/14/2020,8/14/2020,81420,82L-IMPORT PAYROLL-GILES SHAYLA,D108,HJ,28.29,,36246.13
6150,8/14/2020,8/14/2020,81420,82L-IMPORT PAYROLL-GILES SHAYLA,D108,HJ,64.95,,36311.08
6150,8/14/2020,8/14/2020,81420,82L-IMPORT PAYROLL-JONES JORDAN,D108,HJ,15.19,,36326.27
6150,8/14/2020,8/14/2020,81420,82L-IMPORT PAYROLL-JONES JORDAN,D108,HJ,64.95,,36391.22
6150,8/14/2020,8/14/2020,81420,82L-IMPORT PAYROLL-KHAN HUDA,D108,HJ,15.19,,36406.41
6150,8/14/2020,8/14/2020,81420,82L-IMPORT PAYROLL-KHAN HUDA,D108,HJ,28.29,,36434.7
6150,8/14/2020,8/14/2020,81420,82L-IMPORT PAYROLL-KHAN HUDA,D108,HJ,64.95,,36499.65
6150,8/14/2020,8/14/2020,81420,82L-IMPORT PAYROLL-KING IRIS,D108,HJ,7.01,,36506.66
6150,8/14/2020,8/14/2020,81420,82L-IMPORT PAYROLL-KING IRIS,D108,HJ,13.05,,36519.71
6150,8/14/2020,8/14/2020,81420,82L-IMPORT PAYROLL-KING IRIS,D108,HJ,29.98,,36549.69
6150,8/14/2020,8/14/2020,81420,82L-IMPORT PAYROLL-KLOHR TIMOTHY JORDAN,D108,HJ,21.41,,36571.1
6150,8/14/2020,8/14/2020,81420,82L-IMPORT PAYROLL-KLOHR TIMOTHY JORDAN,D108,HJ,39.88,,36610.98
6150,8/14/2020,8/14/2020,81420,82L-IMPORT PAYROLL-KLOHR TIMOTHY JORDAN,D108,HJ,91.57,,36702.55
6150,8/14/2020,8/14/2020,81420,82L-IMPORT PAYROLL-KOPSHEVER MELISSA,D108,HJ,42.29,,36744.84
6150,8/14/2020,8/14/2020,81420,82L-IMPORT PAYROLL-KOPSHEVER MELISSA,D108,HJ,52.1,,36796.94
6150,8/14/2020,8/14/2020,81420,82L-IMPORT PAYROLL-KOPSHEVER MELISSA,D108,HJ,180.83,,36977.77
6150,8/14/2020,8/14/2020,81420,82L-IMPORT PAYROLL-LI SEN YUAN,D108,HJ,14.05,,36991.82
6150,8/14/2020,8/14/2020,81420,82L-IMPORT PAYROLL-LI SEN YUAN,D108,HJ,26.16,,37017.98
6150,8/14/2020,8/14/2020,81420,82L-IMPORT PAYROLL-LI SEN YUAN,D108,HJ,60.07,,37078.05
6150,8/14/2020,8/14/2020,81420,82L-IMPORT PAYROLL-LIPSCOMB STEPHEN,D108,HJ,33.58,,37111.63
6150,8/14/2020,8/14/2020,81420,82L-IMPORT PAYROLL-LIPSCOMB STEPHEN,D108,HJ,62.53,,37174.16
6150,8/14/2020,8/14/2020,81420,82L-IMPORT PAYROLL-LIPSCOMB STEPHEN,D108,HJ,143.59,,37317.75
6150,8/14/2020,8/14/2020,81420,82L-IMPORT PAYROLL-MCLAUGHLIN MARA,D108,HJ,15.19,,37332.94
6150,8/14/2020,8/14/2020,81420,82L-IMPORT PAYROLL-MCLAUGHLIN MARA,D108,HJ,64.95,,37397.89
6150,8/14/2020,8/14/2020,81420,82L-IMPORT PAYROLL-MEJIA CARLOS MANUEL,D108,HJ,14.01,,37411.9
6150,8/14/2020,8/14/2020,81420,82L-IMPORT PAYROLL-MEJIA CARLOS MANUEL,D108,HJ,59.89,,37471.79
6150,8/14/2020,8/14/2020,81420,82L-IMPORT PAYROLL-MONROY-MEJIA JASON,D108,HJ,15.19,,37486.98
6150,8/14/2020,8/14/2020,81420,82L-IMPORT PAYROLL-MONROY-MEJIA JASON,D108,HJ,36.67,,37523.65
6150,8/14/2020,8/14/2020,81420,82L-IMPORT PAYROLL-MONROY-MEJIA JASON,D108,HJ,64.95,,37588.6
6150,8/14/2020,8/14/2020,81420,82L-IMPORT PAYROLL-O'FLYNN-PRUITT NATHAN COLYAR,D108,HJ,15.19,,37603.79
6150,8/14/2020,8/14/2020,81420,82L-IMPORT PAYROLL-O'FLYNN-PRUITT NATHAN COLYAR,D108,HJ,36.67,,37640.46
6150,8/14/2020,8/14/2020,81420,82L-IMPORT PAYROLL-O'FLYNN-PRUITT NATHAN COLYAR,D108,HJ,64.95,,37705.41
6150,8/14/2020,8/14/2020,81420,82L-IMPORT PAYROLL-PATTERSON STEVE,D108,HJ,15.19,,37720.6
6150,8/14/2020,8/14/2020,81420,82L-IMPORT PAYROLL-PATTERSON STEVE,D108,HJ,28.29,,37748.89
6150,8/14/2020,8/14/2020,81420,82L-IMPORT PAYROLL-PATTERSON STEVE,D108,HJ,64.95,,37813.84
6150,8/14/2020,8/14/2020,81420,82L-IMPORT PAYROLL-ROBBINS DEANNA,D108,HJ,36.85,,37850.69
6150,8/14/2020,8/14/2020,81420,82L-IMPORT PAYROLL-ROBBINS DEANNA,D108,HJ,68.63,,37919.32
6150,8/14/2020,8/14/2020,81420,82L-IMPORT PAYROLL-ROBBINS DEANNA,D108,HJ,157.58,,38076.9
6150,8/14/2020,8/14/2020,81420,82L-IMPORT PAYROLL-SCOTT KIRK DONOVAN,D108,HJ,14.05,,38090.95
6150,8/14/2020,8/14/2020,81420,82L-IMPORT PAYROLL-SCOTT KIRK DONOVAN,D108,HJ,26.16,,38117.11
6150,8/14/2020,8/14/2020,81420,82L-IMPORT PAYROLL-SCOTT KIRK DONOVAN,D108,HJ,60.07,,38177.18
6150,8/14/2020,8/14/2020,81420,82L-IMPORT PAYROLL-SILVER KELLY,D108,HJ,34.63,,38211.81
6150,8/14/2020,8/14/2020,81420,82L-IMPORT PAYROLL-SILVER KELLY,D108,HJ,64.48,,38276.29
6150,8/14/2020,8/14/2020,81420,82L-IMPORT PAYROLL-SILVER KELLY,D108,HJ,148.06,,38424.35
6150,8/14/2020,8/14/2020,81420,82L-IMPORT PAYROLL-SOLIMAN MARK,D108,HJ,15.19,,38439.54
6150,8/14/2020,8/14/2020,81420,82L-IMPORT PAYROLL-SOLIMAN MARK,D108,HJ,36.67,,38476.21
6150,8/14/2020,8/14/2020,81420,82L-IMPORT PAYROLL-SOLIMAN MARK,D108,HJ,64.95,,38541.16
6150,8/14/2020,8/14/2020,81420,82L-IMPORT PAYROLL-STROUD DAVID,D108,HJ,14.65,,38555.81
6150,8/14/2020,8/14/2020,81420,82L-IMPORT PAYROLL-STROUD DAVID,D108,HJ,62.62,,38618.43
6150,8/14/2020,8/14/2020,81420,82L-IMPORT PAYROLL-VALCIN SABRINA JEMIMAH,D108,HJ,14.25,,38632.68
6150,8/14/2020,8/14/2020,81420,82L-IMPORT PAYROLL-VALCIN SABRINA JEMIMAH,D108,HJ,26.53,,38659.21
6150,8/14/2020,8/14/2020,81420,82L-IMPORT PAYROLL-VALCIN SABRINA JEMIMAH,D108,HJ,60.92,,38720.13
6150,8/14/2020,8/14/2020,81420,82L-IMPORT PAYROLL-WILLIAMS MACK ANTHONY,D108,HJ,14.07,,38734.2
6150,8/14/2020,8/14/2020,81420,82L-IMPORT PAYROLL-WILLIAMS MACK ANTHONY,D108,HJ,26.21,,38760.41
6150,8/14/2020,8/14/2020,81420,82L-IMPORT PAYROLL-WILLIAMS MACK ANTHONY,D108,HJ,60.18,,38820.59
6150,8/14/2020,8/14/2020,81420,82L-IMPORT PAYROLL-WILLIAMS MIL'YONTA,D108,HJ,15.19,,38835.78
6150,8/14/2020,8/14/2020,81420,82L-IMPORT PAYROLL-WILLIAMS MIL'YONTA,D108,HJ,64.95,,38900.73
6150,8/14/2020,8/14/2020,81420,82L-IMPORT PAYROLL-ANTHONY BETTY S,D108,HJ,41.85,,38942.58
6150,8/14/2020,8/14/2020,81420,82L-IMPORT PAYROLL-ANTHONY BETTY S,D108,HJ,178.96,,39121.54
6150,8/14/2020,8/14/2020,81420,82L-IMPORT PAYROLL-AUSTIN PERCY,D108,HJ,36.34,,39157.88
6150,8/14/2020,8/14/2020,81420,82L-IMPORT PAYROLL-AUSTIN PERCY,D108,HJ,155.39,,39313.27
6150,8/14/2020,8/14/2020,81420,82L-IMPORT PAYROLL-BAUSH DANIEL,D108,HJ,37.97,,39351.24
6150,8/14/2020,8/14/2020,81420,82L-IMPORT PAYROLL-BAUSH DANIEL,D108,HJ,162.36,,39513.6
6150,8/14/2020,8/14/2020,81420,82L-IMPORT PAYROLL-CHAPMAN CLAUDY EARL,D108,HJ,26.38,,39539.98
6150,8/14/2020,8/14/2020,81420,82L-IMPORT PAYROLL-CHAPMAN CLAUDY EARL,D108,HJ,112.81,,39652.79
6150,8/14/2020,8/14/2020,81420,82L-IMPORT PAYROLL-DADA ARIKPO E,D108,HJ,30.83,,39683.62
6150,8/14/2020,8/14/2020,81420,82L-IMPORT PAYROLL-DADA ARIKPO E,D108,HJ,131.84,,39815.46
6150,8/14/2020,8/14/2020,81420,82L-IMPORT PAYROLL-GUTHRIE LESLIE,D108,HJ,33.42,,39848.88
6150,8/14/2020,8/14/2020,81420,82L-IMPORT PAYROLL-GUTHRIE LESLIE,D108,HJ,142.9,,39991.78
6150,8/14/2020,8/14/2020,81420,82L-IMPORT PAYROLL-HOLMES JOREL ALEXANDER,D108,HJ,31.22,,40023
6150,8/14/2020,8/14/2020,81420,82L-IMPORT PAYROLL-HOLMES JOREL ALEXANDER,D108,HJ,133.51,,40156.51
6150,8/14/2020,8/14/2020,81420,82L-IMPORT PAYROLL-JORDAN TIFFANY T,D108,HJ,45.87,,40202.38
6150,8/14/2020,8/14/2020,81420,82L-IMPORT PAYROLL-JORDAN TIFFANY T,D108,HJ,196.13,,40398.51
6150,8/14/2020,8/14/2020,81420,82L-IMPORT PAYROLL-LANIGAN LISA A,D108,HJ,45.1,,40443.61
6150,8/14/2020,8/14/2020,81420,82L-IMPORT PAYROLL-LANIGAN LISA A,D108,HJ,192.83,,40636.44
6150,8/14/2020,8/14/2020,81420,82L-IMPORT PAYROLL-MCELWEE MELISSA,D108,HJ,38.67,,40675.11
6150,8/14/2020,8/14/2020,81420,82L-IMPORT PAYROLL-MCELWEE MELISSA,D108,HJ,165.33,,40840.44
6150,8/14/2020,8/14/2020,81420,82L-IMPORT PAYROLL-MCNICHOLAS MARY,D108,HJ,33.23,,40873.67
6150,8/14/2020,8/14/2020,81420,82L-IMPORT PAYROLL-MCNICHOLAS MARY,D108,HJ,142.08,,41015.75
6150,8/14/2020,8/14/2020,81420,82L-IMPORT PAYROLL-NWAKANMA NANCY,D108,HJ,42.32,,41058.07
6150,8/14/2020,8/14/2020,81420,82L-IMPORT PAYROLL-NWAKANMA NANCY,D108,HJ,180.94,,41239.01
6150,8/14/2020,8/14/2020,81420,82L-IMPORT PAYROLL-ONICA ANTHONY J,D108,HJ,31.33,,41270.34
6150,8/14/2020,8/14/2020,81420,82L-IMPORT PAYROLL-ONICA ANTHONY J,D108,HJ,133.98,,41404.32
6150,8/14/2020,8/14/2020,81420,82L-IMPORT PAYROLL-PRAHIN NICOLE M,D108,HJ,52.91,,41457.23
6150,8/14/2020,8/14/2020,81420,82L-IMPORT PAYROLL-PRAHIN NICOLE M,D108,HJ,226.22,,41683.45
6150,8/14/2020,8/14/2020,81420,82L-IMPORT PAYROLL-RIVERS QUIONNA DIANE,D108,HJ,36.46,,41719.91
6150,8/14/2020,8/14/2020,81420,82L-IMPORT PAYROLL-RIVERS QUIONNA DIANE,D108,HJ,155.89,,41875.8
6150,8/14/2020,8/14/2020,81420,82L-IMPORT PAYROLL-SALIM YASSER,D108,HJ,33.1,,41908.9
6150,8/14/2020,8/14/2020,81420,82L-IMPORT PAYROLL-SALIM YASSER,D108,HJ,141.55,,42050.45
6150,8/14/2020,8/14/2020,81420,82L-IMPORT PAYROLL-SEJOUR MAHALIAH,D108,HJ,34.07,,42084.52
6150,8/14/2020,8/14/2020,81420,82L-IMPORT PAYROLL-SEJOUR MAHALIAH,D108,HJ,145.66,,42230.18
6150,8/14/2020,8/14/2020,81420,82L-IMPORT PAYROLL-SKALSKI CHRISTOPHER,D108,HJ,33.86,,42264.04
6150,8/14/2020,8/14/2020,81420,82L-IMPORT PAYROLL-SKALSKI CHRISTOPHER,D108,HJ,144.76,,42408.8
6150,8/14/2020,8/14/2020,81420,82L-IMPORT PAYROLL-TAM CW RYAN,D108,HJ,0.94,,42409.74
6150,8/14/2020,8/14/2020,81420,82L-IMPORT PAYROLL-TAM CW RYAN,D108,HJ,4.03,,42413.77
6150,8/14/2020,8/14/2020,81420,82L-IMPORT PAYROLL-TUMENJARGAL ENKHJIN,D108,HJ,32.92,,42446.69
6150,8/14/2020,8/14/2020,81420,82L-IMPORT PAYROLL-TUMENJARGAL ENKHJIN,D108,HJ,140.75,,42587.44
6150,8/14/2020,8/14/2020,81420,82L-IMPORT PAYROLL-VILLEGAS EVELYN,D108,HJ,33.4,,42620.84
6150,8/14/2020,8/14/2020,81420,82L-IMPORT PAYROLL-VILLEGAS EVELYN,D108,HJ,142.81,,42763.65
6150,8/14/2020,8/14/2020,81420,82L-IMPORT PAYROLL-WOLF ANNA A,D108,HJ,36.3,,42799.95
6150,8/14/2020,8/14/2020,81420,82L-IMPORT PAYROLL-WOLF ANNA A,D108,HJ,155.19,,42955.14
6150,8/14/2020,8/14/2020,81420,82L-IMPORT PAYROLL-ACEVEDO MONIVETT,D107,HJ,72.42,,43027.56
6150,8/14/2020,8/14/2020,81420,82L-IMPORT PAYROLL-ACEVEDO MONIVETT,D107,HJ,309.64,,43337.2
6150,8/14/2020,8/14/2020,81420,82L-IMPORT PAYROLL-AKLESTAD ISABEL,D111,HJ,23.29,,43360.49
6150,8/14/2020,8/14/2020,81420,82L-IMPORT PAYROLL-AKLESTAD ISABEL,D111,HJ,99.58,,43460.07
6150,8/14/2020,8/14/2020,81420,82L-IMPORT PAYROLL-ALLEN KIMBERLY MARY,D111,HJ,26.58,,43486.65
6150,8/14/2020,8/14/2020,81420,82L-IMPORT PAYROLL-ALLEN KIMBERLY MARY,D111,HJ,113.67,,43600.32
6150,8/14/2020,8/14/2020,81420,82L-IMPORT PAYROLL-BOWMAN HALLEY K,D101,HJ,49.84,,43650.16
6150,8/14/2020,8/14/2020,81420,82L-IMPORT PAYROLL-BOWMAN HALLEY K,D101,HJ,213.13,,43863.29
6150,8/14/2020,8/14/2020,81420,82L-IMPORT PAYROLL-COOK CATHRYN ANNA,D105,HJ,49.87,,43913.16
6150,8/14/2020,8/14/2020,81420,82L-IMPORT PAYROLL-COOK CATHRYN ANNA,D105,HJ,213.25,,44126.41
6150,8/14/2020,8/14/2020,81420,82L-IMPORT PAYROLL-COOPER ASHLEE R,D101,HJ,33.51,,44159.92
6150,8/14/2020,8/14/2020,81420,82L-IMPORT PAYROLL-COOPER ASHLEE R,D101,HJ,143.3,,44303.22
6150,8/14/2020,8/14/2020,81420,82L-IMPORT PAYROLL-CORTEZ MIRANDA A,D111,HJ,38.45,,44341.67
6150,8/14/2020,8/14/2020,81420,82L-IMPORT PAYROLL-CORTEZ MIRANDA A,D111,HJ,164.42,,44506.09
6150,8/14/2020,8/14/2020,81420,82L-IMPORT PAYROLL-DAUGHERTY DEVIN W,D101,HJ,15.1,,44521.19
6150,8/14/2020,8/14/2020,81420,82L-IMPORT PAYROLL-DAUGHERTY DEVIN W,D101,HJ,64.58,,44585.77
6150,8/14/2020,8/14/2020,81420,82L-IMPORT PAYROLL-DETONE KYRA MAYA,D102,HJ,39,,44624.77
6150,8/14/2020,8/14/2020,81420,82L-IMPORT PAYROLL-DETONE KYRA MAYA,D102,HJ,166.75,,44791.52
6150,8/14/2020,8/14/2020,81420,82L-IMPORT PAYROLL-DUPUIS CHRISTOPHER M,D107,HJ,33.72,,44825.24
6150,8/14/2020,8/14/2020,81420,82L-IMPORT PAYROLL-DUPUIS CHRISTOPHER M,D107,HJ,55.02,,44880.26
6150,8/14/2020,8/14/2020,81420,82L-IMPORT PAYROLL-DUPUIS CHRISTOPHER M,D107,HJ,144.2,,45024.46
6150,8/14/2020,8/14/2020,81420,82L-IMPORT PAYROLL-DUPUIS CHRISTOPHER M,D107,HJ,235.25,,45259.71
6150,8/14/2020,8/14/2020,81420,82L-IMPORT PAYROLL-DZIEDZIC JULIE K,D101,HJ,17.71,,45277.42
6150,8/14/2020,8/14/2020,81420,82L-IMPORT PAYROLL-DZIEDZIC JULIE K,D101,HJ,75.71,,45353.13
6150,8/14/2020,8/14/2020,81420,82L-IMPORT PAYROLL-GORNSTEIN STEVEN,D101,HJ,39.27,,45392.4
6150,8/14/2020,8/14/2020,81420,82L-IMPORT PAYROLL-GORNSTEIN STEVEN,D101,HJ,114.45,,45506.85
6150,8/14/2020,8/14/2020,81420,82L-IMPORT PAYROLL-GORNSTEIN STEVEN,D101,HJ,167.92,,45674.77
6150,8/14/2020,8/14/2020,81420,82L-IMPORT PAYROLL-GRAVES KAMIESHIA,D101,HJ,26.3,,45701.07
6150,8/14/2020,8/14/2020,81420,82L-IMPORT PAYROLL-GRAVES KAMIESHIA,D101,HJ,112.45,,45813.52
6150,8/14/2020,8/14/2020,81420,82L-IMPORT PAYROLL-GUADARRAMA-ALVAREZ URIEL A,D105,HJ,39.93,,45853.45
6150,8/14/2020,8/14/2020,81420,82L-IMPORT PAYROLL-GUADARRAMA-ALVAREZ URIEL A,D105,HJ,170.75,,46024.2
6150,8/14/2020,8/14/2020,81420,82L-IMPORT PAYROLL-GUTIERREZ ANTONIO J,D107,HJ,14.85,,46039.05
6150,8/14/2020,8/14/2020,81420,82L-IMPORT PAYROLL-GUTIERREZ ANTONIO J,D107,HJ,59.4,,46098.45
6150,8/14/2020,8/14/2020,81420,82L-IMPORT PAYROLL-GUTIERREZ ANTONIO J,D107,HJ,63.5,,46161.95
6150,8/14/2020,8/14/2020,81420,82L-IMPORT PAYROLL-GUTIERREZ ANTONIO J,D107,HJ,253.98,,46415.93
6150,8/14/2020,8/14/2020,81420,82L-IMPORT PAYROLL-HESTER TYLER CONRAD,D105,HJ,27.79,,46443.72
6150,8/14/2020,8/14/2020,81420,82L-IMPORT PAYROLL-HESTER TYLER CONRAD,D105,HJ,118.83,,46562.55
6150,8/14/2020,8/14/2020,81420,82L-IMPORT PAYROLL-LACEY DEQUITA,D107,HJ,35.7,,46598.25
6150,8/14/2020,8/14/2020,81420,82L-IMPORT PAYROLL-LACEY DEQUITA,D107,HJ,152.64,,46750.89
6150,8/14/2020,8/14/2020,81420,82L-IMPORT PAYROLL-LIPORACE HERNAN LUIS,D103,HJ,33.06,,46783.95
6150,8/14/2020,8/14/2020,81420,82L-IMPORT PAYROLL-LIPORACE HERNAN LUIS,D103,HJ,61.55,,46845.5
6150,8/14/2020,8/14/2020,81420,82L-IMPORT PAYROLL-LIPORACE HERNAN LUIS,D103,HJ,141.34,,46986.84
6150,8/14/2020,8/14/2020,81420,82L-IMPORT PAYROLL-MASON ANGELA,D107,HJ,78.57,,47065.41
6150,8/14/2020,8/14/2020,81420,82L-IMPORT PAYROLL-MASON ANGELA,D107,HJ,335.97,,47401.38
6150,8/14/2020,8/14/2020,81420,82L-IMPORT PAYROLL-ODONNELL STEPHEN,D104,HJ,39.26,,47440.64
6150,8/14/2020,8/14/2020,81420,82L-IMPORT PAYROLL-ODONNELL STEPHEN,D104,HJ,167.87,,47608.51
6150,8/14/2020,8/14/2020,81420,82L-IMPORT PAYROLL-PARETS MALLORY GRACE,D101,HJ,17.57,,47626.08
6150,8/14/2020,8/14/2020,81420,82L-IMPORT PAYROLL-PARETS MALLORY GRACE,D101,HJ,41.08,,47667.16
6150,8/14/2020,8/14/2020,81420,82L-IMPORT PAYROLL-PARETS MALLORY GRACE,D101,HJ,76.5,,47743.66
6150,8/14/2020,8/14/2020,81420,82L-IMPORT PAYROLL-PARETS MALLORY GRACE,D101,HJ,175.67,,47919.33
6150,8/14/2020,8/14/2020,81420,82L-IMPORT PAYROLL-PARHAM-GANTT DENISE M,D112,HJ,37.96,,47957.29
6150,8/14/2020,8/14/2020,81420,82L-IMPORT PAYROLL-PARHAM-GANTT DENISE M,D112,HJ,162.32,,48119.61
6150,8/14/2020,8/14/2020,81420,82L-IMPORT PAYROLL-PEINADO ELIZABETH R,D111,HJ,52.29,,48171.9
6150,8/14/2020,8/14/2020,81420,82L-IMPORT PAYROLL-PEINADO ELIZABETH R,D111,HJ,223.58,,48395.48
6150,8/14/2020,8/14/2020,81420,82L-IMPORT PAYROLL-POLANCO ODALIS,D103,HJ,43.23,,48438.71
6150,8/14/2020,8/14/2020,81420,82L-IMPORT PAYROLL-POLANCO ODALIS,D103,HJ,184.83,,48623.54
6150,8/14/2020,8/14/2020,81420,82L-IMPORT PAYROLL-QUINTAS JASHIVE,D105,HJ,27.79,,48651.33
6150,8/14/2020,8/14/2020,81420,82L-IMPORT PAYROLL-QUINTAS JASHIVE,D105,HJ,118.83,,48770.16
6150,8/14/2020,8/14/2020,81420,82L-IMPORT PAYROLL-RANDOLPH ALEXANDER,D111,HJ,11.63,,48781.79
6150,8/14/2020,8/14/2020,81420,82L-IMPORT PAYROLL-RANDOLPH ALEXANDER,D111,HJ,25.1,,48806.89
6150,8/14/2020,8/14/2020,81420,82L-IMPORT PAYROLL-RANDOLPH ALEXANDER,D111,HJ,50.63,,48857.52
6150,8/14/2020,8/14/2020,81420,82L-IMPORT PAYROLL-RANDOLPH ALEXANDER,D111,HJ,107.33,,48964.85
6150,8/14/2020,8/14/2020,81420,82L-IMPORT PAYROLL-SAFRAN ALAN P,D107,HJ,10.84,,48975.69
6150,8/14/2020,8/14/2020,81420,82L-IMPORT PAYROLL-SAFRAN ALAN P,D107,HJ,46.37,,49022.06
6150,8/14/2020,8/14/2020,81420,82L-IMPORT PAYROLL-SAFRAN ALAN P,D107,HJ,97.59,,49119.65
6150,8/14/2020,8/14/2020,81420,82L-IMPORT PAYROLL-SAFRAN ALAN P,D107,HJ,417.25,,49536.9
6150,8/14/2020,8/14/2020,81420,82L-IMPORT PAYROLL-SHENKMAN OLIVIA,D101,HJ,29,,49565.9
6150,8/14/2020,8/14/2020,81420,82L-IMPORT PAYROLL-SHENKMAN OLIVIA,D101,HJ,124,,49689.9
6150,8/14/2020,8/14/2020,81420,82L-IMPORT PAYROLL-SHI GRACE,D103,HJ,12.69,,49702.59
6150,8/14/2020,8/14/2020,81420,82L-IMPORT PAYROLL-SHI GRACE,D103,HJ,36.98,,49739.57
6150,8/14/2020,8/14/2020,81420,82L-IMPORT PAYROLL-SHI GRACE,D103,HJ,54.25,,49793.82
6150,8/14/2020,8/14/2020,81420,82L-IMPORT PAYROLL-WALLACE AMENA T,D104,HJ,28.93,,49822.75
6150,8/14/2020,8/14/2020,81420,82L-IMPORT PAYROLL-WALLACE AMENA T,D104,HJ,123.72,,49946.47
6150,8/14/2020,8/14/2020,81420,82L-IMPORT PAYROLL-WEINSTOCK EMILY,D101,HJ,17.57,,49964.04
6150,8/14/2020,8/14/2020,81420,82L-IMPORT PAYROLL-WEINSTOCK EMILY,D101,HJ,38.11,,50002.15
6150,8/14/2020,8/14/2020,81420,82L-IMPORT PAYROLL-WEINSTOCK EMILY,D101,HJ,76.5,,50078.65
6150,8/14/2020,8/14/2020,81420,82L-IMPORT PAYROLL-WEINSTOCK EMILY,D101,HJ,162.94,,50241.59
6150,8/14/2020,8/14/2020,81420,82L-IMPORT PAYROLL-WINANS JENNIFER,D111,HJ,36.33,,50277.92
6150,8/14/2020,8/14/2020,81420,82L-IMPORT PAYROLL-WINANS JENNIFER,D111,HJ,155.35,,50433.27
6150,8/14/2020,8/14/2020,81420,82L-IMPORT PAYROLL-ZARATE JOSEPH M,D105,HJ,31.18,,50464.45
6150,8/14/2020,8/14/2020,81420,82L-IMPORT PAYROLL-ZARATE JOSEPH M,D105,HJ,133.3,,50597.75
6150,8/14/2020,8/14/2020,81420,82L-IMPORT PAYROLL-ARCHER AUBREYNA,D108,HJ,39.86,,50637.61
6150,8/14/2020,8/14/2020,81420,82L-IMPORT PAYROLL-ARCHER AUBREYNA,D108,HJ,170.44,,50808.05
6150,8/14/2020,8/14/2020,81420,82L-IMPORT PAYROLL-BARTOLD DEANNA MARIE,D108,HJ,41.91,,50849.96
6150,8/14/2020,8/14/2020,81420,82L-IMPORT PAYROLL-BARTOLD DEANNA MARIE,D108,HJ,179.22,,51029.18
6150,8/14/2020,8/14/2020,81420,82L-IMPORT PAYROLL-BELLOT GENESIS,D108,HJ,31.93,,51061.11
6150,8/14/2020,8/14/2020,81420,82L-IMPORT PAYROLL-BELLOT GENESIS,D108,HJ,136.53,,51197.64
6150,8/14/2020,8/14/2020,81420,82L-IMPORT PAYROLL-CIRKER MIA,D108,HJ,32.63,,51230.27
6150,8/14/2020,8/14/2020,81420,82L-IMPORT PAYROLL-CIRKER MIA,D108,HJ,139.5,,51369.77
6150,8/14/2020,8/14/2020,81420,82L-IMPORT PAYROLL-FEIGHERY JOHN,D108,HJ,30.56,,51400.33
6150,8/14/2020,8/14/2020,81420,82L-IMPORT PAYROLL-FEIGHERY JOHN,D108,HJ,130.69,,51531.02
6150,8/14/2020,8/14/2020,81420,82L-IMPORT PAYROLL-GARCIA MARILYN,D108,HJ,33.23,,51564.25
6150,8/14/2020,8/14/2020,81420,82L-IMPORT PAYROLL-GARCIA MARILYN,D108,HJ,142.08,,51706.33
6150,8/14/2020,8/14/2020,81420,82L-IMPORT PAYROLL-GRIFFIN ANDREW,D108,HJ,30.44,,51736.77
6150,8/14/2020,8/14/2020,81420,82L-IMPORT PAYROLL-GRIFFIN ANDREW,D108,HJ,130.16,,51866.93
6150,8/14/2020,8/14/2020,81420,82L-IMPORT PAYROLL-HALLINAN GABRIEL B,D108,HJ,34.79,,51901.72
6150,8/14/2020,8/14/2020,81420,82L-IMPORT PAYROLL-HALLINAN GABRIEL B,D108,HJ,148.76,,52050.48
6150,8/14/2020,8/14/2020,81420,82L-IMPORT PAYROLL-HOLDER LATIVA M,D108,HJ,55.28,,52105.76
6150,8/14/2020,8/14/2020,81420,82L-IMPORT PAYROLL-HOLDER LATIVA M,D108,HJ,236.38,,52342.14
6150,8/14/2020,8/14/2020,81420,82L-IMPORT PAYROLL-HOSSAIN MYESHA R,D108,HJ,35.1,,52377.24
6150,8/14/2020,8/14/2020,81420,82L-IMPORT PAYROLL-HOSSAIN MYESHA R,D108,HJ,150.1,,52527.34
6150,8/14/2020,8/14/2020,81420,82L-IMPORT PAYROLL-JACKSON TASNIM F,D108,HJ,31,,52558.34
6150,8/14/2020,8/14/2020,81420,82L-IMPORT PAYROLL-JACKSON TASNIM F,D108,HJ,132.56,,52690.9
6150,8/14/2020,8/14/2020,81420,82L-IMPORT PAYROLL-LI BELLA,D108,HJ,33.96,,52724.86
6150,8/14/2020,8/14/2020,81420,82L-IMPORT PAYROLL-LI BELLA,D108,HJ,145.23,,52870.09
6150,8/14/2020,8/14/2020,81420,82L-IMPORT PAYROLL-MOSELEY ARIELLE,D108,HJ,37.83,,52907.92
6150,8/14/2020,8/14/2020,81420,82L-IMPORT PAYROLL-MOSELEY ARIELLE,D108,HJ,161.75,,53069.67
6150,8/14/2020,8/14/2020,81420,82L-IMPORT PAYROLL-TILLERY ASIA,D108,HJ,47.73,,53117.4
6150,8/14/2020,8/14/2020,81420,82L-IMPORT PAYROLL-TILLERY ASIA,D108,HJ,204.08,,53321.48
6150,8/14/2020,8/14/2020,81420,82L-IMPORT PAYROLL-BALASUBRAMANIAN SHARANYA,D108,HJ,38.67,,53360.15
6150,8/14/2020,8/14/2020,81420,82L-IMPORT PAYROLL-BALASUBRAMANIAN SHARANYA,D108,HJ,58.33,,53418.48
6150,8/14/2020,8/14/2020,81420,82L-IMPORT PAYROLL-BALASUBRAMANIAN SHARANYA,D108,HJ,165.33,,53583.81
6150,8/14/2020,8/14/2020,81420,82L-IMPORT PAYROLL-COVENEY ALLISON,D108,HJ,38.07,,53621.88
6150,8/14/2020,8/14/2020,81420,82L-IMPORT PAYROLL-COVENEY ALLISON,D108,HJ,162.79,,53784.67
6150,8/14/2020,8/14/2020,81420,82L-IMPORT PAYROLL-JACKSON CLAICE M,D108,HJ,19.38,,53804.05
6150,8/14/2020,8/14/2020,81420,82L-IMPORT PAYROLL-JACKSON CLAICE M,D108,HJ,42.91,,53846.96
6150,8/14/2020,8/14/2020,81420,82L-IMPORT PAYROLL-JACKSON CLAICE M,D108,HJ,183.48,,54030.44
6150,8/14/2020,8/14/2020,81420,82L-IMPORT PAYROLL-JANG DANIEL,D108,HJ,37.75,,54068.19
6150,8/14/2020,8/14/2020,81420,82L-IMPORT PAYROLL-JANG DANIEL,D108,HJ,161.4,,54229.59
6150,8/14/2020,8/14/2020,81420,82L-IMPORT PAYROLL-LENEGHAN MARYELLEN B,D108,HJ,21.28,,54250.87
6150,8/14/2020,8/14/2020,81420,82L-IMPORT PAYROLL-LENEGHAN MARYELLEN B,D108,HJ,23.64,,54274.51
6150,8/14/2020,8/14/2020,81420,82L-IMPORT PAYROLL-LENEGHAN MARYELLEN B,D108,HJ,31.92,,54306.43
6150,8/14/2020,8/14/2020,81420,82L-IMPORT PAYROLL-LENEGHAN MARYELLEN B,D108,HJ,90.98,,54397.41
6150,8/14/2020,8/14/2020,81420,82L-IMPORT PAYROLL-LENEGHAN MARYELLEN B,D108,HJ,136.48,,54533.89
6150,8/14/2020,8/14/2020,82L-PRPD-081520,82L-PRPD-081520 -IMPORT PAYROLL-ALLEN KIMBERLY MARY,D108,HJ,26.58,,54560.47
6150,8/14/2020,8/14/2020,82L-PRPD-081520,82L-PRPD-081520 -IMPORT PAYROLL-ALLEN KIMBERLY MARY,D108,HJ,113.67,,54674.14
6150,8/14/2020,8/14/2020,82L-PRPD-081520,82L-PRPD-081520 -IMPORT PAYROLL-ANTHONY BETTY S,D108,HJ,41.85,,54715.99
6150,8/14/2020,8/14/2020,82L-PRPD-081520,82L-PRPD-081520 -IMPORT PAYROLL-ANTHONY BETTY S,D108,HJ,178.96,,54894.95
6150,8/14/2020,8/14/2020,82L-PRPD-081520,82L-PRPD-081520 -IMPORT PAYROLL-AUSTIN PERCY,D108,HJ,36.34,,54931.29
6150,8/14/2020,8/14/2020,82L-PRPD-081520,82L-PRPD-081520 -IMPORT PAYROLL-AUSTIN PERCY,D108,HJ,155.39,,55086.68
6150,8/14/2020,8/14/2020,82L-PRPD-081520,82L-PRPD-081520 -IMPORT PAYROLL-BAUSH DANIEL,D108,HJ,37.97,,55124.65
6150,8/14/2020,8/14/2020,82L-PRPD-081520,82L-PRPD-081520 -IMPORT PAYROLL-BAUSH DANIEL,D108,HJ,162.36,,55287.01
6150,8/14/2020,8/14/2020,82L-PRPD-081520,82L-PRPD-081520 -IMPORT PAYROLL-CHAPMAN CLAUDY EARL,D108,HJ,26.38,,55313.39
6150,8/14/2020,8/14/2020,82L-PRPD-081520,82L-PRPD-081520 -IMPORT PAYROLL-CHAPMAN CLAUDY EARL,D108,HJ,112.81,,55426.2
6150,8/14/2020,8/14/2020,82L-PRPD-081520,82L-PRPD-081520 -IMPORT PAYROLL-DADA ARIKPO E,D108,HJ,30.83,,55457.03
6150,8/14/2020,8/14/2020,82L-PRPD-081520,82L-PRPD-081520 -IMPORT PAYROLL-DADA ARIKPO E,D108,HJ,131.84,,55588.87
6150,8/14/2020,8/14/2020,82L-PRPD-081520,82L-PRPD-081520 -IMPORT PAYROLL-GUTHRIE LESLIE,D108,HJ,33.42,,55622.29
6150,8/14/2020,8/14/2020,82L-PRPD-081520,82L-PRPD-081520 -IMPORT PAYROLL-GUTHRIE LESLIE,D108,HJ,142.9,,55765.19
6150,8/14/2020,8/14/2020,82L-PRPD-081520,82L-PRPD-081520 -IMPORT PAYROLL-HOLMES JOREL ALEXANDER,D108,HJ,31.22,,55796.41
6150,8/14/2020,8/14/2020,82L-PRPD-081520,82L-PRPD-081520 -IMPORT PAYROLL-HOLMES JOREL ALEXANDER,D108,HJ,133.51,,55929.92
6150,8/14/2020,8/14/2020,82L-PRPD-081520,82L-PRPD-081520 -IMPORT PAYROLL-JORDAN TIFFANY T,D108,HJ,45.87,,55975.79
6150,8/14/2020,8/14/2020,82L-PRPD-081520,82L-PRPD-081520 -IMPORT PAYROLL-JORDAN TIFFANY T,D108,HJ,196.13,,56171.92
6150,8/14/2020,8/14/2020,82L-PRPD-081520,82L-PRPD-081520 -IMPORT PAYROLL-LANIGAN LISA A,D108,HJ,45.1,,56217.02
6150,8/14/2020,8/14/2020,82L-PRPD-081520,82L-PRPD-081520 -IMPORT PAYROLL-LANIGAN LISA A,D108,HJ,192.83,,56409.85
6150,8/14/2020,8/14/2020,82L-PRPD-081520,82L-PRPD-081520 -IMPORT PAYROLL-MCELWEE MELISSA,D108,HJ,38.67,,56448.52
6150,8/14/2020,8/14/2020,82L-PRPD-081520,82L-PRPD-081520 -IMPORT PAYROLL-MCELWEE MELISSA,D108,HJ,165.33,,56613.85
6150,8/14/2020,8/14/2020,82L-PRPD-081520,82L-PRPD-081520 -IMPORT PAYROLL-MCNICHOLAS MARY,D108,HJ,33.23,,56647.08
6150,8/14/2020,8/14/2020,82L-PRPD-081520,82L-PRPD-081520 -IMPORT PAYROLL-MCNICHOLAS MARY,D108,HJ,142.08,,56789.16
6150,8/14/2020,8/14/2020,82L-PRPD-081520,82L-PRPD-081520 -IMPORT PAYROLL-NWAKANMA NANCY,D108,HJ,42.32,,56831.48
6150,8/14/2020,8/14/2020,82L-PRPD-081520,82L-PRPD-081520 -IMPORT PAYROLL-NWAKANMA NANCY,D108,HJ,180.94,,57012.42
6150,8/14/2020,8/14/2020,82L-PRPD-081520,82L-PRPD-081520 -IMPORT PAYROLL-ONICA ANTHONY J,D108,HJ,31.33,,57043.75
6150,8/14/2020,8/14/2020,82L-PRPD-081520,82L-PRPD-081520 -IMPORT PAYROLL-ONICA ANTHONY J,D108,HJ,133.98,,57177.73
6150,8/14/2020,8/14/2020,82L-PRPD-081520,82L-PRPD-081520 -IMPORT PAYROLL-PRAHIN NICOLE M,D108,HJ,52.91,,57230.64
6150,8/14/2020,8/14/2020,82L-PRPD-081520,82L-PRPD-081520 -IMPORT PAYROLL-PRAHIN NICOLE M,D108,HJ,226.22,,57456.86
6150,8/14/2020,8/14/2020,82L-PRPD-081520,82L-PRPD-081520 -IMPORT PAYROLL-RIVERS QUIONNA DIANE,D108,HJ,36.46,,57493.32
6150,8/14/2020,8/14/2020,82L-PRPD-081520,82L-PRPD-081520 -IMPORT PAYROLL-RIVERS QUIONNA DIANE,D108,HJ,155.89,,57649.21
6150,8/14/2020,8/14/2020,82L-PRPD-081520,82L-PRPD-081520 -IMPORT PAYROLL-SALIM YASSER,D108,HJ,33.1,,57682.31
6150,8/14/2020,8/14/2020,82L-PRPD-081520,82L-PRPD-081520 -IMPORT PAYROLL-SALIM YASSER,D108,HJ,141.55,,57823.86
6150,8/14/2020,8/14/2020,82L-PRPD-081520,82L-PRPD-081520 -IMPORT PAYROLL-SEJOUR MAHALIAH,D108,HJ,34.07,,57857.93
6150,8/14/2020,8/14/2020,82L-PRPD-081520,82L-PRPD-081520 -IMPORT PAYROLL-SEJOUR MAHALIAH,D108,HJ,145.66,,58003.59
6150,8/14/2020,8/14/2020,82L-PRPD-081520,82L-PRPD-081520 -IMPORT PAYROLL-SKALSKI CHRISTOPHER,D108,HJ,33.86,,58037.45
6150,8/14/2020,8/14/2020,82L-PRPD-081520,82L-PRPD-081520 -IMPORT PAYROLL-SKALSKI CHRISTOPHER,D108,HJ,144.76,,58182.21
6150,8/14/2020,8/14/2020,82L-PRPD-081520,82L-PRPD-081520 -IMPORT PAYROLL-TAM CW RYAN,D105,HJ,0.94,,58183.15
6150,8/14/2020,8/14/2020,82L-PRPD-081520,82L-PRPD-081520 -IMPORT PAYROLL-TAM CW RYAN,D105,HJ,4.03,,58187.18
6150,8/14/2020,8/14/2020,82L-PRPD-081520,82L-PRPD-081520 -IMPORT PAYROLL-TUMENJARGAL ENKHJIN,D108,HJ,32.92,,58220.1
6150,8/14/2020,8/14/2020,82L-PRPD-081520,82L-PRPD-081520 -IMPORT PAYROLL-TUMENJARGAL ENKHJIN,D108,HJ,140.75,,58360.85
6150,8/14/2020,8/14/2020,82L-PRPD-081520,82L-PRPD-081520 -IMPORT PAYROLL-VILLEGAS EVELYN,D108,HJ,33.4,,58394.25
6150,8/14/2020,8/14/2020,82L-PRPD-081520,82L-PRPD-081520 -IMPORT PAYROLL-VILLEGAS EVELYN,D108,HJ,142.81,,58537.06
6150,8/14/2020,8/14/2020,82L-PRPD-081520,82L-PRPD-081520 -IMPORT PAYROLL-WALLACE AMENA T,D108,HJ,28.93,,58565.99
6150,8/14/2020,8/14/2020,82L-PRPD-081520,82L-PRPD-081520 -IMPORT PAYROLL-WALLACE AMENA T,D108,HJ,123.72,,58689.71
6150,8/14/2020,8/14/2020,82L-PRPD-081520,82L-PRPD-081520 -IMPORT PAYROLL-WINANS JENNIFER,D111,HJ,36.33,,58726.04
6150,8/14/2020,8/14/2020,82L-PRPD-081520,82L-PRPD-081520 -IMPORT PAYROLL-WINANS JENNIFER,D111,HJ,155.35,,58881.39
6150,8/14/2020,8/14/2020,82L-PRPD-081520,82L-PRPD-081520 -IMPORT PAYROLL-WOLF ANNA A,D108,HJ,36.3,,58917.69
6150,8/14/2020,8/14/2020,82L-PRPD-081520,82L-PRPD-081520 -IMPORT PAYROLL-WOLF ANNA A,D108,HJ,155.19,,59072.88
6150,8/14/2020,8/14/2020,82L-PRPD-081520,82L-PRPD-081520 -IMPORT PAYROLL-ACEVEDO MONIVETT,D103,HJ,72.42,,59145.3
6150,8/14/2020,8/14/2020,82L-PRPD-081520,82L-PRPD-081520 -IMPORT PAYROLL-ACEVEDO MONIVETT,D103,HJ,309.64,,59454.94
6150,8/14/2020,8/14/2020,82L-PRPD-081520,82L-PRPD-081520 -IMPORT PAYROLL-AKLESTAD ISABEL,D107,HJ,23.29,,59478.23
6150,8/14/2020,8/14/2020,82L-PRPD-081520,82L-PRPD-081520 -IMPORT PAYROLL-AKLESTAD ISABEL,D107,HJ,99.58,,59577.81
6150,8/14/2020,8/14/2020,82L-PRPD-081520,82L-PRPD-081520 -IMPORT PAYROLL-ALVAREZ-MORINE LISIS,D107,HJ,34.63,,59612.44
6150,8/14/2020,8/14/2020,82L-PRPD-081520,82L-PRPD-081520 -IMPORT PAYROLL-ALVAREZ-MORINE LISIS,D107,HJ,64.48,,59676.92
6150,8/14/2020,8/14/2020,82L-PRPD-081520,82L-PRPD-081520 -IMPORT PAYROLL-ALVAREZ-MORINE LISIS,D107,HJ,148.06,,59824.98
6150,8/14/2020,8/14/2020,82L-PRPD-081520,82L-PRPD-081520 -IMPORT PAYROLL-ALWARDT CALEB,D107,HJ,15.19,,59840.17
6150,8/14/2020,8/14/2020,82L-PRPD-081520,82L-PRPD-081520 -IMPORT PAYROLL-ALWARDT CALEB,D107,HJ,64.95,,59905.12
6150,8/14/2020,8/14/2020,82L-PRPD-081520,82L-PRPD-081520 -IMPORT PAYROLL-BARTHELEMY RACHALIE,D107,HJ,14.01,,59919.13
6150,8/14/2020,8/14/2020,82L-PRPD-081520,82L-PRPD-081520 -IMPORT PAYROLL-BARTHELEMY RACHALIE,D107,HJ,26.08,,59945.21
6150,8/14/2020,8/14/2020,82L-PRPD-081520,82L-PRPD-081520 -IMPORT PAYROLL-BARTHELEMY RACHALIE,D107,HJ,59.89,,60005.1
6150,8/14/2020,8/14/2020,82L-PRPD-081520,82L-PRPD-081520 -IMPORT PAYROLL-BOHLSEN GRACE,D107,HJ,15.19,,60020.29
6150,8/14/2020,8/14/2020,82L-PRPD-081520,82L-PRPD-081520 -IMPORT PAYROLL-BOHLSEN GRACE,D107,HJ,64.95,,60085.24
6150,8/14/2020,8/14/2020,82L-PRPD-081520,82L-PRPD-081520 -IMPORT PAYROLL-BORCHART SPENCER,D107,HJ,15.19,,60100.43
6150,8/14/2020,8/14/2020,82L-PRPD-081520,82L-PRPD-081520 -IMPORT PAYROLL-BORCHART SPENCER,D107,HJ,44.27,,60144.7
6150,8/14/2020,8/14/2020,82L-PRPD-081520,82L-PRPD-081520 -IMPORT PAYROLL-BORCHART SPENCER,D107,HJ,64.95,,60209.65
6150,8/14/2020,8/14/2020,82L-PRPD-081520,82L-PRPD-081520 -IMPORT PAYROLL-BOWMAN HALLEY K,D107,HJ,49.84,,60259.49
6150,8/14/2020,8/14/2020,82L-PRPD-081520,82L-PRPD-081520 -IMPORT PAYROLL-BOWMAN HALLEY K,D107,HJ,213.13,,60472.62
6150,8/14/2020,8/14/2020,82L-PRPD-081520,82L-PRPD-081520 -IMPORT PAYROLL-BREEDLOVE JOHNDEE L,D107,HJ,14.98,,60487.6
6150,8/14/2020,8/14/2020,82L-PRPD-081520,82L-PRPD-081520 -IMPORT PAYROLL-BREEDLOVE JOHNDEE L,D107,HJ,27.89,,60515.49
6150,8/14/2020,8/14/2020,82L-PRPD-081520,82L-PRPD-081520 -IMPORT PAYROLL-BREEDLOVE JOHNDEE L,D107,HJ,64.03,,60579.52
6150,8/14/2020,8/14/2020,82L-PRPD-081520,82L-PRPD-081520 -IMPORT PAYROLL-BROWN ISAAC,D107,HJ,15.19,,60594.71
6150,8/14/2020,8/14/2020,82L-PRPD-081520,82L-PRPD-081520 -IMPORT PAYROLL-BROWN ISAAC,D107,HJ,20.14,,60614.85
6150,8/14/2020,8/14/2020,82L-PRPD-081520,82L-PRPD-081520 -IMPORT PAYROLL-BROWN ISAAC,D107,HJ,64.95,,60679.8
6150,8/14/2020,8/14/2020,82L-PRPD-081520,82L-PRPD-081520 -IMPORT PAYROLL-BURKE MARIAH,D107,HJ,15.19,,60694.99
6150,8/14/2020,8/14/2020,82L-PRPD-081520,82L-PRPD-081520 -IMPORT PAYROLL-BURKE MARIAH,D107,HJ,64.95,,60759.94
6150,8/14/2020,8/14/2020,82L-PRPD-081520,82L-PRPD-081520 -IMPORT PAYROLL-CHAVOUS MILFORD,D107,HJ,15.19,,60775.13
6150,8/14/2020,8/14/2020,82L-PRPD-081520,82L-PRPD-081520 -IMPORT PAYROLL-CHAVOUS MILFORD,D107,HJ,28.29,,60803.42
6150,8/14/2020,8/14/2020,82L-PRPD-081520,82L-PRPD-081520 -IMPORT PAYROLL-CHAVOUS MILFORD,D107,HJ,64.95,,60868.37
6150,8/14/2020,8/14/2020,82L-PRPD-081520,82L-PRPD-081520 -IMPORT PAYROLL-CHEN LING,D107,HJ,15.19,,60883.56
6150,8/14/2020,8/14/2020,82L-PRPD-081520,82L-PRPD-081520 -IMPORT PAYROLL-CHEN LING,D107,HJ,64.95,,60948.51
6150,8/14/2020,8/14/2020,82L-PRPD-081520,82L-PRPD-081520 -IMPORT PAYROLL-COOK CATHRYN ANNA,D107,HJ,49.87,,60998.38
6150,8/14/2020,8/14/2020,82L-PRPD-081520,82L-PRPD-081520 -IMPORT PAYROLL-COOK CATHRYN ANNA,D107,HJ,213.25,,61211.63
6150,8/14/2020,8/14/2020,82L-PRPD-081520,82L-PRPD-081520 -IMPORT PAYROLL-COOPER ASHLEE R,D107,HJ,33.51,,61245.14
6150,8/14/2020,8/14/2020,82L-PRPD-081520,82L-PRPD-081520 -IMPORT PAYROLL-COOPER ASHLEE R,D107,HJ,143.3,,61388.44
6150,8/14/2020,8/14/2020,82L-PRPD-081520,82L-PRPD-081520 -IMPORT PAYROLL-DARKO OLIVIA,D107,HJ,15.19,,61403.63
6150,8/14/2020,8/14/2020,82L-PRPD-081520,82L-PRPD-081520 -IMPORT PAYROLL-DARKO OLIVIA,D107,HJ,64.95,,61468.58
6150,8/14/2020,8/14/2020,82L-PRPD-081520,82L-PRPD-081520 -IMPORT PAYROLL-DAUGHERTY DEVIN W,D107,HJ,15.1,,61483.68
6150,8/14/2020,8/14/2020,82L-PRPD-081520,82L-PRPD-081520 -IMPORT PAYROLL-DAUGHERTY DEVIN W,D107,HJ,64.58,,61548.26
6150,8/14/2020,8/14/2020,82L-PRPD-081520,82L-PRPD-081520 -IMPORT PAYROLL-DAWSON JAMIL NAFAYE-BEYAH,D107,HJ,15.19,,61563.45
6150,8/14/2020,8/14/2020,82L-PRPD-081520,82L-PRPD-081520 -IMPORT PAYROLL-DAWSON JAMIL NAFAYE-BEYAH,D107,HJ,64.95,,61628.4
6150,8/14/2020,8/14/2020,82L-PRPD-081520,82L-PRPD-081520 -IMPORT PAYROLL-DETONE KYRA MAYA,D102,HJ,39,,61667.4
6150,8/14/2020,8/14/2020,82L-PRPD-081520,82L-PRPD-081520 -IMPORT PAYROLL-DETONE KYRA MAYA,D102,HJ,166.75,,61834.15
6150,8/14/2020,8/14/2020,82L-PRPD-081520,82L-PRPD-081520 -IMPORT PAYROLL-DUPUIS CHRISTOPHER M,D107,HJ,88.74,,61922.89
6150,8/14/2020,8/14/2020,82L-PRPD-081520,82L-PRPD-081520 -IMPORT PAYROLL-DUPUIS CHRISTOPHER M,D107,HJ,379.45,,62302.34
6150,8/14/2020,8/14/2020,82L-PRPD-081520,82L-PRPD-081520 -IMPORT PAYROLL-DZIEDZIC JULIE K,D107,HJ,17.71,,62320.05
6150,8/14/2020,8/14/2020,82L-PRPD-081520,82L-PRPD-081520 -IMPORT PAYROLL-DZIEDZIC JULIE K,D107,HJ,75.71,,62395.76
6150,8/14/2020,8/14/2020,82L-PRPD-081520,82L-PRPD-081520 -IMPORT PAYROLL-GILES SHAYLA,D107,HJ,15.19,,62410.95
6150,8/14/2020,8/14/2020,82L-PRPD-081520,82L-PRPD-081520 -IMPORT PAYROLL-GILES SHAYLA,D107,HJ,28.29,,62439.24
6150,8/14/2020,8/14/2020,82L-PRPD-081520,82L-PRPD-081520 -IMPORT PAYROLL-GILES SHAYLA,D107,HJ,64.95,,62504.19
6150,8/14/2020,8/14/2020,82L-PRPD-081520,82L-PRPD-081520 -IMPORT PAYROLL-GORNSTEIN STEVEN,D107,HJ,39.27,,62543.46
6150,8/14/2020,8/14/2020,82L-PRPD-081520,82L-PRPD-081520 -IMPORT PAYROLL-GORNSTEIN STEVEN,D107,HJ,114.45,,62657.91
6150,8/14/2020,8/14/2020,82L-PRPD-081520,82L-PRPD-081520 -IMPORT PAYROLL-GORNSTEIN STEVEN,D107,HJ,167.92,,62825.83
6150,8/14/2020,8/14/2020,82L-PRPD-081520,82L-PRPD-081520 -IMPORT PAYROLL-GRAVES KAMIESHIA,D107,HJ,26.3,,62852.13
6150,8/14/2020,8/14/2020,82L-PRPD-081520,82L-PRPD-081520 -IMPORT PAYROLL-GRAVES KAMIESHIA,D107,HJ,112.45,,62964.58
6150,8/14/2020,8/14/2020,82L-PRPD-081520,82L-PRPD-081520 -IMPORT PAYROLL-GUADARRAMA-ALVAREZ URIEL A,D107,HJ,39.93,,63004.51
6150,8/14/2020,8/14/2020,82L-PRPD-081520,82L-PRPD-081520 -IMPORT PAYROLL-GUADARRAMA-ALVAREZ URIEL A,D107,HJ,170.75,,63175.26
6150,8/14/2020,8/14/2020,82L-PRPD-081520,82L-PRPD-081520 -IMPORT PAYROLL-GUTIERREZ ANTONIO J,D102,HJ,74.25,,63249.51
6150,8/14/2020,8/14/2020,82L-PRPD-081520,82L-PRPD-081520 -IMPORT PAYROLL-GUTIERREZ ANTONIO J,D102,HJ,317.48,,63566.99
6150,8/14/2020,8/14/2020,82L-PRPD-081520,82L-PRPD-081520 -IMPORT PAYROLL-HESTER TYLER CONRAD,D107,HJ,27.79,,63594.78
6150,8/14/2020,8/14/2020,82L-PRPD-081520,82L-PRPD-081520 -IMPORT PAYROLL-HESTER TYLER CONRAD,D107,HJ,118.83,,63713.61
6150,8/14/2020,8/14/2020,82L-PRPD-081520,82L-PRPD-081520 -IMPORT PAYROLL-JONES JORDAN,D107,HJ,15.19,,63728.8
6150,8/14/2020,8/14/2020,82L-PRPD-081520,82L-PRPD-081520 -IMPORT PAYROLL-JONES JORDAN,D107,HJ,64.95,,63793.75
6150,8/14/2020,8/14/2020,82L-PRPD-081520,82L-PRPD-081520 -IMPORT PAYROLL-KHAN HUDA,D107,HJ,15.19,,63808.94
6150,8/14/2020,8/14/2020,82L-PRPD-081520,82L-PRPD-081520 -IMPORT PAYROLL-KHAN HUDA,D107,HJ,28.29,,63837.23
6150,8/14/2020,8/14/2020,82L-PRPD-081520,82L-PRPD-081520 -IMPORT PAYROLL-KHAN HUDA,D107,HJ,64.95,,63902.18
6150,8/14/2020,8/14/2020,82L-PRPD-081520,82L-PRPD-081520 -IMPORT PAYROLL-KING IRIS,D107,HJ,7.01,,63909.19
6150,8/14/2020,8/14/2020,82L-PRPD-081520,82L-PRPD-081520 -IMPORT PAYROLL-KING IRIS,D107,HJ,13.05,,63922.24
6150,8/14/2020,8/14/2020,82L-PRPD-081520,82L-PRPD-081520 -IMPORT PAYROLL-KING IRIS,D107,HJ,29.98,,63952.22
6150,8/14/2020,8/14/2020,82L-PRPD-081520,82L-PRPD-081520 -IMPORT PAYROLL-KLOHR TIMOTHY JORDAN,D107,HJ,21.41,,63973.63
6150,8/14/2020,8/14/2020,82L-PRPD-081520,82L-PRPD-081520 -IMPORT PAYROLL-KLOHR TIMOTHY JORDAN,D107,HJ,39.88,,64013.51
6150,8/14/2020,8/14/2020,82L-PRPD-081520,82L-PRPD-081520 -IMPORT PAYROLL-KLOHR TIMOTHY JORDAN,D107,HJ,91.57,,64105.08
6150,8/14/2020,8/14/2020,82L-PRPD-081520,82L-PRPD-081520 -IMPORT PAYROLL-KOPSHEVER MELISSA,D107,HJ,42.29,,64147.37
6150,8/14/2020,8/14/2020,82L-PRPD-081520,82L-PRPD-081520 -IMPORT PAYROLL-KOPSHEVER MELISSA,D107,HJ,52.1,,64199.47
6150,8/14/2020,8/14/2020,82L-PRPD-081520,82L-PRPD-081520 -IMPORT PAYROLL-KOPSHEVER MELISSA,D107,HJ,180.83,,64380.3
6150,8/14/2020,8/14/2020,82L-PRPD-081520,82L-PRPD-081520 -IMPORT PAYROLL-LACEY DEQUITA,D108,HJ,35.7,,64416
6150,8/14/2020,8/14/2020,82L-PRPD-081520,82L-PRPD-081520 -IMPORT PAYROLL-LACEY DEQUITA,D108,HJ,152.64,,64568.64
6150,8/14/2020,8/14/2020,82L-PRPD-081520,82L-PRPD-081520 -IMPORT PAYROLL-LI SEN YUAN,D107,HJ,14.05,,64582.69
6150,8/14/2020,8/14/2020,82L-PRPD-081520,82L-PRPD-081520 -IMPORT PAYROLL-LI SEN YUAN,D107,HJ,26.16,,64608.85
6150,8/14/2020,8/14/2020,82L-PRPD-081520,82L-PRPD-081520 -IMPORT PAYROLL-LI SEN YUAN,D107,HJ,60.07,,64668.92
6150,8/14/2020,8/14/2020,82L-PRPD-081520,82L-PRPD-081520 -IMPORT PAYROLL-LIPORACE HERNAN LUIS,D103,HJ,33.06,,64701.98
6150,8/14/2020,8/14/2020,82L-PRPD-081520,82L-PRPD-081520 -IMPORT PAYROLL-LIPORACE HERNAN LUIS,D103,HJ,61.55,,64763.53
6150,8/14/2020,8/14/2020,82L-PRPD-081520,82L-PRPD-081520 -IMPORT PAYROLL-LIPORACE HERNAN LUIS,D103,HJ,141.34,,64904.87
6150,8/14/2020,8/14/2020,82L-PRPD-081520,82L-PRPD-081520 -IMPORT PAYROLL-LIPSCOMB STEPHEN,D107,HJ,33.58,,64938.45
6150,8/14/2020,8/14/2020,82L-PRPD-081520,82L-PRPD-081520 -IMPORT PAYROLL-LIPSCOMB STEPHEN,D107,HJ,62.53,,65000.98
6150,8/14/2020,8/14/2020,82L-PRPD-081520,82L-PRPD-081520 -IMPORT PAYROLL-LIPSCOMB STEPHEN,D107,HJ,143.59,,65144.57
6150,8/14/2020,8/14/2020,82L-PRPD-081520,82L-PRPD-081520 -IMPORT PAYROLL-MASON ANGELA,D107,HJ,78.57,,65223.14
6150,8/14/2020,8/14/2020,82L-PRPD-081520,82L-PRPD-081520 -IMPORT PAYROLL-MASON ANGELA,D107,HJ,335.97,,65559.11
6150,8/14/2020,8/14/2020,82L-PRPD-081520,82L-PRPD-081520 -IMPORT PAYROLL-MCLAUGHLIN MARA,D107,HJ,15.19,,65574.3
6150,8/14/2020,8/14/2020,82L-PRPD-081520,82L-PRPD-081520 -IMPORT PAYROLL-MCLAUGHLIN MARA,D107,HJ,64.95,,65639.25
6150,8/14/2020,8/14/2020,82L-PRPD-081520,82L-PRPD-081520 -IMPORT PAYROLL-MEJIA CARLOS MANUEL,D107,HJ,14.01,,65653.26
6150,8/14/2020,8/14/2020,82L-PRPD-081520,82L-PRPD-081520 -IMPORT PAYROLL-MEJIA CARLOS MANUEL,D107,HJ,59.89,,65713.15
6150,8/14/2020,8/14/2020,82L-PRPD-081520,82L-PRPD-081520 -IMPORT PAYROLL-MONROY-MEJIA JASON,D107,HJ,15.19,,65728.34
6150,8/14/2020,8/14/2020,82L-PRPD-081520,82L-PRPD-081520 -IMPORT PAYROLL-MONROY-MEJIA JASON,D107,HJ,36.67,,65765.01
6150,8/14/2020,8/14/2020,82L-PRPD-081520,82L-PRPD-081520 -IMPORT PAYROLL-MONROY-MEJIA JASON,D107,HJ,64.95,,65829.96
6150,8/14/2020,8/14/2020,82L-PRPD-081520,82L-PRPD-081520 -IMPORT PAYROLL-O'FLYNN-PRUITT NATHAN COLYAR,D107,HJ,15.19,,65845.15
6150,8/14/2020,8/14/2020,82L-PRPD-081520,82L-PRPD-081520 -IMPORT PAYROLL-O'FLYNN-PRUITT NATHAN COLYAR,D107,HJ,36.67,,65881.82
6150,8/14/2020,8/14/2020,82L-PRPD-081520,82L-PRPD-081520 -IMPORT PAYROLL-O'FLYNN-PRUITT NATHAN COLYAR,D107,HJ,64.95,,65946.77
6150,8/14/2020,8/14/2020,82L-PRPD-081520,82L-PRPD-081520 -IMPORT PAYROLL-ODONNELL STEPHEN,D107,HJ,39.26,,65986.03
6150,8/14/2020,8/14/2020,82L-PRPD-081520,82L-PRPD-081520 -IMPORT PAYROLL-ODONNELL STEPHEN,D107,HJ,167.87,,66153.9
6150,8/14/2020,8/14/2020,82L-PRPD-081520,82L-PRPD-081520 -IMPORT PAYROLL-PARETS MALLORY GRACE,D107,HJ,17.57,,66171.47
6150,8/14/2020,8/14/2020,82L-PRPD-081520,82L-PRPD-081520 -IMPORT PAYROLL-PARETS MALLORY GRACE,D107,HJ,41.08,,66212.55
6150,8/14/2020,8/14/2020,82L-PRPD-081520,82L-PRPD-081520 -IMPORT PAYROLL-PARETS MALLORY GRACE,D107,HJ,76.5,,66289.05
6150,8/14/2020,8/14/2020,82L-PRPD-081520,82L-PRPD-081520 -IMPORT PAYROLL-PARETS MALLORY GRACE,D107,HJ,175.67,,66464.72
6150,8/14/2020,8/14/2020,82L-PRPD-081520,82L-PRPD-081520 -IMPORT PAYROLL-PARHAM-GANTT DENISE M,D108,HJ,37.96,,66502.68
6150,8/14/2020,8/14/2020,82L-PRPD-081520,82L-PRPD-081520 -IMPORT PAYROLL-PARHAM-GANTT DENISE M,D108,HJ,162.32,,66665
6150,8/14/2020,8/14/2020,82L-PRPD-081520,82L-PRPD-081520 -IMPORT PAYROLL-PATTERSON STEVE,D107,HJ,15.19,,66680.19
6150,8/14/2020,8/14/2020,82L-PRPD-081520,82L-PRPD-081520 -IMPORT PAYROLL-PATTERSON STEVE,D107,HJ,28.29,,66708.48
6150,8/14/2020,8/14/2020,82L-PRPD-081520,82L-PRPD-081520 -IMPORT PAYROLL-PATTERSON STEVE,D107,HJ,64.95,,66773.43
6150,8/14/2020,8/14/2020,82L-PRPD-081520,82L-PRPD-081520 -IMPORT PAYROLL-PEINADO ELIZABETH R,D107,HJ,52.29,,66825.72
6150,8/14/2020,8/14/2020,82L-PRPD-081520,82L-PRPD-081520 -IMPORT PAYROLL-PEINADO ELIZABETH R,D107,HJ,223.58,,67049.3
6150,8/14/2020,8/14/2020,82L-PRPD-081520,82L-PRPD-081520 -IMPORT PAYROLL-POLANCO ODALIS,D103,HJ,43.23,,67092.53
6150,8/14/2020,8/14/2020,82L-PRPD-081520,82L-PRPD-081520 -IMPORT PAYROLL-POLANCO ODALIS,D103,HJ,184.83,,67277.36
6150,8/14/2020,8/14/2020,82L-PRPD-081520,82L-PRPD-081520 -IMPORT PAYROLL-QUINTAS JASHIVE,D107,HJ,27.79,,67305.15
6150,8/14/2020,8/14/2020,82L-PRPD-081520,82L-PRPD-081520 -IMPORT PAYROLL-QUINTAS JASHIVE,D107,HJ,118.83,,67423.98
6150,8/14/2020,8/14/2020,82L-PRPD-081520,82L-PRPD-081520 -IMPORT PAYROLL-RANDOLPH ALEXANDER,D107,HJ,11.63,,67435.61
6150,8/14/2020,8/14/2020,82L-PRPD-081520,82L-PRPD-081520 -IMPORT PAYROLL-RANDOLPH ALEXANDER,D107,HJ,25.1,,67460.71
6150,8/14/2020,8/14/2020,82L-PRPD-081520,82L-PRPD-081520 -IMPORT PAYROLL-RANDOLPH ALEXANDER,D107,HJ,50.63,,67511.34
6150,8/14/2020,8/14/2020,82L-PRPD-081520,82L-PRPD-081520 -IMPORT PAYROLL-RANDOLPH ALEXANDER,D107,HJ,107.33,,67618.67
6150,8/14/2020,8/14/2020,82L-PRPD-081520,82L-PRPD-081520 -IMPORT PAYROLL-ROBBINS DEANNA,D107,HJ,36.85,,67655.52
6150,8/14/2020,8/14/2020,82L-PRPD-081520,82L-PRPD-081520 -IMPORT PAYROLL-ROBBINS DEANNA,D107,HJ,68.63,,67724.15
6150,8/14/2020,8/14/2020,82L-PRPD-081520,82L-PRPD-081520 -IMPORT PAYROLL-ROBBINS DEANNA,D107,HJ,157.58,,67881.73
6150,8/14/2020,8/14/2020,82L-PRPD-081520,82L-PRPD-081520 -IMPORT PAYROLL-SAFRAN ALAN P,D102,HJ,108.43,,67990.16
6150,8/14/2020,8/14/2020,82L-PRPD-081520,82L-PRPD-081520 -IMPORT PAYROLL-SAFRAN ALAN P,D102,HJ,463.62,,68453.78
6150,8/14/2020,8/14/2020,82L-PRPD-081520,82L-PRPD-081520 -IMPORT PAYROLL-SCOTT KIRK DONOVAN,D107,HJ,14.05,,68467.83
6150,8/14/2020,8/14/2020,82L-PRPD-081520,82L-PRPD-081520 -IMPORT PAYROLL-SCOTT KIRK DONOVAN,D107,HJ,26.16,,68493.99
6150,8/14/2020,8/14/2020,82L-PRPD-081520,82L-PRPD-081520 -IMPORT PAYROLL-SCOTT KIRK DONOVAN,D107,HJ,60.07,,68554.06
6150,8/14/2020,8/14/2020,82L-PRPD-081520,82L-PRPD-081520 -IMPORT PAYROLL-SHENKMAN OLIVIA,D107,HJ,29,,68583.06
6150,8/14/2020,8/14/2020,82L-PRPD-081520,82L-PRPD-081520 -IMPORT PAYROLL-SHENKMAN OLIVIA,D107,HJ,124,,68707.06
6150,8/14/2020,8/14/2020,82L-PRPD-081520,82L-PRPD-081520 -IMPORT PAYROLL-SHI GRACE,D103,HJ,12.69,,68719.75
6150,8/14/2020,8/14/2020,82L-PRPD-081520,82L-PRPD-081520 -IMPORT PAYROLL-SHI GRACE,D103,HJ,36.98,,68756.73
6150,8/14/2020,8/14/2020,82L-PRPD-081520,82L-PRPD-081520 -IMPORT PAYROLL-SHI GRACE,D103,HJ,54.25,,68810.98
6150,8/14/2020,8/14/2020,82L-PRPD-081520,82L-PRPD-081520 -IMPORT PAYROLL-SILVER KELLY,D107,HJ,34.63,,68845.61
6150,8/14/2020,8/14/2020,82L-PRPD-081520,82L-PRPD-081520 -IMPORT PAYROLL-SILVER KELLY,D107,HJ,64.48,,68910.09
6150,8/14/2020,8/14/2020,82L-PRPD-081520,82L-PRPD-081520 -IMPORT PAYROLL-SILVER KELLY,D107,HJ,148.06,,69058.15
6150,8/14/2020,8/14/2020,82L-PRPD-081520,82L-PRPD-081520 -IMPORT PAYROLL-SOLIMAN MARK,D107,HJ,15.19,,69073.34
6150,8/14/2020,8/14/2020,82L-PRPD-081520,82L-PRPD-081520 -IMPORT PAYROLL-SOLIMAN MARK,D107,HJ,36.67,,69110.01
6150,8/14/2020,8/14/2020,82L-PRPD-081520,82L-PRPD-081520 -IMPORT PAYROLL-SOLIMAN MARK,D107,HJ,64.95,,69174.96
6150,8/14/2020,8/14/2020,82L-PRPD-081520,82L-PRPD-081520 -IMPORT PAYROLL-STROUD DAVID,D107,HJ,14.65,,69189.61
6150,8/14/2020,8/14/2020,82L-PRPD-081520,82L-PRPD-081520 -IMPORT PAYROLL-STROUD DAVID,D107,HJ,62.62,,69252.23
6150,8/14/2020,8/14/2020,82L-PRPD-081520,82L-PRPD-081520 -IMPORT PAYROLL-VALCIN SABRINA JEMIMAH,D107,HJ,14.25,,69266.48
6150,8/14/2020,8/14/2020,82L-PRPD-081520,82L-PRPD-081520 -IMPORT PAYROLL-VALCIN SABRINA JEMIMAH,D107,HJ,26.53,,69293.01
6150,8/14/2020,8/14/2020,82L-PRPD-081520,82L-PRPD-081520 -IMPORT PAYROLL-VALCIN SABRINA JEMIMAH,D107,HJ,60.92,,69353.93
6150,8/14/2020,8/14/2020,82L-PRPD-081520,82L-PRPD-081520 -IMPORT PAYROLL-WEINSTOCK EMILY,D107,HJ,17.57,,69371.5
6150,8/14/2020,8/14/2020,82L-PRPD-081520,82L-PRPD-081520 -IMPORT PAYROLL-WEINSTOCK EMILY,D107,HJ,38.11,,69409.61
6150,8/14/2020,8/14/2020,82L-PRPD-081520,82L-PRPD-081520 -IMPORT PAYROLL-WEINSTOCK EMILY,D107,HJ,76.5,,69486.11
6150,8/14/2020,8/14/2020,82L-PRPD-081520,82L-PRPD-081520 -IMPORT PAYROLL-WEINSTOCK EMILY,D107,HJ,162.94,,69649.05
6150,8/14/2020,8/14/2020,82L-PRPD-081520,82L-PRPD-081520 -IMPORT PAYROLL-WILLIAMS MACK ANTHONY,D107,HJ,14.07,,69663.12
6150,8/14/2020,8/14/2020,82L-PRPD-081520,82L-PRPD-081520 -IMPORT PAYROLL-WILLIAMS MACK ANTHONY,D107,HJ,26.21,,69689.33
6150,8/14/2020,8/14/2020,82L-PRPD-081520,82L-PRPD-081520 -IMPORT PAYROLL-WILLIAMS MACK ANTHONY,D107,HJ,60.18,,69749.51
6150,8/14/2020,8/14/2020,82L-PRPD-081520,82L-PRPD-081520 -IMPORT PAYROLL-WILLIAMS MIL'YONTA,D107,HJ,15.19,,69764.7
6150,8/14/2020,8/14/2020,82L-PRPD-081520,82L-PRPD-081520 -IMPORT PAYROLL-WILLIAMS MIL'YONTA,D107,HJ,64.95,,69829.65
6150,8/14/2020,8/14/2020,82L-PRPD-081520,82L-PRPD-081520 -IMPORT PAYROLL-ZARATE JOSEPH M,D107,HJ,31.18,,69860.83
6150,8/14/2020,8/14/2020,82L-PRPD-081520,82L-PRPD-081520 -IMPORT PAYROLL-ZARATE JOSEPH M,D107,HJ,133.3,,69994.13
6150,8/14/2020,8/14/2020,82L-PRPD-081520,82L-PRPD-081520 -IMPORT PAYROLL-ARCHER AUBREYNA,D108,HJ,39.86,,70033.99
6150,8/14/2020,8/14/2020,82L-PRPD-081520,82L-PRPD-081520 -IMPORT PAYROLL-ARCHER AUBREYNA,D108,HJ,170.44,,70204.43
6150,8/14/2020,8/14/2020,82L-PRPD-081520,82L-PRPD-081520 -IMPORT PAYROLL-BARTOLD DEANNA MARIE,D108,HJ,41.91,,70246.34
6150,8/14/2020,8/14/2020,82L-PRPD-081520,82L-PRPD-081520 -IMPORT PAYROLL-BARTOLD DEANNA MARIE,D108,HJ,179.22,,70425.56
6150,8/14/2020,8/14/2020,82L-PRPD-081520,82L-PRPD-081520 -IMPORT PAYROLL-BELLOT GENESIS,D108,HJ,31.93,,70457.49
6150,8/14/2020,8/14/2020,82L-PRPD-081520,82L-PRPD-081520 -IMPORT PAYROLL-BELLOT GENESIS,D108,HJ,136.53,,70594.02
6150,8/14/2020,8/14/2020,82L-PRPD-081520,82L-PRPD-081520 -IMPORT PAYROLL-CIRKER MIA,D108,HJ,32.63,,70626.65
6150,8/14/2020,8/14/2020,82L-PRPD-081520,82L-PRPD-081520 -IMPORT PAYROLL-CIRKER MIA,D108,HJ,139.5,,70766.15
6150,8/14/2020,8/14/2020,82L-PRPD-081520,82L-PRPD-081520 -IMPORT PAYROLL-CORTEZ MIRANDA A,D111,HJ,38.45,,70804.6
6150,8/14/2020,8/14/2020,82L-PRPD-081520,82L-PRPD-081520 -IMPORT PAYROLL-CORTEZ MIRANDA A,D111,HJ,164.42,,70969.02
6150,8/14/2020,8/14/2020,82L-PRPD-081520,82L-PRPD-081520 -IMPORT PAYROLL-FEIGHERY JOHN,D108,HJ,30.56,,70999.58
6150,8/14/2020,8/14/2020,82L-PRPD-081520,82L-PRPD-081520 -IMPORT PAYROLL-FEIGHERY JOHN,D108,HJ,130.69,,71130.27
6150,8/14/2020,8/14/2020,82L-PRPD-081520,82L-PRPD-081520 -IMPORT PAYROLL-GARCIA MARILYN,D108,HJ,33.23,,71163.5
6150,8/14/2020,8/14/2020,82L-PRPD-081520,82L-PRPD-081520 -IMPORT PAYROLL-GARCIA MARILYN,D108,HJ,142.08,,71305.58
6150,8/14/2020,8/14/2020,82L-PRPD-081520,82L-PRPD-081520 -IMPORT PAYROLL-GRIFFIN ANDREW,D108,HJ,30.44,,71336.02
6150,8/14/2020,8/14/2020,82L-PRPD-081520,82L-PRPD-081520 -IMPORT PAYROLL-GRIFFIN ANDREW,D108,HJ,130.16,,71466.18
6150,8/14/2020,8/14/2020,82L-PRPD-081520,82L-PRPD-081520 -IMPORT PAYROLL-HALLINAN GABRIEL B,D108,HJ,34.79,,71500.97
6150,8/14/2020,8/14/2020,82L-PRPD-081520,82L-PRPD-081520 -IMPORT PAYROLL-HALLINAN GABRIEL B,D108,HJ,148.76,,71649.73
6150,8/14/2020,8/14/2020,82L-PRPD-081520,82L-PRPD-081520 -IMPORT PAYROLL-HOLDER LATIVA M,D108,HJ,55.28,,71705.01
6150,8/14/2020,8/14/2020,82L-PRPD-081520,82L-PRPD-081520 -IMPORT PAYROLL-HOLDER LATIVA M,D108,HJ,236.38,,71941.39
6150,8/14/2020,8/14/2020,82L-PRPD-081520,82L-PRPD-081520 -IMPORT PAYROLL-HOSSAIN MYESHA R,D108,HJ,35.1,,71976.49
6150,8/14/2020,8/14/2020,82L-PRPD-081520,82L-PRPD-081520 -IMPORT PAYROLL-HOSSAIN MYESHA R,D108,HJ,150.1,,72126.59
6150,8/14/2020,8/14/2020,82L-PRPD-081520,82L-PRPD-081520 -IMPORT PAYROLL-JACKSON TASNIM F,D108,HJ,31,,72157.59
6150,8/14/2020,8/14/2020,82L-PRPD-081520,82L-PRPD-081520 -IMPORT PAYROLL-JACKSON TASNIM F,D108,HJ,132.56,,72290.15
6150,8/14/2020,8/14/2020,82L-PRPD-081520,82L-PRPD-081520 -IMPORT PAYROLL-LI BELLA,D108,HJ,33.96,,72324.11
6150,8/14/2020,8/14/2020,82L-PRPD-081520,82L-PRPD-081520 -IMPORT PAYROLL-LI BELLA,D108,HJ,145.23,,72469.34
6150,8/14/2020,8/14/2020,82L-PRPD-081520,82L-PRPD-081520 -IMPORT PAYROLL-MOSELEY ARIELLE,D108,HJ,37.83,,72507.17
6150,8/14/2020,8/14/2020,82L-PRPD-081520,82L-PRPD-081520 -IMPORT PAYROLL-MOSELEY ARIELLE,D108,HJ,161.75,,72668.92
6150,8/14/2020,8/14/2020,82L-PRPD-081520,82L-PRPD-081520 -IMPORT PAYROLL-TILLERY ASIA,D108,HJ,47.73,,72716.65
6150,8/14/2020,8/14/2020,82L-PRPD-081520,82L-PRPD-081520 -IMPORT PAYROLL-TILLERY ASIA,D108,HJ,204.08,,72920.73
6150,8/14/2020,8/14/2020,82L-PRPD-081520,82L-PRPD-081520 -IMPORT PAYROLL-BALASUBRAMANIAN SHARANYA,D108,HJ,38.67,,72959.4
6150,8/14/2020,8/14/2020,82L-PRPD-081520,82L-PRPD-081520 -IMPORT PAYROLL-BALASUBRAMANIAN SHARANYA,D108,HJ,58.33,,73017.73
6150,8/14/2020,8/14/2020,82L-PRPD-081520,82L-PRPD-081520 -IMPORT PAYROLL-BALASUBRAMANIAN SHARANYA,D108,HJ,165.33,,73183.06
6150,8/14/2020,8/14/2020,82L-PRPD-081520,82L-PRPD-081520 -IMPORT PAYROLL-COVENEY ALLISON,D108,HJ,38.07,,73221.13
6150,8/14/2020,8/14/2020,82L-PRPD-081520,82L-PRPD-081520 -IMPORT PAYROLL-COVENEY ALLISON,D108,HJ,162.79,,73383.92
6150,8/14/2020,8/14/2020,82L-PRPD-081520,82L-PRPD-081520 -IMPORT PAYROLL-JACKSON CLAICE M,D108,HJ,19.38,,73403.3
6150,8/14/2020,8/14/2020,82L-PRPD-081520,82L-PRPD-081520 -IMPORT PAYROLL-JACKSON CLAICE M,D108,HJ,42.91,,73446.21
6150,8/14/2020,8/14/2020,82L-PRPD-081520,82L-PRPD-081520 -IMPORT PAYROLL-JACKSON CLAICE M,D108,HJ,183.48,,73629.69
6150,8/14/2020,8/14/2020,82L-PRPD-081520,82L-PRPD-081520 -IMPORT PAYROLL-JANG DANIEL,D108,HJ,37.75,,73667.44
6150,8/14/2020,8/14/2020,82L-PRPD-081520,82L-PRPD-081520 -IMPORT PAYROLL-JANG DANIEL,D108,HJ,161.4,,73828.84
6150,8/14/2020,8/14/2020,82L-PRPD-081520,82L-PRPD-081520 -IMPORT PAYROLL-LENEGHAN MARYELLEN B,D108,HJ,23.64,,73852.48
6150,8/14/2020,8/14/2020,82L-PRPD-081520,82L-PRPD-081520 -IMPORT PAYROLL-LENEGHAN MARYELLEN B,D108,HJ,53.2,,73905.68
6150,8/14/2020,8/14/2020,82L-PRPD-081520,82L-PRPD-081520 -IMPORT PAYROLL-LENEGHAN MARYELLEN B,D108,HJ,227.46,,74133.14
6150,8/15/2020,8/15/2020,82L-PRPD-081520,To reverse 82L payroll 0815 JE-21-0020-To reverse 82L Payroll of 8152020,D105,HJ,,0.94,74132.2
6150,8/15/2020,8/15/2020,82L-PRPD-081520,To reverse 82L payroll 0815 JE-21-0020-To reverse 82L Payroll of 8152020,D105,HJ,,4.03,74128.17
6150,8/15/2020,8/15/2020,82L-PRPD-081520,To reverse 82L payroll 0815 JE-21-0020-To reverse 82L Payroll of 8152020,D108,HJ,,26.38,74101.79
6150,8/15/2020,8/15/2020,82L-PRPD-081520,To reverse 82L payroll 0815 JE-21-0020-To reverse 82L Payroll of 8152020,D108,HJ,,26.58,74075.21
6150,8/15/2020,8/15/2020,82L-PRPD-081520,To reverse 82L payroll 0815 JE-21-0020-To reverse 82L Payroll of 8152020,D108,HJ,,28.93,74046.28
6150,8/15/2020,8/15/2020,82L-PRPD-081520,To reverse 82L payroll 0815 JE-21-0020-To reverse 82L Payroll of 8152020,D108,HJ,,30.83,74015.45
6150,8/15/2020,8/15/2020,82L-PRPD-081520,To reverse 82L payroll 0815 JE-21-0020-To reverse 82L Payroll of 8152020,D108,HJ,,31.22,73984.23
6150,8/15/2020,8/15/2020,82L-PRPD-081520,To reverse 82L payroll 0815 JE-21-0020-To reverse 82L Payroll of 8152020,D108,HJ,,31.33,73952.9
6150,8/15/2020,8/15/2020,82L-PRPD-081520,To reverse 82L payroll 0815 JE-21-0020-To reverse 82L Payroll of 8152020,D108,HJ,,32.92,73919.98
6150,8/15/2020,8/15/2020,82L-PRPD-081520,To reverse 82L payroll 0815 JE-21-0020-To reverse 82L Payroll of 8152020,D108,HJ,,33.1,73886.88
6150,8/15/2020,8/15/2020,82L-PRPD-081520,To reverse 82L payroll 0815 JE-21-0020-To reverse 82L Payroll of 8152020,D108,HJ,,33.23,73853.65
6150,8/15/2020,8/15/2020,82L-PRPD-081520,To reverse 82L payroll 0815 JE-21-0020-To reverse 82L Payroll of 8152020,D108,HJ,,33.4,73820.25
6150,8/15/2020,8/15/2020,82L-PRPD-081520,To reverse 82L payroll 0815 JE-21-0020-To reverse 82L Payroll of 8152020,D108,HJ,,33.42,73786.83
6150,8/15/2020,8/15/2020,82L-PRPD-081520,To reverse 82L payroll 0815 JE-21-0020-To reverse 82L Payroll of 8152020,D108,HJ,,33.86,73752.97
6150,8/15/2020,8/15/2020,82L-PRPD-081520,To reverse 82L payroll 0815 JE-21-0020-To reverse 82L Payroll of 8152020,D108,HJ,,34.07,73718.9
6150,8/15/2020,8/15/2020,82L-PRPD-081520,To reverse 82L payroll 0815 JE-21-0020-To reverse 82L Payroll of 8152020,D108,HJ,,36.3,73682.6
6150,8/15/2020,8/15/2020,82L-PRPD-081520,To reverse 82L payroll 0815 JE-21-0020-To reverse 82L Payroll of 8152020,D108,HJ,,36.34,73646.26
6150,8/15/2020,8/15/2020,82L-PRPD-081520,To reverse 82L payroll 0815 JE-21-0020-To reverse 82L Payroll of 8152020,D108,HJ,,36.46,73609.8
6150,8/15/2020,8/15/2020,82L-PRPD-081520,To reverse 82L payroll 0815 JE-21-0020-To reverse 82L Payroll of 8152020,D108,HJ,,37.97,73571.83
6150,8/15/2020,8/15/2020,82L-PRPD-081520,To reverse 82L payroll 0815 JE-21-0020-To reverse 82L Payroll of 8152020,D108,HJ,,38.67,73533.16
6150,8/15/2020,8/15/2020,82L-PRPD-081520,To reverse 82L payroll 0815 JE-21-0020-To reverse 82L Payroll of 8152020,D108,HJ,,41.85,73491.31
6150,8/15/2020,8/15/2020,82L-PRPD-081520,To reverse 82L payroll 0815 JE-21-0020-To reverse 82L Payroll of 8152020,D108,HJ,,42.32,73448.99
6150,8/15/2020,8/15/2020,82L-PRPD-081520,To reverse 82L payroll 0815 JE-21-0020-To reverse 82L Payroll of 8152020,D108,HJ,,45.1,73403.89
6150,8/15/2020,8/15/2020,82L-PRPD-081520,To reverse 82L payroll 0815 JE-21-0020-To reverse 82L Payroll of 8152020,D108,HJ,,45.87,73358.02
6150,8/15/2020,8/15/2020,82L-PRPD-081520,To reverse 82L payroll 0815 JE-21-0020-To reverse 82L Payroll of 8152020,D108,HJ,,52.91,73305.11
6150,8/15/2020,8/15/2020,82L-PRPD-081520,To reverse 82L payroll 0815 JE-21-0020-To reverse 82L Payroll of 8152020,D108,HJ,,112.81,73192.3
6150,8/15/2020,8/15/2020,82L-PRPD-081520,To reverse 82L payroll 0815 JE-21-0020-To reverse 82L Payroll of 8152020,D108,HJ,,113.67,73078.63
6150,8/15/2020,8/15/2020,82L-PRPD-081520,To reverse 82L payroll 0815 JE-21-0020-To reverse 82L Payroll of 8152020,D108,HJ,,123.72,72954.91
6150,8/15/2020,8/15/2020,82L-PRPD-081520,To reverse 82L payroll 0815 JE-21-0020-To reverse 82L Payroll of 8152020,D108,HJ,,131.84,72823.07
6150,8/15/2020,8/15/2020,82L-PRPD-081520,To reverse 82L payroll 0815 JE-21-0020-To reverse 82L Payroll of 8152020,D108,HJ,,133.51,72689.56
6150,8/15/2020,8/15/2020,82L-PRPD-081520,To reverse 82L payroll 0815 JE-21-0020-To reverse 82L Payroll of 8152020,D108,HJ,,133.98,72555.58
6150,8/15/2020,8/15/2020,82L-PRPD-081520,To reverse 82L payroll 0815 JE-21-0020-To reverse 82L Payroll of 8152020,D108,HJ,,140.75,72414.83
6150,8/15/2020,8/15/2020,82L-PRPD-081520,To reverse 82L payroll 0815 JE-21-0020-To reverse 82L Payroll of 8152020,D108,HJ,,141.55,72273.28
6150,8/15/2020,8/15/2020,82L-PRPD-081520,To reverse 82L payroll 0815 JE-21-0020-To reverse 82L Payroll of 8152020,D108,HJ,,142.08,72131.2
6150,8/15/2020,8/15/2020,82L-PRPD-081520,To reverse 82L payroll 0815 JE-21-0020-To reverse 82L Payroll of 8152020,D108,HJ,,142.81,71988.39
6150,8/15/2020,8/15/2020,82L-PRPD-081520,To reverse 82L payroll 0815 JE-21-0020-To reverse 82L Payroll of 8152020,D108,HJ,,142.9,71845.49
6150,8/15/2020,8/15/2020,82L-PRPD-081520,To reverse 82L payroll 0815 JE-21-0020-To reverse 82L Payroll of 8152020,D108,HJ,,144.76,71700.73
6150,8/15/2020,8/15/2020,82L-PRPD-081520,To reverse 82L payroll 0815 JE-21-0020-To reverse 82L Payroll of 8152020,D108,HJ,,145.66,71555.07
6150,8/15/2020,8/15/2020,82L-PRPD-081520,To reverse 82L payroll 0815 JE-21-0020-To reverse 82L Payroll of 8152020,D108,HJ,,155.19,71399.88
6150,8/15/2020,8/15/2020,82L-PRPD-081520,To reverse 82L payroll 0815 JE-21-0020-To reverse 82L Payroll of 8152020,D108,HJ,,155.39,71244.49
6150,8/15/2020,8/15/2020,82L-PRPD-081520,To reverse 82L payroll 0815 JE-21-0020-To reverse 82L Payroll of 8152020,D108,HJ,,155.89,71088.6
6150,8/15/2020,8/15/2020,82L-PRPD-081520,To reverse 82L payroll 0815 JE-21-0020-To reverse 82L Payroll of 8152020,D108,HJ,,162.36,70926.24
6150,8/15/2020,8/15/2020,82L-PRPD-081520,To reverse 82L payroll 0815 JE-21-0020-To reverse 82L Payroll of 8152020,D108,HJ,,165.33,70760.91
6150,8/15/2020,8/15/2020,82L-PRPD-081520,To reverse 82L payroll 0815 JE-21-0020-To reverse 82L Payroll of 8152020,D108,HJ,,178.96,70581.95
6150,8/15/2020,8/15/2020,82L-PRPD-081520,To reverse 82L payroll 0815 JE-21-0020-To reverse 82L Payroll of 8152020,D108,HJ,,180.94,70401.01
6150,8/15/2020,8/15/2020,82L-PRPD-081520,To reverse 82L payroll 0815 JE-21-0020-To reverse 82L Payroll of 8152020,D108,HJ,,192.83,70208.18
6150,8/15/2020,8/15/2020,82L-PRPD-081520,To reverse 82L payroll 0815 JE-21-0020-To reverse 82L Payroll of 8152020,D108,HJ,,196.13,70012.05
6150,8/15/2020,8/15/2020,82L-PRPD-081520,To reverse 82L payroll 0815 JE-21-0020-To reverse 82L Payroll of 8152020,D108,HJ,,226.22,69785.83
6150,8/15/2020,8/15/2020,82L-PRPD-081520,To reverse 82L payroll 0815 JE-21-0020-To reverse 82L Payroll of 8152020,D111,HJ,,36.33,69749.5
6150,8/15/2020,8/15/2020,82L-PRPD-081520,To reverse 82L payroll 0815 JE-21-0020-To reverse 82L Payroll of 8152020,D111,HJ,,155.35,69594.15
6150,8/15/2020,8/15/2020,82L-PRPD-081520,To reverse 82L payroll 0815 JE-21-0020-To reverse 82L Payroll of 8152020,D102,HJ,,39,69555.15
6150,8/15/2020,8/15/2020,82L-PRPD-081520,To reverse 82L payroll 0815 JE-21-0020-To reverse 82L Payroll of 8152020,D102,HJ,,74.25,69480.9
6150,8/15/2020,8/15/2020,82L-PRPD-081520,To reverse 82L payroll 0815 JE-21-0020-To reverse 82L Payroll of 8152020,D102,HJ,,108.43,69372.47
6150,8/15/2020,8/15/2020,82L-PRPD-081520,To reverse 82L payroll 0815 JE-21-0020-To reverse 82L Payroll of 8152020,D102,HJ,,166.75,69205.72
6150,8/15/2020,8/15/2020,82L-PRPD-081520,To reverse 82L payroll 0815 JE-21-0020-To reverse 82L Payroll of 8152020,D102,HJ,,317.48,68888.24
6150,8/15/2020,8/15/2020,82L-PRPD-081520,To reverse 82L payroll 0815 JE-21-0020-To reverse 82L Payroll of 8152020,D102,HJ,,463.62,68424.62
6150,8/15/2020,8/15/2020,82L-PRPD-081520,To reverse 82L payroll 0815 JE-21-0020-To reverse 82L Payroll of 8152020,D103,HJ,,12.69,68411.93
6150,8/15/2020,8/15/2020,82L-PRPD-081520,To reverse 82L payroll 0815 JE-21-0020-To reverse 82L Payroll of 8152020,D103,HJ,,33.06,68378.87
6150,8/15/2020,8/15/2020,82L-PRPD-081520,To reverse 82L payroll 0815 JE-21-0020-To reverse 82L Payroll of 8152020,D103,HJ,,36.98,68341.89
6150,8/15/2020,8/15/2020,82L-PRPD-081520,To reverse 82L payroll 0815 JE-21-0020-To reverse 82L Payroll of 8152020,D103,HJ,,43.23,68298.66
6150,8/15/2020,8/15/2020,82L-PRPD-081520,To reverse 82L payroll 0815 JE-21-0020-To reverse 82L Payroll of 8152020,D103,HJ,,54.25,68244.41
6150,8/15/2020,8/15/2020,82L-PRPD-081520,To reverse 82L payroll 0815 JE-21-0020-To reverse 82L Payroll of 8152020,D103,HJ,,61.55,68182.86
6150,8/15/2020,8/15/2020,82L-PRPD-081520,To reverse 82L payroll 0815 JE-21-0020-To reverse 82L Payroll of 8152020,D103,HJ,,72.42,68110.44
6150,8/15/2020,8/15/2020,82L-PRPD-081520,To reverse 82L payroll 0815 JE-21-0020-To reverse 82L Payroll of 8152020,D103,HJ,,141.34,67969.1
6150,8/15/2020,8/15/2020,82L-PRPD-081520,To reverse 82L payroll 0815 JE-21-0020-To reverse 82L Payroll of 8152020,D103,HJ,,184.83,67784.27
6150,8/15/2020,8/15/2020,82L-PRPD-081520,To reverse 82L payroll 0815 JE-21-0020-To reverse 82L Payroll of 8152020,D103,HJ,,309.64,67474.63
6150,8/15/2020,8/15/2020,82L-PRPD-081520,To reverse 82L payroll 0815 JE-21-0020-To reverse 82L Payroll of 8152020,D107,HJ,,7.01,67467.62
6150,8/15/2020,8/15/2020,82L-PRPD-081520,To reverse 82L payroll 0815 JE-21-0020-To reverse 82L Payroll of 8152020,D107,HJ,,11.63,67455.99
6150,8/15/2020,8/15/2020,82L-PRPD-081520,To reverse 82L payroll 0815 JE-21-0020-To reverse 82L Payroll of 8152020,D107,HJ,,13.05,67442.94
6150,8/15/2020,8/15/2020,82L-PRPD-081520,To reverse 82L payroll 0815 JE-21-0020-To reverse 82L Payroll of 8152020,D107,HJ,,14.01,67428.93
6150,8/15/2020,8/15/2020,82L-PRPD-081520,To reverse 82L payroll 0815 JE-21-0020-To reverse 82L Payroll of 8152020,D107,HJ,,14.01,67414.92
6150,8/15/2020,8/15/2020,82L-PRPD-081520,To reverse 82L payroll 0815 JE-21-0020-To reverse 82L Payroll of 8152020,D107,HJ,,14.05,67400.87
6150,8/15/2020,8/15/2020,82L-PRPD-081520,To reverse 82L payroll 0815 JE-21-0020-To reverse 82L Payroll of 8152020,D107,HJ,,14.05,67386.82
6150,8/15/2020,8/15/2020,82L-PRPD-081520,To reverse 82L payroll 0815 JE-21-0020-To reverse 82L Payroll of 8152020,D107,HJ,,14.07,67372.75
6150,8/15/2020,8/15/2020,82L-PRPD-081520,To reverse 82L payroll 0815 JE-21-0020-To reverse 82L Payroll of 8152020,D107,HJ,,14.25,67358.5
6150,8/15/2020,8/15/2020,82L-PRPD-081520,To reverse 82L payroll 0815 JE-21-0020-To reverse 82L Payroll of 8152020,D107,HJ,,14.65,67343.85
6150,8/15/2020,8/15/2020,82L-PRPD-081520,To reverse 82L payroll 0815 JE-21-0020-To reverse 82L Payroll of 8152020,D107,HJ,,14.98,67328.87
6150,8/15/2020,8/15/2020,82L-PRPD-081520,To reverse 82L payroll 0815 JE-21-0020-To reverse 82L Payroll of 8152020,D107,HJ,,15.1,67313.77
6150,8/15/2020,8/15/2020,82L-PRPD-081520,To reverse 82L payroll 0815 JE-21-0020-To reverse 82L Payroll of 8152020,D107,HJ,,15.19,67298.58
6150,8/15/2020,8/15/2020,82L-PRPD-081520,To reverse 82L payroll 0815 JE-21-0020-To reverse 82L Payroll of 8152020,D107,HJ,,15.19,67283.39
6150,8/15/2020,8/15/2020,82L-PRPD-081520,To reverse 82L payroll 0815 JE-21-0020-To reverse 82L Payroll of 8152020,D107,HJ,,15.19,67268.2
6150,8/15/2020,8/15/2020,82L-PRPD-081520,To reverse 82L payroll 0815 JE-21-0020-To reverse 82L Payroll of 8152020,D107,HJ,,15.19,67253.01
6150,8/15/2020,8/15/2020,82L-PRPD-081520,To reverse 82L payroll 0815 JE-21-0020-To reverse 82L Payroll of 8152020,D107,HJ,,15.19,67237.82
6150,8/15/2020,8/15/2020,82L-PRPD-081520,To reverse 82L payroll 0815 JE-21-0020-To reverse 82L Payroll of 8152020,D107,HJ,,15.19,67222.63
6150,8/15/2020,8/15/2020,82L-PRPD-081520,To reverse 82L payroll 0815 JE-21-0020-To reverse 82L Payroll of 8152020,D107,HJ,,15.19,67207.44
6150,8/15/2020,8/15/2020,82L-PRPD-081520,To reverse 82L payroll 0815 JE-21-0020-To reverse 82L Payroll of 8152020,D107,HJ,,15.19,67192.25
6150,8/15/2020,8/15/2020,82L-PRPD-081520,To reverse 82L payroll 0815 JE-21-0020-To reverse 82L Payroll of 8152020,D107,HJ,,15.19,67177.06
6150,8/15/2020,8/15/2020,82L-PRPD-081520,To reverse 82L payroll 0815 JE-21-0020-To reverse 82L Payroll of 8152020,D107,HJ,,15.19,67161.87
6150,8/15/2020,8/15/2020,82L-PRPD-081520,To reverse 82L payroll 0815 JE-21-0020-To reverse 82L Payroll of 8152020,D107,HJ,,15.19,67146.68
6150,8/15/2020,8/15/2020,82L-PRPD-081520,To reverse 82L payroll 0815 JE-21-0020-To reverse 82L Payroll of 8152020,D107,HJ,,15.19,67131.49
6150,8/15/2020,8/15/2020,82L-PRPD-081520,To reverse 82L payroll 0815 JE-21-0020-To reverse 82L Payroll of 8152020,D107,HJ,,15.19,67116.3
6150,8/15/2020,8/15/2020,82L-PRPD-081520,To reverse 82L payroll 0815 JE-21-0020-To reverse 82L Payroll of 8152020,D107,HJ,,15.19,67101.11
6150,8/15/2020,8/15/2020,82L-PRPD-081520,To reverse 82L payroll 0815 JE-21-0020-To reverse 82L Payroll of 8152020,D107,HJ,,15.19,67085.92
6150,8/15/2020,8/15/2020,82L-PRPD-081520,To reverse 82L payroll 0815 JE-21-0020-To reverse 82L Payroll of 8152020,D107,HJ,,15.19,67070.73
6150,8/15/2020,8/15/2020,82L-PRPD-081520,To reverse 82L payroll 0815 JE-21-0020-To reverse 82L Payroll of 8152020,D107,HJ,,15.19,67055.54
6150,8/15/2020,8/15/2020,82L-PRPD-081520,To reverse 82L payroll 0815 JE-21-0020-To reverse 82L Payroll of 8152020,D107,HJ,,15.19,67040.35
6150,8/15/2020,8/15/2020,82L-PRPD-081520,To reverse 82L payroll 0815 JE-21-0020-To reverse 82L Payroll of 8152020,D107,HJ,,17.57,67022.78
6150,8/15/2020,8/15/2020,82L-PRPD-081520,To reverse 82L payroll 0815 JE-21-0020-To reverse 82L Payroll of 8152020,D107,HJ,,17.57,67005.21
6150,8/15/2020,8/15/2020,82L-PRPD-081520,To reverse 82L payroll 0815 JE-21-0020-To reverse 82L Payroll of 8152020,D107,HJ,,17.71,66987.5
6150,8/15/2020,8/15/2020,82L-PRPD-081520,To reverse 82L payroll 0815 JE-21-0020-To reverse 82L Payroll of 8152020,D107,HJ,,20.14,66967.36
6150,8/15/2020,8/15/2020,82L-PRPD-081520,To reverse 82L payroll 0815 JE-21-0020-To reverse 82L Payroll of 8152020,D107,HJ,,21.41,66945.95
6150,8/15/2020,8/15/2020,82L-PRPD-081520,To reverse 82L payroll 0815 JE-21-0020-To reverse 82L Payroll of 8152020,D107,HJ,,23.29,66922.66
6150,8/15/2020,8/15/2020,82L-PRPD-081520,To reverse 82L payroll 0815 JE-21-0020-To reverse 82L Payroll of 8152020,D107,HJ,,25.1,66897.56
6150,8/15/2020,8/15/2020,82L-PRPD-081520,To reverse 82L payroll 0815 JE-21-0020-To reverse 82L Payroll of 8152020,D107,HJ,,26.08,66871.48
6150,8/15/2020,8/15/2020,82L-PRPD-081520,To reverse 82L payroll 0815 JE-21-0020-To reverse 82L Payroll of 8152020,D107,HJ,,26.16,66845.32
6150,8/15/2020,8/15/2020,82L-PRPD-081520,To reverse 82L payroll 0815 JE-21-0020-To reverse 82L Payroll of 8152020,D107,HJ,,26.16,66819.16
6150,8/15/2020,8/15/2020,82L-PRPD-081520,To reverse 82L payroll 0815 JE-21-0020-To reverse 82L Payroll of 8152020,D107,HJ,,26.21,66792.95
6150,8/15/2020,8/15/2020,82L-PRPD-081520,To reverse 82L payroll 0815 JE-21-0020-To reverse 82L Payroll of 8152020,D107,HJ,,26.3,66766.65
6150,8/15/2020,8/15/2020,82L-PRPD-081520,To reverse 82L payroll 0815 JE-21-0020-To reverse 82L Payroll of 8152020,D107,HJ,,26.53,66740.12
6150,8/15/2020,8/15/2020,82L-PRPD-081520,To reverse 82L payroll 0815 JE-21-0020-To reverse 82L Payroll of 8152020,D107,HJ,,27.79,66712.33
6150,8/15/2020,8/15/2020,82L-PRPD-081520,To reverse 82L payroll 0815 JE-21-0020-To reverse 82L Payroll of 8152020,D107,HJ,,27.79,66684.54
6150,8/15/2020,8/15/2020,82L-PRPD-081520,To reverse 82L payroll 0815 JE-21-0020-To reverse 82L Payroll of 8152020,D107,HJ,,27.89,66656.65
6150,8/15/2020,8/15/2020,82L-PRPD-081520,To reverse 82L payroll 0815 JE-21-0020-To reverse 82L Payroll of 8152020,D107,HJ,,28.29,66628.36
6150,8/15/2020,8/15/2020,82L-PRPD-081520,To reverse 82L payroll 0815 JE-21-0020-To reverse 82L Payroll of 8152020,D107,HJ,,28.29,66600.07
6150,8/15/2020,8/15/2020,82L-PRPD-081520,To reverse 82L payroll 0815 JE-21-0020-To reverse 82L Payroll of 8152020,D107,HJ,,28.29,66571.78
6150,8/15/2020,8/15/2020,82L-PRPD-081520,To reverse 82L payroll 0815 JE-21-0020-To reverse 82L Payroll of 8152020,D107,HJ,,28.29,66543.49
6150,8/15/2020,8/15/2020,82L-PRPD-081520,To reverse 82L payroll 0815 JE-21-0020-To reverse 82L Payroll of 8152020,D107,HJ,,29,66514.49
6150,8/15/2020,8/15/2020,82L-PRPD-081520,To reverse 82L payroll 0815 JE-21-0020-To reverse 82L Payroll of 8152020,D107,HJ,,29.98,66484.51
6150,8/15/2020,8/15/2020,82L-PRPD-081520,To reverse 82L payroll 0815 JE-21-0020-To reverse 82L Payroll of 8152020,D107,HJ,,31.18,66453.33
6150,8/15/2020,8/15/2020,82L-PRPD-081520,To reverse 82L payroll 0815 JE-21-0020-To reverse 82L Payroll of 8152020,D107,HJ,,33.51,66419.82
6150,8/15/2020,8/15/2020,82L-PRPD-081520,To reverse 82L payroll 0815 JE-21-0020-To reverse 82L Payroll of 8152020,D107,HJ,,33.58,66386.24
6150,8/15/2020,8/15/2020,82L-PRPD-081520,To reverse 82L payroll 0815 JE-21-0020-To reverse 82L Payroll of 8152020,D107,HJ,,34.63,66351.61
6150,8/15/2020,8/15/2020,82L-PRPD-081520,To reverse 82L payroll 0815 JE-21-0020-To reverse 82L Payroll of 8152020,D107,HJ,,34.63,66316.98
6150,8/15/2020,8/15/2020,82L-PRPD-081520,To reverse 82L payroll 0815 JE-21-0020-To reverse 82L Payroll of 8152020,D107,HJ,,36.67,66280.31
6150,8/15/2020,8/15/2020,82L-PRPD-081520,To reverse 82L payroll 0815 JE-21-0020-To reverse 82L Payroll of 8152020,D107,HJ,,36.67,66243.64
6150,8/15/2020,8/15/2020,82L-PRPD-081520,To reverse 82L payroll 0815 JE-21-0020-To reverse 82L Payroll of 8152020,D107,HJ,,36.67,66206.97
6150,8/15/2020,8/15/2020,82L-PRPD-081520,To reverse 82L payroll 0815 JE-21-0020-To reverse 82L Payroll of 8152020,D107,HJ,,36.85,66170.12
6150,8/15/2020,8/15/2020,82L-PRPD-081520,To reverse 82L payroll 0815 JE-21-0020-To reverse 82L Payroll of 8152020,D107,HJ,,38.11,66132.01
6150,8/15/2020,8/15/2020,82L-PRPD-081520,To reverse 82L payroll 0815 JE-21-0020-To reverse 82L Payroll of 8152020,D107,HJ,,39.26,66092.75
6150,8/15/2020,8/15/2020,82L-PRPD-081520,To reverse 82L payroll 0815 JE-21-0020-To reverse 82L Payroll of 8152020,D107,HJ,,39.27,66053.48
6150,8/15/2020,8/15/2020,82L-PRPD-081520,To reverse 82L payroll 0815 JE-21-0020-To reverse 82L Payroll of 8152020,D107,HJ,,39.88,66013.6
6150,8/15/2020,8/15/2020,82L-PRPD-081520,To reverse 82L payroll 0815 JE-21-0020-To reverse 82L Payroll of 8152020,D107,HJ,,39.93,65973.67
6150,8/15/2020,8/15/2020,82L-PRPD-081520,To reverse 82L payroll 0815 JE-21-0020-To reverse 82L Payroll of 8152020,D107,HJ,,41.08,65932.59
6150,8/15/2020,8/15/2020,82L-PRPD-081520,To reverse 82L payroll 0815 JE-21-0020-To reverse 82L Payroll of 8152020,D107,HJ,,42.29,65890.3
6150,8/15/2020,8/15/2020,82L-PRPD-081520,To reverse 82L payroll 0815 JE-21-0020-To reverse 82L Payroll of 8152020,D107,HJ,,44.27,65846.03
6150,8/15/2020,8/15/2020,82L-PRPD-081520,To reverse 82L payroll 0815 JE-21-0020-To reverse 82L Payroll of 8152020,D107,HJ,,49.84,65796.19
6150,8/15/2020,8/15/2020,82L-PRPD-081520,To reverse 82L payroll 0815 JE-21-0020-To reverse 82L Payroll of 8152020,D107,HJ,,49.87,65746.32
6150,8/15/2020,8/15/2020,82L-PRPD-081520,To reverse 82L payroll 0815 JE-21-0020-To reverse 82L Payroll of 8152020,D107,HJ,,50.63,65695.69
6150,8/15/2020,8/15/2020,82L-PRPD-081520,To reverse 82L payroll 0815 JE-21-0020-To reverse 82L Payroll of 8152020,D107,HJ,,52.1,65643.59
6150,8/15/2020,8/15/2020,82L-PRPD-081520,To reverse 82L payroll 0815 JE-21-0020-To reverse 82L Payroll of 8152020,D107,HJ,,52.29,65591.3
6150,8/15/2020,8/15/2020,82L-PRPD-081520,To reverse 82L payroll 0815 JE-21-0020-To reverse 82L Payroll of 8152020,D107,HJ,,59.89,65531.41
6150,8/15/2020,8/15/2020,82L-PRPD-081520,To reverse 82L payroll 0815 JE-21-0020-To reverse 82L Payroll of 8152020,D107,HJ,,59.89,65471.52
6150,8/15/2020,8/15/2020,82L-PRPD-081520,To reverse 82L payroll 0815 JE-21-0020-To reverse 82L Payroll of 8152020,D107,HJ,,60.07,65411.45
6150,8/15/2020,8/15/2020,82L-PRPD-081520,To reverse 82L payroll 0815 JE-21-0020-To reverse 82L Payroll of 8152020,D107,HJ,,60.07,65351.38
6150,8/15/2020,8/15/2020,82L-PRPD-081520,To reverse 82L payroll 0815 JE-21-0020-To reverse 82L Payroll of 8152020,D107,HJ,,60.18,65291.2
6150,8/15/2020,8/15/2020,82L-PRPD-081520,To reverse 82L payroll 0815 JE-21-0020-To reverse 82L Payroll of 8152020,D107,HJ,,60.92,65230.28
6150,8/15/2020,8/15/2020,82L-PRPD-081520,To reverse 82L payroll 0815 JE-21-0020-To reverse 82L Payroll of 8152020,D107,HJ,,62.53,65167.75
6150,8/15/2020,8/15/2020,82L-PRPD-081520,To reverse 82L payroll 0815 JE-21-0020-To reverse 82L Payroll of 8152020,D107,HJ,,62.62,65105.13
6150,8/15/2020,8/15/2020,82L-PRPD-081520,To reverse 82L payroll 0815 JE-21-0020-To reverse 82L Payroll of 8152020,D107,HJ,,64.03,65041.1
6150,8/15/2020,8/15/2020,82L-PRPD-081520,To reverse 82L payroll 0815 JE-21-0020-To reverse 82L Payroll of 8152020,D107,HJ,,64.48,64976.62
6150,8/15/2020,8/15/2020,82L-PRPD-081520,To reverse 82L payroll 0815 JE-21-0020-To reverse 82L Payroll of 8152020,D107,HJ,,64.48,64912.14
6150,8/15/2020,8/15/2020,82L-PRPD-081520,To reverse 82L payroll 0815 JE-21-0020-To reverse 82L Payroll of 8152020,D107,HJ,,64.58,64847.56
6150,8/15/2020,8/15/2020,82L-PRPD-081520,To reverse 82L payroll 0815 JE-21-0020-To reverse 82L Payroll of 8152020,D107,HJ,,64.95,64782.61
6150,8/15/2020,8/15/2020,82L-PRPD-081520,To reverse 82L payroll 0815 JE-21-0020-To reverse 82L Payroll of 8152020,D107,HJ,,64.95,64717.66
6150,8/15/2020,8/15/2020,82L-PRPD-081520,To reverse 82L payroll 0815 JE-21-0020-To reverse 82L Payroll of 8152020,D107,HJ,,64.95,64652.71
6150,8/15/2020,8/15/2020,82L-PRPD-081520,To reverse 82L payroll 0815 JE-21-0020-To reverse 82L Payroll of 8152020,D107,HJ,,64.95,64587.76
6150,8/15/2020,8/15/2020,82L-PRPD-081520,To reverse 82L payroll 0815 JE-21-0020-To reverse 82L Payroll of 8152020,D107,HJ,,64.95,64522.81
6150,8/15/2020,8/15/2020,82L-PRPD-081520,To reverse 82L payroll 0815 JE-21-0020-To reverse 82L Payroll of 8152020,D107,HJ,,64.95,64457.86
6150,8/15/2020,8/15/2020,82L-PRPD-081520,To reverse 82L payroll 0815 JE-21-0020-To reverse 82L Payroll of 8152020,D107,HJ,,64.95,64392.91
6150,8/15/2020,8/15/2020,82L-PRPD-081520,To reverse 82L payroll 0815 JE-21-0020-To reverse 82L Payroll of 8152020,D107,HJ,,64.95,64327.96
6150,8/15/2020,8/15/2020,82L-PRPD-081520,To reverse 82L payroll 0815 JE-21-0020-To reverse 82L Payroll of 8152020,D107,HJ,,64.95,64263.01
6150,8/15/2020,8/15/2020,82L-PRPD-081520,To reverse 82L payroll 0815 JE-21-0020-To reverse 82L Payroll of 8152020,D107,HJ,,64.95,64198.06
6150,8/15/2020,8/15/2020,82L-PRPD-081520,To reverse 82L payroll 0815 JE-21-0020-To reverse 82L Payroll of 8152020,D107,HJ,,64.95,64133.11
6150,8/15/2020,8/15/2020,82L-PRPD-081520,To reverse 82L payroll 0815 JE-21-0020-To reverse 82L Payroll of 8152020,D107,HJ,,64.95,64068.16
6150,8/15/2020,8/15/2020,82L-PRPD-081520,To reverse 82L payroll 0815 JE-21-0020-To reverse 82L Payroll of 8152020,D107,HJ,,64.95,64003.21
6150,8/15/2020,8/15/2020,82L-PRPD-081520,To reverse 82L payroll 0815 JE-21-0020-To reverse 82L Payroll of 8152020,D107,HJ,,64.95,63938.26
6150,8/15/2020,8/15/2020,82L-PRPD-081520,To reverse 82L payroll 0815 JE-21-0020-To reverse 82L Payroll of 8152020,D107,HJ,,64.95,63873.31
6150,8/15/2020,8/15/2020,82L-PRPD-081520,To reverse 82L payroll 0815 JE-21-0020-To reverse 82L Payroll of 8152020,D107,HJ,,64.95,63808.36
6150,8/15/2020,8/15/2020,82L-PRPD-081520,To reverse 82L payroll 0815 JE-21-0020-To reverse 82L Payroll of 8152020,D107,HJ,,64.95,63743.41
6150,8/15/2020,8/15/2020,82L-PRPD-081520,To reverse 82L payroll 0815 JE-21-0020-To reverse 82L Payroll of 8152020,D107,HJ,,64.95,63678.46
6150,8/15/2020,8/15/2020,82L-PRPD-081520,To reverse 82L payroll 0815 JE-21-0020-To reverse 82L Payroll of 8152020,D107,HJ,,68.63,63609.83
6150,8/15/2020,8/15/2020,82L-PRPD-081520,To reverse 82L payroll 0815 JE-21-0020-To reverse 82L Payroll of 8152020,D107,HJ,,75.71,63534.12
6150,8/15/2020,8/15/2020,82L-PRPD-081520,To reverse 82L payroll 0815 JE-21-0020-To reverse 82L Payroll of 8152020,D107,HJ,,76.5,63457.62
6150,8/15/2020,8/15/2020,82L-PRPD-081520,To reverse 82L payroll 0815 JE-21-0020-To reverse 82L Payroll of 8152020,D107,HJ,,76.5,63381.12
6150,8/15/2020,8/15/2020,82L-PRPD-081520,To reverse 82L payroll 0815 JE-21-0020-To reverse 82L Payroll of 8152020,D107,HJ,,78.57,63302.55
6150,8/15/2020,8/15/2020,82L-PRPD-081520,To reverse 82L payroll 0815 JE-21-0020-To reverse 82L Payroll of 8152020,D107,HJ,,88.74,63213.81
6150,8/15/2020,8/15/2020,82L-PRPD-081520,To reverse 82L payroll 0815 JE-21-0020-To reverse 82L Payroll of 8152020,D107,HJ,,91.57,63122.24
6150,8/15/2020,8/15/2020,82L-PRPD-081520,To reverse 82L payroll 0815 JE-21-0020-To reverse 82L Payroll of 8152020,D107,HJ,,99.58,63022.66
6150,8/15/2020,8/15/2020,82L-PRPD-081520,To reverse 82L payroll 0815 JE-21-0020-To reverse 82L Payroll of 8152020,D107,HJ,,107.33,62915.33
6150,8/15/2020,8/15/2020,82L-PRPD-081520,To reverse 82L payroll 0815 JE-21-0020-To reverse 82L Payroll of 8152020,D107,HJ,,112.45,62802.88
6150,8/15/2020,8/15/2020,82L-PRPD-081520,To reverse 82L payroll 0815 JE-21-0020-To reverse 82L Payroll of 8152020,D107,HJ,,114.45,62688.43
6150,8/15/2020,8/15/2020,82L-PRPD-081520,To reverse 82L payroll 0815 JE-21-0020-To reverse 82L Payroll of 8152020,D107,HJ,,118.83,62569.6
6150,8/15/2020,8/15/2020,82L-PRPD-081520,To reverse 82L payroll 0815 JE-21-0020-To reverse 82L Payroll of 8152020,D107,HJ,,118.83,62450.77
6150,8/15/2020,8/15/2020,82L-PRPD-081520,To reverse 82L payroll 0815 JE-21-0020-To reverse 82L Payroll of 8152020,D107,HJ,,124,62326.77
6150,8/15/2020,8/15/2020,82L-PRPD-081520,To reverse 82L payroll 0815 JE-21-0020-To reverse 82L Payroll of 8152020,D107,HJ,,133.3,62193.47
6150,8/15/2020,8/15/2020,82L-PRPD-081520,To reverse 82L payroll 0815 JE-21-0020-To reverse 82L Payroll of 8152020,D107,HJ,,143.3,62050.17
6150,8/15/2020,8/15/2020,82L-PRPD-081520,To reverse 82L payroll 0815 JE-21-0020-To reverse 82L Payroll of 8152020,D107,HJ,,143.59,61906.58
6150,8/15/2020,8/15/2020,82L-PRPD-081520,To reverse 82L payroll 0815 JE-21-0020-To reverse 82L Payroll of 8152020,D107,HJ,,148.06,61758.52
6150,8/15/2020,8/15/2020,82L-PRPD-081520,To reverse 82L payroll 0815 JE-21-0020-To reverse 82L Payroll of 8152020,D107,HJ,,148.06,61610.46
6150,8/15/2020,8/15/2020,82L-PRPD-081520,To reverse 82L payroll 0815 JE-21-0020-To reverse 82L Payroll of 8152020,D107,HJ,,157.58,61452.88
6150,8/15/2020,8/15/2020,82L-PRPD-081520,To reverse 82L payroll 0815 JE-21-0020-To reverse 82L Payroll of 8152020,D107,HJ,,162.94,61289.94
6150,8/15/2020,8/15/2020,82L-PRPD-081520,To reverse 82L payroll 0815 JE-21-0020-To reverse 82L Payroll of 8152020,D107,HJ,,167.87,61122.07
6150,8/15/2020,8/15/2020,82L-PRPD-081520,To reverse 82L payroll 0815 JE-21-0020-To reverse 82L Payroll of 8152020,D107,HJ,,167.92,60954.15
6150,8/15/2020,8/15/2020,82L-PRPD-081520,To reverse 82L payroll 0815 JE-21-0020-To reverse 82L Payroll of 8152020,D107,HJ,,170.75,60783.4
6150,8/15/2020,8/15/2020,82L-PRPD-081520,To reverse 82L payroll 0815 JE-21-0020-To reverse 82L Payroll of 8152020,D107,HJ,,175.67,60607.73
6150,8/15/2020,8/15/2020,82L-PRPD-081520,To reverse 82L payroll 0815 JE-21-0020-To reverse 82L Payroll of 8152020,D107,HJ,,180.83,60426.9
6150,8/15/2020,8/15/2020,82L-PRPD-081520,To reverse 82L payroll 0815 JE-21-0020-To reverse 82L Payroll of 8152020,D107,HJ,,213.13,60213.77
6150,8/15/2020,8/15/2020,82L-PRPD-081520,To reverse 82L payroll 0815 JE-21-0020-To reverse 82L Payroll of 8152020,D107,HJ,,213.25,60000.52
6150,8/15/2020,8/15/2020,82L-PRPD-081520,To reverse 82L payroll 0815 JE-21-0020-To reverse 82L Payroll of 8152020,D107,HJ,,223.58,59776.94
6150,8/15/2020,8/15/2020,82L-PRPD-081520,To reverse 82L payroll 0815 JE-21-0020-To reverse 82L Payroll of 8152020,D107,HJ,,335.97,59440.97
6150,8/15/2020,8/15/2020,82L-PRPD-081520,To reverse 82L payroll 0815 JE-21-0020-To reverse 82L Payroll of 8152020,D107,HJ,,379.45,59061.52
6150,8/15/2020,8/15/2020,82L-PRPD-081520,To reverse 82L payroll 0815 JE-21-0020-To reverse 82L Payroll of 8152020,D108,HJ,,35.7,59025.82
6150,8/15/2020,8/15/2020,82L-PRPD-081520,To reverse 82L payroll 0815 JE-21-0020-To reverse 82L Payroll of 8152020,D108,HJ,,37.96,58987.86
6150,8/15/2020,8/15/2020,82L-PRPD-081520,To reverse 82L payroll 0815 JE-21-0020-To reverse 82L Payroll of 8152020,D108,HJ,,152.64,58835.22
6150,8/15/2020,8/15/2020,82L-PRPD-081520,To reverse 82L payroll 0815 JE-21-0020-To reverse 82L Payroll of 8152020,D108,HJ,,162.32,58672.9
6150,8/15/2020,8/15/2020,82L-PRPD-081520,To reverse 82L payroll 0815 JE-21-0020-To reverse 82L Payroll of 8152020,D108,HJ,,30.44,58642.46
6150,8/15/2020,8/15/2020,82L-PRPD-081520,To reverse 82L payroll 0815 JE-21-0020-To reverse 82L Payroll of 8152020,D108,HJ,,30.56,58611.9
6150,8/15/2020,8/15/2020,82L-PRPD-081520,To reverse 82L payroll 0815 JE-21-0020-To reverse 82L Payroll of 8152020,D108,HJ,,31,58580.9
6150,8/15/2020,8/15/2020,82L-PRPD-081520,To reverse 82L payroll 0815 JE-21-0020-To reverse 82L Payroll of 8152020,D108,HJ,,31.93,58548.97
6150,8/15/2020,8/15/2020,82L-PRPD-081520,To reverse 82L payroll 0815 JE-21-0020-To reverse 82L Payroll of 8152020,D108,HJ,,32.63,58516.34
6150,8/15/2020,8/15/2020,82L-PRPD-081520,To reverse 82L payroll 0815 JE-21-0020-To reverse 82L Payroll of 8152020,D108,HJ,,33.23,58483.11
6150,8/15/2020,8/15/2020,82L-PRPD-081520,To reverse 82L payroll 0815 JE-21-0020-To reverse 82L Payroll of 8152020,D108,HJ,,33.96,58449.15
6150,8/15/2020,8/15/2020,82L-PRPD-081520,To reverse 82L payroll 0815 JE-21-0020-To reverse 82L Payroll of 8152020,D108,HJ,,34.79,58414.36
6150,8/15/2020,8/15/2020,82L-PRPD-081520,To reverse 82L payroll 0815 JE-21-0020-To reverse 82L Payroll of 8152020,D108,HJ,,35.1,58379.26
6150,8/15/2020,8/15/2020,82L-PRPD-081520,To reverse 82L payroll 0815 JE-21-0020-To reverse 82L Payroll of 8152020,D108,HJ,,37.83,58341.43
6150,8/15/2020,8/15/2020,82L-PRPD-081520,To reverse 82L payroll 0815 JE-21-0020-To reverse 82L Payroll of 8152020,D108,HJ,,39.86,58301.57
6150,8/15/2020,8/15/2020,82L-PRPD-081520,To reverse 82L payroll 0815 JE-21-0020-To reverse 82L Payroll of 8152020,D108,HJ,,41.91,58259.66
6150,8/15/2020,8/15/2020,82L-PRPD-081520,To reverse 82L payroll 0815 JE-21-0020-To reverse 82L Payroll of 8152020,D108,HJ,,47.73,58211.93
6150,8/15/2020,8/15/2020,82L-PRPD-081520,To reverse 82L payroll 0815 JE-21-0020-To reverse 82L Payroll of 8152020,D108,HJ,,55.28,58156.65
6150,8/15/2020,8/15/2020,82L-PRPD-081520,To reverse 82L payroll 0815 JE-21-0020-To reverse 82L Payroll of 8152020,D108,HJ,,130.16,58026.49
6150,8/15/2020,8/15/2020,82L-PRPD-081520,To reverse 82L payroll 0815 JE-21-0020-To reverse 82L Payroll of 8152020,D108,HJ,,130.69,57895.8
6150,8/15/2020,8/15/2020,82L-PRPD-081520,To reverse 82L payroll 0815 JE-21-0020-To reverse 82L Payroll of 8152020,D108,HJ,,132.56,57763.24
6150,8/15/2020,8/15/2020,82L-PRPD-081520,To reverse 82L payroll 0815 JE-21-0020-To reverse 82L Payroll of 8152020,D108,HJ,,136.53,57626.71
6150,8/15/2020,8/15/2020,82L-PRPD-081520,To reverse 82L payroll 0815 JE-21-0020-To reverse 82L Payroll of 8152020,D108,HJ,,139.5,57487.21
6150,8/15/2020,8/15/2020,82L-PRPD-081520,To reverse 82L payroll 0815 JE-21-0020-To reverse 82L Payroll of 8152020,D108,HJ,,142.08,57345.13
6150,8/15/2020,8/15/2020,82L-PRPD-081520,To reverse 82L payroll 0815 JE-21-0020-To reverse 82L Payroll of 8152020,D108,HJ,,145.23,57199.9
6150,8/15/2020,8/15/2020,82L-PRPD-081520,To reverse 82L payroll 0815 JE-21-0020-To reverse 82L Payroll of 8152020,D108,HJ,,148.76,57051.14
6150,8/15/2020,8/15/2020,82L-PRPD-081520,To reverse 82L payroll 0815 JE-21-0020-To reverse 82L Payroll of 8152020,D108,HJ,,150.1,56901.04
6150,8/15/2020,8/15/2020,82L-PRPD-081520,To reverse 82L payroll 0815 JE-21-0020-To reverse 82L Payroll of 8152020,D108,HJ,,161.75,56739.29
6150,8/15/2020,8/15/2020,82L-PRPD-081520,To reverse 82L payroll 0815 JE-21-0020-To reverse 82L Payroll of 8152020,D108,HJ,,170.44,56568.85
6150,8/15/2020,8/15/2020,82L-PRPD-081520,To reverse 82L payroll 0815 JE-21-0020-To reverse 82L Payroll of 8152020,D108,HJ,,179.22,56389.63
6150,8/15/2020,8/15/2020,82L-PRPD-081520,To reverse 82L payroll 0815 JE-21-0020-To reverse 82L Payroll of 8152020,D108,HJ,,204.08,56185.55
6150,8/15/2020,8/15/2020,82L-PRPD-081520,To reverse 82L payroll 0815 JE-21-0020-To reverse 82L Payroll of 8152020,D108,HJ,,236.38,55949.17
6150,8/15/2020,8/15/2020,82L-PRPD-081520,To reverse 82L payroll 0815 JE-21-0020-To reverse 82L Payroll of 8152020,D111,HJ,,38.45,55910.72
6150,8/15/2020,8/15/2020,82L-PRPD-081520,To reverse 82L payroll 0815 JE-21-0020-To reverse 82L Payroll of 8152020,D111,HJ,,164.42,55746.3
6150,8/15/2020,8/15/2020,82L-PRPD-081520,To reverse 82L payroll 0815 JE-21-0020-To reverse 82L Payroll of 8152020,D108,HJ,,19.38,55726.92
6150,8/15/2020,8/15/2020,82L-PRPD-081520,To reverse 82L payroll 0815 JE-21-0020-To reverse 82L Payroll of 8152020,D108,HJ,,23.64,55703.28
6150,8/15/2020,8/15/2020,82L-PRPD-081520,To reverse 82L payroll 0815 JE-21-0020-To reverse 82L Payroll of 8152020,D108,HJ,,37.75,55665.53
6150,8/15/2020,8/15/2020,82L-PRPD-081520,To reverse 82L payroll 0815 JE-21-0020-To reverse 82L Payroll of 8152020,D108,HJ,,38.07,55627.46
6150,8/15/2020,8/15/2020,82L-PRPD-081520,To reverse 82L payroll 0815 JE-21-0020-To reverse 82L Payroll of 8152020,D108,HJ,,38.67,55588.79
6150,8/15/2020,8/15/2020,82L-PRPD-081520,To reverse 82L payroll 0815 JE-21-0020-To reverse 82L Payroll of 8152020,D108,HJ,,42.91,55545.88
6150,8/15/2020,8/15/2020,82L-PRPD-081520,To reverse 82L payroll 0815 JE-21-0020-To reverse 82L Payroll of 8152020,D108,HJ,,53.2,55492.68
6150,8/15/2020,8/15/2020,82L-PRPD-081520,To reverse 82L payroll 0815 JE-21-0020-To reverse 82L Payroll of 8152020,D108,HJ,,58.33,55434.35
6150,8/15/2020,8/15/2020,82L-PRPD-081520,To reverse 82L payroll 0815 JE-21-0020-To reverse 82L Payroll of 8152020,D108,HJ,,161.4,55272.95
6150,8/15/2020,8/15/2020,82L-PRPD-081520,To reverse 82L payroll 0815 JE-21-0020-To reverse 82L Payroll of 8152020,D108,HJ,,162.79,55110.16
6150,8/15/2020,8/15/2020,82L-PRPD-081520,To reverse 82L payroll 0815 JE-21-0020-To reverse 82L Payroll of 8152020,D108,HJ,,165.33,54944.83
6150,8/15/2020,8/15/2020,82L-PRPD-081520,To reverse 82L payroll 0815 JE-21-0020-To reverse 82L Payroll of 8152020,D108,HJ,,183.48,54761.35
6150,8/15/2020,8/15/2020,82L-PRPD-081520,To reverse 82L payroll 0815 JE-21-0020-To reverse 82L Payroll of 8152020,D108,HJ,,227.46,54533.89
6150,8/31/2020,8/31/2020,83120,82L-IMPORT PAYROLL-ALVAREZ-MORINE LISIS,D108,HJ,34.63,,54568.52
6150,8/31/2020,8/31/2020,83120,82L-IMPORT PAYROLL-ALVAREZ-MORINE LISIS,D108,HJ,61.18,,54629.7
6150,8/31/2020,8/31/2020,83120,82L-IMPORT PAYROLL-ALVAREZ-MORINE LISIS,D108,HJ,148.06,,54777.76
6150,8/31/2020,8/31/2020,83120,82L-IMPORT PAYROLL-ALWARDT CALEB,D108,HJ,15.19,,54792.95
6150,8/31/2020,8/31/2020,83120,82L-IMPORT PAYROLL-ALWARDT CALEB,D108,HJ,64.95,,54857.9
6150,8/31/2020,8/31/2020,83120,82L-IMPORT PAYROLL-BARTHELEMY RACHALIE,D108,HJ,14.01,,54871.91
6150,8/31/2020,8/31/2020,83120,82L-IMPORT PAYROLL-BARTHELEMY RACHALIE,D108,HJ,26.08,,54897.99
6150,8/31/2020,8/31/2020,83120,82L-IMPORT PAYROLL-BARTHELEMY RACHALIE,D108,HJ,59.89,,54957.88
6150,8/31/2020,8/31/2020,83120,82L-IMPORT PAYROLL-BASHAM WILLIAM EDWARD,D108,HJ,14.06,,54971.94
6150,8/31/2020,8/31/2020,83120,82L-IMPORT PAYROLL-BASHAM WILLIAM EDWARD,D108,HJ,60.11,,55032.05
6150,8/31/2020,8/31/2020,83120,82L-IMPORT PAYROLL-BOHLSEN GRACE,D108,HJ,15.19,,55047.24
6150,8/31/2020,8/31/2020,83120,82L-IMPORT PAYROLL-BOHLSEN GRACE,D108,HJ,64.95,,55112.19
6150,8/31/2020,8/31/2020,83120,82L-IMPORT PAYROLL-BORCHART SPENCER,D108,HJ,15.19,,55127.38
6150,8/31/2020,8/31/2020,83120,82L-IMPORT PAYROLL-BORCHART SPENCER,D108,HJ,44.27,,55171.65
6150,8/31/2020,8/31/2020,83120,82L-IMPORT PAYROLL-BORCHART SPENCER,D108,HJ,64.95,,55236.6
6150,8/31/2020,8/31/2020,83120,82L-IMPORT PAYROLL-BREEDLOVE JOHNDEE L,D108,HJ,14.98,,55251.58
6150,8/31/2020,8/31/2020,83120,82L-IMPORT PAYROLL-BREEDLOVE JOHNDEE L,D108,HJ,27.89,,55279.47
6150,8/31/2020,8/31/2020,83120,82L-IMPORT PAYROLL-BREEDLOVE JOHNDEE L,D108,HJ,64.03,,55343.5
6150,8/31/2020,8/31/2020,83120,82L-IMPORT PAYROLL-BROWN ISAAC,D108,HJ,14.01,,55357.51
6150,8/31/2020,8/31/2020,83120,82L-IMPORT PAYROLL-BROWN ISAAC,D108,HJ,20.14,,55377.65
6150,8/31/2020,8/31/2020,83120,82L-IMPORT PAYROLL-BROWN ISAAC,D108,HJ,59.89,,55437.54
6150,8/31/2020,8/31/2020,83120,82L-IMPORT PAYROLL-BURKE MARIAH,D108,HJ,15.19,,55452.73
6150,8/31/2020,8/31/2020,83120,82L-IMPORT PAYROLL-BURKE MARIAH,D108,HJ,64.95,,55517.68
6150,8/31/2020,8/31/2020,83120,82L-IMPORT PAYROLL-CASSADY JOSHUA LEWIS,D108,HJ,15.19,,55532.87
6150,8/31/2020,8/31/2020,83120,82L-IMPORT PAYROLL-CASSADY JOSHUA LEWIS,D108,HJ,28.29,,55561.16
6150,8/31/2020,8/31/2020,83120,82L-IMPORT PAYROLL-CASSADY JOSHUA LEWIS,D108,HJ,64.95,,55626.11
6150,8/31/2020,8/31/2020,83120,82L-IMPORT PAYROLL-CHAVOUS MILFORD,D108,HJ,15.19,,55641.3
6150,8/31/2020,8/31/2020,83120,82L-IMPORT PAYROLL-CHAVOUS MILFORD,D108,HJ,28.29,,55669.59
6150,8/31/2020,8/31/2020,83120,82L-IMPORT PAYROLL-CHAVOUS MILFORD,D108,HJ,64.95,,55734.54
6150,8/31/2020,8/31/2020,83120,82L-IMPORT PAYROLL-CHEN LING,D108,HJ,15.19,,55749.73
6150,8/31/2020,8/31/2020,83120,82L-IMPORT PAYROLL-CHEN LING,D108,HJ,64.95,,55814.68
6150,8/31/2020,8/31/2020,83120,82L-IMPORT PAYROLL-DARKO OLIVIA,D108,HJ,15.19,,55829.87
6150,8/31/2020,8/31/2020,83120,82L-IMPORT PAYROLL-DARKO OLIVIA,D108,HJ,64.95,,55894.82
6150,8/31/2020,8/31/2020,83120,82L-IMPORT PAYROLL-DAWSON JAMIL NAFAYE-BEYAH,D108,HJ,15.19,,55910.01
6150,8/31/2020,8/31/2020,83120,82L-IMPORT PAYROLL-DAWSON JAMIL NAFAYE-BEYAH,D108,HJ,64.95,,55974.96
6150,8/31/2020,8/31/2020,83120,82L-IMPORT PAYROLL-ESCAMILLA OLGA,D108,HJ,15.19,,55990.15
6150,8/31/2020,8/31/2020,83120,82L-IMPORT PAYROLL-ESCAMILLA OLGA,D108,HJ,64.95,,56055.1
6150,8/31/2020,8/31/2020,83120,82L-IMPORT PAYROLL-GARCIA SANTIAGO,D108,HJ,29.61,,56084.71
6150,8/31/2020,8/31/2020,83120,82L-IMPORT PAYROLL-GARCIA SANTIAGO,D108,HJ,55.13,,56139.84
6150,8/31/2020,8/31/2020,83120,82L-IMPORT PAYROLL-GARCIA SANTIAGO,D108,HJ,126.6,,56266.44
6150,8/31/2020,8/31/2020,83120,82L-IMPORT PAYROLL-GILES SHAYLA,D108,HJ,15.19,,56281.63
6150,8/31/2020,8/31/2020,83120,82L-IMPORT PAYROLL-GILES SHAYLA,D108,HJ,28.29,,56309.92
6150,8/31/2020,8/31/2020,83120,82L-IMPORT PAYROLL-GILES SHAYLA,D108,HJ,64.95,,56374.87
6150,8/31/2020,8/31/2020,83120,82L-IMPORT PAYROLL-JONES JORDAN,D108,HJ,15.19,,56390.06
6150,8/31/2020,8/31/2020,83120,82L-IMPORT PAYROLL-JONES JORDAN,D108,HJ,64.95,,56455.01
6150,8/31/2020,8/31/2020,83120,82L-IMPORT PAYROLL-KHAN HUDA,D108,HJ,14.25,,56469.26
6150,8/31/2020,8/31/2020,83120,82L-IMPORT PAYROLL-KHAN HUDA,D108,HJ,26.53,,56495.79
6150,8/31/2020,8/31/2020,83120,82L-IMPORT PAYROLL-KHAN HUDA,D108,HJ,60.92,,56556.71
6150,8/31/2020,8/31/2020,83120,82L-IMPORT PAYROLL-KLOHR TIMOTHY JORDAN,D108,HJ,29,,56585.71
6150,8/31/2020,8/31/2020,83120,82L-IMPORT PAYROLL-KLOHR TIMOTHY JORDAN,D108,HJ,54,,56639.71
6150,8/31/2020,8/31/2020,83120,82L-IMPORT PAYROLL-KLOHR TIMOTHY JORDAN,D108,HJ,124,,56763.71
6150,8/31/2020,8/31/2020,83120,82L-IMPORT PAYROLL-KOPSHEVER MELISSA,D108,HJ,38.29,,56802
6150,8/31/2020,8/31/2020,83120,82L-IMPORT PAYROLL-KOPSHEVER MELISSA,D108,HJ,163.74,,56965.74
6150,8/31/2020,8/31/2020,83120,82L-IMPORT PAYROLL-LI SEN YUAN,D108,HJ,14.05,,56979.79
6150,8/31/2020,8/31/2020,83120,82L-IMPORT PAYROLL-LI SEN YUAN,D108,HJ,26.16,,57005.95
6150,8/31/2020,8/31/2020,83120,82L-IMPORT PAYROLL-LI SEN YUAN,D108,HJ,60.07,,57066.02
6150,8/31/2020,8/31/2020,83120,82L-IMPORT PAYROLL-LIPSCOMB STEPHEN,D108,HJ,33.58,,57099.6
6150,8/31/2020,8/31/2020,83120,82L-IMPORT PAYROLL-LIPSCOMB STEPHEN,D108,HJ,62.53,,57162.13
6150,8/31/2020,8/31/2020,83120,82L-IMPORT PAYROLL-LIPSCOMB STEPHEN,D108,HJ,143.59,,57305.72
6150,8/31/2020,8/31/2020,83120,82L-IMPORT PAYROLL-MALLECK JESSICA R,D108,HJ,15.19,,57320.91
6150,8/31/2020,8/31/2020,83120,82L-IMPORT PAYROLL-MALLECK JESSICA R,D108,HJ,64.95,,57385.86
6150,8/31/2020,8/31/2020,83120,82L-IMPORT PAYROLL-MCLAUGHLIN MARA,D108,HJ,15.19,,57401.05
6150,8/31/2020,8/31/2020,83120,82L-IMPORT PAYROLL-MCLAUGHLIN MARA,D108,HJ,64.95,,57466
6150,8/31/2020,8/31/2020,83120,82L-IMPORT PAYROLL-MEJIA CARLOS MANUEL,D108,HJ,14.01,,57480.01
6150,8/31/2020,8/31/2020,83120,82L-IMPORT PAYROLL-MEJIA CARLOS MANUEL,D108,HJ,59.89,,57539.9
6150,8/31/2020,8/31/2020,83120,82L-IMPORT PAYROLL-MONROY-MEJIA JASON,D108,HJ,15.19,,57555.09
6150,8/31/2020,8/31/2020,83120,82L-IMPORT PAYROLL-MONROY-MEJIA JASON,D108,HJ,36.67,,57591.76
6150,8/31/2020,8/31/2020,83120,82L-IMPORT PAYROLL-MONROY-MEJIA JASON,D108,HJ,64.95,,57656.71
6150,8/31/2020,8/31/2020,83120,82L-IMPORT PAYROLL-O'FLYNN-PRUITT NATHAN COLYAR,D108,HJ,15.19,,57671.9
6150,8/31/2020,8/31/2020,83120,82L-IMPORT PAYROLL-O'FLYNN-PRUITT NATHAN COLYAR,D108,HJ,36.67,,57708.57
6150,8/31/2020,8/31/2020,83120,82L-IMPORT PAYROLL-O'FLYNN-PRUITT NATHAN COLYAR,D108,HJ,64.95,,57773.52
6150,8/31/2020,8/31/2020,83120,82L-IMPORT PAYROLL-PATTERSON STEVE,D108,HJ,15.19,,57788.71
6150,8/31/2020,8/31/2020,83120,82L-IMPORT PAYROLL-PATTERSON STEVE,D108,HJ,28.29,,57817
6150,8/31/2020,8/31/2020,83120,82L-IMPORT PAYROLL-PATTERSON STEVE,D108,HJ,64.95,,57881.95
6150,8/31/2020,8/31/2020,83120,82L-IMPORT PAYROLL-ROBBINS DEANNA,D108,HJ,17.01,,57898.96
6150,8/31/2020,8/31/2020,83120,82L-IMPORT PAYROLL-ROBBINS DEANNA,D108,HJ,31.67,,57930.63
6150,8/31/2020,8/31/2020,83120,82L-IMPORT PAYROLL-ROBBINS DEANNA,D108,HJ,72.73,,58003.36
6150,8/31/2020,8/31/2020,83120,82L-IMPORT PAYROLL-SCHMIESS RACHEL JOY,D108,HJ,30.38,,58033.74
6150,8/31/2020,8/31/2020,83120,82L-IMPORT PAYROLL-SCHMIESS RACHEL JOY,D108,HJ,129.9,,58163.64
6150,8/31/2020,8/31/2020,83120,82L-IMPORT PAYROLL-SCOTT KIRK DONOVAN,D108,HJ,14.05,,58177.69
6150,8/31/2020,8/31/2020,83120,82L-IMPORT PAYROLL-SCOTT KIRK DONOVAN,D108,HJ,26.16,,58203.85
6150,8/31/2020,8/31/2020,83120,82L-IMPORT PAYROLL-SCOTT KIRK DONOVAN,D108,HJ,60.07,,58263.92
6150,8/31/2020,8/31/2020,83120,82L-IMPORT PAYROLL-SILVER KELLY,D108,HJ,34.63,,58298.55
6150,8/31/2020,8/31/2020,83120,82L-IMPORT PAYROLL-SILVER KELLY,D108,HJ,64.48,,58363.03
6150,8/31/2020,8/31/2020,83120,82L-IMPORT PAYROLL-SILVER KELLY,D108,HJ,148.06,,58511.09
6150,8/31/2020,8/31/2020,83120,82L-IMPORT PAYROLL-SOLIMAN MARK,D108,HJ,15.19,,58526.28
6150,8/31/2020,8/31/2020,83120,82L-IMPORT PAYROLL-SOLIMAN MARK,D108,HJ,36.67,,58562.95
6150,8/31/2020,8/31/2020,83120,82L-IMPORT PAYROLL-SOLIMAN MARK,D108,HJ,64.95,,58627.9
6150,8/31/2020,8/31/2020,83120,82L-IMPORT PAYROLL-STROUD DAVID,D108,HJ,14.66,,58642.56
6150,8/31/2020,8/31/2020,83120,82L-IMPORT PAYROLL-STROUD DAVID,D108,HJ,62.68,,58705.24
6150,8/31/2020,8/31/2020,83120,82L-IMPORT PAYROLL-VALCIN SABRINA JEMIMAH,D108,HJ,14.25,,58719.49
6150,8/31/2020,8/31/2020,83120,82L-IMPORT PAYROLL-VALCIN SABRINA JEMIMAH,D108,HJ,26.53,,58746.02
6150,8/31/2020,8/31/2020,83120,82L-IMPORT PAYROLL-VALCIN SABRINA JEMIMAH,D108,HJ,60.92,,58806.94
6150,8/31/2020,8/31/2020,83120,82L-IMPORT PAYROLL-VALDES ERNEST L,D108,HJ,30.38,,58837.32
6150,8/31/2020,8/31/2020,83120,82L-IMPORT PAYROLL-VALDES ERNEST L,D108,HJ,73.33,,58910.65
6150,8/31/2020,8/31/2020,83120,82L-IMPORT PAYROLL-VALDES ERNEST L,D108,HJ,129.9,,59040.55
6150,8/31/2020,8/31/2020,83120,82L-IMPORT PAYROLL-WILLIAMS MACK ANTHONY,D108,HJ,15.02,,59055.57
6150,8/31/2020,8/31/2020,83120,82L-IMPORT PAYROLL-WILLIAMS MACK ANTHONY,D108,HJ,27.96,,59083.53
6150,8/31/2020,8/31/2020,83120,82L-IMPORT PAYROLL-WILLIAMS MACK ANTHONY,D108,HJ,64.21,,59147.74
6150,8/31/2020,8/31/2020,83120,82L-IMPORT PAYROLL-WILLIAMS MIL'YONTA,D108,HJ,15.19,,59162.93
6150,8/31/2020,8/31/2020,83120,82L-IMPORT PAYROLL-WILLIAMS MIL'YONTA,D108,HJ,64.95,,59227.88
6150,8/31/2020,8/31/2020,83120,82L-IMPORT PAYROLL-ANTHONY BETTY S,D108,HJ,41.85,,59269.73
6150,8/31/2020,8/31/2020,83120,82L-IMPORT PAYROLL-ANTHONY BETTY S,D108,HJ,178.96,,59448.69
6150,8/31/2020,8/31/2020,83120,82L-IMPORT PAYROLL-AUSTIN PERCY,D108,HJ,36.34,,59485.03
6150,8/31/2020,8/31/2020,83120,82L-IMPORT PAYROLL-AUSTIN PERCY,D108,HJ,155.39,,59640.42
6150,8/31/2020,8/31/2020,83120,82L-IMPORT PAYROLL-BAUSH DANIEL,D108,HJ,45.22,,59685.64
6150,8/31/2020,8/31/2020,83120,82L-IMPORT PAYROLL-BAUSH DANIEL,D108,HJ,193.36,,59879
6150,8/31/2020,8/31/2020,83120,82L-IMPORT PAYROLL-CHAPMAN CLAUDY EARL,D108,HJ,26.38,,59905.38
6150,8/31/2020,8/31/2020,83120,82L-IMPORT PAYROLL-CHAPMAN CLAUDY EARL,D108,HJ,112.81,,60018.19
6150,8/31/2020,8/31/2020,83120,82L-IMPORT PAYROLL-DADA ARIKPO E,D108,HJ,39.29,,60057.48
6150,8/31/2020,8/31/2020,83120,82L-IMPORT PAYROLL-DADA ARIKPO E,D108,HJ,168,,60225.48
6150,8/31/2020,8/31/2020,83120,82L-IMPORT PAYROLL-GUTHRIE LESLIE,D108,HJ,33.42,,60258.9
6150,8/31/2020,8/31/2020,83120,82L-IMPORT PAYROLL-GUTHRIE LESLIE,D108,HJ,142.9,,60401.8
6150,8/31/2020,8/31/2020,83120,82L-IMPORT PAYROLL-HOLMES JOREL ALEXANDER,D108,HJ,31.22,,60433.02
6150,8/31/2020,8/31/2020,83120,82L-IMPORT PAYROLL-HOLMES JOREL ALEXANDER,D108,HJ,133.51,,60566.53
6150,8/31/2020,8/31/2020,83120,82L-IMPORT PAYROLL-JORDAN TIFFANY T,D108,HJ,45.87,,60612.4
6150,8/31/2020,8/31/2020,83120,82L-IMPORT PAYROLL-JORDAN TIFFANY T,D108,HJ,196.13,,60808.53
6150,8/31/2020,8/31/2020,83120,82L-IMPORT PAYROLL-LANIGAN LISA A,D108,HJ,45.1,,60853.63
6150,8/31/2020,8/31/2020,83120,82L-IMPORT PAYROLL-LANIGAN LISA A,D108,HJ,192.83,,61046.46
6150,8/31/2020,8/31/2020,83120,82L-IMPORT PAYROLL-MCELWEE MELISSA,D108,HJ,38.67,,61085.13
6150,8/31/2020,8/31/2020,83120,82L-IMPORT PAYROLL-MCELWEE MELISSA,D108,HJ,165.33,,61250.46
6150,8/31/2020,8/31/2020,83120,82L-IMPORT PAYROLL-MCNICHOLAS MARY,D108,HJ,33.23,,61283.69
6150,8/31/2020,8/31/2020,83120,82L-IMPORT PAYROLL-MCNICHOLAS MARY,D108,HJ,142.08,,61425.77
6150,8/31/2020,8/31/2020,83120,82L-IMPORT PAYROLL-NWAKANMA NANCY,D108,HJ,49.57,,61475.34
6150,8/31/2020,8/31/2020,83120,82L-IMPORT PAYROLL-NWAKANMA NANCY,D108,HJ,211.94,,61687.28
6150,8/31/2020,8/31/2020,83120,82L-IMPORT PAYROLL-ONICA ANTHONY J,D108,HJ,32.86,,61720.14
6150,8/31/2020,8/31/2020,83120,82L-IMPORT PAYROLL-ONICA ANTHONY J,D108,HJ,140.49,,61860.63
6150,8/31/2020,8/31/2020,83120,82L-IMPORT PAYROLL-PRAHIN NICOLE M,D108,HJ,52.91,,61913.54
6150,8/31/2020,8/31/2020,83120,82L-IMPORT PAYROLL-PRAHIN NICOLE M,D108,HJ,226.22,,62139.76
6150,8/31/2020,8/31/2020,83120,82L-IMPORT PAYROLL-RIVERS QUIONNA DIANE,D108,HJ,43.71,,62183.47
6150,8/31/2020,8/31/2020,83120,82L-IMPORT PAYROLL-RIVERS QUIONNA DIANE,D108,HJ,186.89,,62370.36
6150,8/31/2020,8/31/2020,83120,82L-IMPORT PAYROLL-SALIM YASSER,D108,HJ,33.1,,62403.46
6150,8/31/2020,8/31/2020,83120,82L-IMPORT PAYROLL-SALIM YASSER,D108,HJ,141.55,,62545.01
6150,8/31/2020,8/31/2020,83120,82L-IMPORT PAYROLL-SEJOUR MAHALIAH,D108,HJ,34.07,,62579.08
6150,8/31/2020,8/31/2020,83120,82L-IMPORT PAYROLL-SEJOUR MAHALIAH,D108,HJ,145.66,,62724.74
6150,8/31/2020,8/31/2020,83120,82L-IMPORT PAYROLL-SKALSKI CHRISTOPHER,D108,HJ,33.86,,62758.6
6150,8/31/2020,8/31/2020,83120,82L-IMPORT PAYROLL-SKALSKI CHRISTOPHER,D108,HJ,144.76,,62903.36
6150,8/31/2020,8/31/2020,83120,82L-IMPORT PAYROLL-TUMENJARGAL ENKHJIN,D108,HJ,32.92,,62936.28
6150,8/31/2020,8/31/2020,83120,82L-IMPORT PAYROLL-TUMENJARGAL ENKHJIN,D108,HJ,140.75,,63077.03
6150,8/31/2020,8/31/2020,83120,82L-IMPORT PAYROLL-VILLEGAS EVELYN,D108,HJ,40.65,,63117.68
6150,8/31/2020,8/31/2020,83120,82L-IMPORT PAYROLL-VILLEGAS EVELYN,D108,HJ,173.81,,63291.49
6150,8/31/2020,8/31/2020,83120,82L-IMPORT PAYROLL-WOLF ANNA A,D108,HJ,36.3,,63327.79
6150,8/31/2020,8/31/2020,83120,82L-IMPORT PAYROLL-WOLF ANNA A,D108,HJ,155.19,,63482.98
6150,8/31/2020,8/31/2020,83120,82L-IMPORT PAYROLL-ACEVEDO MONIVETT,D107,HJ,72.42,,63555.4
6150,8/31/2020,8/31/2020,83120,82L-IMPORT PAYROLL-ACEVEDO MONIVETT,D107,HJ,309.64,,63865.04
6150,8/31/2020,8/31/2020,83120,82L-IMPORT PAYROLL-AKLESTAD ISABEL,D111,HJ,23.29,,63888.33
6150,8/31/2020,8/31/2020,83120,82L-IMPORT PAYROLL-AKLESTAD ISABEL,D111,HJ,99.58,,63987.91
6150,8/31/2020,8/31/2020,83120,82L-IMPORT PAYROLL-ALLEN KIMBERLY MARY,D111,HJ,26.58,,64014.49
6150,8/31/2020,8/31/2020,83120,82L-IMPORT PAYROLL-ALLEN KIMBERLY MARY,D111,HJ,113.67,,64128.16
6150,8/31/2020,8/31/2020,83120,82L-IMPORT PAYROLL-BOWMAN HALLEY K,D101,HJ,49.84,,64178
6150,8/31/2020,8/31/2020,83120,82L-IMPORT PAYROLL-BOWMAN HALLEY K,D101,HJ,213.13,,64391.13
6150,8/31/2020,8/31/2020,83120,82L-IMPORT PAYROLL-COOK CATHRYN ANNA,D105,HJ,49.87,,64441
6150,8/31/2020,8/31/2020,83120,82L-IMPORT PAYROLL-COOK CATHRYN ANNA,D105,HJ,213.25,,64654.25
6150,8/31/2020,8/31/2020,83120,82L-IMPORT PAYROLL-COOPER ASHLEE R,D101,HJ,33.51,,64687.76
6150,8/31/2020,8/31/2020,83120,82L-IMPORT PAYROLL-COOPER ASHLEE R,D101,HJ,143.3,,64831.06
6150,8/31/2020,8/31/2020,83120,82L-IMPORT PAYROLL-CORTEZ MIRANDA A,D111,HJ,38.45,,64869.51
6150,8/31/2020,8/31/2020,83120,82L-IMPORT PAYROLL-CORTEZ MIRANDA A,D111,HJ,164.42,,65033.93
6150,8/31/2020,8/31/2020,83120,82L-IMPORT PAYROLL-DAUGHERTY DEVIN W,D101,HJ,15.1,,65049.03
6150,8/31/2020,8/31/2020,83120,82L-IMPORT PAYROLL-DAUGHERTY DEVIN W,D101,HJ,64.58,,65113.61
6150,8/31/2020,8/31/2020,83120,82L-IMPORT PAYROLL-DETONE KYRA MAYA,D102,HJ,39,,65152.61
6150,8/31/2020,8/31/2020,83120,82L-IMPORT PAYROLL-DETONE KYRA MAYA,D102,HJ,166.75,,65319.36
6150,8/31/2020,8/31/2020,83120,82L-IMPORT PAYROLL-DUPUIS CHRISTOPHER M,D107,HJ,37.27,,65356.63
6150,8/31/2020,8/31/2020,83120,82L-IMPORT PAYROLL-DUPUIS CHRISTOPHER M,D107,HJ,51.47,,65408.1
6150,8/31/2020,8/31/2020,83120,82L-IMPORT PAYROLL-DUPUIS CHRISTOPHER M,D107,HJ,159.37,,65567.47
6150,8/31/2020,8/31/2020,83120,82L-IMPORT PAYROLL-DUPUIS CHRISTOPHER M,D107,HJ,220.08,,65787.55
6150,8/31/2020,8/31/2020,83120,82L-IMPORT PAYROLL-DZIEDZIC JULIE K,D101,HJ,17.71,,65805.26
6150,8/31/2020,8/31/2020,83120,82L-IMPORT PAYROLL-DZIEDZIC JULIE K,D101,HJ,75.71,,65880.97
6150,8/31/2020,8/31/2020,83120,82L-IMPORT PAYROLL-GORNSTEIN STEVEN,D101,HJ,39.27,,65920.24
6150,8/31/2020,8/31/2020,83120,82L-IMPORT PAYROLL-GORNSTEIN STEVEN,D101,HJ,114.45,,66034.69
6150,8/31/2020,8/31/2020,83120,82L-IMPORT PAYROLL-GORNSTEIN STEVEN,D101,HJ,167.92,,66202.61
6150,8/31/2020,8/31/2020,83120,82L-IMPORT PAYROLL-GRAVES KAMIESHIA,D101,HJ,26.3,,66228.91
6150,8/31/2020,8/31/2020,83120,82L-IMPORT PAYROLL-GRAVES KAMIESHIA,D101,HJ,112.45,,66341.36
6150,8/31/2020,8/31/2020,83120,82L-IMPORT PAYROLL-GUADARRAMA-ALVAREZ URIEL A,D105,HJ,39.93,,66381.29
6150,8/31/2020,8/31/2020,83120,82L-IMPORT PAYROLL-GUADARRAMA-ALVAREZ URIEL A,D105,HJ,170.75,,66552.04
6150,8/31/2020,8/31/2020,83120,82L-IMPORT PAYROLL-GUTIERREZ ANTONIO J,D107,HJ,74.25,,66626.29
6150,8/31/2020,8/31/2020,83120,82L-IMPORT PAYROLL-GUTIERREZ ANTONIO J,D107,HJ,317.48,,66943.77
6150,8/31/2020,8/31/2020,83120,82L-IMPORT PAYROLL-HENRY GILLIAN,D102,HJ,6.97,,66950.74
6150,8/31/2020,8/31/2020,83120,82L-IMPORT PAYROLL-HENRY GILLIAN,D102,HJ,16.83,,66967.57
6150,8/31/2020,8/31/2020,83120,82L-IMPORT PAYROLL-HENRY GILLIAN,D102,HJ,29.81,,66997.38
6150,8/31/2020,8/31/2020,83120,82L-IMPORT PAYROLL-HESTER TYLER CONRAD,D105,HJ,27.79,,67025.17
6150,8/31/2020,8/31/2020,83120,82L-IMPORT PAYROLL-HESTER TYLER CONRAD,D105,HJ,118.83,,67144
6150,8/31/2020,8/31/2020,83120,82L-IMPORT PAYROLL-LACEY DEQUITA,D107,HJ,35.7,,67179.7
6150,8/31/2020,8/31/2020,83120,82L-IMPORT PAYROLL-LACEY DEQUITA,D107,HJ,152.64,,67332.34
6150,8/31/2020,8/31/2020,83120,82L-IMPORT PAYROLL-LIPORACE HERNAN LUIS,D103,HJ,20.53,,67352.87
6150,8/31/2020,8/31/2020,83120,82L-IMPORT PAYROLL-LIPORACE HERNAN LUIS,D103,HJ,33.06,,67385.93
6150,8/31/2020,8/31/2020,83120,82L-IMPORT PAYROLL-LIPORACE HERNAN LUIS,D103,HJ,141.34,,67527.27
6150,8/31/2020,8/31/2020,83120,82L-IMPORT PAYROLL-MASON ANGELA,D107,HJ,78.57,,67605.84
6150,8/31/2020,8/31/2020,83120,82L-IMPORT PAYROLL-MASON ANGELA,D107,HJ,335.97,,67941.81
6150,8/31/2020,8/31/2020,83120,82L-IMPORT PAYROLL-ODONNELL STEPHEN,D104,HJ,39.26,,67981.07
6150,8/31/2020,8/31/2020,83120,82L-IMPORT PAYROLL-ODONNELL STEPHEN,D104,HJ,167.87,,68148.94
6150,8/31/2020,8/31/2020,83120,82L-IMPORT PAYROLL-PARETS MALLORY GRACE,D101,HJ,17.57,,68166.51
6150,8/31/2020,8/31/2020,83120,82L-IMPORT PAYROLL-PARETS MALLORY GRACE,D101,HJ,41.08,,68207.59
6150,8/31/2020,8/31/2020,83120,82L-IMPORT PAYROLL-PARETS MALLORY GRACE,D101,HJ,75.88,,68283.47
6150,8/31/2020,8/31/2020,83120,82L-IMPORT PAYROLL-PARETS MALLORY GRACE,D101,HJ,175.67,,68459.14
6150,8/31/2020,8/31/2020,83120,82L-IMPORT PAYROLL-PARHAM-GANTT DENISE M,D112,HJ,37.96,,68497.1
6150,8/31/2020,8/31/2020,83120,82L-IMPORT PAYROLL-PARHAM-GANTT DENISE M,D112,HJ,162.32,,68659.42
6150,8/31/2020,8/31/2020,83120,82L-IMPORT PAYROLL-PEINADO ELIZABETH R,D111,HJ,52.29,,68711.71
6150,8/31/2020,8/31/2020,83120,82L-IMPORT PAYROLL-PEINADO ELIZABETH R,D111,HJ,223.58,,68935.29
6150,8/31/2020,8/31/2020,83120,82L-IMPORT PAYROLL-POLANCO ODALIS,D103,HJ,43.23,,68978.52
6150,8/31/2020,8/31/2020,83120,82L-IMPORT PAYROLL-POLANCO ODALIS,D103,HJ,184.83,,69163.35
6150,8/31/2020,8/31/2020,83120,82L-IMPORT PAYROLL-QUINTAS JASHIVE,D105,HJ,25.57,,69188.92
6150,8/31/2020,8/31/2020,83120,82L-IMPORT PAYROLL-QUINTAS JASHIVE,D105,HJ,109.31,,69298.23
6150,8/31/2020,8/31/2020,83120,82L-IMPORT PAYROLL-RANDOLPH ALEXANDER,D111,HJ,11.63,,69309.86
6150,8/31/2020,8/31/2020,83120,82L-IMPORT PAYROLL-RANDOLPH ALEXANDER,D111,HJ,25.1,,69334.96
6150,8/31/2020,8/31/2020,83120,82L-IMPORT PAYROLL-RANDOLPH ALEXANDER,D111,HJ,50.63,,69385.59
6150,8/31/2020,8/31/2020,83120,82L-IMPORT PAYROLL-RANDOLPH ALEXANDER,D111,HJ,107.33,,69492.92
6150,8/31/2020,8/31/2020,83120,82L-IMPORT PAYROLL-SAFRAN ALAN P,D107,HJ,8.68,,69501.6
6150,8/31/2020,8/31/2020,83120,82L-IMPORT PAYROLL-SAFRAN ALAN P,D107,HJ,37.08,,69538.68
6150,8/31/2020,8/31/2020,83120,82L-IMPORT PAYROLL-SAFRAN ALAN P,D107,HJ,99.75,,69638.43
6150,8/31/2020,8/31/2020,83120,82L-IMPORT PAYROLL-SAFRAN ALAN P,D107,HJ,426.54,,70064.97
6150,8/31/2020,8/31/2020,83120,82L-IMPORT PAYROLL-SHENKMAN OLIVIA,D101,HJ,29,,70093.97
6150,8/31/2020,8/31/2020,83120,82L-IMPORT PAYROLL-SHENKMAN OLIVIA,D101,HJ,124,,70217.97
6150,8/31/2020,8/31/2020,83120,82L-IMPORT PAYROLL-SHI GRACE,D103,HJ,12.69,,70230.66
6150,8/31/2020,8/31/2020,83120,82L-IMPORT PAYROLL-SHI GRACE,D103,HJ,36.98,,70267.64
6150,8/31/2020,8/31/2020,83120,82L-IMPORT PAYROLL-SHI GRACE,D103,HJ,54.25,,70321.89
6150,8/31/2020,8/31/2020,83120,82L-IMPORT PAYROLL-WALLACE AMENA,D104,HJ,28.93,,70350.82
6150,8/31/2020,8/31/2020,83120,82L-IMPORT PAYROLL-WALLACE AMENA,D104,HJ,123.72,,70474.54
6150,8/31/2020,8/31/2020,83120,82L-IMPORT PAYROLL-WEINSTOCK EMILY,D101,HJ,13.5,,70488.04
6150,8/31/2020,8/31/2020,83120,82L-IMPORT PAYROLL-WEINSTOCK EMILY,D101,HJ,17.57,,70505.61
6150,8/31/2020,8/31/2020,83120,82L-IMPORT PAYROLL-WEINSTOCK EMILY,D101,HJ,38.11,,70543.72
6150,8/31/2020,8/31/2020,83120,82L-IMPORT PAYROLL-WEINSTOCK EMILY,D101,HJ,162.94,,70706.66
6150,8/31/2020,8/31/2020,83120,82L-IMPORT PAYROLL-WINANS JENNIFER,D111,HJ,36.33,,70742.99
6150,8/31/2020,8/31/2020,83120,82L-IMPORT PAYROLL-WINANS JENNIFER,D111,HJ,155.35,,70898.34
6150,8/31/2020,8/31/2020,83120,82L-IMPORT PAYROLL-ZARATE JOSEPH M,D105,HJ,31.18,,70929.52
6150,8/31/2020,8/31/2020,83120,82L-IMPORT PAYROLL-ZARATE JOSEPH M,D105,HJ,133.3,,71062.82
6150,8/31/2020,8/31/2020,83120,82L-IMPORT PAYROLL-AGUANNO JOSEPH,D108,HJ,16.23,,71079.05
6150,8/31/2020,8/31/2020,83120,82L-IMPORT PAYROLL-AGUANNO JOSEPH,D108,HJ,69.38,,71148.43
6150,8/31/2020,8/31/2020,83120,82L-IMPORT PAYROLL-AKESODE FEHINTOLA,D108,HJ,16.23,,71164.66
6150,8/31/2020,8/31/2020,83120,82L-IMPORT PAYROLL-AKESODE FEHINTOLA,D108,HJ,69.38,,71234.04
6150,8/31/2020,8/31/2020,83120,82L-IMPORT PAYROLL-ARCHER AUBREYNA,D108,HJ,11.03,,71245.07
6150,8/31/2020,8/31/2020,83120,82L-IMPORT PAYROLL-ARCHER AUBREYNA,D108,HJ,47.15,,71292.22
6150,8/31/2020,8/31/2020,83120,82L-IMPORT PAYROLL-BARTOLD DEANNA MARIE,D108,HJ,41.91,,71334.13
6150,8/31/2020,8/31/2020,83120,82L-IMPORT PAYROLL-BARTOLD DEANNA MARIE,D108,HJ,179.22,,71513.35
6150,8/31/2020,8/31/2020,83120,82L-IMPORT PAYROLL-BELLOT GENESIS,D108,HJ,31.93,,71545.28
6150,8/31/2020,8/31/2020,83120,82L-IMPORT PAYROLL-BELLOT GENESIS,D108,HJ,136.53,,71681.81
6150,8/31/2020,8/31/2020,83120,82L-IMPORT PAYROLL-BENNETT JAMES H,D108,HJ,16.23,,71698.04
6150,8/31/2020,8/31/2020,83120,82L-IMPORT PAYROLL-BENNETT JAMES H,D108,HJ,69.38,,71767.42
6150,8/31/2020,8/31/2020,83120,82L-IMPORT PAYROLL-BURRELL RUSSELL,D108,HJ,16.23,,71783.65
6150,8/31/2020,8/31/2020,83120,82L-IMPORT PAYROLL-BURRELL RUSSELL,D108,HJ,69.38,,71853.03
6150,8/31/2020,8/31/2020,83120,82L-IMPORT PAYROLL-CHUI KENT,D108,HJ,16.23,,71869.26
6150,8/31/2020,8/31/2020,83120,82L-IMPORT PAYROLL-CHUI KENT,D108,HJ,69.38,,71938.64
6150,8/31/2020,8/31/2020,83120,82L-IMPORT PAYROLL-CIRKER MIA,D108,HJ,32.63,,71971.27
6150,8/31/2020,8/31/2020,83120,82L-IMPORT PAYROLL-CIRKER MIA,D108,HJ,139.5,,72110.77
6150,8/31/2020,8/31/2020,83120,82L-IMPORT PAYROLL-COUGHLIN ABIGAIL,D108,HJ,16.23,,72127
6150,8/31/2020,8/31/2020,83120,82L-IMPORT PAYROLL-COUGHLIN ABIGAIL,D108,HJ,69.38,,72196.38
6150,8/31/2020,8/31/2020,83120,82L-IMPORT PAYROLL-DEFREITAS NOEL,D108,HJ,6.55,,72202.93
6150,8/31/2020,8/31/2020,83120,82L-IMPORT PAYROLL-DEFREITAS NOEL,D108,HJ,27.99,,72230.92
6150,8/31/2020,8/31/2020,83120,82L-IMPORT PAYROLL-DIETZ MARY,D108,HJ,16.23,,72247.15
6150,8/31/2020,8/31/2020,83120,82L-IMPORT PAYROLL-DIETZ MARY,D108,HJ,69.38,,72316.53
6150,8/31/2020,8/31/2020,83120,82L-IMPORT PAYROLL-DOMINIQUE PRINCESSA,D108,HJ,16.23,,72332.76
6150,8/31/2020,8/31/2020,83120,82L-IMPORT PAYROLL-DOMINIQUE PRINCESSA,D108,HJ,69.38,,72402.14
6150,8/31/2020,8/31/2020,83120,82L-IMPORT PAYROLL-DONNELLY HOME,D108,HJ,16.23,,72418.37
6150,8/31/2020,8/31/2020,83120,82L-IMPORT PAYROLL-DONNELLY HOME,D108,HJ,21.49,,72439.86
6150,8/31/2020,8/31/2020,83120,82L-IMPORT PAYROLL-DONNELLY HOME,D108,HJ,69.38,,72509.24
6150,8/31/2020,8/31/2020,83120,82L-IMPORT PAYROLL-FEIGHERY JOHN,D108,HJ,30.56,,72539.8
6150,8/31/2020,8/31/2020,83120,82L-IMPORT PAYROLL-FEIGHERY JOHN,D108,HJ,130.69,,72670.49
6150,8/31/2020,8/31/2020,83120,82L-IMPORT PAYROLL-GARCIA MARILYN,D108,HJ,33.23,,72703.72
6150,8/31/2020,8/31/2020,83120,82L-IMPORT PAYROLL-GARCIA MARILYN,D108,HJ,142.08,,72845.8
6150,8/31/2020,8/31/2020,83120,82L-IMPORT PAYROLL-GARNER IVORY,D108,HJ,23.66,,72869.46
6150,8/31/2020,8/31/2020,83120,82L-IMPORT PAYROLL-GARNER IVORY,D108,HJ,101.18,,72970.64
6150,8/31/2020,8/31/2020,83120,82L-IMPORT PAYROLL-GILL JULIA,D108,HJ,16.23,,72986.87
6150,8/31/2020,8/31/2020,83120,82L-IMPORT PAYROLL-GILL JULIA,D108,HJ,69.38,,73056.25
6150,8/31/2020,8/31/2020,83120,82L-IMPORT PAYROLL-GREENE BROOKE,D108,HJ,16.23,,73072.48
6150,8/31/2020,8/31/2020,83120,82L-IMPORT PAYROLL-GREENE BROOKE,D108,HJ,69.38,,73141.86
6150,8/31/2020,8/31/2020,83120,82L-IMPORT PAYROLL-GRIFFIN ANDREW,D108,HJ,30.44,,73172.3
6150,8/31/2020,8/31/2020,83120,82L-IMPORT PAYROLL-GRIFFIN ANDREW,D108,HJ,130.16,,73302.46
6150,8/31/2020,8/31/2020,83120,82L-IMPORT PAYROLL-GROSS EMILY,D108,HJ,14,,73316.46
6150,8/31/2020,8/31/2020,83120,82L-IMPORT PAYROLL-GROSS EMILY,D108,HJ,59.86,,73376.32
6150,8/31/2020,8/31/2020,83120,82L-IMPORT PAYROLL-GUERRERO LUIS,D108,HJ,16.23,,73392.55
6150,8/31/2020,8/31/2020,83120,82L-IMPORT PAYROLL-GUERRERO LUIS,D108,HJ,69.38,,73461.93
6150,8/31/2020,8/31/2020,83120,82L-IMPORT PAYROLL-HALLINAN GABRIEL B,D108,HJ,34.79,,73496.72
6150,8/31/2020,8/31/2020,83120,82L-IMPORT PAYROLL-HALLINAN GABRIEL B,D108,HJ,148.76,,73645.48
6150,8/31/2020,8/31/2020,83120,82L-IMPORT PAYROLL-HAMERSLY WILLIAM,D108,HJ,34.16,,73679.64
6150,8/31/2020,8/31/2020,83120,82L-IMPORT PAYROLL-HAMERSLY WILLIAM,D108,HJ,146.08,,73825.72
6150,8/31/2020,8/31/2020,83120,82L-IMPORT PAYROLL-HEYMANN DANIEL A,D108,HJ,16.23,,73841.95
6150,8/31/2020,8/31/2020,83120,82L-IMPORT PAYROLL-HEYMANN DANIEL A,D108,HJ,69.38,,73911.33
6150,8/31/2020,8/31/2020,83120,82L-IMPORT PAYROLL-HOLDER LATIVA M,D108,HJ,55.28,,73966.61
6150,8/31/2020,8/31/2020,83120,82L-IMPORT PAYROLL-HOLDER LATIVA M,D108,HJ,236.38,,74202.99
6150,8/31/2020,8/31/2020,83120,82L-IMPORT PAYROLL-HOSSAIN MYESHA R,D108,HJ,35.1,,74238.09
6150,8/31/2020,8/31/2020,83120,82L-IMPORT PAYROLL-HOSSAIN MYESHA R,D108,HJ,150.1,,74388.19
6150,8/31/2020,8/31/2020,83120,82L-IMPORT PAYROLL-JACKSON TASNIM F,D108,HJ,31,,74419.19
6150,8/31/2020,8/31/2020,83120,82L-IMPORT PAYROLL-JACKSON TASNIM F,D108,HJ,132.56,,74551.75
6150,8/31/2020,8/31/2020,83120,82L-IMPORT PAYROLL-KERKHOFF HARPER FAITH,D108,HJ,16.23,,74567.98
6150,8/31/2020,8/31/2020,83120,82L-IMPORT PAYROLL-KERKHOFF HARPER FAITH,D108,HJ,69.38,,74637.36
6150,8/31/2020,8/31/2020,83120,82L-IMPORT PAYROLL-LEARY AUBREY,D108,HJ,16.23,,74653.59
6150,8/31/2020,8/31/2020,83120,82L-IMPORT PAYROLL-LEARY AUBREY,D108,HJ,69.38,,74722.97
6150,8/31/2020,8/31/2020,83120,82L-IMPORT PAYROLL-LI BELLA,D108,HJ,33.96,,74756.93
6150,8/31/2020,8/31/2020,83120,82L-IMPORT PAYROLL-LI BELLA,D108,HJ,145.23,,74902.16
6150,8/31/2020,8/31/2020,83120,82L-IMPORT PAYROLL-LOUIE JORDAN,D108,HJ,16.23,,74918.39
6150,8/31/2020,8/31/2020,83120,82L-IMPORT PAYROLL-LOUIE JORDAN,D108,HJ,69.38,,74987.77
6150,8/31/2020,8/31/2020,83120,82L-IMPORT PAYROLL-MELCHOR OSBEIDY,D108,HJ,16.23,,75004
6150,8/31/2020,8/31/2020,83120,82L-IMPORT PAYROLL-MELCHOR OSBEIDY,D108,HJ,69.38,,75073.38
6150,8/31/2020,8/31/2020,83120,82L-IMPORT PAYROLL-MORRIS ZAKIYA,D108,HJ,16.23,,75089.61
6150,8/31/2020,8/31/2020,83120,82L-IMPORT PAYROLL-MORRIS ZAKIYA,D108,HJ,69.38,,75158.99
6150,8/31/2020,8/31/2020,83120,82L-IMPORT PAYROLL-MORSELETTO RAFAEL,D108,HJ,16.23,,75175.22
6150,8/31/2020,8/31/2020,83120,82L-IMPORT PAYROLL-MORSELETTO RAFAEL,D108,HJ,69.38,,75244.6
6150,8/31/2020,8/31/2020,83120,82L-IMPORT PAYROLL-OBI TOBECHUKWU,D108,HJ,16.23,,75260.83
6150,8/31/2020,8/31/2020,83120,82L-IMPORT PAYROLL-OBI TOBECHUKWU,D108,HJ,69.38,,75330.21
6150,8/31/2020,8/31/2020,83120,82L-IMPORT PAYROLL-OPUH NDIDI,D108,HJ,44.87,,75375.08
6150,8/31/2020,8/31/2020,83120,82L-IMPORT PAYROLL-OPUH NDIDI,D108,HJ,191.86,,75566.94
6150,8/31/2020,8/31/2020,83120,82L-IMPORT PAYROLL-PAULINO THAIRI,D108,HJ,16.23,,75583.17
6150,8/31/2020,8/31/2020,83120,82L-IMPORT PAYROLL-PAULINO THAIRI,D108,HJ,69.38,,75652.55
6150,8/31/2020,8/31/2020,83120,82L-IMPORT PAYROLL-RICE DELASIA,D108,HJ,4.49,,75657.04
6150,8/31/2020,8/31/2020,83120,82L-IMPORT PAYROLL-RICE DELASIA,D108,HJ,19.21,,75676.25
6150,8/31/2020,8/31/2020,83120,82L-IMPORT PAYROLL-ROSENBAUM MURRAY,D108,HJ,16.23,,75692.48
6150,8/31/2020,8/31/2020,83120,82L-IMPORT PAYROLL-ROSENBAUM MURRAY,D108,HJ,69.38,,75761.86
6150,8/31/2020,8/31/2020,83120,82L-IMPORT PAYROLL-SCHWETTMANN CLAIRE,D108,HJ,15.28,,75777.14
6150,8/31/2020,8/31/2020,83120,82L-IMPORT PAYROLL-SCHWETTMANN CLAIRE,D108,HJ,65.35,,75842.49
6150,8/31/2020,8/31/2020,83120,82L-IMPORT PAYROLL-SOBELMAN JUSTIN,D108,HJ,14.44,,75856.93
6150,8/31/2020,8/31/2020,83120,82L-IMPORT PAYROLL-SOBELMAN JUSTIN,D108,HJ,61.74,,75918.67
6150,8/31/2020,8/31/2020,83120,82L-IMPORT PAYROLL-TERRENCE-SMITH ZI,D108,HJ,14.32,,75932.99
6150,8/31/2020,8/31/2020,83120,82L-IMPORT PAYROLL-TERRENCE-SMITH ZI,D108,HJ,61.22,,75994.21
6150,8/31/2020,8/31/2020,83120,82L-IMPORT PAYROLL-TILLERY ASIA,D108,HJ,47.73,,76041.94
6150,8/31/2020,8/31/2020,83120,82L-IMPORT PAYROLL-TILLERY ASIA,D108,HJ,204.08,,76246.02
6150,8/31/2020,8/31/2020,83120,82L-IMPORT PAYROLL-WILLIAMS- MASSEY BRIANNA M,D108,HJ,16.23,,76262.25
6150,8/31/2020,8/31/2020,83120,82L-IMPORT PAYROLL-WILLIAMS- MASSEY BRIANNA M,D108,HJ,69.38,,76331.63
6150,8/31/2020,8/31/2020,83120,82L-IMPORT PAYROLL-XIAO CHENGYAO,D108,HJ,16.23,,76347.86
6150,8/31/2020,8/31/2020,83120,82L-IMPORT PAYROLL-XIAO CHENGYAO,D108,HJ,69.38,,76417.24
6150,8/31/2020,8/31/2020,83120,82L-IMPORT PAYROLL-ZIAUDDIN ABUTAHER M,D108,HJ,16.23,,76433.47
6150,8/31/2020,8/31/2020,83120,82L-IMPORT PAYROLL-ZIAUDDIN ABUTAHER M,D108,HJ,69.38,,76502.85
6150,8/31/2020,8/31/2020,83120,82L-IMPORT PAYROLL-BALASUBRAMANIAN SHARANYA,D108,HJ,38.67,,76541.52
6150,8/31/2020,8/31/2020,83120,82L-IMPORT PAYROLL-BALASUBRAMANIAN SHARANYA,D108,HJ,165.33,,76706.85
6150,8/31/2020,8/31/2020,83120,82L-IMPORT PAYROLL-COVENEY ALLISON,D108,HJ,38.07,,76744.92
6150,8/31/2020,8/31/2020,83120,82L-IMPORT PAYROLL-COVENEY ALLISON,D108,HJ,162.79,,76907.71
6150,8/31/2020,8/31/2020,83120,82L-IMPORT PAYROLL-JACKSON CLAICE M,D108,HJ,19.38,,76927.09
6150,8/31/2020,8/31/2020,83120,82L-IMPORT PAYROLL-JACKSON CLAICE M,D108,HJ,42.91,,76970
6150,8/31/2020,8/31/2020,83120,82L-IMPORT PAYROLL-JACKSON CLAICE M,D108,HJ,183.48,,77153.48
6150,8/31/2020,8/31/2020,83120,82L-IMPORT PAYROLL-JANG DANIEL,D108,HJ,37.75,,77191.23
6150,8/31/2020,8/31/2020,83120,82L-IMPORT PAYROLL-JANG DANIEL,D108,HJ,161.4,,77352.63
6150,8/31/2020,8/31/2020,83120,82L-IMPORT PAYROLL-LENEGHAN MARYELLEN,D108,HJ,14.36,,77366.99
6150,8/31/2020,8/31/2020,83120,82L-IMPORT PAYROLL-LENEGHAN MARYELLEN,D108,HJ,38.84,,77405.83
6150,8/31/2020,8/31/2020,83120,82L-IMPORT PAYROLL-LENEGHAN MARYELLEN,D108,HJ,61.4,,77467.23
6150,8/31/2020,8/31/2020,83120,82L-IMPORT PAYROLL-LENEGHAN MARYELLEN,D108,HJ,166.06,,77633.29
6150,8/31/2020,8/31/2020,82L-PRPD-083120,82L-PRPD-083120 -IMPORT PAYROLL-ALLEN KIMBERLY MARY,D108,HJ,26.58,,77659.87
6150,8/31/2020,8/31/2020,82L-PRPD-083120,82L-PRPD-083120 -IMPORT PAYROLL-ALLEN KIMBERLY MARY,D108,HJ,113.67,,77773.54
6150,8/31/2020,8/31/2020,82L-PRPD-083120,82L-PRPD-083120 -IMPORT PAYROLL-ANTHONY BETTY S,D108,HJ,41.85,,77815.39
6150,8/31/2020,8/31/2020,82L-PRPD-083120,82L-PRPD-083120 -IMPORT PAYROLL-ANTHONY BETTY S,D108,HJ,178.96,,77994.35
6150,8/31/2020,8/31/2020,82L-PRPD-083120,82L-PRPD-083120 -IMPORT PAYROLL-AUSTIN PERCY,D108,HJ,36.34,,78030.69
6150,8/31/2020,8/31/2020,82L-PRPD-083120,82L-PRPD-083120 -IMPORT PAYROLL-AUSTIN PERCY,D108,HJ,155.39,,78186.08
6150,8/31/2020,8/31/2020,82L-PRPD-083120,82L-PRPD-083120 -IMPORT PAYROLL-BAUSH DANIEL,D108,HJ,37.97,,78224.05
6150,8/31/2020,8/31/2020,82L-PRPD-083120,82L-PRPD-083120 -IMPORT PAYROLL-BAUSH DANIEL,D108,HJ,162.36,,78386.41
6150,8/31/2020,8/31/2020,82L-PRPD-083120,82L-PRPD-083120 -IMPORT PAYROLL-CHAPMAN CLAUDY EARL,D108,HJ,26.38,,78412.79
6150,8/31/2020,8/31/2020,82L-PRPD-083120,82L-PRPD-083120 -IMPORT PAYROLL-CHAPMAN CLAUDY EARL,D108,HJ,112.81,,78525.6
6150,8/31/2020,8/31/2020,82L-PRPD-083120,82L-PRPD-083120 -IMPORT PAYROLL-DADA ARIKPO E,D108,HJ,30.83,,78556.43
6150,8/31/2020,8/31/2020,82L-PRPD-083120,82L-PRPD-083120 -IMPORT PAYROLL-DADA ARIKPO E,D108,HJ,131.84,,78688.27
6150,8/31/2020,8/31/2020,82L-PRPD-083120,82L-PRPD-083120 -IMPORT PAYROLL-GUTHRIE LESLIE,D108,HJ,33.42,,78721.69
6150,8/31/2020,8/31/2020,82L-PRPD-083120,82L-PRPD-083120 -IMPORT PAYROLL-GUTHRIE LESLIE,D108,HJ,142.9,,78864.59
6150,8/31/2020,8/31/2020,82L-PRPD-083120,82L-PRPD-083120 -IMPORT PAYROLL-HOLMES JOREL ALEXANDER,D108,HJ,31.22,,78895.81
6150,8/31/2020,8/31/2020,82L-PRPD-083120,82L-PRPD-083120 -IMPORT PAYROLL-HOLMES JOREL ALEXANDER,D108,HJ,133.51,,79029.32
6150,8/31/2020,8/31/2020,82L-PRPD-083120,82L-PRPD-083120 -IMPORT PAYROLL-JORDAN TIFFANY T,D108,HJ,45.87,,79075.19
6150,8/31/2020,8/31/2020,82L-PRPD-083120,82L-PRPD-083120 -IMPORT PAYROLL-JORDAN TIFFANY T,D108,HJ,196.13,,79271.32
6150,8/31/2020,8/31/2020,82L-PRPD-083120,82L-PRPD-083120 -IMPORT PAYROLL-LANIGAN LISA A,D108,HJ,45.1,,79316.42
6150,8/31/2020,8/31/2020,82L-PRPD-083120,82L-PRPD-083120 -IMPORT PAYROLL-LANIGAN LISA A,D108,HJ,192.83,,79509.25
6150,8/31/2020,8/31/2020,82L-PRPD-083120,82L-PRPD-083120 -IMPORT PAYROLL-MCELWEE MELISSA,D108,HJ,38.67,,79547.92
6150,8/31/2020,8/31/2020,82L-PRPD-083120,82L-PRPD-083120 -IMPORT PAYROLL-MCELWEE MELISSA,D108,HJ,165.33,,79713.25
6150,8/31/2020,8/31/2020,82L-PRPD-083120,82L-PRPD-083120 -IMPORT PAYROLL-MCNICHOLAS MARY,D108,HJ,33.23,,79746.48
6150,8/31/2020,8/31/2020,82L-PRPD-083120,82L-PRPD-083120 -IMPORT PAYROLL-MCNICHOLAS MARY,D108,HJ,142.08,,79888.56
6150,8/31/2020,8/31/2020,82L-PRPD-083120,82L-PRPD-083120 -IMPORT PAYROLL-NWAKANMA NANCY,D108,HJ,42.32,,79930.88
6150,8/31/2020,8/31/2020,82L-PRPD-083120,82L-PRPD-083120 -IMPORT PAYROLL-NWAKANMA NANCY,D108,HJ,180.94,,80111.82
6150,8/31/2020,8/31/2020,82L-PRPD-083120,82L-PRPD-083120 -IMPORT PAYROLL-ONICA ANTHONY J,D108,HJ,31.33,,80143.15
6150,8/31/2020,8/31/2020,82L-PRPD-083120,82L-PRPD-083120 -IMPORT PAYROLL-ONICA ANTHONY J,D108,HJ,133.98,,80277.13
6150,8/31/2020,8/31/2020,82L-PRPD-083120,82L-PRPD-083120 -IMPORT PAYROLL-PRAHIN NICOLE M,D108,HJ,52.91,,80330.04
6150,8/31/2020,8/31/2020,82L-PRPD-083120,82L-PRPD-083120 -IMPORT PAYROLL-PRAHIN NICOLE M,D108,HJ,226.22,,80556.26
6150,8/31/2020,8/31/2020,82L-PRPD-083120,82L-PRPD-083120 -IMPORT PAYROLL-RIVERS QUIONNA DIANE,D108,HJ,36.46,,80592.72
6150,8/31/2020,8/31/2020,82L-PRPD-083120,82L-PRPD-083120 -IMPORT PAYROLL-RIVERS QUIONNA DIANE,D108,HJ,155.89,,80748.61
6150,8/31/2020,8/31/2020,82L-PRPD-083120,82L-PRPD-083120 -IMPORT PAYROLL-SALIM YASSER,D108,HJ,33.1,,80781.71
6150,8/31/2020,8/31/2020,82L-PRPD-083120,82L-PRPD-083120 -IMPORT PAYROLL-SALIM YASSER,D108,HJ,141.55,,80923.26
6150,8/31/2020,8/31/2020,82L-PRPD-083120,82L-PRPD-083120 -IMPORT PAYROLL-SEJOUR MAHALIAH,D108,HJ,34.07,,80957.33
6150,8/31/2020,8/31/2020,82L-PRPD-083120,82L-PRPD-083120 -IMPORT PAYROLL-SEJOUR MAHALIAH,D108,HJ,145.66,,81102.99
6150,8/31/2020,8/31/2020,82L-PRPD-083120,82L-PRPD-083120 -IMPORT PAYROLL-SKALSKI CHRISTOPHER,D108,HJ,33.86,,81136.85
6150,8/31/2020,8/31/2020,82L-PRPD-083120,82L-PRPD-083120 -IMPORT PAYROLL-SKALSKI CHRISTOPHER,D108,HJ,144.76,,81281.61
6150,8/31/2020,8/31/2020,82L-PRPD-083120,82L-PRPD-083120 -IMPORT PAYROLL-TAM CW RYAN,D105,HJ,0.94,,81282.55
6150,8/31/2020,8/31/2020,82L-PRPD-083120,82L-PRPD-083120 -IMPORT PAYROLL-TAM CW RYAN,D105,HJ,4.03,,81286.58
6150,8/31/2020,8/31/2020,82L-PRPD-083120,82L-PRPD-083120 -IMPORT PAYROLL-TUMENJARGAL ENKHJIN,D108,HJ,32.92,,81319.5
6150,8/31/2020,8/31/2020,82L-PRPD-083120,82L-PRPD-083120 -IMPORT PAYROLL-TUMENJARGAL ENKHJIN,D108,HJ,140.75,,81460.25
6150,8/31/2020,8/31/2020,82L-PRPD-083120,82L-PRPD-083120 -IMPORT PAYROLL-VILLEGAS EVELYN,D108,HJ,33.4,,81493.65
6150,8/31/2020,8/31/2020,82L-PRPD-083120,82L-PRPD-083120 -IMPORT PAYROLL-VILLEGAS EVELYN,D108,HJ,142.81,,81636.46
6150,8/31/2020,8/31/2020,82L-PRPD-083120,82L-PRPD-083120 -IMPORT PAYROLL-WALLACE AMENA T,D108,HJ,28.93,,81665.39
6150,8/31/2020,8/31/2020,82L-PRPD-083120,82L-PRPD-083120 -IMPORT PAYROLL-WALLACE AMENA T,D108,HJ,123.72,,81789.11
6150,8/31/2020,8/31/2020,82L-PRPD-083120,82L-PRPD-083120 -IMPORT PAYROLL-WINANS JENNIFER,D111,HJ,36.33,,81825.44
6150,8/31/2020,8/31/2020,82L-PRPD-083120,82L-PRPD-083120 -IMPORT PAYROLL-WINANS JENNIFER,D111,HJ,155.35,,81980.79
6150,8/31/2020,8/31/2020,82L-PRPD-083120,82L-PRPD-083120 -IMPORT PAYROLL-WOLF ANNA A,D108,HJ,36.3,,82017.09
6150,8/31/2020,8/31/2020,82L-PRPD-083120,82L-PRPD-083120 -IMPORT PAYROLL-WOLF ANNA A,D108,HJ,155.19,,82172.28
6150,8/31/2020,8/31/2020,82L-PRPD-083120,Reverse 82L payroll of 83120 JE-21-0021-IMPORT PAYROLL,D105,HJ,,0.94,82171.34
6150,8/31/2020,8/31/2020,82L-PRPD-083120,Reverse 82L payroll of 83120 JE-21-0021-IMPORT PAYROLL,D105,HJ,,4.03,82167.31
6150,8/31/2020,8/31/2020,82L-PRPD-083120,Reverse 82L payroll of 83120 JE-21-0021-IMPORT PAYROLL,D108,HJ,,26.38,82140.93
6150,8/31/2020,8/31/2020,82L-PRPD-083120,Reverse 82L payroll of 83120 JE-21-0021-IMPORT PAYROLL,D108,HJ,,26.58,82114.35
6150,8/31/2020,8/31/2020,82L-PRPD-083120,Reverse 82L payroll of 83120 JE-21-0021-IMPORT PAYROLL,D108,HJ,,28.93,82085.42
6150,8/31/2020,8/31/2020,82L-PRPD-083120,Reverse 82L payroll of 83120 JE-21-0021-IMPORT PAYROLL,D108,HJ,,30.83,82054.59
6150,8/31/2020,8/31/2020,82L-PRPD-083120,Reverse 82L payroll of 83120 JE-21-0021-IMPORT PAYROLL,D108,HJ,,31.22,82023.37
6150,8/31/2020,8/31/2020,82L-PRPD-083120,Reverse 82L payroll of 83120 JE-21-0021-IMPORT PAYROLL,D108,HJ,,31.33,81992.04
6150,8/31/2020,8/31/2020,82L-PRPD-083120,Reverse 82L payroll of 83120 JE-21-0021-IMPORT PAYROLL,D108,HJ,,32.92,81959.12
6150,8/31/2020,8/31/2020,82L-PRPD-083120,Reverse 82L payroll of 83120 JE-21-0021-IMPORT PAYROLL,D108,HJ,,33.1,81926.02
6150,8/31/2020,8/31/2020,82L-PRPD-083120,Reverse 82L payroll of 83120 JE-21-0021-IMPORT PAYROLL,D108,HJ,,33.23,81892.79
6150,8/31/2020,8/31/2020,82L-PRPD-083120,Reverse 82L payroll of 83120 JE-21-0021-IMPORT PAYROLL,D108,HJ,,33.4,81859.39
6150,8/31/2020,8/31/2020,82L-PRPD-083120,Reverse 82L payroll of 83120 JE-21-0021-IMPORT PAYROLL,D108,HJ,,33.42,81825.97
6150,8/31/2020,8/31/2020,82L-PRPD-083120,Reverse 82L payroll of 83120 JE-21-0021-IMPORT PAYROLL,D108,HJ,,33.86,81792.11
6150,8/31/2020,8/31/2020,82L-PRPD-083120,Reverse 82L payroll of 83120 JE-21-0021-IMPORT PAYROLL,D108,HJ,,34.07,81758.04
6150,8/31/2020,8/31/2020,82L-PRPD-083120,Reverse 82L payroll of 83120 JE-21-0021-IMPORT PAYROLL,D108,HJ,,36.3,81721.74
6150,8/31/2020,8/31/2020,82L-PRPD-083120,Reverse 82L payroll of 83120 JE-21-0021-IMPORT PAYROLL,D108,HJ,,36.34,81685.4
6150,8/31/2020,8/31/2020,82L-PRPD-083120,Reverse 82L payroll of 83120 JE-21-0021-IMPORT PAYROLL,D108,HJ,,36.46,81648.94
6150,8/31/2020,8/31/2020,82L-PRPD-083120,Reverse 82L payroll of 83120 JE-21-0021-IMPORT PAYROLL,D108,HJ,,37.97,81610.97
6150,8/31/2020,8/31/2020,82L-PRPD-083120,Reverse 82L payroll of 83120 JE-21-0021-IMPORT PAYROLL,D108,HJ,,38.67,81572.3
6150,8/31/2020,8/31/2020,82L-PRPD-083120,Reverse 82L payroll of 83120 JE-21-0021-IMPORT PAYROLL,D108,HJ,,41.85,81530.45
6150,8/31/2020,8/31/2020,82L-PRPD-083120,Reverse 82L payroll of 83120 JE-21-0021-IMPORT PAYROLL,D108,HJ,,42.32,81488.13
6150,8/31/2020,8/31/2020,82L-PRPD-083120,Reverse 82L payroll of 83120 JE-21-0021-IMPORT PAYROLL,D108,HJ,,45.1,81443.03
6150,8/31/2020,8/31/2020,82L-PRPD-083120,Reverse 82L payroll of 83120 JE-21-0021-IMPORT PAYROLL,D108,HJ,,45.87,81397.16
6150,8/31/2020,8/31/2020,82L-PRPD-083120,Reverse 82L payroll of 83120 JE-21-0021-IMPORT PAYROLL,D108,HJ,,52.91,81344.25
6150,8/31/2020,8/31/2020,82L-PRPD-083120,Reverse 82L payroll of 83120 JE-21-0021-IMPORT PAYROLL,D108,HJ,,112.81,81231.44
6150,8/31/2020,8/31/2020,82L-PRPD-083120,Reverse 82L payroll of 83120 JE-21-0021-IMPORT PAYROLL,D108,HJ,,113.67,81117.77
6150,8/31/2020,8/31/2020,82L-PRPD-083120,Reverse 82L payroll of 83120 JE-21-0021-IMPORT PAYROLL,D108,HJ,,123.72,80994.05
6150,8/31/2020,8/31/2020,82L-PRPD-083120,Reverse 82L payroll of 83120 JE-21-0021-IMPORT PAYROLL,D108,HJ,,131.84,80862.21
6150,8/31/2020,8/31/2020,82L-PRPD-083120,Reverse 82L payroll of 83120 JE-21-0021-IMPORT PAYROLL,D108,HJ,,133.51,80728.7
6150,8/31/2020,8/31/2020,82L-PRPD-083120,Reverse 82L payroll of 83120 JE-21-0021-IMPORT PAYROLL,D108,HJ,,133.98,80594.72
6150,8/31/2020,8/31/2020,82L-PRPD-083120,Reverse 82L payroll of 83120 JE-21-0021-IMPORT PAYROLL,D108,HJ,,140.75,80453.97
6150,8/31/2020,8/31/2020,82L-PRPD-083120,Reverse 82L payroll of 83120 JE-21-0021-IMPORT PAYROLL,D108,HJ,,141.55,80312.42
6150,8/31/2020,8/31/2020,82L-PRPD-083120,Reverse 82L payroll of 83120 JE-21-0021-IMPORT PAYROLL,D108,HJ,,142.08,80170.34
6150,8/31/2020,8/31/2020,82L-PRPD-083120,Reverse 82L payroll of 83120 JE-21-0021-IMPORT PAYROLL,D108,HJ,,142.81,80027.53
6150,8/31/2020,8/31/2020,82L-PRPD-083120,Reverse 82L payroll of 83120 JE-21-0021-IMPORT PAYROLL,D108,HJ,,142.9,79884.63
6150,8/31/2020,8/31/2020,82L-PRPD-083120,Reverse 82L payroll of 83120 JE-21-0021-IMPORT PAYROLL,D108,HJ,,144.76,79739.87
6150,8/31/2020,8/31/2020,82L-PRPD-083120,Reverse 82L payroll of 83120 JE-21-0021-IMPORT PAYROLL,D108,HJ,,145.66,79594.21
6150,8/31/2020,8/31/2020,82L-PRPD-083120,Reverse 82L payroll of 83120 JE-21-0021-IMPORT PAYROLL,D108,HJ,,155.19,79439.02
6150,8/31/2020,8/31/2020,82L-PRPD-083120,Reverse 82L payroll of 83120 JE-21-0021-IMPORT PAYROLL,D108,HJ,,155.39,79283.63
6150,8/31/2020,8/31/2020,82L-PRPD-083120,Reverse 82L payroll of 83120 JE-21-0021-IMPORT PAYROLL,D108,HJ,,155.89,79127.74
6150,8/31/2020,8/31/2020,82L-PRPD-083120,Reverse 82L payroll of 83120 JE-21-0021-IMPORT PAYROLL,D108,HJ,,162.36,78965.38
6150,8/31/2020,8/31/2020,82L-PRPD-083120,Reverse 82L payroll of 83120 JE-21-0021-IMPORT PAYROLL,D108,HJ,,165.33,78800.05
6150,8/31/2020,8/31/2020,82L-PRPD-083120,Reverse 82L payroll of 83120 JE-21-0021-IMPORT PAYROLL,D108,HJ,,178.96,78621.09
6150,8/31/2020,8/31/2020,82L-PRPD-083120,Reverse 82L payroll of 83120 JE-21-0021-IMPORT PAYROLL,D108,HJ,,180.94,78440.15
6150,8/31/2020,8/31/2020,82L-PRPD-083120,Reverse 82L payroll of 83120 JE-21-0021-IMPORT PAYROLL,D108,HJ,,192.83,78247.32
6150,8/31/2020,8/31/2020,82L-PRPD-083120,Reverse 82L payroll of 83120 JE-21-0021-IMPORT PAYROLL,D108,HJ,,196.13,78051.19
6150,8/31/2020,8/31/2020,82L-PRPD-083120,Reverse 82L payroll of 83120 JE-21-0021-IMPORT PAYROLL,D108,HJ,,226.22,77824.97
6150,8/31/2020,8/31/2020,82L-PRPD-083120,Reverse 82L payroll of 83120 JE-21-0021-IMPORT PAYROLL,D111,HJ,,36.33,77788.64
6150,8/31/2020,8/31/2020,82L-PRPD-083120,Reverse 82L payroll of 83120 JE-21-0021-IMPORT PAYROLL,D111,HJ,,155.35,77633.29
6150,8/31/2020,8/31/2020,82L-PRPD-083120,82L-PRPD-083120 -IMPORT PAYROLL-ACEVEDO MONIVETT,D103,HJ,72.42,,77705.71
6150,8/31/2020,8/31/2020,82L-PRPD-083120,82L-PRPD-083120 -IMPORT PAYROLL-ACEVEDO MONIVETT,D103,HJ,309.64,,78015.35
6150,8/31/2020,8/31/2020,82L-PRPD-083120,82L-PRPD-083120 -IMPORT PAYROLL-AKLESTAD ISABEL,D107,HJ,23.29,,78038.64
6150,8/31/2020,8/31/2020,82L-PRPD-083120,82L-PRPD-083120 -IMPORT PAYROLL-AKLESTAD ISABEL,D107,HJ,99.58,,78138.22
6150,8/31/2020,8/31/2020,82L-PRPD-083120,82L-PRPD-083120 -IMPORT PAYROLL-ALVAREZ-MORINE LISIS,D107,HJ,34.63,,78172.85
6150,8/31/2020,8/31/2020,82L-PRPD-083120,82L-PRPD-083120 -IMPORT PAYROLL-ALVAREZ-MORINE LISIS,D107,HJ,64.48,,78237.33
6150,8/31/2020,8/31/2020,82L-PRPD-083120,82L-PRPD-083120 -IMPORT PAYROLL-ALVAREZ-MORINE LISIS,D107,HJ,148.06,,78385.39
6150,8/31/2020,8/31/2020,82L-PRPD-083120,82L-PRPD-083120 -IMPORT PAYROLL-ALWARDT CALEB,D107,HJ,15.19,,78400.58
6150,8/31/2020,8/31/2020,82L-PRPD-083120,82L-PRPD-083120 -IMPORT PAYROLL-ALWARDT CALEB,D107,HJ,64.95,,78465.53
6150,8/31/2020,8/31/2020,82L-PRPD-083120,82L-PRPD-083120 -IMPORT PAYROLL-BARTHELEMY RACHALIE,D107,HJ,14.01,,78479.54
6150,8/31/2020,8/31/2020,82L-PRPD-083120,82L-PRPD-083120 -IMPORT PAYROLL-BARTHELEMY RACHALIE,D107,HJ,26.08,,78505.62
6150,8/31/2020,8/31/2020,82L-PRPD-083120,82L-PRPD-083120 -IMPORT PAYROLL-BARTHELEMY RACHALIE,D107,HJ,59.89,,78565.51
6150,8/31/2020,8/31/2020,82L-PRPD-083120,82L-PRPD-083120 -IMPORT PAYROLL-BOHLSEN GRACE,D107,HJ,15.19,,78580.7
6150,8/31/2020,8/31/2020,82L-PRPD-083120,82L-PRPD-083120 -IMPORT PAYROLL-BOHLSEN GRACE,D107,HJ,64.95,,78645.65
6150,8/31/2020,8/31/2020,82L-PRPD-083120,82L-PRPD-083120 -IMPORT PAYROLL-BORCHART SPENCER,D107,HJ,15.19,,78660.84
6150,8/31/2020,8/31/2020,82L-PRPD-083120,82L-PRPD-083120 -IMPORT PAYROLL-BORCHART SPENCER,D107,HJ,44.27,,78705.11
6150,8/31/2020,8/31/2020,82L-PRPD-083120,82L-PRPD-083120 -IMPORT PAYROLL-BORCHART SPENCER,D107,HJ,64.95,,78770.06
6150,8/31/2020,8/31/2020,82L-PRPD-083120,82L-PRPD-083120 -IMPORT PAYROLL-BOWMAN HALLEY K,D107,HJ,49.84,,78819.9
6150,8/31/2020,8/31/2020,82L-PRPD-083120,82L-PRPD-083120 -IMPORT PAYROLL-BOWMAN HALLEY K,D107,HJ,213.13,,79033.03
6150,8/31/2020,8/31/2020,82L-PRPD-083120,82L-PRPD-083120 -IMPORT PAYROLL-BREEDLOVE JOHNDEE L,D107,HJ,14.98,,79048.01
6150,8/31/2020,8/31/2020,82L-PRPD-083120,82L-PRPD-083120 -IMPORT PAYROLL-BREEDLOVE JOHNDEE L,D107,HJ,27.89,,79075.9
6150,8/31/2020,8/31/2020,82L-PRPD-083120,82L-PRPD-083120 -IMPORT PAYROLL-BREEDLOVE JOHNDEE L,D107,HJ,64.03,,79139.93
6150,8/31/2020,8/31/2020,82L-PRPD-083120,82L-PRPD-083120 -IMPORT PAYROLL-BROWN ISAAC,D107,HJ,15.19,,79155.12
6150,8/31/2020,8/31/2020,82L-PRPD-083120,82L-PRPD-083120 -IMPORT PAYROLL-BROWN ISAAC,D107,HJ,20.14,,79175.26
6150,8/31/2020,8/31/2020,82L-PRPD-083120,82L-PRPD-083120 -IMPORT PAYROLL-BROWN ISAAC,D107,HJ,64.95,,79240.21
6150,8/31/2020,8/31/2020,82L-PRPD-083120,82L-PRPD-083120 -IMPORT PAYROLL-BURKE MARIAH,D107,HJ,15.19,,79255.4
6150,8/31/2020,8/31/2020,82L-PRPD-083120,82L-PRPD-083120 -IMPORT PAYROLL-BURKE MARIAH,D107,HJ,64.95,,79320.35
6150,8/31/2020,8/31/2020,82L-PRPD-083120,82L-PRPD-083120 -IMPORT PAYROLL-CHAVOUS MILFORD,D107,HJ,15.19,,79335.54
6150,8/31/2020,8/31/2020,82L-PRPD-083120,82L-PRPD-083120 -IMPORT PAYROLL-CHAVOUS MILFORD,D107,HJ,28.29,,79363.83
6150,8/31/2020,8/31/2020,82L-PRPD-083120,82L-PRPD-083120 -IMPORT PAYROLL-CHAVOUS MILFORD,D107,HJ,64.95,,79428.78
6150,8/31/2020,8/31/2020,82L-PRPD-083120,82L-PRPD-083120 -IMPORT PAYROLL-CHEN LING,D107,HJ,15.19,,79443.97
6150,8/31/2020,8/31/2020,82L-PRPD-083120,82L-PRPD-083120 -IMPORT PAYROLL-CHEN LING,D107,HJ,64.95,,79508.92
6150,8/31/2020,8/31/2020,82L-PRPD-083120,82L-PRPD-083120 -IMPORT PAYROLL-COOK CATHRYN ANNA,D107,HJ,49.87,,79558.79
6150,8/31/2020,8/31/2020,82L-PRPD-083120,82L-PRPD-083120 -IMPORT PAYROLL-COOK CATHRYN ANNA,D107,HJ,213.25,,79772.04
6150,8/31/2020,8/31/2020,82L-PRPD-083120,82L-PRPD-083120 -IMPORT PAYROLL-COOPER ASHLEE R,D107,HJ,33.51,,79805.55
6150,8/31/2020,8/31/2020,82L-PRPD-083120,82L-PRPD-083120 -IMPORT PAYROLL-COOPER ASHLEE R,D107,HJ,143.3,,79948.85
6150,8/31/2020,8/31/2020,82L-PRPD-083120,82L-PRPD-083120 -IMPORT PAYROLL-DARKO OLIVIA,D107,HJ,15.19,,79964.04
6150,8/31/2020,8/31/2020,82L-PRPD-083120,82L-PRPD-083120 -IMPORT PAYROLL-DARKO OLIVIA,D107,HJ,64.95,,80028.99
6150,8/31/2020,8/31/2020,82L-PRPD-083120,82L-PRPD-083120 -IMPORT PAYROLL-DAUGHERTY DEVIN W,D107,HJ,15.1,,80044.09
6150,8/31/2020,8/31/2020,82L-PRPD-083120,82L-PRPD-083120 -IMPORT PAYROLL-DAUGHERTY DEVIN W,D107,HJ,64.58,,80108.67
6150,8/31/2020,8/31/2020,82L-PRPD-083120,82L-PRPD-083120 -IMPORT PAYROLL-DAWSON JAMIL NAFAYE-BEYAH,D107,HJ,15.19,,80123.86
6150,8/31/2020,8/31/2020,82L-PRPD-083120,82L-PRPD-083120 -IMPORT PAYROLL-DAWSON JAMIL NAFAYE-BEYAH,D107,HJ,64.95,,80188.81
6150,8/31/2020,8/31/2020,82L-PRPD-083120,82L-PRPD-083120 -IMPORT PAYROLL-DETONE KYRA MAYA,D102,HJ,39,,80227.81
6150,8/31/2020,8/31/2020,82L-PRPD-083120,82L-PRPD-083120 -IMPORT PAYROLL-DETONE KYRA MAYA,D102,HJ,166.75,,80394.56
6150,8/31/2020,8/31/2020,82L-PRPD-083120,82L-PRPD-083120 -IMPORT PAYROLL-DUPUIS CHRISTOPHER M,D107,HJ,88.74,,80483.3
6150,8/31/2020,8/31/2020,82L-PRPD-083120,82L-PRPD-083120 -IMPORT PAYROLL-DUPUIS CHRISTOPHER M,D107,HJ,379.45,,80862.75
6150,8/31/2020,8/31/2020,82L-PRPD-083120,82L-PRPD-083120 -IMPORT PAYROLL-DZIEDZIC JULIE K,D107,HJ,17.71,,80880.46
6150,8/31/2020,8/31/2020,82L-PRPD-083120,82L-PRPD-083120 -IMPORT PAYROLL-DZIEDZIC JULIE K,D107,HJ,75.71,,80956.17
6150,8/31/2020,8/31/2020,82L-PRPD-083120,82L-PRPD-083120 -IMPORT PAYROLL-GILES SHAYLA,D107,HJ,15.19,,80971.36
6150,8/31/2020,8/31/2020,82L-PRPD-083120,82L-PRPD-083120 -IMPORT PAYROLL-GILES SHAYLA,D107,HJ,28.29,,80999.65
6150,8/31/2020,8/31/2020,82L-PRPD-083120,82L-PRPD-083120 -IMPORT PAYROLL-GILES SHAYLA,D107,HJ,64.95,,81064.6
6150,8/31/2020,8/31/2020,82L-PRPD-083120,82L-PRPD-083120 -IMPORT PAYROLL-GORNSTEIN STEVEN,D107,HJ,39.27,,81103.87
6150,8/31/2020,8/31/2020,82L-PRPD-083120,82L-PRPD-083120 -IMPORT PAYROLL-GORNSTEIN STEVEN,D107,HJ,114.45,,81218.32
6150,8/31/2020,8/31/2020,82L-PRPD-083120,82L-PRPD-083120 -IMPORT PAYROLL-GORNSTEIN STEVEN,D107,HJ,167.92,,81386.24
6150,8/31/2020,8/31/2020,82L-PRPD-083120,82L-PRPD-083120 -IMPORT PAYROLL-GRAVES KAMIESHIA,D107,HJ,26.3,,81412.54
6150,8/31/2020,8/31/2020,82L-PRPD-083120,82L-PRPD-083120 -IMPORT PAYROLL-GRAVES KAMIESHIA,D107,HJ,112.45,,81524.99
6150,8/31/2020,8/31/2020,82L-PRPD-083120,82L-PRPD-083120 -IMPORT PAYROLL-GUADARRAMA-ALVAREZ URIEL A,D107,HJ,39.93,,81564.92
6150,8/31/2020,8/31/2020,82L-PRPD-083120,82L-PRPD-083120 -IMPORT PAYROLL-GUADARRAMA-ALVAREZ URIEL A,D107,HJ,170.75,,81735.67
6150,8/31/2020,8/31/2020,82L-PRPD-083120,82L-PRPD-083120 -IMPORT PAYROLL-GUTIERREZ ANTONIO J,D102,HJ,74.25,,81809.92
6150,8/31/2020,8/31/2020,82L-PRPD-083120,82L-PRPD-083120 -IMPORT PAYROLL-GUTIERREZ ANTONIO J,D102,HJ,317.48,,82127.4
6150,8/31/2020,8/31/2020,82L-PRPD-083120,82L-PRPD-083120 -IMPORT PAYROLL-HESTER TYLER CONRAD,D107,HJ,27.79,,82155.19
6150,8/31/2020,8/31/2020,82L-PRPD-083120,82L-PRPD-083120 -IMPORT PAYROLL-HESTER TYLER CONRAD,D107,HJ,118.83,,82274.02
6150,8/31/2020,8/31/2020,82L-PRPD-083120,82L-PRPD-083120 -IMPORT PAYROLL-JONES JORDAN,D107,HJ,15.19,,82289.21
6150,8/31/2020,8/31/2020,82L-PRPD-083120,82L-PRPD-083120 -IMPORT PAYROLL-JONES JORDAN,D107,HJ,64.95,,82354.16
6150,8/31/2020,8/31/2020,82L-PRPD-083120,82L-PRPD-083120 -IMPORT PAYROLL-KHAN HUDA,D107,HJ,15.19,,82369.35
6150,8/31/2020,8/31/2020,82L-PRPD-083120,82L-PRPD-083120 -IMPORT PAYROLL-KHAN HUDA,D107,HJ,28.29,,82397.64
6150,8/31/2020,8/31/2020,82L-PRPD-083120,82L-PRPD-083120 -IMPORT PAYROLL-KHAN HUDA,D107,HJ,64.95,,82462.59
6150,8/31/2020,8/31/2020,82L-PRPD-083120,82L-PRPD-083120 -IMPORT PAYROLL-KING IRIS,D107,HJ,7.01,,82469.6
6150,8/31/2020,8/31/2020,82L-PRPD-083120,82L-PRPD-083120 -IMPORT PAYROLL-KING IRIS,D107,HJ,13.05,,82482.65
6150,8/31/2020,8/31/2020,82L-PRPD-083120,82L-PRPD-083120 -IMPORT PAYROLL-KING IRIS,D107,HJ,29.98,,82512.63
6150,8/31/2020,8/31/2020,82L-PRPD-083120,82L-PRPD-083120 -IMPORT PAYROLL-KLOHR TIMOTHY JORDAN,D107,HJ,21.41,,82534.04
6150,8/31/2020,8/31/2020,82L-PRPD-083120,82L-PRPD-083120 -IMPORT PAYROLL-KLOHR TIMOTHY JORDAN,D107,HJ,39.88,,82573.92
6150,8/31/2020,8/31/2020,82L-PRPD-083120,82L-PRPD-083120 -IMPORT PAYROLL-KLOHR TIMOTHY JORDAN,D107,HJ,91.57,,82665.49
6150,8/31/2020,8/31/2020,82L-PRPD-083120,82L-PRPD-083120 -IMPORT PAYROLL-KOPSHEVER MELISSA,D107,HJ,42.29,,82707.78
6150,8/31/2020,8/31/2020,82L-PRPD-083120,82L-PRPD-083120 -IMPORT PAYROLL-KOPSHEVER MELISSA,D107,HJ,52.1,,82759.88
6150,8/31/2020,8/31/2020,82L-PRPD-083120,82L-PRPD-083120 -IMPORT PAYROLL-KOPSHEVER MELISSA,D107,HJ,180.83,,82940.71
6150,8/31/2020,8/31/2020,82L-PRPD-083120,82L-PRPD-083120 -IMPORT PAYROLL-LACEY DEQUITA,D108,HJ,35.7,,82976.41
6150,8/31/2020,8/31/2020,82L-PRPD-083120,82L-PRPD-083120 -IMPORT PAYROLL-LACEY DEQUITA,D108,HJ,152.64,,83129.05
6150,8/31/2020,8/31/2020,82L-PRPD-083120,82L-PRPD-083120 -IMPORT PAYROLL-LI SEN YUAN,D107,HJ,14.05,,83143.1
6150,8/31/2020,8/31/2020,82L-PRPD-083120,82L-PRPD-083120 -IMPORT PAYROLL-LI SEN YUAN,D107,HJ,26.16,,83169.26
6150,8/31/2020,8/31/2020,82L-PRPD-083120,82L-PRPD-083120 -IMPORT PAYROLL-LI SEN YUAN,D107,HJ,60.07,,83229.33
6150,8/31/2020,8/31/2020,82L-PRPD-083120,82L-PRPD-083120 -IMPORT PAYROLL-LIPORACE HERNAN LUIS,D103,HJ,33.06,,83262.39
6150,8/31/2020,8/31/2020,82L-PRPD-083120,82L-PRPD-083120 -IMPORT PAYROLL-LIPORACE HERNAN LUIS,D103,HJ,61.55,,83323.94
6150,8/31/2020,8/31/2020,82L-PRPD-083120,82L-PRPD-083120 -IMPORT PAYROLL-LIPORACE HERNAN LUIS,D103,HJ,141.34,,83465.28
6150,8/31/2020,8/31/2020,82L-PRPD-083120,82L-PRPD-083120 -IMPORT PAYROLL-LIPSCOMB STEPHEN,D107,HJ,33.58,,83498.86
6150,8/31/2020,8/31/2020,82L-PRPD-083120,82L-PRPD-083120 -IMPORT PAYROLL-LIPSCOMB STEPHEN,D107,HJ,62.53,,83561.39
6150,8/31/2020,8/31/2020,82L-PRPD-083120,82L-PRPD-083120 -IMPORT PAYROLL-LIPSCOMB STEPHEN,D107,HJ,143.59,,83704.98
6150,8/31/2020,8/31/2020,82L-PRPD-083120,82L-PRPD-083120 -IMPORT PAYROLL-MASON ANGELA,D107,HJ,78.57,,83783.55
6150,8/31/2020,8/31/2020,82L-PRPD-083120,82L-PRPD-083120 -IMPORT PAYROLL-MASON ANGELA,D107,HJ,335.97,,84119.52
6150,8/31/2020,8/31/2020,82L-PRPD-083120,82L-PRPD-083120 -IMPORT PAYROLL-MCLAUGHLIN MARA,D107,HJ,15.19,,84134.71
6150,8/31/2020,8/31/2020,82L-PRPD-083120,82L-PRPD-083120 -IMPORT PAYROLL-MCLAUGHLIN MARA,D107,HJ,64.95,,84199.66
6150,8/31/2020,8/31/2020,82L-PRPD-083120,82L-PRPD-083120 -IMPORT PAYROLL-MEJIA CARLOS MANUEL,D107,HJ,14.01,,84213.67
6150,8/31/2020,8/31/2020,82L-PRPD-083120,82L-PRPD-083120 -IMPORT PAYROLL-MEJIA CARLOS MANUEL,D107,HJ,59.89,,84273.56
6150,8/31/2020,8/31/2020,82L-PRPD-083120,82L-PRPD-083120 -IMPORT PAYROLL-MONROY-MEJIA JASON,D107,HJ,15.19,,84288.75
6150,8/31/2020,8/31/2020,82L-PRPD-083120,82L-PRPD-083120 -IMPORT PAYROLL-MONROY-MEJIA JASON,D107,HJ,36.67,,84325.42
6150,8/31/2020,8/31/2020,82L-PRPD-083120,82L-PRPD-083120 -IMPORT PAYROLL-MONROY-MEJIA JASON,D107,HJ,64.95,,84390.37
6150,8/31/2020,8/31/2020,82L-PRPD-083120,82L-PRPD-083120 -IMPORT PAYROLL-O'FLYNN-PRUITT NATHAN COLYAR,D107,HJ,15.19,,84405.56
6150,8/31/2020,8/31/2020,82L-PRPD-083120,82L-PRPD-083120 -IMPORT PAYROLL-O'FLYNN-PRUITT NATHAN COLYAR,D107,HJ,36.67,,84442.23
6150,8/31/2020,8/31/2020,82L-PRPD-083120,82L-PRPD-083120 -IMPORT PAYROLL-O'FLYNN-PRUITT NATHAN COLYAR,D107,HJ,64.95,,84507.18
6150,8/31/2020,8/31/2020,82L-PRPD-083120,82L-PRPD-083120 -IMPORT PAYROLL-ODONNELL STEPHEN,D107,HJ,39.26,,84546.44
6150,8/31/2020,8/31/2020,82L-PRPD-083120,82L-PRPD-083120 -IMPORT PAYROLL-ODONNELL STEPHEN,D107,HJ,167.87,,84714.31
6150,8/31/2020,8/31/2020,82L-PRPD-083120,82L-PRPD-083120 -IMPORT PAYROLL-PARETS MALLORY GRACE,D107,HJ,17.57,,84731.88
6150,8/31/2020,8/31/2020,82L-PRPD-083120,82L-PRPD-083120 -IMPORT PAYROLL-PARETS MALLORY GRACE,D107,HJ,41.08,,84772.96
6150,8/31/2020,8/31/2020,82L-PRPD-083120,82L-PRPD-083120 -IMPORT PAYROLL-PARETS MALLORY GRACE,D107,HJ,76.5,,84849.46
6150,8/31/2020,8/31/2020,82L-PRPD-083120,82L-PRPD-083120 -IMPORT PAYROLL-PARETS MALLORY GRACE,D107,HJ,175.67,,85025.13
6150,8/31/2020,8/31/2020,82L-PRPD-083120,82L-PRPD-083120 -IMPORT PAYROLL-PARHAM-GANTT DENISE M,D108,HJ,37.96,,85063.09
6150,8/31/2020,8/31/2020,82L-PRPD-083120,82L-PRPD-083120 -IMPORT PAYROLL-PARHAM-GANTT DENISE M,D108,HJ,162.32,,85225.41
6150,8/31/2020,8/31/2020,82L-PRPD-083120,82L-PRPD-083120 -IMPORT PAYROLL-PATTERSON STEVE,D107,HJ,15.19,,85240.6
6150,8/31/2020,8/31/2020,82L-PRPD-083120,82L-PRPD-083120 -IMPORT PAYROLL-PATTERSON STEVE,D107,HJ,28.29,,85268.89
6150,8/31/2020,8/31/2020,82L-PRPD-083120,82L-PRPD-083120 -IMPORT PAYROLL-PATTERSON STEVE,D107,HJ,64.95,,85333.84
6150,8/31/2020,8/31/2020,82L-PRPD-083120,82L-PRPD-083120 -IMPORT PAYROLL-PEINADO ELIZABETH R,D107,HJ,52.29,,85386.13
6150,8/31/2020,8/31/2020,82L-PRPD-083120,82L-PRPD-083120 -IMPORT PAYROLL-PEINADO ELIZABETH R,D107,HJ,223.58,,85609.71
6150,8/31/2020,8/31/2020,82L-PRPD-083120,82L-PRPD-083120 -IMPORT PAYROLL-POLANCO ODALIS,D103,HJ,43.23,,85652.94
6150,8/31/2020,8/31/2020,82L-PRPD-083120,82L-PRPD-083120 -IMPORT PAYROLL-POLANCO ODALIS,D103,HJ,184.83,,85837.77
6150,8/31/2020,8/31/2020,82L-PRPD-083120,82L-PRPD-083120 -IMPORT PAYROLL-QUINTAS JASHIVE,D107,HJ,27.79,,85865.56
6150,8/31/2020,8/31/2020,82L-PRPD-083120,82L-PRPD-083120 -IMPORT PAYROLL-QUINTAS JASHIVE,D107,HJ,118.83,,85984.39
6150,8/31/2020,8/31/2020,82L-PRPD-083120,82L-PRPD-083120 -IMPORT PAYROLL-RANDOLPH ALEXANDER,D107,HJ,11.63,,85996.02
6150,8/31/2020,8/31/2020,82L-PRPD-083120,82L-PRPD-083120 -IMPORT PAYROLL-RANDOLPH ALEXANDER,D107,HJ,25.1,,86021.12
6150,8/31/2020,8/31/2020,82L-PRPD-083120,82L-PRPD-083120 -IMPORT PAYROLL-RANDOLPH ALEXANDER,D107,HJ,50.63,,86071.75
6150,8/31/2020,8/31/2020,82L-PRPD-083120,82L-PRPD-083120 -IMPORT PAYROLL-RANDOLPH ALEXANDER,D107,HJ,107.33,,86179.08
6150,8/31/2020,8/31/2020,82L-PRPD-083120,82L-PRPD-083120 -IMPORT PAYROLL-ROBBINS DEANNA,D107,HJ,36.85,,86215.93
6150,8/31/2020,8/31/2020,82L-PRPD-083120,82L-PRPD-083120 -IMPORT PAYROLL-ROBBINS DEANNA,D107,HJ,68.63,,86284.56
6150,8/31/2020,8/31/2020,82L-PRPD-083120,82L-PRPD-083120 -IMPORT PAYROLL-ROBBINS DEANNA,D107,HJ,157.58,,86442.14
6150,8/31/2020,8/31/2020,82L-PRPD-083120,82L-PRPD-083120 -IMPORT PAYROLL-SAFRAN ALAN P,D102,HJ,108.43,,86550.57
6150,8/31/2020,8/31/2020,82L-PRPD-083120,82L-PRPD-083120 -IMPORT PAYROLL-SAFRAN ALAN P,D102,HJ,463.62,,87014.19
6150,8/31/2020,8/31/2020,82L-PRPD-083120,82L-PRPD-083120 -IMPORT PAYROLL-SCOTT KIRK DONOVAN,D107,HJ,14.05,,87028.24
6150,8/31/2020,8/31/2020,82L-PRPD-083120,82L-PRPD-083120 -IMPORT PAYROLL-SCOTT KIRK DONOVAN,D107,HJ,26.16,,87054.4
6150,8/31/2020,8/31/2020,82L-PRPD-083120,82L-PRPD-083120 -IMPORT PAYROLL-SCOTT KIRK DONOVAN,D107,HJ,60.07,,87114.47
6150,8/31/2020,8/31/2020,82L-PRPD-083120,82L-PRPD-083120 -IMPORT PAYROLL-SHENKMAN OLIVIA,D107,HJ,29,,87143.47
6150,8/31/2020,8/31/2020,82L-PRPD-083120,82L-PRPD-083120 -IMPORT PAYROLL-SHENKMAN OLIVIA,D107,HJ,124,,87267.47
6150,8/31/2020,8/31/2020,82L-PRPD-083120,82L-PRPD-083120 -IMPORT PAYROLL-SHI GRACE,D103,HJ,12.69,,87280.16
6150,8/31/2020,8/31/2020,82L-PRPD-083120,82L-PRPD-083120 -IMPORT PAYROLL-SHI GRACE,D103,HJ,36.98,,87317.14
6150,8/31/2020,8/31/2020,82L-PRPD-083120,82L-PRPD-083120 -IMPORT PAYROLL-SHI GRACE,D103,HJ,54.25,,87371.39
6150,8/31/2020,8/31/2020,82L-PRPD-083120,82L-PRPD-083120 -IMPORT PAYROLL-SILVER KELLY,D107,HJ,34.63,,87406.02
6150,8/31/2020,8/31/2020,82L-PRPD-083120,82L-PRPD-083120 -IMPORT PAYROLL-SILVER KELLY,D107,HJ,64.48,,87470.5
6150,8/31/2020,8/31/2020,82L-PRPD-083120,82L-PRPD-083120 -IMPORT PAYROLL-SILVER KELLY,D107,HJ,148.06,,87618.56
6150,8/31/2020,8/31/2020,82L-PRPD-083120,82L-PRPD-083120 -IMPORT PAYROLL-SOLIMAN MARK,D107,HJ,15.19,,87633.75
6150,8/31/2020,8/31/2020,82L-PRPD-083120,82L-PRPD-083120 -IMPORT PAYROLL-SOLIMAN MARK,D107,HJ,36.67,,87670.42
6150,8/31/2020,8/31/2020,82L-PRPD-083120,82L-PRPD-083120 -IMPORT PAYROLL-SOLIMAN MARK,D107,HJ,64.95,,87735.37
6150,8/31/2020,8/31/2020,82L-PRPD-083120,82L-PRPD-083120 -IMPORT PAYROLL-STROUD DAVID,D107,HJ,14.65,,87750.02
6150,8/31/2020,8/31/2020,82L-PRPD-083120,82L-PRPD-083120 -IMPORT PAYROLL-STROUD DAVID,D107,HJ,62.62,,87812.64
6150,8/31/2020,8/31/2020,82L-PRPD-083120,82L-PRPD-083120 -IMPORT PAYROLL-VALCIN SABRINA JEMIMAH,D107,HJ,14.25,,87826.89
6150,8/31/2020,8/31/2020,82L-PRPD-083120,82L-PRPD-083120 -IMPORT PAYROLL-VALCIN SABRINA JEMIMAH,D107,HJ,26.53,,87853.42
6150,8/31/2020,8/31/2020,82L-PRPD-083120,82L-PRPD-083120 -IMPORT PAYROLL-VALCIN SABRINA JEMIMAH,D107,HJ,60.92,,87914.34
6150,8/31/2020,8/31/2020,82L-PRPD-083120,82L-PRPD-083120 -IMPORT PAYROLL-WEINSTOCK EMILY,D107,HJ,17.57,,87931.91
6150,8/31/2020,8/31/2020,82L-PRPD-083120,82L-PRPD-083120 -IMPORT PAYROLL-WEINSTOCK EMILY,D107,HJ,38.11,,87970.02
6150,8/31/2020,8/31/2020,82L-PRPD-083120,82L-PRPD-083120 -IMPORT PAYROLL-WEINSTOCK EMILY,D107,HJ,76.5,,88046.52
6150,8/31/2020,8/31/2020,82L-PRPD-083120,82L-PRPD-083120 -IMPORT PAYROLL-WEINSTOCK EMILY,D107,HJ,162.94,,88209.46
6150,8/31/2020,8/31/2020,82L-PRPD-083120,82L-PRPD-083120 -IMPORT PAYROLL-WILLIAMS MACK ANTHONY,D107,HJ,14.07,,88223.53
6150,8/31/2020,8/31/2020,82L-PRPD-083120,82L-PRPD-083120 -IMPORT PAYROLL-WILLIAMS MACK ANTHONY,D107,HJ,26.21,,88249.74
6150,8/31/2020,8/31/2020,82L-PRPD-083120,82L-PRPD-083120 -IMPORT PAYROLL-WILLIAMS MACK ANTHONY,D107,HJ,60.18,,88309.92
6150,8/31/2020,8/31/2020,82L-PRPD-083120,82L-PRPD-083120 -IMPORT PAYROLL-WILLIAMS MIL'YONTA,D107,HJ,15.19,,88325.11
6150,8/31/2020,8/31/2020,82L-PRPD-083120,82L-PRPD-083120 -IMPORT PAYROLL-WILLIAMS MIL'YONTA,D107,HJ,64.95,,88390.06
6150,8/31/2020,8/31/2020,82L-PRPD-083120,82L-PRPD-083120 -IMPORT PAYROLL-ZARATE JOSEPH M,D107,HJ,31.18,,88421.24
6150,8/31/2020,8/31/2020,82L-PRPD-083120,82L-PRPD-083120 -IMPORT PAYROLL-ZARATE JOSEPH M,D107,HJ,133.3,,88554.54
6150,8/31/2020,8/31/2020,82L-PRPD-083120,Reverse 82L payroll of 83120 JE-21-0021-IMPORT PAYROLL,D102,HJ,,39,88515.54
6150,8/31/2020,8/31/2020,82L-PRPD-083120,Reverse 82L payroll of 83120 JE-21-0021-IMPORT PAYROLL,D102,HJ,,74.25,88441.29
6150,8/31/2020,8/31/2020,82L-PRPD-083120,Reverse 82L payroll of 83120 JE-21-0021-IMPORT PAYROLL,D102,HJ,,108.43,88332.86
6150,8/31/2020,8/31/2020,82L-PRPD-083120,Reverse 82L payroll of 83120 JE-21-0021-IMPORT PAYROLL,D102,HJ,,166.75,88166.11
6150,8/31/2020,8/31/2020,82L-PRPD-083120,Reverse 82L payroll of 83120 JE-21-0021-IMPORT PAYROLL,D102,HJ,,317.48,87848.63
6150,8/31/2020,8/31/2020,82L-PRPD-083120,Reverse 82L payroll of 83120 JE-21-0021-IMPORT PAYROLL,D102,HJ,,463.62,87385.01
6150,8/31/2020,8/31/2020,82L-PRPD-083120,Reverse 82L payroll of 83120 JE-21-0021-IMPORT PAYROLL,D103,HJ,,12.69,87372.32
6150,8/31/2020,8/31/2020,82L-PRPD-083120,Reverse 82L payroll of 83120 JE-21-0021-IMPORT PAYROLL,D103,HJ,,33.06,87339.26
6150,8/31/2020,8/31/2020,82L-PRPD-083120,Reverse 82L payroll of 83120 JE-21-0021-IMPORT PAYROLL,D103,HJ,,36.98,87302.28
6150,8/31/2020,8/31/2020,82L-PRPD-083120,Reverse 82L payroll of 83120 JE-21-0021-IMPORT PAYROLL,D103,HJ,,43.23,87259.05
6150,8/31/2020,8/31/2020,82L-PRPD-083120,Reverse 82L payroll of 83120 JE-21-0021-IMPORT PAYROLL,D103,HJ,,54.25,87204.8
6150,8/31/2020,8/31/2020,82L-PRPD-083120,Reverse 82L payroll of 83120 JE-21-0021-IMPORT PAYROLL,D103,HJ,,61.55,87143.25
6150,8/31/2020,8/31/2020,82L-PRPD-083120,Reverse 82L payroll of 83120 JE-21-0021-IMPORT PAYROLL,D103,HJ,,72.42,87070.83
6150,8/31/2020,8/31/2020,82L-PRPD-083120,Reverse 82L payroll of 83120 JE-21-0021-IMPORT PAYROLL,D103,HJ,,141.34,86929.49
6150,8/31/2020,8/31/2020,82L-PRPD-083120,Reverse 82L payroll of 83120 JE-21-0021-IMPORT PAYROLL,D103,HJ,,184.83,86744.66
6150,8/31/2020,8/31/2020,82L-PRPD-083120,Reverse 82L payroll of 83120 JE-21-0021-IMPORT PAYROLL,D103,HJ,,309.64,86435.02
6150,8/31/2020,8/31/2020,82L-PRPD-083120,Reverse 82L payroll of 83120 JE-21-0021-IMPORT PAYROLL,D107,HJ,,7.01,86428.01
6150,8/31/2020,8/31/2020,82L-PRPD-083120,Reverse 82L payroll of 83120 JE-21-0021-IMPORT PAYROLL,D107,HJ,,11.63,86416.38
6150,8/31/2020,8/31/2020,82L-PRPD-083120,Reverse 82L payroll of 83120 JE-21-0021-IMPORT PAYROLL,D107,HJ,,13.05,86403.33
6150,8/31/2020,8/31/2020,82L-PRPD-083120,Reverse 82L payroll of 83120 JE-21-0021-IMPORT PAYROLL,D107,HJ,,14.01,86389.32
6150,8/31/2020,8/31/2020,82L-PRPD-083120,Reverse 82L payroll of 83120 JE-21-0021-IMPORT PAYROLL,D107,HJ,,14.01,86375.31
6150,8/31/2020,8/31/2020,82L-PRPD-083120,Reverse 82L payroll of 83120 JE-21-0021-IMPORT PAYROLL,D107,HJ,,14.05,86361.26
6150,8/31/2020,8/31/2020,82L-PRPD-083120,Reverse 82L payroll of 83120 JE-21-0021-IMPORT PAYROLL,D107,HJ,,14.05,86347.21
6150,8/31/2020,8/31/2020,82L-PRPD-083120,Reverse 82L payroll of 83120 JE-21-0021-IMPORT PAYROLL,D107,HJ,,14.07,86333.14
6150,8/31/2020,8/31/2020,82L-PRPD-083120,Reverse 82L payroll of 83120 JE-21-0021-IMPORT PAYROLL,D107,HJ,,14.25,86318.89
6150,8/31/2020,8/31/2020,82L-PRPD-083120,Reverse 82L payroll of 83120 JE-21-0021-IMPORT PAYROLL,D107,HJ,,14.65,86304.24
6150,8/31/2020,8/31/2020,82L-PRPD-083120,Reverse 82L payroll of 83120 JE-21-0021-IMPORT PAYROLL,D107,HJ,,14.98,86289.26
6150,8/31/2020,8/31/2020,82L-PRPD-083120,Reverse 82L payroll of 83120 JE-21-0021-IMPORT PAYROLL,D107,HJ,,15.1,86274.16
6150,8/31/2020,8/31/2020,82L-PRPD-083120,Reverse 82L payroll of 83120 JE-21-0021-IMPORT PAYROLL,D107,HJ,,15.19,86258.97
6150,8/31/2020,8/31/2020,82L-PRPD-083120,Reverse 82L payroll of 83120 JE-21-0021-IMPORT PAYROLL,D107,HJ,,15.19,86243.78
6150,8/31/2020,8/31/2020,82L-PRPD-083120,Reverse 82L payroll of 83120 JE-21-0021-IMPORT PAYROLL,D107,HJ,,15.19,86228.59
6150,8/31/2020,8/31/2020,82L-PRPD-083120,Reverse 82L payroll of 83120 JE-21-0021-IMPORT PAYROLL,D107,HJ,,15.19,86213.4
6150,8/31/2020,8/31/2020,82L-PRPD-083120,Reverse 82L payroll of 83120 JE-21-0021-IMPORT PAYROLL,D107,HJ,,15.19,86198.21
6150,8/31/2020,8/31/2020,82L-PRPD-083120,Reverse 82L payroll of 83120 JE-21-0021-IMPORT PAYROLL,D107,HJ,,15.19,86183.02
6150,8/31/2020,8/31/2020,82L-PRPD-083120,Reverse 82L payroll of 83120 JE-21-0021-IMPORT PAYROLL,D107,HJ,,15.19,86167.83
6150,8/31/2020,8/31/2020,82L-PRPD-083120,Reverse 82L payroll of 83120 JE-21-0021-IMPORT PAYROLL,D107,HJ,,15.19,86152.64
6150,8/31/2020,8/31/2020,82L-PRPD-083120,Reverse 82L payroll of 83120 JE-21-0021-IMPORT PAYROLL,D107,HJ,,15.19,86137.45
6150,8/31/2020,8/31/2020,82L-PRPD-083120,Reverse 82L payroll of 83120 JE-21-0021-IMPORT PAYROLL,D107,HJ,,15.19,86122.26
6150,8/31/2020,8/31/2020,82L-PRPD-083120,Reverse 82L payroll of 83120 JE-21-0021-IMPORT PAYROLL,D107,HJ,,15.19,86107.07
6150,8/31/2020,8/31/2020,82L-PRPD-083120,Reverse 82L payroll of 83120 JE-21-0021-IMPORT PAYROLL,D107,HJ,,15.19,86091.88
6150,8/31/2020,8/31/2020,82L-PRPD-083120,Reverse 82L payroll of 83120 JE-21-0021-IMPORT PAYROLL,D107,HJ,,15.19,86076.69
6150,8/31/2020,8/31/2020,82L-PRPD-083120,Reverse 82L payroll of 83120 JE-21-0021-IMPORT PAYROLL,D107,HJ,,15.19,86061.5
6150,8/31/2020,8/31/2020,82L-PRPD-083120,Reverse 82L payroll of 83120 JE-21-0021-IMPORT PAYROLL,D107,HJ,,15.19,86046.31
6150,8/31/2020,8/31/2020,82L-PRPD-083120,Reverse 82L payroll of 83120 JE-21-0021-IMPORT PAYROLL,D107,HJ,,15.19,86031.12
6150,8/31/2020,8/31/2020,82L-PRPD-083120,Reverse 82L payroll of 83120 JE-21-0021-IMPORT PAYROLL,D107,HJ,,15.19,86015.93
6150,8/31/2020,8/31/2020,82L-PRPD-083120,Reverse 82L payroll of 83120 JE-21-0021-IMPORT PAYROLL,D107,HJ,,15.19,86000.74
6150,8/31/2020,8/31/2020,82L-PRPD-083120,Reverse 82L payroll of 83120 JE-21-0021-IMPORT PAYROLL,D107,HJ,,17.57,85983.17
6150,8/31/2020,8/31/2020,82L-PRPD-083120,Reverse 82L payroll of 83120 JE-21-0021-IMPORT PAYROLL,D107,HJ,,17.57,85965.6
6150,8/31/2020,8/31/2020,82L-PRPD-083120,Reverse 82L payroll of 83120 JE-21-0021-IMPORT PAYROLL,D107,HJ,,17.71,85947.89
6150,8/31/2020,8/31/2020,82L-PRPD-083120,Reverse 82L payroll of 83120 JE-21-0021-IMPORT PAYROLL,D107,HJ,,20.14,85927.75
6150,8/31/2020,8/31/2020,82L-PRPD-083120,Reverse 82L payroll of 83120 JE-21-0021-IMPORT PAYROLL,D107,HJ,,21.41,85906.34
6150,8/31/2020,8/31/2020,82L-PRPD-083120,Reverse 82L payroll of 83120 JE-21-0021-IMPORT PAYROLL,D107,HJ,,23.29,85883.05
6150,8/31/2020,8/31/2020,82L-PRPD-083120,Reverse 82L payroll of 83120 JE-21-0021-IMPORT PAYROLL,D107,HJ,,25.1,85857.95
6150,8/31/2020,8/31/2020,82L-PRPD-083120,Reverse 82L payroll of 83120 JE-21-0021-IMPORT PAYROLL,D107,HJ,,26.08,85831.87
6150,8/31/2020,8/31/2020,82L-PRPD-083120,Reverse 82L payroll of 83120 JE-21-0021-IMPORT PAYROLL,D107,HJ,,26.16,85805.71
6150,8/31/2020,8/31/2020,82L-PRPD-083120,Reverse 82L payroll of 83120 JE-21-0021-IMPORT PAYROLL,D107,HJ,,26.16,85779.55
6150,8/31/2020,8/31/2020,82L-PRPD-083120,Reverse 82L payroll of 83120 JE-21-0021-IMPORT PAYROLL,D107,HJ,,26.21,85753.34
6150,8/31/2020,8/31/2020,82L-PRPD-083120,Reverse 82L payroll of 83120 JE-21-0021-IMPORT PAYROLL,D107,HJ,,26.3,85727.04
6150,8/31/2020,8/31/2020,82L-PRPD-083120,Reverse 82L payroll of 83120 JE-21-0021-IMPORT PAYROLL,D107,HJ,,26.53,85700.51
6150,8/31/2020,8/31/2020,82L-PRPD-083120,Reverse 82L payroll of 83120 JE-21-0021-IMPORT PAYROLL,D107,HJ,,27.79,85672.72
6150,8/31/2020,8/31/2020,82L-PRPD-083120,Reverse 82L payroll of 83120 JE-21-0021-IMPORT PAYROLL,D107,HJ,,27.79,85644.93
6150,8/31/2020,8/31/2020,82L-PRPD-083120,Reverse 82L payroll of 83120 JE-21-0021-IMPORT PAYROLL,D107,HJ,,27.89,85617.04
6150,8/31/2020,8/31/2020,82L-PRPD-083120,Reverse 82L payroll of 83120 JE-21-0021-IMPORT PAYROLL,D107,HJ,,28.29,85588.75
6150,8/31/2020,8/31/2020,82L-PRPD-083120,Reverse 82L payroll of 83120 JE-21-0021-IMPORT PAYROLL,D107,HJ,,28.29,85560.46
6150,8/31/2020,8/31/2020,82L-PRPD-083120,Reverse 82L payroll of 83120 JE-21-0021-IMPORT PAYROLL,D107,HJ,,28.29,85532.17
6150,8/31/2020,8/31/2020,82L-PRPD-083120,Reverse 82L payroll of 83120 JE-21-0021-IMPORT PAYROLL,D107,HJ,,28.29,85503.88
6150,8/31/2020,8/31/2020,82L-PRPD-083120,Reverse 82L payroll of 83120 JE-21-0021-IMPORT PAYROLL,D107,HJ,,29,85474.88
6150,8/31/2020,8/31/2020,82L-PRPD-083120,Reverse 82L payroll of 83120 JE-21-0021-IMPORT PAYROLL,D107,HJ,,29.98,85444.9
6150,8/31/2020,8/31/2020,82L-PRPD-083120,Reverse 82L payroll of 83120 JE-21-0021-IMPORT PAYROLL,D107,HJ,,31.18,85413.72
6150,8/31/2020,8/31/2020,82L-PRPD-083120,Reverse 82L payroll of 83120 JE-21-0021-IMPORT PAYROLL,D107,HJ,,33.51,85380.21
6150,8/31/2020,8/31/2020,82L-PRPD-083120,Reverse 82L payroll of 83120 JE-21-0021-IMPORT PAYROLL,D107,HJ,,33.58,85346.63
6150,8/31/2020,8/31/2020,82L-PRPD-083120,Reverse 82L payroll of 83120 JE-21-0021-IMPORT PAYROLL,D107,HJ,,34.63,85312
6150,8/31/2020,8/31/2020,82L-PRPD-083120,Reverse 82L payroll of 83120 JE-21-0021-IMPORT PAYROLL,D107,HJ,,34.63,85277.37
6150,8/31/2020,8/31/2020,82L-PRPD-083120,Reverse 82L payroll of 83120 JE-21-0021-IMPORT PAYROLL,D107,HJ,,36.67,85240.7
6150,8/31/2020,8/31/2020,82L-PRPD-083120,Reverse 82L payroll of 83120 JE-21-0021-IMPORT PAYROLL,D107,HJ,,36.67,85204.03
6150,8/31/2020,8/31/2020,82L-PRPD-083120,Reverse 82L payroll of 83120 JE-21-0021-IMPORT PAYROLL,D107,HJ,,36.67,85167.36
6150,8/31/2020,8/31/2020,82L-PRPD-083120,Reverse 82L payroll of 83120 JE-21-0021-IMPORT PAYROLL,D107,HJ,,36.85,85130.51
6150,8/31/2020,8/31/2020,82L-PRPD-083120,Reverse 82L payroll of 83120 JE-21-0021-IMPORT PAYROLL,D107,HJ,,38.11,85092.4
6150,8/31/2020,8/31/2020,82L-PRPD-083120,Reverse 82L payroll of 83120 JE-21-0021-IMPORT PAYROLL,D107,HJ,,39.26,85053.14
6150,8/31/2020,8/31/2020,82L-PRPD-083120,Reverse 82L payroll of 83120 JE-21-0021-IMPORT PAYROLL,D107,HJ,,39.27,85013.87
6150,8/31/2020,8/31/2020,82L-PRPD-083120,Reverse 82L payroll of 83120 JE-21-0021-IMPORT PAYROLL,D107,HJ,,39.88,84973.99
6150,8/31/2020,8/31/2020,82L-PRPD-083120,Reverse 82L payroll of 83120 JE-21-0021-IMPORT PAYROLL,D107,HJ,,39.93,84934.06
6150,8/31/2020,8/31/2020,82L-PRPD-083120,Reverse 82L payroll of 83120 JE-21-0021-IMPORT PAYROLL,D107,HJ,,41.08,84892.98
6150,8/31/2020,8/31/2020,82L-PRPD-083120,Reverse 82L payroll of 83120 JE-21-0021-IMPORT PAYROLL,D107,HJ,,42.29,84850.69
6150,8/31/2020,8/31/2020,82L-PRPD-083120,Reverse 82L payroll of 83120 JE-21-0021-IMPORT PAYROLL,D107,HJ,,44.27,84806.42
6150,8/31/2020,8/31/2020,82L-PRPD-083120,Reverse 82L payroll of 83120 JE-21-0021-IMPORT PAYROLL,D107,HJ,,49.84,84756.58
6150,8/31/2020,8/31/2020,82L-PRPD-083120,Reverse 82L payroll of 83120 JE-21-0021-IMPORT PAYROLL,D107,HJ,,49.87,84706.71
6150,8/31/2020,8/31/2020,82L-PRPD-083120,Reverse 82L payroll of 83120 JE-21-0021-IMPORT PAYROLL,D107,HJ,,50.63,84656.08
6150,8/31/2020,8/31/2020,82L-PRPD-083120,Reverse 82L payroll of 83120 JE-21-0021-IMPORT PAYROLL,D107,HJ,,52.1,84603.98
6150,8/31/2020,8/31/2020,82L-PRPD-083120,Reverse 82L payroll of 83120 JE-21-0021-IMPORT PAYROLL,D107,HJ,,52.29,84551.69
6150,8/31/2020,8/31/2020,82L-PRPD-083120,Reverse 82L payroll of 83120 JE-21-0021-IMPORT PAYROLL,D107,HJ,,59.89,84491.8
6150,8/31/2020,8/31/2020,82L-PRPD-083120,Reverse 82L payroll of 83120 JE-21-0021-IMPORT PAYROLL,D107,HJ,,59.89,84431.91
6150,8/31/2020,8/31/2020,82L-PRPD-083120,Reverse 82L payroll of 83120 JE-21-0021-IMPORT PAYROLL,D107,HJ,,60.07,84371.84
6150,8/31/2020,8/31/2020,82L-PRPD-083120,Reverse 82L payroll of 83120 JE-21-0021-IMPORT PAYROLL,D107,HJ,,60.07,84311.77
6150,8/31/2020,8/31/2020,82L-PRPD-083120,Reverse 82L payroll of 83120 JE-21-0021-IMPORT PAYROLL,D107,HJ,,60.18,84251.59
6150,8/31/2020,8/31/2020,82L-PRPD-083120,Reverse 82L payroll of 83120 JE-21-0021-IMPORT PAYROLL,D107,HJ,,60.92,84190.67
6150,8/31/2020,8/31/2020,82L-PRPD-083120,Reverse 82L payroll of 83120 JE-21-0021-IMPORT PAYROLL,D107,HJ,,62.53,84128.14
6150,8/31/2020,8/31/2020,82L-PRPD-083120,Reverse 82L payroll of 83120 JE-21-0021-IMPORT PAYROLL,D107,HJ,,62.62,84065.52
6150,8/31/2020,8/31/2020,82L-PRPD-083120,Reverse 82L payroll of 83120 JE-21-0021-IMPORT PAYROLL,D107,HJ,,64.03,84001.49
6150,8/31/2020,8/31/2020,82L-PRPD-083120,Reverse 82L payroll of 83120 JE-21-0021-IMPORT PAYROLL,D107,HJ,,64.48,83937.01
6150,8/31/2020,8/31/2020,82L-PRPD-083120,Reverse 82L payroll of 83120 JE-21-0021-IMPORT PAYROLL,D107,HJ,,64.48,83872.53
6150,8/31/2020,8/31/2020,82L-PRPD-083120,Reverse 82L payroll of 83120 JE-21-0021-IMPORT PAYROLL,D107,HJ,,64.58,83807.95
6150,8/31/2020,8/31/2020,82L-PRPD-083120,Reverse 82L payroll of 83120 JE-21-0021-IMPORT PAYROLL,D107,HJ,,64.95,83743
6150,8/31/2020,8/31/2020,82L-PRPD-083120,Reverse 82L payroll of 83120 JE-21-0021-IMPORT PAYROLL,D107,HJ,,64.95,83678.05
6150,8/31/2020,8/31/2020,82L-PRPD-083120,Reverse 82L payroll of 83120 JE-21-0021-IMPORT PAYROLL,D107,HJ,,64.95,83613.1
6150,8/31/2020,8/31/2020,82L-PRPD-083120,Reverse 82L payroll of 83120 JE-21-0021-IMPORT PAYROLL,D107,HJ,,64.95,83548.15
6150,8/31/2020,8/31/2020,82L-PRPD-083120,Reverse 82L payroll of 83120 JE-21-0021-IMPORT PAYROLL,D107,HJ,,64.95,83483.2
6150,8/31/2020,8/31/2020,82L-PRPD-083120,Reverse 82L payroll of 83120 JE-21-0021-IMPORT PAYROLL,D107,HJ,,64.95,83418.25
6150,8/31/2020,8/31/2020,82L-PRPD-083120,Reverse 82L payroll of 83120 JE-21-0021-IMPORT PAYROLL,D107,HJ,,64.95,83353.3
6150,8/31/2020,8/31/2020,82L-PRPD-083120,Reverse 82L payroll of 83120 JE-21-0021-IMPORT PAYROLL,D107,HJ,,64.95,83288.35
6150,8/31/2020,8/31/2020,82L-PRPD-083120,Reverse 82L payroll of 83120 JE-21-0021-IMPORT PAYROLL,D107,HJ,,64.95,83223.4
6150,8/31/2020,8/31/2020,82L-PRPD-083120,Reverse 82L payroll of 83120 JE-21-0021-IMPORT PAYROLL,D107,HJ,,64.95,83158.45
6150,8/31/2020,8/31/2020,82L-PRPD-083120,Reverse 82L payroll of 83120 JE-21-0021-IMPORT PAYROLL,D107,HJ,,64.95,83093.5
6150,8/31/2020,8/31/2020,82L-PRPD-083120,Reverse 82L payroll of 83120 JE-21-0021-IMPORT PAYROLL,D107,HJ,,64.95,83028.55
6150,8/31/2020,8/31/2020,82L-PRPD-083120,Reverse 82L payroll of 83120 JE-21-0021-IMPORT PAYROLL,D107,HJ,,64.95,82963.6
6150,8/31/2020,8/31/2020,82L-PRPD-083120,Reverse 82L payroll of 83120 JE-21-0021-IMPORT PAYROLL,D107,HJ,,64.95,82898.65
6150,8/31/2020,8/31/2020,82L-PRPD-083120,Reverse 82L payroll of 83120 JE-21-0021-IMPORT PAYROLL,D107,HJ,,64.95,82833.7
6150,8/31/2020,8/31/2020,82L-PRPD-083120,Reverse 82L payroll of 83120 JE-21-0021-IMPORT PAYROLL,D107,HJ,,64.95,82768.75
6150,8/31/2020,8/31/2020,82L-PRPD-083120,Reverse 82L payroll of 83120 JE-21-0021-IMPORT PAYROLL,D107,HJ,,64.95,82703.8
6150,8/31/2020,8/31/2020,82L-PRPD-083120,Reverse 82L payroll of 83120 JE-21-0021-IMPORT PAYROLL,D107,HJ,,64.95,82638.85
6150,8/31/2020,8/31/2020,82L-PRPD-083120,Reverse 82L payroll of 83120 JE-21-0021-IMPORT PAYROLL,D107,HJ,,68.63,82570.22
6150,8/31/2020,8/31/2020,82L-PRPD-083120,Reverse 82L payroll of 83120 JE-21-0021-IMPORT PAYROLL,D107,HJ,,75.71,82494.51
6150,8/31/2020,8/31/2020,82L-PRPD-083120,Reverse 82L payroll of 83120 JE-21-0021-IMPORT PAYROLL,D107,HJ,,76.5,82418.01
6150,8/31/2020,8/31/2020,82L-PRPD-083120,Reverse 82L payroll of 83120 JE-21-0021-IMPORT PAYROLL,D107,HJ,,76.5,82341.51
6150,8/31/2020,8/31/2020,82L-PRPD-083120,Reverse 82L payroll of 83120 JE-21-0021-IMPORT PAYROLL,D107,HJ,,78.57,82262.94
6150,8/31/2020,8/31/2020,82L-PRPD-083120,Reverse 82L payroll of 83120 JE-21-0021-IMPORT PAYROLL,D107,HJ,,88.74,82174.2
6150,8/31/2020,8/31/2020,82L-PRPD-083120,Reverse 82L payroll of 83120 JE-21-0021-IMPORT PAYROLL,D107,HJ,,91.57,82082.63
6150,8/31/2020,8/31/2020,82L-PRPD-083120,Reverse 82L payroll of 83120 JE-21-0021-IMPORT PAYROLL,D107,HJ,,99.58,81983.05
6150,8/31/2020,8/31/2020,82L-PRPD-083120,Reverse 82L payroll of 83120 JE-21-0021-IMPORT PAYROLL,D107,HJ,,107.33,81875.72
6150,8/31/2020,8/31/2020,82L-PRPD-083120,Reverse 82L payroll of 83120 JE-21-0021-IMPORT PAYROLL,D107,HJ,,112.45,81763.27
6150,8/31/2020,8/31/2020,82L-PRPD-083120,Reverse 82L payroll of 83120 JE-21-0021-IMPORT PAYROLL,D107,HJ,,114.45,81648.82
6150,8/31/2020,8/31/2020,82L-PRPD-083120,Reverse 82L payroll of 83120 JE-21-0021-IMPORT PAYROLL,D107,HJ,,118.83,81529.99
6150,8/31/2020,8/31/2020,82L-PRPD-083120,Reverse 82L payroll of 83120 JE-21-0021-IMPORT PAYROLL,D107,HJ,,118.83,81411.16
6150,8/31/2020,8/31/2020,82L-PRPD-083120,Reverse 82L payroll of 83120 JE-21-0021-IMPORT PAYROLL,D107,HJ,,124,81287.16
6150,8/31/2020,8/31/2020,82L-PRPD-083120,Reverse 82L payroll of 83120 JE-21-0021-IMPORT PAYROLL,D107,HJ,,133.3,81153.86
6150,8/31/2020,8/31/2020,82L-PRPD-083120,Reverse 82L payroll of 83120 JE-21-0021-IMPORT PAYROLL,D107,HJ,,143.3,81010.56
6150,8/31/2020,8/31/2020,82L-PRPD-083120,Reverse 82L payroll of 83120 JE-21-0021-IMPORT PAYROLL,D107,HJ,,143.59,80866.97
6150,8/31/2020,8/31/2020,82L-PRPD-083120,Reverse 82L payroll of 83120 JE-21-0021-IMPORT PAYROLL,D107,HJ,,148.06,80718.91
6150,8/31/2020,8/31/2020,82L-PRPD-083120,Reverse 82L payroll of 83120 JE-21-0021-IMPORT PAYROLL,D107,HJ,,148.06,80570.85
6150,8/31/2020,8/31/2020,82L-PRPD-083120,Reverse 82L payroll of 83120 JE-21-0021-IMPORT PAYROLL,D107,HJ,,157.58,80413.27
6150,8/31/2020,8/31/2020,82L-PRPD-083120,Reverse 82L payroll of 83120 JE-21-0021-IMPORT PAYROLL,D107,HJ,,162.94,80250.33
6150,8/31/2020,8/31/2020,82L-PRPD-083120,Reverse 82L payroll of 83120 JE-21-0021-IMPORT PAYROLL,D107,HJ,,167.87,80082.46
6150,8/31/2020,8/31/2020,82L-PRPD-083120,Reverse 82L payroll of 83120 JE-21-0021-IMPORT PAYROLL,D107,HJ,,167.92,79914.54
6150,8/31/2020,8/31/2020,82L-PRPD-083120,Reverse 82L payroll of 83120 JE-21-0021-IMPORT PAYROLL,D107,HJ,,170.75,79743.79
6150,8/31/2020,8/31/2020,82L-PRPD-083120,Reverse 82L payroll of 83120 JE-21-0021-IMPORT PAYROLL,D107,HJ,,175.67,79568.12
6150,8/31/2020,8/31/2020,82L-PRPD-083120,Reverse 82L payroll of 83120 JE-21-0021-IMPORT PAYROLL,D107,HJ,,180.83,79387.29
6150,8/31/2020,8/31/2020,82L-PRPD-083120,Reverse 82L payroll of 83120 JE-21-0021-IMPORT PAYROLL,D107,HJ,,213.13,79174.16
6150,8/31/2020,8/31/2020,82L-PRPD-083120,Reverse 82L payroll of 83120 JE-21-0021-IMPORT PAYROLL,D107,HJ,,213.25,78960.91
6150,8/31/2020,8/31/2020,82L-PRPD-083120,Reverse 82L payroll of 83120 JE-21-0021-IMPORT PAYROLL,D107,HJ,,223.58,78737.33
6150,8/31/2020,8/31/2020,82L-PRPD-083120,Reverse 82L payroll of 83120 JE-21-0021-IMPORT PAYROLL,D107,HJ,,335.97,78401.36
6150,8/31/2020,8/31/2020,82L-PRPD-083120,Reverse 82L payroll of 83120 JE-21-0021-IMPORT PAYROLL,D107,HJ,,379.45,78021.91
6150,8/31/2020,8/31/2020,82L-PRPD-083120,Reverse 82L payroll of 83120 JE-21-0021-IMPORT PAYROLL,D108,HJ,,35.7,77986.21
6150,8/31/2020,8/31/2020,82L-PRPD-083120,Reverse 82L payroll of 83120 JE-21-0021-IMPORT PAYROLL,D108,HJ,,37.96,77948.25
6150,8/31/2020,8/31/2020,82L-PRPD-083120,Reverse 82L payroll of 83120 JE-21-0021-IMPORT PAYROLL,D108,HJ,,152.64,77795.61
6150,8/31/2020,8/31/2020,82L-PRPD-083120,Reverse 82L payroll of 83120 JE-21-0021-IMPORT PAYROLL,D108,HJ,,162.32,77633.29
6150,8/31/2020,8/31/2020,82L-PRPD-083120,82L-PRPD-083120 -IMPORT PAYROLL-ARCHER AUBREYNA,D108,HJ,39.86,,77673.15
6150,8/31/2020,8/31/2020,82L-PRPD-083120,82L-PRPD-083120 -IMPORT PAYROLL-ARCHER AUBREYNA,D108,HJ,170.44,,77843.59
6150,8/31/2020,8/31/2020,82L-PRPD-083120,82L-PRPD-083120 -IMPORT PAYROLL-BARTOLD DEANNA MARIE,D108,HJ,41.91,,77885.5
6150,8/31/2020,8/31/2020,82L-PRPD-083120,82L-PRPD-083120 -IMPORT PAYROLL-BARTOLD DEANNA MARIE,D108,HJ,179.22,,78064.72
6150,8/31/2020,8/31/2020,82L-PRPD-083120,82L-PRPD-083120 -IMPORT PAYROLL-BELLOT GENESIS,D108,HJ,31.93,,78096.65
6150,8/31/2020,8/31/2020,82L-PRPD-083120,82L-PRPD-083120 -IMPORT PAYROLL-BELLOT GENESIS,D108,HJ,136.53,,78233.18
6150,8/31/2020,8/31/2020,82L-PRPD-083120,82L-PRPD-083120 -IMPORT PAYROLL-CIRKER MIA,D108,HJ,32.63,,78265.81
6150,8/31/2020,8/31/2020,82L-PRPD-083120,82L-PRPD-083120 -IMPORT PAYROLL-CIRKER MIA,D108,HJ,139.5,,78405.31
6150,8/31/2020,8/31/2020,82L-PRPD-083120,82L-PRPD-083120 -IMPORT PAYROLL-CORTEZ MIRANDA A,D111,HJ,38.45,,78443.76
6150,8/31/2020,8/31/2020,82L-PRPD-083120,82L-PRPD-083120 -IMPORT PAYROLL-CORTEZ MIRANDA A,D111,HJ,164.42,,78608.18
6150,8/31/2020,8/31/2020,82L-PRPD-083120,82L-PRPD-083120 -IMPORT PAYROLL-FEIGHERY JOHN,D108,HJ,30.56,,78638.74
6150,8/31/2020,8/31/2020,82L-PRPD-083120,82L-PRPD-083120 -IMPORT PAYROLL-FEIGHERY JOHN,D108,HJ,130.69,,78769.43
6150,8/31/2020,8/31/2020,82L-PRPD-083120,82L-PRPD-083120 -IMPORT PAYROLL-GARCIA MARILYN,D108,HJ,33.23,,78802.66
6150,8/31/2020,8/31/2020,82L-PRPD-083120,82L-PRPD-083120 -IMPORT PAYROLL-GARCIA MARILYN,D108,HJ,142.08,,78944.74
6150,8/31/2020,8/31/2020,82L-PRPD-083120,82L-PRPD-083120 -IMPORT PAYROLL-GRIFFIN ANDREW,D108,HJ,30.44,,78975.18
6150,8/31/2020,8/31/2020,82L-PRPD-083120,82L-PRPD-083120 -IMPORT PAYROLL-GRIFFIN ANDREW,D108,HJ,130.16,,79105.34
6150,8/31/2020,8/31/2020,82L-PRPD-083120,82L-PRPD-083120 -IMPORT PAYROLL-HALLINAN GABRIEL B,D108,HJ,34.79,,79140.13
6150,8/31/2020,8/31/2020,82L-PRPD-083120,82L-PRPD-083120 -IMPORT PAYROLL-HALLINAN GABRIEL B,D108,HJ,148.76,,79288.89
6150,8/31/2020,8/31/2020,82L-PRPD-083120,82L-PRPD-083120 -IMPORT PAYROLL-HOLDER LATIVA M,D108,HJ,55.28,,79344.17
6150,8/31/2020,8/31/2020,82L-PRPD-083120,82L-PRPD-083120 -IMPORT PAYROLL-HOLDER LATIVA M,D108,HJ,236.38,,79580.55
6150,8/31/2020,8/31/2020,82L-PRPD-083120,82L-PRPD-083120 -IMPORT PAYROLL-HOSSAIN MYESHA R,D108,HJ,35.1,,79615.65
6150,8/31/2020,8/31/2020,82L-PRPD-083120,82L-PRPD-083120 -IMPORT PAYROLL-HOSSAIN MYESHA R,D108,HJ,150.1,,79765.75
6150,8/31/2020,8/31/2020,82L-PRPD-083120,82L-PRPD-083120 -IMPORT PAYROLL-JACKSON TASNIM F,D108,HJ,31,,79796.75
6150,8/31/2020,8/31/2020,82L-PRPD-083120,82L-PRPD-083120 -IMPORT PAYROLL-JACKSON TASNIM F,D108,HJ,132.56,,79929.31
6150,8/31/2020,8/31/2020,82L-PRPD-083120,82L-PRPD-083120 -IMPORT PAYROLL-LI BELLA,D108,HJ,33.96,,79963.27
6150,8/31/2020,8/31/2020,82L-PRPD-083120,82L-PRPD-083120 -IMPORT PAYROLL-LI BELLA,D108,HJ,145.23,,80108.5
6150,8/31/2020,8/31/2020,82L-PRPD-083120,82L-PRPD-083120 -IMPORT PAYROLL-MOSELEY ARIELLE,D108,HJ,37.83,,80146.33
6150,8/31/2020,8/31/2020,82L-PRPD-083120,82L-PRPD-083120 -IMPORT PAYROLL-MOSELEY ARIELLE,D108,HJ,161.75,,80308.08
6150,8/31/2020,8/31/2020,82L-PRPD-083120,82L-PRPD-083120 -IMPORT PAYROLL-TILLERY ASIA,D108,HJ,47.73,,80355.81
6150,8/31/2020,8/31/2020,82L-PRPD-083120,82L-PRPD-083120 -IMPORT PAYROLL-TILLERY ASIA,D108,HJ,204.08,,80559.89
6150,8/31/2020,8/31/2020,82L-PRPD-083120,Reverse 82L payroll of 83120 JE-21-0021-IMPORT PAYROLL,D108,HJ,,30.44,80529.45
6150,8/31/2020,8/31/2020,82L-PRPD-083120,Reverse 82L payroll of 83120 JE-21-0021-IMPORT PAYROLL,D108,HJ,,30.56,80498.89
6150,8/31/2020,8/31/2020,82L-PRPD-083120,Reverse 82L payroll of 83120 JE-21-0021-IMPORT PAYROLL,D108,HJ,,31,80467.89
6150,8/31/2020,8/31/2020,82L-PRPD-083120,Reverse 82L payroll of 83120 JE-21-0021-IMPORT PAYROLL,D108,HJ,,31.93,80435.96
6150,8/31/2020,8/31/2020,82L-PRPD-083120,Reverse 82L payroll of 83120 JE-21-0021-IMPORT PAYROLL,D108,HJ,,32.63,80403.33
6150,8/31/2020,8/31/2020,82L-PRPD-083120,Reverse 82L payroll of 83120 JE-21-0021-IMPORT PAYROLL,D108,HJ,,33.23,80370.1
6150,8/31/2020,8/31/2020,82L-PRPD-083120,Reverse 82L payroll of 83120 JE-21-0021-IMPORT PAYROLL,D108,HJ,,33.96,80336.14
6150,8/31/2020,8/31/2020,82L-PRPD-083120,Reverse 82L payroll of 83120 JE-21-0021-IMPORT PAYROLL,D108,HJ,,34.79,80301.35
6150,8/31/2020,8/31/2020,82L-PRPD-083120,Reverse 82L payroll of 83120 JE-21-0021-IMPORT PAYROLL,D108,HJ,,35.1,80266.25
6150,8/31/2020,8/31/2020,82L-PRPD-083120,Reverse 82L payroll of 83120 JE-21-0021-IMPORT PAYROLL,D108,HJ,,37.83,80228.42
6150,8/31/2020,8/31/2020,82L-PRPD-083120,Reverse 82L payroll of 83120 JE-21-0021-IMPORT PAYROLL,D108,HJ,,39.86,80188.56
6150,8/31/2020,8/31/2020,82L-PRPD-083120,Reverse 82L payroll of 83120 JE-21-0021-IMPORT PAYROLL,D108,HJ,,41.91,80146.65
6150,8/31/2020,8/31/2020,82L-PRPD-083120,Reverse 82L payroll of 83120 JE-21-0021-IMPORT PAYROLL,D108,HJ,,47.73,80098.92
6150,8/31/2020,8/31/2020,82L-PRPD-083120,Reverse 82L payroll of 83120 JE-21-0021-IMPORT PAYROLL,D108,HJ,,55.28,80043.64
6150,8/31/2020,8/31/2020,82L-PRPD-083120,Reverse 82L payroll of 83120 JE-21-0021-IMPORT PAYROLL,D108,HJ,,130.16,79913.48
6150,8/31/2020,8/31/2020,82L-PRPD-083120,Reverse 82L payroll of 83120 JE-21-0021-IMPORT PAYROLL,D108,HJ,,130.69,79782.79
6150,8/31/2020,8/31/2020,82L-PRPD-083120,Reverse 82L payroll of 83120 JE-21-0021-IMPORT PAYROLL,D108,HJ,,132.56,79650.23
6150,8/31/2020,8/31/2020,82L-PRPD-083120,Reverse 82L payroll of 83120 JE-21-0021-IMPORT PAYROLL,D108,HJ,,136.53,79513.7
6150,8/31/2020,8/31/2020,82L-PRPD-083120,Reverse 82L payroll of 83120 JE-21-0021-IMPORT PAYROLL,D108,HJ,,139.5,79374.2
6150,8/31/2020,8/31/2020,82L-PRPD-083120,Reverse 82L payroll of 83120 JE-21-0021-IMPORT PAYROLL,D108,HJ,,142.08,79232.12
6150,8/31/2020,8/31/2020,82L-PRPD-083120,Reverse 82L payroll of 83120 JE-21-0021-IMPORT PAYROLL,D108,HJ,,145.23,79086.89
6150,8/31/2020,8/31/2020,82L-PRPD-083120,Reverse 82L payroll of 83120 JE-21-0021-IMPORT PAYROLL,D108,HJ,,148.76,78938.13
6150,8/31/2020,8/31/2020,82L-PRPD-083120,Reverse 82L payroll of 83120 JE-21-0021-IMPORT PAYROLL,D108,HJ,,150.1,78788.03
6150,8/31/2020,8/31/2020,82L-PRPD-083120,Reverse 82L payroll of 83120 JE-21-0021-IMPORT PAYROLL,D108,HJ,,161.75,78626.28
6150,8/31/2020,8/31/2020,82L-PRPD-083120,Reverse 82L payroll of 83120 JE-21-0021-IMPORT PAYROLL,D108,HJ,,170.44,78455.84
6150,8/31/2020,8/31/2020,82L-PRPD-083120,Reverse 82L payroll of 83120 JE-21-0021-IMPORT PAYROLL,D108,HJ,,179.22,78276.62
6150,8/31/2020,8/31/2020,82L-PRPD-083120,Reverse 82L payroll of 83120 JE-21-0021-IMPORT PAYROLL,D108,HJ,,204.08,78072.54
6150,8/31/2020,8/31/2020,82L-PRPD-083120,Reverse 82L payroll of 83120 JE-21-0021-IMPORT PAYROLL,D108,HJ,,236.38,77836.16
6150,8/31/2020,8/31/2020,82L-PRPD-083120,Reverse 82L payroll of 83120 JE-21-0021-IMPORT PAYROLL,D111,HJ,,38.45,77797.71
6150,8/31/2020,8/31/2020,82L-PRPD-083120,Reverse 82L payroll of 83120 JE-21-0021-IMPORT PAYROLL,D111,HJ,,164.42,77633.29
6150,8/31/2020,8/31/2020,82L-PRPD-083120,82L-PRPD-083120 -IMPORT PAYROLL-BALASUBRAMANIAN SHARANYA,D108,HJ,38.67,,77671.96
6150,8/31/2020,8/31/2020,82L-PRPD-083120,82L-PRPD-083120 -IMPORT PAYROLL-BALASUBRAMANIAN SHARANYA,D108,HJ,58.33,,77730.29
6150,8/31/2020,8/31/2020,82L-PRPD-083120,82L-PRPD-083120 -IMPORT PAYROLL-BALASUBRAMANIAN SHARANYA,D108,HJ,165.33,,77895.62
6150,8/31/2020,8/31/2020,82L-PRPD-083120,82L-PRPD-083120 -IMPORT PAYROLL-COVENEY ALLISON,D108,HJ,38.07,,77933.69
6150,8/31/2020,8/31/2020,82L-PRPD-083120,82L-PRPD-083120 -IMPORT PAYROLL-COVENEY ALLISON,D108,HJ,162.79,,78096.48
6150,8/31/2020,8/31/2020,82L-PRPD-083120,82L-PRPD-083120 -IMPORT PAYROLL-JACKSON CLAICE M,D108,HJ,19.38,,78115.86
6150,8/31/2020,8/31/2020,82L-PRPD-083120,82L-PRPD-083120 -IMPORT PAYROLL-JACKSON CLAICE M,D108,HJ,42.91,,78158.77
6150,8/31/2020,8/31/2020,82L-PRPD-083120,82L-PRPD-083120 -IMPORT PAYROLL-JACKSON CLAICE M,D108,HJ,183.48,,78342.25
6150,8/31/2020,8/31/2020,82L-PRPD-083120,82L-PRPD-083120 -IMPORT PAYROLL-JANG DANIEL,D108,HJ,37.75,,78380
6150,8/31/2020,8/31/2020,82L-PRPD-083120,82L-PRPD-083120 -IMPORT PAYROLL-JANG DANIEL,D108,HJ,161.4,,78541.4
6150,8/31/2020,8/31/2020,82L-PRPD-083120,82L-PRPD-083120 -IMPORT PAYROLL-LENEGHAN MARYELLEN B,D108,HJ,23.64,,78565.04
6150,8/31/2020,8/31/2020,82L-PRPD-083120,82L-PRPD-083120 -IMPORT PAYROLL-LENEGHAN MARYELLEN B,D108,HJ,53.2,,78618.24
6150,8/31/2020,8/31/2020,82L-PRPD-083120,82L-PRPD-083120 -IMPORT PAYROLL-LENEGHAN MARYELLEN B,D108,HJ,227.46,,78845.7
6150,8/31/2020,8/31/2020,82L-PRPD-083120,Reverse 82L payroll of 83120 JE-21-0021-IMPORT PAYROLL,D108,HJ,,19.38,78826.32
6150,8/31/2020,8/31/2020,82L-PRPD-083120,Reverse 82L payroll of 83120 JE-21-0021-IMPORT PAYROLL,D108,HJ,,23.64,78802.68
6150,8/31/2020,8/31/2020,82L-PRPD-083120,Reverse 82L payroll of 83120 JE-21-0021-IMPORT PAYROLL,D108,HJ,,37.75,78764.93
6150,8/31/2020,8/31/2020,82L-PRPD-083120,Reverse 82L payroll of 83120 JE-21-0021-IMPORT PAYROLL,D108,HJ,,38.07,78726.86
6150,8/31/2020,8/31/2020,82L-PRPD-083120,Reverse 82L payroll of 83120 JE-21-0021-IMPORT PAYROLL,D108,HJ,,38.67,78688.19
6150,8/31/2020,8/31/2020,82L-PRPD-083120,Reverse 82L payroll of 83120 JE-21-0021-IMPORT PAYROLL,D108,HJ,,42.91,78645.28
6150,8/31/2020,8/31/2020,82L-PRPD-083120,Reverse 82L payroll of 83120 JE-21-0021-IMPORT PAYROLL,D108,HJ,,53.2,78592.08
6150,8/31/2020,8/31/2020,82L-PRPD-083120,Reverse 82L payroll of 83120 JE-21-0021-IMPORT PAYROLL,D108,HJ,,58.33,78533.75
6150,8/31/2020,8/31/2020,82L-PRPD-083120,Reverse 82L payroll of 83120 JE-21-0021-IMPORT PAYROLL,D108,HJ,,161.4,78372.35
6150,8/31/2020,8/31/2020,82L-PRPD-083120,Reverse 82L payroll of 83120 JE-21-0021-IMPORT PAYROLL,D108,HJ,,162.79,78209.56
6150,8/31/2020,8/31/2020,82L-PRPD-083120,Reverse 82L payroll of 83120 JE-21-0021-IMPORT PAYROLL,D108,HJ,,165.33,78044.23
6150,8/31/2020,8/31/2020,82L-PRPD-083120,Reverse 82L payroll of 83120 JE-21-0021-IMPORT PAYROLL,D108,HJ,,183.48,77860.75
6150,8/31/2020,8/31/2020,82L-PRPD-083120,Reverse 82L payroll of 83120 JE-21-0021-IMPORT PAYROLL,D108,HJ,,227.46,77633.29
6150,8/31/2020,8/31/2020,Reallocation to GM3 - ACY2,To reallocate Salaraies to GM3 - ACY2-To reallocate salaries to GM3 - ACY2 ( Wallace Stephen Odonells Lacey Dequita),D104,HJ,1096.24,,78729.53
6150,8/31/2020,8/31/2020,Reallocation to GM3 - ACY2,To reverse JE-21-0053-To reverse reallocation of salaries to GM3 - ACY2,D104,HJ,,1096.24,77633.29
6150,9/15/2020,9/15/2020,91520,82L-IMPORT PAYROLL-ALVAREZ-MORINE LISIS,D108,HJ,34.63,,77667.92
6150,9/15/2020,9/15/2020,91520,82L-IMPORT PAYROLL-ALVAREZ-MORINE LISIS,D108,HJ,148.06,,77815.98
6150,9/15/2020,9/15/2020,91520,82L-IMPORT PAYROLL-ALWARDT CALEB,D108,HJ,15.19,,77831.17
6150,9/15/2020,9/15/2020,91520,82L-IMPORT PAYROLL-ALWARDT CALEB,D108,HJ,64.95,,77896.12
6150,9/15/2020,9/15/2020,91520,82L-IMPORT PAYROLL-BARTHELEMY RACHALIE,D108,HJ,14.01,,77910.13
6150,9/15/2020,9/15/2020,91520,82L-IMPORT PAYROLL-BARTHELEMY RACHALIE,D108,HJ,26.08,,77936.21
6150,9/15/2020,9/15/2020,91520,82L-IMPORT PAYROLL-BARTHELEMY RACHALIE,D108,HJ,59.89,,77996.1
6150,9/15/2020,9/15/2020,91520,82L-IMPORT PAYROLL-BASHAM WILLIAM EDWARD,D108,HJ,14.06,,78010.16
6150,9/15/2020,9/15/2020,91520,82L-IMPORT PAYROLL-BASHAM WILLIAM EDWARD,D108,HJ,60.11,,78070.27
6150,9/15/2020,9/15/2020,91520,82L-IMPORT PAYROLL-BOHLSEN GRACE,D108,HJ,15.16,,78085.43
6150,9/15/2020,9/15/2020,91520,82L-IMPORT PAYROLL-BOHLSEN GRACE,D108,HJ,64.84,,78150.27
6150,9/15/2020,9/15/2020,91520,82L-IMPORT PAYROLL-BORCHART SPENCER,D108,HJ,15.19,,78165.46
6150,9/15/2020,9/15/2020,91520,82L-IMPORT PAYROLL-BORCHART SPENCER,D108,HJ,44.27,,78209.73
6150,9/15/2020,9/15/2020,91520,82L-IMPORT PAYROLL-BORCHART SPENCER,D108,HJ,64.95,,78274.68
6150,9/15/2020,9/15/2020,91520,82L-IMPORT PAYROLL-BROWN ISAAC,D108,HJ,14.01,,78288.69
6150,9/15/2020,9/15/2020,91520,82L-IMPORT PAYROLL-BROWN ISAAC,D108,HJ,20.14,,78308.83
6150,9/15/2020,9/15/2020,91520,82L-IMPORT PAYROLL-BROWN ISAAC,D108,HJ,59.89,,78368.72
6150,9/15/2020,9/15/2020,91520,82L-IMPORT PAYROLL-BURKE MARIAH,D108,HJ,15.19,,78383.91
6150,9/15/2020,9/15/2020,91520,82L-IMPORT PAYROLL-BURKE MARIAH,D108,HJ,64.95,,78448.86
6150,9/15/2020,9/15/2020,91520,82L-IMPORT PAYROLL-CASSADY JOSHUA LEWIS,D108,HJ,15.19,,78464.05
6150,9/15/2020,9/15/2020,91520,82L-IMPORT PAYROLL-CASSADY JOSHUA LEWIS,D108,HJ,28.29,,78492.34
6150,9/15/2020,9/15/2020,91520,82L-IMPORT PAYROLL-CASSADY JOSHUA LEWIS,D108,HJ,64.95,,78557.29
6150,9/15/2020,9/15/2020,91520,82L-IMPORT PAYROLL-CHAVOUS MILFORD,D108,HJ,15.19,,78572.48
6150,9/15/2020,9/15/2020,91520,82L-IMPORT PAYROLL-CHAVOUS MILFORD,D108,HJ,28.29,,78600.77
6150,9/15/2020,9/15/2020,91520,82L-IMPORT PAYROLL-CHAVOUS MILFORD,D108,HJ,64.95,,78665.72
6150,9/15/2020,9/15/2020,91520,82L-IMPORT PAYROLL-CHEN LING,D108,HJ,4.21,,78669.93
6150,9/15/2020,9/15/2020,91520,82L-IMPORT PAYROLL-CHEN LING,D108,HJ,17.99,,78687.92
6150,9/15/2020,9/15/2020,91520,82L-IMPORT PAYROLL-DARKO OLIVIA,D108,HJ,15.19,,78703.11
6150,9/15/2020,9/15/2020,91520,82L-IMPORT PAYROLL-DARKO OLIVIA,D108,HJ,64.95,,78768.06
6150,9/15/2020,9/15/2020,91520,82L-IMPORT PAYROLL-DAWSON JAMIL NAFAYE-BEYAH,D108,HJ,15.19,,78783.25
6150,9/15/2020,9/15/2020,91520,82L-IMPORT PAYROLL-DAWSON JAMIL NAFAYE-BEYAH,D108,HJ,64.95,,78848.2
6150,9/15/2020,9/15/2020,91520,82L-IMPORT PAYROLL-ESCAMILLA OLGA,D108,HJ,15.19,,78863.39
6150,9/15/2020,9/15/2020,91520,82L-IMPORT PAYROLL-ESCAMILLA OLGA,D108,HJ,64.95,,78928.34
6150,9/15/2020,9/15/2020,91520,82L-IMPORT PAYROLL-GARCIA SANTIAGO,D108,HJ,29.61,,78957.95
6150,9/15/2020,9/15/2020,91520,82L-IMPORT PAYROLL-GARCIA SANTIAGO,D108,HJ,55.13,,79013.08
6150,9/15/2020,9/15/2020,91520,82L-IMPORT PAYROLL-GARCIA SANTIAGO,D108,HJ,126.6,,79139.68
6150,9/15/2020,9/15/2020,91520,82L-IMPORT PAYROLL-GILES SHAYLA,D108,HJ,15.19,,79154.87
6150,9/15/2020,9/15/2020,91520,82L-IMPORT PAYROLL-GILES SHAYLA,D108,HJ,28.29,,79183.16
6150,9/15/2020,9/15/2020,91520,82L-IMPORT PAYROLL-GILES SHAYLA,D108,HJ,64.95,,79248.11
6150,9/15/2020,9/15/2020,91520,82L-IMPORT PAYROLL-IKUNIKA FUNMILAYO,D108,HJ,26.3,,79274.41
6150,9/15/2020,9/15/2020,91520,82L-IMPORT PAYROLL-IKUNIKA FUNMILAYO,D108,HJ,112.45,,79386.86
6150,9/15/2020,9/15/2020,91520,82L-IMPORT PAYROLL-JONES JORDAN,D108,HJ,15.19,,79402.05
6150,9/15/2020,9/15/2020,91520,82L-IMPORT PAYROLL-JONES JORDAN,D108,HJ,64.95,,79467
6150,9/15/2020,9/15/2020,91520,82L-IMPORT PAYROLL-KHAN HUDA,D108,HJ,14.25,,79481.25
6150,9/15/2020,9/15/2020,91520,82L-IMPORT PAYROLL-KHAN HUDA,D108,HJ,26.53,,79507.78
6150,9/15/2020,9/15/2020,91520,82L-IMPORT PAYROLL-KHAN HUDA,D108,HJ,60.92,,79568.7
6150,9/15/2020,9/15/2020,91520,82L-IMPORT PAYROLL-KLOHR TIMOTHY JORDAN,D108,HJ,29,,79597.7
6150,9/15/2020,9/15/2020,91520,82L-IMPORT PAYROLL-KLOHR TIMOTHY JORDAN,D108,HJ,54,,79651.7
6150,9/15/2020,9/15/2020,91520,82L-IMPORT PAYROLL-KLOHR TIMOTHY JORDAN,D108,HJ,124,,79775.7
6150,9/15/2020,9/15/2020,91520,82L-IMPORT PAYROLL-KOPSHEVER MELISSA,D108,HJ,38.26,,79813.96
6150,9/15/2020,9/15/2020,91520,82L-IMPORT PAYROLL-KOPSHEVER MELISSA,D108,HJ,163.58,,79977.54
6150,9/15/2020,9/15/2020,91520,82L-IMPORT PAYROLL-LI SEN,D108,HJ,14.05,,79991.59
6150,9/15/2020,9/15/2020,91520,82L-IMPORT PAYROLL-LI SEN,D108,HJ,26.16,,80017.75
6150,9/15/2020,9/15/2020,91520,82L-IMPORT PAYROLL-LI SEN,D108,HJ,60.07,,80077.82
6150,9/15/2020,9/15/2020,91520,82L-IMPORT PAYROLL-LIPSCOMB STEPHEN,D108,HJ,13.02,,80090.84
6150,9/15/2020,9/15/2020,91520,82L-IMPORT PAYROLL-LIPSCOMB STEPHEN,D108,HJ,33.58,,80124.42
6150,9/15/2020,9/15/2020,91520,82L-IMPORT PAYROLL-LIPSCOMB STEPHEN,D108,HJ,143.59,,80268.01
6150,9/15/2020,9/15/2020,91520,82L-IMPORT PAYROLL-MALLECK JESSICA R,D108,HJ,15.19,,80283.2
6150,9/15/2020,9/15/2020,91520,82L-IMPORT PAYROLL-MALLECK JESSICA R,D108,HJ,64.95,,80348.15
6150,9/15/2020,9/15/2020,91520,82L-IMPORT PAYROLL-MCLAUGHLIN MARA,D108,HJ,15.19,,80363.34
6150,9/15/2020,9/15/2020,91520,82L-IMPORT PAYROLL-MCLAUGHLIN MARA,D108,HJ,64.95,,80428.29
6150,9/15/2020,9/15/2020,91520,82L-IMPORT PAYROLL-MEJIA CARLOS MANUEL,D108,HJ,14.01,,80442.3
6150,9/15/2020,9/15/2020,91520,82L-IMPORT PAYROLL-MEJIA CARLOS MANUEL,D108,HJ,59.89,,80502.19
6150,9/15/2020,9/15/2020,91520,82L-IMPORT PAYROLL-MONROY-MEJIA JASON,D108,HJ,15.19,,80517.38
6150,9/15/2020,9/15/2020,91520,82L-IMPORT PAYROLL-MONROY-MEJIA JASON,D108,HJ,36.67,,80554.05
6150,9/15/2020,9/15/2020,91520,82L-IMPORT PAYROLL-MONROY-MEJIA JASON,D108,HJ,64.95,,80619
6150,9/15/2020,9/15/2020,91520,82L-IMPORT PAYROLL-O'FLYNN-PRUITT NATHAN COLYAR,D108,HJ,15.19,,80634.19
6150,9/15/2020,9/15/2020,91520,82L-IMPORT PAYROLL-O'FLYNN-PRUITT NATHAN COLYAR,D108,HJ,36.67,,80670.86
6150,9/15/2020,9/15/2020,91520,82L-IMPORT PAYROLL-O'FLYNN-PRUITT NATHAN COLYAR,D108,HJ,64.95,,80735.81
6150,9/15/2020,9/15/2020,91520,82L-IMPORT PAYROLL-PATTERSON STEVE,D108,HJ,15.19,,80751
6150,9/15/2020,9/15/2020,91520,82L-IMPORT PAYROLL-PATTERSON STEVE,D108,HJ,28.29,,80779.29
6150,9/15/2020,9/15/2020,91520,82L-IMPORT PAYROLL-PATTERSON STEVE,D108,HJ,64.95,,80844.24
6150,9/15/2020,9/15/2020,91520,82L-IMPORT PAYROLL-SCHMIESS RACHEL JOY,D108,HJ,15.19,,80859.43
6150,9/15/2020,9/15/2020,91520,82L-IMPORT PAYROLL-SCHMIESS RACHEL JOY,D108,HJ,64.95,,80924.38
6150,9/15/2020,9/15/2020,91520,82L-IMPORT PAYROLL-SCOTT KIRK,D108,HJ,14.05,,80938.43
6150,9/15/2020,9/15/2020,91520,82L-IMPORT PAYROLL-SCOTT KIRK,D108,HJ,26.16,,80964.59
6150,9/15/2020,9/15/2020,91520,82L-IMPORT PAYROLL-SCOTT KIRK,D108,HJ,60.07,,81024.66
6150,9/15/2020,9/15/2020,91520,82L-IMPORT PAYROLL-SILVER KELLY,D108,HJ,0.84,,81025.5
6150,9/15/2020,9/15/2020,91520,82L-IMPORT PAYROLL-SILVER KELLY,D108,HJ,34.63,,81060.13
6150,9/15/2020,9/15/2020,91520,82L-IMPORT PAYROLL-SILVER KELLY,D108,HJ,148.06,,81208.19
6150,9/15/2020,9/15/2020,91520,82L-IMPORT PAYROLL-SOLIMAN MARK,D108,HJ,15.19,,81223.38
6150,9/15/2020,9/15/2020,91520,82L-IMPORT PAYROLL-SOLIMAN MARK,D108,HJ,36.67,,81260.05
6150,9/15/2020,9/15/2020,91520,82L-IMPORT PAYROLL-SOLIMAN MARK,D108,HJ,64.95,,81325
6150,9/15/2020,9/15/2020,91520,82L-IMPORT PAYROLL-STEIN KYLE,D108,HJ,19.94,,81344.94
6150,9/15/2020,9/15/2020,91520,82L-IMPORT PAYROLL-STEIN KYLE,D108,HJ,37.13,,81382.07
6150,9/15/2020,9/15/2020,91520,82L-IMPORT PAYROLL-STEIN KYLE,D108,HJ,85.25,,81467.32
6150,9/15/2020,9/15/2020,91520,82L-IMPORT PAYROLL-STROUD DAVID,D108,HJ,14.65,,81481.97
6150,9/15/2020,9/15/2020,91520,82L-IMPORT PAYROLL-STROUD DAVID,D108,HJ,62.62,,81544.59
6150,9/15/2020,9/15/2020,91520,82L-IMPORT PAYROLL-VALCIN SABRINA JEMIMAH,D108,HJ,14.25,,81558.84
6150,9/15/2020,9/15/2020,91520,82L-IMPORT PAYROLL-VALCIN SABRINA JEMIMAH,D108,HJ,26.53,,81585.37
6150,9/15/2020,9/15/2020,91520,82L-IMPORT PAYROLL-VALCIN SABRINA JEMIMAH,D108,HJ,60.92,,81646.29
6150,9/15/2020,9/15/2020,91520,82L-IMPORT PAYROLL-VALDES ERNEST L,D108,HJ,15.19,,81661.48
6150,9/15/2020,9/15/2020,91520,82L-IMPORT PAYROLL-VALDES ERNEST L,D108,HJ,36.67,,81698.15
6150,9/15/2020,9/15/2020,91520,82L-IMPORT PAYROLL-VALDES ERNEST L,D108,HJ,64.95,,81763.1
6150,9/15/2020,9/15/2020,91520,82L-IMPORT PAYROLL-WILLIAMS MACK,D108,HJ,15.02,,81778.12
6150,9/15/2020,9/15/2020,91520,82L-IMPORT PAYROLL-WILLIAMS MACK,D108,HJ,27.96,,81806.08
6150,9/15/2020,9/15/2020,91520,82L-IMPORT PAYROLL-WILLIAMS MACK,D108,HJ,64.21,,81870.29
6150,9/15/2020,9/15/2020,91520,82L-IMPORT PAYROLL-WILLIAMS MIL'YONTA,D108,HJ,15.19,,81885.48
6150,9/15/2020,9/15/2020,91520,82L-IMPORT PAYROLL-WILLIAMS MIL'YONTA,D108,HJ,64.95,,81950.43
6150,9/15/2020,9/15/2020,91520,82L-IMPORT PAYROLL-ANTHONY BETTY,D108,HJ,41.85,,81992.28
6150,9/15/2020,9/15/2020,91520,82L-IMPORT PAYROLL-ANTHONY BETTY,D108,HJ,178.96,,82171.24
6150,9/15/2020,9/15/2020,91520,82L-IMPORT PAYROLL-AUSTIN PERCY,D108,HJ,36.34,,82207.58
6150,9/15/2020,9/15/2020,91520,82L-IMPORT PAYROLL-AUSTIN PERCY,D108,HJ,155.39,,82362.97
6150,9/15/2020,9/15/2020,91520,82L-IMPORT PAYROLL-BUHMANN JAY,D108,HJ,32.93,,82395.9
6150,9/15/2020,9/15/2020,91520,82L-IMPORT PAYROLL-BUHMANN JAY,D108,HJ,140.8,,82536.7
6150,9/15/2020,9/15/2020,91520,82L-IMPORT PAYROLL-CHAPMAN CLAUDY EARL,D108,HJ,26.38,,82563.08
6150,9/15/2020,9/15/2020,91520,82L-IMPORT PAYROLL-CHAPMAN CLAUDY EARL,D108,HJ,112.81,,82675.89
6150,9/15/2020,9/15/2020,91520,82L-IMPORT PAYROLL-DADA ARIKPO,D108,HJ,30.83,,82706.72
6150,9/15/2020,9/15/2020,91520,82L-IMPORT PAYROLL-DADA ARIKPO,D108,HJ,131.84,,82838.56
6150,9/15/2020,9/15/2020,91520,82L-IMPORT PAYROLL-GUTHRIE LESLIE,D108,HJ,33.42,,82871.98
6150,9/15/2020,9/15/2020,91520,82L-IMPORT PAYROLL-GUTHRIE LESLIE,D108,HJ,142.9,,83014.88
6150,9/15/2020,9/15/2020,91520,82L-IMPORT PAYROLL-HOLMES JOREL ALEXANDER,D108,HJ,31.22,,83046.1
6150,9/15/2020,9/15/2020,91520,82L-IMPORT PAYROLL-HOLMES JOREL ALEXANDER,D108,HJ,133.51,,83179.61
6150,9/15/2020,9/15/2020,91520,82L-IMPORT PAYROLL-JORDAN TIFFANY T,D108,HJ,45.87,,83225.48
6150,9/15/2020,9/15/2020,91520,82L-IMPORT PAYROLL-JORDAN TIFFANY T,D108,HJ,196.13,,83421.61
6150,9/15/2020,9/15/2020,91520,82L-IMPORT PAYROLL-LANIGAN LISA A,D108,HJ,45.1,,83466.71
6150,9/15/2020,9/15/2020,91520,82L-IMPORT PAYROLL-LANIGAN LISA A,D108,HJ,192.83,,83659.54
6150,9/15/2020,9/15/2020,91520,82L-IMPORT PAYROLL-MCELWEE MELISSA,D108,HJ,38.67,,83698.21
6150,9/15/2020,9/15/2020,91520,82L-IMPORT PAYROLL-MCELWEE MELISSA,D108,HJ,165.33,,83863.54
6150,9/15/2020,9/15/2020,91520,82L-IMPORT PAYROLL-MCNICHOLAS MARY,D108,HJ,33.23,,83896.77
6150,9/15/2020,9/15/2020,91520,82L-IMPORT PAYROLL-MCNICHOLAS MARY,D108,HJ,142.08,,84038.85
6150,9/15/2020,9/15/2020,91520,82L-IMPORT PAYROLL-NWAKANMA NANCY,D108,HJ,42.32,,84081.17
6150,9/15/2020,9/15/2020,91520,82L-IMPORT PAYROLL-NWAKANMA NANCY,D108,HJ,180.94,,84262.11
6150,9/15/2020,9/15/2020,91520,82L-IMPORT PAYROLL-ONICA ANTHONY J,D108,HJ,31.33,,84293.44
6150,9/15/2020,9/15/2020,91520,82L-IMPORT PAYROLL-ONICA ANTHONY J,D108,HJ,133.98,,84427.42
6150,9/15/2020,9/15/2020,91520,82L-IMPORT PAYROLL-PRAHIN NICOLE M,D108,HJ,23.28,,84450.7
6150,9/15/2020,9/15/2020,91520,82L-IMPORT PAYROLL-PRAHIN NICOLE M,D108,HJ,29.63,,84480.33
6150,9/15/2020,9/15/2020,91520,82L-IMPORT PAYROLL-PRAHIN NICOLE M,D108,HJ,99.53,,84579.86
6150,9/15/2020,9/15/2020,91520,82L-IMPORT PAYROLL-PRAHIN NICOLE M,D108,HJ,126.69,,84706.55
6150,9/15/2020,9/15/2020,91520,82L-IMPORT PAYROLL-RIVERS QUIONNA DIANE,D108,HJ,36.46,,84743.01
6150,9/15/2020,9/15/2020,91520,82L-IMPORT PAYROLL-RIVERS QUIONNA DIANE,D108,HJ,155.89,,84898.9
6150,9/15/2020,9/15/2020,91520,82L-IMPORT PAYROLL-SALIM YASSER,D108,HJ,33.1,,84932
6150,9/15/2020,9/15/2020,91520,82L-IMPORT PAYROLL-SALIM YASSER,D108,HJ,141.55,,85073.55
6150,9/15/2020,9/15/2020,91520,82L-IMPORT PAYROLL-SEJOUR MAHALIAH,D108,HJ,34.07,,85107.62
6150,9/15/2020,9/15/2020,91520,82L-IMPORT PAYROLL-SEJOUR MAHALIAH,D108,HJ,145.66,,85253.28
6150,9/15/2020,9/15/2020,91520,82L-IMPORT PAYROLL-SKALSKI CHRISTOPHER,D108,HJ,33.86,,85287.14
6150,9/15/2020,9/15/2020,91520,82L-IMPORT PAYROLL-SKALSKI CHRISTOPHER,D108,HJ,144.76,,85431.9
6150,9/15/2020,9/15/2020,91520,82L-IMPORT PAYROLL-TUMENJARGAL ENKHJIN,D108,HJ,32.92,,85464.82
6150,9/15/2020,9/15/2020,91520,82L-IMPORT PAYROLL-TUMENJARGAL ENKHJIN,D108,HJ,140.75,,85605.57
6150,9/15/2020,9/15/2020,91520,82L-IMPORT PAYROLL-VILLEGAS EVELYN,D108,HJ,33.4,,85638.97
6150,9/15/2020,9/15/2020,91520,82L-IMPORT PAYROLL-VILLEGAS EVELYN,D108,HJ,142.81,,85781.78
6150,9/15/2020,9/15/2020,91520,82L-IMPORT PAYROLL-WOLF ANNA A,D108,HJ,36.3,,85818.08
6150,9/15/2020,9/15/2020,91520,82L-IMPORT PAYROLL-WOLF ANNA A,D108,HJ,155.19,,85973.27
6150,9/15/2020,9/15/2020,91520,82L-IMPORT PAYROLL-ACEVEDO MONIVETT,D107,HJ,72.42,,86045.69
6150,9/15/2020,9/15/2020,91520,82L-IMPORT PAYROLL-ACEVEDO MONIVETT,D107,HJ,309.64,,86355.33
6150,9/15/2020,9/15/2020,91520,82L-IMPORT PAYROLL-AKLESTAD ISABEL,D111,HJ,23.29,,86378.62
6150,9/15/2020,9/15/2020,91520,82L-IMPORT PAYROLL-AKLESTAD ISABEL,D111,HJ,99.58,,86478.2
6150,9/15/2020,9/15/2020,91520,82L-IMPORT PAYROLL-ALLEN KIMBERLY,D111,HJ,26.58,,86504.78
6150,9/15/2020,9/15/2020,91520,82L-IMPORT PAYROLL-ALLEN KIMBERLY,D111,HJ,113.67,,86618.45
6150,9/15/2020,9/15/2020,91520,82L-IMPORT PAYROLL-BIBB TIFFANI,D104,HJ,24.64,,86643.09
6150,9/15/2020,9/15/2020,91520,82L-IMPORT PAYROLL-BIBB TIFFANI,D104,HJ,45.88,,86688.97
6150,9/15/2020,9/15/2020,91520,82L-IMPORT PAYROLL-BIBB TIFFANI,D104,HJ,105.36,,86794.33
6150,9/15/2020,9/15/2020,91520,82L-IMPORT PAYROLL-BOWMAN HALLEY,D101,HJ,49.84,,86844.17
6150,9/15/2020,9/15/2020,91520,82L-IMPORT PAYROLL-BOWMAN HALLEY,D101,HJ,213.13,,87057.3
6150,9/15/2020,9/15/2020,91520,82L-IMPORT PAYROLL-COOK CATHRYN ANNA,D105,HJ,49.87,,87107.17
6150,9/15/2020,9/15/2020,91520,82L-IMPORT PAYROLL-COOK CATHRYN ANNA,D105,HJ,213.25,,87320.42
6150,9/15/2020,9/15/2020,91520,82L-IMPORT PAYROLL-COOPER ASHLEE R,D101,HJ,33.51,,87353.93
6150,9/15/2020,9/15/2020,91520,82L-IMPORT PAYROLL-COOPER ASHLEE R,D101,HJ,143.3,,87497.23
6150,9/15/2020,9/15/2020,91520,82L-IMPORT PAYROLL-CORTEZ MIRANDA A,D111,HJ,38.45,,87535.68
6150,9/15/2020,9/15/2020,91520,82L-IMPORT PAYROLL-CORTEZ MIRANDA A,D111,HJ,164.42,,87700.1
6150,9/15/2020,9/15/2020,91520,82L-IMPORT PAYROLL-DAUGHERTY DEVIN W,D101,HJ,15.34,,87715.44
6150,9/15/2020,9/15/2020,91520,82L-IMPORT PAYROLL-DAUGHERTY DEVIN W,D101,HJ,65.58,,87781.02
6150,9/15/2020,9/15/2020,91520,82L-IMPORT PAYROLL-DETONE KYRA MAYA,D102,HJ,5.07,,87786.09
6150,9/15/2020,9/15/2020,91520,82L-IMPORT PAYROLL-DETONE KYRA MAYA,D102,HJ,21.68,,87807.77
6150,9/15/2020,9/15/2020,91520,82L-IMPORT PAYROLL-DETONE KYRA MAYA,D102,HJ,33.93,,87841.7
6150,9/15/2020,9/15/2020,91520,82L-IMPORT PAYROLL-DETONE KYRA MAYA,D102,HJ,145.07,,87986.77
6150,9/15/2020,9/15/2020,91520,82L-IMPORT PAYROLL-DUPUIS CHRISTOPHER M,D107,HJ,31.05,,88017.82
6150,9/15/2020,9/15/2020,91520,82L-IMPORT PAYROLL-DUPUIS CHRISTOPHER M,D107,HJ,57.69,,88075.51
6150,9/15/2020,9/15/2020,91520,82L-IMPORT PAYROLL-DUPUIS CHRISTOPHER M,D107,HJ,132.8,,88208.31
6150,9/15/2020,9/15/2020,91520,82L-IMPORT PAYROLL-DUPUIS CHRISTOPHER M,D107,HJ,246.65,,88454.96
6150,9/15/2020,9/15/2020,91520,82L-IMPORT PAYROLL-DZIEDZIC JULIE K,D101,HJ,17.71,,88472.67
6150,9/15/2020,9/15/2020,91520,82L-IMPORT PAYROLL-DZIEDZIC JULIE K,D101,HJ,75.71,,88548.38
6150,9/15/2020,9/15/2020,91520,82L-IMPORT PAYROLL-GORNSTEIN STEVEN,D101,HJ,3.53,,88551.91
6150,9/15/2020,9/15/2020,91520,82L-IMPORT PAYROLL-GORNSTEIN STEVEN,D101,HJ,15.12,,88567.03
6150,9/15/2020,9/15/2020,91520,82L-IMPORT PAYROLL-GORNSTEIN STEVEN,D101,HJ,35.74,,88602.77
6150,9/15/2020,9/15/2020,91520,82L-IMPORT PAYROLL-GORNSTEIN STEVEN,D101,HJ,114.45,,88717.22
6150,9/15/2020,9/15/2020,91520,82L-IMPORT PAYROLL-GORNSTEIN STEVEN,D101,HJ,152.8,,88870.02
6150,9/15/2020,9/15/2020,91520,82L-IMPORT PAYROLL-GUADARRAMA-ALVAREZ URIEL A,D105,HJ,39.93,,88909.95
6150,9/15/2020,9/15/2020,91520,82L-IMPORT PAYROLL-GUADARRAMA-ALVAREZ URIEL A,D105,HJ,170.75,,89080.7
6150,9/15/2020,9/15/2020,91520,82L-IMPORT PAYROLL-GUTIERREZ ANTONIO J,D107,HJ,26.73,,89107.43
6150,9/15/2020,9/15/2020,91520,82L-IMPORT PAYROLL-GUTIERREZ ANTONIO J,D107,HJ,47.52,,89154.95
6150,9/15/2020,9/15/2020,91520,82L-IMPORT PAYROLL-GUTIERREZ ANTONIO J,D107,HJ,114.29,,89269.24
6150,9/15/2020,9/15/2020,91520,82L-IMPORT PAYROLL-GUTIERREZ ANTONIO J,D107,HJ,203.19,,89472.43
6150,9/15/2020,9/15/2020,91520,82L-IMPORT PAYROLL-HENRY GILLIAN,D102,HJ,15.1,,89487.53
6150,9/15/2020,9/15/2020,91520,82L-IMPORT PAYROLL-HENRY GILLIAN,D102,HJ,15.11,,89502.64
6150,9/15/2020,9/15/2020,91520,82L-IMPORT PAYROLL-HENRY GILLIAN,D102,HJ,64.58,,89567.22
6150,9/15/2020,9/15/2020,91520,82L-IMPORT PAYROLL-HENRY GILLIAN,D102,HJ,64.59,,89631.81
6150,9/15/2020,9/15/2020,91520,82L-IMPORT PAYROLL-HENRY GILLIAN,D102,HJ,72.92,,89704.73
6150,9/15/2020,9/15/2020,91520,82L-IMPORT PAYROLL-HERMAN ADAM,D102,HJ,19.99,,89724.72
6150,9/15/2020,9/15/2020,91520,82L-IMPORT PAYROLL-HERMAN ADAM,D102,HJ,85.46,,89810.18
6150,9/15/2020,9/15/2020,91520,82L-IMPORT PAYROLL-HESTER TYLER CONRAD,D105,HJ,27.79,,89837.97
6150,9/15/2020,9/15/2020,91520,82L-IMPORT PAYROLL-HESTER TYLER CONRAD,D105,HJ,118.83,,89956.8
6150,9/15/2020,9/15/2020,91520,82L-IMPORT PAYROLL-LACEY DEQUITA,D104,HJ,35.7,,89992.5
6150,9/15/2020,9/15/2020,91520,82L-IMPORT PAYROLL-LACEY DEQUITA,D104,HJ,152.64,,90145.14
6150,9/15/2020,9/15/2020,91520,82L-IMPORT PAYROLL-LIPORACE HERNAN LUIS,D103,HJ,33.06,,90178.2
6150,9/15/2020,9/15/2020,91520,82L-IMPORT PAYROLL-LIPORACE HERNAN LUIS,D103,HJ,141.34,,90319.54
6150,9/15/2020,9/15/2020,91520,82L-IMPORT PAYROLL-MASON ANGELA,D107,HJ,14.15,,90333.69
6150,9/15/2020,9/15/2020,91520,82L-IMPORT PAYROLL-MASON ANGELA,D107,HJ,60.48,,90394.17
6150,9/15/2020,9/15/2020,91520,82L-IMPORT PAYROLL-MASON ANGELA,D107,HJ,64.42,,90458.59
6150,9/15/2020,9/15/2020,91520,82L-IMPORT PAYROLL-MASON ANGELA,D107,HJ,275.49,,90734.08
6150,9/15/2020,9/15/2020,91520,82L-IMPORT PAYROLL-O'DONNELL STEPHEN,D104,HJ,39.26,,90773.34
6150,9/15/2020,9/15/2020,91520,82L-IMPORT PAYROLL-O'DONNELL STEPHEN,D104,HJ,167.87,,90941.21
6150,9/15/2020,9/15/2020,91520,82L-IMPORT PAYROLL-PARETS MALLORY GRACE,D101,HJ,17.57,,90958.78
6150,9/15/2020,9/15/2020,91520,82L-IMPORT PAYROLL-PARETS MALLORY GRACE,D101,HJ,41.08,,90999.86
6150,9/15/2020,9/15/2020,91520,82L-IMPORT PAYROLL-PARETS MALLORY GRACE,D101,HJ,175.67,,91175.53
6150,9/15/2020,9/15/2020,91520,82L-IMPORT PAYROLL-PARHAM-GANTT DENISE M,D112,HJ,37.96,,91213.49
6150,9/15/2020,9/15/2020,91520,82L-IMPORT PAYROLL-PARHAM-GANTT DENISE M,D112,HJ,162.32,,91375.81
6150,9/15/2020,9/15/2020,91520,82L-IMPORT PAYROLL-PEINADO ELIZABETH R,D111,HJ,52.29,,91428.1
6150,9/15/2020,9/15/2020,91520,82L-IMPORT PAYROLL-PEINADO ELIZABETH R,D111,HJ,223.58,,91651.68
6150,9/15/2020,9/15/2020,91520,82L-IMPORT PAYROLL-POLANCO ODALIS,D103,HJ,43.23,,91694.91
6150,9/15/2020,9/15/2020,91520,82L-IMPORT PAYROLL-POLANCO ODALIS,D103,HJ,184.83,,91879.74
6150,9/15/2020,9/15/2020,91520,82L-IMPORT PAYROLL-QUINTAS JASHIVE,D105,HJ,25.57,,91905.31
6150,9/15/2020,9/15/2020,91520,82L-IMPORT PAYROLL-QUINTAS JASHIVE,D105,HJ,109.31,,92014.62
6150,9/15/2020,9/15/2020,91520,82L-IMPORT PAYROLL-RANDOLPH ALEXANDER,D111,HJ,11.63,,92026.25
6150,9/15/2020,9/15/2020,91520,82L-IMPORT PAYROLL-RANDOLPH ALEXANDER,D111,HJ,25.1,,92051.35
6150,9/15/2020,9/15/2020,91520,82L-IMPORT PAYROLL-RANDOLPH ALEXANDER,D111,HJ,31.15,,92082.5
6150,9/15/2020,9/15/2020,91520,82L-IMPORT PAYROLL-RANDOLPH ALEXANDER,D111,HJ,107.33,,92189.83
6150,9/15/2020,9/15/2020,91520,82L-IMPORT PAYROLL-RUBI PERLA,D101,HJ,15.92,,92205.75
6150,9/15/2020,9/15/2020,91520,82L-IMPORT PAYROLL-RUBI PERLA,D101,HJ,68.09,,92273.84
6150,9/15/2020,9/15/2020,91520,82L-IMPORT PAYROLL-SAFRAN ALAN P,D107,HJ,9.76,,92283.6
6150,9/15/2020,9/15/2020,91520,82L-IMPORT PAYROLL-SAFRAN ALAN P,D107,HJ,41.73,,92325.33
6150,9/15/2020,9/15/2020,91520,82L-IMPORT PAYROLL-SAFRAN ALAN P,D107,HJ,98.67,,92424
6150,9/15/2020,9/15/2020,91520,82L-IMPORT PAYROLL-SAFRAN ALAN P,D107,HJ,421.89,,92845.89
6150,9/15/2020,9/15/2020,91520,82L-IMPORT PAYROLL-SHENKMAN OLIVIA,D101,HJ,29,,92874.89
6150,9/15/2020,9/15/2020,91520,82L-IMPORT PAYROLL-SHENKMAN OLIVIA,D101,HJ,124,,92998.89
6150,9/15/2020,9/15/2020,91520,82L-IMPORT PAYROLL-SHI GRACE,D103,HJ,12.69,,93011.58
6150,9/15/2020,9/15/2020,91520,82L-IMPORT PAYROLL-SHI GRACE,D103,HJ,36.98,,93048.56
6150,9/15/2020,9/15/2020,91520,82L-IMPORT PAYROLL-SHI GRACE,D103,HJ,54.25,,93102.81
6150,9/15/2020,9/15/2020,91520,82L-IMPORT PAYROLL-WALLACE AMENA,D104,HJ,28.93,,93131.74
6150,9/15/2020,9/15/2020,91520,82L-IMPORT PAYROLL-WALLACE AMENA,D104,HJ,123.72,,93255.46
6150,9/15/2020,9/15/2020,91520,82L-IMPORT PAYROLL-WEINSTOCK EMILY,D101,HJ,17.57,,93273.03
6150,9/15/2020,9/15/2020,91520,82L-IMPORT PAYROLL-WEINSTOCK EMILY,D101,HJ,38.11,,93311.14
6150,9/15/2020,9/15/2020,91520,82L-IMPORT PAYROLL-WEINSTOCK EMILY,D101,HJ,162.94,,93474.08
6150,9/15/2020,9/15/2020,91520,82L-IMPORT PAYROLL-WINANS JENNIFER,D111,HJ,36.33,,93510.41
6150,9/15/2020,9/15/2020,91520,82L-IMPORT PAYROLL-WINANS JENNIFER,D111,HJ,155.35,,93665.76
6150,9/15/2020,9/15/2020,91520,82L-IMPORT PAYROLL-ZARATE JOSEPH M,D105,HJ,31.18,,93696.94
6150,9/15/2020,9/15/2020,91520,82L-IMPORT PAYROLL-ZARATE JOSEPH M,D105,HJ,133.3,,93830.24
6150,9/15/2020,9/15/2020,91520,82L-IMPORT PAYROLL-AGUANNO JOSEPH,D108,HJ,16.23,,93846.47
6150,9/15/2020,9/15/2020,91520,82L-IMPORT PAYROLL-AGUANNO JOSEPH,D108,HJ,69.38,,93915.85
6150,9/15/2020,9/15/2020,91520,82L-IMPORT PAYROLL-AKESODE FEHINTOLA,D108,HJ,16.23,,93932.08
6150,9/15/2020,9/15/2020,91520,82L-IMPORT PAYROLL-AKESODE FEHINTOLA,D108,HJ,69.38,,94001.46
6150,9/15/2020,9/15/2020,91520,82L-IMPORT PAYROLL-BARTOLD DEANNA MARIE,D108,HJ,41.91,,94043.37
6150,9/15/2020,9/15/2020,91520,82L-IMPORT PAYROLL-BARTOLD DEANNA MARIE,D108,HJ,179.22,,94222.59
6150,9/15/2020,9/15/2020,91520,82L-IMPORT PAYROLL-BELLOT GENESIS,D108,HJ,32.36,,94254.95
6150,9/15/2020,9/15/2020,91520,82L-IMPORT PAYROLL-BELLOT GENESIS,D108,HJ,138.38,,94393.33
6150,9/15/2020,9/15/2020,91520,82L-IMPORT PAYROLL-BENNETT JAMES H,D108,HJ,16.23,,94409.56
6150,9/15/2020,9/15/2020,91520,82L-IMPORT PAYROLL-BENNETT JAMES H,D108,HJ,69.38,,94478.94
6150,9/15/2020,9/15/2020,91520,82L-IMPORT PAYROLL-BOWMAN ABIGAIL,D108,HJ,16.23,,94495.17
6150,9/15/2020,9/15/2020,91520,82L-IMPORT PAYROLL-BOWMAN ABIGAIL,D108,HJ,69.38,,94564.55
6150,9/15/2020,9/15/2020,91520,82L-IMPORT PAYROLL-BURRELL RUSSELL,D108,HJ,16.23,,94580.78
6150,9/15/2020,9/15/2020,91520,82L-IMPORT PAYROLL-BURRELL RUSSELL,D108,HJ,69.38,,94650.16
6150,9/15/2020,9/15/2020,91520,82L-IMPORT PAYROLL-CHUI KENT,D108,HJ,16.23,,94666.39
6150,9/15/2020,9/15/2020,91520,82L-IMPORT PAYROLL-CHUI KENT,D108,HJ,69.38,,94735.77
6150,9/15/2020,9/15/2020,91520,82L-IMPORT PAYROLL-CIRKER MIA,D108,HJ,32.63,,94768.4
6150,9/15/2020,9/15/2020,91520,82L-IMPORT PAYROLL-CIRKER MIA,D108,HJ,139.5,,94907.9
6150,9/15/2020,9/15/2020,91520,82L-IMPORT PAYROLL-DIETZ MARY,D108,HJ,16.23,,94924.13
6150,9/15/2020,9/15/2020,91520,82L-IMPORT PAYROLL-DIETZ MARY,D108,HJ,69.38,,94993.51
6150,9/15/2020,9/15/2020,91520,82L-IMPORT PAYROLL-DOMINIQUE PRINCESSA,D108,HJ,16.23,,95009.74
6150,9/15/2020,9/15/2020,91520,82L-IMPORT PAYROLL-DOMINIQUE PRINCESSA,D108,HJ,69.38,,95079.12
6150,9/15/2020,9/15/2020,91520,82L-IMPORT PAYROLL-DONNELLY HOME,D108,HJ,16.23,,95095.35
6150,9/15/2020,9/15/2020,91520,82L-IMPORT PAYROLL-DONNELLY HOME,D108,HJ,21.49,,95116.84
6150,9/15/2020,9/15/2020,91520,82L-IMPORT PAYROLL-DONNELLY HOME,D108,HJ,69.38,,95186.22
6150,9/15/2020,9/15/2020,91520,82L-IMPORT PAYROLL-FEIGHERY JOHN,D108,HJ,30.56,,95216.78
6150,9/15/2020,9/15/2020,91520,82L-IMPORT PAYROLL-FEIGHERY JOHN,D108,HJ,130.69,,95347.47
6150,9/15/2020,9/15/2020,91520,82L-IMPORT PAYROLL-FORTH KYLE,D108,HJ,16.23,,95363.7
6150,9/15/2020,9/15/2020,91520,82L-IMPORT PAYROLL-FORTH KYLE,D108,HJ,69.38,,95433.08
6150,9/15/2020,9/15/2020,91520,82L-IMPORT PAYROLL-GARCIA MARILYN,D108,HJ,33.23,,95466.31
6150,9/15/2020,9/15/2020,91520,82L-IMPORT PAYROLL-GARCIA MARILYN,D108,HJ,142.08,,95608.39
6150,9/15/2020,9/15/2020,91520,82L-IMPORT PAYROLL-GREENE BROOKE,D108,HJ,15.28,,95623.67
6150,9/15/2020,9/15/2020,91520,82L-IMPORT PAYROLL-GREENE BROOKE,D108,HJ,65.35,,95689.02
6150,9/15/2020,9/15/2020,91520,82L-IMPORT PAYROLL-GRIFFIN ANDREW,D108,HJ,30.44,,95719.46
6150,9/15/2020,9/15/2020,91520,82L-IMPORT PAYROLL-GRIFFIN ANDREW,D108,HJ,130.16,,95849.62
6150,9/15/2020,9/15/2020,91520,82L-IMPORT PAYROLL-GROSS EMILY,D108,HJ,14,,95863.62
6150,9/15/2020,9/15/2020,91520,82L-IMPORT PAYROLL-GROSS EMILY,D108,HJ,59.86,,95923.48
6150,9/15/2020,9/15/2020,91520,82L-IMPORT PAYROLL-GUERRERO LUIS,D108,HJ,16.23,,95939.71
6150,9/15/2020,9/15/2020,91520,82L-IMPORT PAYROLL-GUERRERO LUIS,D108,HJ,69.38,,96009.09
6150,9/15/2020,9/15/2020,91520,82L-IMPORT PAYROLL-HALLINAN GABRIEL B,D108,HJ,34.79,,96043.88
6150,9/15/2020,9/15/2020,91520,82L-IMPORT PAYROLL-HALLINAN GABRIEL B,D108,HJ,148.76,,96192.64
6150,9/15/2020,9/15/2020,91520,82L-IMPORT PAYROLL-HAMERSLY WILLIAM,D108,HJ,34.16,,96226.8
6150,9/15/2020,9/15/2020,91520,82L-IMPORT PAYROLL-HAMERSLY WILLIAM,D108,HJ,146.08,,96372.88
6150,9/15/2020,9/15/2020,91520,82L-IMPORT PAYROLL-HOLDER LATIVA M,D108,HJ,55.28,,96428.16
6150,9/15/2020,9/15/2020,91520,82L-IMPORT PAYROLL-HOLDER LATIVA M,D108,HJ,236.38,,96664.54
6150,9/15/2020,9/15/2020,91520,82L-IMPORT PAYROLL-HOSSAIN MYESHA R,D108,HJ,35.1,,96699.64
6150,9/15/2020,9/15/2020,91520,82L-IMPORT PAYROLL-HOSSAIN MYESHA R,D108,HJ,150.1,,96849.74
6150,9/15/2020,9/15/2020,91520,82L-IMPORT PAYROLL-JACKSON TASNIM,D108,HJ,31,,96880.74
6150,9/15/2020,9/15/2020,91520,82L-IMPORT PAYROLL-JACKSON TASNIM,D108,HJ,132.56,,97013.3
6150,9/15/2020,9/15/2020,91520,82L-IMPORT PAYROLL-KERKHOFF HARPER FAITH,D108,HJ,16.23,,97029.53
6150,9/15/2020,9/15/2020,91520,82L-IMPORT PAYROLL-KERKHOFF HARPER FAITH,D108,HJ,69.38,,97098.91
6150,9/15/2020,9/15/2020,91520,82L-IMPORT PAYROLL-LEARY AUBREY,D108,HJ,16.2,,97115.11
6150,9/15/2020,9/15/2020,91520,82L-IMPORT PAYROLL-LEARY AUBREY,D108,HJ,69.27,,97184.38
6150,9/15/2020,9/15/2020,91520,82L-IMPORT PAYROLL-LI BELLA,D108,HJ,33.96,,97218.34
6150,9/15/2020,9/15/2020,91520,82L-IMPORT PAYROLL-LI BELLA,D108,HJ,145.23,,97363.57
6150,9/15/2020,9/15/2020,91520,82L-IMPORT PAYROLL-LOUIE JORDAN,D108,HJ,16.23,,97379.8
6150,9/15/2020,9/15/2020,91520,82L-IMPORT PAYROLL-LOUIE JORDAN,D108,HJ,69.38,,97449.18
6150,9/15/2020,9/15/2020,91520,82L-IMPORT PAYROLL-MELCHOR OSBEIDY,D108,HJ,16.23,,97465.41
6150,9/15/2020,9/15/2020,91520,82L-IMPORT PAYROLL-MELCHOR OSBEIDY,D108,HJ,69.38,,97534.79
6150,9/15/2020,9/15/2020,91520,82L-IMPORT PAYROLL-MITTLEMAN ROBERT,D108,HJ,16.23,,97551.02
6150,9/15/2020,9/15/2020,91520,82L-IMPORT PAYROLL-MITTLEMAN ROBERT,D108,HJ,69.38,,97620.4
6150,9/15/2020,9/15/2020,91520,82L-IMPORT PAYROLL-MORRIS ZAKIYA,D108,HJ,16.23,,97636.63
6150,9/15/2020,9/15/2020,91520,82L-IMPORT PAYROLL-MORRIS ZAKIYA,D108,HJ,69.38,,97706.01
6150,9/15/2020,9/15/2020,91520,82L-IMPORT PAYROLL-MORSELETTO RAFAEL,D108,HJ,16.23,,97722.24
6150,9/15/2020,9/15/2020,91520,82L-IMPORT PAYROLL-MORSELETTO RAFAEL,D108,HJ,69.38,,97791.62
6150,9/15/2020,9/15/2020,91520,82L-IMPORT PAYROLL-OBI TOBECHUKWU,D108,HJ,16.23,,97807.85
6150,9/15/2020,9/15/2020,91520,82L-IMPORT PAYROLL-OBI TOBECHUKWU,D108,HJ,69.38,,97877.23
6150,9/15/2020,9/15/2020,91520,82L-IMPORT PAYROLL-OPUH NDIDI,D108,HJ,34.73,,97911.96
6150,9/15/2020,9/15/2020,91520,82L-IMPORT PAYROLL-OPUH NDIDI,D108,HJ,148.51,,98060.47
6150,9/15/2020,9/15/2020,91520,82L-IMPORT PAYROLL-PAULINO THAIRI,D108,HJ,16.23,,98076.7
6150,9/15/2020,9/15/2020,91520,82L-IMPORT PAYROLL-PAULINO THAIRI,D108,HJ,69.38,,98146.08
6150,9/15/2020,9/15/2020,91520,82L-IMPORT PAYROLL-ROSENBAUM MURRAY,D108,HJ,16.23,,98162.31
6150,9/15/2020,9/15/2020,91520,82L-IMPORT PAYROLL-ROSENBAUM MURRAY,D108,HJ,69.38,,98231.69
6150,9/15/2020,9/15/2020,91520,82L-IMPORT PAYROLL-SCHWETTMANN CLAIRE,D108,HJ,15.28,,98246.97
6150,9/15/2020,9/15/2020,91520,82L-IMPORT PAYROLL-SCHWETTMANN CLAIRE,D108,HJ,65.35,,98312.32
6150,9/15/2020,9/15/2020,91520,82L-IMPORT PAYROLL-SOBELMAN JUSTIN,D108,HJ,14.44,,98326.76
6150,9/15/2020,9/15/2020,91520,82L-IMPORT PAYROLL-SOBELMAN JUSTIN,D108,HJ,61.74,,98388.5
6150,9/15/2020,9/15/2020,91520,82L-IMPORT PAYROLL-TERRENCE-SMITH ZIHIR UNIQUE,D108,HJ,14.32,,98402.82
6150,9/15/2020,9/15/2020,91520,82L-IMPORT PAYROLL-TERRENCE-SMITH ZIHIR UNIQUE,D108,HJ,61.22,,98464.04
6150,9/15/2020,9/15/2020,91520,82L-IMPORT PAYROLL-TILLERY ASIA,D108,HJ,47.73,,98511.77
6150,9/15/2020,9/15/2020,91520,82L-IMPORT PAYROLL-TILLERY ASIA,D108,HJ,204.08,,98715.85
6150,9/15/2020,9/15/2020,91520,82L-IMPORT PAYROLL-WILLIAMS- MASSEY BRIANNA M,D108,HJ,16.05,,98731.9
6150,9/15/2020,9/15/2020,91520,82L-IMPORT PAYROLL-WILLIAMS- MASSEY BRIANNA M,D108,HJ,68.64,,98800.54
6150,9/15/2020,9/15/2020,91520,82L-IMPORT PAYROLL-XIAO CHENGYAO,D108,HJ,16.23,,98816.77
6150,9/15/2020,9/15/2020,91520,82L-IMPORT PAYROLL-XIAO CHENGYAO,D108,HJ,69.38,,98886.15
6150,9/15/2020,9/15/2020,91520,82L-IMPORT PAYROLL-ZIAUDDIN ABUTAHER M,D108,HJ,16.23,,98902.38
6150,9/15/2020,9/15/2020,91520,82L-IMPORT PAYROLL-ZIAUDDIN ABUTAHER M,D108,HJ,69.38,,98971.76
6150,9/15/2020,9/15/2020,91520,82L-IMPORT PAYROLL-BALASUBRAMANIAN SHARANYA,D108,HJ,38.67,,99010.43
6150,9/15/2020,9/15/2020,91520,82L-IMPORT PAYROLL-BALASUBRAMANIAN SHARANYA,D108,HJ,165.33,,99175.76
6150,9/15/2020,9/15/2020,91520,82L-IMPORT PAYROLL-COVENEY ALLISON,D108,HJ,38.07,,99213.83
6150,9/15/2020,9/15/2020,91520,82L-IMPORT PAYROLL-COVENEY ALLISON,D108,HJ,162.79,,99376.62
6150,9/15/2020,9/15/2020,91520,82L-IMPORT PAYROLL-JACKSON CLAICE,D108,HJ,19.38,,99396
6150,9/15/2020,9/15/2020,91520,82L-IMPORT PAYROLL-JACKSON CLAICE,D108,HJ,42.91,,99438.91
6150,9/15/2020,9/15/2020,91520,82L-IMPORT PAYROLL-JACKSON CLAICE,D108,HJ,183.48,,99622.39
6150,9/15/2020,9/15/2020,91520,82L-IMPORT PAYROLL-JANG DANIEL,D108,HJ,37.75,,99660.14
6150,9/15/2020,9/15/2020,91520,82L-IMPORT PAYROLL-JANG DANIEL,D108,HJ,161.4,,99821.54
6150,9/15/2020,9/15/2020,91520,82L-IMPORT PAYROLL-LENEGHAN MARYELLEN,D108,HJ,54.63,,99876.17
6150,9/15/2020,9/15/2020,91520,82L-IMPORT PAYROLL-LENEGHAN MARYELLEN,D108,HJ,66.77,,99942.94
6150,9/15/2020,9/15/2020,91520,82L-IMPORT PAYROLL-LENEGHAN MARYELLEN,D108,HJ,233.58,,100176.52
6150,9/15/2020,9/15/2020,91520,82L-IMPORT PAYROLL-LENEGHAN MARYELLEN,D108,HJ,285.5,,100462.02
6150,9/30/2020,9/30/2020,93020,82L-IMPORT PAYROLL-ALVAREZ-MORINE LISIS,D108,HJ,34.63,,100496.65
6150,9/30/2020,9/30/2020,93020,82L-IMPORT PAYROLL-ALVAREZ-MORINE LISIS,D108,HJ,148.06,,100644.71
6150,9/30/2020,9/30/2020,93020,82L-IMPORT PAYROLL-ALWARDT CALEB,D108,HJ,15.19,,100659.9
6150,9/30/2020,9/30/2020,93020,82L-IMPORT PAYROLL-ALWARDT CALEB,D108,HJ,64.95,,100724.85
6150,9/30/2020,9/30/2020,93020,82L-IMPORT PAYROLL-BARTHELEMY RACHALIE,D108,HJ,14.01,,100738.86
6150,9/30/2020,9/30/2020,93020,82L-IMPORT PAYROLL-BARTHELEMY RACHALIE,D108,HJ,26.08,,100764.94
6150,9/30/2020,9/30/2020,93020,82L-IMPORT PAYROLL-BARTHELEMY RACHALIE,D108,HJ,59.89,,100824.83
6150,9/30/2020,9/30/2020,93020,82L-IMPORT PAYROLL-BASHAM WILLIAM EDWARD,D108,HJ,14.06,,100838.89
6150,9/30/2020,9/30/2020,93020,82L-IMPORT PAYROLL-BASHAM WILLIAM EDWARD,D108,HJ,60.11,,100899
6150,9/30/2020,9/30/2020,93020,82L-IMPORT PAYROLL-BOHLSEN GRACE,D108,HJ,15.16,,100914.16
6150,9/30/2020,9/30/2020,93020,82L-IMPORT PAYROLL-BOHLSEN GRACE,D108,HJ,64.84,,100979
6150,9/30/2020,9/30/2020,93020,82L-IMPORT PAYROLL-BORCHART SPENCER,D108,HJ,15.19,,100994.19
6150,9/30/2020,9/30/2020,93020,82L-IMPORT PAYROLL-BORCHART SPENCER,D108,HJ,44.27,,101038.46
6150,9/30/2020,9/30/2020,93020,82L-IMPORT PAYROLL-BORCHART SPENCER,D108,HJ,64.95,,101103.41
6150,9/30/2020,9/30/2020,93020,82L-IMPORT PAYROLL-BROWN ISAAC,D108,HJ,14.01,,101117.42
6150,9/30/2020,9/30/2020,93020,82L-IMPORT PAYROLL-BROWN ISAAC,D108,HJ,20.14,,101137.56
6150,9/30/2020,9/30/2020,93020,82L-IMPORT PAYROLL-BROWN ISAAC,D108,HJ,59.89,,101197.45
6150,9/30/2020,9/30/2020,93020,82L-IMPORT PAYROLL-BURKE MARIAH,D108,HJ,15.19,,101212.64
6150,9/30/2020,9/30/2020,93020,82L-IMPORT PAYROLL-BURKE MARIAH,D108,HJ,64.95,,101277.59
6150,9/30/2020,9/30/2020,93020,82L-IMPORT PAYROLL-CASSADY JOSHUA LEWIS,D108,HJ,15.19,,101292.78
6150,9/30/2020,9/30/2020,93020,82L-IMPORT PAYROLL-CASSADY JOSHUA LEWIS,D108,HJ,28.29,,101321.07
6150,9/30/2020,9/30/2020,93020,82L-IMPORT PAYROLL-CASSADY JOSHUA LEWIS,D108,HJ,64.95,,101386.02
6150,9/30/2020,9/30/2020,93020,82L-IMPORT PAYROLL-CHAVOUS MILFORD,D108,HJ,15.19,,101401.21
6150,9/30/2020,9/30/2020,93020,82L-IMPORT PAYROLL-CHAVOUS MILFORD,D108,HJ,28.29,,101429.5
6150,9/30/2020,9/30/2020,93020,82L-IMPORT PAYROLL-CHAVOUS MILFORD,D108,HJ,64.95,,101494.45
6150,9/30/2020,9/30/2020,93020,82L-IMPORT PAYROLL-DARKO OLIVIA,D108,HJ,15.19,,101509.64
6150,9/30/2020,9/30/2020,93020,82L-IMPORT PAYROLL-DARKO OLIVIA,D108,HJ,64.95,,101574.59
6150,9/30/2020,9/30/2020,93020,82L-IMPORT PAYROLL-DAWSON JAMIL NAFAYE-BEYAH,D108,HJ,15.19,,101589.78
6150,9/30/2020,9/30/2020,93020,82L-IMPORT PAYROLL-DAWSON JAMIL NAFAYE-BEYAH,D108,HJ,64.95,,101654.73
6150,9/30/2020,9/30/2020,93020,82L-IMPORT PAYROLL-ESCAMILLA OLGA,D108,HJ,15.19,,101669.92
6150,9/30/2020,9/30/2020,93020,82L-IMPORT PAYROLL-ESCAMILLA OLGA,D108,HJ,64.95,,101734.87
6150,9/30/2020,9/30/2020,93020,82L-IMPORT PAYROLL-GARCIA SANTIAGO,D108,HJ,29.61,,101764.48
6150,9/30/2020,9/30/2020,93020,82L-IMPORT PAYROLL-GARCIA SANTIAGO,D108,HJ,55.13,,101819.61
6150,9/30/2020,9/30/2020,93020,82L-IMPORT PAYROLL-GARCIA SANTIAGO,D108,HJ,126.6,,101946.21
6150,9/30/2020,9/30/2020,93020,82L-IMPORT PAYROLL-GILES SHAYLA,D108,HJ,15.19,,101961.4
6150,9/30/2020,9/30/2020,93020,82L-IMPORT PAYROLL-GILES SHAYLA,D108,HJ,28.29,,101989.69
6150,9/30/2020,9/30/2020,93020,82L-IMPORT PAYROLL-GILES SHAYLA,D108,HJ,64.95,,102054.64
6150,9/30/2020,9/30/2020,93020,82L-IMPORT PAYROLL-IKUNIKA FUNMILAYO,D108,HJ,30.2,,102084.84
6150,9/30/2020,9/30/2020,93020,82L-IMPORT PAYROLL-IKUNIKA FUNMILAYO,D108,HJ,56.24,,102141.08
6150,9/30/2020,9/30/2020,93020,82L-IMPORT PAYROLL-IKUNIKA FUNMILAYO,D108,HJ,129.15,,102270.23
6150,9/30/2020,9/30/2020,93020,82L-IMPORT PAYROLL-JONES JORDAN,D108,HJ,15.19,,102285.42
6150,9/30/2020,9/30/2020,93020,82L-IMPORT PAYROLL-JONES JORDAN,D108,HJ,64.95,,102350.37
6150,9/30/2020,9/30/2020,93020,82L-IMPORT PAYROLL-KHAN HUDA,D108,HJ,14.25,,102364.62
6150,9/30/2020,9/30/2020,93020,82L-IMPORT PAYROLL-KHAN HUDA,D108,HJ,26.53,,102391.15
6150,9/30/2020,9/30/2020,93020,82L-IMPORT PAYROLL-KHAN HUDA,D108,HJ,60.92,,102452.07
6150,9/30/2020,9/30/2020,93020,82L-IMPORT PAYROLL-KLOHR TIMOTHY JORDAN,D108,HJ,29,,102481.07
6150,9/30/2020,9/30/2020,93020,82L-IMPORT PAYROLL-KLOHR TIMOTHY JORDAN,D108,HJ,41.12,,102522.19
6150,9/30/2020,9/30/2020,93020,82L-IMPORT PAYROLL-KLOHR TIMOTHY JORDAN,D108,HJ,124,,102646.19
6150,9/30/2020,9/30/2020,93020,82L-IMPORT PAYROLL-KNOWLIN ZYLIA,D108,HJ,28.39,,102674.58
6150,9/30/2020,9/30/2020,93020,82L-IMPORT PAYROLL-KNOWLIN ZYLIA,D108,HJ,52.87,,102727.45
6150,9/30/2020,9/30/2020,93020,82L-IMPORT PAYROLL-KNOWLIN ZYLIA,D108,HJ,121.41,,102848.86
6150,9/30/2020,9/30/2020,93020,82L-IMPORT PAYROLL-KOPSHEVER MELISSA,D108,HJ,38.29,,102887.15
6150,9/30/2020,9/30/2020,93020,82L-IMPORT PAYROLL-KOPSHEVER MELISSA,D108,HJ,163.74,,103050.89
6150,9/30/2020,9/30/2020,93020,82L-IMPORT PAYROLL-LI SEN,D108,HJ,14.05,,103064.94
6150,9/30/2020,9/30/2020,93020,82L-IMPORT PAYROLL-LI SEN,D108,HJ,26.16,,103091.1
6150,9/30/2020,9/30/2020,93020,82L-IMPORT PAYROLL-LI SEN,D108,HJ,60.07,,103151.17
6150,9/30/2020,9/30/2020,93020,82L-IMPORT PAYROLL-LIPSCOMB STEPHEN,D108,HJ,33.58,,103184.75
6150,9/30/2020,9/30/2020,93020,82L-IMPORT PAYROLL-LIPSCOMB STEPHEN,D108,HJ,143.59,,103328.34
6150,9/30/2020,9/30/2020,93020,82L-IMPORT PAYROLL-MALLECK JESSICA R,D108,HJ,15.19,,103343.53
6150,9/30/2020,9/30/2020,93020,82L-IMPORT PAYROLL-MALLECK JESSICA R,D108,HJ,64.95,,103408.48
6150,9/30/2020,9/30/2020,93020,82L-IMPORT PAYROLL-MCLAUGHLIN MARA,D108,HJ,15.19,,103423.67
6150,9/30/2020,9/30/2020,93020,82L-IMPORT PAYROLL-MCLAUGHLIN MARA,D108,HJ,64.95,,103488.62
6150,9/30/2020,9/30/2020,93020,82L-IMPORT PAYROLL-MEJIA CARLOS MANUEL,D108,HJ,14.01,,103502.63
6150,9/30/2020,9/30/2020,93020,82L-IMPORT PAYROLL-MEJIA CARLOS MANUEL,D108,HJ,59.89,,103562.52
6150,9/30/2020,9/30/2020,93020,82L-IMPORT PAYROLL-MONROY-MEJIA JASON,D108,HJ,15.19,,103577.71
6150,9/30/2020,9/30/2020,93020,82L-IMPORT PAYROLL-MONROY-MEJIA JASON,D108,HJ,36.67,,103614.38
6150,9/30/2020,9/30/2020,93020,82L-IMPORT PAYROLL-MONROY-MEJIA JASON,D108,HJ,64.95,,103679.33
6150,9/30/2020,9/30/2020,93020,82L-IMPORT PAYROLL-O'FLYNN-PRUITT NATHAN COLYAR,D108,HJ,15.19,,103694.52
6150,9/30/2020,9/30/2020,93020,82L-IMPORT PAYROLL-O'FLYNN-PRUITT NATHAN COLYAR,D108,HJ,36.67,,103731.19
6150,9/30/2020,9/30/2020,93020,82L-IMPORT PAYROLL-O'FLYNN-PRUITT NATHAN COLYAR,D108,HJ,64.95,,103796.14
6150,9/30/2020,9/30/2020,93020,82L-IMPORT PAYROLL-PATTERSON STEVE,D108,HJ,15.19,,103811.33
6150,9/30/2020,9/30/2020,93020,82L-IMPORT PAYROLL-PATTERSON STEVE,D108,HJ,28.29,,103839.62
6150,9/30/2020,9/30/2020,93020,82L-IMPORT PAYROLL-PATTERSON STEVE,D108,HJ,64.95,,103904.57
6150,9/30/2020,9/30/2020,93020,82L-IMPORT PAYROLL-SCHMIESS RACHEL JOY,D108,HJ,15.19,,103919.76
6150,9/30/2020,9/30/2020,93020,82L-IMPORT PAYROLL-SCHMIESS RACHEL JOY,D108,HJ,64.95,,103984.71
6150,9/30/2020,9/30/2020,93020,82L-IMPORT PAYROLL-SCOTT KIRK,D108,HJ,14.05,,103998.76
6150,9/30/2020,9/30/2020,93020,82L-IMPORT PAYROLL-SCOTT KIRK,D108,HJ,26.16,,104024.92
6150,9/30/2020,9/30/2020,93020,82L-IMPORT PAYROLL-SCOTT KIRK,D108,HJ,60.07,,104084.99
6150,9/30/2020,9/30/2020,93020,82L-IMPORT PAYROLL-SILVER KELLY,D108,HJ,34.63,,104119.62
6150,9/30/2020,9/30/2020,93020,82L-IMPORT PAYROLL-SILVER KELLY,D108,HJ,148.06,,104267.68
6150,9/30/2020,9/30/2020,93020,82L-IMPORT PAYROLL-SOLIMAN MARK,D108,HJ,15.19,,104282.87
6150,9/30/2020,9/30/2020,93020,82L-IMPORT PAYROLL-SOLIMAN MARK,D108,HJ,36.67,,104319.54
6150,9/30/2020,9/30/2020,93020,82L-IMPORT PAYROLL-SOLIMAN MARK,D108,HJ,64.95,,104384.49
6150,9/30/2020,9/30/2020,93020,82L-IMPORT PAYROLL-STEIN KYLE,D108,HJ,27.84,,104412.33
6150,9/30/2020,9/30/2020,93020,82L-IMPORT PAYROLL-STEIN KYLE,D108,HJ,51.84,,104464.17
6150,9/30/2020,9/30/2020,93020,82L-IMPORT PAYROLL-STEIN KYLE,D108,HJ,119.03,,104583.2
6150,9/30/2020,9/30/2020,93020,82L-IMPORT PAYROLL-STROUD DAVID,D108,HJ,14.66,,104597.86
6150,9/30/2020,9/30/2020,93020,82L-IMPORT PAYROLL-STROUD DAVID,D108,HJ,62.68,,104660.54
6150,9/30/2020,9/30/2020,93020,82L-IMPORT PAYROLL-VALCIN SABRINA JEMIMAH,D108,HJ,14.25,,104674.79
6150,9/30/2020,9/30/2020,93020,82L-IMPORT PAYROLL-VALCIN SABRINA JEMIMAH,D108,HJ,26.53,,104701.32
6150,9/30/2020,9/30/2020,93020,82L-IMPORT PAYROLL-VALCIN SABRINA JEMIMAH,D108,HJ,60.92,,104762.24
6150,9/30/2020,9/30/2020,93020,82L-IMPORT PAYROLL-VALDES ERNEST L,D108,HJ,15.19,,104777.43
6150,9/30/2020,9/30/2020,93020,82L-IMPORT PAYROLL-VALDES ERNEST L,D108,HJ,36.67,,104814.1
6150,9/30/2020,9/30/2020,93020,82L-IMPORT PAYROLL-VALDES ERNEST L,D108,HJ,64.95,,104879.05
6150,9/30/2020,9/30/2020,93020,82L-IMPORT PAYROLL-WILLIAMS MACK,D108,HJ,15.02,,104894.07
6150,9/30/2020,9/30/2020,93020,82L-IMPORT PAYROLL-WILLIAMS MACK,D108,HJ,27.96,,104922.03
6150,9/30/2020,9/30/2020,93020,82L-IMPORT PAYROLL-WILLIAMS MACK,D108,HJ,64.21,,104986.24
6150,9/30/2020,9/30/2020,93020,82L-IMPORT PAYROLL-WILLIAMS MIL'YONTA,D108,HJ,15.19,,105001.43
6150,9/30/2020,9/30/2020,93020,82L-IMPORT PAYROLL-WILLIAMS MIL'YONTA,D108,HJ,64.95,,105066.38
6150,9/30/2020,9/30/2020,93020,82L-IMPORT PAYROLL-ANTHONY BETTY,D108,HJ,41.85,,105108.23
6150,9/30/2020,9/30/2020,93020,82L-IMPORT PAYROLL-ANTHONY BETTY,D108,HJ,178.96,,105287.19
6150,9/30/2020,9/30/2020,93020,82L-IMPORT PAYROLL-AUSTIN PERCY,D108,HJ,36.34,,105323.53
6150,9/30/2020,9/30/2020,93020,82L-IMPORT PAYROLL-AUSTIN PERCY,D108,HJ,155.39,,105478.92
6150,9/30/2020,9/30/2020,93020,82L-IMPORT PAYROLL-BUHMANN JAY,D108,HJ,32.9,,105511.82
6150,9/30/2020,9/30/2020,93020,82L-IMPORT PAYROLL-BUHMANN JAY,D108,HJ,140.69,,105652.51
6150,9/30/2020,9/30/2020,93020,82L-IMPORT PAYROLL-CHAPMAN CLAUDY EARL,D108,HJ,26.38,,105678.89
6150,9/30/2020,9/30/2020,93020,82L-IMPORT PAYROLL-CHAPMAN CLAUDY EARL,D108,HJ,112.81,,105791.7
6150,9/30/2020,9/30/2020,93020,82L-IMPORT PAYROLL-DADA ARIKPO,D108,HJ,32.04,,105823.74
6150,9/30/2020,9/30/2020,93020,82L-IMPORT PAYROLL-DADA ARIKPO,D108,HJ,137,,105960.74
6150,9/30/2020,9/30/2020,93020,82L-IMPORT PAYROLL-GUTHRIE LESLIE,D108,HJ,33.42,,105994.16
6150,9/30/2020,9/30/2020,93020,82L-IMPORT PAYROLL-GUTHRIE LESLIE,D108,HJ,142.9,,106137.06
6150,9/30/2020,9/30/2020,93020,82L-IMPORT PAYROLL-HOLMES JOREL ALEXANDER,D108,HJ,31.22,,106168.28
6150,9/30/2020,9/30/2020,93020,82L-IMPORT PAYROLL-HOLMES JOREL ALEXANDER,D108,HJ,133.51,,106301.79
6150,9/30/2020,9/30/2020,93020,82L-IMPORT PAYROLL-JORDAN TIFFANY T,D108,HJ,45.87,,106347.66
6150,9/30/2020,9/30/2020,93020,82L-IMPORT PAYROLL-JORDAN TIFFANY T,D108,HJ,196.13,,106543.79
6150,9/30/2020,9/30/2020,93020,82L-IMPORT PAYROLL-LANIGAN LISA A,D108,HJ,45.1,,106588.89
6150,9/30/2020,9/30/2020,93020,82L-IMPORT PAYROLL-LANIGAN LISA A,D108,HJ,192.83,,106781.72
6150,9/30/2020,9/30/2020,93020,82L-IMPORT PAYROLL-MCELWEE MELISSA,D108,HJ,38.67,,106820.39
6150,9/30/2020,9/30/2020,93020,82L-IMPORT PAYROLL-MCELWEE MELISSA,D108,HJ,165.33,,106985.72
6150,9/30/2020,9/30/2020,93020,82L-IMPORT PAYROLL-MCNICHOLAS MARY,D108,HJ,33.23,,107018.95
6150,9/30/2020,9/30/2020,93020,82L-IMPORT PAYROLL-MCNICHOLAS MARY,D108,HJ,142.08,,107161.03
6150,9/30/2020,9/30/2020,93020,82L-IMPORT PAYROLL-NWAKANMA NANCY,D108,HJ,42.83,,107203.86
6150,9/30/2020,9/30/2020,93020,82L-IMPORT PAYROLL-NWAKANMA NANCY,D108,HJ,183.14,,107387
6150,9/30/2020,9/30/2020,93020,82L-IMPORT PAYROLL-ONICA ANTHONY J,D108,HJ,32.86,,107419.86
6150,9/30/2020,9/30/2020,93020,82L-IMPORT PAYROLL-ONICA ANTHONY J,D108,HJ,140.49,,107560.35
6150,9/30/2020,9/30/2020,93020,82L-IMPORT PAYROLL-PRAHIN NICOLE M,D108,HJ,14.28,,107574.63
6150,9/30/2020,9/30/2020,93020,82L-IMPORT PAYROLL-PRAHIN NICOLE M,D108,HJ,38.62,,107613.25
6150,9/30/2020,9/30/2020,93020,82L-IMPORT PAYROLL-PRAHIN NICOLE M,D108,HJ,61.07,,107674.32
6150,9/30/2020,9/30/2020,93020,82L-IMPORT PAYROLL-PRAHIN NICOLE M,D108,HJ,165.22,,107839.54
6150,9/30/2020,9/30/2020,93020,82L-IMPORT PAYROLL-RIVERS QUIONNA DIANE,D108,HJ,37.24,,107876.78
6150,9/30/2020,9/30/2020,93020,82L-IMPORT PAYROLL-RIVERS QUIONNA DIANE,D108,HJ,159.22,,108036
6150,9/30/2020,9/30/2020,93020,82L-IMPORT PAYROLL-SALIM YASSER,D108,HJ,33.1,,108069.1
6150,9/30/2020,9/30/2020,93020,82L-IMPORT PAYROLL-SALIM YASSER,D108,HJ,141.55,,108210.65
6150,9/30/2020,9/30/2020,93020,82L-IMPORT PAYROLL-SEJOUR MAHALIAH,D108,HJ,34.07,,108244.72
6150,9/30/2020,9/30/2020,93020,82L-IMPORT PAYROLL-SEJOUR MAHALIAH,D108,HJ,145.66,,108390.38
6150,9/30/2020,9/30/2020,93020,82L-IMPORT PAYROLL-SKALSKI CHRISTOPHER,D108,HJ,33.86,,108424.24
6150,9/30/2020,9/30/2020,93020,82L-IMPORT PAYROLL-SKALSKI CHRISTOPHER,D108,HJ,144.76,,108569
6150,9/30/2020,9/30/2020,93020,82L-IMPORT PAYROLL-TUMENJARGAL ENKHJIN,D108,HJ,32.92,,108601.92
6150,9/30/2020,9/30/2020,93020,82L-IMPORT PAYROLL-TUMENJARGAL ENKHJIN,D108,HJ,140.75,,108742.67
6150,9/30/2020,9/30/2020,93020,82L-IMPORT PAYROLL-VILLEGAS EVELYN,D108,HJ,33.4,,108776.07
6150,9/30/2020,9/30/2020,93020,82L-IMPORT PAYROLL-VILLEGAS EVELYN,D108,HJ,142.81,,108918.88
6150,9/30/2020,9/30/2020,93020,82L-IMPORT PAYROLL-WOLF ANNA A,D108,HJ,36.3,,108955.18
6150,9/30/2020,9/30/2020,93020,82L-IMPORT PAYROLL-WOLF ANNA A,D108,HJ,155.19,,109110.37
6150,9/30/2020,9/30/2020,93020,82L-IMPORT PAYROLL-ACEVEDO MONIVETT,D107,HJ,72.42,,109182.79
6150,9/30/2020,9/30/2020,93020,82L-IMPORT PAYROLL-ACEVEDO MONIVETT,D107,HJ,309.64,,109492.43
6150,9/30/2020,9/30/2020,93020,82L-IMPORT PAYROLL-AKLESTAD ISABEL,D111,HJ,23.29,,109515.72
6150,9/30/2020,9/30/2020,93020,82L-IMPORT PAYROLL-AKLESTAD ISABEL,D111,HJ,99.58,,109615.3
6150,9/30/2020,9/30/2020,93020,82L-IMPORT PAYROLL-ALLEN KIMBERLY,D111,HJ,26.58,,109641.88
6150,9/30/2020,9/30/2020,93020,82L-IMPORT PAYROLL-ALLEN KIMBERLY,D111,HJ,113.67,,109755.55
6150,9/30/2020,9/30/2020,93020,82L-IMPORT PAYROLL-BIBB TIFFANI,D104,HJ,49.71,,109805.26
6150,9/30/2020,9/30/2020,93020,82L-IMPORT PAYROLL-BIBB TIFFANI,D104,HJ,92.56,,109897.82
6150,9/30/2020,9/30/2020,93020,82L-IMPORT PAYROLL-BIBB TIFFANI,D104,HJ,212.55,,110110.37
6150,9/30/2020,9/30/2020,93020,82L-IMPORT PAYROLL-Bowman Halley,D101,HJ,49.84,,110160.21
6150,9/30/2020,9/30/2020,93020,82L-IMPORT PAYROLL-Bowman Halley,D101,HJ,213.13,,110373.34
6150,9/30/2020,9/30/2020,93020,82L-IMPORT PAYROLL-COOK CATHRYN ANNA,D105,HJ,49.87,,110423.21
6150,9/30/2020,9/30/2020,93020,82L-IMPORT PAYROLL-COOK CATHRYN ANNA,D105,HJ,213.25,,110636.46
6150,9/30/2020,9/30/2020,93020,82L-IMPORT PAYROLL-COOPER ASHLEE R,D101,HJ,33.51,,110669.97
6150,9/30/2020,9/30/2020,93020,82L-IMPORT PAYROLL-COOPER ASHLEE R,D101,HJ,143.3,,110813.27
6150,9/30/2020,9/30/2020,93020,82L-IMPORT PAYROLL-CORTEZ MIRANDA A,D111,HJ,38.45,,110851.72
6150,9/30/2020,9/30/2020,93020,82L-IMPORT PAYROLL-CORTEZ MIRANDA A,D111,HJ,164.42,,111016.14
6150,9/30/2020,9/30/2020,93020,82L-IMPORT PAYROLL-DAUGHERTY DEVIN W,D101,HJ,15.1,,111031.24
6150,9/30/2020,9/30/2020,93020,82L-IMPORT PAYROLL-DAUGHERTY DEVIN W,D101,HJ,64.58,,111095.82
6150,9/30/2020,9/30/2020,93020,82L-IMPORT PAYROLL-DETONE KYRA MAYA,D102,HJ,2.36,,111098.18
6150,9/30/2020,9/30/2020,93020,82L-IMPORT PAYROLL-DETONE KYRA MAYA,D102,HJ,10.05,,111108.23
6150,9/30/2020,9/30/2020,93020,82L-IMPORT PAYROLL-DETONE KYRA MAYA,D102,HJ,36.66,,111144.89
6150,9/30/2020,9/30/2020,93020,82L-IMPORT PAYROLL-DETONE KYRA MAYA,D102,HJ,156.74,,111301.63
6150,9/30/2020,9/30/2020,93020,82L-IMPORT PAYROLL-DUPUIS CHRISTOPHER M,D107,HJ,43.48,,111345.11
6150,9/30/2020,9/30/2020,93020,82L-IMPORT PAYROLL-DUPUIS CHRISTOPHER M,D107,HJ,45.25,,111390.36
6150,9/30/2020,9/30/2020,93020,82L-IMPORT PAYROLL-DUPUIS CHRISTOPHER M,D107,HJ,185.93,,111576.29
6150,9/30/2020,9/30/2020,93020,82L-IMPORT PAYROLL-DUPUIS CHRISTOPHER M,D107,HJ,193.51,,111769.8
6150,9/30/2020,9/30/2020,93020,82L-IMPORT PAYROLL-DZIEDZIC JULIE K,D101,HJ,17.71,,111787.51
6150,9/30/2020,9/30/2020,93020,82L-IMPORT PAYROLL-DZIEDZIC JULIE K,D101,HJ,75.71,,111863.22
6150,9/30/2020,9/30/2020,93020,82L-IMPORT PAYROLL-GORNSTEIN STEVEN,D101,HJ,39.27,,111902.49
6150,9/30/2020,9/30/2020,93020,82L-IMPORT PAYROLL-GORNSTEIN STEVEN,D101,HJ,61.63,,111964.12
6150,9/30/2020,9/30/2020,93020,82L-IMPORT PAYROLL-GORNSTEIN STEVEN,D101,HJ,167.92,,112132.04
6150,9/30/2020,9/30/2020,93020,82L-IMPORT PAYROLL-GUADARRAMA-ALVAREZ URIEL A,D105,HJ,39.93,,112171.97
6150,9/30/2020,9/30/2020,93020,82L-IMPORT PAYROLL-GUADARRAMA-ALVAREZ URIEL A,D105,HJ,170.75,,112342.72
6150,9/30/2020,9/30/2020,93020,82L-IMPORT PAYROLL-GUTIERREZ ANTONIO J,D107,HJ,33.41,,112376.13
6150,9/30/2020,9/30/2020,93020,82L-IMPORT PAYROLL-GUTIERREZ ANTONIO J,D107,HJ,40.83,,112416.96
6150,9/30/2020,9/30/2020,93020,82L-IMPORT PAYROLL-GUTIERREZ ANTONIO J,D107,HJ,142.86,,112559.82
6150,9/30/2020,9/30/2020,93020,82L-IMPORT PAYROLL-GUTIERREZ ANTONIO J,D107,HJ,174.61,,112734.43
6150,9/30/2020,9/30/2020,93020,82L-IMPORT PAYROLL-HENRY GILLIAN,D102,HJ,10.5,,112744.93
6150,9/30/2020,9/30/2020,93020,82L-IMPORT PAYROLL-HENRY GILLIAN,D102,HJ,18.66,,112763.59
6150,9/30/2020,9/30/2020,93020,82L-IMPORT PAYROLL-HENRY GILLIAN,D102,HJ,44.9,,112808.49
6150,9/30/2020,9/30/2020,93020,82L-IMPORT PAYROLL-HENRY GILLIAN,D102,HJ,70.42,,112878.91
6150,9/30/2020,9/30/2020,93020,82L-IMPORT PAYROLL-HENRY GILLIAN,D102,HJ,79.83,,112958.74
6150,9/30/2020,9/30/2020,93020,82L-IMPORT PAYROLL-HERMAN ADAM,D102,HJ,28.2,,112986.94
6150,9/30/2020,9/30/2020,93020,82L-IMPORT PAYROLL-HERMAN ADAM,D102,HJ,120.56,,113107.5
6150,9/30/2020,9/30/2020,93020,82L-IMPORT PAYROLL-HESTER TYLER CONRAD,D105,HJ,27.79,,113135.29
6150,9/30/2020,9/30/2020,93020,82L-IMPORT PAYROLL-HESTER TYLER CONRAD,D105,HJ,118.83,,113254.12
6150,9/30/2020,9/30/2020,93020,82L-IMPORT PAYROLL-LACEY DEQUITA,D104,HJ,12.42,,113266.54
6150,9/30/2020,9/30/2020,93020,82L-IMPORT PAYROLL-LACEY DEQUITA,D104,HJ,53.11,,113319.65
6150,9/30/2020,9/30/2020,93020,82L-IMPORT PAYROLL-LIPORACE HERNAN LUIS,D103,HJ,33.06,,113352.71
6150,9/30/2020,9/30/2020,93020,82L-IMPORT PAYROLL-LIPORACE HERNAN LUIS,D103,HJ,141.34,,113494.05
6150,9/30/2020,9/30/2020,93020,82L-IMPORT PAYROLL-MASON ANGELA,D107,HJ,21.21,,113515.26
6150,9/30/2020,9/30/2020,93020,82L-IMPORT PAYROLL-MASON ANGELA,D107,HJ,57.35,,113572.61
6150,9/30/2020,9/30/2020,93020,82L-IMPORT PAYROLL-MASON ANGELA,D107,HJ,90.71,,113663.32
6150,9/30/2020,9/30/2020,93020,82L-IMPORT PAYROLL-MASON ANGELA,D107,HJ,245.25,,113908.57
6150,9/30/2020,9/30/2020,93020,82L-IMPORT PAYROLL-O'DONNELL STEPHEN,D104,HJ,39.26,,113947.83
6150,9/30/2020,9/30/2020,93020,82L-IMPORT PAYROLL-O'DONNELL STEPHEN,D104,HJ,167.87,,114115.7
6150,9/30/2020,9/30/2020,93020,82L-IMPORT PAYROLL-PARETS MALLORY GRACE,D101,HJ,17.57,,114133.27
6150,9/30/2020,9/30/2020,93020,82L-IMPORT PAYROLL-PARETS MALLORY GRACE,D101,HJ,41.08,,114174.35
6150,9/30/2020,9/30/2020,93020,82L-IMPORT PAYROLL-PARETS MALLORY GRACE,D101,HJ,175.67,,114350.02
6150,9/30/2020,9/30/2020,93020,82L-IMPORT PAYROLL-PARHAM-GANTT DENISE M,D112,HJ,37.96,,114387.98
6150,9/30/2020,9/30/2020,93020,82L-IMPORT PAYROLL-PARHAM-GANTT DENISE M,D112,HJ,162.32,,114550.3
6150,9/30/2020,9/30/2020,93020,82L-IMPORT PAYROLL-PEINADO ELIZABETH R,D111,HJ,52.29,,114602.59
6150,9/30/2020,9/30/2020,93020,82L-IMPORT PAYROLL-PEINADO ELIZABETH R,D111,HJ,223.58,,114826.17
6150,9/30/2020,9/30/2020,93020,82L-IMPORT PAYROLL-POLANCO ODALIS,D103,HJ,43.23,,114869.4
6150,9/30/2020,9/30/2020,93020,82L-IMPORT PAYROLL-POLANCO ODALIS,D103,HJ,184.83,,115054.23
6150,9/30/2020,9/30/2020,93020,82L-IMPORT PAYROLL-QUINTAS JASHIVE,D105,HJ,25.57,,115079.8
6150,9/30/2020,9/30/2020,93020,82L-IMPORT PAYROLL-QUINTAS JASHIVE,D105,HJ,109.31,,115189.11
6150,9/30/2020,9/30/2020,93020,82L-IMPORT PAYROLL-RANDOLPH ALEXANDER,D111,HJ,11.63,,115200.74
6150,9/30/2020,9/30/2020,93020,82L-IMPORT PAYROLL-RANDOLPH ALEXANDER,D111,HJ,25.1,,115225.84
6150,9/30/2020,9/30/2020,93020,82L-IMPORT PAYROLL-RANDOLPH ALEXANDER,D111,HJ,107.33,,115333.17
6150,9/30/2020,9/30/2020,93020,82L-IMPORT PAYROLL-RUBI PERLA,D101,HJ,15.92,,115349.09
6150,9/30/2020,9/30/2020,93020,82L-IMPORT PAYROLL-RUBI PERLA,D101,HJ,68.09,,115417.18
6150,9/30/2020,9/30/2020,93020,82L-IMPORT PAYROLL-SAFRAN ALAN P,D107,HJ,9.75,,115426.93
6150,9/30/2020,9/30/2020,93020,82L-IMPORT PAYROLL-SAFRAN ALAN P,D107,HJ,41.72,,115468.65
6150,9/30/2020,9/30/2020,93020,82L-IMPORT PAYROLL-SAFRAN ALAN P,D107,HJ,98.67,,115567.32
6150,9/30/2020,9/30/2020,93020,82L-IMPORT PAYROLL-SAFRAN ALAN P,D107,HJ,421.89,,115989.21
6150,9/30/2020,9/30/2020,93020,82L-IMPORT PAYROLL-SHENKMAN OLIVIA,D101,HJ,29,,116018.21
6150,9/30/2020,9/30/2020,93020,82L-IMPORT PAYROLL-SHENKMAN OLIVIA,D101,HJ,124,,116142.21
6150,9/30/2020,9/30/2020,93020,82L-IMPORT PAYROLL-SHI GRACE,D103,HJ,12.69,,116154.9
6150,9/30/2020,9/30/2020,93020,82L-IMPORT PAYROLL-SHI GRACE,D103,HJ,34,,116188.9
6150,9/30/2020,9/30/2020,93020,82L-IMPORT PAYROLL-SHI GRACE,D103,HJ,54.25,,116243.15
6150,9/30/2020,9/30/2020,93020,82L-IMPORT PAYROLL-WALLACE AMENA,D104,HJ,28.93,,116272.08
6150,9/30/2020,9/30/2020,93020,82L-IMPORT PAYROLL-WALLACE AMENA,D104,HJ,123.72,,116395.8
6150,9/30/2020,9/30/2020,93020,82L-IMPORT PAYROLL-WEINSTOCK EMILY,D101,HJ,17.57,,116413.37
6150,9/30/2020,9/30/2020,93020,82L-IMPORT PAYROLL-WEINSTOCK EMILY,D101,HJ,38.11,,116451.48
6150,9/30/2020,9/30/2020,93020,82L-IMPORT PAYROLL-WEINSTOCK EMILY,D101,HJ,162.94,,116614.42
6150,9/30/2020,9/30/2020,93020,82L-IMPORT PAYROLL-WINANS JENNIFER,D111,HJ,36.33,,116650.75
6150,9/30/2020,9/30/2020,93020,82L-IMPORT PAYROLL-WINANS JENNIFER,D111,HJ,155.35,,116806.1
6150,9/30/2020,9/30/2020,93020,82L-IMPORT PAYROLL-ZARATE JOSEPH M,D105,HJ,31.18,,116837.28
6150,9/30/2020,9/30/2020,93020,82L-IMPORT PAYROLL-ZARATE JOSEPH M,D105,HJ,133.3,,116970.58
6150,9/30/2020,9/30/2020,93020,82L-IMPORT PAYROLL-AGUANNO JOSEPH,D108,HJ,16.23,,116986.81
6150,9/30/2020,9/30/2020,93020,82L-IMPORT PAYROLL-AGUANNO JOSEPH,D108,HJ,69.38,,117056.19
6150,9/30/2020,9/30/2020,93020,82L-IMPORT PAYROLL-AKESODE FEHINTOLA,D108,HJ,16.23,,117072.42
6150,9/30/2020,9/30/2020,93020,82L-IMPORT PAYROLL-AKESODE FEHINTOLA,D108,HJ,69.38,,117141.8
6150,9/30/2020,9/30/2020,93020,82L-IMPORT PAYROLL-BARTOLD DEANNA MARIE,D108,HJ,41.91,,117183.71
6150,9/30/2020,9/30/2020,93020,82L-IMPORT PAYROLL-BARTOLD DEANNA MARIE,D108,HJ,179.22,,117362.93
6150,9/30/2020,9/30/2020,93020,82L-IMPORT PAYROLL-BELLOT GENESIS,D108,HJ,32.36,,117395.29
6150,9/30/2020,9/30/2020,93020,82L-IMPORT PAYROLL-BELLOT GENESIS,D108,HJ,138.38,,117533.67
6150,9/30/2020,9/30/2020,93020,82L-IMPORT PAYROLL-BENNETT JAMES H,D108,HJ,16.23,,117549.9
6150,9/30/2020,9/30/2020,93020,82L-IMPORT PAYROLL-BENNETT JAMES H,D108,HJ,69.38,,117619.28
6150,9/30/2020,9/30/2020,93020,82L-IMPORT PAYROLL-BOWMAN ABIGAIL,D108,HJ,16.23,,117635.51
6150,9/30/2020,9/30/2020,93020,82L-IMPORT PAYROLL-BOWMAN ABIGAIL,D108,HJ,69.38,,117704.89
6150,9/30/2020,9/30/2020,93020,82L-IMPORT PAYROLL-BURRELL RUSSELL,D108,HJ,15.08,,117719.97
6150,9/30/2020,9/30/2020,93020,82L-IMPORT PAYROLL-BURRELL RUSSELL,D108,HJ,64.5,,117784.47
6150,9/30/2020,9/30/2020,93020,82L-IMPORT PAYROLL-CHUI KENT,D108,HJ,16.23,,117800.7
6150,9/30/2020,9/30/2020,93020,82L-IMPORT PAYROLL-CHUI KENT,D108,HJ,69.38,,117870.08
6150,9/30/2020,9/30/2020,93020,82L-IMPORT PAYROLL-CIRKER MIA,D108,HJ,32.63,,117902.71
6150,9/30/2020,9/30/2020,93020,82L-IMPORT PAYROLL-CIRKER MIA,D108,HJ,139.5,,118042.21
6150,9/30/2020,9/30/2020,93020,82L-IMPORT PAYROLL-DIETZ MARY,D108,HJ,16.23,,118058.44
6150,9/30/2020,9/30/2020,93020,82L-IMPORT PAYROLL-DIETZ MARY,D108,HJ,69.38,,118127.82
6150,9/30/2020,9/30/2020,93020,82L-IMPORT PAYROLL-DOMINIQUE PRINCESSA,D108,HJ,16.23,,118144.05
6150,9/30/2020,9/30/2020,93020,82L-IMPORT PAYROLL-DOMINIQUE PRINCESSA,D108,HJ,69.38,,118213.43
6150,9/30/2020,9/30/2020,93020,82L-IMPORT PAYROLL-DONNELLY HOME,D108,HJ,16.23,,118229.66
6150,9/30/2020,9/30/2020,93020,82L-IMPORT PAYROLL-DONNELLY HOME,D108,HJ,21.49,,118251.15
6150,9/30/2020,9/30/2020,93020,82L-IMPORT PAYROLL-DONNELLY HOME,D108,HJ,69.38,,118320.53
6150,9/30/2020,9/30/2020,93020,82L-IMPORT PAYROLL-FEIGHERY JOHN,D108,HJ,30.56,,118351.09
6150,9/30/2020,9/30/2020,93020,82L-IMPORT PAYROLL-FEIGHERY JOHN,D108,HJ,130.69,,118481.78
6150,9/30/2020,9/30/2020,93020,82L-IMPORT PAYROLL-FORTH KYLE,D108,HJ,16.23,,118498.01
6150,9/30/2020,9/30/2020,93020,82L-IMPORT PAYROLL-FORTH KYLE,D108,HJ,69.38,,118567.39
6150,9/30/2020,9/30/2020,93020,82L-IMPORT PAYROLL-GARCIA MARILYN,D108,HJ,33.23,,118600.62
6150,9/30/2020,9/30/2020,93020,82L-IMPORT PAYROLL-GARCIA MARILYN,D108,HJ,142.08,,118742.7
6150,9/30/2020,9/30/2020,93020,82L-IMPORT PAYROLL-GREENE BROOKE,D108,HJ,15.28,,118757.98
6150,9/30/2020,9/30/2020,93020,82L-IMPORT PAYROLL-GREENE BROOKE,D108,HJ,65.35,,118823.33
6150,9/30/2020,9/30/2020,93020,82L-IMPORT PAYROLL-GRIFFIN ANDREW,D108,HJ,30.44,,118853.77
6150,9/30/2020,9/30/2020,93020,82L-IMPORT PAYROLL-GRIFFIN ANDREW,D108,HJ,130.16,,118983.93
6150,9/30/2020,9/30/2020,93020,82L-IMPORT PAYROLL-GROSS EMILY,D108,HJ,14,,118997.93
6150,9/30/2020,9/30/2020,93020,82L-IMPORT PAYROLL-GROSS EMILY,D108,HJ,59.86,,119057.79
6150,9/30/2020,9/30/2020,93020,82L-IMPORT PAYROLL-GUERRERO LUIS,D108,HJ,16.23,,119074.02
6150,9/30/2020,9/30/2020,93020,82L-IMPORT PAYROLL-GUERRERO LUIS,D108,HJ,69.38,,119143.4
6150,9/30/2020,9/30/2020,93020,82L-IMPORT PAYROLL-HALLINAN GABRIEL B,D108,HJ,34.79,,119178.19
6150,9/30/2020,9/30/2020,93020,82L-IMPORT PAYROLL-HALLINAN GABRIEL B,D108,HJ,148.76,,119326.95
6150,9/30/2020,9/30/2020,93020,82L-IMPORT PAYROLL-HAMERSLY WILLIAM,D108,HJ,34.16,,119361.11
6150,9/30/2020,9/30/2020,93020,82L-IMPORT PAYROLL-HAMERSLY WILLIAM,D108,HJ,146.08,,119507.19
6150,9/30/2020,9/30/2020,93020,82L-IMPORT PAYROLL-HOLDER LATIVA M,D108,HJ,55.28,,119562.47
6150,9/30/2020,9/30/2020,93020,82L-IMPORT PAYROLL-HOLDER LATIVA M,D108,HJ,236.38,,119798.85
6150,9/30/2020,9/30/2020,93020,82L-IMPORT PAYROLL-HOSSAIN MYESHA R,D108,HJ,35.1,,119833.95
6150,9/30/2020,9/30/2020,93020,82L-IMPORT PAYROLL-HOSSAIN MYESHA R,D108,HJ,150.1,,119984.05
6150,9/30/2020,9/30/2020,93020,82L-IMPORT PAYROLL-JACKSON TASNIM,D108,HJ,31,,120015.05
6150,9/30/2020,9/30/2020,93020,82L-IMPORT PAYROLL-JACKSON TASNIM,D108,HJ,132.56,,120147.61
6150,9/30/2020,9/30/2020,93020,82L-IMPORT PAYROLL-KERKHOFF HARPER FAITH,D108,HJ,16.23,,120163.84
6150,9/30/2020,9/30/2020,93020,82L-IMPORT PAYROLL-KERKHOFF HARPER FAITH,D108,HJ,69.38,,120233.22
6150,9/30/2020,9/30/2020,93020,82L-IMPORT PAYROLL-LEARY AUBREY,D108,HJ,16.2,,120249.42
6150,9/30/2020,9/30/2020,93020,82L-IMPORT PAYROLL-LEARY AUBREY,D108,HJ,69.27,,120318.69
6150,9/30/2020,9/30/2020,93020,82L-IMPORT PAYROLL-LI BELLA,D108,HJ,33.96,,120352.65
6150,9/30/2020,9/30/2020,93020,82L-IMPORT PAYROLL-LI BELLA,D108,HJ,145.23,,120497.88
6150,9/30/2020,9/30/2020,93020,82L-IMPORT PAYROLL-LOUIE JORDAN,D108,HJ,16.23,,120514.11
6150,9/30/2020,9/30/2020,93020,82L-IMPORT PAYROLL-LOUIE JORDAN,D108,HJ,69.38,,120583.49
6150,9/30/2020,9/30/2020,93020,82L-IMPORT PAYROLL-MELCHOR OSBEIDY,D108,HJ,16.23,,120599.72
6150,9/30/2020,9/30/2020,93020,82L-IMPORT PAYROLL-MELCHOR OSBEIDY,D108,HJ,69.38,,120669.1
6150,9/30/2020,9/30/2020,93020,82L-IMPORT PAYROLL-MITTLEMAN ROBERT,D108,HJ,16.23,,120685.33
6150,9/30/2020,9/30/2020,93020,82L-IMPORT PAYROLL-MITTLEMAN ROBERT,D108,HJ,69.38,,120754.71
6150,9/30/2020,9/30/2020,93020,82L-IMPORT PAYROLL-MORRIS ZAKIYA,D108,HJ,16.23,,120770.94
6150,9/30/2020,9/30/2020,93020,82L-IMPORT PAYROLL-MORRIS ZAKIYA,D108,HJ,69.38,,120840.32
6150,9/30/2020,9/30/2020,93020,82L-IMPORT PAYROLL-OBI TOBECHUKWU,D108,HJ,16.23,,120856.55
6150,9/30/2020,9/30/2020,93020,82L-IMPORT PAYROLL-OBI TOBECHUKWU,D108,HJ,69.38,,120925.93
6150,9/30/2020,9/30/2020,93020,82L-IMPORT PAYROLL-OPUH NDIDI,D108,HJ,34.73,,120960.66
6150,9/30/2020,9/30/2020,93020,82L-IMPORT PAYROLL-OPUH NDIDI,D108,HJ,148.51,,121109.17
6150,9/30/2020,9/30/2020,93020,82L-IMPORT PAYROLL-PAULINO THAIRI,D108,HJ,16.23,,121125.4
6150,9/30/2020,9/30/2020,93020,82L-IMPORT PAYROLL-PAULINO THAIRI,D108,HJ,69.38,,121194.78
6150,9/30/2020,9/30/2020,93020,82L-IMPORT PAYROLL-ROSENBAUM MURRAY,D108,HJ,16.23,,121211.01
6150,9/30/2020,9/30/2020,93020,82L-IMPORT PAYROLL-ROSENBAUM MURRAY,D108,HJ,69.38,,121280.39
6150,9/30/2020,9/30/2020,93020,82L-IMPORT PAYROLL-SCHWETTMANN CLAIRE,D108,HJ,15.28,,121295.67
6150,9/30/2020,9/30/2020,93020,82L-IMPORT PAYROLL-SCHWETTMANN CLAIRE,D108,HJ,65.35,,121361.02
6150,9/30/2020,9/30/2020,93020,82L-IMPORT PAYROLL-SOBELMAN JUSTIN,D108,HJ,16.36,,121377.38
6150,9/30/2020,9/30/2020,93020,82L-IMPORT PAYROLL-SOBELMAN JUSTIN,D108,HJ,69.96,,121447.34
6150,9/30/2020,9/30/2020,93020,82L-IMPORT PAYROLL-TERRENCE-SMITH ZIHIR UNIQUE,D108,HJ,14.32,,121461.66
6150,9/30/2020,9/30/2020,93020,82L-IMPORT PAYROLL-TERRENCE-SMITH ZIHIR UNIQUE,D108,HJ,61.22,,121522.88
6150,9/30/2020,9/30/2020,93020,82L-IMPORT PAYROLL-TILLERY ASIA,D108,HJ,47.73,,121570.61
6150,9/30/2020,9/30/2020,93020,82L-IMPORT PAYROLL-TILLERY ASIA,D108,HJ,204.08,,121774.69
6150,9/30/2020,9/30/2020,93020,82L-IMPORT PAYROLL-WILLIAMS- MASSEY BRIANNA M,D108,HJ,16.05,,121790.74
6150,9/30/2020,9/30/2020,93020,82L-IMPORT PAYROLL-WILLIAMS- MASSEY BRIANNA M,D108,HJ,68.64,,121859.38
6150,9/30/2020,9/30/2020,93020,82L-IMPORT PAYROLL-XIAO CHENGYAO,D108,HJ,16.23,,121875.61
6150,9/30/2020,9/30/2020,93020,82L-IMPORT PAYROLL-XIAO CHENGYAO,D108,HJ,69.38,,121944.99
6150,9/30/2020,9/30/2020,93020,82L-IMPORT PAYROLL-ZIAUDDIN ABUTAHER M,D108,HJ,16.23,,121961.22
6150,9/30/2020,9/30/2020,93020,82L-IMPORT PAYROLL-ZIAUDDIN ABUTAHER M,D108,HJ,69.38,,122030.6
6150,9/30/2020,9/30/2020,93020,82L-IMPORT PAYROLL-BALASUBRAMANIAN SHARANYA,D108,HJ,38.67,,122069.27
6150,9/30/2020,9/30/2020,93020,82L-IMPORT PAYROLL-BALASUBRAMANIAN SHARANYA,D108,HJ,165.33,,122234.6
6150,9/30/2020,9/30/2020,93020,82L-IMPORT PAYROLL-COVENEY ALLISON,D108,HJ,38.07,,122272.67
6150,9/30/2020,9/30/2020,93020,82L-IMPORT PAYROLL-COVENEY ALLISON,D108,HJ,162.79,,122435.46
6150,9/30/2020,9/30/2020,93020,82L-IMPORT PAYROLL-JACKSON CLAICE,D108,HJ,19.38,,122454.84
6150,9/30/2020,9/30/2020,93020,82L-IMPORT PAYROLL-JACKSON CLAICE,D108,HJ,42.91,,122497.75
6150,9/30/2020,9/30/2020,93020,82L-IMPORT PAYROLL-JACKSON CLAICE,D108,HJ,183.48,,122681.23
6150,9/30/2020,9/30/2020,93020,82L-IMPORT PAYROLL-JANG DANIEL,D108,HJ,37.75,,122718.98
6150,9/30/2020,9/30/2020,93020,82L-IMPORT PAYROLL-JANG DANIEL,D108,HJ,161.4,,122880.38
6150,9/30/2020,9/30/2020,93020,82L-IMPORT PAYROLL-LENEGHAN MARYELLEN,D108,HJ,30.07,,122910.45
6150,9/30/2020,9/30/2020,93020,82L-IMPORT PAYROLL-LENEGHAN MARYELLEN,D108,HJ,36.76,,122947.21
6150,9/30/2020,9/30/2020,93020,82L-IMPORT PAYROLL-LENEGHAN MARYELLEN,D108,HJ,128.6,,123075.81
6150,9/30/2020,9/30/2020,93020,82L-IMPORT PAYROLL-LENEGHAN MARYELLEN,D108,HJ,157.17,,123232.98
6150,9/30/2020,9/30/2020,202009,Adj to reallocate Salaries FICA and benefits from GM3 - ACY2 to G-BL-To reallocate Amena Wallance from GM3 - ACY2 to G-BL,D104,HJ,,305.3,122927.68
6150,9/30/2020,9/30/2020,202009,Adj to reallocate Salaries FICA and benefits from GM3 - ACY2 to G-BL-To reallocate Amena Wallance from GM3 - ACY2 to G-BL,D104,HJ,305.3,,123232.98
6150,9/30/2020,9/30/2020,202009,Adj to reallocate Salaries FICA and benefits from GM3 - ACY2 to G-BL-To reallocate Lacey Dequita and T.Bibb salary from GM3 - ACY2 to G-BL,D104,HJ,,784.57,122448.41
6150,9/30/2020,9/30/2020,202009,Adj to reallocate Salaries FICA and benefits from GM3 - ACY2 to G-BL-To reallocate Lacey Dequita and T.Bibb salary from GM3 - ACY2 to G-BL,D104,HJ,784.57,,123232.98
6150,10/15/2020,10/15/2020,101520,82L-IMPORT PAYROLL-ALVAREZ-MORINE LISIS,D108,HJ,23.81,,123256.79
6150,10/15/2020,10/15/2020,101520,82L-IMPORT PAYROLL-ALVAREZ-MORINE LISIS,D108,HJ,101.82,,123358.61
6150,10/15/2020,10/15/2020,101520,82L-IMPORT PAYROLL-ALWARDT CALEB,D108,HJ,15.19,,123373.8
6150,10/15/2020,10/15/2020,101520,82L-IMPORT PAYROLL-ALWARDT CALEB,D108,HJ,64.95,,123438.75
6150,10/15/2020,10/15/2020,101520,82L-IMPORT PAYROLL-BARTHELEMY RACHALIE,D108,HJ,14.01,,123452.76
6150,10/15/2020,10/15/2020,101520,82L-IMPORT PAYROLL-BARTHELEMY RACHALIE,D108,HJ,26.08,,123478.84
6150,10/15/2020,10/15/2020,101520,82L-IMPORT PAYROLL-BARTHELEMY RACHALIE,D108,HJ,59.89,,123538.73
6150,10/15/2020,10/15/2020,101520,82L-IMPORT PAYROLL-BASHAM WILLIAM EDWARD,D108,HJ,14.06,,123552.79
6150,10/15/2020,10/15/2020,101520,82L-IMPORT PAYROLL-BASHAM WILLIAM EDWARD,D108,HJ,60.11,,123612.9
6150,10/15/2020,10/15/2020,101520,82L-IMPORT PAYROLL-BOHLSEN GRACE,D108,HJ,15.16,,123628.06
6150,10/15/2020,10/15/2020,101520,82L-IMPORT PAYROLL-BOHLSEN GRACE,D108,HJ,64.84,,123692.9
6150,10/15/2020,10/15/2020,101520,82L-IMPORT PAYROLL-BOLIVAR ANDREA,D108,HJ,46.28,,123739.18
6150,10/15/2020,10/15/2020,101520,82L-IMPORT PAYROLL-BOLIVAR ANDREA,D108,HJ,86.17,,123825.35
6150,10/15/2020,10/15/2020,101520,82L-IMPORT PAYROLL-BOLIVAR ANDREA,D108,HJ,197.87,,124023.22
6150,10/15/2020,10/15/2020,101520,82L-IMPORT PAYROLL-BORCHART SPENCER,D108,HJ,15.19,,124038.41
6150,10/15/2020,10/15/2020,101520,82L-IMPORT PAYROLL-BORCHART SPENCER,D108,HJ,44.27,,124082.68
6150,10/15/2020,10/15/2020,101520,82L-IMPORT PAYROLL-BORCHART SPENCER,D108,HJ,64.95,,124147.63
6150,10/15/2020,10/15/2020,101520,82L-IMPORT PAYROLL-BROWN ISAAC,D108,HJ,14.01,,124161.64
6150,10/15/2020,10/15/2020,101520,82L-IMPORT PAYROLL-BROWN ISAAC,D108,HJ,20.14,,124181.78
6150,10/15/2020,10/15/2020,101520,82L-IMPORT PAYROLL-BROWN ISAAC,D108,HJ,59.89,,124241.67
6150,10/15/2020,10/15/2020,101520,82L-IMPORT PAYROLL-BURKE MARIAH,D108,HJ,15.19,,124256.86
6150,10/15/2020,10/15/2020,101520,82L-IMPORT PAYROLL-BURKE MARIAH,D108,HJ,64.95,,124321.81
6150,10/15/2020,10/15/2020,101520,82L-IMPORT PAYROLL-CASSADY JOSHUA LEWIS,D108,HJ,15.19,,124337
6150,10/15/2020,10/15/2020,101520,82L-IMPORT PAYROLL-CASSADY JOSHUA LEWIS,D108,HJ,28.29,,124365.29
6150,10/15/2020,10/15/2020,101520,82L-IMPORT PAYROLL-CASSADY JOSHUA LEWIS,D108,HJ,64.95,,124430.24
6150,10/15/2020,10/15/2020,101520,82L-IMPORT PAYROLL-DARKO OLIVIA,D108,HJ,15.19,,124445.43
6150,10/15/2020,10/15/2020,101520,82L-IMPORT PAYROLL-DARKO OLIVIA,D108,HJ,64.95,,124510.38
6150,10/15/2020,10/15/2020,101520,82L-IMPORT PAYROLL-DAWSON JAMIL NAFAYE-BEYAH,D108,HJ,15.19,,124525.57
6150,10/15/2020,10/15/2020,101520,82L-IMPORT PAYROLL-DAWSON JAMIL NAFAYE-BEYAH,D108,HJ,64.95,,124590.52
6150,10/15/2020,10/15/2020,101520,82L-IMPORT PAYROLL-ESCAMILLA OLGA,D108,HJ,15.19,,124605.71
6150,10/15/2020,10/15/2020,101520,82L-IMPORT PAYROLL-ESCAMILLA OLGA,D108,HJ,64.95,,124670.66
6150,10/15/2020,10/15/2020,101520,82L-IMPORT PAYROLL-GARCIA SANTIAGO,D108,HJ,23.6,,124694.26
6150,10/15/2020,10/15/2020,101520,82L-IMPORT PAYROLL-GARCIA SANTIAGO,D108,HJ,32.33,,124726.59
6150,10/15/2020,10/15/2020,101520,82L-IMPORT PAYROLL-GARCIA SANTIAGO,D108,HJ,138.25,,124864.84
6150,10/15/2020,10/15/2020,101520,82L-IMPORT PAYROLL-GILES SHAYLA,D108,HJ,15.19,,124880.03
6150,10/15/2020,10/15/2020,101520,82L-IMPORT PAYROLL-GILES SHAYLA,D108,HJ,28.29,,124908.32
6150,10/15/2020,10/15/2020,101520,82L-IMPORT PAYROLL-GILES SHAYLA,D108,HJ,64.95,,124973.27
6150,10/15/2020,10/15/2020,101520,82L-IMPORT PAYROLL-IKUNIKA FUNMILAYO,D108,HJ,41.34,,125014.61
6150,10/15/2020,10/15/2020,101520,82L-IMPORT PAYROLL-IKUNIKA FUNMILAYO,D108,HJ,76.99,,125091.6
6150,10/15/2020,10/15/2020,101520,82L-IMPORT PAYROLL-IKUNIKA FUNMILAYO,D108,HJ,176.78,,125268.38
6150,10/15/2020,10/15/2020,101520,82L-IMPORT PAYROLL-JONES JORDAN,D108,HJ,15.19,,125283.57
6150,10/15/2020,10/15/2020,101520,82L-IMPORT PAYROLL-JONES JORDAN,D108,HJ,64.95,,125348.52
6150,10/15/2020,10/15/2020,101520,82L-IMPORT PAYROLL-KHAN HUDA,D108,HJ,14.25,,125362.77
6150,10/15/2020,10/15/2020,101520,82L-IMPORT PAYROLL-KHAN HUDA,D108,HJ,26.53,,125389.3
6150,10/15/2020,10/15/2020,101520,82L-IMPORT PAYROLL-KHAN HUDA,D108,HJ,60.92,,125450.22
6150,10/15/2020,10/15/2020,101520,82L-IMPORT PAYROLL-KLOHR TIMOTHY JORDAN,D108,HJ,31.67,,125481.89
6150,10/15/2020,10/15/2020,101520,82L-IMPORT PAYROLL-KLOHR TIMOTHY JORDAN,D108,HJ,135.4,,125617.29
6150,10/15/2020,10/15/2020,101520,82L-IMPORT PAYROLL-KNOWLIN ZYLIA,D108,HJ,38.02,,125655.31
6150,10/15/2020,10/15/2020,101520,82L-IMPORT PAYROLL-KNOWLIN ZYLIA,D108,HJ,70.8,,125726.11
6150,10/15/2020,10/15/2020,101520,82L-IMPORT PAYROLL-KNOWLIN ZYLIA,D108,HJ,162.58,,125888.69
6150,10/15/2020,10/15/2020,101520,82L-IMPORT PAYROLL-KOPSHEVER MELISSA,D108,HJ,42.15,,125930.84
6150,10/15/2020,10/15/2020,101520,82L-IMPORT PAYROLL-KOPSHEVER MELISSA,D108,HJ,180.21,,126111.05
6150,10/15/2020,10/15/2020,101520,82L-IMPORT PAYROLL-LI SEN,D108,HJ,14.05,,126125.1
6150,10/15/2020,10/15/2020,101520,82L-IMPORT PAYROLL-LI SEN,D108,HJ,26.16,,126151.26
6150,10/15/2020,10/15/2020,101520,82L-IMPORT PAYROLL-LI SEN,D108,HJ,60.07,,126211.33
6150,10/15/2020,10/15/2020,101520,82L-IMPORT PAYROLL-LIPSCOMB STEPHEN,D108,HJ,36.97,,126248.3
6150,10/15/2020,10/15/2020,101520,82L-IMPORT PAYROLL-LIPSCOMB STEPHEN,D108,HJ,158.08,,126406.38
6150,10/15/2020,10/15/2020,101520,82L-IMPORT PAYROLL-MALLECK JESSICA R,D108,HJ,15.19,,126421.57
6150,10/15/2020,10/15/2020,101520,82L-IMPORT PAYROLL-MALLECK JESSICA R,D108,HJ,64.95,,126486.52
6150,10/15/2020,10/15/2020,101520,82L-IMPORT PAYROLL-MCLAUGHLIN MARA,D108,HJ,15.19,,126501.71
6150,10/15/2020,10/15/2020,101520,82L-IMPORT PAYROLL-MCLAUGHLIN MARA,D108,HJ,64.95,,126566.66
6150,10/15/2020,10/15/2020,101520,82L-IMPORT PAYROLL-MEJIA CARLOS MANUEL,D108,HJ,14.01,,126580.67
6150,10/15/2020,10/15/2020,101520,82L-IMPORT PAYROLL-MEJIA CARLOS MANUEL,D108,HJ,59.89,,126640.56
6150,10/15/2020,10/15/2020,101520,82L-IMPORT PAYROLL-MONROY-MEJIA JASON,D108,HJ,15.19,,126655.75
6150,10/15/2020,10/15/2020,101520,82L-IMPORT PAYROLL-MONROY-MEJIA JASON,D108,HJ,36.67,,126692.42
6150,10/15/2020,10/15/2020,101520,82L-IMPORT PAYROLL-MONROY-MEJIA JASON,D108,HJ,64.95,,126757.37
6150,10/15/2020,10/15/2020,101520,82L-IMPORT PAYROLL-O'FLYNN-PRUITT NATHAN COLYAR,D108,HJ,15.19,,126772.56
6150,10/15/2020,10/15/2020,101520,82L-IMPORT PAYROLL-O'FLYNN-PRUITT NATHAN COLYAR,D108,HJ,36.67,,126809.23
6150,10/15/2020,10/15/2020,101520,82L-IMPORT PAYROLL-O'FLYNN-PRUITT NATHAN COLYAR,D108,HJ,64.95,,126874.18
6150,10/15/2020,10/15/2020,101520,82L-IMPORT PAYROLL-PATTERSON STEVE,D108,HJ,15.19,,126889.37
6150,10/15/2020,10/15/2020,101520,82L-IMPORT PAYROLL-PATTERSON STEVE,D108,HJ,28.29,,126917.66
6150,10/15/2020,10/15/2020,101520,82L-IMPORT PAYROLL-PATTERSON STEVE,D108,HJ,64.95,,126982.61
6150,10/15/2020,10/15/2020,101520,82L-IMPORT PAYROLL-SCHMIESS RACHEL JOY,D108,HJ,15.19,,126997.8
6150,10/15/2020,10/15/2020,101520,82L-IMPORT PAYROLL-SCHMIESS RACHEL JOY,D108,HJ,64.95,,127062.75
6150,10/15/2020,10/15/2020,101520,82L-IMPORT PAYROLL-SCOTT KIRK,D108,HJ,14.05,,127076.8
6150,10/15/2020,10/15/2020,101520,82L-IMPORT PAYROLL-SCOTT KIRK,D108,HJ,26.16,,127102.96
6150,10/15/2020,10/15/2020,101520,82L-IMPORT PAYROLL-SCOTT KIRK,D108,HJ,60.07,,127163.03
6150,10/15/2020,10/15/2020,101520,82L-IMPORT PAYROLL-SILVER KELLY,D108,HJ,38.02,,127201.05
6150,10/15/2020,10/15/2020,101520,82L-IMPORT PAYROLL-SILVER KELLY,D108,HJ,162.56,,127363.61
6150,10/15/2020,10/15/2020,101520,82L-IMPORT PAYROLL-SOLIMAN MARK,D108,HJ,15.19,,127378.8
6150,10/15/2020,10/15/2020,101520,82L-IMPORT PAYROLL-SOLIMAN MARK,D108,HJ,36.67,,127415.47
6150,10/15/2020,10/15/2020,101520,82L-IMPORT PAYROLL-SOLIMAN MARK,D108,HJ,64.95,,127480.42
6150,10/15/2020,10/15/2020,101520,82L-IMPORT PAYROLL-STEIN KYLE,D108,HJ,30.62,,127511.04
6150,10/15/2020,10/15/2020,101520,82L-IMPORT PAYROLL-STEIN KYLE,D108,HJ,57.01,,127568.05
6150,10/15/2020,10/15/2020,101520,82L-IMPORT PAYROLL-STEIN KYLE,D108,HJ,130.91,,127698.96
6150,10/15/2020,10/15/2020,101520,82L-IMPORT PAYROLL-STROUD DAVID,D108,HJ,14.65,,127713.61
6150,10/15/2020,10/15/2020,101520,82L-IMPORT PAYROLL-STROUD DAVID,D108,HJ,62.62,,127776.23
6150,10/15/2020,10/15/2020,101520,82L-IMPORT PAYROLL-VALCIN SABRINA JEMIMAH,D108,HJ,14.25,,127790.48
6150,10/15/2020,10/15/2020,101520,82L-IMPORT PAYROLL-VALCIN SABRINA JEMIMAH,D108,HJ,26.53,,127817.01
6150,10/15/2020,10/15/2020,101520,82L-IMPORT PAYROLL-VALCIN SABRINA JEMIMAH,D108,HJ,60.92,,127877.93
6150,10/15/2020,10/15/2020,101520,82L-IMPORT PAYROLL-VALDES ERNEST L,D108,HJ,15.19,,127893.12
6150,10/15/2020,10/15/2020,101520,82L-IMPORT PAYROLL-VALDES ERNEST L,D108,HJ,36.67,,127929.79
6150,10/15/2020,10/15/2020,101520,82L-IMPORT PAYROLL-VALDES ERNEST L,D108,HJ,64.95,,127994.74
6150,10/15/2020,10/15/2020,101520,82L-IMPORT PAYROLL-WILLIAMS MACK,D108,HJ,15.02,,128009.76
6150,10/15/2020,10/15/2020,101520,82L-IMPORT PAYROLL-WILLIAMS MACK,D108,HJ,27.96,,128037.72
6150,10/15/2020,10/15/2020,101520,82L-IMPORT PAYROLL-WILLIAMS MACK,D108,HJ,64.21,,128101.93
6150,10/15/2020,10/15/2020,101520,82L-IMPORT PAYROLL-WILLIAMS MIL'YONTA,D108,HJ,15.19,,128117.12
6150,10/15/2020,10/15/2020,101520,82L-IMPORT PAYROLL-WILLIAMS MIL'YONTA,D108,HJ,64.95,,128182.07
6150,10/15/2020,10/15/2020,101520,82L-IMPORT PAYROLL-ANTHONY BETTY,D108,HJ,41.85,,128223.92
6150,10/15/2020,10/15/2020,101520,82L-IMPORT PAYROLL-ANTHONY BETTY,D108,HJ,178.96,,128402.88
6150,10/15/2020,10/15/2020,101520,82L-IMPORT PAYROLL-APULI LINDSAY,D108,HJ,34.16,,128437.04
6150,10/15/2020,10/15/2020,101520,82L-IMPORT PAYROLL-APULI LINDSAY,D108,HJ,146.08,,128583.12
6150,10/15/2020,10/15/2020,101520,82L-IMPORT PAYROLL-AUSTIN PERCY,D108,HJ,36.34,,128619.46
6150,10/15/2020,10/15/2020,101520,82L-IMPORT PAYROLL-AUSTIN PERCY,D108,HJ,155.39,,128774.85
6150,10/15/2020,10/15/2020,101520,82L-IMPORT PAYROLL-BUHMANN JAY,D108,HJ,32.9,,128807.75
6150,10/15/2020,10/15/2020,101520,82L-IMPORT PAYROLL-BUHMANN JAY,D108,HJ,140.69,,128948.44
6150,10/15/2020,10/15/2020,101520,82L-IMPORT PAYROLL-CAIN CORY,D108,HJ,33.3,,128981.74
6150,10/15/2020,10/15/2020,101520,82L-IMPORT PAYROLL-CAIN CORY,D108,HJ,142.38,,129124.12
6150,10/15/2020,10/15/2020,101520,82L-IMPORT PAYROLL-CHAPMAN CLAUDY EARL,D108,HJ,26.38,,129150.5
6150,10/15/2020,10/15/2020,101520,82L-IMPORT PAYROLL-CHAPMAN CLAUDY EARL,D108,HJ,112.81,,129263.31
6150,10/15/2020,10/15/2020,101520,82L-IMPORT PAYROLL-DADA ARIKPO,D108,HJ,30.83,,129294.14
6150,10/15/2020,10/15/2020,101520,82L-IMPORT PAYROLL-DADA ARIKPO,D108,HJ,131.84,,129425.98
6150,10/15/2020,10/15/2020,101520,82L-IMPORT PAYROLL-GUTHRIE LESLIE,D108,HJ,33.42,,129459.4
6150,10/15/2020,10/15/2020,101520,82L-IMPORT PAYROLL-GUTHRIE LESLIE,D108,HJ,142.9,,129602.3
6150,10/15/2020,10/15/2020,101520,82L-IMPORT PAYROLL-HOLMES JOREL ALEXANDER,D108,HJ,31.22,,129633.52
6150,10/15/2020,10/15/2020,101520,82L-IMPORT PAYROLL-HOLMES JOREL ALEXANDER,D108,HJ,133.51,,129767.03
6150,10/15/2020,10/15/2020,101520,82L-IMPORT PAYROLL-JORDAN TIFFANY T,D108,HJ,45.87,,129812.9
6150,10/15/2020,10/15/2020,101520,82L-IMPORT PAYROLL-JORDAN TIFFANY T,D108,HJ,196.13,,130009.03
6150,10/15/2020,10/15/2020,101520,82L-IMPORT PAYROLL-LANIGAN LISA A,D108,HJ,45.1,,130054.13
6150,10/15/2020,10/15/2020,101520,82L-IMPORT PAYROLL-LANIGAN LISA A,D108,HJ,192.83,,130246.96
6150,10/15/2020,10/15/2020,101520,82L-IMPORT PAYROLL-MCELWEE MELISSA,D108,HJ,38.67,,130285.63
6150,10/15/2020,10/15/2020,101520,82L-IMPORT PAYROLL-MCELWEE MELISSA,D108,HJ,165.33,,130450.96
6150,10/15/2020,10/15/2020,101520,82L-IMPORT PAYROLL-MCNICHOLAS MARY,D108,HJ,33.23,,130484.19
6150,10/15/2020,10/15/2020,101520,82L-IMPORT PAYROLL-MCNICHOLAS MARY,D108,HJ,142.08,,130626.27
6150,10/15/2020,10/15/2020,101520,82L-IMPORT PAYROLL-NWAKANMA NANCY,D108,HJ,73.18,,130699.45
6150,10/15/2020,10/15/2020,101520,82L-IMPORT PAYROLL-NWAKANMA NANCY,D108,HJ,312.89,,131012.34
6150,10/15/2020,10/15/2020,101520,82L-IMPORT PAYROLL-ONICA ANTHONY J,D108,HJ,31.33,,131043.67
6150,10/15/2020,10/15/2020,101520,82L-IMPORT PAYROLL-ONICA ANTHONY J,D108,HJ,133.98,,131177.65
6150,10/15/2020,10/15/2020,101520,82L-IMPORT PAYROLL-PRAHIN NICOLE M,D108,HJ,23.81,,131201.46
6150,10/15/2020,10/15/2020,101520,82L-IMPORT PAYROLL-PRAHIN NICOLE M,D108,HJ,29.1,,131230.56
6150,10/15/2020,10/15/2020,101520,82L-IMPORT PAYROLL-PRAHIN NICOLE M,D108,HJ,101.8,,131332.36
6150,10/15/2020,10/15/2020,101520,82L-IMPORT PAYROLL-PRAHIN NICOLE M,D108,HJ,124.42,,131456.78
6150,10/15/2020,10/15/2020,101520,82L-IMPORT PAYROLL-RIVERS QUIONNA DIANE,D108,HJ,68.27,,131525.05
6150,10/15/2020,10/15/2020,101520,82L-IMPORT PAYROLL-RIVERS QUIONNA DIANE,D108,HJ,291.92,,131816.97
6150,10/15/2020,10/15/2020,101520,82L-IMPORT PAYROLL-SALIM YASSER,D108,HJ,33.1,,131850.07
6150,10/15/2020,10/15/2020,101520,82L-IMPORT PAYROLL-SALIM YASSER,D108,HJ,141.55,,131991.62
6150,10/15/2020,10/15/2020,101520,82L-IMPORT PAYROLL-SEJOUR MAHALIAH,D108,HJ,34.07,,132025.69
6150,10/15/2020,10/15/2020,101520,82L-IMPORT PAYROLL-SEJOUR MAHALIAH,D108,HJ,145.66,,132171.35
6150,10/15/2020,10/15/2020,101520,82L-IMPORT PAYROLL-SKALSKI CHRISTOPHER,D108,HJ,33.86,,132205.21
6150,10/15/2020,10/15/2020,101520,82L-IMPORT PAYROLL-SKALSKI CHRISTOPHER,D108,HJ,144.76,,132349.97
6150,10/15/2020,10/15/2020,101520,82L-IMPORT PAYROLL-TUMENJARGAL ENKHJIN,D108,HJ,32.92,,132382.89
6150,10/15/2020,10/15/2020,101520,82L-IMPORT PAYROLL-TUMENJARGAL ENKHJIN,D108,HJ,140.75,,132523.64
6150,10/15/2020,10/15/2020,101520,82L-IMPORT PAYROLL-VILLEGAS EVELYN,D108,HJ,33.4,,132557.04
6150,10/15/2020,10/15/2020,101520,82L-IMPORT PAYROLL-VILLEGAS EVELYN,D108,HJ,142.81,,132699.85
6150,10/15/2020,10/15/2020,101520,82L-IMPORT PAYROLL-WOLF ANNA A,D108,HJ,36.3,,132736.15
6150,10/15/2020,10/15/2020,101520,82L-IMPORT PAYROLL-WOLF ANNA A,D108,HJ,155.19,,132891.34
6150,10/15/2020,10/15/2020,101520,82L-IMPORT PAYROLL-ACEVEDO MONIVETT,D107,HJ,72.42,,132963.76
6150,10/15/2020,10/15/2020,101520,82L-IMPORT PAYROLL-ACEVEDO MONIVETT,D107,HJ,309.64,,133273.4
6150,10/15/2020,10/15/2020,101520,82L-IMPORT PAYROLL-AKLESTAD ISABEL,D111,HJ,23.29,,133296.69
6150,10/15/2020,10/15/2020,101520,82L-IMPORT PAYROLL-AKLESTAD ISABEL,D111,HJ,99.58,,133396.27
6150,10/15/2020,10/15/2020,101520,82L-IMPORT PAYROLL-ALLEN KIMBERLY,D111,HJ,26.58,,133422.85
6150,10/15/2020,10/15/2020,101520,82L-IMPORT PAYROLL-ALLEN KIMBERLY,D111,HJ,113.67,,133536.52
6150,10/15/2020,10/15/2020,101520,82L-IMPORT PAYROLL-BIBB TIFFANI,D104,HJ,49.71,,133586.23
6150,10/15/2020,10/15/2020,101520,82L-IMPORT PAYROLL-BIBB TIFFANI,D104,HJ,50.56,,133636.79
6150,10/15/2020,10/15/2020,101520,82L-IMPORT PAYROLL-BIBB TIFFANI,D104,HJ,212.55,,133849.34
6150,10/15/2020,10/15/2020,101520,82L-IMPORT PAYROLL-Bowman Halley,D101,HJ,46.01,,133895.35
6150,10/15/2020,10/15/2020,101520,82L-IMPORT PAYROLL-Bowman Halley,D101,HJ,196.72,,134092.07
6150,10/15/2020,10/15/2020,101520,82L-IMPORT PAYROLL-COOK CATHRYN ANNA,D105,HJ,49.87,,134141.94
6150,10/15/2020,10/15/2020,101520,82L-IMPORT PAYROLL-COOK CATHRYN ANNA,D105,HJ,213.25,,134355.19
6150,10/15/2020,10/15/2020,101520,82L-IMPORT PAYROLL-COOPER ASHLEE R,D101,HJ,33.51,,134388.7
6150,10/15/2020,10/15/2020,101520,82L-IMPORT PAYROLL-COOPER ASHLEE R,D101,HJ,143.3,,134532
6150,10/15/2020,10/15/2020,101520,82L-IMPORT PAYROLL-CORTEZ MIRANDA A,D111,HJ,38.45,,134570.45
6150,10/15/2020,10/15/2020,101520,82L-IMPORT PAYROLL-CORTEZ MIRANDA A,D111,HJ,164.42,,134734.87
6150,10/15/2020,10/15/2020,101520,82L-IMPORT PAYROLL-DAUGHERTY DEVIN W,D101,HJ,15.1,,134749.97
6150,10/15/2020,10/15/2020,101520,82L-IMPORT PAYROLL-DAUGHERTY DEVIN W,D101,HJ,64.58,,134814.55
6150,10/15/2020,10/15/2020,101520,82L-IMPORT PAYROLL-DETONE KYRA MAYA,D102,HJ,2.73,,134817.28
6150,10/15/2020,10/15/2020,101520,82L-IMPORT PAYROLL-DETONE KYRA MAYA,D102,HJ,11.67,,134828.95
6150,10/15/2020,10/15/2020,101520,82L-IMPORT PAYROLL-DETONE KYRA MAYA,D102,HJ,36.27,,134865.22
6150,10/15/2020,10/15/2020,101520,82L-IMPORT PAYROLL-DETONE KYRA MAYA,D102,HJ,155.08,,135020.3
6150,10/15/2020,10/15/2020,101520,82L-IMPORT PAYROLL-DUPUIS CHRISTOPHER M,D107,HJ,34.6,,135054.9
6150,10/15/2020,10/15/2020,101520,82L-IMPORT PAYROLL-DUPUIS CHRISTOPHER M,D107,HJ,54.14,,135109.04
6150,10/15/2020,10/15/2020,101520,82L-IMPORT PAYROLL-DUPUIS CHRISTOPHER M,D107,HJ,147.98,,135257.02
6150,10/15/2020,10/15/2020,101520,82L-IMPORT PAYROLL-DUPUIS CHRISTOPHER M,D107,HJ,231.47,,135488.49
6150,10/15/2020,10/15/2020,101520,82L-IMPORT PAYROLL-DZIEDZIC JULIE K,D101,HJ,17.71,,135506.2
6150,10/15/2020,10/15/2020,101520,82L-IMPORT PAYROLL-DZIEDZIC JULIE K,D101,HJ,75.71,,135581.91
6150,10/15/2020,10/15/2020,101520,82L-IMPORT PAYROLL-GORNSTEIN STEVEN,D101,HJ,39.27,,135621.18
6150,10/15/2020,10/15/2020,101520,82L-IMPORT PAYROLL-GORNSTEIN STEVEN,D101,HJ,167.92,,135789.1
6150,10/15/2020,10/15/2020,101520,82L-IMPORT PAYROLL-GUADARRAMA-ALVAREZ URIEL A,D105,HJ,39.93,,135829.03
6150,10/15/2020,10/15/2020,101520,82L-IMPORT PAYROLL-GUADARRAMA-ALVAREZ URIEL A,D105,HJ,170.75,,135999.78
6150,10/15/2020,10/15/2020,101520,82L-IMPORT PAYROLL-GUTIERREZ ANTONIO J,D107,HJ,33.41,,136033.19
6150,10/15/2020,10/15/2020,101520,82L-IMPORT PAYROLL-GUTIERREZ ANTONIO J,D107,HJ,40.84,,136074.03
6150,10/15/2020,10/15/2020,101520,82L-IMPORT PAYROLL-GUTIERREZ ANTONIO J,D107,HJ,142.87,,136216.9
6150,10/15/2020,10/15/2020,101520,82L-IMPORT PAYROLL-GUTIERREZ ANTONIO J,D107,HJ,174.61,,136391.51
6150,10/15/2020,10/15/2020,101520,82L-IMPORT PAYROLL-HENRY GILLIAN,D102,HJ,2.63,,136394.14
6150,10/15/2020,10/15/2020,101520,82L-IMPORT PAYROLL-HENRY GILLIAN,D102,HJ,11.23,,136405.37
6150,10/15/2020,10/15/2020,101520,82L-IMPORT PAYROLL-HENRY GILLIAN,D102,HJ,26.54,,136431.91
6150,10/15/2020,10/15/2020,101520,82L-IMPORT PAYROLL-HENRY GILLIAN,D102,HJ,70.42,,136502.33
6150,10/15/2020,10/15/2020,101520,82L-IMPORT PAYROLL-HENRY GILLIAN,D102,HJ,113.51,,136615.84
6150,10/15/2020,10/15/2020,101520,82L-IMPORT PAYROLL-HERMAN ADAM,D102,HJ,28.2,,136644.04
6150,10/15/2020,10/15/2020,101520,82L-IMPORT PAYROLL-HERMAN ADAM,D102,HJ,120.56,,136764.6
6150,10/15/2020,10/15/2020,101520,82L-IMPORT PAYROLL-HESTER TYLER CONRAD,D105,HJ,27.79,,136792.39
6150,10/15/2020,10/15/2020,101520,82L-IMPORT PAYROLL-HESTER TYLER CONRAD,D105,HJ,118.83,,136911.22
6150,10/15/2020,10/15/2020,101520,82L-IMPORT PAYROLL-Import Payroll,D107,HJ,,16.53,136894.69
6150,10/15/2020,10/15/2020,101520,82L-IMPORT PAYROLL-Import Payroll,D107,HJ,,17.57,136877.12
6150,10/15/2020,10/15/2020,101520,82L-IMPORT PAYROLL-Import Payroll,D107,HJ,,28.29,136848.83
6150,10/15/2020,10/15/2020,101520,82L-IMPORT PAYROLL-Import Payroll,D107,HJ,,48.58,136800.25
6150,10/15/2020,10/15/2020,101520,82L-IMPORT PAYROLL-LIPORACE HERNAN LUIS,D103,HJ,33.06,,136833.31
6150,10/15/2020,10/15/2020,101520,82L-IMPORT PAYROLL-LIPORACE HERNAN LUIS,D103,HJ,141.34,,136974.65
6150,10/15/2020,10/15/2020,101520,82L-IMPORT PAYROLL-MASON ANGELA,D107,HJ,21.21,,136995.86
6150,10/15/2020,10/15/2020,101520,82L-IMPORT PAYROLL-MASON ANGELA,D107,HJ,57.36,,137053.22
6150,10/15/2020,10/15/2020,101520,82L-IMPORT PAYROLL-MASON ANGELA,D107,HJ,90.71,,137143.93
6150,10/15/2020,10/15/2020,101520,82L-IMPORT PAYROLL-MASON ANGELA,D107,HJ,245.26,,137389.19
6150,10/15/2020,10/15/2020,101520,82L-IMPORT PAYROLL-O'DONNELL STEPHEN,D104,HJ,39.26,,137428.45
6150,10/15/2020,10/15/2020,101520,82L-IMPORT PAYROLL-O'DONNELL STEPHEN,D104,HJ,167.87,,137596.32
6150,10/15/2020,10/15/2020,101520,82L-IMPORT PAYROLL-PARETS MALLORY GRACE,D101,HJ,17.57,,137613.89
6150,10/15/2020,10/15/2020,101520,82L-IMPORT PAYROLL-PARETS MALLORY GRACE,D101,HJ,41.08,,137654.97
6150,10/15/2020,10/15/2020,101520,82L-IMPORT PAYROLL-PARETS MALLORY GRACE,D101,HJ,175.67,,137830.64
6150,10/15/2020,10/15/2020,101520,82L-IMPORT PAYROLL-PARHAM-GANTT DENISE M,D112,HJ,37.96,,137868.6
6150,10/15/2020,10/15/2020,101520,82L-IMPORT PAYROLL-PARHAM-GANTT DENISE M,D112,HJ,162.32,,138030.92
6150,10/15/2020,10/15/2020,101520,82L-IMPORT PAYROLL-PEINADO ELIZABETH R,D111,HJ,52.29,,138083.21
6150,10/15/2020,10/15/2020,101520,82L-IMPORT PAYROLL-PEINADO ELIZABETH R,D111,HJ,223.58,,138306.79
6150,10/15/2020,10/15/2020,101520,82L-IMPORT PAYROLL-POLANCO ODALIS,D103,HJ,43.23,,138350.02
6150,10/15/2020,10/15/2020,101520,82L-IMPORT PAYROLL-POLANCO ODALIS,D103,HJ,184.83,,138534.85
6150,10/15/2020,10/15/2020,101520,82L-IMPORT PAYROLL-QUINTAS JASHIVE,D105,HJ,2.3,,138537.15
6150,10/15/2020,10/15/2020,101520,82L-IMPORT PAYROLL-QUINTAS JASHIVE,D105,HJ,9.84,,138546.99
6150,10/15/2020,10/15/2020,101520,82L-IMPORT PAYROLL-QUINTAS JASHIVE,D105,HJ,23.27,,138570.26
6150,10/15/2020,10/15/2020,101520,82L-IMPORT PAYROLL-QUINTAS JASHIVE,D105,HJ,99.47,,138669.73
6150,10/15/2020,10/15/2020,101520,82L-IMPORT PAYROLL-RANDOLPH ALEXANDER,D111,HJ,11.63,,138681.36
6150,10/15/2020,10/15/2020,101520,82L-IMPORT PAYROLL-RANDOLPH ALEXANDER,D111,HJ,25.1,,138706.46
6150,10/15/2020,10/15/2020,101520,82L-IMPORT PAYROLL-RANDOLPH ALEXANDER,D111,HJ,107.33,,138813.79
6150,10/15/2020,10/15/2020,101520,82L-IMPORT PAYROLL-RUBI PERLA,D101,HJ,15.92,,138829.71
6150,10/15/2020,10/15/2020,101520,82L-IMPORT PAYROLL-RUBI PERLA,D101,HJ,68.09,,138897.8
6150,10/15/2020,10/15/2020,101520,82L-IMPORT PAYROLL-SAFRAN ALAN P,D107,HJ,9.76,,138907.56
6150,10/15/2020,10/15/2020,101520,82L-IMPORT PAYROLL-SAFRAN ALAN P,D107,HJ,26.98,,138934.54
6150,10/15/2020,10/15/2020,101520,82L-IMPORT PAYROLL-SAFRAN ALAN P,D107,HJ,98.67,,139033.21
6150,10/15/2020,10/15/2020,101520,82L-IMPORT PAYROLL-SAFRAN ALAN P,D107,HJ,272.84,,139306.05
6150,10/15/2020,10/15/2020,101520,82L-IMPORT PAYROLL-SHENKMAN OLIVIA,D101,HJ,29,,139335.05
6150,10/15/2020,10/15/2020,101520,82L-IMPORT PAYROLL-SHENKMAN OLIVIA,D101,HJ,124,,139459.05
6150,10/15/2020,10/15/2020,101520,82L-IMPORT PAYROLL-SHI GRACE,D103,HJ,12.69,,139471.74
6150,10/15/2020,10/15/2020,101520,82L-IMPORT PAYROLL-SHI GRACE,D103,HJ,54.25,,139525.99
6150,10/15/2020,10/15/2020,101520,82L-IMPORT PAYROLL-WALLACE AMENA,D104,HJ,28.93,,139554.92
6150,10/15/2020,10/15/2020,101520,82L-IMPORT PAYROLL-WALLACE AMENA,D104,HJ,123.72,,139678.64
6150,10/15/2020,10/15/2020,101520,82L-IMPORT PAYROLL-WEINSTOCK EMILY,D101,HJ,17.57,,139696.21
6150,10/15/2020,10/15/2020,101520,82L-IMPORT PAYROLL-WEINSTOCK EMILY,D101,HJ,38.11,,139734.32
6150,10/15/2020,10/15/2020,101520,82L-IMPORT PAYROLL-WEINSTOCK EMILY,D101,HJ,162.94,,139897.26
6150,10/15/2020,10/15/2020,101520,82L-IMPORT PAYROLL-WINANS JENNIFER,D111,HJ,36.33,,139933.59
6150,10/15/2020,10/15/2020,101520,82L-IMPORT PAYROLL-WINANS JENNIFER,D111,HJ,155.35,,140088.94
6150,10/15/2020,10/15/2020,101520,82L-IMPORT PAYROLL-ZARATE JOSEPH M,D105,HJ,31.18,,140120.12
6150,10/15/2020,10/15/2020,101520,82L-IMPORT PAYROLL-ZARATE JOSEPH M,D105,HJ,133.3,,140253.42
6150,10/15/2020,10/15/2020,101520,82L-IMPORT PAYROLL-AGUANNO JOSEPH,D108,HJ,16.23,,140269.65
6150,10/15/2020,10/15/2020,101520,82L-IMPORT PAYROLL-AGUANNO JOSEPH,D108,HJ,69.38,,140339.03
6150,10/15/2020,10/15/2020,101520,82L-IMPORT PAYROLL-AKESODE FEHINTOLA,D108,HJ,16.23,,140355.26
6150,10/15/2020,10/15/2020,101520,82L-IMPORT PAYROLL-AKESODE FEHINTOLA,D108,HJ,69.38,,140424.64
6150,10/15/2020,10/15/2020,101520,82L-IMPORT PAYROLL-BARTOLD DEANNA MARIE,D108,HJ,41.91,,140466.55
6150,10/15/2020,10/15/2020,101520,82L-IMPORT PAYROLL-BARTOLD DEANNA MARIE,D108,HJ,179.22,,140645.77
6150,10/15/2020,10/15/2020,101520,82L-IMPORT PAYROLL-BELLOT GENESIS,D108,HJ,32.36,,140678.13
6150,10/15/2020,10/15/2020,101520,82L-IMPORT PAYROLL-BELLOT GENESIS,D108,HJ,138.38,,140816.51
6150,10/15/2020,10/15/2020,101520,82L-IMPORT PAYROLL-BENNETT JAMES H,D108,HJ,16.23,,140832.74
6150,10/15/2020,10/15/2020,101520,82L-IMPORT PAYROLL-BENNETT JAMES H,D108,HJ,69.38,,140902.12
6150,10/15/2020,10/15/2020,101520,82L-IMPORT PAYROLL-BOWMAN ABIGAIL,D108,HJ,16.23,,140918.35
6150,10/15/2020,10/15/2020,101520,82L-IMPORT PAYROLL-BOWMAN ABIGAIL,D108,HJ,69.38,,140987.73
6150,10/15/2020,10/15/2020,101520,82L-IMPORT PAYROLL-BURRELL RUSSELL,D108,HJ,15.08,,141002.81
6150,10/15/2020,10/15/2020,101520,82L-IMPORT PAYROLL-BURRELL RUSSELL,D108,HJ,64.5,,141067.31
6150,10/15/2020,10/15/2020,101520,82L-IMPORT PAYROLL-CHUI KENT,D108,HJ,16.23,,141083.54
6150,10/15/2020,10/15/2020,101520,82L-IMPORT PAYROLL-CHUI KENT,D108,HJ,69.38,,141152.92
6150,10/15/2020,10/15/2020,101520,82L-IMPORT PAYROLL-CIRKER MIA,D108,HJ,32.63,,141185.55
6150,10/15/2020,10/15/2020,101520,82L-IMPORT PAYROLL-CIRKER MIA,D108,HJ,139.5,,141325.05
6150,10/15/2020,10/15/2020,101520,82L-IMPORT PAYROLL-DEWS CAMERYN,D108,HJ,42.44,,141367.49
6150,10/15/2020,10/15/2020,101520,82L-IMPORT PAYROLL-DEWS CAMERYN,D108,HJ,181.45,,141548.94
6150,10/15/2020,10/15/2020,101520,82L-IMPORT PAYROLL-DIETZ MARY,D108,HJ,16.23,,141565.17
6150,10/15/2020,10/15/2020,101520,82L-IMPORT PAYROLL-DIETZ MARY,D108,HJ,69.38,,141634.55
6150,10/15/2020,10/15/2020,101520,82L-IMPORT PAYROLL-DOMINIQUE PRINCESSA,D108,HJ,16.23,,141650.78
6150,10/15/2020,10/15/2020,101520,82L-IMPORT PAYROLL-DOMINIQUE PRINCESSA,D108,HJ,69.38,,141720.16
6150,10/15/2020,10/15/2020,101520,82L-IMPORT PAYROLL-DONNELLY HOME,D108,HJ,16.23,,141736.39
6150,10/15/2020,10/15/2020,101520,82L-IMPORT PAYROLL-DONNELLY HOME,D108,HJ,21.49,,141757.88
6150,10/15/2020,10/15/2020,101520,82L-IMPORT PAYROLL-DONNELLY HOME,D108,HJ,69.38,,141827.26
6150,10/15/2020,10/15/2020,101520,82L-IMPORT PAYROLL-FEIGHERY JOHN,D108,HJ,30.56,,141857.82
6150,10/15/2020,10/15/2020,101520,82L-IMPORT PAYROLL-FEIGHERY JOHN,D108,HJ,130.69,,141988.51
6150,10/15/2020,10/15/2020,101520,82L-IMPORT PAYROLL-FORTH KYLE,D108,HJ,16.23,,142004.74
6150,10/15/2020,10/15/2020,101520,82L-IMPORT PAYROLL-FORTH KYLE,D108,HJ,69.38,,142074.12
6150,10/15/2020,10/15/2020,101520,82L-IMPORT PAYROLL-GARCIA MARILYN,D108,HJ,33.23,,142107.35
6150,10/15/2020,10/15/2020,101520,82L-IMPORT PAYROLL-GARCIA MARILYN,D108,HJ,142.08,,142249.43
6150,10/15/2020,10/15/2020,101520,82L-IMPORT PAYROLL-GREENE BROOKE,D108,HJ,15.28,,142264.71
6150,10/15/2020,10/15/2020,101520,82L-IMPORT PAYROLL-GREENE BROOKE,D108,HJ,65.35,,142330.06
6150,10/15/2020,10/15/2020,101520,82L-IMPORT PAYROLL-GRIFFIN ANDREW,D108,HJ,30.44,,142360.5
6150,10/15/2020,10/15/2020,101520,82L-IMPORT PAYROLL-GRIFFIN ANDREW,D108,HJ,130.16,,142490.66
6150,10/15/2020,10/15/2020,101520,82L-IMPORT PAYROLL-GROSS EMILY,D108,HJ,14,,142504.66
6150,10/15/2020,10/15/2020,101520,82L-IMPORT PAYROLL-GROSS EMILY,D108,HJ,59.86,,142564.52
6150,10/15/2020,10/15/2020,101520,82L-IMPORT PAYROLL-GUERRERO LUIS,D108,HJ,16.23,,142580.75
6150,10/15/2020,10/15/2020,101520,82L-IMPORT PAYROLL-GUERRERO LUIS,D108,HJ,69.38,,142650.13
6150,10/15/2020,10/15/2020,101520,82L-IMPORT PAYROLL-HALLINAN GABRIEL B,D108,HJ,34.79,,142684.92
6150,10/15/2020,10/15/2020,101520,82L-IMPORT PAYROLL-HALLINAN GABRIEL B,D108,HJ,148.76,,142833.68
6150,10/15/2020,10/15/2020,101520,82L-IMPORT PAYROLL-HAMERSLY WILLIAM,D108,HJ,34.16,,142867.84
6150,10/15/2020,10/15/2020,101520,82L-IMPORT PAYROLL-HAMERSLY WILLIAM,D108,HJ,146.08,,143013.92
6150,10/15/2020,10/15/2020,101520,82L-IMPORT PAYROLL-HOLDER LATIVA M,D108,HJ,55.28,,143069.2
6150,10/15/2020,10/15/2020,101520,82L-IMPORT PAYROLL-HOLDER LATIVA M,D108,HJ,236.38,,143305.58
6150,10/15/2020,10/15/2020,101520,82L-IMPORT PAYROLL-HOSSAIN MYESHA R,D108,HJ,35.1,,143340.68
6150,10/15/2020,10/15/2020,101520,82L-IMPORT PAYROLL-HOSSAIN MYESHA R,D108,HJ,150.1,,143490.78
6150,10/15/2020,10/15/2020,101520,82L-IMPORT PAYROLL-JACKSON TASNIM,D108,HJ,31,,143521.78
6150,10/15/2020,10/15/2020,101520,82L-IMPORT PAYROLL-JACKSON TASNIM,D108,HJ,132.56,,143654.34
6150,10/15/2020,10/15/2020,101520,82L-IMPORT PAYROLL-KERKHOFF HARPER FAITH,D108,HJ,16.23,,143670.57
6150,10/15/2020,10/15/2020,101520,82L-IMPORT PAYROLL-KERKHOFF HARPER FAITH,D108,HJ,69.38,,143739.95
6150,10/15/2020,10/15/2020,101520,82L-IMPORT PAYROLL-LEARY AUBREY,D108,HJ,16.2,,143756.15
6150,10/15/2020,10/15/2020,101520,82L-IMPORT PAYROLL-LEARY AUBREY,D108,HJ,69.27,,143825.42
6150,10/15/2020,10/15/2020,101520,82L-IMPORT PAYROLL-LI BELLA,D108,HJ,33.96,,143859.38
6150,10/15/2020,10/15/2020,101520,82L-IMPORT PAYROLL-LI BELLA,D108,HJ,145.23,,144004.61
6150,10/15/2020,10/15/2020,101520,82L-IMPORT PAYROLL-LOUIE JORDAN,D108,HJ,16.23,,144020.84
6150,10/15/2020,10/15/2020,101520,82L-IMPORT PAYROLL-LOUIE JORDAN,D108,HJ,69.38,,144090.22
6150,10/15/2020,10/15/2020,101520,82L-IMPORT PAYROLL-MELCHOR OSBEIDY,D108,HJ,16.23,,144106.45
6150,10/15/2020,10/15/2020,101520,82L-IMPORT PAYROLL-MELCHOR OSBEIDY,D108,HJ,69.38,,144175.83
6150,10/15/2020,10/15/2020,101520,82L-IMPORT PAYROLL-MITTLEMAN ROBERT,D108,HJ,16.23,,144192.06
6150,10/15/2020,10/15/2020,101520,82L-IMPORT PAYROLL-MITTLEMAN ROBERT,D108,HJ,69.38,,144261.44
6150,10/15/2020,10/15/2020,101520,82L-IMPORT PAYROLL-MORRIS ZAKIYA,D108,HJ,16.23,,144277.67
6150,10/15/2020,10/15/2020,101520,82L-IMPORT PAYROLL-MORRIS ZAKIYA,D108,HJ,69.38,,144347.05
6150,10/15/2020,10/15/2020,101520,82L-IMPORT PAYROLL-MORSELETTO RAFAEL,D108,HJ,10.48,,144357.53
6150,10/15/2020,10/15/2020,101520,82L-IMPORT PAYROLL-MORSELETTO RAFAEL,D108,HJ,44.83,,144402.36
6150,10/15/2020,10/15/2020,101520,82L-IMPORT PAYROLL-OBI TOBECHUKWU,D108,HJ,16.23,,144418.59
6150,10/15/2020,10/15/2020,101520,82L-IMPORT PAYROLL-OBI TOBECHUKWU,D108,HJ,69.38,,144487.97
6150,10/15/2020,10/15/2020,101520,82L-IMPORT PAYROLL-OPUH NDIDI,D108,HJ,34.73,,144522.7
6150,10/15/2020,10/15/2020,101520,82L-IMPORT PAYROLL-OPUH NDIDI,D108,HJ,148.51,,144671.21
6150,10/15/2020,10/15/2020,101520,82L-IMPORT PAYROLL-PAULINO THAIRI,D108,HJ,16.23,,144687.44
6150,10/15/2020,10/15/2020,101520,82L-IMPORT PAYROLL-PAULINO THAIRI,D108,HJ,69.38,,144756.82
6150,10/15/2020,10/15/2020,101520,82L-IMPORT PAYROLL-ROSENBAUM MURRAY,D108,HJ,16.23,,144773.05
6150,10/15/2020,10/15/2020,101520,82L-IMPORT PAYROLL-ROSENBAUM MURRAY,D108,HJ,69.38,,144842.43
6150,10/15/2020,10/15/2020,101520,82L-IMPORT PAYROLL-SCHWETTMANN CLAIRE,D108,HJ,15.28,,144857.71
6150,10/15/2020,10/15/2020,101520,82L-IMPORT PAYROLL-SCHWETTMANN CLAIRE,D108,HJ,65.35,,144923.06
6150,10/15/2020,10/15/2020,101520,82L-IMPORT PAYROLL-SOBELMAN JUSTIN,D108,HJ,15.08,,144938.14
6150,10/15/2020,10/15/2020,101520,82L-IMPORT PAYROLL-SOBELMAN JUSTIN,D108,HJ,64.5,,145002.64
6150,10/15/2020,10/15/2020,101520,82L-IMPORT PAYROLL-TERRENCE-SMITH ZIHIR UNIQUE,D108,HJ,14.32,,145016.96
6150,10/15/2020,10/15/2020,101520,82L-IMPORT PAYROLL-TERRENCE-SMITH ZIHIR UNIQUE,D108,HJ,61.22,,145078.18
6150,10/15/2020,10/15/2020,101520,82L-IMPORT PAYROLL-TILLERY ASIA,D108,HJ,47.73,,145125.91
6150,10/15/2020,10/15/2020,101520,82L-IMPORT PAYROLL-TILLERY ASIA,D108,HJ,204.08,,145329.99
6150,10/15/2020,10/15/2020,101520,82L-IMPORT PAYROLL-WILLIAMS- MASSEY BRIANNA M,D108,HJ,16.05,,145346.04
6150,10/15/2020,10/15/2020,101520,82L-IMPORT PAYROLL-WILLIAMS- MASSEY BRIANNA M,D108,HJ,68.64,,145414.68
6150,10/15/2020,10/15/2020,101520,82L-IMPORT PAYROLL-XIAO CHENGYAO,D108,HJ,16.23,,145430.91
6150,10/15/2020,10/15/2020,101520,82L-IMPORT PAYROLL-XIAO CHENGYAO,D108,HJ,69.38,,145500.29
6150,10/15/2020,10/15/2020,101520,82L-IMPORT PAYROLL-ZIAUDDIN ABUTAHER M,D108,HJ,16.23,,145516.52
6150,10/15/2020,10/15/2020,101520,82L-IMPORT PAYROLL-ZIAUDDIN ABUTAHER M,D108,HJ,69.38,,145585.9
6150,10/15/2020,10/15/2020,101520,82L-IMPORT PAYROLL-BALASUBRAMANIAN SHARANYA,D108,HJ,16.53,,145602.43
6150,10/15/2020,10/15/2020,101520,82L-IMPORT PAYROLL-BALASUBRAMANIAN SHARANYA,D108,HJ,38.67,,145641.1
6150,10/15/2020,10/15/2020,101520,82L-IMPORT PAYROLL-BALASUBRAMANIAN SHARANYA,D108,HJ,54,,145695.1
6150,10/15/2020,10/15/2020,101520,82L-IMPORT PAYROLL-BALASUBRAMANIAN SHARANYA,D108,HJ,165.33,,145860.43
6150,10/15/2020,10/15/2020,101520,82L-IMPORT PAYROLL-COVENEY ALLISON,D108,HJ,38.07,,145898.5
6150,10/15/2020,10/15/2020,101520,82L-IMPORT PAYROLL-COVENEY ALLISON,D108,HJ,162.79,,146061.29
6150,10/15/2020,10/15/2020,101520,82L-IMPORT PAYROLL-JACKSON CLAICE,D108,HJ,19.38,,146080.67
6150,10/15/2020,10/15/2020,101520,82L-IMPORT PAYROLL-JACKSON CLAICE,D108,HJ,42.91,,146123.58
6150,10/15/2020,10/15/2020,101520,82L-IMPORT PAYROLL-JACKSON CLAICE,D108,HJ,183.48,,146307.06
6150,10/15/2020,10/15/2020,101520,82L-IMPORT PAYROLL-JANG DANIEL,D108,HJ,37.75,,146344.81
6150,10/15/2020,10/15/2020,101520,82L-IMPORT PAYROLL-JANG DANIEL,D108,HJ,161.4,,146506.21
6150,10/15/2020,10/15/2020,101520,82L-IMPORT PAYROLL-LENEGHAN MARYELLEN,D108,HJ,30.08,,146536.29
6150,10/15/2020,10/15/2020,101520,82L-IMPORT PAYROLL-LENEGHAN MARYELLEN,D108,HJ,36.76,,146573.05
6150,10/15/2020,10/15/2020,101520,82L-IMPORT PAYROLL-LENEGHAN MARYELLEN,D108,HJ,128.6,,146701.65
6150,10/15/2020,10/15/2020,101520,82L-IMPORT PAYROLL-LENEGHAN MARYELLEN,D108,HJ,157.18,,146858.83
6150,10/30/2020,10/30/2020,103120,82L-IMPORT PAYROLL-ALWARDT CALEB,D108,HJ,4.21,,146863.04
6150,10/30/2020,10/30/2020,103120,82L-IMPORT PAYROLL-ALWARDT CALEB,D108,HJ,17.99,,146881.03
6150,10/30/2020,10/30/2020,103120,82L-IMPORT PAYROLL-BARTHELEMY RACHALIE,D108,HJ,14.01,,146895.04
6150,10/30/2020,10/30/2020,103120,82L-IMPORT PAYROLL-BARTHELEMY RACHALIE,D108,HJ,26.08,,146921.12
6150,10/30/2020,10/30/2020,103120,82L-IMPORT PAYROLL-BARTHELEMY RACHALIE,D108,HJ,59.89,,146981.01
6150,10/30/2020,10/30/2020,103120,82L-IMPORT PAYROLL-BASHAM WILLIAM EDWARD,D108,HJ,14.06,,146995.07
6150,10/30/2020,10/30/2020,103120,82L-IMPORT PAYROLL-BASHAM WILLIAM EDWARD,D108,HJ,60.11,,147055.18
6150,10/30/2020,10/30/2020,103120,82L-IMPORT PAYROLL-BOHLSEN GRACE ISABELLE,D108,HJ,15.16,,147070.34
6150,10/30/2020,10/30/2020,103120,82L-IMPORT PAYROLL-BOHLSEN GRACE ISABELLE,D108,HJ,64.84,,147135.18
6150,10/30/2020,10/30/2020,103120,82L-IMPORT PAYROLL-BOLIVAR ANDREA,D108,HJ,36.25,,147171.43
6150,10/30/2020,10/30/2020,103120,82L-IMPORT PAYROLL-BOLIVAR ANDREA,D108,HJ,67.5,,147238.93
6150,10/30/2020,10/30/2020,103120,82L-IMPORT PAYROLL-BOLIVAR ANDREA,D108,HJ,155,,147393.93
6150,10/30/2020,10/30/2020,103120,82L-IMPORT PAYROLL-BORCHART SPENCER,D108,HJ,15.19,,147409.12
6150,10/30/2020,10/30/2020,103120,82L-IMPORT PAYROLL-BORCHART SPENCER,D108,HJ,44.27,,147453.39
6150,10/30/2020,10/30/2020,103120,82L-IMPORT PAYROLL-BORCHART SPENCER,D108,HJ,64.95,,147518.34
6150,10/30/2020,10/30/2020,103120,82L-IMPORT PAYROLL-BROWN ISAAC,D108,HJ,14.01,,147532.35
6150,10/30/2020,10/30/2020,103120,82L-IMPORT PAYROLL-BROWN ISAAC,D108,HJ,20.14,,147552.49
6150,10/30/2020,10/30/2020,103120,82L-IMPORT PAYROLL-BROWN ISAAC,D108,HJ,59.89,,147612.38
6150,10/30/2020,10/30/2020,103120,82L-IMPORT PAYROLL-BURKE MARIAH,D108,HJ,15.19,,147627.57
6150,10/30/2020,10/30/2020,103120,82L-IMPORT PAYROLL-BURKE MARIAH,D108,HJ,64.95,,147692.52
6150,10/30/2020,10/30/2020,103120,82L-IMPORT PAYROLL-CASSADY JOSHUA LEWIS,D108,HJ,15.19,,147707.71
6150,10/30/2020,10/30/2020,103120,82L-IMPORT PAYROLL-CASSADY JOSHUA LEWIS,D108,HJ,28.29,,147736
6150,10/30/2020,10/30/2020,103120,82L-IMPORT PAYROLL-CASSADY JOSHUA LEWIS,D108,HJ,64.95,,147800.95
6150,10/30/2020,10/30/2020,103120,82L-IMPORT PAYROLL-DARKO OLIVIA,D108,HJ,15.19,,147816.14
6150,10/30/2020,10/30/2020,103120,82L-IMPORT PAYROLL-DARKO OLIVIA,D108,HJ,64.95,,147881.09
6150,10/30/2020,10/30/2020,103120,82L-IMPORT PAYROLL-DAWSON JAMIL NAFAYE-BEYAH,D108,HJ,15.19,,147896.28
6150,10/30/2020,10/30/2020,103120,82L-IMPORT PAYROLL-DAWSON JAMIL NAFAYE-BEYAH,D108,HJ,64.95,,147961.23
6150,10/30/2020,10/30/2020,103120,82L-IMPORT PAYROLL-ESCAMILLA OLGA,D108,HJ,15.19,,147976.42
6150,10/30/2020,10/30/2020,103120,82L-IMPORT PAYROLL-ESCAMILLA OLGA,D108,HJ,64.95,,148041.37
6150,10/30/2020,10/30/2020,103120,82L-IMPORT PAYROLL-GARCIA SANTIAGO,D108,HJ,29.61,,148070.98
6150,10/30/2020,10/30/2020,103120,82L-IMPORT PAYROLL-GARCIA SANTIAGO,D108,HJ,126.6,,148197.58
6150,10/30/2020,10/30/2020,103120,82L-IMPORT PAYROLL-GILES SHAYLA,D108,HJ,15.19,,148212.77
6150,10/30/2020,10/30/2020,103120,82L-IMPORT PAYROLL-GILES SHAYLA,D108,HJ,28.29,,148241.06
6150,10/30/2020,10/30/2020,103120,82L-IMPORT PAYROLL-GILES SHAYLA,D108,HJ,64.95,,148306.01
6150,10/30/2020,10/30/2020,103120,82L-IMPORT PAYROLL-IKUNIKA FUNMILAYO,D108,HJ,30.2,,148336.21
6150,10/30/2020,10/30/2020,103120,82L-IMPORT PAYROLL-IKUNIKA FUNMILAYO,D108,HJ,55.77,,148391.98
6150,10/30/2020,10/30/2020,103120,82L-IMPORT PAYROLL-IKUNIKA FUNMILAYO,D108,HJ,129.15,,148521.13
6150,10/30/2020,10/30/2020,103120,82L-IMPORT PAYROLL-JONES JORDAN,D108,HJ,15.19,,148536.32
6150,10/30/2020,10/30/2020,103120,82L-IMPORT PAYROLL-JONES JORDAN,D108,HJ,64.95,,148601.27
6150,10/30/2020,10/30/2020,103120,82L-IMPORT PAYROLL-KHAN HUDA,D108,HJ,14.25,,148615.52
6150,10/30/2020,10/30/2020,103120,82L-IMPORT PAYROLL-KHAN HUDA,D108,HJ,26.53,,148642.05
6150,10/30/2020,10/30/2020,103120,82L-IMPORT PAYROLL-KHAN HUDA,D108,HJ,60.92,,148702.97
6150,10/30/2020,10/30/2020,103120,82L-IMPORT PAYROLL-KLOHR TIMOTHY JORDAN,D108,HJ,29,,148731.97
6150,10/30/2020,10/30/2020,103120,82L-IMPORT PAYROLL-KLOHR TIMOTHY JORDAN,D108,HJ,124,,148855.97
6150,10/30/2020,10/30/2020,103120,82L-IMPORT PAYROLL-KNOWLIN ZYLIA,D108,HJ,34.63,,148890.6
6150,10/30/2020,10/30/2020,103120,82L-IMPORT PAYROLL-KNOWLIN ZYLIA,D108,HJ,64.49,,148955.09
6150,10/30/2020,10/30/2020,103120,82L-IMPORT PAYROLL-KNOWLIN ZYLIA,D108,HJ,148.09,,149103.18
6150,10/30/2020,10/30/2020,103120,82L-IMPORT PAYROLL-KOPSHEVER MELISSA,D108,HJ,38.29,,149141.47
6150,10/30/2020,10/30/2020,103120,82L-IMPORT PAYROLL-KOPSHEVER MELISSA,D108,HJ,163.74,,149305.21
6150,10/30/2020,10/30/2020,103120,82L-IMPORT PAYROLL-LI SEN YUAN,D108,HJ,14.05,,149319.26
6150,10/30/2020,10/30/2020,103120,82L-IMPORT PAYROLL-LI SEN YUAN,D108,HJ,26.16,,149345.42
6150,10/30/2020,10/30/2020,103120,82L-IMPORT PAYROLL-LI SEN YUAN,D108,HJ,60.07,,149405.49
6150,10/30/2020,10/30/2020,103120,82L-IMPORT PAYROLL-LIPSCOMB STEPHEN,D108,HJ,33.58,,149439.07
6150,10/30/2020,10/30/2020,103120,82L-IMPORT PAYROLL-LIPSCOMB STEPHEN,D108,HJ,143.59,,149582.66
6150,10/30/2020,10/30/2020,103120,82L-IMPORT PAYROLL-MALLECK JESSICA R,D108,HJ,15.19,,149597.85
6150,10/30/2020,10/30/2020,103120,82L-IMPORT PAYROLL-MALLECK JESSICA R,D108,HJ,64.95,,149662.8
6150,10/30/2020,10/30/2020,103120,82L-IMPORT PAYROLL-MCLAUGHLIN MARA,D108,HJ,15.19,,149677.99
6150,10/30/2020,10/30/2020,103120,82L-IMPORT PAYROLL-MCLAUGHLIN MARA,D108,HJ,64.95,,149742.94
6150,10/30/2020,10/30/2020,103120,82L-IMPORT PAYROLL-MEJIA ROSO CARLOS,D108,HJ,14.01,,149756.95
6150,10/30/2020,10/30/2020,103120,82L-IMPORT PAYROLL-MEJIA ROSO CARLOS,D108,HJ,26.08,,149783.03
6150,10/30/2020,10/30/2020,103120,82L-IMPORT PAYROLL-MEJIA ROSO CARLOS,D108,HJ,59.89,,149842.92
6150,10/30/2020,10/30/2020,103120,82L-IMPORT PAYROLL-MONROY-MEJIA JASON,D108,HJ,15.19,,149858.11
6150,10/30/2020,10/30/2020,103120,82L-IMPORT PAYROLL-MONROY-MEJIA JASON,D108,HJ,36.67,,149894.78
6150,10/30/2020,10/30/2020,103120,82L-IMPORT PAYROLL-MONROY-MEJIA JASON,D108,HJ,64.95,,149959.73
6150,10/30/2020,10/30/2020,103120,82L-IMPORT PAYROLL-O'FLYNN-PRUITT NATHAN COLYAR,D108,HJ,15.19,,149974.92
6150,10/30/2020,10/30/2020,103120,82L-IMPORT PAYROLL-O'FLYNN-PRUITT NATHAN COLYAR,D108,HJ,36.67,,150011.59
6150,10/30/2020,10/30/2020,103120,82L-IMPORT PAYROLL-O'FLYNN-PRUITT NATHAN COLYAR,D108,HJ,64.95,,150076.54
6150,10/30/2020,10/30/2020,103120,82L-IMPORT PAYROLL-PATTERSON STEVE,D108,HJ,15.19,,150091.73
6150,10/30/2020,10/30/2020,103120,82L-IMPORT PAYROLL-PATTERSON STEVE,D108,HJ,28.29,,150120.02
6150,10/30/2020,10/30/2020,103120,82L-IMPORT PAYROLL-PATTERSON STEVE,D108,HJ,64.95,,150184.97
6150,10/30/2020,10/30/2020,103120,82L-IMPORT PAYROLL-SCHMIESS RACHEL JOY,D108,HJ,15.19,,150200.16
6150,10/30/2020,10/30/2020,103120,82L-IMPORT PAYROLL-SCHMIESS RACHEL JOY,D108,HJ,64.95,,150265.11
6150,10/30/2020,10/30/2020,103120,82L-IMPORT PAYROLL-SCOTT KIRK DONOVAN,D108,HJ,14.05,,150279.16
6150,10/30/2020,10/30/2020,103120,82L-IMPORT PAYROLL-SCOTT KIRK DONOVAN,D108,HJ,26.16,,150305.32
6150,10/30/2020,10/30/2020,103120,82L-IMPORT PAYROLL-SCOTT KIRK DONOVAN,D108,HJ,60.07,,150365.39
6150,10/30/2020,10/30/2020,103120,82L-IMPORT PAYROLL-SILVER KELLY,D108,HJ,34.63,,150400.02
6150,10/30/2020,10/30/2020,103120,82L-IMPORT PAYROLL-SILVER KELLY,D108,HJ,148.06,,150548.08
6150,10/30/2020,10/30/2020,103120,82L-IMPORT PAYROLL-SOLIMAN MARK,D108,HJ,15.19,,150563.27
6150,10/30/2020,10/30/2020,103120,82L-IMPORT PAYROLL-SOLIMAN MARK,D108,HJ,36.67,,150599.94
6150,10/30/2020,10/30/2020,103120,82L-IMPORT PAYROLL-SOLIMAN MARK,D108,HJ,64.95,,150664.89
6150,10/30/2020,10/30/2020,103120,82L-IMPORT PAYROLL-STEIN KYLE,D108,HJ,27.84,,150692.73
6150,10/30/2020,10/30/2020,103120,82L-IMPORT PAYROLL-STEIN KYLE,D108,HJ,43.03,,150735.76
6150,10/30/2020,10/30/2020,103120,82L-IMPORT PAYROLL-STEIN KYLE,D108,HJ,119.03,,150854.79
6150,10/30/2020,10/30/2020,103120,82L-IMPORT PAYROLL-STROUD DAVID,D108,HJ,14.66,,150869.45
6150,10/30/2020,10/30/2020,103120,82L-IMPORT PAYROLL-STROUD DAVID,D108,HJ,62.68,,150932.13
6150,10/30/2020,10/30/2020,103120,82L-IMPORT PAYROLL-VALCIN SABRINA JEMIMAH,D108,HJ,14.25,,150946.38
6150,10/30/2020,10/30/2020,103120,82L-IMPORT PAYROLL-VALCIN SABRINA JEMIMAH,D108,HJ,26.53,,150972.91
6150,10/30/2020,10/30/2020,103120,82L-IMPORT PAYROLL-VALCIN SABRINA JEMIMAH,D108,HJ,60.92,,151033.83
6150,10/30/2020,10/30/2020,103120,82L-IMPORT PAYROLL-VALDES ERNEST L,D108,HJ,15.19,,151049.02
6150,10/30/2020,10/30/2020,103120,82L-IMPORT PAYROLL-VALDES ERNEST L,D108,HJ,36.67,,151085.69
6150,10/30/2020,10/30/2020,103120,82L-IMPORT PAYROLL-VALDES ERNEST L,D108,HJ,64.95,,151150.64
6150,10/30/2020,10/30/2020,103120,82L-IMPORT PAYROLL-WILLIAMS MACK ANTHONY,D108,HJ,15.02,,151165.66
6150,10/30/2020,10/30/2020,103120,82L-IMPORT PAYROLL-WILLIAMS MACK ANTHONY,D108,HJ,27.96,,151193.62
6150,10/30/2020,10/30/2020,103120,82L-IMPORT PAYROLL-WILLIAMS MACK ANTHONY,D108,HJ,64.21,,151257.83
6150,10/30/2020,10/30/2020,103120,82L-IMPORT PAYROLL-WILLIAMS MIL'YONTA,D108,HJ,15.19,,151273.02
6150,10/30/2020,10/30/2020,103120,82L-IMPORT PAYROLL-WILLIAMS MIL'YONTA,D108,HJ,64.95,,151337.97
6150,10/30/2020,10/30/2020,103120,82L-IMPORT PAYROLL-ANTHONY BETTY S,D108,HJ,41.85,,151379.82
6150,10/30/2020,10/30/2020,103120,82L-IMPORT PAYROLL-ANTHONY BETTY S,D108,HJ,178.96,,151558.78
6150,10/30/2020,10/30/2020,103120,82L-IMPORT PAYROLL-APULI LINDSAY,D108,HJ,34.16,,151592.94
6150,10/30/2020,10/30/2020,103120,82L-IMPORT PAYROLL-APULI LINDSAY,D108,HJ,146.08,,151739.02
6150,10/30/2020,10/30/2020,103120,82L-IMPORT PAYROLL-AUSTIN PERCY ANTONIO,D108,HJ,36.34,,151775.36
6150,10/30/2020,10/30/2020,103120,82L-IMPORT PAYROLL-AUSTIN PERCY ANTONIO,D108,HJ,155.39,,151930.75
6150,10/30/2020,10/30/2020,103120,82L-IMPORT PAYROLL-BUHMANN JAY,D108,HJ,32.9,,151963.65
6150,10/30/2020,10/30/2020,103120,82L-IMPORT PAYROLL-BUHMANN JAY,D108,HJ,140.69,,152104.34
6150,10/30/2020,10/30/2020,103120,82L-IMPORT PAYROLL-CAIN CORY,D108,HJ,33.3,,152137.64
6150,10/30/2020,10/30/2020,103120,82L-IMPORT PAYROLL-CAIN CORY,D108,HJ,142.38,,152280.02
6150,10/30/2020,10/30/2020,103120,82L-IMPORT PAYROLL-CHAPMAN CLAUDY EARL,D108,HJ,26.38,,152306.4
6150,10/30/2020,10/30/2020,103120,82L-IMPORT PAYROLL-CHAPMAN CLAUDY EARL,D108,HJ,112.81,,152419.21
6150,10/30/2020,10/30/2020,103120,82L-IMPORT PAYROLL-DADA ARIKPO E,D108,HJ,34.29,,152453.5
6150,10/30/2020,10/30/2020,103120,82L-IMPORT PAYROLL-DADA ARIKPO E,D108,HJ,146.61,,152600.11
6150,10/30/2020,10/30/2020,103120,82L-IMPORT PAYROLL-GUTHRIE LESLIE,D108,HJ,33.42,,152633.53
6150,10/30/2020,10/30/2020,103120,82L-IMPORT PAYROLL-GUTHRIE LESLIE,D108,HJ,142.9,,152776.43
6150,10/30/2020,10/30/2020,103120,82L-IMPORT PAYROLL-HOLMES JOREL ALEXANDER,D108,HJ,33.47,,152809.9
6150,10/30/2020,10/30/2020,103120,82L-IMPORT PAYROLL-HOLMES JOREL ALEXANDER,D108,HJ,143.11,,152953.01
6150,10/30/2020,10/30/2020,103120,82L-IMPORT PAYROLL-JORDAN TIFFANY T,D108,HJ,48.12,,153001.13
6150,10/30/2020,10/30/2020,103120,82L-IMPORT PAYROLL-JORDAN TIFFANY T,D108,HJ,205.74,,153206.87
6150,10/30/2020,10/30/2020,103120,82L-IMPORT PAYROLL-LANIGAN LISA A,D108,HJ,45.1,,153251.97
6150,10/30/2020,10/30/2020,103120,82L-IMPORT PAYROLL-LANIGAN LISA A,D108,HJ,192.83,,153444.8
6150,10/30/2020,10/30/2020,103120,82L-IMPORT PAYROLL-MCELWEE MELISSA,D108,HJ,38.67,,153483.47
6150,10/30/2020,10/30/2020,103120,82L-IMPORT PAYROLL-MCELWEE MELISSA,D108,HJ,165.33,,153648.8
6150,10/30/2020,10/30/2020,103120,82L-IMPORT PAYROLL-MCNICHOLAS MARY,D108,HJ,33.23,,153682.03
6150,10/30/2020,10/30/2020,103120,82L-IMPORT PAYROLL-MCNICHOLAS MARY,D108,HJ,142.08,,153824.11
6150,10/30/2020,10/30/2020,103120,82L-IMPORT PAYROLL-NWAKANMA NANCY,D108,HJ,44.18,,153868.29
6150,10/30/2020,10/30/2020,103120,82L-IMPORT PAYROLL-NWAKANMA NANCY,D108,HJ,188.89,,154057.18
6150,10/30/2020,10/30/2020,103120,82L-IMPORT PAYROLL-ONICA ANTHONY J,D108,HJ,35.1,,154092.28
6150,10/30/2020,10/30/2020,103120,82L-IMPORT PAYROLL-ONICA ANTHONY J,D108,HJ,150.1,,154242.38
6150,10/30/2020,10/30/2020,103120,82L-IMPORT PAYROLL-PRAHIN NICOLE M,D108,HJ,14.89,,154257.27
6150,10/30/2020,10/30/2020,103120,82L-IMPORT PAYROLL-PRAHIN NICOLE M,D108,HJ,40.26,,154297.53
6150,10/30/2020,10/30/2020,103120,82L-IMPORT PAYROLL-PRAHIN NICOLE M,D108,HJ,63.67,,154361.2
6150,10/30/2020,10/30/2020,103120,82L-IMPORT PAYROLL-PRAHIN NICOLE M,D108,HJ,172.15,,154533.35
6150,10/30/2020,10/30/2020,103120,82L-IMPORT PAYROLL-RIVERS QUIONNA DIANE,D108,HJ,39.27,,154572.62
6150,10/30/2020,10/30/2020,103120,82L-IMPORT PAYROLL-RIVERS QUIONNA DIANE,D108,HJ,167.92,,154740.54
6150,10/30/2020,10/30/2020,103120,82L-IMPORT PAYROLL-SALIM YASSER,D108,HJ,35.35,,154775.89
6150,10/30/2020,10/30/2020,103120,82L-IMPORT PAYROLL-SALIM YASSER,D108,HJ,151.15,,154927.04
6150,10/30/2020,10/30/2020,103120,82L-IMPORT PAYROLL-SEJOUR MAHALIAH,D108,HJ,36.31,,154963.35
6150,10/30/2020,10/30/2020,103120,82L-IMPORT PAYROLL-SEJOUR MAHALIAH,D108,HJ,155.26,,155118.61
6150,10/30/2020,10/30/2020,103120,82L-IMPORT PAYROLL-SKALSKI CHRISTOPHER,D108,HJ,35.4,,155154.01
6150,10/30/2020,10/30/2020,103120,82L-IMPORT PAYROLL-SKALSKI CHRISTOPHER,D108,HJ,151.35,,155305.36
6150,10/30/2020,10/30/2020,103120,82L-IMPORT PAYROLL-TUMENJARGAL ENKHJIN,D108,HJ,35.16,,155340.52
6150,10/30/2020,10/30/2020,103120,82L-IMPORT PAYROLL-TUMENJARGAL ENKHJIN,D108,HJ,150.35,,155490.87
6150,10/30/2020,10/30/2020,103120,82L-IMPORT PAYROLL-VILLEGAS EVELYN,D108,HJ,35.64,,155526.51
6150,10/30/2020,10/30/2020,103120,82L-IMPORT PAYROLL-VILLEGAS EVELYN,D108,HJ,152.41,,155678.92
6150,10/30/2020,10/30/2020,103120,82L-IMPORT PAYROLL-WOLF ANNA A,D108,HJ,37.84,,155716.76
6150,10/30/2020,10/30/2020,103120,82L-IMPORT PAYROLL-WOLF ANNA A,D108,HJ,161.78,,155878.54
6150,10/30/2020,10/30/2020,103120,82L-IMPORT PAYROLL-ACEVEDO MONIVETT,D107,HJ,11.95,,155890.49
6150,10/30/2020,10/30/2020,103120,82L-IMPORT PAYROLL-ACEVEDO MONIVETT,D107,HJ,51.08,,155941.57
6150,10/30/2020,10/30/2020,103120,82L-IMPORT PAYROLL-ACEVEDO MONIVETT,D107,HJ,62.71,,156004.28
6150,10/30/2020,10/30/2020,103120,82L-IMPORT PAYROLL-ACEVEDO MONIVETT,D107,HJ,268.17,,156272.45
6150,10/30/2020,10/30/2020,103120,82L-IMPORT PAYROLL-AKLESTAD ISABEL,D111,HJ,23.29,,156295.74
6150,10/30/2020,10/30/2020,103120,82L-IMPORT PAYROLL-AKLESTAD ISABEL,D111,HJ,99.58,,156395.32
6150,10/30/2020,10/30/2020,103120,82L-IMPORT PAYROLL-ALLEN KIMBERLY MARY,D111,HJ,26.58,,156421.9
6150,10/30/2020,10/30/2020,103120,82L-IMPORT PAYROLL-ALLEN KIMBERLY MARY,D111,HJ,113.67,,156535.57
6150,10/30/2020,10/30/2020,103120,82L-IMPORT PAYROLL-BIBB TIFFANI,D104,HJ,13.43,,156549
6150,10/30/2020,10/30/2020,103120,82L-IMPORT PAYROLL-BIBB TIFFANI,D104,HJ,36.28,,156585.28
6150,10/30/2020,10/30/2020,103120,82L-IMPORT PAYROLL-BIBB TIFFANI,D104,HJ,57.38,,156642.66
6150,10/30/2020,10/30/2020,103120,82L-IMPORT PAYROLL-BIBB TIFFANI,D104,HJ,155.17,,156797.83
6150,10/30/2020,10/30/2020,103120,82L-IMPORT PAYROLL-BOWMAN HALLEY K,D101,HJ,40.83,,156838.66
6150,10/30/2020,10/30/2020,103120,82L-IMPORT PAYROLL-BOWMAN HALLEY K,D101,HJ,174.59,,157013.25
6150,10/30/2020,10/30/2020,103120,82L-IMPORT PAYROLL-COOK CATHRYN ANNA,D105,HJ,51.41,,157064.66
6150,10/30/2020,10/30/2020,103120,82L-IMPORT PAYROLL-COOK CATHRYN ANNA,D105,HJ,219.83,,157284.49
6150,10/30/2020,10/30/2020,103120,82L-IMPORT PAYROLL-COOPER ASHLEE R,D101,HJ,35.76,,157320.25
6150,10/30/2020,10/30/2020,103120,82L-IMPORT PAYROLL-COOPER ASHLEE R,D101,HJ,152.9,,157473.15
6150,10/30/2020,10/30/2020,103120,82L-IMPORT PAYROLL-CORTEZ MIRANDA A,D111,HJ,38.45,,157511.6
6150,10/30/2020,10/30/2020,103120,82L-IMPORT PAYROLL-CORTEZ MIRANDA A,D111,HJ,164.42,,157676.02
6150,10/30/2020,10/30/2020,103120,82L-IMPORT PAYROLL-DAUGHERTY DEVIN W,D101,HJ,15.1,,157691.12
6150,10/30/2020,10/30/2020,103120,82L-IMPORT PAYROLL-DAUGHERTY DEVIN W,D101,HJ,64.58,,157755.7
6150,10/30/2020,10/30/2020,103120,82L-IMPORT PAYROLL-DETONE KYRA MAYA,D102,HJ,0.83,,157756.53
6150,10/30/2020,10/30/2020,103120,82L-IMPORT PAYROLL-DETONE KYRA MAYA,D102,HJ,3.52,,157760.05
6150,10/30/2020,10/30/2020,103120,82L-IMPORT PAYROLL-DETONE KYRA MAYA,D102,HJ,40.41,,157800.46
6150,10/30/2020,10/30/2020,103120,82L-IMPORT PAYROLL-DETONE KYRA MAYA,D102,HJ,172.82,,157973.28
6150,10/30/2020,10/30/2020,103120,82L-IMPORT PAYROLL-DUPUIS CHRISTOPHER M,D107,HJ,42.76,,158016.04
6150,10/30/2020,10/30/2020,103120,82L-IMPORT PAYROLL-DUPUIS CHRISTOPHER M,D107,HJ,48.23,,158064.27
6150,10/30/2020,10/30/2020,103120,82L-IMPORT PAYROLL-DUPUIS CHRISTOPHER M,D107,HJ,182.86,,158247.13
6150,10/30/2020,10/30/2020,103120,82L-IMPORT PAYROLL-DUPUIS CHRISTOPHER M,D107,HJ,206.19,,158453.32
6150,10/30/2020,10/30/2020,103120,82L-IMPORT PAYROLL-DZIEDZIC JULIE K,D101,HJ,17.71,,158471.03
6150,10/30/2020,10/30/2020,103120,82L-IMPORT PAYROLL-DZIEDZIC JULIE K,D101,HJ,75.71,,158546.74
6150,10/30/2020,10/30/2020,103120,82L-IMPORT PAYROLL-FISCHABER THOMAS,D109,HJ,223.55,,158770.29
6150,10/30/2020,10/30/2020,103120,82L-IMPORT PAYROLL-FISCHABER THOMAS,D109,HJ,955.85,,159726.14
6150,10/30/2020,10/30/2020,103120,82L-IMPORT PAYROLL-FLORY MEGAN,D109,HJ,21.75,,159747.89
6150,10/30/2020,10/30/2020,103120,82L-IMPORT PAYROLL-FLORY MEGAN,D109,HJ,93,,159840.89
6150,10/30/2020,10/30/2020,103120,82L-IMPORT PAYROLL-GORNSTEIN STEVEN,D101,HJ,39.27,,159880.16
6150,10/30/2020,10/30/2020,103120,82L-IMPORT PAYROLL-GORNSTEIN STEVEN,D101,HJ,167.92,,160048.08
6150,10/30/2020,10/30/2020,103120,82L-IMPORT PAYROLL-GUADARRAMA-ALVAREZ URIEL A,D105,HJ,41.47,,160089.55
6150,10/30/2020,10/30/2020,103120,82L-IMPORT PAYROLL-GUADARRAMA-ALVAREZ URIEL A,D105,HJ,177.34,,160266.89
6150,10/30/2020,10/30/2020,103120,82L-IMPORT PAYROLL-GUTIERREZ ANTONIO J,D107,HJ,27.54,,160294.43
6150,10/30/2020,10/30/2020,103120,82L-IMPORT PAYROLL-GUTIERREZ ANTONIO J,D107,HJ,48.96,,160343.39
6150,10/30/2020,10/30/2020,103120,82L-IMPORT PAYROLL-GUTIERREZ ANTONIO J,D107,HJ,117.52,,160460.91
6150,10/30/2020,10/30/2020,103120,82L-IMPORT PAYROLL-GUTIERREZ ANTONIO J,D107,HJ,209.57,,160670.48
6150,10/30/2020,10/30/2020,103120,82L-IMPORT PAYROLL-HENRY GILLIAN,D102,HJ,14.42,,160684.9
6150,10/30/2020,10/30/2020,103120,82L-IMPORT PAYROLL-HENRY GILLIAN,D102,HJ,29.17,,160714.07
6150,10/30/2020,10/30/2020,103120,82L-IMPORT PAYROLL-HENRY GILLIAN,D102,HJ,124.74,,160838.81
6150,10/30/2020,10/30/2020,103120,82L-IMPORT PAYROLL-HERMAN ADAM,D102,HJ,28.2,,160867.01
6150,10/30/2020,10/30/2020,103120,82L-IMPORT PAYROLL-HERMAN ADAM,D102,HJ,120.56,,160987.57
6150,10/30/2020,10/30/2020,103120,82L-IMPORT PAYROLL-HESTER TYLER CONRAD,D105,HJ,27.79,,161015.36
6150,10/30/2020,10/30/2020,103120,82L-IMPORT PAYROLL-HESTER TYLER CONRAD,D105,HJ,118.83,,161134.19
6150,10/30/2020,10/30/2020,103120,82L-IMPORT PAYROLL-HOLT ADAM,D109,HJ,60.42,,161194.61
6150,10/30/2020,10/30/2020,103120,82L-IMPORT PAYROLL-HOLT ADAM,D109,HJ,258.35,,161452.96
6150,10/30/2020,10/30/2020,103120,82L-IMPORT PAYROLL-KELLY SEAN,D109,HJ,223.55,,161676.51
6150,10/30/2020,10/30/2020,103120,82L-IMPORT PAYROLL-KELLY SEAN,D109,HJ,955.85,,162632.36
6150,10/30/2020,10/30/2020,103120,82L-IMPORT PAYROLL-KRUGER MARK,D109,HJ,72.5,,162704.86
6150,10/30/2020,10/30/2020,103120,82L-IMPORT PAYROLL-KRUGER MARK,D109,HJ,310,,163014.86
6150,10/30/2020,10/30/2020,103120,82L-IMPORT PAYROLL-LIPORACE HERNAN LUIS,D103,HJ,33.06,,163047.92
6150,10/30/2020,10/30/2020,103120,82L-IMPORT PAYROLL-LIPORACE HERNAN LUIS,D103,HJ,141.34,,163189.26
6150,10/30/2020,10/30/2020,103120,82L-IMPORT PAYROLL-MARKS KRISTA,D109,HJ,78.55,,163267.81
6150,10/30/2020,10/30/2020,103120,82L-IMPORT PAYROLL-MARKS KRISTA,D109,HJ,335.85,,163603.66
6150,10/30/2020,10/30/2020,103120,82L-IMPORT PAYROLL-MASON ANGELA,D107,HJ,21.83,,163625.49
6150,10/30/2020,10/30/2020,103120,82L-IMPORT PAYROLL-MASON ANGELA,D107,HJ,58.99,,163684.48
6150,10/30/2020,10/30/2020,103120,82L-IMPORT PAYROLL-MASON ANGELA,D107,HJ,93.31,,163777.79
6150,10/30/2020,10/30/2020,103120,82L-IMPORT PAYROLL-MASON ANGELA,D107,HJ,252.27,,164030.06
6150,10/30/2020,10/30/2020,103120,82L-IMPORT PAYROLL-MILNE ROGER,D109,HJ,223.55,,164253.61
6150,10/30/2020,10/30/2020,103120,82L-IMPORT PAYROLL-MILNE ROGER,D109,HJ,955.85,,165209.46
6150,10/30/2020,10/30/2020,103120,82L-IMPORT PAYROLL-MOSTAFAVI YASAMAN,D109,HJ,7.66,,165217.12
6150,10/30/2020,10/30/2020,103120,82L-IMPORT PAYROLL-MOSTAFAVI YASAMAN,D109,HJ,32.74,,165249.86
6150,10/30/2020,10/30/2020,103120,82L-IMPORT PAYROLL-O'DONNELL STEPHEN,D104,HJ,39.26,,165289.12
6150,10/30/2020,10/30/2020,103120,82L-IMPORT PAYROLL-O'DONNELL STEPHEN,D104,HJ,167.87,,165456.99
6150,10/30/2020,10/30/2020,103120,82L-IMPORT PAYROLL-PARETS MALLORY GRACE,D101,HJ,17.57,,165474.56
6150,10/30/2020,10/30/2020,103120,82L-IMPORT PAYROLL-PARETS MALLORY GRACE,D101,HJ,41.08,,165515.64
6150,10/30/2020,10/30/2020,103120,82L-IMPORT PAYROLL-PARETS MALLORY GRACE,D101,HJ,175.67,,165691.31
6150,10/30/2020,10/30/2020,103120,82L-IMPORT PAYROLL-PARHAM-GANTT DENISE M,D112,HJ,39.5,,165730.81
6150,10/30/2020,10/30/2020,103120,82L-IMPORT PAYROLL-PARHAM-GANTT DENISE M,D112,HJ,168.91,,165899.72
6150,10/30/2020,10/30/2020,103120,82L-IMPORT PAYROLL-PEINADO ELIZABETH R,D111,HJ,54.53,,165954.25
6150,10/30/2020,10/30/2020,103120,82L-IMPORT PAYROLL-PEINADO ELIZABETH R,D111,HJ,233.18,,166187.43
6150,10/30/2020,10/30/2020,103120,82L-IMPORT PAYROLL-PERNIA JEFFREY,D109,HJ,56.19,,166243.62
6150,10/30/2020,10/30/2020,103120,82L-IMPORT PAYROLL-PERNIA JEFFREY,D109,HJ,240.25,,166483.87
6150,10/30/2020,10/30/2020,103120,82L-IMPORT PAYROLL-POLANCO ODALIS,D103,HJ,45.47,,166529.34
6150,10/30/2020,10/30/2020,103120,82L-IMPORT PAYROLL-POLANCO ODALIS,D103,HJ,194.43,,166723.77
6150,10/30/2020,10/30/2020,103120,82L-IMPORT PAYROLL-QUINTAS JASHIVE,D105,HJ,25.57,,166749.34
6150,10/30/2020,10/30/2020,103120,82L-IMPORT PAYROLL-QUINTAS JASHIVE,D105,HJ,109.31,,166858.65
6150,10/30/2020,10/30/2020,103120,82L-IMPORT PAYROLL-RANDOLPH ALEXANDER,D111,HJ,11.63,,166870.28
6150,10/30/2020,10/30/2020,103120,82L-IMPORT PAYROLL-RANDOLPH ALEXANDER,D111,HJ,25.1,,166895.38
6150,10/30/2020,10/30/2020,103120,82L-IMPORT PAYROLL-RANDOLPH ALEXANDER,D111,HJ,107.33,,167002.71
6150,10/30/2020,10/30/2020,103120,82L-IMPORT PAYROLL-RUBI PERLA,D101,HJ,17.46,,167020.17
6150,10/30/2020,10/30/2020,103120,82L-IMPORT PAYROLL-RUBI PERLA,D101,HJ,74.68,,167094.85
6150,10/30/2020,10/30/2020,103120,82L-IMPORT PAYROLL-SAFRAN ALAN P,D107,HJ,9.83,,167104.68
6150,10/30/2020,10/30/2020,103120,82L-IMPORT PAYROLL-SAFRAN ALAN P,D107,HJ,99.3,,167203.98
6150,10/30/2020,10/30/2020,103120,82L-IMPORT PAYROLL-SHENKMAN OLIVIA,D101,HJ,29,,167232.98
6150,10/30/2020,10/30/2020,103120,82L-IMPORT PAYROLL-SHENKMAN OLIVIA,D101,HJ,124,,167356.98
6150,10/30/2020,10/30/2020,103120,82L-IMPORT PAYROLL-SHI GRACE,D103,HJ,12.69,,167369.67
6150,10/30/2020,10/30/2020,103120,82L-IMPORT PAYROLL-SHI GRACE,D103,HJ,54.25,,167423.92
6150,10/30/2020,10/30/2020,103120,82L-IMPORT PAYROLL-WALLACE AMENA,D104,HJ,31.18,,167455.1
6150,10/30/2020,10/30/2020,103120,82L-IMPORT PAYROLL-WALLACE AMENA,D104,HJ,133.32,,167588.42
6150,10/30/2020,10/30/2020,103120,82L-IMPORT PAYROLL-WARD JEFFREY,D109,HJ,223.55,,167811.97
6150,10/30/2020,10/30/2020,103120,82L-IMPORT PAYROLL-WARD JEFFREY,D109,HJ,955.85,,168767.82
6150,10/30/2020,10/30/2020,103120,82L-IMPORT PAYROLL-WARD JENNIFER,D109,HJ,13.44,,168781.26
6150,10/30/2020,10/30/2020,103120,82L-IMPORT PAYROLL-WARD JENNIFER,D109,HJ,57.47,,168838.73
6150,10/30/2020,10/30/2020,103120,82L-IMPORT PAYROLL-WEINSTOCK EMILY,D101,HJ,17.57,,168856.3
6150,10/30/2020,10/30/2020,103120,82L-IMPORT PAYROLL-WEINSTOCK EMILY,D101,HJ,38.11,,168894.41
6150,10/30/2020,10/30/2020,103120,82L-IMPORT PAYROLL-WEINSTOCK EMILY,D101,HJ,162.94,,169057.35
6150,10/30/2020,10/30/2020,103120,82L-IMPORT PAYROLL-WINANS JENNIFER,D111,HJ,36.33,,169093.68
6150,10/30/2020,10/30/2020,103120,82L-IMPORT PAYROLL-WINANS JENNIFER,D111,HJ,155.35,,169249.03
6150,10/30/2020,10/30/2020,103120,82L-IMPORT PAYROLL-ZARATE JOSEPH M,D105,HJ,31.18,,169280.21
6150,10/30/2020,10/30/2020,103120,82L-IMPORT PAYROLL-ZARATE JOSEPH M,D105,HJ,133.3,,169413.51
6150,10/30/2020,10/30/2020,103120,82L-IMPORT PAYROLL-AGUANNO JOSEPH,D108,HJ,16.23,,169429.74
6150,10/30/2020,10/30/2020,103120,82L-IMPORT PAYROLL-AGUANNO JOSEPH,D108,HJ,69.38,,169499.12
6150,10/30/2020,10/30/2020,103120,82L-IMPORT PAYROLL-AKESODE FEHINTOLA,D108,HJ,16.23,,169515.35
6150,10/30/2020,10/30/2020,103120,82L-IMPORT PAYROLL-AKESODE FEHINTOLA,D108,HJ,69.38,,169584.73
6150,10/30/2020,10/30/2020,103120,82L-IMPORT PAYROLL-BARTOLD DEANNA MARIE,D108,HJ,44.16,,169628.89
6150,10/30/2020,10/30/2020,103120,82L-IMPORT PAYROLL-BARTOLD DEANNA MARIE,D108,HJ,188.82,,169817.71
6150,10/30/2020,10/30/2020,103120,82L-IMPORT PAYROLL-BELLOT GENESIS,D108,HJ,32.36,,169850.07
6150,10/30/2020,10/30/2020,103120,82L-IMPORT PAYROLL-BELLOT GENESIS,D108,HJ,138.38,,169988.45
6150,10/30/2020,10/30/2020,103120,82L-IMPORT PAYROLL-BENNETT JAMES H,D108,HJ,16.23,,170004.68
6150,10/30/2020,10/30/2020,103120,82L-IMPORT PAYROLL-BENNETT JAMES H,D108,HJ,69.38,,170074.06
6150,10/30/2020,10/30/2020,103120,82L-IMPORT PAYROLL-BOWMAN ABIGAIL,D108,HJ,16.23,,170090.29
6150,10/30/2020,10/30/2020,103120,82L-IMPORT PAYROLL-BOWMAN ABIGAIL,D108,HJ,69.38,,170159.67
6150,10/30/2020,10/30/2020,103120,82L-IMPORT PAYROLL-BURRELL RUSSELL,D108,HJ,15.08,,170174.75
6150,10/30/2020,10/30/2020,103120,82L-IMPORT PAYROLL-BURRELL RUSSELL,D108,HJ,64.5,,170239.25
6150,10/30/2020,10/30/2020,103120,82L-IMPORT PAYROLL-CHUI KENT,D108,HJ,16.23,,170255.48
6150,10/30/2020,10/30/2020,103120,82L-IMPORT PAYROLL-CHUI KENT,D108,HJ,69.38,,170324.86
6150,10/30/2020,10/30/2020,103120,82L-IMPORT PAYROLL-CIRKER MIA,D108,HJ,32.63,,170357.49
6150,10/30/2020,10/30/2020,103120,82L-IMPORT PAYROLL-CIRKER MIA,D108,HJ,139.5,,170496.99
6150,10/30/2020,10/30/2020,103120,82L-IMPORT PAYROLL-DEWS CAMERYN,D108,HJ,33.23,,170530.22
6150,10/30/2020,10/30/2020,103120,82L-IMPORT PAYROLL-DEWS CAMERYN,D108,HJ,142.1,,170672.32
6150,10/30/2020,10/30/2020,103120,82L-IMPORT PAYROLL-DIETZ MARY,D108,HJ,16.23,,170688.55
6150,10/30/2020,10/30/2020,103120,82L-IMPORT PAYROLL-DIETZ MARY,D108,HJ,69.38,,170757.93
6150,10/30/2020,10/30/2020,103120,82L-IMPORT PAYROLL-DOMINIQUE PRINCESSA,D108,HJ,16.23,,170774.16
6150,10/30/2020,10/30/2020,103120,82L-IMPORT PAYROLL-DOMINIQUE PRINCESSA,D108,HJ,69.38,,170843.54
6150,10/30/2020,10/30/2020,103120,82L-IMPORT PAYROLL-DONNELLY MARCUS,D108,HJ,16.23,,170859.77
6150,10/30/2020,10/30/2020,103120,82L-IMPORT PAYROLL-DONNELLY MARCUS,D108,HJ,21.49,,170881.26
6150,10/30/2020,10/30/2020,103120,82L-IMPORT PAYROLL-DONNELLY MARCUS,D108,HJ,69.38,,170950.64
6150,10/30/2020,10/30/2020,103120,82L-IMPORT PAYROLL-FEIGHERY JOHN,D108,HJ,32.81,,170983.45
6150,10/30/2020,10/30/2020,103120,82L-IMPORT PAYROLL-FEIGHERY JOHN,D108,HJ,140.3,,171123.75
6150,10/30/2020,10/30/2020,103120,82L-IMPORT PAYROLL-FORTH KYLE,D108,HJ,16.23,,171139.98
6150,10/30/2020,10/30/2020,103120,82L-IMPORT PAYROLL-FORTH KYLE,D108,HJ,69.38,,171209.36
6150,10/30/2020,10/30/2020,103120,82L-IMPORT PAYROLL-GARCIA MARILYN,D108,HJ,33.23,,171242.59
6150,10/30/2020,10/30/2020,103120,82L-IMPORT PAYROLL-GARCIA MARILYN,D108,HJ,142.08,,171384.67
6150,10/30/2020,10/30/2020,103120,82L-IMPORT PAYROLL-GREENE BROOKE,D108,HJ,15.28,,171399.95
6150,10/30/2020,10/30/2020,103120,82L-IMPORT PAYROLL-GREENE BROOKE,D108,HJ,65.35,,171465.3
6150,10/30/2020,10/30/2020,103120,82L-IMPORT PAYROLL-GRIFFIN ANDREW,D108,HJ,30.44,,171495.74
6150,10/30/2020,10/30/2020,103120,82L-IMPORT PAYROLL-GRIFFIN ANDREW,D108,HJ,130.16,,171625.9
6150,10/30/2020,10/30/2020,103120,82L-IMPORT PAYROLL-GROSS EMILY,D108,HJ,14,,171639.9
6150,10/30/2020,10/30/2020,103120,82L-IMPORT PAYROLL-GROSS EMILY,D108,HJ,59.86,,171699.76
6150,10/30/2020,10/30/2020,103120,82L-IMPORT PAYROLL-GUERRERO LUIS,D108,HJ,16.23,,171715.99
6150,10/30/2020,10/30/2020,103120,82L-IMPORT PAYROLL-GUERRERO LUIS,D108,HJ,69.38,,171785.37
6150,10/30/2020,10/30/2020,103120,82L-IMPORT PAYROLL-HALLINAN GABRIEL,D108,HJ,37.04,,171822.41
6150,10/30/2020,10/30/2020,103120,82L-IMPORT PAYROLL-HALLINAN GABRIEL,D108,HJ,158.36,,171980.77
6150,10/30/2020,10/30/2020,103120,82L-IMPORT PAYROLL-HAMERSLY WILLIAM,D108,HJ,34.16,,172014.93
6150,10/30/2020,10/30/2020,103120,82L-IMPORT PAYROLL-HAMERSLY WILLIAM,D108,HJ,146.08,,172161.01
6150,10/30/2020,10/30/2020,103120,82L-IMPORT PAYROLL-HOLDER LATIVA M,D108,HJ,55.99,,172217
6150,10/30/2020,10/30/2020,103120,82L-IMPORT PAYROLL-HOLDER LATIVA M,D108,HJ,239.39,,172456.39
6150,10/30/2020,10/30/2020,103120,82L-IMPORT PAYROLL-HOSSAIN MYESHA,D108,HJ,35.1,,172491.49
6150,10/30/2020,10/30/2020,103120,82L-IMPORT PAYROLL-HOSSAIN MYESHA,D108,HJ,150.1,,172641.59
6150,10/30/2020,10/30/2020,103120,82L-IMPORT PAYROLL-JACKSON TASNIM F,D108,HJ,31,,172672.59
6150,10/30/2020,10/30/2020,103120,82L-IMPORT PAYROLL-JACKSON TASNIM F,D108,HJ,132.56,,172805.15
6150,10/30/2020,10/30/2020,103120,82L-IMPORT PAYROLL-KERKHOFF HARPER FAITH,D108,HJ,16.23,,172821.38
6150,10/30/2020,10/30/2020,103120,82L-IMPORT PAYROLL-KERKHOFF HARPER FAITH,D108,HJ,69.38,,172890.76
6150,10/30/2020,10/30/2020,103120,82L-IMPORT PAYROLL-LEARY AUBREY,D108,HJ,16.2,,172906.96
6150,10/30/2020,10/30/2020,103120,82L-IMPORT PAYROLL-LEARY AUBREY,D108,HJ,69.27,,172976.23
6150,10/30/2020,10/30/2020,103120,82L-IMPORT PAYROLL-LI BELLA,D108,HJ,36.21,,173012.44
6150,10/30/2020,10/30/2020,103120,82L-IMPORT PAYROLL-LI BELLA,D108,HJ,154.83,,173167.27
6150,10/30/2020,10/30/2020,103120,82L-IMPORT PAYROLL-LOUIE JORDAN,D108,HJ,16.23,,173183.5
6150,10/30/2020,10/30/2020,103120,82L-IMPORT PAYROLL-LOUIE JORDAN,D108,HJ,69.38,,173252.88
6150,10/30/2020,10/30/2020,103120,82L-IMPORT PAYROLL-MELCHOR OSBEIDY,D108,HJ,16.23,,173269.11
6150,10/30/2020,10/30/2020,103120,82L-IMPORT PAYROLL-MELCHOR OSBEIDY,D108,HJ,69.38,,173338.49
6150,10/30/2020,10/30/2020,103120,82L-IMPORT PAYROLL-MITTLEMAN ROBERT,D108,HJ,13.48,,173351.97
6150,10/30/2020,10/30/2020,103120,82L-IMPORT PAYROLL-MITTLEMAN ROBERT,D108,HJ,57.64,,173409.61
6150,10/30/2020,10/30/2020,103120,82L-IMPORT PAYROLL-MORRIS ZAKIYA,D108,HJ,16.23,,173425.84
6150,10/30/2020,10/30/2020,103120,82L-IMPORT PAYROLL-MORRIS ZAKIYA,D108,HJ,69.38,,173495.22
6150,10/30/2020,10/30/2020,103120,82L-IMPORT PAYROLL-MORSELETTO RAFAEL,D108,HJ,16.23,,173511.45
6150,10/30/2020,10/30/2020,103120,82L-IMPORT PAYROLL-MORSELETTO RAFAEL,D108,HJ,69.38,,173580.83
6150,10/30/2020,10/30/2020,103120,82L-IMPORT PAYROLL-OBI TOBECHUKWU,D108,HJ,16.23,,173597.06
6150,10/30/2020,10/30/2020,103120,82L-IMPORT PAYROLL-OBI TOBECHUKWU,D108,HJ,69.38,,173666.44
6150,10/30/2020,10/30/2020,103120,82L-IMPORT PAYROLL-OPUH NDIDI,D108,HJ,34.73,,173701.17
6150,10/30/2020,10/30/2020,103120,82L-IMPORT PAYROLL-OPUH NDIDI,D108,HJ,148.51,,173849.68
6150,10/30/2020,10/30/2020,103120,82L-IMPORT PAYROLL-PAULINO THAIRI,D108,HJ,16.23,,173865.91
6150,10/30/2020,10/30/2020,103120,82L-IMPORT PAYROLL-PAULINO THAIRI,D108,HJ,69.38,,173935.29
6150,10/30/2020,10/30/2020,103120,82L-IMPORT PAYROLL-ROSENBAUM MURRAY,D108,HJ,16.23,,173951.52
6150,10/30/2020,10/30/2020,103120,82L-IMPORT PAYROLL-ROSENBAUM MURRAY,D108,HJ,69.38,,174020.9
6150,10/30/2020,10/30/2020,103120,82L-IMPORT PAYROLL-SCHWETTMANN CLAIRE,D108,HJ,15.28,,174036.18
6150,10/30/2020,10/30/2020,103120,82L-IMPORT PAYROLL-SCHWETTMANN CLAIRE,D108,HJ,65.35,,174101.53
6150,10/30/2020,10/30/2020,103120,82L-IMPORT PAYROLL-SOBELMAN JUSTIN,D108,HJ,15.08,,174116.61
6150,10/30/2020,10/30/2020,103120,82L-IMPORT PAYROLL-SOBELMAN JUSTIN,D108,HJ,64.5,,174181.11
6150,10/30/2020,10/30/2020,103120,82L-IMPORT PAYROLL-TERRENCE-SMITH ZIHIR,D108,HJ,14.32,,174195.43
6150,10/30/2020,10/30/2020,103120,82L-IMPORT PAYROLL-TERRENCE-SMITH ZIHIR,D108,HJ,61.22,,174256.65
6150,10/30/2020,10/30/2020,103120,82L-IMPORT PAYROLL-TILLERY ASIA,D108,HJ,47.73,,174304.38
6150,10/30/2020,10/30/2020,103120,82L-IMPORT PAYROLL-TILLERY ASIA,D108,HJ,204.08,,174508.46
6150,10/30/2020,10/30/2020,103120,82L-IMPORT PAYROLL-WILLIAMS-MASSEY BRIANNA,D108,HJ,16.05,,174524.51
6150,10/30/2020,10/30/2020,103120,82L-IMPORT PAYROLL-WILLIAMS-MASSEY BRIANNA,D108,HJ,68.64,,174593.15
6150,10/30/2020,10/30/2020,103120,82L-IMPORT PAYROLL-XIAO CHENGYAO,D108,HJ,16.23,,174609.38
6150,10/30/2020,10/30/2020,103120,82L-IMPORT PAYROLL-XIAO CHENGYAO,D108,HJ,69.38,,174678.76
6150,10/30/2020,10/30/2020,103120,82L-IMPORT PAYROLL-ZIAUDDIN ABUTAHER,D108,HJ,16.23,,174694.99
6150,10/30/2020,10/30/2020,103120,82L-IMPORT PAYROLL-ZIAUDDIN ABUTAHER,D108,HJ,69.38,,174764.37
6150,10/30/2020,10/30/2020,103120,82L-IMPORT PAYROLL-BALASUBRAMANIAN SHARANYA,D108,HJ,16.53,,174780.9
6150,10/30/2020,10/30/2020,103120,82L-IMPORT PAYROLL-BALASUBRAMANIAN SHARANYA,D108,HJ,38.67,,174819.57
6150,10/30/2020,10/30/2020,103120,82L-IMPORT PAYROLL-BALASUBRAMANIAN SHARANYA,D108,HJ,165.33,,174984.9
6150,10/30/2020,10/30/2020,103120,82L-IMPORT PAYROLL-COVENEY ALLISON,D108,HJ,38.07,,175022.97
6150,10/30/2020,10/30/2020,103120,82L-IMPORT PAYROLL-COVENEY ALLISON,D108,HJ,162.79,,175185.76
6150,10/30/2020,10/30/2020,103120,82L-IMPORT PAYROLL-JACKSON CLAICE M,D108,HJ,19.38,,175205.14
6150,10/30/2020,10/30/2020,103120,82L-IMPORT PAYROLL-JACKSON CLAICE M,D108,HJ,45.16,,175250.3
6150,10/30/2020,10/30/2020,103120,82L-IMPORT PAYROLL-JACKSON CLAICE M,D108,HJ,193.08,,175443.38
6150,10/30/2020,10/30/2020,103120,82L-IMPORT PAYROLL-JANG DANIEL,D108,HJ,37.75,,175481.13
6150,10/30/2020,10/30/2020,103120,82L-IMPORT PAYROLL-JANG DANIEL,D108,HJ,161.4,,175642.53
6150,10/30/2020,10/30/2020,103120,82L-IMPORT PAYROLL-LENEGHAN MARYELLEN,D108,HJ,25.99,,175668.52
6150,10/30/2020,10/30/2020,103120,82L-IMPORT PAYROLL-LENEGHAN MARYELLEN,D108,HJ,42.39,,175710.91
6150,10/30/2020,10/30/2020,103120,82L-IMPORT PAYROLL-LENEGHAN MARYELLEN,D108,HJ,111.11,,175822.02
6150,10/30/2020,10/30/2020,103120,82L-IMPORT PAYROLL-LENEGHAN MARYELLEN,D108,HJ,181.26,,176003.28
6150,10/31/2020,10/31/2020,202010,Adj to reallocate Salaries FICA and benefits from GM3 - ACY2 to G-BL-To reallocate Amena Wallance from GM3 - ACY2 to G-BL,D104,HJ,,317.15,175686.13
6150,10/31/2020,10/31/2020,202010,Adj to reallocate Salaries FICA and benefits from GM3 - ACY2 to G-BL-To reallocate Amena Wallance from GM3 - ACY2 to G-BL,D104,HJ,317.15,,176003.28
6150,10/31/2020,10/31/2020,202010,Adj to reallocate Salaries FICA and benefits from GM3 - ACY2 to G-BL-To reallocate J.Messing and T.Bibb salary from GM3 - ACY2 to G-BL,D104,HJ,,575.08,175428.2
6150,10/31/2020,10/31/2020,202010,Adj to reallocate Salaries FICA and benefits from GM3 - ACY2 to G-BL-To reallocate J.Messing and T.Bibb salary from GM3 - ACY2 to G-BL,D104,HJ,575.08,,176003.28
6150,11/13/2020,11/13/2020,111320,82L-IMPORT PAYROLL-BARTHELEMY RACHALIE,D108,HJ,14.01,,176017.29
6150,11/13/2020,11/13/2020,111320,82L-IMPORT PAYROLL-BARTHELEMY RACHALIE,D108,HJ,26.08,,176043.37
6150,11/13/2020,11/13/2020,111320,82L-IMPORT PAYROLL-BARTHELEMY RACHALIE,D108,HJ,59.89,,176103.26
6150,11/13/2020,11/13/2020,111320,82L-IMPORT PAYROLL-BASHAM WILLIAM EDWARD,D108,HJ,14.06,,176117.32
6150,11/13/2020,11/13/2020,111320,82L-IMPORT PAYROLL-BASHAM WILLIAM EDWARD,D108,HJ,60.11,,176177.43
6150,11/13/2020,11/13/2020,111320,82L-IMPORT PAYROLL-BOHLSEN GRACE ISABELLE,D108,HJ,15.16,,176192.59
6150,11/13/2020,11/13/2020,111320,82L-IMPORT PAYROLL-BOHLSEN GRACE ISABELLE,D108,HJ,64.84,,176257.43
6150,11/13/2020,11/13/2020,111320,82L-IMPORT PAYROLL-BOLIVAR ANDREA,D108,HJ,35.33,,176292.76
6150,11/13/2020,11/13/2020,111320,82L-IMPORT PAYROLL-BOLIVAR ANDREA,D108,HJ,36.25,,176329.01
6150,11/13/2020,11/13/2020,111320,82L-IMPORT PAYROLL-BOLIVAR ANDREA,D108,HJ,155,,176484.01
6150,11/13/2020,11/13/2020,111320,82L-IMPORT PAYROLL-BORCHART SPENCER,D108,HJ,15.19,,176499.2
6150,11/13/2020,11/13/2020,111320,82L-IMPORT PAYROLL-BORCHART SPENCER,D108,HJ,44.27,,176543.47
6150,11/13/2020,11/13/2020,111320,82L-IMPORT PAYROLL-BORCHART SPENCER,D108,HJ,64.95,,176608.42
6150,11/13/2020,11/13/2020,111320,82L-IMPORT PAYROLL-BROWN ISAAC,D108,HJ,14.01,,176622.43
6150,11/13/2020,11/13/2020,111320,82L-IMPORT PAYROLL-BROWN ISAAC,D108,HJ,20.14,,176642.57
6150,11/13/2020,11/13/2020,111320,82L-IMPORT PAYROLL-BROWN ISAAC,D108,HJ,59.89,,176702.46
6150,11/13/2020,11/13/2020,111320,82L-IMPORT PAYROLL-BURKE MARIAH,D108,HJ,15.19,,176717.65
6150,11/13/2020,11/13/2020,111320,82L-IMPORT PAYROLL-BURKE MARIAH,D108,HJ,64.95,,176782.6
6150,11/13/2020,11/13/2020,111320,82L-IMPORT PAYROLL-CASSADY JOSHUA LEWIS,D108,HJ,15.19,,176797.79
6150,11/13/2020,11/13/2020,111320,82L-IMPORT PAYROLL-CASSADY JOSHUA LEWIS,D108,HJ,28.29,,176826.08
6150,11/13/2020,11/13/2020,111320,82L-IMPORT PAYROLL-CASSADY JOSHUA LEWIS,D108,HJ,64.95,,176891.03
6150,11/13/2020,11/13/2020,111320,82L-IMPORT PAYROLL-DARKO OLIVIA,D108,HJ,15.19,,176906.22
6150,11/13/2020,11/13/2020,111320,82L-IMPORT PAYROLL-DARKO OLIVIA,D108,HJ,64.95,,176971.17
6150,11/13/2020,11/13/2020,111320,82L-IMPORT PAYROLL-DAWSON JAMIL NAFAYE-BEYAH,D108,HJ,15.19,,176986.36
6150,11/13/2020,11/13/2020,111320,82L-IMPORT PAYROLL-DAWSON JAMIL NAFAYE-BEYAH,D108,HJ,64.95,,177051.31
6150,11/13/2020,11/13/2020,111320,82L-IMPORT PAYROLL-ESCAMILLA OLGA,D108,HJ,15.19,,177066.5
6150,11/13/2020,11/13/2020,111320,82L-IMPORT PAYROLL-ESCAMILLA OLGA,D108,HJ,64.95,,177131.45
6150,11/13/2020,11/13/2020,111320,82L-IMPORT PAYROLL-GARCIA SANTIAGO,D108,HJ,29.6,,177161.05
6150,11/13/2020,11/13/2020,111320,82L-IMPORT PAYROLL-GARCIA SANTIAGO,D108,HJ,126.58,,177287.63
6150,11/13/2020,11/13/2020,111320,82L-IMPORT PAYROLL-GILES SHAYLA,D108,HJ,15.19,,177302.82
6150,11/13/2020,11/13/2020,111320,82L-IMPORT PAYROLL-GILES SHAYLA,D108,HJ,19.29,,177322.11
6150,11/13/2020,11/13/2020,111320,82L-IMPORT PAYROLL-GILES SHAYLA,D108,HJ,64.95,,177387.06
6150,11/13/2020,11/13/2020,111320,82L-IMPORT PAYROLL-IKUNIKA FUNMILAYO,D108,HJ,30.21,,177417.27
6150,11/13/2020,11/13/2020,111320,82L-IMPORT PAYROLL-IKUNIKA FUNMILAYO,D108,HJ,129.17,,177546.44
6150,11/13/2020,11/13/2020,111320,82L-IMPORT PAYROLL-JONES JORDAN,D108,HJ,15.19,,177561.63
6150,11/13/2020,11/13/2020,111320,82L-IMPORT PAYROLL-JONES JORDAN,D108,HJ,64.95,,177626.58
6150,11/13/2020,11/13/2020,111320,82L-IMPORT PAYROLL-KHAN HUDA,D108,HJ,14.25,,177640.83
6150,11/13/2020,11/13/2020,111320,82L-IMPORT PAYROLL-KHAN HUDA,D108,HJ,26.53,,177667.36
6150,11/13/2020,11/13/2020,111320,82L-IMPORT PAYROLL-KHAN HUDA,D108,HJ,60.92,,177728.28
6150,11/13/2020,11/13/2020,111320,82L-IMPORT PAYROLL-KLOHR TIMOTHY JORDAN,D108,HJ,29,,177757.28
6150,11/13/2020,11/13/2020,111320,82L-IMPORT PAYROLL-KLOHR TIMOTHY JORDAN,D108,HJ,124,,177881.28
6150,11/13/2020,11/13/2020,111320,82L-IMPORT PAYROLL-KNOWLIN ZYLIA,D108,HJ,0.84,,177882.12
6150,11/13/2020,11/13/2020,111320,82L-IMPORT PAYROLL-KNOWLIN ZYLIA,D108,HJ,34.63,,177916.75
6150,11/13/2020,11/13/2020,111320,82L-IMPORT PAYROLL-KNOWLIN ZYLIA,D108,HJ,148.06,,178064.81
6150,11/13/2020,11/13/2020,111320,82L-IMPORT PAYROLL-KOPSHEVER MELISSA,D108,HJ,38.26,,178103.07
6150,11/13/2020,11/13/2020,111320,82L-IMPORT PAYROLL-KOPSHEVER MELISSA,D108,HJ,163.58,,178266.65
6150,11/13/2020,11/13/2020,111320,82L-IMPORT PAYROLL-LENEGHAN MARYELLEN,D108,HJ,33.42,,178300.07
6150,11/13/2020,11/13/2020,111320,82L-IMPORT PAYROLL-LENEGHAN MARYELLEN,D108,HJ,142.89,,178442.96
6150,11/13/2020,11/13/2020,111320,82L-IMPORT PAYROLL-LI SEN YUAN,D108,HJ,14.05,,178457.01
6150,11/13/2020,11/13/2020,111320,82L-IMPORT PAYROLL-LI SEN YUAN,D108,HJ,26.16,,178483.17
6150,11/13/2020,11/13/2020,111320,82L-IMPORT PAYROLL-LI SEN YUAN,D108,HJ,60.07,,178543.24
6150,11/13/2020,11/13/2020,111320,82L-IMPORT PAYROLL-LIPSCOMB STEPHEN,D108,HJ,33.58,,178576.82
6150,11/13/2020,11/13/2020,111320,82L-IMPORT PAYROLL-LIPSCOMB STEPHEN,D108,HJ,143.59,,178720.41
6150,11/13/2020,11/13/2020,111320,82L-IMPORT PAYROLL-MALLECK JESSICA R,D108,HJ,15.19,,178735.6
6150,11/13/2020,11/13/2020,111320,82L-IMPORT PAYROLL-MALLECK JESSICA R,D108,HJ,64.95,,178800.55
6150,11/13/2020,11/13/2020,111320,82L-IMPORT PAYROLL-MCLAUGHLIN MARA,D108,HJ,15.19,,178815.74
6150,11/13/2020,11/13/2020,111320,82L-IMPORT PAYROLL-MCLAUGHLIN MARA,D108,HJ,64.95,,178880.69
6150,11/13/2020,11/13/2020,111320,82L-IMPORT PAYROLL-MEJIA ROSO CARLOS,D108,HJ,14.01,,178894.7
6150,11/13/2020,11/13/2020,111320,82L-IMPORT PAYROLL-MEJIA ROSO CARLOS,D108,HJ,26.08,,178920.78
6150,11/13/2020,11/13/2020,111320,82L-IMPORT PAYROLL-MEJIA ROSO CARLOS,D108,HJ,59.89,,178980.67
6150,11/13/2020,11/13/2020,111320,82L-IMPORT PAYROLL-MONROY-MEJIA JASON,D108,HJ,15.19,,178995.86
6150,11/13/2020,11/13/2020,111320,82L-IMPORT PAYROLL-MONROY-MEJIA JASON,D108,HJ,25,,179020.86
6150,11/13/2020,11/13/2020,111320,82L-IMPORT PAYROLL-MONROY-MEJIA JASON,D108,HJ,64.95,,179085.81
6150,11/13/2020,11/13/2020,111320,82L-IMPORT PAYROLL-O'FLYNN-PRUITT NATHAN COLYAR,D108,HJ,15.19,,179101
6150,11/13/2020,11/13/2020,111320,82L-IMPORT PAYROLL-O'FLYNN-PRUITT NATHAN COLYAR,D108,HJ,25,,179126
6150,11/13/2020,11/13/2020,111320,82L-IMPORT PAYROLL-O'FLYNN-PRUITT NATHAN COLYAR,D108,HJ,64.95,,179190.95
6150,11/13/2020,11/13/2020,111320,82L-IMPORT PAYROLL-PATTERSON STEVE,D108,HJ,15.19,,179206.14
6150,11/13/2020,11/13/2020,111320,82L-IMPORT PAYROLL-PATTERSON STEVE,D108,HJ,19.29,,179225.43
6150,11/13/2020,11/13/2020,111320,82L-IMPORT PAYROLL-PATTERSON STEVE,D108,HJ,64.95,,179290.38
6150,11/13/2020,11/13/2020,111320,82L-IMPORT PAYROLL-SCHMIESS RACHEL JOY,D108,HJ,15.19,,179305.57
6150,11/13/2020,11/13/2020,111320,82L-IMPORT PAYROLL-SCHMIESS RACHEL JOY,D108,HJ,64.95,,179370.52
6150,11/13/2020,11/13/2020,111320,82L-IMPORT PAYROLL-SCOTT KIRK DONOVAN,D108,HJ,14.05,,179384.57
6150,11/13/2020,11/13/2020,111320,82L-IMPORT PAYROLL-SCOTT KIRK DONOVAN,D108,HJ,26.16,,179410.73
6150,11/13/2020,11/13/2020,111320,82L-IMPORT PAYROLL-SCOTT KIRK DONOVAN,D108,HJ,60.07,,179470.8
6150,11/13/2020,11/13/2020,111320,82L-IMPORT PAYROLL-SILVER KELLY,D108,HJ,34.63,,179505.43
6150,11/13/2020,11/13/2020,111320,82L-IMPORT PAYROLL-SILVER KELLY,D108,HJ,148.06,,179653.49
6150,11/13/2020,11/13/2020,111320,82L-IMPORT PAYROLL-SOLIMAN MARK,D108,HJ,15.19,,179668.68
6150,11/13/2020,11/13/2020,111320,82L-IMPORT PAYROLL-SOLIMAN MARK,D108,HJ,25,,179693.68
6150,11/13/2020,11/13/2020,111320,82L-IMPORT PAYROLL-SOLIMAN MARK,D108,HJ,64.95,,179758.63
6150,11/13/2020,11/13/2020,111320,82L-IMPORT PAYROLL-STEIN KYLE,D108,HJ,27.84,,179786.47
6150,11/13/2020,11/13/2020,111320,82L-IMPORT PAYROLL-STEIN KYLE,D108,HJ,119.05,,179905.52
6150,11/13/2020,11/13/2020,111320,82L-IMPORT PAYROLL-STROUD DAVID,D108,HJ,14.65,,179920.17
6150,11/13/2020,11/13/2020,111320,82L-IMPORT PAYROLL-STROUD DAVID,D108,HJ,62.62,,179982.79
6150,11/13/2020,11/13/2020,111320,82L-IMPORT PAYROLL-VALCIN SABRINA JEMIMAH,D108,HJ,14.25,,179997.04
6150,11/13/2020,11/13/2020,111320,82L-IMPORT PAYROLL-VALCIN SABRINA JEMIMAH,D108,HJ,26.53,,180023.57
6150,11/13/2020,11/13/2020,111320,82L-IMPORT PAYROLL-VALCIN SABRINA JEMIMAH,D108,HJ,60.92,,180084.49
6150,11/13/2020,11/13/2020,111320,82L-IMPORT PAYROLL-VALDES ERNEST L,D108,HJ,15.19,,180099.68
6150,11/13/2020,11/13/2020,111320,82L-IMPORT PAYROLL-VALDES ERNEST L,D108,HJ,25,,180124.68
6150,11/13/2020,11/13/2020,111320,82L-IMPORT PAYROLL-VALDES ERNEST L,D108,HJ,64.95,,180189.63
6150,11/13/2020,11/13/2020,111320,82L-IMPORT PAYROLL-WILLIAMS MACK ANTHONY,D108,HJ,15.02,,180204.65
6150,11/13/2020,11/13/2020,111320,82L-IMPORT PAYROLL-WILLIAMS MACK ANTHONY,D108,HJ,22.98,,180227.63
6150,11/13/2020,11/13/2020,111320,82L-IMPORT PAYROLL-WILLIAMS MACK ANTHONY,D108,HJ,64.21,,180291.84
6150,11/13/2020,11/13/2020,111320,82L-IMPORT PAYROLL-WILLIAMS MIL'YONTA,D108,HJ,15.19,,180307.03
6150,11/13/2020,11/13/2020,111320,82L-IMPORT PAYROLL-WILLIAMS MIL'YONTA,D108,HJ,64.95,,180371.98
6150,11/13/2020,11/13/2020,111320,82L-IMPORT PAYROLL-ANTHONY BETTY S,D108,HJ,41.85,,180413.83
6150,11/13/2020,11/13/2020,111320,82L-IMPORT PAYROLL-ANTHONY BETTY S,D108,HJ,178.96,,180592.79
6150,11/13/2020,11/13/2020,111320,82L-IMPORT PAYROLL-APULI LINDSAY,D108,HJ,34.16,,180626.95
6150,11/13/2020,11/13/2020,111320,82L-IMPORT PAYROLL-APULI LINDSAY,D108,HJ,146.08,,180773.03
6150,11/13/2020,11/13/2020,111320,82L-IMPORT PAYROLL-AUSTIN PERCY ANTONIO,D108,HJ,36.34,,180809.37
6150,11/13/2020,11/13/2020,111320,82L-IMPORT PAYROLL-AUSTIN PERCY ANTONIO,D108,HJ,155.39,,180964.76
6150,11/13/2020,11/13/2020,111320,82L-IMPORT PAYROLL-BUHMANN JENNIFER,D108,HJ,32.9,,180997.66
6150,11/13/2020,11/13/2020,111320,82L-IMPORT PAYROLL-BUHMANN JENNIFER,D108,HJ,140.68,,181138.34
6150,11/13/2020,11/13/2020,111320,82L-IMPORT PAYROLL-CAIN CORY,D108,HJ,42.36,,181180.7
6150,11/13/2020,11/13/2020,111320,82L-IMPORT PAYROLL-CAIN CORY,D108,HJ,181.13,,181361.83
6150,11/13/2020,11/13/2020,111320,82L-IMPORT PAYROLL-CHAPMAN CLAUDY EARL,D108,HJ,26.38,,181388.21
6150,11/13/2020,11/13/2020,111320,82L-IMPORT PAYROLL-CHAPMAN CLAUDY EARL,D108,HJ,112.81,,181501.02
6150,11/13/2020,11/13/2020,111320,82L-IMPORT PAYROLL-DADA ARIKPO E,D108,HJ,32.04,,181533.06
6150,11/13/2020,11/13/2020,111320,82L-IMPORT PAYROLL-DADA ARIKPO E,D108,HJ,137,,181670.06
6150,11/13/2020,11/13/2020,111320,82L-IMPORT PAYROLL-GUTHRIE LESLIE,D108,HJ,33.42,,181703.48
6150,11/13/2020,11/13/2020,111320,82L-IMPORT PAYROLL-GUTHRIE LESLIE,D108,HJ,142.9,,181846.38
6150,11/13/2020,11/13/2020,111320,82L-IMPORT PAYROLL-HOLMES JOREL ALEXANDER,D108,HJ,31.22,,181877.6
6150,11/13/2020,11/13/2020,111320,82L-IMPORT PAYROLL-HOLMES JOREL ALEXANDER,D108,HJ,133.51,,182011.11
6150,11/13/2020,11/13/2020,111320,82L-IMPORT PAYROLL-JORDAN TIFFANY T,D108,HJ,45.87,,182056.98
6150,11/13/2020,11/13/2020,111320,82L-IMPORT PAYROLL-JORDAN TIFFANY T,D108,HJ,196.13,,182253.11
6150,11/13/2020,11/13/2020,111320,82L-IMPORT PAYROLL-LANIGAN LISA A,D108,HJ,45.1,,182298.21
6150,11/13/2020,11/13/2020,111320,82L-IMPORT PAYROLL-LANIGAN LISA A,D108,HJ,192.83,,182491.04
6150,11/13/2020,11/13/2020,111320,82L-IMPORT PAYROLL-MCELWEE MELISSA,D108,HJ,38.67,,182529.71
6150,11/13/2020,11/13/2020,111320,82L-IMPORT PAYROLL-MCELWEE MELISSA,D108,HJ,165.33,,182695.04
6150,11/13/2020,11/13/2020,111320,82L-IMPORT PAYROLL-MCNICHOLAS MARY,D108,HJ,33.23,,182728.27
6150,11/13/2020,11/13/2020,111320,82L-IMPORT PAYROLL-MCNICHOLAS MARY,D108,HJ,142.08,,182870.35
6150,11/13/2020,11/13/2020,111320,82L-IMPORT PAYROLL-NWAKANMA NANCY,D108,HJ,44.18,,182914.53
6150,11/13/2020,11/13/2020,111320,82L-IMPORT PAYROLL-NWAKANMA NANCY,D108,HJ,188.89,,183103.42
6150,11/13/2020,11/13/2020,111320,82L-IMPORT PAYROLL-ONICA ANTHONY J,D108,HJ,32.86,,183136.28
6150,11/13/2020,11/13/2020,111320,82L-IMPORT PAYROLL-ONICA ANTHONY J,D108,HJ,140.49,,183276.77
6150,11/13/2020,11/13/2020,111320,82L-IMPORT PAYROLL-PRAHIN NICOLE M,D108,HJ,21.16,,183297.93
6150,11/13/2020,11/13/2020,111320,82L-IMPORT PAYROLL-PRAHIN NICOLE M,D108,HJ,31.75,,183329.68
6150,11/13/2020,11/13/2020,111320,82L-IMPORT PAYROLL-PRAHIN NICOLE M,D108,HJ,90.49,,183420.17
6150,11/13/2020,11/13/2020,111320,82L-IMPORT PAYROLL-PRAHIN NICOLE M,D108,HJ,135.73,,183555.9
6150,11/13/2020,11/13/2020,111320,82L-IMPORT PAYROLL-RIVERS QUIONNA DIANE,D108,HJ,39.27,,183595.17
6150,11/13/2020,11/13/2020,111320,82L-IMPORT PAYROLL-RIVERS QUIONNA DIANE,D108,HJ,167.92,,183763.09
6150,11/13/2020,11/13/2020,111320,82L-IMPORT PAYROLL-SALIM YASSER,D108,HJ,33.1,,183796.19
6150,11/13/2020,11/13/2020,111320,82L-IMPORT PAYROLL-SALIM YASSER,D108,HJ,141.55,,183937.74
6150,11/13/2020,11/13/2020,111320,82L-IMPORT PAYROLL-SEJOUR MAHALIAH,D108,HJ,34.07,,183971.81
6150,11/13/2020,11/13/2020,111320,82L-IMPORT PAYROLL-SEJOUR MAHALIAH,D108,HJ,145.66,,184117.47
6150,11/13/2020,11/13/2020,111320,82L-IMPORT PAYROLL-SKALSKI CHRISTOPHER,D108,HJ,33.86,,184151.33
6150,11/13/2020,11/13/2020,111320,82L-IMPORT PAYROLL-SKALSKI CHRISTOPHER,D108,HJ,144.76,,184296.09
6150,11/13/2020,11/13/2020,111320,82L-IMPORT PAYROLL-TUMENJARGAL ENKHJIN,D108,HJ,32.92,,184329.01
6150,11/13/2020,11/13/2020,111320,82L-IMPORT PAYROLL-TUMENJARGAL ENKHJIN,D108,HJ,140.75,,184469.76
6150,11/13/2020,11/13/2020,111320,82L-IMPORT PAYROLL-VILLEGAS EVELYN,D108,HJ,33.4,,184503.16
6150,11/13/2020,11/13/2020,111320,82L-IMPORT PAYROLL-VILLEGAS EVELYN,D108,HJ,142.81,,184645.97
6150,11/13/2020,11/13/2020,111320,82L-IMPORT PAYROLL-WOLF ANNA A,D108,HJ,36.3,,184682.27
6150,11/13/2020,11/13/2020,111320,82L-IMPORT PAYROLL-WOLF ANNA A,D108,HJ,155.19,,184837.46
6150,11/13/2020,11/13/2020,111320,82L-IMPORT PAYROLL-ACEVEDO MONIVETT,D107,HJ,72.42,,184909.88
6150,11/13/2020,11/13/2020,111320,82L-IMPORT PAYROLL-ACEVEDO MONIVETT,D107,HJ,309.64,,185219.52
6150,11/13/2020,11/13/2020,111320,82L-IMPORT PAYROLL-AKLESTAD ISABEL,D111,HJ,23.29,,185242.81
6150,11/13/2020,11/13/2020,111320,82L-IMPORT PAYROLL-AKLESTAD ISABEL,D111,HJ,99.58,,185342.39
6150,11/13/2020,11/13/2020,111320,82L-IMPORT PAYROLL-ALLEN KIMBERLY MARY,D111,HJ,12.27,,185354.66
6150,11/13/2020,11/13/2020,111320,82L-IMPORT PAYROLL-ALLEN KIMBERLY MARY,D111,HJ,52.46,,185407.12
6150,11/13/2020,11/13/2020,111320,82L-IMPORT PAYROLL-BIBB TIFFANI,D104,HJ,49.71,,185456.83
6150,11/13/2020,11/13/2020,111320,82L-IMPORT PAYROLL-BIBB TIFFANI,D104,HJ,212.55,,185669.38
6150,11/13/2020,11/13/2020,111320,82L-IMPORT PAYROLL-BOWMAN HALLEY K,D101,HJ,34.89,,185704.27
6150,11/13/2020,11/13/2020,111320,82L-IMPORT PAYROLL-BOWMAN HALLEY K,D101,HJ,149.19,,185853.46
6150,11/13/2020,11/13/2020,111320,82L-IMPORT PAYROLL-COOK CATHRYN ANNA,D105,HJ,49.87,,185903.33
6150,11/13/2020,11/13/2020,111320,82L-IMPORT PAYROLL-COOK CATHRYN ANNA,D105,HJ,213.25,,186116.58
6150,11/13/2020,11/13/2020,111320,82L-IMPORT PAYROLL-COOPER ASHLEE R,D101,HJ,33.51,,186150.09
6150,11/13/2020,11/13/2020,111320,82L-IMPORT PAYROLL-COOPER ASHLEE R,D101,HJ,143.3,,186293.39
6150,11/13/2020,11/13/2020,111320,82L-IMPORT PAYROLL-CORTEZ MIRANDA A,D111,HJ,38.45,,186331.84
6150,11/13/2020,11/13/2020,111320,82L-IMPORT PAYROLL-CORTEZ MIRANDA A,D111,HJ,164.42,,186496.26
6150,11/13/2020,11/13/2020,111320,82L-IMPORT PAYROLL-DAUGHERTY DEVIN W,D101,HJ,15.1,,186511.36
6150,11/13/2020,11/13/2020,111320,82L-IMPORT PAYROLL-DAUGHERTY DEVIN W,D101,HJ,64.58,,186575.94
6150,11/13/2020,11/13/2020,111320,82L-IMPORT PAYROLL-DETONE KYRA MAYA,D102,HJ,3.51,,186579.45
6150,11/13/2020,11/13/2020,111320,82L-IMPORT PAYROLL-DETONE KYRA MAYA,D102,HJ,15,,186594.45
6150,11/13/2020,11/13/2020,111320,82L-IMPORT PAYROLL-DETONE KYRA MAYA,D102,HJ,35.49,,186629.94
6150,11/13/2020,11/13/2020,111320,82L-IMPORT PAYROLL-DETONE KYRA MAYA,D102,HJ,151.75,,186781.69
6150,11/13/2020,11/13/2020,111320,82L-IMPORT PAYROLL-DUPUIS CHRISTOPHER M,D107,HJ,35.5,,186817.19
6150,11/13/2020,11/13/2020,111320,82L-IMPORT PAYROLL-DUPUIS CHRISTOPHER M,D107,HJ,53.24,,186870.43
6150,11/13/2020,11/13/2020,111320,82L-IMPORT PAYROLL-DUPUIS CHRISTOPHER M,D107,HJ,151.78,,187022.21
6150,11/13/2020,11/13/2020,111320,82L-IMPORT PAYROLL-DUPUIS CHRISTOPHER M,D107,HJ,227.67,,187249.88
6150,11/13/2020,11/13/2020,111320,82L-IMPORT PAYROLL-DZIEDZIC JULIE K,D101,HJ,17.71,,187267.59
6150,11/13/2020,11/13/2020,111320,82L-IMPORT PAYROLL-DZIEDZIC JULIE K,D101,HJ,75.71,,187343.3
6150,11/13/2020,11/13/2020,111320,82L-IMPORT PAYROLL-FISCHABER THOMAS,D109,HJ,77.9,,187421.2
6150,11/13/2020,11/13/2020,111320,82L-IMPORT PAYROLL-FISCHABER THOMAS,D109,HJ,333.1,,187754.3
6150,11/13/2020,11/13/2020,111320,82L-IMPORT PAYROLL-FLORY MEGAN,D109,HJ,21.75,,187776.05
6150,11/13/2020,11/13/2020,111320,82L-IMPORT PAYROLL-FLORY MEGAN,D109,HJ,93,,187869.05
6150,11/13/2020,11/13/2020,111320,82L-IMPORT PAYROLL-GORNSTEIN STEVEN,D101,HJ,39.27,,187908.32
6150,11/13/2020,11/13/2020,111320,82L-IMPORT PAYROLL-GORNSTEIN STEVEN,D101,HJ,167.92,,188076.24
6150,11/13/2020,11/13/2020,111320,82L-IMPORT PAYROLL-GUADARRAMA-ALVAREZ URIEL A,D105,HJ,39.93,,188116.17
6150,11/13/2020,11/13/2020,111320,82L-IMPORT PAYROLL-GUADARRAMA-ALVAREZ URIEL A,D105,HJ,170.75,,188286.92
6150,11/13/2020,11/13/2020,111320,82L-IMPORT PAYROLL-GUTIERREZ ANTONIO J,D107,HJ,37.12,,188324.04
6150,11/13/2020,11/13/2020,111320,82L-IMPORT PAYROLL-GUTIERREZ ANTONIO J,D107,HJ,37.13,,188361.17
6150,11/13/2020,11/13/2020,111320,82L-IMPORT PAYROLL-GUTIERREZ ANTONIO J,D107,HJ,158.74,,188519.91
6150,11/13/2020,11/13/2020,111320,82L-IMPORT PAYROLL-GUTIERREZ ANTONIO J,D107,HJ,158.74,,188678.65
6150,11/13/2020,11/13/2020,111320,82L-IMPORT PAYROLL-HENRY GILLIAN,D102,HJ,29.17,,188707.82
6150,11/13/2020,11/13/2020,111320,82L-IMPORT PAYROLL-HENRY GILLIAN,D102,HJ,124.74,,188832.56
6150,11/13/2020,11/13/2020,111320,82L-IMPORT PAYROLL-HERMAN ADAM,D102,HJ,28.2,,188860.76
6150,11/13/2020,11/13/2020,111320,82L-IMPORT PAYROLL-HERMAN ADAM,D102,HJ,120.56,,188981.32
6150,11/13/2020,11/13/2020,111320,82L-IMPORT PAYROLL-HESTER TYLER CONRAD,D105,HJ,27.79,,189009.11
6150,11/13/2020,11/13/2020,111320,82L-IMPORT PAYROLL-HESTER TYLER CONRAD,D105,HJ,118.83,,189127.94
6150,11/13/2020,11/13/2020,111320,82L-IMPORT PAYROLL-HOLT ADAM,D109,HJ,58.24,,189186.18
6150,11/13/2020,11/13/2020,111320,82L-IMPORT PAYROLL-HOLT ADAM,D109,HJ,249.02,,189435.2
6150,11/13/2020,11/13/2020,111320,82L-IMPORT PAYROLL-KELLY SEAN,D109,HJ,78.54,,189513.74
6150,11/13/2020,11/13/2020,111320,82L-IMPORT PAYROLL-KELLY SEAN,D109,HJ,335.83,,189849.57
6150,11/13/2020,11/13/2020,111320,82L-IMPORT PAYROLL-KRUGER MARK,D109,HJ,72.5,,189922.07
6150,11/13/2020,11/13/2020,111320,82L-IMPORT PAYROLL-KRUGER MARK,D109,HJ,310,,190232.07
6150,11/13/2020,11/13/2020,111320,82L-IMPORT PAYROLL-LIPORACE HERNAN LUIS,D103,HJ,33.06,,190265.13
6150,11/13/2020,11/13/2020,111320,82L-IMPORT PAYROLL-LIPORACE HERNAN LUIS,D103,HJ,141.34,,190406.47
6150,11/13/2020,11/13/2020,111320,82L-IMPORT PAYROLL-MARKS KRISTA,D109,HJ,76.2,,190482.67
6150,11/13/2020,11/13/2020,111320,82L-IMPORT PAYROLL-MARKS KRISTA,D109,HJ,325.8,,190808.47
6150,11/13/2020,11/13/2020,111320,82L-IMPORT PAYROLL-MASON ANGELA,D107,HJ,21.22,,190829.69
6150,11/13/2020,11/13/2020,111320,82L-IMPORT PAYROLL-MASON ANGELA,D107,HJ,57.35,,190887.04
6150,11/13/2020,11/13/2020,111320,82L-IMPORT PAYROLL-MASON ANGELA,D107,HJ,91.72,,190978.76
6150,11/13/2020,11/13/2020,111320,82L-IMPORT PAYROLL-MASON ANGELA,D107,HJ,245.25,,191224.01
6150,11/13/2020,11/13/2020,111320,82L-IMPORT PAYROLL-MELVIN DARNELL,D109,HJ,55.91,,191279.92
6150,11/13/2020,11/13/2020,111320,82L-IMPORT PAYROLL-MELVIN DARNELL,D109,HJ,239.08,,191519
6150,11/13/2020,11/13/2020,111320,82L-IMPORT PAYROLL-MESSING JENNIFER,D104,HJ,34.12,,191553.12
6150,11/13/2020,11/13/2020,111320,82L-IMPORT PAYROLL-MESSING JENNIFER,D104,HJ,63.54,,191616.66
6150,11/13/2020,11/13/2020,111320,82L-IMPORT PAYROLL-MESSING JENNIFER,D104,HJ,145.9,,191762.56
6150,11/13/2020,11/13/2020,111320,82L-IMPORT PAYROLL-MILNE ROGER,D109,HJ,4.71,,191767.27
6150,11/13/2020,11/13/2020,111320,82L-IMPORT PAYROLL-MILNE ROGER,D109,HJ,20.15,,191787.42
6150,11/13/2020,11/13/2020,111320,82L-IMPORT PAYROLL-MILNE ROGER,D109,HJ,73.83,,191861.25
6150,11/13/2020,11/13/2020,111320,82L-IMPORT PAYROLL-MILNE ROGER,D109,HJ,315.68,,192176.93
6150,11/13/2020,11/13/2020,111320,82L-IMPORT PAYROLL-MOSTAFAVI YASAMAN,D109,HJ,3.83,,192180.76
6150,11/13/2020,11/13/2020,111320,82L-IMPORT PAYROLL-MOSTAFAVI YASAMAN,D109,HJ,16.37,,192197.13
6150,11/13/2020,11/13/2020,111320,82L-IMPORT PAYROLL-O'DONNELL STEPHEN,D104,HJ,39.26,,192236.39
6150,11/13/2020,11/13/2020,111320,82L-IMPORT PAYROLL-O'DONNELL STEPHEN,D104,HJ,167.87,,192404.26
6150,11/13/2020,11/13/2020,111320,82L-IMPORT PAYROLL-PARETS MALLORY GRACE,D101,HJ,17.57,,192421.83
6150,11/13/2020,11/13/2020,111320,82L-IMPORT PAYROLL-PARETS MALLORY GRACE,D101,HJ,41.08,,192462.91
6150,11/13/2020,11/13/2020,111320,82L-IMPORT PAYROLL-PARETS MALLORY GRACE,D101,HJ,175.67,,192638.58
6150,11/13/2020,11/13/2020,111320,82L-IMPORT PAYROLL-PARHAM-GANTT DENISE M,D112,HJ,37.96,,192676.54
6150,11/13/2020,11/13/2020,111320,82L-IMPORT PAYROLL-PARHAM-GANTT DENISE M,D112,HJ,162.32,,192838.86
6150,11/13/2020,11/13/2020,111320,82L-IMPORT PAYROLL-PEINADO ELIZABETH R,D111,HJ,52.29,,192891.15
6150,11/13/2020,11/13/2020,111320,82L-IMPORT PAYROLL-PEINADO ELIZABETH R,D111,HJ,223.58,,193114.73
6150,11/13/2020,11/13/2020,111320,82L-IMPORT PAYROLL-PERNIA JEFFREY,D109,HJ,56.19,,193170.92
6150,11/13/2020,11/13/2020,111320,82L-IMPORT PAYROLL-PERNIA JEFFREY,D109,HJ,240.25,,193411.17
6150,11/13/2020,11/13/2020,111320,82L-IMPORT PAYROLL-POLANCO ODALIS,D103,HJ,43.23,,193454.4
6150,11/13/2020,11/13/2020,111320,82L-IMPORT PAYROLL-POLANCO ODALIS,D103,HJ,184.83,,193639.23
6150,11/13/2020,11/13/2020,111320,82L-IMPORT PAYROLL-QUINTAS JASHIVE,D105,HJ,25.57,,193664.8
6150,11/13/2020,11/13/2020,111320,82L-IMPORT PAYROLL-QUINTAS JASHIVE,D105,HJ,109.31,,193774.11
6150,11/13/2020,11/13/2020,111320,82L-IMPORT PAYROLL-RANDOLPH ALEXANDER,D111,HJ,11.63,,193785.74
6150,11/13/2020,11/13/2020,111320,82L-IMPORT PAYROLL-RANDOLPH ALEXANDER,D111,HJ,25.1,,193810.84
6150,11/13/2020,11/13/2020,111320,82L-IMPORT PAYROLL-RANDOLPH ALEXANDER,D111,HJ,107.33,,193918.17
6150,11/13/2020,11/13/2020,111320,82L-IMPORT PAYROLL-RUBI PERLA,D101,HJ,15.92,,193934.09
6150,11/13/2020,11/13/2020,111320,82L-IMPORT PAYROLL-RUBI PERLA,D101,HJ,68.09,,194002.18
6150,11/13/2020,11/13/2020,111320,82L-IMPORT PAYROLL-SAFRAN ALAN P,D107,HJ,10.03,,194012.21
6150,11/13/2020,11/13/2020,111320,82L-IMPORT PAYROLL-SAFRAN ALAN P,D107,HJ,90.22,,194102.43
6150,11/13/2020,11/13/2020,111320,82L-IMPORT PAYROLL-SHENKMAN OLIVIA,D101,HJ,29,,194131.43
6150,11/13/2020,11/13/2020,111320,82L-IMPORT PAYROLL-SHENKMAN OLIVIA,D101,HJ,124,,194255.43
6150,11/13/2020,11/13/2020,111320,82L-IMPORT PAYROLL-SHI GRACE,D103,HJ,12.69,,194268.12
6150,11/13/2020,11/13/2020,111320,82L-IMPORT PAYROLL-SHI GRACE,D103,HJ,54.25,,194322.37
6150,11/13/2020,11/13/2020,111320,82L-IMPORT PAYROLL-WALLACE AMENA,D104,HJ,28.93,,194351.3
6150,11/13/2020,11/13/2020,111320,82L-IMPORT PAYROLL-WALLACE AMENA,D104,HJ,123.72,,194475.02
6150,11/13/2020,11/13/2020,111320,82L-IMPORT PAYROLL-WARD JEFFREY,D109,HJ,78.54,,194553.56
6150,11/13/2020,11/13/2020,111320,82L-IMPORT PAYROLL-WARD JEFFREY,D109,HJ,335.83,,194889.39
6150,11/13/2020,11/13/2020,111320,82L-IMPORT PAYROLL-WARD JENNIFER,D109,HJ,7.63,,194897.02
6150,11/13/2020,11/13/2020,111320,82L-IMPORT PAYROLL-WARD JENNIFER,D109,HJ,32.64,,194929.66
6150,11/13/2020,11/13/2020,111320,82L-IMPORT PAYROLL-WEINSTOCK EMILY,D101,HJ,17.57,,194947.23
6150,11/13/2020,11/13/2020,111320,82L-IMPORT PAYROLL-WEINSTOCK EMILY,D101,HJ,38.11,,194985.34
6150,11/13/2020,11/13/2020,111320,82L-IMPORT PAYROLL-WEINSTOCK EMILY,D101,HJ,162.94,,195148.28
6150,11/13/2020,11/13/2020,111320,82L-IMPORT PAYROLL-WINANS JENNIFER,D111,HJ,36.33,,195184.61
6150,11/13/2020,11/13/2020,111320,82L-IMPORT PAYROLL-WINANS JENNIFER,D111,HJ,155.35,,195339.96
6150,11/13/2020,11/13/2020,111320,82L-IMPORT PAYROLL-ZARATE JOSEPH M,D105,HJ,31.18,,195371.14
6150,11/13/2020,11/13/2020,111320,82L-IMPORT PAYROLL-ZARATE JOSEPH M,D105,HJ,133.3,,195504.44
6150,11/13/2020,11/13/2020,111320,82L-IMPORT PAYROLL-AGUANNO JOSEPH,D108,HJ,16.23,,195520.67
6150,11/13/2020,11/13/2020,111320,82L-IMPORT PAYROLL-AGUANNO JOSEPH,D108,HJ,69.38,,195590.05
6150,11/13/2020,11/13/2020,111320,82L-IMPORT PAYROLL-AKESODE FEHINTOLA,D108,HJ,16.23,,195606.28
6150,11/13/2020,11/13/2020,111320,82L-IMPORT PAYROLL-AKESODE FEHINTOLA,D108,HJ,69.38,,195675.66
6150,11/13/2020,11/13/2020,111320,82L-IMPORT PAYROLL-BARTOLD DEANNA MARIE,D108,HJ,41.91,,195717.57
6150,11/13/2020,11/13/2020,111320,82L-IMPORT PAYROLL-BARTOLD DEANNA MARIE,D108,HJ,179.22,,195896.79
6150,11/13/2020,11/13/2020,111320,82L-IMPORT PAYROLL-BELLOT GENESIS,D108,HJ,32.36,,195929.15
6150,11/13/2020,11/13/2020,111320,82L-IMPORT PAYROLL-BELLOT GENESIS,D108,HJ,138.38,,196067.53
6150,11/13/2020,11/13/2020,111320,82L-IMPORT PAYROLL-BENNETT JAMES H,D108,HJ,16.23,,196083.76
6150,11/13/2020,11/13/2020,111320,82L-IMPORT PAYROLL-BENNETT JAMES H,D108,HJ,69.38,,196153.14
6150,11/13/2020,11/13/2020,111320,82L-IMPORT PAYROLL-BOWMAN ABIGAIL,D108,HJ,16.23,,196169.37
6150,11/13/2020,11/13/2020,111320,82L-IMPORT PAYROLL-BOWMAN ABIGAIL,D108,HJ,69.38,,196238.75
6150,11/13/2020,11/13/2020,111320,82L-IMPORT PAYROLL-BURRELL RUSSELL,D108,HJ,15.08,,196253.83
6150,11/13/2020,11/13/2020,111320,82L-IMPORT PAYROLL-BURRELL RUSSELL,D108,HJ,64.5,,196318.33
6150,11/13/2020,11/13/2020,111320,82L-IMPORT PAYROLL-CHUI KENT,D108,HJ,16.23,,196334.56
6150,11/13/2020,11/13/2020,111320,82L-IMPORT PAYROLL-CHUI KENT,D108,HJ,69.38,,196403.94
6150,11/13/2020,11/13/2020,111320,82L-IMPORT PAYROLL-CIRKER MIA,D108,HJ,32.63,,196436.57
6150,11/13/2020,11/13/2020,111320,82L-IMPORT PAYROLL-CIRKER MIA,D108,HJ,139.5,,196576.07
6150,11/13/2020,11/13/2020,111320,82L-IMPORT PAYROLL-DEWS CAMERYN,D108,HJ,33.23,,196609.3
6150,11/13/2020,11/13/2020,111320,82L-IMPORT PAYROLL-DEWS CAMERYN,D108,HJ,142.08,,196751.38
6150,11/13/2020,11/13/2020,111320,82L-IMPORT PAYROLL-DIETZ MARY,D108,HJ,16.23,,196767.61
6150,11/13/2020,11/13/2020,111320,82L-IMPORT PAYROLL-DIETZ MARY,D108,HJ,69.38,,196836.99
6150,11/13/2020,11/13/2020,111320,82L-IMPORT PAYROLL-DOMINIQUE PRINCESSA,D108,HJ,16.23,,196853.22
6150,11/13/2020,11/13/2020,111320,82L-IMPORT PAYROLL-DOMINIQUE PRINCESSA,D108,HJ,69.38,,196922.6
6150,11/13/2020,11/13/2020,111320,82L-IMPORT PAYROLL-DONNELLY MARCUS,D108,HJ,16.23,,196938.83
6150,11/13/2020,11/13/2020,111320,82L-IMPORT PAYROLL-DONNELLY MARCUS,D108,HJ,21.49,,196960.32
6150,11/13/2020,11/13/2020,111320,82L-IMPORT PAYROLL-DONNELLY MARCUS,D108,HJ,69.38,,197029.7
6150,11/13/2020,11/13/2020,111320,82L-IMPORT PAYROLL-FEIGHERY JOHN,D108,HJ,30.56,,197060.26
6150,11/13/2020,11/13/2020,111320,82L-IMPORT PAYROLL-FEIGHERY JOHN,D108,HJ,130.69,,197190.95
6150,11/13/2020,11/13/2020,111320,82L-IMPORT PAYROLL-FORTH KYLE,D108,HJ,16.23,,197207.18
6150,11/13/2020,11/13/2020,111320,82L-IMPORT PAYROLL-FORTH KYLE,D108,HJ,69.38,,197276.56
6150,11/13/2020,11/13/2020,111320,82L-IMPORT PAYROLL-GARCIA MARILYN,D108,HJ,33.23,,197309.79
6150,11/13/2020,11/13/2020,111320,82L-IMPORT PAYROLL-GARCIA MARILYN,D108,HJ,142.08,,197451.87
6150,11/13/2020,11/13/2020,111320,82L-IMPORT PAYROLL-GREENE BROOKE,D108,HJ,15.28,,197467.15
6150,11/13/2020,11/13/2020,111320,82L-IMPORT PAYROLL-GREENE BROOKE,D108,HJ,65.35,,197532.5
6150,11/13/2020,11/13/2020,111320,82L-IMPORT PAYROLL-GRIFFIN ANDREW,D108,HJ,30.44,,197562.94
6150,11/13/2020,11/13/2020,111320,82L-IMPORT PAYROLL-GRIFFIN ANDREW,D108,HJ,130.16,,197693.1
6150,11/13/2020,11/13/2020,111320,82L-IMPORT PAYROLL-GROSS EMILY,D108,HJ,14,,197707.1
6150,11/13/2020,11/13/2020,111320,82L-IMPORT PAYROLL-GROSS EMILY,D108,HJ,59.86,,197766.96
6150,11/13/2020,11/13/2020,111320,82L-IMPORT PAYROLL-GUERRERO LUIS,D108,HJ,16.23,,197783.19
6150,11/13/2020,11/13/2020,111320,82L-IMPORT PAYROLL-GUERRERO LUIS,D108,HJ,69.38,,197852.57
6150,11/13/2020,11/13/2020,111320,82L-IMPORT PAYROLL-HALLINAN GABRIEL,D108,HJ,34.79,,197887.36
6150,11/13/2020,11/13/2020,111320,82L-IMPORT PAYROLL-HALLINAN GABRIEL,D108,HJ,148.76,,198036.12
6150,11/13/2020,11/13/2020,111320,82L-IMPORT PAYROLL-HAMERSLY WILLIAM,D108,HJ,34.16,,198070.28
6150,11/13/2020,11/13/2020,111320,82L-IMPORT PAYROLL-HAMERSLY WILLIAM,D108,HJ,146.08,,198216.36
6150,11/13/2020,11/13/2020,111320,82L-IMPORT PAYROLL-HOLDER LATIVA M,D108,HJ,55.28,,198271.64
6150,11/13/2020,11/13/2020,111320,82L-IMPORT PAYROLL-HOLDER LATIVA M,D108,HJ,236.38,,198508.02
6150,11/13/2020,11/13/2020,111320,82L-IMPORT PAYROLL-HOSSAIN MYESHA,D108,HJ,35.1,,198543.12
6150,11/13/2020,11/13/2020,111320,82L-IMPORT PAYROLL-HOSSAIN MYESHA,D108,HJ,150.1,,198693.22
6150,11/13/2020,11/13/2020,111320,82L-IMPORT PAYROLL-JACKSON TASNIM F,D108,HJ,31,,198724.22
6150,11/13/2020,11/13/2020,111320,82L-IMPORT PAYROLL-JACKSON TASNIM F,D108,HJ,132.56,,198856.78
6150,11/13/2020,11/13/2020,111320,82L-IMPORT PAYROLL-KERKHOFF HARPER FAITH,D108,HJ,16.23,,198873.01
6150,11/13/2020,11/13/2020,111320,82L-IMPORT PAYROLL-KERKHOFF HARPER FAITH,D108,HJ,69.38,,198942.39
6150,11/13/2020,11/13/2020,111320,82L-IMPORT PAYROLL-LEARY AUBREY,D108,HJ,16.2,,198958.59
6150,11/13/2020,11/13/2020,111320,82L-IMPORT PAYROLL-LEARY AUBREY,D108,HJ,69.27,,199027.86
6150,11/13/2020,11/13/2020,111320,82L-IMPORT PAYROLL-LI BELLA,D108,HJ,33.96,,199061.82
6150,11/13/2020,11/13/2020,111320,82L-IMPORT PAYROLL-LI BELLA,D108,HJ,145.23,,199207.05
6150,11/13/2020,11/13/2020,111320,82L-IMPORT PAYROLL-LOUIE JORDAN,D108,HJ,16.23,,199223.28
6150,11/13/2020,11/13/2020,111320,82L-IMPORT PAYROLL-LOUIE JORDAN,D108,HJ,69.38,,199292.66
6150,11/13/2020,11/13/2020,111320,82L-IMPORT PAYROLL-MELCHOR OSBEIDY,D108,HJ,16.23,,199308.89
6150,11/13/2020,11/13/2020,111320,82L-IMPORT PAYROLL-MELCHOR OSBEIDY,D108,HJ,69.38,,199378.27
6150,11/13/2020,11/13/2020,111320,82L-IMPORT PAYROLL-MORRIS ZAKIYA,D108,HJ,16.23,,199394.5
6150,11/13/2020,11/13/2020,111320,82L-IMPORT PAYROLL-MORRIS ZAKIYA,D108,HJ,69.38,,199463.88
6150,11/13/2020,11/13/2020,111320,82L-IMPORT PAYROLL-MORSELETTO RAFAEL,D108,HJ,16.23,,199480.11
6150,11/13/2020,11/13/2020,111320,82L-IMPORT PAYROLL-MORSELETTO RAFAEL,D108,HJ,69.38,,199549.49
6150,11/13/2020,11/13/2020,111320,82L-IMPORT PAYROLL-OBI TOBECHUKWU,D108,HJ,16.23,,199565.72
6150,11/13/2020,11/13/2020,111320,82L-IMPORT PAYROLL-OBI TOBECHUKWU,D108,HJ,69.38,,199635.1
6150,11/13/2020,11/13/2020,111320,82L-IMPORT PAYROLL-OPUH NDIDI,D108,HJ,34.74,,199669.84
6150,11/13/2020,11/13/2020,111320,82L-IMPORT PAYROLL-OPUH NDIDI,D108,HJ,148.53,,199818.37
6150,11/13/2020,11/13/2020,111320,82L-IMPORT PAYROLL-PAULINO THAIRI,D108,HJ,16.23,,199834.6
6150,11/13/2020,11/13/2020,111320,82L-IMPORT PAYROLL-PAULINO THAIRI,D108,HJ,69.38,,199903.98
6150,11/13/2020,11/13/2020,111320,82L-IMPORT PAYROLL-ROSENBAUM MURRAY,D108,HJ,16.23,,199920.21
6150,11/13/2020,11/13/2020,111320,82L-IMPORT PAYROLL-ROSENBAUM MURRAY,D108,HJ,69.38,,199989.59
6150,11/13/2020,11/13/2020,111320,82L-IMPORT PAYROLL-SCHWETTMANN CLAIRE,D108,HJ,15.28,,200004.87
6150,11/13/2020,11/13/2020,111320,82L-IMPORT PAYROLL-SCHWETTMANN CLAIRE,D108,HJ,65.35,,200070.22
6150,11/13/2020,11/13/2020,111320,82L-IMPORT PAYROLL-SOBELMAN JUSTIN,D108,HJ,15.08,,200085.3
6150,11/13/2020,11/13/2020,111320,82L-IMPORT PAYROLL-SOBELMAN JUSTIN,D108,HJ,64.5,,200149.8
6150,11/13/2020,11/13/2020,111320,82L-IMPORT PAYROLL-TERRENCE-SMITH ZIHIR,D108,HJ,14.32,,200164.12
6150,11/13/2020,11/13/2020,111320,82L-IMPORT PAYROLL-TERRENCE-SMITH ZIHIR,D108,HJ,61.22,,200225.34
6150,11/13/2020,11/13/2020,111320,82L-IMPORT PAYROLL-TILLERY ASIA,D108,HJ,47.73,,200273.07
6150,11/13/2020,11/13/2020,111320,82L-IMPORT PAYROLL-TILLERY ASIA,D108,HJ,204.08,,200477.15
6150,11/13/2020,11/13/2020,111320,82L-IMPORT PAYROLL-WILLIAMS-MASSEY BRIANNA,D108,HJ,16.05,,200493.2
6150,11/13/2020,11/13/2020,111320,82L-IMPORT PAYROLL-WILLIAMS-MASSEY BRIANNA,D108,HJ,68.64,,200561.84
6150,11/13/2020,11/13/2020,111320,82L-IMPORT PAYROLL-XIAO CHENGYAO,D108,HJ,16.23,,200578.07
6150,11/13/2020,11/13/2020,111320,82L-IMPORT PAYROLL-XIAO CHENGYAO,D108,HJ,69.38,,200647.45
6150,11/13/2020,11/13/2020,111320,82L-IMPORT PAYROLL-ZIAUDDIN ABUTAHER,D108,HJ,16.23,,200663.68
6150,11/13/2020,11/13/2020,111320,82L-IMPORT PAYROLL-ZIAUDDIN ABUTAHER,D108,HJ,69.38,,200733.06
6150,11/13/2020,11/13/2020,111320,82L-IMPORT PAYROLL-BALASUBRAMANIAN SHARANYA,D108,HJ,16.53,,200749.59
6150,11/13/2020,11/13/2020,111320,82L-IMPORT PAYROLL-BALASUBRAMANIAN SHARANYA,D108,HJ,38.67,,200788.26
6150,11/13/2020,11/13/2020,111320,82L-IMPORT PAYROLL-BALASUBRAMANIAN SHARANYA,D108,HJ,165.33,,200953.59
6150,11/13/2020,11/13/2020,111320,82L-IMPORT PAYROLL-COVENEY ALLISON,D108,HJ,38.07,,200991.66
6150,11/13/2020,11/13/2020,111320,82L-IMPORT PAYROLL-COVENEY ALLISON,D108,HJ,162.79,,201154.45
6150,11/13/2020,11/13/2020,111320,82L-IMPORT PAYROLL-JACKSON CLAICE M,D108,HJ,19.38,,201173.83
6150,11/13/2020,11/13/2020,111320,82L-IMPORT PAYROLL-JACKSON CLAICE M,D108,HJ,42.91,,201216.74
6150,11/13/2020,11/13/2020,111320,82L-IMPORT PAYROLL-JACKSON CLAICE M,D108,HJ,183.48,,201400.22
6150,11/13/2020,11/13/2020,111320,82L-IMPORT PAYROLL-JANG DANIEL,D108,HJ,37.75,,201437.97
6150,11/13/2020,11/13/2020,111320,82L-IMPORT PAYROLL-JANG DANIEL,D108,HJ,161.4,,201599.37
6150,11/13/2020,11/13/2020,111320,82L-IMPORT PAYROLL-LENEGHAN MARYELLEN,D108,HJ,33.42,,201632.79
6150,11/13/2020,11/13/2020,111320,82L-IMPORT PAYROLL-LENEGHAN MARYELLEN,D108,HJ,142.89,,201775.68
6150,11/30/2020,11/30/2020,113020,82L-IMPORT PAYROLL-BARTHELEMY RACHALIE,D108,HJ,6.42,,201782.1
6150,11/30/2020,11/30/2020,113020,82L-IMPORT PAYROLL-BARTHELEMY RACHALIE,D108,HJ,14.01,,201796.11
6150,11/30/2020,11/30/2020,113020,82L-IMPORT PAYROLL-BARTHELEMY RACHALIE,D108,HJ,59.89,,201856
6150,11/30/2020,11/30/2020,113020,82L-IMPORT PAYROLL-BASHAM WILLIAM EDWARD,D108,HJ,14.06,,201870.06
6150,11/30/2020,11/30/2020,113020,82L-IMPORT PAYROLL-BASHAM WILLIAM EDWARD,D108,HJ,60.11,,201930.17
6150,11/30/2020,11/30/2020,113020,82L-IMPORT PAYROLL-BOHLSEN GRACE ISABELLE,D108,HJ,15.16,,201945.33
6150,11/30/2020,11/30/2020,113020,82L-IMPORT PAYROLL-BOHLSEN GRACE ISABELLE,D108,HJ,64.84,,202010.17
6150,11/30/2020,11/30/2020,113020,82L-IMPORT PAYROLL-BOLIVAR ANDREA,D108,HJ,36.25,,202046.42
6150,11/30/2020,11/30/2020,113020,82L-IMPORT PAYROLL-BOLIVAR ANDREA,D108,HJ,155,,202201.42
6150,11/30/2020,11/30/2020,113020,82L-IMPORT PAYROLL-BORCHART SPENCER,D108,HJ,15.19,,202216.61
6150,11/30/2020,11/30/2020,113020,82L-IMPORT PAYROLL-BORCHART SPENCER,D108,HJ,44.27,,202260.88
6150,11/30/2020,11/30/2020,113020,82L-IMPORT PAYROLL-BORCHART SPENCER,D108,HJ,64.95,,202325.83
6150,11/30/2020,11/30/2020,113020,82L-IMPORT PAYROLL-BROWN ISAAC,D108,HJ,14.01,,202339.84
6150,11/30/2020,11/30/2020,113020,82L-IMPORT PAYROLL-BROWN ISAAC,D108,HJ,20.14,,202359.98
6150,11/30/2020,11/30/2020,113020,82L-IMPORT PAYROLL-BROWN ISAAC,D108,HJ,59.89,,202419.87
6150,11/30/2020,11/30/2020,113020,82L-IMPORT PAYROLL-BURKE MARIAH,D108,HJ,15.19,,202435.06
6150,11/30/2020,11/30/2020,113020,82L-IMPORT PAYROLL-BURKE MARIAH,D108,HJ,64.95,,202500.01
6150,11/30/2020,11/30/2020,113020,82L-IMPORT PAYROLL-CASSADY JOSHUA LEWIS,D108,HJ,15.19,,202515.2
6150,11/30/2020,11/30/2020,113020,82L-IMPORT PAYROLL-CASSADY JOSHUA LEWIS,D108,HJ,28.29,,202543.49
6150,11/30/2020,11/30/2020,113020,82L-IMPORT PAYROLL-CASSADY JOSHUA LEWIS,D108,HJ,64.95,,202608.44
6150,11/30/2020,11/30/2020,113020,82L-IMPORT PAYROLL-DARKO OLIVIA,D108,HJ,15.19,,202623.63
6150,11/30/2020,11/30/2020,113020,82L-IMPORT PAYROLL-DARKO OLIVIA,D108,HJ,64.95,,202688.58
6150,11/30/2020,11/30/2020,113020,82L-IMPORT PAYROLL-DAWSON JAMIL NAFAYE-BEYAH,D108,HJ,15.19,,202703.77
6150,11/30/2020,11/30/2020,113020,82L-IMPORT PAYROLL-DAWSON JAMIL NAFAYE-BEYAH,D108,HJ,64.95,,202768.72
6150,11/30/2020,11/30/2020,113020,82L-IMPORT PAYROLL-ESCAMILLA OLGA,D108,HJ,15.19,,202783.91
6150,11/30/2020,11/30/2020,113020,82L-IMPORT PAYROLL-ESCAMILLA OLGA,D108,HJ,64.95,,202848.86
6150,11/30/2020,11/30/2020,113020,82L-IMPORT PAYROLL-GARCIA SANTIAGO,D108,HJ,29.6,,202878.46
6150,11/30/2020,11/30/2020,113020,82L-IMPORT PAYROLL-GARCIA SANTIAGO,D108,HJ,126.58,,203005.04
6150,11/30/2020,11/30/2020,113020,82L-IMPORT PAYROLL-GILES SHAYLA,D108,HJ,15.19,,203020.23
6150,11/30/2020,11/30/2020,113020,82L-IMPORT PAYROLL-GILES SHAYLA,D108,HJ,64.95,,203085.18
6150,11/30/2020,11/30/2020,113020,82L-IMPORT PAYROLL-IKUNIKA FUNMILAYO,D108,HJ,30.21,,203115.39
6150,11/30/2020,11/30/2020,113020,82L-IMPORT PAYROLL-IKUNIKA FUNMILAYO,D108,HJ,129.17,,203244.56
6150,11/30/2020,11/30/2020,113020,82L-IMPORT PAYROLL-JONES JORDAN,D108,HJ,15.19,,203259.75
6150,11/30/2020,11/30/2020,113020,82L-IMPORT PAYROLL-JONES JORDAN,D108,HJ,64.95,,203324.7
6150,11/30/2020,11/30/2020,113020,82L-IMPORT PAYROLL-KHAN HUDA,D108,HJ,1.53,,203326.23
6150,11/30/2020,11/30/2020,113020,82L-IMPORT PAYROLL-KHAN HUDA,D108,HJ,14.25,,203340.48
6150,11/30/2020,11/30/2020,113020,82L-IMPORT PAYROLL-KHAN HUDA,D108,HJ,60.92,,203401.4
6150,11/30/2020,11/30/2020,113020,82L-IMPORT PAYROLL-KLOHR TIMOTHY JORDAN,D108,HJ,29,,203430.4
6150,11/30/2020,11/30/2020,113020,82L-IMPORT PAYROLL-KLOHR TIMOTHY JORDAN,D108,HJ,124,,203554.4
6150,11/30/2020,11/30/2020,113020,82L-IMPORT PAYROLL-KNOWLIN ZYLIA,D108,HJ,34.63,,203589.03
6150,11/30/2020,11/30/2020,113020,82L-IMPORT PAYROLL-KNOWLIN ZYLIA,D108,HJ,148.06,,203737.09
6150,11/30/2020,11/30/2020,113020,82L-IMPORT PAYROLL-KOPSHEVER MELISSA,D108,HJ,38.29,,203775.38
6150,11/30/2020,11/30/2020,113020,82L-IMPORT PAYROLL-KOPSHEVER MELISSA,D108,HJ,163.74,,203939.12
6150,11/30/2020,11/30/2020,113020,82L-IMPORT PAYROLL-LI SEN YUAN,D108,HJ,5.88,,203945
6150,11/30/2020,11/30/2020,113020,82L-IMPORT PAYROLL-LI SEN YUAN,D108,HJ,14.05,,203959.05
6150,11/30/2020,11/30/2020,113020,82L-IMPORT PAYROLL-LI SEN YUAN,D108,HJ,60.07,,204019.12
6150,11/30/2020,11/30/2020,113020,82L-IMPORT PAYROLL-LIPSCOMB STEPHEN,D108,HJ,33.58,,204052.7
6150,11/30/2020,11/30/2020,113020,82L-IMPORT PAYROLL-LIPSCOMB STEPHEN,D108,HJ,143.59,,204196.29
6150,11/30/2020,11/30/2020,113020,82L-IMPORT PAYROLL-MALLECK JESSICA R,D108,HJ,15.19,,204211.48
6150,11/30/2020,11/30/2020,113020,82L-IMPORT PAYROLL-MALLECK JESSICA R,D108,HJ,64.95,,204276.43
6150,11/30/2020,11/30/2020,113020,82L-IMPORT PAYROLL-MCLAUGHLIN MARA,D108,HJ,15.19,,204291.62
6150,11/30/2020,11/30/2020,113020,82L-IMPORT PAYROLL-MCLAUGHLIN MARA,D108,HJ,64.95,,204356.57
6150,11/30/2020,11/30/2020,113020,82L-IMPORT PAYROLL-MEJIA ROSO CARLOS,D108,HJ,6.42,,204362.99
6150,11/30/2020,11/30/2020,113020,82L-IMPORT PAYROLL-MEJIA ROSO CARLOS,D108,HJ,14.01,,204377
6150,11/30/2020,11/30/2020,113020,82L-IMPORT PAYROLL-MEJIA ROSO CARLOS,D108,HJ,59.89,,204436.89
6150,11/30/2020,11/30/2020,113020,82L-IMPORT PAYROLL-MONROY-MEJIA JASON,D108,HJ,15.19,,204452.08
6150,11/30/2020,11/30/2020,113020,82L-IMPORT PAYROLL-MONROY-MEJIA JASON,D108,HJ,64.95,,204517.03
6150,11/30/2020,11/30/2020,113020,82L-IMPORT PAYROLL-O'FLYNN-PRUITT NATHAN COLYAR,D108,HJ,15.19,,204532.22
6150,11/30/2020,11/30/2020,113020,82L-IMPORT PAYROLL-O'FLYNN-PRUITT NATHAN COLYAR,D108,HJ,64.95,,204597.17
6150,11/30/2020,11/30/2020,113020,82L-IMPORT PAYROLL-PATTERSON STEVE,D108,HJ,15.19,,204612.36
6150,11/30/2020,11/30/2020,113020,82L-IMPORT PAYROLL-PATTERSON STEVE,D108,HJ,64.95,,204677.31
6150,11/30/2020,11/30/2020,113020,82L-IMPORT PAYROLL-SCHMIESS RACHEL JOY,D108,HJ,15.19,,204692.5
6150,11/30/2020,11/30/2020,113020,82L-IMPORT PAYROLL-SCHMIESS RACHEL JOY,D108,HJ,64.95,,204757.45
6150,11/30/2020,11/30/2020,113020,82L-IMPORT PAYROLL-SCOTT KIRK DONOVAN,D108,HJ,5.88,,204763.33
6150,11/30/2020,11/30/2020,113020,82L-IMPORT PAYROLL-SCOTT KIRK DONOVAN,D108,HJ,14.05,,204777.38
6150,11/30/2020,11/30/2020,113020,82L-IMPORT PAYROLL-SCOTT KIRK DONOVAN,D108,HJ,60.07,,204837.45
6150,11/30/2020,11/30/2020,113020,82L-IMPORT PAYROLL-SILVER KELLY,D108,HJ,34.63,,204872.08
6150,11/30/2020,11/30/2020,113020,82L-IMPORT PAYROLL-SILVER KELLY,D108,HJ,148.06,,205020.14
6150,11/30/2020,11/30/2020,113020,82L-IMPORT PAYROLL-SOLIMAN MARK,D108,HJ,15.19,,205035.33
6150,11/30/2020,11/30/2020,113020,82L-IMPORT PAYROLL-SOLIMAN MARK,D108,HJ,64.95,,205100.28
6150,11/30/2020,11/30/2020,113020,82L-IMPORT PAYROLL-STEIN KYLE,D108,HJ,27.84,,205128.12
6150,11/30/2020,11/30/2020,113020,82L-IMPORT PAYROLL-STEIN KYLE,D108,HJ,119.05,,205247.17
6150,11/30/2020,11/30/2020,113020,82L-IMPORT PAYROLL-STROUD DAVID,D108,HJ,14.66,,205261.83
6150,11/30/2020,11/30/2020,113020,82L-IMPORT PAYROLL-STROUD DAVID,D108,HJ,62.68,,205324.51
6150,11/30/2020,11/30/2020,113020,82L-IMPORT PAYROLL-VALCIN SABRINA JEMIMAH,D108,HJ,3.28,,205327.79
6150,11/30/2020,11/30/2020,113020,82L-IMPORT PAYROLL-VALCIN SABRINA JEMIMAH,D108,HJ,14.25,,205342.04
6150,11/30/2020,11/30/2020,113020,82L-IMPORT PAYROLL-VALCIN SABRINA JEMIMAH,D108,HJ,60.92,,205402.96
6150,11/30/2020,11/30/2020,113020,82L-IMPORT PAYROLL-VALDES ERNEST L,D108,HJ,15.19,,205418.15
6150,11/30/2020,11/30/2020,113020,82L-IMPORT PAYROLL-VALDES ERNEST L,D108,HJ,64.95,,205483.1
6150,11/30/2020,11/30/2020,113020,82L-IMPORT PAYROLL-WILLIAMS MACK ANTHONY,D108,HJ,15.02,,205498.12
6150,11/30/2020,11/30/2020,113020,82L-IMPORT PAYROLL-WILLIAMS MACK ANTHONY,D108,HJ,64.21,,205562.33
6150,11/30/2020,11/30/2020,113020,82L-IMPORT PAYROLL-WILLIAMS MIL'YONTA,D108,HJ,15.19,,205577.52
6150,11/30/2020,11/30/2020,113020,82L-IMPORT PAYROLL-WILLIAMS MIL'YONTA,D108,HJ,64.95,,205642.47
6150,11/30/2020,11/30/2020,113020,82L-IMPORT PAYROLL-ANTHONY BETTY S,D108,HJ,41.85,,205684.32
6150,11/30/2020,11/30/2020,113020,82L-IMPORT PAYROLL-ANTHONY BETTY S,D108,HJ,178.96,,205863.28
6150,11/30/2020,11/30/2020,113020,82L-IMPORT PAYROLL-APULI LINDSAY,D108,HJ,34.16,,205897.44
6150,11/30/2020,11/30/2020,113020,82L-IMPORT PAYROLL-APULI LINDSAY,D108,HJ,146.08,,206043.52
6150,11/30/2020,11/30/2020,113020,82L-IMPORT PAYROLL-AUSTIN PERCY ANTONIO,D108,HJ,36.34,,206079.86
6150,11/30/2020,11/30/2020,113020,82L-IMPORT PAYROLL-AUSTIN PERCY ANTONIO,D108,HJ,155.39,,206235.25
6150,11/30/2020,11/30/2020,113020,82L-IMPORT PAYROLL-BUHMANN JENNIFER,D108,HJ,32.9,,206268.15
6150,11/30/2020,11/30/2020,113020,82L-IMPORT PAYROLL-BUHMANN JENNIFER,D108,HJ,140.68,,206408.83
6150,11/30/2020,11/30/2020,113020,82L-IMPORT PAYROLL-CAIN CORY,D108,HJ,36.32,,206445.15
6150,11/30/2020,11/30/2020,113020,82L-IMPORT PAYROLL-CAIN CORY,D108,HJ,155.3,,206600.45
6150,11/30/2020,11/30/2020,113020,82L-IMPORT PAYROLL-CHAPMAN CLAUDY EARL,D108,HJ,26.38,,206626.83
6150,11/30/2020,11/30/2020,113020,82L-IMPORT PAYROLL-CHAPMAN CLAUDY EARL,D108,HJ,112.81,,206739.64
6150,11/30/2020,11/30/2020,113020,82L-IMPORT PAYROLL-DADA ARIKPO E,D108,HJ,32.04,,206771.68
6150,11/30/2020,11/30/2020,113020,82L-IMPORT PAYROLL-DADA ARIKPO E,D108,HJ,137,,206908.68
6150,11/30/2020,11/30/2020,113020,82L-IMPORT PAYROLL-GUTHRIE LESLIE,D108,HJ,33.42,,206942.1
6150,11/30/2020,11/30/2020,113020,82L-IMPORT PAYROLL-GUTHRIE LESLIE,D108,HJ,142.9,,207085
6150,11/30/2020,11/30/2020,113020,82L-IMPORT PAYROLL-HOLMES JOREL ALEXANDER,D108,HJ,31.22,,207116.22
6150,11/30/2020,11/30/2020,113020,82L-IMPORT PAYROLL-HOLMES JOREL ALEXANDER,D108,HJ,133.51,,207249.73
6150,11/30/2020,11/30/2020,113020,82L-IMPORT PAYROLL-JORDAN TIFFANY T,D108,HJ,45.87,,207295.6
6150,11/30/2020,11/30/2020,113020,82L-IMPORT PAYROLL-JORDAN TIFFANY T,D108,HJ,196.13,,207491.73
6150,11/30/2020,11/30/2020,113020,82L-IMPORT PAYROLL-LANIGAN LISA A,D108,HJ,45.1,,207536.83
6150,11/30/2020,11/30/2020,113020,82L-IMPORT PAYROLL-LANIGAN LISA A,D108,HJ,192.83,,207729.66
6150,11/30/2020,11/30/2020,113020,82L-IMPORT PAYROLL-MCELWEE MELISSA,D108,HJ,38.67,,207768.33
6150,11/30/2020,11/30/2020,113020,82L-IMPORT PAYROLL-MCELWEE MELISSA,D108,HJ,165.33,,207933.66
6150,11/30/2020,11/30/2020,113020,82L-IMPORT PAYROLL-MCNICHOLAS MARY,D108,HJ,33.23,,207966.89
6150,11/30/2020,11/30/2020,113020,82L-IMPORT PAYROLL-MCNICHOLAS MARY,D108,HJ,142.08,,208108.97
6150,11/30/2020,11/30/2020,113020,82L-IMPORT PAYROLL-NWAKANMA NANCY,D108,HJ,44.18,,208153.15
6150,11/30/2020,11/30/2020,113020,82L-IMPORT PAYROLL-NWAKANMA NANCY,D108,HJ,188.89,,208342.04
6150,11/30/2020,11/30/2020,113020,82L-IMPORT PAYROLL-ONICA ANTHONY J,D108,HJ,32.86,,208374.9
6150,11/30/2020,11/30/2020,113020,82L-IMPORT PAYROLL-ONICA ANTHONY J,D108,HJ,140.49,,208515.39
6150,11/30/2020,11/30/2020,113020,82L-IMPORT PAYROLL-PRAHIN NICOLE M,D108,HJ,9.52,,208524.91
6150,11/30/2020,11/30/2020,113020,82L-IMPORT PAYROLL-PRAHIN NICOLE M,D108,HJ,40.72,,208565.63
6150,11/30/2020,11/30/2020,113020,82L-IMPORT PAYROLL-PRAHIN NICOLE M,D108,HJ,43.39,,208609.02
6150,11/30/2020,11/30/2020,113020,82L-IMPORT PAYROLL-PRAHIN NICOLE M,D108,HJ,185.5,,208794.52
6150,11/30/2020,11/30/2020,113020,82L-IMPORT PAYROLL-RIVERS QUIONNA DIANE,D108,HJ,39.27,,208833.79
6150,11/30/2020,11/30/2020,113020,82L-IMPORT PAYROLL-RIVERS QUIONNA DIANE,D108,HJ,167.92,,209001.71
6150,11/30/2020,11/30/2020,113020,82L-IMPORT PAYROLL-SALIM YASSER,D108,HJ,33.1,,209034.81
6150,11/30/2020,11/30/2020,113020,82L-IMPORT PAYROLL-SALIM YASSER,D108,HJ,141.55,,209176.36
6150,11/30/2020,11/30/2020,113020,82L-IMPORT PAYROLL-SEJOUR MAHALIAH,D108,HJ,34.07,,209210.43
6150,11/30/2020,11/30/2020,113020,82L-IMPORT PAYROLL-SEJOUR MAHALIAH,D108,HJ,145.66,,209356.09
6150,11/30/2020,11/30/2020,113020,82L-IMPORT PAYROLL-SKALSKI CHRISTOPHER,D108,HJ,33.86,,209389.95
6150,11/30/2020,11/30/2020,113020,82L-IMPORT PAYROLL-SKALSKI CHRISTOPHER,D108,HJ,144.76,,209534.71
6150,11/30/2020,11/30/2020,113020,82L-IMPORT PAYROLL-TUMENJARGAL ENKHJIN,D108,HJ,32.92,,209567.63
6150,11/30/2020,11/30/2020,113020,82L-IMPORT PAYROLL-TUMENJARGAL ENKHJIN,D108,HJ,140.75,,209708.38
6150,11/30/2020,11/30/2020,113020,82L-IMPORT PAYROLL-VILLEGAS EVELYN,D108,HJ,33.4,,209741.78
6150,11/30/2020,11/30/2020,113020,82L-IMPORT PAYROLL-VILLEGAS EVELYN,D108,HJ,142.81,,209884.59
6150,11/30/2020,11/30/2020,113020,82L-IMPORT PAYROLL-WOLF ANNA A,D108,HJ,36.3,,209920.89
6150,11/30/2020,11/30/2020,113020,82L-IMPORT PAYROLL-WOLF ANNA A,D108,HJ,155.19,,210076.08
6150,11/30/2020,11/30/2020,113020,82L-IMPORT PAYROLL-ACEVEDO MONIVETT,D107,HJ,13.04,,210089.12
6150,11/30/2020,11/30/2020,113020,82L-IMPORT PAYROLL-ACEVEDO MONIVETT,D107,HJ,55.74,,210144.86
6150,11/30/2020,11/30/2020,113020,82L-IMPORT PAYROLL-ACEVEDO MONIVETT,D107,HJ,59.38,,210204.24
6150,11/30/2020,11/30/2020,113020,82L-IMPORT PAYROLL-ACEVEDO MONIVETT,D107,HJ,253.9,,210458.14
6150,11/30/2020,11/30/2020,113020,82L-IMPORT PAYROLL-AKLESTAD ISABEL,D111,HJ,26.91,,210485.05
6150,11/30/2020,11/30/2020,113020,82L-IMPORT PAYROLL-AKLESTAD ISABEL,D111,HJ,115.08,,210600.13
6150,11/30/2020,11/30/2020,113020,82L-IMPORT PAYROLL-BIBB TIFFANI,D104,HJ,49.71,,210649.84
6150,11/30/2020,11/30/2020,113020,82L-IMPORT PAYROLL-BIBB TIFFANI,D104,HJ,212.55,,210862.39
6150,11/30/2020,11/30/2020,113020,82L-IMPORT PAYROLL-BOWMAN HALLEY K,D101,HJ,46.44,,210908.83
6150,11/30/2020,11/30/2020,113020,82L-IMPORT PAYROLL-BOWMAN HALLEY K,D101,HJ,198.56,,211107.39
6150,11/30/2020,11/30/2020,113020,82L-IMPORT PAYROLL-COOK CATHRYN ANNA,D105,HJ,8.98,,211116.37
6150,11/30/2020,11/30/2020,113020,82L-IMPORT PAYROLL-COOK CATHRYN ANNA,D105,HJ,38.38,,211154.75
6150,11/30/2020,11/30/2020,113020,82L-IMPORT PAYROLL-COOK CATHRYN ANNA,D105,HJ,40.89,,211195.64
6150,11/30/2020,11/30/2020,113020,82L-IMPORT PAYROLL-COOK CATHRYN ANNA,D105,HJ,174.87,,211370.51
6150,11/30/2020,11/30/2020,113020,82L-IMPORT PAYROLL-COOPER ASHLEE R,D101,HJ,33.51,,211404.02
6150,11/30/2020,11/30/2020,113020,82L-IMPORT PAYROLL-COOPER ASHLEE R,D101,HJ,143.3,,211547.32
6150,11/30/2020,11/30/2020,113020,82L-IMPORT PAYROLL-CORTEZ MIRANDA A,D111,HJ,42.08,,211589.4
6150,11/30/2020,11/30/2020,113020,82L-IMPORT PAYROLL-CORTEZ MIRANDA A,D111,HJ,179.92,,211769.32
6150,11/30/2020,11/30/2020,113020,82L-IMPORT PAYROLL-DAUGHERTY DEVIN W,D101,HJ,15.1,,211784.42
6150,11/30/2020,11/30/2020,113020,82L-IMPORT PAYROLL-DAUGHERTY DEVIN W,D101,HJ,64.58,,211849
6150,11/30/2020,11/30/2020,113020,82L-IMPORT PAYROLL-DETONE KYRA MAYA,D102,HJ,3.51,,211852.51
6150,11/30/2020,11/30/2020,113020,82L-IMPORT PAYROLL-DETONE KYRA MAYA,D102,HJ,15.01,,211867.52
6150,11/30/2020,11/30/2020,113020,82L-IMPORT PAYROLL-DETONE KYRA MAYA,D102,HJ,35.49,,211903.01
6150,11/30/2020,11/30/2020,113020,82L-IMPORT PAYROLL-DETONE KYRA MAYA,D102,HJ,151.74,,212054.75
6150,11/30/2020,11/30/2020,113020,82L-IMPORT PAYROLL-DUPUIS CHRISTOPHER M,D107,HJ,31.95,,212086.7
6150,11/30/2020,11/30/2020,113020,82L-IMPORT PAYROLL-DUPUIS CHRISTOPHER M,D107,HJ,56.79,,212143.49
6150,11/30/2020,11/30/2020,113020,82L-IMPORT PAYROLL-DUPUIS CHRISTOPHER M,D107,HJ,136.6,,212280.09
6150,11/30/2020,11/30/2020,113020,82L-IMPORT PAYROLL-DUPUIS CHRISTOPHER M,D107,HJ,242.85,,212522.94
6150,11/30/2020,11/30/2020,113020,82L-IMPORT PAYROLL-DZIEDZIC JULIE K,D101,HJ,17.71,,212540.65
6150,11/30/2020,11/30/2020,113020,82L-IMPORT PAYROLL-DZIEDZIC JULIE K,D101,HJ,75.71,,212616.36
6150,11/30/2020,11/30/2020,113020,82L-IMPORT PAYROLL-FISCHABER THOMAS,D109,HJ,77.9,,212694.26
6150,11/30/2020,11/30/2020,113020,82L-IMPORT PAYROLL-FISCHABER THOMAS,D109,HJ,333.1,,213027.36
6150,11/30/2020,11/30/2020,113020,82L-IMPORT PAYROLL-FLORY MEGAN,D109,HJ,21.75,,213049.11
6150,11/30/2020,11/30/2020,113020,82L-IMPORT PAYROLL-FLORY MEGAN,D109,HJ,93,,213142.11
6150,11/30/2020,11/30/2020,113020,82L-IMPORT PAYROLL-GORNSTEIN STEVEN,D101,HJ,39.27,,213181.38
6150,11/30/2020,11/30/2020,113020,82L-IMPORT PAYROLL-GORNSTEIN STEVEN,D101,HJ,167.92,,213349.3
6150,11/30/2020,11/30/2020,113020,82L-IMPORT PAYROLL-GUADARRAMA-ALVAREZ URIEL A,D105,HJ,39.93,,213389.23
6150,11/30/2020,11/30/2020,113020,82L-IMPORT PAYROLL-GUADARRAMA-ALVAREZ URIEL A,D105,HJ,170.75,,213559.98
6150,11/30/2020,11/30/2020,113020,82L-IMPORT PAYROLL-GUTIERREZ ANTONIO J,D107,HJ,13.36,,213573.34
6150,11/30/2020,11/30/2020,113020,82L-IMPORT PAYROLL-GUTIERREZ ANTONIO J,D107,HJ,57.15,,213630.49
6150,11/30/2020,11/30/2020,113020,82L-IMPORT PAYROLL-GUTIERREZ ANTONIO J,D107,HJ,60.89,,213691.38
6150,11/30/2020,11/30/2020,113020,82L-IMPORT PAYROLL-GUTIERREZ ANTONIO J,D107,HJ,260.33,,213951.71
6150,11/30/2020,11/30/2020,113020,82L-IMPORT PAYROLL-HENRY GILLIAN,D102,HJ,2.52,,213954.23
6150,11/30/2020,11/30/2020,113020,82L-IMPORT PAYROLL-HENRY GILLIAN,D102,HJ,11.23,,213965.46
6150,11/30/2020,11/30/2020,113020,82L-IMPORT PAYROLL-HENRY GILLIAN,D102,HJ,26.65,,213992.11
6150,11/30/2020,11/30/2020,113020,82L-IMPORT PAYROLL-HENRY GILLIAN,D102,HJ,113.51,,214105.62
6150,11/30/2020,11/30/2020,113020,82L-IMPORT PAYROLL-HERMAN ADAM,D102,HJ,28.2,,214133.82
6150,11/30/2020,11/30/2020,113020,82L-IMPORT PAYROLL-HERMAN ADAM,D102,HJ,120.56,,214254.38
6150,11/30/2020,11/30/2020,113020,82L-IMPORT PAYROLL-HESTER TYLER CONRAD,D105,HJ,27.79,,214282.17
6150,11/30/2020,11/30/2020,113020,82L-IMPORT PAYROLL-HESTER TYLER CONRAD,D105,HJ,118.83,,214401
6150,11/30/2020,11/30/2020,113020,82L-IMPORT PAYROLL-HOLT ADAM,D109,HJ,58.24,,214459.24
6150,11/30/2020,11/30/2020,113020,82L-IMPORT PAYROLL-HOLT ADAM,D109,HJ,249.03,,214708.27
6150,11/30/2020,11/30/2020,113020,82L-IMPORT PAYROLL-KELLY SEAN,D109,HJ,78.54,,214786.81
6150,11/30/2020,11/30/2020,113020,82L-IMPORT PAYROLL-KELLY SEAN,D109,HJ,335.83,,215122.64
6150,11/30/2020,11/30/2020,113020,82L-IMPORT PAYROLL-KRUGER MARK,D109,HJ,72.5,,215195.14
6150,11/30/2020,11/30/2020,113020,82L-IMPORT PAYROLL-KRUGER MARK,D109,HJ,310,,215505.14
6150,11/30/2020,11/30/2020,113020,82L-IMPORT PAYROLL-LIPORACE HERNAN LUIS,D103,HJ,33.06,,215538.2
6150,11/30/2020,11/30/2020,113020,82L-IMPORT PAYROLL-LIPORACE HERNAN LUIS,D103,HJ,141.34,,215679.54
6150,11/30/2020,11/30/2020,113020,82L-IMPORT PAYROLL-MARKS KRISTA,D109,HJ,76.2,,215755.74
6150,11/30/2020,11/30/2020,113020,82L-IMPORT PAYROLL-MARKS KRISTA,D109,HJ,325.8,,216081.54
6150,11/30/2020,11/30/2020,113020,82L-IMPORT PAYROLL-MELVIN DARNELL KEVIN,D109,HJ,55.91,,216137.45
6150,11/30/2020,11/30/2020,113020,82L-IMPORT PAYROLL-MELVIN DARNELL KEVIN,D109,HJ,239.08,,216376.53
6150,11/30/2020,11/30/2020,113020,82L-IMPORT PAYROLL-MESSING JENNIFER,D104,HJ,34.12,,216410.65
6150,11/30/2020,11/30/2020,113020,82L-IMPORT PAYROLL-MESSING JENNIFER,D104,HJ,63.54,,216474.19
6150,11/30/2020,11/30/2020,113020,82L-IMPORT PAYROLL-MESSING JENNIFER,D104,HJ,145.9,,216620.09
6150,11/30/2020,11/30/2020,113020,82L-IMPORT PAYROLL-MILNE ROGER,D109,HJ,4.57,,216624.66
6150,11/30/2020,11/30/2020,113020,82L-IMPORT PAYROLL-MILNE ROGER,D109,HJ,19.55,,216644.21
6150,11/30/2020,11/30/2020,113020,82L-IMPORT PAYROLL-MILNE ROGER,D109,HJ,71.63,,216715.84
6150,11/30/2020,11/30/2020,113020,82L-IMPORT PAYROLL-MILNE ROGER,D109,HJ,306.25,,217022.09
6150,11/30/2020,11/30/2020,113020,82L-IMPORT PAYROLL-MOSTAFAVI YASAMAN,D109,HJ,5.1,,217027.19
6150,11/30/2020,11/30/2020,113020,82L-IMPORT PAYROLL-MOSTAFAVI YASAMAN,D109,HJ,21.82,,217049.01
6150,11/30/2020,11/30/2020,113020,82L-IMPORT PAYROLL-O'DONNELL STEPHEN,D104,HJ,39.26,,217088.27
6150,11/30/2020,11/30/2020,113020,82L-IMPORT PAYROLL-O'DONNELL STEPHEN,D104,HJ,167.87,,217256.14
6150,11/30/2020,11/30/2020,113020,82L-IMPORT PAYROLL-PARETS MALLORY GRACE,D101,HJ,17.57,,217273.71
6150,11/30/2020,11/30/2020,113020,82L-IMPORT PAYROLL-PARETS MALLORY GRACE,D101,HJ,41.08,,217314.79
6150,11/30/2020,11/30/2020,113020,82L-IMPORT PAYROLL-PARETS MALLORY GRACE,D101,HJ,175.67,,217490.46
6150,11/30/2020,11/30/2020,113020,82L-IMPORT PAYROLL-PARHAM-GANTT DENISE M,D112,HJ,37.96,,217528.42
6150,11/30/2020,11/30/2020,113020,82L-IMPORT PAYROLL-PARHAM-GANTT DENISE M,D112,HJ,162.32,,217690.74
6150,11/30/2020,11/30/2020,113020,82L-IMPORT PAYROLL-PEINADO ELIZABETH R,D111,HJ,55.91,,217746.65
6150,11/30/2020,11/30/2020,113020,82L-IMPORT PAYROLL-PEINADO ELIZABETH R,D111,HJ,239.08,,217985.73
6150,11/30/2020,11/30/2020,113020,82L-IMPORT PAYROLL-PERNIA JEFFREY,D109,HJ,56.19,,218041.92
6150,11/30/2020,11/30/2020,113020,82L-IMPORT PAYROLL-PERNIA JEFFREY,D109,HJ,240.25,,218282.17
6150,11/30/2020,11/30/2020,113020,82L-IMPORT PAYROLL-POLANCO ODALIS,D103,HJ,43.23,,218325.4
6150,11/30/2020,11/30/2020,113020,82L-IMPORT PAYROLL-POLANCO ODALIS,D103,HJ,184.83,,218510.23
6150,11/30/2020,11/30/2020,113020,82L-IMPORT PAYROLL-QUINTAS JASHIVE,D105,HJ,25.57,,218535.8
6150,11/30/2020,11/30/2020,113020,82L-IMPORT PAYROLL-QUINTAS JASHIVE,D105,HJ,109.31,,218645.11
6150,11/30/2020,11/30/2020,113020,82L-IMPORT PAYROLL-RANDOLPH ALEXANDER,D111,HJ,13.18,,218658.29
6150,11/30/2020,11/30/2020,113020,82L-IMPORT PAYROLL-RANDOLPH ALEXANDER,D111,HJ,28.73,,218687.02
6150,11/30/2020,11/30/2020,113020,82L-IMPORT PAYROLL-RANDOLPH ALEXANDER,D111,HJ,122.83,,218809.85
6150,11/30/2020,11/30/2020,113020,82L-IMPORT PAYROLL-RUBI PERLA,D101,HJ,15.92,,218825.77
6150,11/30/2020,11/30/2020,113020,82L-IMPORT PAYROLL-RUBI PERLA,D101,HJ,68.09,,218893.86
6150,11/30/2020,11/30/2020,113020,82L-IMPORT PAYROLL-SAFRAN ALAN P,D107,HJ,18.05,,218911.91
6150,11/30/2020,11/30/2020,113020,82L-IMPORT PAYROLL-SAFRAN ALAN P,D107,HJ,82.2,,218994.11
6150,11/30/2020,11/30/2020,113020,82L-IMPORT PAYROLL-SHENKMAN OLIVIA,D101,HJ,29,,219023.11
6150,11/30/2020,11/30/2020,113020,82L-IMPORT PAYROLL-SHENKMAN OLIVIA,D101,HJ,124,,219147.11
6150,11/30/2020,11/30/2020,113020,82L-IMPORT PAYROLL-SHI GRACE,D103,HJ,12.69,,219159.8
6150,11/30/2020,11/30/2020,113020,82L-IMPORT PAYROLL-SHI GRACE,D103,HJ,54.25,,219214.05
6150,11/30/2020,11/30/2020,113020,82L-IMPORT PAYROLL-WALLACE AMENA,D104,HJ,28.93,,219242.98
6150,11/30/2020,11/30/2020,113020,82L-IMPORT PAYROLL-WALLACE AMENA,D104,HJ,123.72,,219366.7
6150,11/30/2020,11/30/2020,113020,82L-IMPORT PAYROLL-WARD JEFFREY,D109,HJ,78.54,,219445.24
6150,11/30/2020,11/30/2020,113020,82L-IMPORT PAYROLL-WARD JEFFREY,D109,HJ,335.83,,219781.07
6150,11/30/2020,11/30/2020,113020,82L-IMPORT PAYROLL-WARD JENNIFER,D109,HJ,18.86,,219799.93
6150,11/30/2020,11/30/2020,113020,82L-IMPORT PAYROLL-WARD JENNIFER,D109,HJ,80.64,,219880.57
6150,11/30/2020,11/30/2020,113020,82L-IMPORT PAYROLL-WEINSTOCK EMILY,D101,HJ,17.57,,219898.14
6150,11/30/2020,11/30/2020,113020,82L-IMPORT PAYROLL-WEINSTOCK EMILY,D101,HJ,38.11,,219936.25
6150,11/30/2020,11/30/2020,113020,82L-IMPORT PAYROLL-WEINSTOCK EMILY,D101,HJ,162.94,,220099.19
6150,11/30/2020,11/30/2020,113020,82L-IMPORT PAYROLL-WINANS JENNIFER,D111,HJ,39.96,,220139.15
6150,11/30/2020,11/30/2020,113020,82L-IMPORT PAYROLL-WINANS JENNIFER,D111,HJ,170.85,,220310
6150,11/30/2020,11/30/2020,113020,82L-IMPORT PAYROLL-ZARATE JOSEPH M,D105,HJ,31.18,,220341.18
6150,11/30/2020,11/30/2020,113020,82L-IMPORT PAYROLL-ZARATE JOSEPH M,D105,HJ,133.3,,220474.48
6150,11/30/2020,11/30/2020,113020,82L-IMPORT PAYROLL-AGUANNO JOSEPH,D108,HJ,16.23,,220490.71
6150,11/30/2020,11/30/2020,113020,82L-IMPORT PAYROLL-AGUANNO JOSEPH,D108,HJ,69.38,,220560.09
6150,11/30/2020,11/30/2020,113020,82L-IMPORT PAYROLL-AKESODE FEHINTOLA,D108,HJ,16.23,,220576.32
6150,11/30/2020,11/30/2020,113020,82L-IMPORT PAYROLL-AKESODE FEHINTOLA,D108,HJ,69.38,,220645.7
6150,11/30/2020,11/30/2020,113020,82L-IMPORT PAYROLL-BARTOLD DEANNA MARIE,D108,HJ,41.91,,220687.61
6150,11/30/2020,11/30/2020,113020,82L-IMPORT PAYROLL-BARTOLD DEANNA MARIE,D108,HJ,179.22,,220866.83
6150,11/30/2020,11/30/2020,113020,82L-IMPORT PAYROLL-BELLOT GENESIS,D108,HJ,32.36,,220899.19
6150,11/30/2020,11/30/2020,113020,82L-IMPORT PAYROLL-BELLOT GENESIS,D108,HJ,138.38,,221037.57
6150,11/30/2020,11/30/2020,113020,82L-IMPORT PAYROLL-BENNETT JAMES H,D108,HJ,16.23,,221053.8
6150,11/30/2020,11/30/2020,113020,82L-IMPORT PAYROLL-BENNETT JAMES H,D108,HJ,69.38,,221123.18
6150,11/30/2020,11/30/2020,113020,82L-IMPORT PAYROLL-BOWMAN ABIGAIL,D108,HJ,16.23,,221139.41
6150,11/30/2020,11/30/2020,113020,82L-IMPORT PAYROLL-BOWMAN ABIGAIL,D108,HJ,69.38,,221208.79
6150,11/30/2020,11/30/2020,113020,82L-IMPORT PAYROLL-BURRELL RUSSELL,D108,HJ,15.08,,221223.87
6150,11/30/2020,11/30/2020,113020,82L-IMPORT PAYROLL-BURRELL RUSSELL,D108,HJ,64.5,,221288.37
6150,11/30/2020,11/30/2020,113020,82L-IMPORT PAYROLL-CHUI KENT,D108,HJ,16.23,,221304.6
6150,11/30/2020,11/30/2020,113020,82L-IMPORT PAYROLL-CHUI KENT,D108,HJ,69.38,,221373.98
6150,11/30/2020,11/30/2020,113020,82L-IMPORT PAYROLL-CIRKER MIA,D108,HJ,32.63,,221406.61
6150,11/30/2020,11/30/2020,113020,82L-IMPORT PAYROLL-CIRKER MIA,D108,HJ,139.5,,221546.11
6150,11/30/2020,11/30/2020,113020,82L-IMPORT PAYROLL-DEWS CAMERYN,D108,HJ,33.23,,221579.34
6150,11/30/2020,11/30/2020,113020,82L-IMPORT PAYROLL-DEWS CAMERYN,D108,HJ,142.08,,221721.42
6150,11/30/2020,11/30/2020,113020,82L-IMPORT PAYROLL-DIETZ MARY,D108,HJ,16.23,,221737.65
6150,11/30/2020,11/30/2020,113020,82L-IMPORT PAYROLL-DIETZ MARY,D108,HJ,69.38,,221807.03
6150,11/30/2020,11/30/2020,113020,82L-IMPORT PAYROLL-DOMINIQUE PRINCESSA,D108,HJ,16.23,,221823.26
6150,11/30/2020,11/30/2020,113020,82L-IMPORT PAYROLL-DOMINIQUE PRINCESSA,D108,HJ,69.38,,221892.64
6150,11/30/2020,11/30/2020,113020,82L-IMPORT PAYROLL-DONNELLY MARCUS,D108,HJ,16.23,,221908.87
6150,11/30/2020,11/30/2020,113020,82L-IMPORT PAYROLL-DONNELLY MARCUS,D108,HJ,21.49,,221930.36
6150,11/30/2020,11/30/2020,113020,82L-IMPORT PAYROLL-DONNELLY MARCUS,D108,HJ,69.38,,221999.74
6150,11/30/2020,11/30/2020,113020,82L-IMPORT PAYROLL-FEIGHERY JOHN,D108,HJ,30.56,,222030.3
6150,11/30/2020,11/30/2020,113020,82L-IMPORT PAYROLL-FEIGHERY JOHN,D108,HJ,130.69,,222160.99
6150,11/30/2020,11/30/2020,113020,82L-IMPORT PAYROLL-FORTH KYLE,D108,HJ,16.23,,222177.22
6150,11/30/2020,11/30/2020,113020,82L-IMPORT PAYROLL-FORTH KYLE,D108,HJ,69.38,,222246.6
6150,11/30/2020,11/30/2020,113020,82L-IMPORT PAYROLL-GARCIA MARILYN,D108,HJ,33.23,,222279.83
6150,11/30/2020,11/30/2020,113020,82L-IMPORT PAYROLL-GARCIA MARILYN,D108,HJ,142.08,,222421.91
6150,11/30/2020,11/30/2020,113020,82L-IMPORT PAYROLL-GREENE BROOKE,D108,HJ,15.28,,222437.19
6150,11/30/2020,11/30/2020,113020,82L-IMPORT PAYROLL-GREENE BROOKE,D108,HJ,65.35,,222502.54
6150,11/30/2020,11/30/2020,113020,82L-IMPORT PAYROLL-GRIFFIN ANDREW,D108,HJ,30.44,,222532.98
6150,11/30/2020,11/30/2020,113020,82L-IMPORT PAYROLL-GRIFFIN ANDREW,D108,HJ,130.16,,222663.14
6150,11/30/2020,11/30/2020,113020,82L-IMPORT PAYROLL-GROSS EMILY,D108,HJ,14,,222677.14
6150,11/30/2020,11/30/2020,113020,82L-IMPORT PAYROLL-GROSS EMILY,D108,HJ,59.86,,222737
6150,11/30/2020,11/30/2020,113020,82L-IMPORT PAYROLL-GUERRERO LUIS,D108,HJ,16.23,,222753.23
6150,11/30/2020,11/30/2020,113020,82L-IMPORT PAYROLL-GUERRERO LUIS,D108,HJ,69.38,,222822.61
6150,11/30/2020,11/30/2020,113020,82L-IMPORT PAYROLL-HALLINAN GABRIEL,D108,HJ,34.79,,222857.4
6150,11/30/2020,11/30/2020,113020,82L-IMPORT PAYROLL-HALLINAN GABRIEL,D108,HJ,148.76,,223006.16
6150,11/30/2020,11/30/2020,113020,82L-IMPORT PAYROLL-HAMERSLY WILLIAM,D108,HJ,34.16,,223040.32
6150,11/30/2020,11/30/2020,113020,82L-IMPORT PAYROLL-HAMERSLY WILLIAM,D108,HJ,146.08,,223186.4
6150,11/30/2020,11/30/2020,113020,82L-IMPORT PAYROLL-HOLDER LATIVA M,D108,HJ,55.28,,223241.68
6150,11/30/2020,11/30/2020,113020,82L-IMPORT PAYROLL-HOLDER LATIVA M,D108,HJ,236.38,,223478.06
6150,11/30/2020,11/30/2020,113020,82L-IMPORT PAYROLL-HOSSAIN MYESHA,D108,HJ,35.1,,223513.16
6150,11/30/2020,11/30/2020,113020,82L-IMPORT PAYROLL-HOSSAIN MYESHA,D108,HJ,150.1,,223663.26
6150,11/30/2020,11/30/2020,113020,82L-IMPORT PAYROLL-JACKSON TASNIM F,D108,HJ,31,,223694.26
6150,11/30/2020,11/30/2020,113020,82L-IMPORT PAYROLL-JACKSON TASNIM F,D108,HJ,132.56,,223826.82
6150,11/30/2020,11/30/2020,113020,82L-IMPORT PAYROLL-KERKHOFF HARPER FAITH,D108,HJ,16.23,,223843.05
6150,11/30/2020,11/30/2020,113020,82L-IMPORT PAYROLL-KERKHOFF HARPER FAITH,D108,HJ,69.38,,223912.43
6150,11/30/2020,11/30/2020,113020,82L-IMPORT PAYROLL-LEARY AUBREY,D108,HJ,16.2,,223928.63
6150,11/30/2020,11/30/2020,113020,82L-IMPORT PAYROLL-LEARY AUBREY,D108,HJ,69.27,,223997.9
6150,11/30/2020,11/30/2020,113020,82L-IMPORT PAYROLL-LI BELLA,D108,HJ,33.96,,224031.86
6150,11/30/2020,11/30/2020,113020,82L-IMPORT PAYROLL-LI BELLA,D108,HJ,145.23,,224177.09
6150,11/30/2020,11/30/2020,113020,82L-IMPORT PAYROLL-LOUIE JORDAN,D108,HJ,16.23,,224193.32
6150,11/30/2020,11/30/2020,113020,82L-IMPORT PAYROLL-LOUIE JORDAN,D108,HJ,69.38,,224262.7
6150,11/30/2020,11/30/2020,113020,82L-IMPORT PAYROLL-MELCHOR OSBEIDY,D108,HJ,16.23,,224278.93
6150,11/30/2020,11/30/2020,113020,82L-IMPORT PAYROLL-MELCHOR OSBEIDY,D108,HJ,69.38,,224348.31
6150,11/30/2020,11/30/2020,113020,82L-IMPORT PAYROLL-MORRIS ZAKIYA,D108,HJ,16.23,,224364.54
6150,11/30/2020,11/30/2020,113020,82L-IMPORT PAYROLL-MORRIS ZAKIYA,D108,HJ,69.38,,224433.92
6150,11/30/2020,11/30/2020,113020,82L-IMPORT PAYROLL-MORSELETTO RAFAEL,D108,HJ,16.23,,224450.15
6150,11/30/2020,11/30/2020,113020,82L-IMPORT PAYROLL-MORSELETTO RAFAEL,D108,HJ,69.38,,224519.53
6150,11/30/2020,11/30/2020,113020,82L-IMPORT PAYROLL-OBI TOBECHUKWU,D108,HJ,16.23,,224535.76
6150,11/30/2020,11/30/2020,113020,82L-IMPORT PAYROLL-OBI TOBECHUKWU,D108,HJ,69.38,,224605.14
6150,11/30/2020,11/30/2020,113020,82L-IMPORT PAYROLL-OPUH NDIDI,D108,HJ,34.74,,224639.88
6150,11/30/2020,11/30/2020,113020,82L-IMPORT PAYROLL-OPUH NDIDI,D108,HJ,148.53,,224788.41
6150,11/30/2020,11/30/2020,113020,82L-IMPORT PAYROLL-PAULINO THAIRI,D108,HJ,16.23,,224804.64
6150,11/30/2020,11/30/2020,113020,82L-IMPORT PAYROLL-PAULINO THAIRI,D108,HJ,69.38,,224874.02
6150,11/30/2020,11/30/2020,113020,82L-IMPORT PAYROLL-ROSENBAUM MURRAY,D108,HJ,16.23,,224890.25
6150,11/30/2020,11/30/2020,113020,82L-IMPORT PAYROLL-ROSENBAUM MURRAY,D108,HJ,69.38,,224959.63
6150,11/30/2020,11/30/2020,113020,82L-IMPORT PAYROLL-SCHWETTMANN CLAIRE,D108,HJ,15.28,,224974.91
6150,11/30/2020,11/30/2020,113020,82L-IMPORT PAYROLL-SCHWETTMANN CLAIRE,D108,HJ,65.35,,225040.26
6150,11/30/2020,11/30/2020,113020,82L-IMPORT PAYROLL-SOBELMAN JUSTIN,D108,HJ,15.08,,225055.34
6150,11/30/2020,11/30/2020,113020,82L-IMPORT PAYROLL-SOBELMAN JUSTIN,D108,HJ,64.5,,225119.84
6150,11/30/2020,11/30/2020,113020,82L-IMPORT PAYROLL-TERRENCE-SMITH ZIHIR,D108,HJ,14.32,,225134.16
6150,11/30/2020,11/30/2020,113020,82L-IMPORT PAYROLL-TERRENCE-SMITH ZIHIR,D108,HJ,61.22,,225195.38
6150,11/30/2020,11/30/2020,113020,82L-IMPORT PAYROLL-TILLERY ASIA,D108,HJ,47.73,,225243.11
6150,11/30/2020,11/30/2020,113020,82L-IMPORT PAYROLL-TILLERY ASIA,D108,HJ,204.08,,225447.19
6150,11/30/2020,11/30/2020,113020,82L-IMPORT PAYROLL-WILLIAMS-MASSEY BRIANNA,D108,HJ,16.05,,225463.24
6150,11/30/2020,11/30/2020,113020,82L-IMPORT PAYROLL-WILLIAMS-MASSEY BRIANNA,D108,HJ,68.64,,225531.88
6150,11/30/2020,11/30/2020,113020,82L-IMPORT PAYROLL-XIAO CHENGYAO,D108,HJ,16.23,,225548.11
6150,11/30/2020,11/30/2020,113020,82L-IMPORT PAYROLL-XIAO CHENGYAO,D108,HJ,69.38,,225617.49
6150,11/30/2020,11/30/2020,113020,82L-IMPORT PAYROLL-ZIAUDDIN ABUTAHER,D108,HJ,16.23,,225633.72
6150,11/30/2020,11/30/2020,113020,82L-IMPORT PAYROLL-ZIAUDDIN ABUTAHER,D108,HJ,69.38,,225703.1
6150,11/30/2020,11/30/2020,113020,82L-IMPORT PAYROLL-BALASUBRAMANIAN SHARANYA,D108,HJ,16.53,,225719.63
6150,11/30/2020,11/30/2020,113020,82L-IMPORT PAYROLL-BALASUBRAMANIAN SHARANYA,D108,HJ,38.67,,225758.3
6150,11/30/2020,11/30/2020,113020,82L-IMPORT PAYROLL-BALASUBRAMANIAN SHARANYA,D108,HJ,165.33,,225923.63
6150,11/30/2020,11/30/2020,113020,82L-IMPORT PAYROLL-COVENEY ALLISON,D108,HJ,38.07,,225961.7
6150,11/30/2020,11/30/2020,113020,82L-IMPORT PAYROLL-COVENEY ALLISON,D108,HJ,162.79,,226124.49
6150,11/30/2020,11/30/2020,113020,82L-IMPORT PAYROLL-JACKSON CLAICE M,D108,HJ,15.45,,226139.94
6150,11/30/2020,11/30/2020,113020,82L-IMPORT PAYROLL-JACKSON CLAICE M,D108,HJ,19.38,,226159.32
6150,11/30/2020,11/30/2020,113020,82L-IMPORT PAYROLL-JACKSON CLAICE M,D108,HJ,27.46,,226186.78
6150,11/30/2020,11/30/2020,113020,82L-IMPORT PAYROLL-JACKSON CLAICE M,D108,HJ,66.05,,226252.83
6150,11/30/2020,11/30/2020,113020,82L-IMPORT PAYROLL-JACKSON CLAICE M,D108,HJ,117.43,,226370.26
6150,11/30/2020,11/30/2020,113020,82L-IMPORT PAYROLL-JANG DANIEL,D108,HJ,37.75,,226408.01
6150,11/30/2020,11/30/2020,113020,82L-IMPORT PAYROLL-JANG DANIEL,D108,HJ,161.4,,226569.41
6150,11/30/2020,11/30/2020,113020,82L-IMPORT PAYROLL-LENEGHAN MARYELLEN,D108,HJ,24.06,,226593.47
6150,11/30/2020,11/30/2020,113020,82L-IMPORT PAYROLL-LENEGHAN MARYELLEN,D108,HJ,42.78,,226636.25
6150,11/30/2020,11/30/2020,113020,82L-IMPORT PAYROLL-LENEGHAN MARYELLEN,D108,HJ,102.88,,226739.13
6150,11/30/2020,11/30/2020,113020,82L-IMPORT PAYROLL-LENEGHAN MARYELLEN,D108,HJ,182.9,,226922.03
6150,11/30/2020,11/30/2020,202011,Adj to reallocate Salaries FICA and benefits from GM3 - ACY2 to G-BL-To reallocate Amena Wallance from GM3 - ACY2 to G-BL,D104,HJ,,305.3,226616.73
6150,11/30/2020,11/30/2020,202011,Adj to reallocate Salaries FICA and benefits from GM3 - ACY2 to G-BL-To reallocate Amena Wallance from GM3 - ACY2 to G-BL,D104,HJ,305.3,,226922.03
6150,11/30/2020,11/30/2020,202011,Adj to reallocate Salaries FICA and benefits from GM3 - ACY2 to G-BL-To reallocate J.Messing and T.Bibb salary from GM3 - ACY2 to G-BL,D104,HJ,,1011.64,225910.39
6150,11/30/2020,11/30/2020,202011,Adj to reallocate Salaries FICA and benefits from GM3 - ACY2 to G-BL-To reallocate J.Messing and T.Bibb salary from GM3 - ACY2 to G-BL,D104,HJ,1011.64,,226922.03
6150,12/15/2020,12/15/2020,121520,82L-IMPORT PAYROLL-BARTHELEMY RACHALIE,D108,HJ,14.01,,226936.04
6150,12/15/2020,12/15/2020,121520,82L-IMPORT PAYROLL-BARTHELEMY RACHALIE,D108,HJ,59.89,,226995.93
6150,12/15/2020,12/15/2020,121520,82L-IMPORT PAYROLL-BASHAM WILLIAM EDWARD,D108,HJ,14.06,,227009.99
6150,12/15/2020,12/15/2020,121520,82L-IMPORT PAYROLL-BASHAM WILLIAM EDWARD,D108,HJ,28.29,,227038.28
6150,12/15/2020,12/15/2020,121520,82L-IMPORT PAYROLL-BASHAM WILLIAM EDWARD,D108,HJ,60.11,,227098.39
6150,12/15/2020,12/15/2020,121520,82L-IMPORT PAYROLL-BOHLSEN GRACE ISABELLE,D108,HJ,15.16,,227113.55
6150,12/15/2020,12/15/2020,121520,82L-IMPORT PAYROLL-BOHLSEN GRACE ISABELLE,D108,HJ,64.84,,227178.39
6150,12/15/2020,12/15/2020,121520,82L-IMPORT PAYROLL-BOLIVAR ANDREA,D108,HJ,36.25,,227214.64
6150,12/15/2020,12/15/2020,121520,82L-IMPORT PAYROLL-BOLIVAR ANDREA,D108,HJ,155,,227369.64
6150,12/15/2020,12/15/2020,121520,82L-IMPORT PAYROLL-BORCHART SPENCER,D108,HJ,15.19,,227384.83
6150,12/15/2020,12/15/2020,121520,82L-IMPORT PAYROLL-BORCHART SPENCER,D108,HJ,44.27,,227429.1
6150,12/15/2020,12/15/2020,121520,82L-IMPORT PAYROLL-BORCHART SPENCER,D108,HJ,64.95,,227494.05
6150,12/15/2020,12/15/2020,121520,82L-IMPORT PAYROLL-BROWN ISAAC,D108,HJ,14.01,,227508.06
6150,12/15/2020,12/15/2020,121520,82L-IMPORT PAYROLL-BROWN ISAAC,D108,HJ,20.14,,227528.2
6150,12/15/2020,12/15/2020,121520,82L-IMPORT PAYROLL-BROWN ISAAC,D108,HJ,59.89,,227588.09
6150,12/15/2020,12/15/2020,121520,82L-IMPORT PAYROLL-BURKE MARIAH,D108,HJ,15.19,,227603.28
6150,12/15/2020,12/15/2020,121520,82L-IMPORT PAYROLL-BURKE MARIAH,D108,HJ,64.95,,227668.23
6150,12/15/2020,12/15/2020,121520,82L-IMPORT PAYROLL-CASSADY JOSHUA LEWIS,D108,HJ,15.19,,227683.42
6150,12/15/2020,12/15/2020,121520,82L-IMPORT PAYROLL-CASSADY JOSHUA LEWIS,D108,HJ,28.29,,227711.71
6150,12/15/2020,12/15/2020,121520,82L-IMPORT PAYROLL-CASSADY JOSHUA LEWIS,D108,HJ,64.95,,227776.66
6150,12/15/2020,12/15/2020,121520,82L-IMPORT PAYROLL-DARKO OLIVIA,D108,HJ,15.19,,227791.85
6150,12/15/2020,12/15/2020,121520,82L-IMPORT PAYROLL-DARKO OLIVIA,D108,HJ,64.95,,227856.8
6150,12/15/2020,12/15/2020,121520,82L-IMPORT PAYROLL-DAWSON JAMIL NAFAYE-BEYAH,D108,HJ,15.19,,227871.99
6150,12/15/2020,12/15/2020,121520,82L-IMPORT PAYROLL-DAWSON JAMIL NAFAYE-BEYAH,D108,HJ,64.95,,227936.94
6150,12/15/2020,12/15/2020,121520,82L-IMPORT PAYROLL-ESCAMILLA OLGA,D108,HJ,15.19,,227952.13
6150,12/15/2020,12/15/2020,121520,82L-IMPORT PAYROLL-ESCAMILLA OLGA,D108,HJ,64.95,,228017.08
6150,12/15/2020,12/15/2020,121520,82L-IMPORT PAYROLL-GARCIA SANTIAGO,D108,HJ,29.6,,228046.68
6150,12/15/2020,12/15/2020,121520,82L-IMPORT PAYROLL-GARCIA SANTIAGO,D108,HJ,126.58,,228173.26
6150,12/15/2020,12/15/2020,121520,82L-IMPORT PAYROLL-GILES SHAYLA,D108,HJ,15.19,,228188.45
6150,12/15/2020,12/15/2020,121520,82L-IMPORT PAYROLL-GILES SHAYLA,D108,HJ,64.95,,228253.4
6150,12/15/2020,12/15/2020,121520,82L-IMPORT PAYROLL-IKUNIKA FUNMILAYO,D108,HJ,30.21,,228283.61
6150,12/15/2020,12/15/2020,121520,82L-IMPORT PAYROLL-IKUNIKA FUNMILAYO,D108,HJ,129.17,,228412.78
6150,12/15/2020,12/15/2020,121520,82L-IMPORT PAYROLL-JONES JORDAN,D108,HJ,15.19,,228427.97
6150,12/15/2020,12/15/2020,121520,82L-IMPORT PAYROLL-JONES JORDAN,D108,HJ,64.95,,228492.92
6150,12/15/2020,12/15/2020,121520,82L-IMPORT PAYROLL-KHAN HUDA,D108,HJ,14.25,,228507.17
6150,12/15/2020,12/15/2020,121520,82L-IMPORT PAYROLL-KHAN HUDA,D108,HJ,60.92,,228568.09
6150,12/15/2020,12/15/2020,121520,82L-IMPORT PAYROLL-KLOHR TIMOTHY JORDAN,D108,HJ,29,,228597.09
6150,12/15/2020,12/15/2020,121520,82L-IMPORT PAYROLL-KLOHR TIMOTHY JORDAN,D108,HJ,124,,228721.09
6150,12/15/2020,12/15/2020,121520,82L-IMPORT PAYROLL-KNOWLIN ZYLIA,D108,HJ,34.63,,228755.72
6150,12/15/2020,12/15/2020,121520,82L-IMPORT PAYROLL-KNOWLIN ZYLIA,D108,HJ,148.06,,228903.78
6150,12/15/2020,12/15/2020,121520,82L-IMPORT PAYROLL-KOPSHEVER MELISSA,D108,HJ,38.26,,228942.04
6150,12/15/2020,12/15/2020,121520,82L-IMPORT PAYROLL-KOPSHEVER MELISSA,D108,HJ,163.58,,229105.62
6150,12/15/2020,12/15/2020,121520,82L-IMPORT PAYROLL-LI SEN YUAN,D108,HJ,14.05,,229119.67
6150,12/15/2020,12/15/2020,121520,82L-IMPORT PAYROLL-LI SEN YUAN,D108,HJ,60.07,,229179.74
6150,12/15/2020,12/15/2020,121520,82L-IMPORT PAYROLL-LIPSCOMB STEPHEN,D108,HJ,33.58,,229213.32
6150,12/15/2020,12/15/2020,121520,82L-IMPORT PAYROLL-LIPSCOMB STEPHEN,D108,HJ,143.59,,229356.91
6150,12/15/2020,12/15/2020,121520,82L-IMPORT PAYROLL-MALLECK JESSICA R,D108,HJ,15.19,,229372.1
6150,12/15/2020,12/15/2020,121520,82L-IMPORT PAYROLL-MALLECK JESSICA R,D108,HJ,64.95,,229437.05
6150,12/15/2020,12/15/2020,121520,82L-IMPORT PAYROLL-MCLAUGHLIN MARA,D108,HJ,15.19,,229452.24
6150,12/15/2020,12/15/2020,121520,82L-IMPORT PAYROLL-MCLAUGHLIN MARA,D108,HJ,22,,229474.24
6150,12/15/2020,12/15/2020,121520,82L-IMPORT PAYROLL-MCLAUGHLIN MARA,D108,HJ,64.95,,229539.19
6150,12/15/2020,12/15/2020,121520,82L-IMPORT PAYROLL-MEJIA ROSO CARLOS,D108,HJ,14.01,,229553.2
6150,12/15/2020,12/15/2020,121520,82L-IMPORT PAYROLL-MEJIA ROSO CARLOS,D108,HJ,59.89,,229613.09
6150,12/15/2020,12/15/2020,121520,82L-IMPORT PAYROLL-MONROY-MEJIA JASON,D108,HJ,15.19,,229628.28
6150,12/15/2020,12/15/2020,121520,82L-IMPORT PAYROLL-MONROY-MEJIA JASON,D108,HJ,64.95,,229693.23
6150,12/15/2020,12/15/2020,121520,82L-IMPORT PAYROLL-O'FLYNN-PRUITT NATHAN COLYAR,D108,HJ,15.19,,229708.42
6150,12/15/2020,12/15/2020,121520,82L-IMPORT PAYROLL-O'FLYNN-PRUITT NATHAN COLYAR,D108,HJ,64.95,,229773.37
6150,12/15/2020,12/15/2020,121520,82L-IMPORT PAYROLL-PATTERSON STEVE,D108,HJ,15.19,,229788.56
6150,12/15/2020,12/15/2020,121520,82L-IMPORT PAYROLL-PATTERSON STEVE,D108,HJ,64.95,,229853.51
6150,12/15/2020,12/15/2020,121520,82L-IMPORT PAYROLL-SCHMIESS RACHEL JOY,D108,HJ,10.69,,229864.2
6150,12/15/2020,12/15/2020,121520,82L-IMPORT PAYROLL-SCHMIESS RACHEL JOY,D108,HJ,15.19,,229879.39
6150,12/15/2020,12/15/2020,121520,82L-IMPORT PAYROLL-SCHMIESS RACHEL JOY,D108,HJ,64.95,,229944.34
6150,12/15/2020,12/15/2020,121520,82L-IMPORT PAYROLL-SCOTT KIRK DONOVAN,D108,HJ,14.05,,229958.39
6150,12/15/2020,12/15/2020,121520,82L-IMPORT PAYROLL-SCOTT KIRK DONOVAN,D108,HJ,60.07,,230018.46
6150,12/15/2020,12/15/2020,121520,82L-IMPORT PAYROLL-SILVER KELLY,D108,HJ,34.63,,230053.09
6150,12/15/2020,12/15/2020,121520,82L-IMPORT PAYROLL-SILVER KELLY,D108,HJ,148.06,,230201.15
6150,12/15/2020,12/15/2020,121520,82L-IMPORT PAYROLL-SOLIMAN MARK,D108,HJ,15.19,,230216.34
6150,12/15/2020,12/15/2020,121520,82L-IMPORT PAYROLL-SOLIMAN MARK,D108,HJ,64.95,,230281.29
6150,12/15/2020,12/15/2020,121520,82L-IMPORT PAYROLL-STEIN KYLE,D108,HJ,27.84,,230309.13
6150,12/15/2020,12/15/2020,121520,82L-IMPORT PAYROLL-STEIN KYLE,D108,HJ,119.05,,230428.18
6150,12/15/2020,12/15/2020,121520,82L-IMPORT PAYROLL-STROUD DAVID,D108,HJ,14.65,,230442.83
6150,12/15/2020,12/15/2020,121520,82L-IMPORT PAYROLL-STROUD DAVID,D108,HJ,62.62,,230505.45
6150,12/15/2020,12/15/2020,121520,82L-IMPORT PAYROLL-VALCIN SABRINA JEMIMAH,D108,HJ,14.25,,230519.7
6150,12/15/2020,12/15/2020,121520,82L-IMPORT PAYROLL-VALCIN SABRINA JEMIMAH,D108,HJ,60.92,,230580.62
6150,12/15/2020,12/15/2020,121520,82L-IMPORT PAYROLL-VALDES ERNEST L,D108,HJ,15.19,,230595.81
6150,12/15/2020,12/15/2020,121520,82L-IMPORT PAYROLL-VALDES ERNEST L,D108,HJ,64.95,,230660.76
6150,12/15/2020,12/15/2020,121520,82L-IMPORT PAYROLL-WILLIAMS MACK ANTHONY,D108,HJ,15.02,,230675.78
6150,12/15/2020,12/15/2020,121520,82L-IMPORT PAYROLL-WILLIAMS MACK ANTHONY,D108,HJ,64.21,,230739.99
6150,12/15/2020,12/15/2020,121520,82L-IMPORT PAYROLL-WILLIAMS MIL'YONTA,D108,HJ,15.19,,230755.18
6150,12/15/2020,12/15/2020,121520,82L-IMPORT PAYROLL-WILLIAMS MIL'YONTA,D108,HJ,64.95,,230820.13
6150,12/15/2020,12/15/2020,121520,82L-IMPORT PAYROLL-ANTHONY BETTY S,D108,HJ,41.85,,230861.98
6150,12/15/2020,12/15/2020,121520,82L-IMPORT PAYROLL-ANTHONY BETTY S,D108,HJ,178.96,,231040.94
6150,12/15/2020,12/15/2020,121520,82L-IMPORT PAYROLL-APULI LINDSAY,D108,HJ,34.16,,231075.1
6150,12/15/2020,12/15/2020,121520,82L-IMPORT PAYROLL-APULI LINDSAY,D108,HJ,146.08,,231221.18
6150,12/15/2020,12/15/2020,121520,82L-IMPORT PAYROLL-AUSTIN PERCY ANTONIO,D108,HJ,36.34,,231257.52
6150,12/15/2020,12/15/2020,121520,82L-IMPORT PAYROLL-AUSTIN PERCY ANTONIO,D108,HJ,155.39,,231412.91
6150,12/15/2020,12/15/2020,121520,82L-IMPORT PAYROLL-BUHMANN JENNIFER,D108,HJ,32.9,,231445.81
6150,12/15/2020,12/15/2020,121520,82L-IMPORT PAYROLL-BUHMANN JENNIFER,D108,HJ,140.68,,231586.49
6150,12/15/2020,12/15/2020,121520,82L-IMPORT PAYROLL-CAIN CORY,D108,HJ,36.32,,231622.81
6150,12/15/2020,12/15/2020,121520,82L-IMPORT PAYROLL-CAIN CORY,D108,HJ,155.3,,231778.11
6150,12/15/2020,12/15/2020,121520,82L-IMPORT PAYROLL-CHAPMAN CLAUDY EARL,D108,HJ,99.49,,231877.6
6150,12/15/2020,12/15/2020,121520,82L-IMPORT PAYROLL-CHAPMAN CLAUDY EARL,D108,HJ,425.4,,232303
6150,12/15/2020,12/15/2020,121520,82L-IMPORT PAYROLL-DADA ARIKPO E,D108,HJ,32.04,,232335.04
6150,12/15/2020,12/15/2020,121520,82L-IMPORT PAYROLL-DADA ARIKPO E,D108,HJ,137,,232472.04
6150,12/15/2020,12/15/2020,121520,82L-IMPORT PAYROLL-GUTHRIE LESLIE,D108,HJ,33.42,,232505.46
6150,12/15/2020,12/15/2020,121520,82L-IMPORT PAYROLL-GUTHRIE LESLIE,D108,HJ,142.9,,232648.36
6150,12/15/2020,12/15/2020,121520,82L-IMPORT PAYROLL-HOLMES JOREL ALEXANDER,D108,HJ,31.22,,232679.58
6150,12/15/2020,12/15/2020,121520,82L-IMPORT PAYROLL-HOLMES JOREL ALEXANDER,D108,HJ,133.51,,232813.09
6150,12/15/2020,12/15/2020,121520,82L-IMPORT PAYROLL-JORDAN TIFFANY T,D108,HJ,45.87,,232858.96
6150,12/15/2020,12/15/2020,121520,82L-IMPORT PAYROLL-JORDAN TIFFANY T,D108,HJ,196.13,,233055.09
6150,12/15/2020,12/15/2020,121520,82L-IMPORT PAYROLL-LANIGAN LISA A,D108,HJ,45.1,,233100.19
6150,12/15/2020,12/15/2020,121520,82L-IMPORT PAYROLL-LANIGAN LISA A,D108,HJ,192.83,,233293.02
6150,12/15/2020,12/15/2020,121520,82L-IMPORT PAYROLL-MCELWEE MELISSA,D108,HJ,38.67,,233331.69
6150,12/15/2020,12/15/2020,121520,82L-IMPORT PAYROLL-MCELWEE MELISSA,D108,HJ,165.33,,233497.02
6150,12/15/2020,12/15/2020,121520,82L-IMPORT PAYROLL-MCNICHOLAS MARY,D108,HJ,33.23,,233530.25
6150,12/15/2020,12/15/2020,121520,82L-IMPORT PAYROLL-MCNICHOLAS MARY,D108,HJ,142.08,,233672.33
6150,12/15/2020,12/15/2020,121520,82L-IMPORT PAYROLL-NWAKANMA NANCY,D108,HJ,44.18,,233716.51
6150,12/15/2020,12/15/2020,121520,82L-IMPORT PAYROLL-NWAKANMA NANCY,D108,HJ,188.89,,233905.4
6150,12/15/2020,12/15/2020,121520,82L-IMPORT PAYROLL-ONICA ANTHONY J,D108,HJ,32.86,,233938.26
6150,12/15/2020,12/15/2020,121520,82L-IMPORT PAYROLL-ONICA ANTHONY J,D108,HJ,140.49,,234078.75
6150,12/15/2020,12/15/2020,121520,82L-IMPORT PAYROLL-PRAHIN NICOLE M,D108,HJ,52.91,,234131.66
6150,12/15/2020,12/15/2020,121520,82L-IMPORT PAYROLL-PRAHIN NICOLE M,D108,HJ,226.22,,234357.88
6150,12/15/2020,12/15/2020,121520,82L-IMPORT PAYROLL-RIVERS QUIONNA DIANE,D108,HJ,39.27,,234397.15
6150,12/15/2020,12/15/2020,121520,82L-IMPORT PAYROLL-RIVERS QUIONNA DIANE,D108,HJ,167.92,,234565.07
6150,12/15/2020,12/15/2020,121520,82L-IMPORT PAYROLL-SALIM YASSER,D108,HJ,33.1,,234598.17
6150,12/15/2020,12/15/2020,121520,82L-IMPORT PAYROLL-SALIM YASSER,D108,HJ,141.55,,234739.72
6150,12/15/2020,12/15/2020,121520,82L-IMPORT PAYROLL-SEJOUR MAHALIAH,D108,HJ,34.07,,234773.79
6150,12/15/2020,12/15/2020,121520,82L-IMPORT PAYROLL-SEJOUR MAHALIAH,D108,HJ,145.66,,234919.45
6150,12/15/2020,12/15/2020,121520,82L-IMPORT PAYROLL-SKALSKI CHRISTOPHER,D108,HJ,33.86,,234953.31
6150,12/15/2020,12/15/2020,121520,82L-IMPORT PAYROLL-SKALSKI CHRISTOPHER,D108,HJ,144.76,,235098.07
6150,12/15/2020,12/15/2020,121520,82L-IMPORT PAYROLL-TUMENJARGAL ENKHJIN,D108,HJ,32.92,,235130.99
6150,12/15/2020,12/15/2020,121520,82L-IMPORT PAYROLL-TUMENJARGAL ENKHJIN,D108,HJ,140.75,,235271.74
6150,12/15/2020,12/15/2020,121520,82L-IMPORT PAYROLL-VILLEGAS EVELYN,D108,HJ,33.4,,235305.14
6150,12/15/2020,12/15/2020,121520,82L-IMPORT PAYROLL-VILLEGAS EVELYN,D108,HJ,142.81,,235447.95
6150,12/15/2020,12/15/2020,121520,82L-IMPORT PAYROLL-WOLF ANNA A,D108,HJ,36.3,,235484.25
6150,12/15/2020,12/15/2020,121520,82L-IMPORT PAYROLL-WOLF ANNA A,D108,HJ,155.19,,235639.44
6150,12/15/2020,12/15/2020,121520,82L-IMPORT PAYROLL-ACEVEDO MONIVETT,D107,HJ,6.52,,235645.96
6150,12/15/2020,12/15/2020,121520,82L-IMPORT PAYROLL-ACEVEDO MONIVETT,D107,HJ,27.87,,235673.83
6150,12/15/2020,12/15/2020,121520,82L-IMPORT PAYROLL-ACEVEDO MONIVETT,D107,HJ,65.9,,235739.73
6150,12/15/2020,12/15/2020,121520,82L-IMPORT PAYROLL-ACEVEDO MONIVETT,D107,HJ,281.77,,236021.5
6150,12/15/2020,12/15/2020,121520,82L-IMPORT PAYROLL-AKLESTAD ISABEL,D111,HJ,23.29,,236044.79
6150,12/15/2020,12/15/2020,121520,82L-IMPORT PAYROLL-AKLESTAD ISABEL,D111,HJ,99.58,,236144.37
6150,12/15/2020,12/15/2020,121520,82L-IMPORT PAYROLL-BIBB TIFFANI,D104,HJ,49.71,,236194.08
6150,12/15/2020,12/15/2020,121520,82L-IMPORT PAYROLL-BIBB TIFFANI,D104,HJ,212.55,,236406.63
6150,12/15/2020,12/15/2020,121520,82L-IMPORT PAYROLL-BOWMAN HALLEY K,D101,HJ,46.72,,236453.35
6150,12/15/2020,12/15/2020,121520,82L-IMPORT PAYROLL-BOWMAN HALLEY K,D101,HJ,199.79,,236653.14
6150,12/15/2020,12/15/2020,121520,82L-IMPORT PAYROLL-COOK CATHRYN ANNA,D105,HJ,49.87,,236703.01
6150,12/15/2020,12/15/2020,121520,82L-IMPORT PAYROLL-COOK CATHRYN ANNA,D105,HJ,213.25,,236916.26
6150,12/15/2020,12/15/2020,121520,82L-IMPORT PAYROLL-COOPER ASHLEE R,D101,HJ,33.51,,236949.77
6150,12/15/2020,12/15/2020,121520,82L-IMPORT PAYROLL-COOPER ASHLEE R,D101,HJ,143.3,,237093.07
6150,12/15/2020,12/15/2020,121520,82L-IMPORT PAYROLL-CORTEZ MIRANDA A,D111,HJ,38.45,,237131.52
6150,12/15/2020,12/15/2020,121520,82L-IMPORT PAYROLL-CORTEZ MIRANDA A,D111,HJ,164.42,,237295.94
6150,12/15/2020,12/15/2020,121520,82L-IMPORT PAYROLL-DAUGHERTY DEVIN W,D101,HJ,15.1,,237311.04
6150,12/15/2020,12/15/2020,121520,82L-IMPORT PAYROLL-DAUGHERTY DEVIN W,D101,HJ,64.58,,237375.62
6150,12/15/2020,12/15/2020,121520,82L-IMPORT PAYROLL-DETONE KYRA MAYA,D102,HJ,39,,237414.62
6150,12/15/2020,12/15/2020,121520,82L-IMPORT PAYROLL-DETONE KYRA MAYA,D102,HJ,166.75,,237581.37
6150,12/15/2020,12/15/2020,121520,82L-IMPORT PAYROLL-DUPUIS CHRISTOPHER M,D107,HJ,39.94,,237621.31
6150,12/15/2020,12/15/2020,121520,82L-IMPORT PAYROLL-DUPUIS CHRISTOPHER M,D107,HJ,48.8,,237670.11
6150,12/15/2020,12/15/2020,121520,82L-IMPORT PAYROLL-DUPUIS CHRISTOPHER M,D107,HJ,170.76,,237840.87
6150,12/15/2020,12/15/2020,121520,82L-IMPORT PAYROLL-DUPUIS CHRISTOPHER M,D107,HJ,208.69,,238049.56
6150,12/15/2020,12/15/2020,121520,82L-IMPORT PAYROLL-DZIEDZIC JULIE K,D101,HJ,17.71,,238067.27
6150,12/15/2020,12/15/2020,121520,82L-IMPORT PAYROLL-DZIEDZIC JULIE K,D101,HJ,75.71,,238142.98
6150,12/15/2020,12/15/2020,121520,82L-IMPORT PAYROLL-FISCHABER THOMAS,D109,HJ,77.9,,238220.88
6150,12/15/2020,12/15/2020,121520,82L-IMPORT PAYROLL-FISCHABER THOMAS,D109,HJ,333.1,,238553.98
6150,12/15/2020,12/15/2020,121520,82L-IMPORT PAYROLL-FLORY MEGAN,D109,HJ,21.75,,238575.73
6150,12/15/2020,12/15/2020,121520,82L-IMPORT PAYROLL-FLORY MEGAN,D109,HJ,25.5,,238601.23
6150,12/15/2020,12/15/2020,121520,82L-IMPORT PAYROLL-FLORY MEGAN,D109,HJ,93,,238694.23
6150,12/15/2020,12/15/2020,121520,82L-IMPORT PAYROLL-GORNSTEIN STEVEN,D101,HJ,39.27,,238733.5
6150,12/15/2020,12/15/2020,121520,82L-IMPORT PAYROLL-GORNSTEIN STEVEN,D101,HJ,167.92,,238901.42
6150,12/15/2020,12/15/2020,121520,82L-IMPORT PAYROLL-GUADARRAMA-ALVAREZ URIEL A,D105,HJ,39.93,,238941.35
6150,12/15/2020,12/15/2020,121520,82L-IMPORT PAYROLL-GUADARRAMA-ALVAREZ URIEL A,D105,HJ,170.75,,239112.1
6150,12/15/2020,12/15/2020,121520,82L-IMPORT PAYROLL-GUTIERREZ ANTONIO J,D107,HJ,84.72,,239196.82
6150,12/15/2020,12/15/2020,121520,82L-IMPORT PAYROLL-GUTIERREZ ANTONIO J,D107,HJ,150.62,,239347.44
6150,12/15/2020,12/15/2020,121520,82L-IMPORT PAYROLL-GUTIERREZ ANTONIO J,D107,HJ,362.26,,239709.7
6150,12/15/2020,12/15/2020,121520,82L-IMPORT PAYROLL-GUTIERREZ ANTONIO J,D107,HJ,644.01,,240353.71
6150,12/15/2020,12/15/2020,121520,82L-IMPORT PAYROLL-HENRY GILLIAN,D102,HJ,29.17,,240382.88
6150,12/15/2020,12/15/2020,121520,82L-IMPORT PAYROLL-HENRY GILLIAN,D102,HJ,124.74,,240507.62
6150,12/15/2020,12/15/2020,121520,82L-IMPORT PAYROLL-HERMAN ADAM,D102,HJ,28.2,,240535.82
6150,12/15/2020,12/15/2020,121520,82L-IMPORT PAYROLL-HERMAN ADAM,D102,HJ,120.56,,240656.38
6150,12/15/2020,12/15/2020,121520,82L-IMPORT PAYROLL-HESTER TYLER CONRAD,D105,HJ,27.79,,240684.17
6150,12/15/2020,12/15/2020,121520,82L-IMPORT PAYROLL-HESTER TYLER CONRAD,D105,HJ,118.83,,240803
6150,12/15/2020,12/15/2020,121520,82L-IMPORT PAYROLL-HOLT ADAM,D109,HJ,23.8,,240826.8
6150,12/15/2020,12/15/2020,121520,82L-IMPORT PAYROLL-HOLT ADAM,D109,HJ,58.24,,240885.04
6150,12/15/2020,12/15/2020,121520,82L-IMPORT PAYROLL-HOLT ADAM,D109,HJ,249.03,,241134.07
6150,12/15/2020,12/15/2020,121520,82L-IMPORT PAYROLL-KELLY SEAN,D109,HJ,78.54,,241212.61
6150,12/15/2020,12/15/2020,121520,82L-IMPORT PAYROLL-KELLY SEAN,D109,HJ,335.83,,241548.44
6150,12/15/2020,12/15/2020,121520,82L-IMPORT PAYROLL-KRUGER MARK,D109,HJ,72.5,,241620.94
6150,12/15/2020,12/15/2020,121520,82L-IMPORT PAYROLL-KRUGER MARK,D109,HJ,310,,241930.94
6150,12/15/2020,12/15/2020,121520,82L-IMPORT PAYROLL-LIPORACE HERNAN LUIS,D103,HJ,33.06,,241964
6150,12/15/2020,12/15/2020,121520,82L-IMPORT PAYROLL-LIPORACE HERNAN LUIS,D103,HJ,141.34,,242105.34
6150,12/15/2020,12/15/2020,121520,82L-IMPORT PAYROLL-MARKS KRISTA,D109,HJ,76.2,,242181.54
6150,12/15/2020,12/15/2020,121520,82L-IMPORT PAYROLL-MARKS KRISTA,D109,HJ,325.8,,242507.34
6150,12/15/2020,12/15/2020,121520,82L-IMPORT PAYROLL-MELVIN DARNELL KEVIN,D109,HJ,16.1,,242523.44
6150,12/15/2020,12/15/2020,121520,82L-IMPORT PAYROLL-MELVIN DARNELL KEVIN,D109,HJ,55.91,,242579.35
6150,12/15/2020,12/15/2020,121520,82L-IMPORT PAYROLL-MELVIN DARNELL KEVIN,D109,HJ,239.08,,242818.43
6150,12/15/2020,12/15/2020,121520,82L-IMPORT PAYROLL-MESSING JENNIFER,D109,HJ,34.12,,242852.55
6150,12/15/2020,12/15/2020,121520,82L-IMPORT PAYROLL-MESSING JENNIFER,D109,HJ,61.92,,242914.47
6150,12/15/2020,12/15/2020,121520,82L-IMPORT PAYROLL-MESSING JENNIFER,D109,HJ,145.9,,243060.37
6150,12/15/2020,12/15/2020,121520,82L-IMPORT PAYROLL-MILNE ROGER,D109,HJ,76.2,,243136.57
6150,12/15/2020,12/15/2020,121520,82L-IMPORT PAYROLL-MILNE ROGER,D109,HJ,325.8,,243462.37
6150,12/15/2020,12/15/2020,121520,82L-IMPORT PAYROLL-MOSTAFAVI YASAMAN,D109,HJ,11.72,,243474.09
6150,12/15/2020,12/15/2020,121520,82L-IMPORT PAYROLL-MOSTAFAVI YASAMAN,D109,HJ,19.21,,243493.3
6150,12/15/2020,12/15/2020,121520,82L-IMPORT PAYROLL-MOSTAFAVI YASAMAN,D109,HJ,50.13,,243543.43
6150,12/15/2020,12/15/2020,121520,82L-IMPORT PAYROLL-O'DONNELL STEPHEN,D104,HJ,39.26,,243582.69
6150,12/15/2020,12/15/2020,121520,82L-IMPORT PAYROLL-O'DONNELL STEPHEN,D104,HJ,67.69,,243650.38
6150,12/15/2020,12/15/2020,121520,82L-IMPORT PAYROLL-O'DONNELL STEPHEN,D104,HJ,167.87,,243818.25
6150,12/15/2020,12/15/2020,121520,82L-IMPORT PAYROLL-PARETS MALLORY GRACE,D101,HJ,17.57,,243835.82
6150,12/15/2020,12/15/2020,121520,82L-IMPORT PAYROLL-PARETS MALLORY GRACE,D101,HJ,41.08,,243876.9
6150,12/15/2020,12/15/2020,121520,82L-IMPORT PAYROLL-PARETS MALLORY GRACE,D101,HJ,175.67,,244052.57
6150,12/15/2020,12/15/2020,121520,82L-IMPORT PAYROLL-PARHAM-GANTT DENISE M,D112,HJ,37.96,,244090.53
6150,12/15/2020,12/15/2020,121520,82L-IMPORT PAYROLL-PARHAM-GANTT DENISE M,D112,HJ,162.32,,244252.85
6150,12/15/2020,12/15/2020,121520,82L-IMPORT PAYROLL-PEINADO ELIZABETH R,D111,HJ,52.29,,244305.14
6150,12/15/2020,12/15/2020,121520,82L-IMPORT PAYROLL-PEINADO ELIZABETH R,D111,HJ,223.58,,244528.72
6150,12/15/2020,12/15/2020,121520,82L-IMPORT PAYROLL-PERNIA JEFFREY,D109,HJ,56.19,,244584.91
6150,12/15/2020,12/15/2020,121520,82L-IMPORT PAYROLL-PERNIA JEFFREY,D109,HJ,240.25,,244825.16
6150,12/15/2020,12/15/2020,121520,82L-IMPORT PAYROLL-POLANCO ODALIS,D103,HJ,43.23,,244868.39
6150,12/15/2020,12/15/2020,121520,82L-IMPORT PAYROLL-POLANCO ODALIS,D103,HJ,184.83,,245053.22
6150,12/15/2020,12/15/2020,121520,82L-IMPORT PAYROLL-QUINTAS JASHIVE,D105,HJ,25.57,,245078.79
6150,12/15/2020,12/15/2020,121520,82L-IMPORT PAYROLL-QUINTAS JASHIVE,D105,HJ,109.31,,245188.1
6150,12/15/2020,12/15/2020,121520,82L-IMPORT PAYROLL-RANDOLPH ALEXANDER,D111,HJ,11.63,,245199.73
6150,12/15/2020,12/15/2020,121520,82L-IMPORT PAYROLL-RANDOLPH ALEXANDER,D111,HJ,25.1,,245224.83
6150,12/15/2020,12/15/2020,121520,82L-IMPORT PAYROLL-RANDOLPH ALEXANDER,D111,HJ,107.33,,245332.16
6150,12/15/2020,12/15/2020,121520,82L-IMPORT PAYROLL-RUBI PERLA,D101,HJ,10.86,,245343.02
6150,12/15/2020,12/15/2020,121520,82L-IMPORT PAYROLL-RUBI PERLA,D101,HJ,15.92,,245358.94
6150,12/15/2020,12/15/2020,121520,82L-IMPORT PAYROLL-SAFRAN ALAN P,D107,HJ,28.74,,245387.68
6150,12/15/2020,12/15/2020,121520,82L-IMPORT PAYROLL-SAFRAN ALAN P,D107,HJ,290.59,,245678.27
6150,12/15/2020,12/15/2020,121520,82L-IMPORT PAYROLL-SHENKMAN OLIVIA,D101,HJ,29,,245707.27
6150,12/15/2020,12/15/2020,121520,82L-IMPORT PAYROLL-SHENKMAN OLIVIA,D101,HJ,124,,245831.27
6150,12/15/2020,12/15/2020,121520,82L-IMPORT PAYROLL-SHI GRACE,D103,HJ,12.69,,245843.96
6150,12/15/2020,12/15/2020,121520,82L-IMPORT PAYROLL-SHI GRACE,D103,HJ,54.25,,245898.21
6150,12/15/2020,12/15/2020,121520,82L-IMPORT PAYROLL-WALLACE AMENA,D104,HJ,28.93,,245927.14
6150,12/15/2020,12/15/2020,121520,82L-IMPORT PAYROLL-WALLACE AMENA,D104,HJ,123.72,,246050.86
6150,12/15/2020,12/15/2020,121520,82L-IMPORT PAYROLL-WARD JEFFREY,D109,HJ,78.54,,246129.4
6150,12/15/2020,12/15/2020,121520,82L-IMPORT PAYROLL-WARD JEFFREY,D109,HJ,335.83,,246465.23
6150,12/15/2020,12/15/2020,121520,82L-IMPORT PAYROLL-WARD JENNIFER,D109,HJ,15.34,,246480.57
6150,12/15/2020,12/15/2020,121520,82L-IMPORT PAYROLL-WARD JENNIFER,D109,HJ,17.98,,246498.55
6150,12/15/2020,12/15/2020,121520,82L-IMPORT PAYROLL-WARD JENNIFER,D109,HJ,65.57,,246564.12
6150,12/15/2020,12/15/2020,121520,82L-IMPORT PAYROLL-WEINSTOCK EMILY,D101,HJ,17.57,,246581.69
6150,12/15/2020,12/15/2020,121520,82L-IMPORT PAYROLL-WEINSTOCK EMILY,D101,HJ,38.11,,246619.8
6150,12/15/2020,12/15/2020,121520,82L-IMPORT PAYROLL-WEINSTOCK EMILY,D101,HJ,162.94,,246782.74
6150,12/15/2020,12/15/2020,121520,82L-IMPORT PAYROLL-WINANS JENNIFER,D111,HJ,36.33,,246819.07
6150,12/15/2020,12/15/2020,121520,82L-IMPORT PAYROLL-WINANS JENNIFER,D111,HJ,155.35,,246974.42
6150,12/15/2020,12/15/2020,121520,82L-IMPORT PAYROLL-ZARATE JOSEPH M,D105,HJ,31.18,,247005.6
6150,12/15/2020,12/15/2020,121520,82L-IMPORT PAYROLL-ZARATE JOSEPH M,D105,HJ,133.3,,247138.9
6150,12/15/2020,12/15/2020,121520,82L-IMPORT PAYROLL-AGUANNO JOSEPH,D108,HJ,16.23,,247155.13
6150,12/15/2020,12/15/2020,121520,82L-IMPORT PAYROLL-AGUANNO JOSEPH,D108,HJ,69.38,,247224.51
6150,12/15/2020,12/15/2020,121520,82L-IMPORT PAYROLL-AKESODE FEHINTOLA,D108,HJ,16.23,,247240.74
6150,12/15/2020,12/15/2020,121520,82L-IMPORT PAYROLL-AKESODE FEHINTOLA,D108,HJ,69.38,,247310.12
6150,12/15/2020,12/15/2020,121520,82L-IMPORT PAYROLL-BARTOLD DEANNA MARIE,D108,HJ,41.91,,247352.03
6150,12/15/2020,12/15/2020,121520,82L-IMPORT PAYROLL-BARTOLD DEANNA MARIE,D108,HJ,179.22,,247531.25
6150,12/15/2020,12/15/2020,121520,82L-IMPORT PAYROLL-BELLOT GENESIS,D108,HJ,32.36,,247563.61
6150,12/15/2020,12/15/2020,121520,82L-IMPORT PAYROLL-BELLOT GENESIS,D108,HJ,138.38,,247701.99
6150,12/15/2020,12/15/2020,121520,82L-IMPORT PAYROLL-BENNETT JAMES H,D108,HJ,16.23,,247718.22
6150,12/15/2020,12/15/2020,121520,82L-IMPORT PAYROLL-BENNETT JAMES H,D108,HJ,69.38,,247787.6
6150,12/15/2020,12/15/2020,121520,82L-IMPORT PAYROLL-BOWMAN ABIGAIL,D108,HJ,16.23,,247803.83
6150,12/15/2020,12/15/2020,121520,82L-IMPORT PAYROLL-BOWMAN ABIGAIL,D108,HJ,69.38,,247873.21
6150,12/15/2020,12/15/2020,121520,82L-IMPORT PAYROLL-BURRELL RUSSELL,D108,HJ,15.08,,247888.29
6150,12/15/2020,12/15/2020,121520,82L-IMPORT PAYROLL-BURRELL RUSSELL,D108,HJ,28.09,,247916.38
6150,12/15/2020,12/15/2020,121520,82L-IMPORT PAYROLL-BURRELL RUSSELL,D108,HJ,64.5,,247980.88
6150,12/15/2020,12/15/2020,121520,82L-IMPORT PAYROLL-CHUI KENT,D108,HJ,16.23,,247997.11
6150,12/15/2020,12/15/2020,121520,82L-IMPORT PAYROLL-CHUI KENT,D108,HJ,69.38,,248066.49
6150,12/15/2020,12/15/2020,121520,82L-IMPORT PAYROLL-CIRKER MIA,D108,HJ,32.63,,248099.12
6150,12/15/2020,12/15/2020,121520,82L-IMPORT PAYROLL-CIRKER MIA,D108,HJ,139.5,,248238.62
6150,12/15/2020,12/15/2020,121520,82L-IMPORT PAYROLL-DEWS CAMERYN,D108,HJ,33.23,,248271.85
6150,12/15/2020,12/15/2020,121520,82L-IMPORT PAYROLL-DEWS CAMERYN,D108,HJ,142.08,,248413.93
6150,12/15/2020,12/15/2020,121520,82L-IMPORT PAYROLL-DIETZ MARY,D108,HJ,16.23,,248430.16
6150,12/15/2020,12/15/2020,121520,82L-IMPORT PAYROLL-DIETZ MARY,D108,HJ,35.81,,248465.97
6150,12/15/2020,12/15/2020,121520,82L-IMPORT PAYROLL-DIETZ MARY,D108,HJ,69.38,,248535.35
6150,12/15/2020,12/15/2020,121520,82L-IMPORT PAYROLL-DOMINIQUE PRINCESSA,D108,HJ,16.23,,248551.58
6150,12/15/2020,12/15/2020,121520,82L-IMPORT PAYROLL-DOMINIQUE PRINCESSA,D108,HJ,69.38,,248620.96
6150,12/15/2020,12/15/2020,121520,82L-IMPORT PAYROLL-DONNELLY HOME,D108,HJ,6.94,,248627.9
6150,12/15/2020,12/15/2020,121520,82L-IMPORT PAYROLL-DONNELLY HOME,D108,HJ,16.23,,248644.13
6150,12/15/2020,12/15/2020,121520,82L-IMPORT PAYROLL-DONNELLY HOME,D108,HJ,30.21,,248674.34
6150,12/15/2020,12/15/2020,121520,82L-IMPORT PAYROLL-DONNELLY HOME,D108,HJ,69.38,,248743.72
6150,12/15/2020,12/15/2020,121520,82L-IMPORT PAYROLL-FEIGHERY JOHN,D108,HJ,30.56,,248774.28
6150,12/15/2020,12/15/2020,121520,82L-IMPORT PAYROLL-FEIGHERY JOHN,D108,HJ,130.69,,248904.97
6150,12/15/2020,12/15/2020,121520,82L-IMPORT PAYROLL-FORTH KYLE,D108,HJ,16.23,,248921.2
6150,12/15/2020,12/15/2020,121520,82L-IMPORT PAYROLL-FORTH KYLE,D108,HJ,69.38,,248990.58
6150,12/15/2020,12/15/2020,121520,82L-IMPORT PAYROLL-GARCIA MARILYN,D108,HJ,33.23,,249023.81
6150,12/15/2020,12/15/2020,121520,82L-IMPORT PAYROLL-GARCIA MARILYN,D108,HJ,142.08,,249165.89
6150,12/15/2020,12/15/2020,121520,82L-IMPORT PAYROLL-GREENE BROOKE,D108,HJ,15.28,,249181.17
6150,12/15/2020,12/15/2020,121520,82L-IMPORT PAYROLL-GREENE BROOKE,D108,HJ,65.35,,249246.52
6150,12/15/2020,12/15/2020,121520,82L-IMPORT PAYROLL-GRIFFIN ANDREW,D108,HJ,30.44,,249276.96
6150,12/15/2020,12/15/2020,121520,82L-IMPORT PAYROLL-GRIFFIN ANDREW,D108,HJ,74.25,,249351.21
6150,12/15/2020,12/15/2020,121520,82L-IMPORT PAYROLL-GRIFFIN ANDREW,D108,HJ,130.16,,249481.37
6150,12/15/2020,12/15/2020,121520,82L-IMPORT PAYROLL-GROSS EMILY,D108,HJ,14,,249495.37
6150,12/15/2020,12/15/2020,121520,82L-IMPORT PAYROLL-GROSS EMILY,D108,HJ,59.86,,249555.23
6150,12/15/2020,12/15/2020,121520,82L-IMPORT PAYROLL-GUERRERO LUIS,D108,HJ,16.23,,249571.46
6150,12/15/2020,12/15/2020,121520,82L-IMPORT PAYROLL-GUERRERO LUIS,D108,HJ,69.38,,249640.84
6150,12/15/2020,12/15/2020,121520,82L-IMPORT PAYROLL-HALLINAN GABRIEL,D108,HJ,34.79,,249675.63
6150,12/15/2020,12/15/2020,121520,82L-IMPORT PAYROLL-HALLINAN GABRIEL,D108,HJ,148.76,,249824.39
6150,12/15/2020,12/15/2020,121520,82L-IMPORT PAYROLL-HAMERSLY WILLIAM,D108,HJ,34.16,,249858.55
6150,12/15/2020,12/15/2020,121520,82L-IMPORT PAYROLL-HAMERSLY WILLIAM,D108,HJ,146.08,,250004.63
6150,12/15/2020,12/15/2020,121520,82L-IMPORT PAYROLL-HOSSAIN MYESHA,D108,HJ,35.1,,250039.73
6150,12/15/2020,12/15/2020,121520,82L-IMPORT PAYROLL-HOSSAIN MYESHA,D108,HJ,150.1,,250189.83
6150,12/15/2020,12/15/2020,121520,82L-IMPORT PAYROLL-JACKSON TASNIM F,D108,HJ,31,,250220.83
6150,12/15/2020,12/15/2020,121520,82L-IMPORT PAYROLL-JACKSON TASNIM F,D108,HJ,132.56,,250353.39
6150,12/15/2020,12/15/2020,121520,82L-IMPORT PAYROLL-KERKHOFF HARPER FAITH,D108,HJ,16.23,,250369.62
6150,12/15/2020,12/15/2020,121520,82L-IMPORT PAYROLL-KERKHOFF HARPER FAITH,D108,HJ,30.21,,250399.83
6150,12/15/2020,12/15/2020,121520,82L-IMPORT PAYROLL-KERKHOFF HARPER FAITH,D108,HJ,69.38,,250469.21
6150,12/15/2020,12/15/2020,121520,82L-IMPORT PAYROLL-LEARY AUBREY,D108,HJ,16.2,,250485.41
6150,12/15/2020,12/15/2020,121520,82L-IMPORT PAYROLL-LEARY AUBREY,D108,HJ,69.27,,250554.68
6150,12/15/2020,12/15/2020,121520,82L-IMPORT PAYROLL-LI BELLA,D108,HJ,33.96,,250588.64
6150,12/15/2020,12/15/2020,121520,82L-IMPORT PAYROLL-LI BELLA,D108,HJ,145.23,,250733.87
6150,12/15/2020,12/15/2020,121520,82L-IMPORT PAYROLL-LOUIE JORDAN,D108,HJ,16.23,,250750.1
6150,12/15/2020,12/15/2020,121520,82L-IMPORT PAYROLL-LOUIE JORDAN,D108,HJ,69.38,,250819.48
6150,12/15/2020,12/15/2020,121520,82L-IMPORT PAYROLL-MELCHOR OSBEIDY,D108,HJ,16.23,,250835.71
6150,12/15/2020,12/15/2020,121520,82L-IMPORT PAYROLL-MELCHOR OSBEIDY,D108,HJ,69.38,,250905.09
6150,12/15/2020,12/15/2020,121520,82L-IMPORT PAYROLL-MORRIS ZAKIYA,D108,HJ,16.23,,250921.32
6150,12/15/2020,12/15/2020,121520,82L-IMPORT PAYROLL-MORRIS ZAKIYA,D108,HJ,69.38,,250990.7
6150,12/15/2020,12/15/2020,121520,82L-IMPORT PAYROLL-MORSELETTO RAFAEL,D108,HJ,1.64,,250992.34
6150,12/15/2020,12/15/2020,121520,82L-IMPORT PAYROLL-MORSELETTO RAFAEL,D108,HJ,11.53,,251003.87
6150,12/15/2020,12/15/2020,121520,82L-IMPORT PAYROLL-MORSELETTO RAFAEL,D108,HJ,16.23,,251020.1
6150,12/15/2020,12/15/2020,121520,82L-IMPORT PAYROLL-MORSELETTO RAFAEL,D108,HJ,69.38,,251089.48
6150,12/15/2020,12/15/2020,121520,82L-IMPORT PAYROLL-OBI TOBECHUKWU,D108,HJ,16.23,,251105.71
6150,12/15/2020,12/15/2020,121520,82L-IMPORT PAYROLL-OBI TOBECHUKWU,D108,HJ,69.38,,251175.09
6150,12/15/2020,12/15/2020,121520,82L-IMPORT PAYROLL-OPUH NDIDI,D108,HJ,34.74,,251209.83
6150,12/15/2020,12/15/2020,121520,82L-IMPORT PAYROLL-OPUH NDIDI,D108,HJ,148.53,,251358.36
6150,12/15/2020,12/15/2020,121520,82L-IMPORT PAYROLL-PAULINO THAIRI,D108,HJ,16.23,,251374.59
6150,12/15/2020,12/15/2020,121520,82L-IMPORT PAYROLL-PAULINO THAIRI,D108,HJ,69.38,,251443.97
6150,12/15/2020,12/15/2020,121520,82L-IMPORT PAYROLL-REYES LATIVA M,D108,HJ,35.72,,251479.69
6150,12/15/2020,12/15/2020,121520,82L-IMPORT PAYROLL-REYES LATIVA M,D108,HJ,152.73,,251632.42
6150,12/15/2020,12/15/2020,121520,82L-IMPORT PAYROLL-ROSENBAUM MURRAY,D108,HJ,16.23,,251648.65
6150,12/15/2020,12/15/2020,121520,82L-IMPORT PAYROLL-ROSENBAUM MURRAY,D108,HJ,69.38,,251718.03
6150,12/15/2020,12/15/2020,121520,82L-IMPORT PAYROLL-SCHWETTMANN CLAIRE,D108,HJ,15.28,,251733.31
6150,12/15/2020,12/15/2020,121520,82L-IMPORT PAYROLL-SCHWETTMANN CLAIRE,D108,HJ,65.35,,251798.66
6150,12/15/2020,12/15/2020,121520,82L-IMPORT PAYROLL-SOBELMAN JUSTIN,D108,HJ,15.08,,251813.74
6150,12/15/2020,12/15/2020,121520,82L-IMPORT PAYROLL-SOBELMAN JUSTIN,D108,HJ,64.5,,251878.24
6150,12/15/2020,12/15/2020,121520,82L-IMPORT PAYROLL-TERRENCE-SMITH ZIHIR,D108,HJ,14.32,,251892.56
6150,12/15/2020,12/15/2020,121520,82L-IMPORT PAYROLL-TERRENCE-SMITH ZIHIR,D108,HJ,61.22,,251953.78
6150,12/15/2020,12/15/2020,121520,82L-IMPORT PAYROLL-TILLERY ASIA,D108,HJ,47.73,,252001.51
6150,12/15/2020,12/15/2020,121520,82L-IMPORT PAYROLL-TILLERY ASIA,D108,HJ,204.08,,252205.59
6150,12/15/2020,12/15/2020,121520,82L-IMPORT PAYROLL-WILLIAMS-MASSEY BRIANNA,D108,HJ,16.05,,252221.64
6150,12/15/2020,12/15/2020,121520,82L-IMPORT PAYROLL-WILLIAMS-MASSEY BRIANNA,D108,HJ,36.93,,252258.57
6150,12/15/2020,12/15/2020,121520,82L-IMPORT PAYROLL-WILLIAMS-MASSEY BRIANNA,D108,HJ,68.64,,252327.21
6150,12/15/2020,12/15/2020,121520,82L-IMPORT PAYROLL-XIAO CHENGYAO,D108,HJ,16.23,,252343.44
6150,12/15/2020,12/15/2020,121520,82L-IMPORT PAYROLL-XIAO CHENGYAO,D108,HJ,69.38,,252412.82
6150,12/15/2020,12/15/2020,121520,82L-IMPORT PAYROLL-ZIAUDDIN ABUTAHER,D108,HJ,16.23,,252429.05
6150,12/15/2020,12/15/2020,121520,82L-IMPORT PAYROLL-ZIAUDDIN ABUTAHER,D108,HJ,69.38,,252498.43
6150,12/15/2020,12/15/2020,121520,82L-IMPORT PAYROLL-BALASUBRAMANIAN SHARANYA,D108,HJ,16.53,,252514.96
6150,12/15/2020,12/15/2020,121520,82L-IMPORT PAYROLL-BALASUBRAMANIAN SHARANYA,D108,HJ,38.67,,252553.63
6150,12/15/2020,12/15/2020,121520,82L-IMPORT PAYROLL-BALASUBRAMANIAN SHARANYA,D108,HJ,165.33,,252718.96
6150,12/15/2020,12/15/2020,121520,82L-IMPORT PAYROLL-COVENEY ALLISON,D108,HJ,38.07,,252757.03
6150,12/15/2020,12/15/2020,121520,82L-IMPORT PAYROLL-COVENEY ALLISON,D108,HJ,162.79,,252919.82
6150,12/15/2020,12/15/2020,121520,82L-IMPORT PAYROLL-JACKSON CLAICE M,D108,HJ,19.38,,252939.2
6150,12/15/2020,12/15/2020,121520,82L-IMPORT PAYROLL-JACKSON CLAICE M,D108,HJ,42.91,,252982.11
6150,12/15/2020,12/15/2020,121520,82L-IMPORT PAYROLL-JACKSON CLAICE M,D108,HJ,183.48,,253165.59
6150,12/15/2020,12/15/2020,121520,82L-IMPORT PAYROLL-JANG DANIEL,D108,HJ,37.75,,253203.34
6150,12/15/2020,12/15/2020,121520,82L-IMPORT PAYROLL-JANG DANIEL,D108,HJ,161.4,,253364.74
6150,12/15/2020,12/15/2020,121520,82L-IMPORT PAYROLL-LENEGHAN MARYELLEN,D108,HJ,30.08,,253394.82
6150,12/15/2020,12/15/2020,121520,82L-IMPORT PAYROLL-LENEGHAN MARYELLEN,D108,HJ,36.76,,253431.58
6150,12/15/2020,12/15/2020,121520,82L-IMPORT PAYROLL-LENEGHAN MARYELLEN,D108,HJ,128.6,,253560.18
6150,12/15/2020,12/15/2020,121520,82L-IMPORT PAYROLL-LENEGHAN MARYELLEN,D108,HJ,157.18,,253717.36
6150,12/31/2020,12/31/2020,123120,82L-IMPORT PAYROLL-BARTHELEMY RACHALIE,D108,HJ,17.63,,253734.99
6150,12/31/2020,12/31/2020,123120,82L-IMPORT PAYROLL-BARTHELEMY RACHALIE,D108,HJ,75.39,,253810.38
6150,12/31/2020,12/31/2020,123120,82L-IMPORT PAYROLL-BASHAM WILLIAM EDWARD,D108,HJ,14.06,,253824.44
6150,12/31/2020,12/31/2020,123120,82L-IMPORT PAYROLL-BASHAM WILLIAM EDWARD,D108,HJ,28.29,,253852.73
6150,12/31/2020,12/31/2020,123120,82L-IMPORT PAYROLL-BASHAM WILLIAM EDWARD,D108,HJ,60.11,,253912.84
6150,12/31/2020,12/31/2020,123120,82L-IMPORT PAYROLL-BOHLSEN GRACE ISABELLE,D108,HJ,15.16,,253928
6150,12/31/2020,12/31/2020,123120,82L-IMPORT PAYROLL-BOHLSEN GRACE ISABELLE,D108,HJ,64.84,,253992.84
6150,12/31/2020,12/31/2020,123120,82L-IMPORT PAYROLL-BOLIVAR ANDREA,D108,HJ,36.25,,254029.09
6150,12/31/2020,12/31/2020,123120,82L-IMPORT PAYROLL-BOLIVAR ANDREA,D108,HJ,155,,254184.09
6150,12/31/2020,12/31/2020,123120,82L-IMPORT PAYROLL-BORCHART SPENCER,D108,HJ,15.19,,254199.28
6150,12/31/2020,12/31/2020,123120,82L-IMPORT PAYROLL-BORCHART SPENCER,D108,HJ,44.27,,254243.55
6150,12/31/2020,12/31/2020,123120,82L-IMPORT PAYROLL-BORCHART SPENCER,D108,HJ,64.95,,254308.5
6150,12/31/2020,12/31/2020,123120,82L-IMPORT PAYROLL-BROWN ISAAC,D108,HJ,10.99,,254319.49
6150,12/31/2020,12/31/2020,123120,82L-IMPORT PAYROLL-BROWN ISAAC,D108,HJ,14.01,,254333.5
6150,12/31/2020,12/31/2020,123120,82L-IMPORT PAYROLL-BROWN ISAAC,D108,HJ,59.89,,254393.39
6150,12/31/2020,12/31/2020,123120,82L-IMPORT PAYROLL-BURKE MARIAH,D108,HJ,15.19,,254408.58
6150,12/31/2020,12/31/2020,123120,82L-IMPORT PAYROLL-BURKE MARIAH,D108,HJ,64.95,,254473.53
6150,12/31/2020,12/31/2020,123120,82L-IMPORT PAYROLL-CASSADY JOSHUA LEWIS,D108,HJ,15.19,,254488.72
6150,12/31/2020,12/31/2020,123120,82L-IMPORT PAYROLL-CASSADY JOSHUA LEWIS,D108,HJ,16.71,,254505.43
6150,12/31/2020,12/31/2020,123120,82L-IMPORT PAYROLL-CASSADY JOSHUA LEWIS,D108,HJ,64.95,,254570.38
6150,12/31/2020,12/31/2020,123120,82L-IMPORT PAYROLL-DARKO OLIVIA,D108,HJ,18.82,,254589.2
6150,12/31/2020,12/31/2020,123120,82L-IMPORT PAYROLL-DARKO OLIVIA,D108,HJ,80.45,,254669.65
6150,12/31/2020,12/31/2020,123120,82L-IMPORT PAYROLL-DAWSON JAMIL NAFAYE-BEYAH,D108,HJ,15.19,,254684.84
6150,12/31/2020,12/31/2020,123120,82L-IMPORT PAYROLL-DAWSON JAMIL NAFAYE-BEYAH,D108,HJ,64.95,,254749.79
6150,12/31/2020,12/31/2020,123120,82L-IMPORT PAYROLL-ESCAMILLA OLGA,D108,HJ,15.19,,254764.98
6150,12/31/2020,12/31/2020,123120,82L-IMPORT PAYROLL-ESCAMILLA OLGA,D108,HJ,64.95,,254829.93
6150,12/31/2020,12/31/2020,123120,82L-IMPORT PAYROLL-GARCIA SANTIAGO,D108,HJ,29.6,,254859.53
6150,12/31/2020,12/31/2020,123120,82L-IMPORT PAYROLL-GARCIA SANTIAGO,D108,HJ,126.58,,254986.11
6150,12/31/2020,12/31/2020,123120,82L-IMPORT PAYROLL-GILES SHAYLA,D108,HJ,15.19,,255001.3
6150,12/31/2020,12/31/2020,123120,82L-IMPORT PAYROLL-GILES SHAYLA,D108,HJ,64.95,,255066.25
6150,12/31/2020,12/31/2020,123120,82L-IMPORT PAYROLL-IKUNIKA FUNMILAYO,D108,HJ,30.21,,255096.46
6150,12/31/2020,12/31/2020,123120,82L-IMPORT PAYROLL-IKUNIKA FUNMILAYO,D108,HJ,129.17,,255225.63
6150,12/31/2020,12/31/2020,123120,82L-IMPORT PAYROLL-JONES JORDAN,D108,HJ,15.19,,255240.82
6150,12/31/2020,12/31/2020,123120,82L-IMPORT PAYROLL-JONES JORDAN,D108,HJ,64.95,,255305.77
6150,12/31/2020,12/31/2020,123120,82L-IMPORT PAYROLL-KHAN HUDA,D108,HJ,17.87,,255323.64
6150,12/31/2020,12/31/2020,123120,82L-IMPORT PAYROLL-KHAN HUDA,D108,HJ,76.42,,255400.06
6150,12/31/2020,12/31/2020,123120,82L-IMPORT PAYROLL-KLOHR TIMOTHY JORDAN,D108,HJ,29,,255429.06
6150,12/31/2020,12/31/2020,123120,82L-IMPORT PAYROLL-KLOHR TIMOTHY JORDAN,D108,HJ,124,,255553.06
6150,12/31/2020,12/31/2020,123120,82L-IMPORT PAYROLL-KNOWLIN ZYLIA,D108,HJ,34.63,,255587.69
6150,12/31/2020,12/31/2020,123120,82L-IMPORT PAYROLL-KNOWLIN ZYLIA,D108,HJ,148.06,,255735.75
6150,12/31/2020,12/31/2020,123120,82L-IMPORT PAYROLL-KOPSHEVER MELISSA,D108,HJ,62.46,,255798.21
6150,12/31/2020,12/31/2020,123120,82L-IMPORT PAYROLL-KOPSHEVER MELISSA,D108,HJ,267.07,,256065.28
6150,12/31/2020,12/31/2020,123120,82L-IMPORT PAYROLL-LI SEN YUAN,D108,HJ,14.05,,256079.33
6150,12/31/2020,12/31/2020,123120,82L-IMPORT PAYROLL-LI SEN YUAN,D108,HJ,60.07,,256139.4
6150,12/31/2020,12/31/2020,123120,82L-IMPORT PAYROLL-LIPSCOMB STEPHEN,D108,HJ,33.58,,256172.98
6150,12/31/2020,12/31/2020,123120,82L-IMPORT PAYROLL-LIPSCOMB STEPHEN,D108,HJ,143.59,,256316.57
6150,12/31/2020,12/31/2020,123120,82L-IMPORT PAYROLL-MALLECK JESSICA R,D108,HJ,15.19,,256331.76
6150,12/31/2020,12/31/2020,123120,82L-IMPORT PAYROLL-MALLECK JESSICA R,D108,HJ,64.95,,256396.71
6150,12/31/2020,12/31/2020,123120,82L-IMPORT PAYROLL-MCLAUGHLIN MARA,D108,HJ,15.19,,256411.9
6150,12/31/2020,12/31/2020,123120,82L-IMPORT PAYROLL-MCLAUGHLIN MARA,D108,HJ,22,,256433.9
6150,12/31/2020,12/31/2020,123120,82L-IMPORT PAYROLL-MCLAUGHLIN MARA,D108,HJ,64.95,,256498.85
6150,12/31/2020,12/31/2020,123120,82L-IMPORT PAYROLL-MEJIA ROSO CARLOS,D108,HJ,14.01,,256512.86
6150,12/31/2020,12/31/2020,123120,82L-IMPORT PAYROLL-MEJIA ROSO CARLOS,D108,HJ,59.89,,256572.75
6150,12/31/2020,12/31/2020,123120,82L-IMPORT PAYROLL-MONROY-MEJIA JASON,D108,HJ,15.19,,256587.94
6150,12/31/2020,12/31/2020,123120,82L-IMPORT PAYROLL-MONROY-MEJIA JASON,D108,HJ,64.95,,256652.89
6150,12/31/2020,12/31/2020,123120,82L-IMPORT PAYROLL-O'FLYNN-PRUITT NATHAN COLYAR,D108,HJ,15.19,,256668.08
6150,12/31/2020,12/31/2020,123120,82L-IMPORT PAYROLL-O'FLYNN-PRUITT NATHAN COLYAR,D108,HJ,64.95,,256733.03
6150,12/31/2020,12/31/2020,123120,82L-IMPORT PAYROLL-PATTERSON STEVE,D108,HJ,18.82,,256751.85
6150,12/31/2020,12/31/2020,123120,82L-IMPORT PAYROLL-PATTERSON STEVE,D108,HJ,80.45,,256832.3
6150,12/31/2020,12/31/2020,123120,82L-IMPORT PAYROLL-SCHMIESS RACHEL JOY,D108,HJ,13.24,,256845.54
6150,12/31/2020,12/31/2020,123120,82L-IMPORT PAYROLL-SCHMIESS RACHEL JOY,D108,HJ,18.82,,256864.36
6150,12/31/2020,12/31/2020,123120,82L-IMPORT PAYROLL-SCHMIESS RACHEL JOY,D108,HJ,80.45,,256944.81
6150,12/31/2020,12/31/2020,123120,82L-IMPORT PAYROLL-SCOTT KIRK DONOVAN,D108,HJ,14.05,,256958.86
6150,12/31/2020,12/31/2020,123120,82L-IMPORT PAYROLL-SCOTT KIRK DONOVAN,D108,HJ,60.07,,257018.93
6150,12/31/2020,12/31/2020,123120,82L-IMPORT PAYROLL-SILVER KELLY,D108,HJ,34.63,,257053.56
6150,12/31/2020,12/31/2020,123120,82L-IMPORT PAYROLL-SILVER KELLY,D108,HJ,148.06,,257201.62
6150,12/31/2020,12/31/2020,123120,82L-IMPORT PAYROLL-SOLIMAN MARK,D108,HJ,15.19,,257216.81
6150,12/31/2020,12/31/2020,123120,82L-IMPORT PAYROLL-SOLIMAN MARK,D108,HJ,64.95,,257281.76
6150,12/31/2020,12/31/2020,123120,82L-IMPORT PAYROLL-STEIN KYLE,D108,HJ,27.84,,257309.6
6150,12/31/2020,12/31/2020,123120,82L-IMPORT PAYROLL-STEIN KYLE,D108,HJ,119.05,,257428.65
6150,12/31/2020,12/31/2020,123120,82L-IMPORT PAYROLL-STROUD DAVID,D108,HJ,18.28,,257446.93
6150,12/31/2020,12/31/2020,123120,82L-IMPORT PAYROLL-STROUD DAVID,D108,HJ,78.18,,257525.11
6150,12/31/2020,12/31/2020,123120,82L-IMPORT PAYROLL-VALCIN SABRINA JEMIMAH,D108,HJ,14.25,,257539.36
6150,12/31/2020,12/31/2020,123120,82L-IMPORT PAYROLL-VALCIN SABRINA JEMIMAH,D108,HJ,60.92,,257600.28
6150,12/31/2020,12/31/2020,123120,82L-IMPORT PAYROLL-VALDES ERNEST L,D108,HJ,15.19,,257615.47
6150,12/31/2020,12/31/2020,123120,82L-IMPORT PAYROLL-VALDES ERNEST L,D108,HJ,64.95,,257680.42
6150,12/31/2020,12/31/2020,123120,82L-IMPORT PAYROLL-WILLIAMS MACK ANTHONY,D108,HJ,15.02,,257695.44
6150,12/31/2020,12/31/2020,123120,82L-IMPORT PAYROLL-WILLIAMS MACK ANTHONY,D108,HJ,64.21,,257759.65
6150,12/31/2020,12/31/2020,123120,82L-IMPORT PAYROLL-WILLIAMS MIL'YONTA,D108,HJ,15.19,,257774.84
6150,12/31/2020,12/31/2020,123120,82L-IMPORT PAYROLL-WILLIAMS MIL'YONTA,D108,HJ,64.95,,257839.79
6150,12/31/2020,12/31/2020,123120,82L-IMPORT PAYROLL-ANTHONY BETTY S,D108,HJ,41.85,,257881.64
6150,12/31/2020,12/31/2020,123120,82L-IMPORT PAYROLL-ANTHONY BETTY S,D108,HJ,178.96,,258060.6
6150,12/31/2020,12/31/2020,123120,82L-IMPORT PAYROLL-APULI LINDSAY,D108,HJ,34.16,,258094.76
6150,12/31/2020,12/31/2020,123120,82L-IMPORT PAYROLL-APULI LINDSAY,D108,HJ,146.08,,258240.84
6150,12/31/2020,12/31/2020,123120,82L-IMPORT PAYROLL-AUSTIN PERCY ANTONIO,D108,HJ,36.34,,258277.18
6150,12/31/2020,12/31/2020,123120,82L-IMPORT PAYROLL-AUSTIN PERCY ANTONIO,D108,HJ,155.39,,258432.57
6150,12/31/2020,12/31/2020,123120,82L-IMPORT PAYROLL-BUHMANN JENNIFER,D108,HJ,32.9,,258465.47
6150,12/31/2020,12/31/2020,123120,82L-IMPORT PAYROLL-BUHMANN JENNIFER,D108,HJ,140.68,,258606.15
6150,12/31/2020,12/31/2020,123120,82L-IMPORT PAYROLL-CAIN CORY,D108,HJ,36.32,,258642.47
6150,12/31/2020,12/31/2020,123120,82L-IMPORT PAYROLL-CAIN CORY,D108,HJ,155.3,,258797.77
6150,12/31/2020,12/31/2020,123120,82L-IMPORT PAYROLL-CHAPMAN CLAUDY EARL,D108,HJ,33.03,,258830.8
6150,12/31/2020,12/31/2020,123120,82L-IMPORT PAYROLL-CHAPMAN CLAUDY EARL,D108,HJ,141.23,,258972.03
6150,12/31/2020,12/31/2020,123120,82L-IMPORT PAYROLL-DADA ARIKPO E,D108,HJ,32.04,,259004.07
6150,12/31/2020,12/31/2020,123120,82L-IMPORT PAYROLL-DADA ARIKPO E,D108,HJ,137,,259141.07
6150,12/31/2020,12/31/2020,123120,82L-IMPORT PAYROLL-GUTHRIE LESLIE,D108,HJ,33.42,,259174.49
6150,12/31/2020,12/31/2020,123120,82L-IMPORT PAYROLL-GUTHRIE LESLIE,D108,HJ,142.9,,259317.39
6150,12/31/2020,12/31/2020,123120,82L-IMPORT PAYROLL-HOLMES JOREL ALEXANDER,D108,HJ,31.22,,259348.61
6150,12/31/2020,12/31/2020,123120,82L-IMPORT PAYROLL-HOLMES JOREL ALEXANDER,D108,HJ,133.51,,259482.12
6150,12/31/2020,12/31/2020,123120,82L-IMPORT PAYROLL-JORDAN TIFFANY T,D108,HJ,45.87,,259527.99
6150,12/31/2020,12/31/2020,123120,82L-IMPORT PAYROLL-JORDAN TIFFANY T,D108,HJ,196.13,,259724.12
6150,12/31/2020,12/31/2020,123120,82L-IMPORT PAYROLL-LANIGAN LISA A,D108,HJ,45.1,,259769.22
6150,12/31/2020,12/31/2020,123120,82L-IMPORT PAYROLL-LANIGAN LISA A,D108,HJ,192.83,,259962.05
6150,12/31/2020,12/31/2020,123120,82L-IMPORT PAYROLL-MCELWEE MELISSA,D108,HJ,38.67,,260000.72
6150,12/31/2020,12/31/2020,123120,82L-IMPORT PAYROLL-MCELWEE MELISSA,D108,HJ,165.33,,260166.05
6150,12/31/2020,12/31/2020,123120,82L-IMPORT PAYROLL-MCNICHOLAS MARY,D108,HJ,33.23,,260199.28
6150,12/31/2020,12/31/2020,123120,82L-IMPORT PAYROLL-MCNICHOLAS MARY,D108,HJ,142.08,,260341.36
6150,12/31/2020,12/31/2020,123120,82L-IMPORT PAYROLL-NWAKANMA NANCY,D108,HJ,44.18,,260385.54
6150,12/31/2020,12/31/2020,123120,82L-IMPORT PAYROLL-NWAKANMA NANCY,D108,HJ,188.89,,260574.43
6150,12/31/2020,12/31/2020,123120,82L-IMPORT PAYROLL-ONICA ANTHONY J,D108,HJ,32.86,,260607.29
6150,12/31/2020,12/31/2020,123120,82L-IMPORT PAYROLL-ONICA ANTHONY J,D108,HJ,140.49,,260747.78
6150,12/31/2020,12/31/2020,123120,82L-IMPORT PAYROLL-PRAHIN NICOLE M,D108,HJ,52.91,,260800.69
6150,12/31/2020,12/31/2020,123120,82L-IMPORT PAYROLL-PRAHIN NICOLE M,D108,HJ,226.22,,261026.91
6150,12/31/2020,12/31/2020,123120,82L-IMPORT PAYROLL-RIVERS QUIONNA DIANE,D108,HJ,39.27,,261066.18
6150,12/31/2020,12/31/2020,123120,82L-IMPORT PAYROLL-RIVERS QUIONNA DIANE,D108,HJ,167.92,,261234.1
6150,12/31/2020,12/31/2020,123120,82L-IMPORT PAYROLL-SALIM YASSER,D108,HJ,33.1,,261267.2
6150,12/31/2020,12/31/2020,123120,82L-IMPORT PAYROLL-SALIM YASSER,D108,HJ,141.55,,261408.75
6150,12/31/2020,12/31/2020,123120,82L-IMPORT PAYROLL-SEJOUR MAHALIAH,D108,HJ,34.07,,261442.82
6150,12/31/2020,12/31/2020,123120,82L-IMPORT PAYROLL-SEJOUR MAHALIAH,D108,HJ,145.66,,261588.48
6150,12/31/2020,12/31/2020,123120,82L-IMPORT PAYROLL-SKALSKI CHRISTOPHER,D108,HJ,33.86,,261622.34
6150,12/31/2020,12/31/2020,123120,82L-IMPORT PAYROLL-SKALSKI CHRISTOPHER,D108,HJ,144.76,,261767.1
6150,12/31/2020,12/31/2020,123120,82L-IMPORT PAYROLL-TUMENJARGAL ENKHJIN,D108,HJ,32.92,,261800.02
6150,12/31/2020,12/31/2020,123120,82L-IMPORT PAYROLL-TUMENJARGAL ENKHJIN,D108,HJ,140.75,,261940.77
6150,12/31/2020,12/31/2020,123120,82L-IMPORT PAYROLL-VILLEGAS EVELYN,D108,HJ,33.4,,261974.17
6150,12/31/2020,12/31/2020,123120,82L-IMPORT PAYROLL-VILLEGAS EVELYN,D108,HJ,142.81,,262116.98
6150,12/31/2020,12/31/2020,123120,82L-IMPORT PAYROLL-WOLF ANNA A,D108,HJ,36.3,,262153.28
6150,12/31/2020,12/31/2020,123120,82L-IMPORT PAYROLL-WOLF ANNA A,D108,HJ,155.19,,262308.47
6150,12/31/2020,12/31/2020,123120,82L-IMPORT PAYROLL-ACEVEDO MONIVETT,D107,HJ,5.79,,262314.26
6150,12/31/2020,12/31/2020,123120,82L-IMPORT PAYROLL-ACEVEDO MONIVETT,D107,HJ,24.77,,262339.03
6150,12/31/2020,12/31/2020,123120,82L-IMPORT PAYROLL-ACEVEDO MONIVETT,D107,HJ,66.63,,262405.66
6150,12/31/2020,12/31/2020,123120,82L-IMPORT PAYROLL-ACEVEDO MONIVETT,D107,HJ,284.87,,262690.53
6150,12/31/2020,12/31/2020,123120,82L-IMPORT PAYROLL-AKLESTAD ISABEL,D111,HJ,24.01,,262714.54
6150,12/31/2020,12/31/2020,123120,82L-IMPORT PAYROLL-AKLESTAD ISABEL,D111,HJ,102.68,,262817.22
6150,12/31/2020,12/31/2020,123120,82L-IMPORT PAYROLL-BIBB TIFFANI,D104,HJ,49.71,,262866.93
6150,12/31/2020,12/31/2020,123120,82L-IMPORT PAYROLL-BIBB TIFFANI,D104,HJ,212.55,,263079.48
6150,12/31/2020,12/31/2020,123120,82L-IMPORT PAYROLL-BOWMAN HALLEY K,D101,HJ,63.83,,263143.31
6150,12/31/2020,12/31/2020,123120,82L-IMPORT PAYROLL-BOWMAN HALLEY K,D101,HJ,272.94,,263416.25
6150,12/31/2020,12/31/2020,123120,82L-IMPORT PAYROLL-COOK CATHRYN ANNA,D105,HJ,49.87,,263466.12
6150,12/31/2020,12/31/2020,123120,82L-IMPORT PAYROLL-COOK CATHRYN ANNA,D105,HJ,213.25,,263679.37
6150,12/31/2020,12/31/2020,123120,82L-IMPORT PAYROLL-COOPER ASHLEE R,D101,HJ,33.51,,263712.88
6150,12/31/2020,12/31/2020,123120,82L-IMPORT PAYROLL-COOPER ASHLEE R,D101,HJ,143.3,,263856.18
6150,12/31/2020,12/31/2020,123120,82L-IMPORT PAYROLL-CORTEZ MIRANDA A,D111,HJ,39.18,,263895.36
6150,12/31/2020,12/31/2020,123120,82L-IMPORT PAYROLL-CORTEZ MIRANDA A,D111,HJ,167.52,,264062.88
6150,12/31/2020,12/31/2020,123120,82L-IMPORT PAYROLL-DAUGHERTY DEVIN W,D101,HJ,15.1,,264077.98
6150,12/31/2020,12/31/2020,123120,82L-IMPORT PAYROLL-DAUGHERTY DEVIN W,D101,HJ,64.58,,264142.56
6150,12/31/2020,12/31/2020,123120,82L-IMPORT PAYROLL-DETONE KYRA MAYA,D102,HJ,39,,264181.56
6150,12/31/2020,12/31/2020,123120,82L-IMPORT PAYROLL-DETONE KYRA MAYA,D102,HJ,166.75,,264348.31
6150,12/31/2020,12/31/2020,123120,82L-IMPORT PAYROLL-DUPUIS CHRISTOPHER M,D107,HJ,21.3,,264369.61
6150,12/31/2020,12/31/2020,123120,82L-IMPORT PAYROLL-DUPUIS CHRISTOPHER M,D107,HJ,29.09,,264398.7
6150,12/31/2020,12/31/2020,123120,82L-IMPORT PAYROLL-DUPUIS CHRISTOPHER M,D107,HJ,67.44,,264466.14
6150,12/31/2020,12/31/2020,123120,82L-IMPORT PAYROLL-DUPUIS CHRISTOPHER M,D107,HJ,92.1,,264558.24
6150,12/31/2020,12/31/2020,123120,82L-IMPORT PAYROLL-DZIEDZIC JULIE K,D101,HJ,17.71,,264575.95
6150,12/31/2020,12/31/2020,123120,82L-IMPORT PAYROLL-DZIEDZIC JULIE K,D101,HJ,75.71,,264651.66
6150,12/31/2020,12/31/2020,123120,82L-IMPORT PAYROLL-FISCHABER THOMAS,D109,HJ,77.9,,264729.56
6150,12/31/2020,12/31/2020,123120,82L-IMPORT PAYROLL-FISCHABER THOMAS,D109,HJ,333.1,,265062.66
6150,12/31/2020,12/31/2020,123120,82L-IMPORT PAYROLL-FLORY MEGAN,D109,HJ,21.75,,265084.41
6150,12/31/2020,12/31/2020,123120,82L-IMPORT PAYROLL-FLORY MEGAN,D109,HJ,25.5,,265109.91
6150,12/31/2020,12/31/2020,123120,82L-IMPORT PAYROLL-FLORY MEGAN,D109,HJ,93,,265202.91
6150,12/31/2020,12/31/2020,123120,82L-IMPORT PAYROLL-GORNSTEIN STEVEN,D101,HJ,39.27,,265242.18
6150,12/31/2020,12/31/2020,123120,82L-IMPORT PAYROLL-GORNSTEIN STEVEN,D101,HJ,167.92,,265410.1
6150,12/31/2020,12/31/2020,123120,82L-IMPORT PAYROLL-GUADARRAMA-ALVAREZ URIEL A,D105,HJ,39.93,,265450.03
6150,12/31/2020,12/31/2020,123120,82L-IMPORT PAYROLL-GUADARRAMA-ALVAREZ URIEL A,D105,HJ,170.75,,265620.78
6150,12/31/2020,12/31/2020,123120,82L-IMPORT PAYROLL-GUTIERREZ ANTONIO J,D107,HJ,76.65,,265697.43
6150,12/31/2020,12/31/2020,123120,82L-IMPORT PAYROLL-GUTIERREZ ANTONIO J,D107,HJ,327.76,,266025.19
6150,12/31/2020,12/31/2020,123120,82L-IMPORT PAYROLL-HENRY GILLIAN,D102,HJ,29.17,,266054.36
6150,12/31/2020,12/31/2020,123120,82L-IMPORT PAYROLL-HENRY GILLIAN,D102,HJ,124.74,,266179.1
6150,12/31/2020,12/31/2020,123120,82L-IMPORT PAYROLL-HERMAN ADAM,D102,HJ,28.2,,266207.3
6150,12/31/2020,12/31/2020,123120,82L-IMPORT PAYROLL-HERMAN ADAM,D102,HJ,120.56,,266327.86
6150,12/31/2020,12/31/2020,123120,82L-IMPORT PAYROLL-HESTER TYLER CONRAD,D105,HJ,27.79,,266355.65
6150,12/31/2020,12/31/2020,123120,82L-IMPORT PAYROLL-HESTER TYLER CONRAD,D105,HJ,118.83,,266474.48
6150,12/31/2020,12/31/2020,123120,82L-IMPORT PAYROLL-HOLT ADAM,D109,HJ,58.24,,266532.72
6150,12/31/2020,12/31/2020,123120,82L-IMPORT PAYROLL-HOLT ADAM,D109,HJ,249.03,,266781.75
6150,12/31/2020,12/31/2020,123120,82L-IMPORT PAYROLL-KELLY SEAN,D109,HJ,78.54,,266860.29
6150,12/31/2020,12/31/2020,123120,82L-IMPORT PAYROLL-KELLY SEAN,D109,HJ,335.83,,267196.12
6150,12/31/2020,12/31/2020,123120,82L-IMPORT PAYROLL-KRUGER MARK,D109,HJ,72.5,,267268.62
6150,12/31/2020,12/31/2020,123120,82L-IMPORT PAYROLL-KRUGER MARK,D109,HJ,310,,267578.62
6150,12/31/2020,12/31/2020,123120,82L-IMPORT PAYROLL-LIPORACE HERNAN LUIS,D103,HJ,33.06,,267611.68
6150,12/31/2020,12/31/2020,123120,82L-IMPORT PAYROLL-LIPORACE HERNAN LUIS,D103,HJ,141.34,,267753.02
6150,12/31/2020,12/31/2020,123120,82L-IMPORT PAYROLL-MARKS KRISTA,D109,HJ,76.2,,267829.22
6150,12/31/2020,12/31/2020,123120,82L-IMPORT PAYROLL-MARKS KRISTA,D109,HJ,325.8,,268155.02
6150,12/31/2020,12/31/2020,123120,82L-IMPORT PAYROLL-MELVIN DARNELL KEVIN,D109,HJ,55.91,,268210.93
6150,12/31/2020,12/31/2020,123120,82L-IMPORT PAYROLL-MELVIN DARNELL KEVIN,D109,HJ,239.08,,268450.01
6150,12/31/2020,12/31/2020,123120,82L-IMPORT PAYROLL-MESSING JENNIFER,D109,HJ,34.12,,268484.13
6150,12/31/2020,12/31/2020,123120,82L-IMPORT PAYROLL-MESSING JENNIFER,D109,HJ,145.9,,268630.03
6150,12/31/2020,12/31/2020,123120,82L-IMPORT PAYROLL-MILNE ROGER,D109,HJ,76.2,,268706.23
6150,12/31/2020,12/31/2020,123120,82L-IMPORT PAYROLL-MILNE ROGER,D109,HJ,325.8,,269032.03
6150,12/31/2020,12/31/2020,123120,82L-IMPORT PAYROLL-MOSTAFAVI YASAMAN,D109,HJ,8.93,,269040.96
6150,12/31/2020,12/31/2020,123120,82L-IMPORT PAYROLL-MOSTAFAVI YASAMAN,D109,HJ,14.64,,269055.6
6150,12/31/2020,12/31/2020,123120,82L-IMPORT PAYROLL-MOSTAFAVI YASAMAN,D109,HJ,38.19,,269093.79
6150,12/31/2020,12/31/2020,123120,82L-IMPORT PAYROLL-O'DONNELL STEPHEN,D104,HJ,39.26,,269133.05
6150,12/31/2020,12/31/2020,123120,82L-IMPORT PAYROLL-O'DONNELL STEPHEN,D104,HJ,67.69,,269200.74
6150,12/31/2020,12/31/2020,123120,82L-IMPORT PAYROLL-O'DONNELL STEPHEN,D104,HJ,167.87,,269368.61
6150,12/31/2020,12/31/2020,123120,82L-IMPORT PAYROLL-PARETS MALLORY GRACE,D101,HJ,17.57,,269386.18
6150,12/31/2020,12/31/2020,123120,82L-IMPORT PAYROLL-PARETS MALLORY GRACE,D101,HJ,41.08,,269427.26
6150,12/31/2020,12/31/2020,123120,82L-IMPORT PAYROLL-PARETS MALLORY GRACE,D101,HJ,175.67,,269602.93
6150,12/31/2020,12/31/2020,123120,82L-IMPORT PAYROLL-PARHAM-GANTT DENISE M,D112,HJ,37.96,,269640.89
6150,12/31/2020,12/31/2020,123120,82L-IMPORT PAYROLL-PARHAM-GANTT DENISE M,D112,HJ,162.32,,269803.21
6150,12/31/2020,12/31/2020,123120,82L-IMPORT PAYROLL-PEINADO ELIZABETH R,D111,HJ,53.01,,269856.22
6150,12/31/2020,12/31/2020,123120,82L-IMPORT PAYROLL-PEINADO ELIZABETH R,D111,HJ,226.68,,270082.9
6150,12/31/2020,12/31/2020,123120,82L-IMPORT PAYROLL-PERNIA JEFFREY,D109,HJ,56.19,,270139.09
6150,12/31/2020,12/31/2020,123120,82L-IMPORT PAYROLL-PERNIA JEFFREY,D109,HJ,240.25,,270379.34
6150,12/31/2020,12/31/2020,123120,82L-IMPORT PAYROLL-POLANCO ODALIS,D103,HJ,43.23,,270422.57
6150,12/31/2020,12/31/2020,123120,82L-IMPORT PAYROLL-POLANCO ODALIS,D103,HJ,184.83,,270607.4
6150,12/31/2020,12/31/2020,123120,82L-IMPORT PAYROLL-QUINTAS JASHIVE,D105,HJ,25.57,,270632.97
6150,12/31/2020,12/31/2020,123120,82L-IMPORT PAYROLL-QUINTAS JASHIVE,D105,HJ,109.31,,270742.28
6150,12/31/2020,12/31/2020,123120,82L-IMPORT PAYROLL-RANDOLPH ALEXANDER,D111,HJ,11.94,,270754.22
6150,12/31/2020,12/31/2020,123120,82L-IMPORT PAYROLL-RANDOLPH ALEXANDER,D111,HJ,25.83,,270780.05
6150,12/31/2020,12/31/2020,123120,82L-IMPORT PAYROLL-RANDOLPH ALEXANDER,D111,HJ,110.43,,270890.48
6150,12/31/2020,12/31/2020,123120,82L-IMPORT PAYROLL-RUBI PERLA,D101,HJ,15.92,,270906.4
6150,12/31/2020,12/31/2020,123120,82L-IMPORT PAYROLL-RUBI PERLA,D101,HJ,68.09,,270974.49
6150,12/31/2020,12/31/2020,123120,82L-IMPORT PAYROLL-SAFRAN ALAN P,D107,HJ,8.28,,270982.77
6150,12/31/2020,12/31/2020,123120,82L-IMPORT PAYROLL-SAFRAN ALAN P,D107,HJ,95.24,,271078.01
6150,12/31/2020,12/31/2020,123120,82L-IMPORT PAYROLL-SHENKMAN OLIVIA,D101,HJ,29,,271107.01
6150,12/31/2020,12/31/2020,123120,82L-IMPORT PAYROLL-SHENKMAN OLIVIA,D101,HJ,124,,271231.01
6150,12/31/2020,12/31/2020,123120,82L-IMPORT PAYROLL-SHI GRACE,D103,HJ,12.69,,271243.7
6150,12/31/2020,12/31/2020,123120,82L-IMPORT PAYROLL-SHI GRACE,D103,HJ,54.25,,271297.95
6150,12/31/2020,12/31/2020,123120,82L-IMPORT PAYROLL-WALLACE AMENA,D104,HJ,28.93,,271326.88
6150,12/31/2020,12/31/2020,123120,82L-IMPORT PAYROLL-WALLACE AMENA,D104,HJ,123.72,,271450.6
6150,12/31/2020,12/31/2020,123120,82L-IMPORT PAYROLL-WARD JEFFREY,D109,HJ,78.54,,271529.14
6150,12/31/2020,12/31/2020,123120,82L-IMPORT PAYROLL-WARD JEFFREY,D109,HJ,335.83,,271864.97
6150,12/31/2020,12/31/2020,123120,82L-IMPORT PAYROLL-WARD JENNIFER,D109,HJ,15.43,,271880.4
6150,12/31/2020,12/31/2020,123120,82L-IMPORT PAYROLL-WARD JENNIFER,D109,HJ,18.09,,271898.49
6150,12/31/2020,12/31/2020,123120,82L-IMPORT PAYROLL-WARD JENNIFER,D109,HJ,65.99,,271964.48
6150,12/31/2020,12/31/2020,123120,82L-IMPORT PAYROLL-WEINSTOCK EMILY,D101,HJ,17.57,,271982.05
6150,12/31/2020,12/31/2020,123120,82L-IMPORT PAYROLL-WEINSTOCK EMILY,D101,HJ,38.11,,272020.16
6150,12/31/2020,12/31/2020,123120,82L-IMPORT PAYROLL-WEINSTOCK EMILY,D101,HJ,162.94,,272183.1
6150,12/31/2020,12/31/2020,123120,82L-IMPORT PAYROLL-WINANS JENNIFER,D111,HJ,37.06,,272220.16
6150,12/31/2020,12/31/2020,123120,82L-IMPORT PAYROLL-WINANS JENNIFER,D111,HJ,158.45,,272378.61
6150,12/31/2020,12/31/2020,123120,82L-IMPORT PAYROLL-ZARATE JOSEPH M,D105,HJ,31.18,,272409.79
6150,12/31/2020,12/31/2020,123120,82L-IMPORT PAYROLL-ZARATE JOSEPH M,D105,HJ,133.3,,272543.09
6150,12/31/2020,12/31/2020,123120,82L-IMPORT PAYROLL-AGUANNO JOSEPH,D108,HJ,19.85,,272562.94
6150,12/31/2020,12/31/2020,123120,82L-IMPORT PAYROLL-AGUANNO JOSEPH,D108,HJ,84.88,,272647.82
6150,12/31/2020,12/31/2020,123120,82L-IMPORT PAYROLL-AKESODE FEHINTOLA,D108,HJ,19.85,,272667.67
6150,12/31/2020,12/31/2020,123120,82L-IMPORT PAYROLL-AKESODE FEHINTOLA,D108,HJ,84.88,,272752.55
6150,12/31/2020,12/31/2020,123120,82L-IMPORT PAYROLL-BARTOLD DEANNA MARIE,D108,HJ,41.91,,272794.46
6150,12/31/2020,12/31/2020,123120,82L-IMPORT PAYROLL-BARTOLD DEANNA MARIE,D108,HJ,179.22,,272973.68
6150,12/31/2020,12/31/2020,123120,82L-IMPORT PAYROLL-BELLOT GENESIS,D108,HJ,32.36,,273006.04
6150,12/31/2020,12/31/2020,123120,82L-IMPORT PAYROLL-BELLOT GENESIS,D108,HJ,138.38,,273144.42
6150,12/31/2020,12/31/2020,123120,82L-IMPORT PAYROLL-BENNETT JAMES H,D108,HJ,19.85,,273164.27
6150,12/31/2020,12/31/2020,123120,82L-IMPORT PAYROLL-BENNETT JAMES H,D108,HJ,84.88,,273249.15
6150,12/31/2020,12/31/2020,123120,82L-IMPORT PAYROLL-BOWMAN ABIGAIL,D108,HJ,19.85,,273269
6150,12/31/2020,12/31/2020,123120,82L-IMPORT PAYROLL-BOWMAN ABIGAIL,D108,HJ,84.88,,273353.88
6150,12/31/2020,12/31/2020,123120,82L-IMPORT PAYROLL-BURRELL RUSSELL,D108,HJ,18.71,,273372.59
6150,12/31/2020,12/31/2020,123120,82L-IMPORT PAYROLL-BURRELL RUSSELL,D108,HJ,23.29,,273395.88
6150,12/31/2020,12/31/2020,123120,82L-IMPORT PAYROLL-BURRELL RUSSELL,D108,HJ,80,,273475.88
6150,12/31/2020,12/31/2020,123120,82L-IMPORT PAYROLL-CHUI KENT,D108,HJ,19.85,,273495.73
6150,12/31/2020,12/31/2020,123120,82L-IMPORT PAYROLL-CHUI KENT,D108,HJ,84.88,,273580.61
6150,12/31/2020,12/31/2020,123120,82L-IMPORT PAYROLL-CIRKER MIA,D108,HJ,32.63,,273613.24
6150,12/31/2020,12/31/2020,123120,82L-IMPORT PAYROLL-CIRKER MIA,D108,HJ,139.5,,273752.74
6150,12/31/2020,12/31/2020,123120,82L-IMPORT PAYROLL-DEWS CAMERYN,D108,HJ,54.98,,273807.72
6150,12/31/2020,12/31/2020,123120,82L-IMPORT PAYROLL-DEWS CAMERYN,D108,HJ,235.08,,274042.8
6150,12/31/2020,12/31/2020,123120,82L-IMPORT PAYROLL-DIETZ MARY,D108,HJ,16.23,,274059.03
6150,12/31/2020,12/31/2020,123120,82L-IMPORT PAYROLL-DIETZ MARY,D108,HJ,35.81,,274094.84
6150,12/31/2020,12/31/2020,123120,82L-IMPORT PAYROLL-DIETZ MARY,D108,HJ,69.38,,274164.22
6150,12/31/2020,12/31/2020,123120,82L-IMPORT PAYROLL-DOMINIQUE PRINCESSA,D108,HJ,19.85,,274184.07
6150,12/31/2020,12/31/2020,123120,82L-IMPORT PAYROLL-DOMINIQUE PRINCESSA,D108,HJ,84.88,,274268.95
6150,12/31/2020,12/31/2020,123120,82L-IMPORT PAYROLL-DONNELLY HOME,D108,HJ,1.29,,274270.24
6150,12/31/2020,12/31/2020,123120,82L-IMPORT PAYROLL-DONNELLY HOME,D108,HJ,6.94,,274277.18
6150,12/31/2020,12/31/2020,123120,82L-IMPORT PAYROLL-DONNELLY HOME,D108,HJ,16.23,,274293.41
6150,12/31/2020,12/31/2020,123120,82L-IMPORT PAYROLL-DONNELLY HOME,D108,HJ,69.38,,274362.79
6150,12/31/2020,12/31/2020,123120,82L-IMPORT PAYROLL-FEIGHERY JOHN,D108,HJ,30.56,,274393.35
6150,12/31/2020,12/31/2020,123120,82L-IMPORT PAYROLL-FEIGHERY JOHN,D108,HJ,130.69,,274524.04
6150,12/31/2020,12/31/2020,123120,82L-IMPORT PAYROLL-FORTH KYLE,D108,HJ,19.85,,274543.89
6150,12/31/2020,12/31/2020,123120,82L-IMPORT PAYROLL-FORTH KYLE,D108,HJ,84.88,,274628.77
6150,12/31/2020,12/31/2020,123120,82L-IMPORT PAYROLL-GARCIA MARILYN,D108,HJ,33.23,,274662
6150,12/31/2020,12/31/2020,123120,82L-IMPORT PAYROLL-GARCIA MARILYN,D108,HJ,142.08,,274804.08
6150,12/31/2020,12/31/2020,123120,82L-IMPORT PAYROLL-GREENE BROOKE,D108,HJ,15.28,,274819.36
6150,12/31/2020,12/31/2020,123120,82L-IMPORT PAYROLL-GREENE BROOKE,D108,HJ,65.35,,274884.71
6150,12/31/2020,12/31/2020,123120,82L-IMPORT PAYROLL-GRIFFIN ANDREW,D108,HJ,30.44,,274915.15
6150,12/31/2020,12/31/2020,123120,82L-IMPORT PAYROLL-GRIFFIN ANDREW,D108,HJ,74.25,,274989.4
6150,12/31/2020,12/31/2020,123120,82L-IMPORT PAYROLL-GRIFFIN ANDREW,D108,HJ,130.16,,275119.56
6150,12/31/2020,12/31/2020,123120,82L-IMPORT PAYROLL-GROSS EMILY,D108,HJ,17.63,,275137.19
6150,12/31/2020,12/31/2020,123120,82L-IMPORT PAYROLL-GROSS EMILY,D108,HJ,75.36,,275212.55
6150,12/31/2020,12/31/2020,123120,82L-IMPORT PAYROLL-GUERRERO LUIS,D108,HJ,16.23,,275228.78
6150,12/31/2020,12/31/2020,123120,82L-IMPORT PAYROLL-GUERRERO LUIS,D108,HJ,69.38,,275298.16
6150,12/31/2020,12/31/2020,123120,82L-IMPORT PAYROLL-HALLINAN GABRIEL,D108,HJ,34.79,,275332.95
6150,12/31/2020,12/31/2020,123120,82L-IMPORT PAYROLL-HALLINAN GABRIEL,D108,HJ,148.76,,275481.71
6150,12/31/2020,12/31/2020,123120,82L-IMPORT PAYROLL-HAMERSLY WILLIAM,D108,HJ,34.16,,275515.87
6150,12/31/2020,12/31/2020,123120,82L-IMPORT PAYROLL-HAMERSLY WILLIAM,D108,HJ,146.08,,275661.95
6150,12/31/2020,12/31/2020,123120,82L-IMPORT PAYROLL-HOSSAIN MYESHA,D108,HJ,35.1,,275697.05
6150,12/31/2020,12/31/2020,123120,82L-IMPORT PAYROLL-HOSSAIN MYESHA,D108,HJ,150.1,,275847.15
6150,12/31/2020,12/31/2020,123120,82L-IMPORT PAYROLL-JACKSON TASNIM F,D108,HJ,31,,275878.15
6150,12/31/2020,12/31/2020,123120,82L-IMPORT PAYROLL-JACKSON TASNIM F,D108,HJ,132.56,,276010.71
6150,12/31/2020,12/31/2020,123120,82L-IMPORT PAYROLL-KERKHOFF HARPER FAITH,D108,HJ,1.29,,276012
6150,12/31/2020,12/31/2020,123120,82L-IMPORT PAYROLL-KERKHOFF HARPER FAITH,D108,HJ,16.23,,276028.23
6150,12/31/2020,12/31/2020,123120,82L-IMPORT PAYROLL-KERKHOFF HARPER FAITH,D108,HJ,69.38,,276097.61
6150,12/31/2020,12/31/2020,123120,82L-IMPORT PAYROLL-LEARY AUBREY,D108,HJ,16.2,,276113.81
6150,12/31/2020,12/31/2020,123120,82L-IMPORT PAYROLL-LEARY AUBREY,D108,HJ,69.27,,276183.08
6150,12/31/2020,12/31/2020,123120,82L-IMPORT PAYROLL-LI BELLA,D108,HJ,33.96,,276217.04
6150,12/31/2020,12/31/2020,123120,82L-IMPORT PAYROLL-LI BELLA,D108,HJ,145.23,,276362.27
6150,12/31/2020,12/31/2020,123120,82L-IMPORT PAYROLL-LOUIE JORDAN,D108,HJ,19.85,,276382.12
6150,12/31/2020,12/31/2020,123120,82L-IMPORT PAYROLL-LOUIE JORDAN,D108,HJ,84.88,,276467
6150,12/31/2020,12/31/2020,123120,82L-IMPORT PAYROLL-MELCHOR OSBEIDY,D108,HJ,19.85,,276486.85
6150,12/31/2020,12/31/2020,123120,82L-IMPORT PAYROLL-MELCHOR OSBEIDY,D108,HJ,84.88,,276571.73
6150,12/31/2020,12/31/2020,123120,82L-IMPORT PAYROLL-MORRIS ZAKIYA,D108,HJ,19.85,,276591.58
6150,12/31/2020,12/31/2020,123120,82L-IMPORT PAYROLL-MORRIS ZAKIYA,D108,HJ,84.88,,276676.46
6150,12/31/2020,12/31/2020,123120,82L-IMPORT PAYROLL-MORSELETTO RAFAEL,D108,HJ,1.64,,276678.1
6150,12/31/2020,12/31/2020,123120,82L-IMPORT PAYROLL-MORSELETTO RAFAEL,D108,HJ,11.53,,276689.63
6150,12/31/2020,12/31/2020,123120,82L-IMPORT PAYROLL-MORSELETTO RAFAEL,D108,HJ,16.23,,276705.86
6150,12/31/2020,12/31/2020,123120,82L-IMPORT PAYROLL-MORSELETTO RAFAEL,D108,HJ,69.38,,276775.24
6150,12/31/2020,12/31/2020,123120,82L-IMPORT PAYROLL-OBI TOBECHUKWU,D108,HJ,19.85,,276795.09
6150,12/31/2020,12/31/2020,123120,82L-IMPORT PAYROLL-OBI TOBECHUKWU,D108,HJ,84.88,,276879.97
6150,12/31/2020,12/31/2020,123120,82L-IMPORT PAYROLL-OPUH NDIDI,D108,HJ,34.74,,276914.71
6150,12/31/2020,12/31/2020,123120,82L-IMPORT PAYROLL-OPUH NDIDI,D108,HJ,148.53,,277063.24
6150,12/31/2020,12/31/2020,123120,82L-IMPORT PAYROLL-PAULINO THAIRI,D108,HJ,19.85,,277083.09
6150,12/31/2020,12/31/2020,123120,82L-IMPORT PAYROLL-PAULINO THAIRI,D108,HJ,84.88,,277167.97
6150,12/31/2020,12/31/2020,123120,82L-IMPORT PAYROLL-REYES LATIVA M,D108,HJ,30.62,,277198.59
6150,12/31/2020,12/31/2020,123120,82L-IMPORT PAYROLL-REYES LATIVA M,D108,HJ,130.91,,277329.5
6150,12/31/2020,12/31/2020,123120,82L-IMPORT PAYROLL-ROSENBAUM MURRAY,D108,HJ,19.85,,277349.35
6150,12/31/2020,12/31/2020,123120,82L-IMPORT PAYROLL-ROSENBAUM MURRAY,D108,HJ,84.88,,277434.23
6150,12/31/2020,12/31/2020,123120,82L-IMPORT PAYROLL-SCHWETTMANN CLAIRE,D108,HJ,18.91,,277453.14
6150,12/31/2020,12/31/2020,123120,82L-IMPORT PAYROLL-SCHWETTMANN CLAIRE,D108,HJ,80.85,,277533.99
6150,12/31/2020,12/31/2020,123120,82L-IMPORT PAYROLL-SOBELMAN JUSTIN,D108,HJ,15.08,,277549.07
6150,12/31/2020,12/31/2020,123120,82L-IMPORT PAYROLL-SOBELMAN JUSTIN,D108,HJ,64.5,,277613.57
6150,12/31/2020,12/31/2020,123120,82L-IMPORT PAYROLL-TERRENCE-SMITH ZIHIR,D108,HJ,17.94,,277631.51
6150,12/31/2020,12/31/2020,123120,82L-IMPORT PAYROLL-TERRENCE-SMITH ZIHIR,D108,HJ,76.72,,277708.23
6150,12/31/2020,12/31/2020,123120,82L-IMPORT PAYROLL-TILLERY ASIA,D108,HJ,47.73,,277755.96
6150,12/31/2020,12/31/2020,123120,82L-IMPORT PAYROLL-TILLERY ASIA,D108,HJ,204.08,,277960.04
6150,12/31/2020,12/31/2020,123120,82L-IMPORT PAYROLL-WILLIAMS-MASSEY BRIANNA,D108,HJ,16.05,,277976.09
6150,12/31/2020,12/31/2020,123120,82L-IMPORT PAYROLL-WILLIAMS-MASSEY BRIANNA,D108,HJ,36.93,,278013.02
6150,12/31/2020,12/31/2020,123120,82L-IMPORT PAYROLL-WILLIAMS-MASSEY BRIANNA,D108,HJ,68.64,,278081.66
6150,12/31/2020,12/31/2020,123120,82L-IMPORT PAYROLL-XIAO CHENGYAO,D108,HJ,19.85,,278101.51
6150,12/31/2020,12/31/2020,123120,82L-IMPORT PAYROLL-XIAO CHENGYAO,D108,HJ,84.88,,278186.39
6150,12/31/2020,12/31/2020,123120,82L-IMPORT PAYROLL-ZIAUDDIN ABUTAHER,D108,HJ,19.85,,278206.24
6150,12/31/2020,12/31/2020,123120,82L-IMPORT PAYROLL-ZIAUDDIN ABUTAHER,D108,HJ,84.88,,278291.12
6150,12/31/2020,12/31/2020,123120,82L-IMPORT PAYROLL-BALASUBRAMANIAN SHARANYA,D108,HJ,16.53,,278307.65
6150,12/31/2020,12/31/2020,123120,82L-IMPORT PAYROLL-BALASUBRAMANIAN SHARANYA,D108,HJ,38.67,,278346.32
6150,12/31/2020,12/31/2020,123120,82L-IMPORT PAYROLL-BALASUBRAMANIAN SHARANYA,D108,HJ,165.33,,278511.65
6150,12/31/2020,12/31/2020,123120,82L-IMPORT PAYROLL-COVENEY ALLISON,D108,HJ,38.07,,278549.72
6150,12/31/2020,12/31/2020,123120,82L-IMPORT PAYROLL-COVENEY ALLISON,D108,HJ,162.79,,278712.51
6150,12/31/2020,12/31/2020,123120,82L-IMPORT PAYROLL-JACKSON CLAICE M,D108,HJ,19.38,,278731.89
6150,12/31/2020,12/31/2020,123120,82L-IMPORT PAYROLL-JACKSON CLAICE M,D108,HJ,42.91,,278774.8
6150,12/31/2020,12/31/2020,123120,82L-IMPORT PAYROLL-JACKSON CLAICE M,D108,HJ,183.48,,278958.28
6150,12/31/2020,12/31/2020,123120,82L-IMPORT PAYROLL-JANG DANIEL,D108,HJ,37.75,,278996.03
6150,12/31/2020,12/31/2020,123120,82L-IMPORT PAYROLL-JANG DANIEL,D108,HJ,161.4,,279157.43
6150,12/31/2020,12/31/2020,123120,82L-IMPORT PAYROLL-LENEGHAN MARYELLEN,D108,HJ,66.84,,279224.27
6150,12/31/2020,12/31/2020,123120,82L-IMPORT PAYROLL-LENEGHAN MARYELLEN,D108,HJ,285.78,,279510.05
6150,1/15/2021,1/15/2021,11521,82L-IMPORT PAYROLL-BARTHELEMY RACHALIE,D108,HJ,14.01,,279524.06
6150,1/15/2021,1/15/2021,11521,82L-IMPORT PAYROLL-BARTHELEMY RACHALIE,D108,HJ,26.08,,279550.14
6150,1/15/2021,1/15/2021,11521,82L-IMPORT PAYROLL-BARTHELEMY RACHALIE,D108,HJ,59.89,,279610.03
6150,1/15/2021,1/15/2021,11521,82L-IMPORT PAYROLL-BASHAM WILLIAM EDWARD,D108,HJ,8.41,,279618.44
6150,1/15/2021,1/15/2021,11521,82L-IMPORT PAYROLL-BASHAM WILLIAM EDWARD,D108,HJ,15.67,,279634.11
6150,1/15/2021,1/15/2021,11521,82L-IMPORT PAYROLL-BASHAM WILLIAM EDWARD,D108,HJ,35.97,,279670.08
6150,1/15/2021,1/15/2021,11521,82L-IMPORT PAYROLL-BOHLSEN GRACE ISABELLE,D108,HJ,15.16,,279685.24
6150,1/15/2021,1/15/2021,11521,82L-IMPORT PAYROLL-BOHLSEN GRACE ISABELLE,D108,HJ,64.84,,279750.08
6150,1/15/2021,1/15/2021,11521,82L-IMPORT PAYROLL-BOLIVAR ANDREA,D108,HJ,36.25,,279786.33
6150,1/15/2021,1/15/2021,11521,82L-IMPORT PAYROLL-BOLIVAR ANDREA,D108,HJ,67.5,,279853.83
6150,1/15/2021,1/15/2021,11521,82L-IMPORT PAYROLL-BOLIVAR ANDREA,D108,HJ,155,,280008.83
6150,1/15/2021,1/15/2021,11521,82L-IMPORT PAYROLL-BORCHART SPENCER,D108,HJ,15.19,,280024.02
6150,1/15/2021,1/15/2021,11521,82L-IMPORT PAYROLL-BORCHART SPENCER,D108,HJ,44.27,,280068.29
6150,1/15/2021,1/15/2021,11521,82L-IMPORT PAYROLL-BORCHART SPENCER,D108,HJ,64.95,,280133.24
6150,1/15/2021,1/15/2021,11521,82L-IMPORT PAYROLL-BROWN ISAAC,D108,HJ,14.01,,280147.25
6150,1/15/2021,1/15/2021,11521,82L-IMPORT PAYROLL-BROWN ISAAC,D108,HJ,20.14,,280167.39
6150,1/15/2021,1/15/2021,11521,82L-IMPORT PAYROLL-BROWN ISAAC,D108,HJ,59.89,,280227.28
6150,1/15/2021,1/15/2021,11521,82L-IMPORT PAYROLL-BURKE MARIAH,D108,HJ,15.19,,280242.47
6150,1/15/2021,1/15/2021,11521,82L-IMPORT PAYROLL-BURKE MARIAH,D108,HJ,64.95,,280307.42
6150,1/15/2021,1/15/2021,11521,82L-IMPORT PAYROLL-CASSADY JOSHUA LEWIS,D108,HJ,15.19,,280322.61
6150,1/15/2021,1/15/2021,11521,82L-IMPORT PAYROLL-CASSADY JOSHUA LEWIS,D108,HJ,28.29,,280350.9
6150,1/15/2021,1/15/2021,11521,82L-IMPORT PAYROLL-CASSADY JOSHUA LEWIS,D108,HJ,64.95,,280415.85
6150,1/15/2021,1/15/2021,11521,82L-IMPORT PAYROLL-DARKO OLIVIA,D108,HJ,15.19,,280431.04
6150,1/15/2021,1/15/2021,11521,82L-IMPORT PAYROLL-DARKO OLIVIA,D108,HJ,64.95,,280495.99
6150,1/15/2021,1/15/2021,11521,82L-IMPORT PAYROLL-DAWSON JAMIL NAFAYE-BEYAH,D108,HJ,14.02,,280510.01
6150,1/15/2021,1/15/2021,11521,82L-IMPORT PAYROLL-DAWSON JAMIL NAFAYE-BEYAH,D108,HJ,29.98,,280539.99
6150,1/15/2021,1/15/2021,11521,82L-IMPORT PAYROLL-DAWSON JAMIL NAFAYE-BEYAH,D108,HJ,59.95,,280599.94
6150,1/15/2021,1/15/2021,11521,82L-IMPORT PAYROLL-ESCAMILLA OLGA,D108,HJ,15.19,,280615.13
6150,1/15/2021,1/15/2021,11521,82L-IMPORT PAYROLL-ESCAMILLA OLGA,D108,HJ,64.95,,280680.08
6150,1/15/2021,1/15/2021,11521,82L-IMPORT PAYROLL-GARCIA SANTIAGO,D108,HJ,29.6,,280709.68
6150,1/15/2021,1/15/2021,11521,82L-IMPORT PAYROLL-GARCIA SANTIAGO,D108,HJ,55.13,,280764.81
6150,1/15/2021,1/15/2021,11521,82L-IMPORT PAYROLL-GARCIA SANTIAGO,D108,HJ,126.58,,280891.39
6150,1/15/2021,1/15/2021,11521,82L-IMPORT PAYROLL-GILES SHAYLA,D108,HJ,15.19,,280906.58
6150,1/15/2021,1/15/2021,11521,82L-IMPORT PAYROLL-GILES SHAYLA,D108,HJ,28.29,,280934.87
6150,1/15/2021,1/15/2021,11521,82L-IMPORT PAYROLL-GILES SHAYLA,D108,HJ,64.95,,280999.82
6150,1/15/2021,1/15/2021,11521,82L-IMPORT PAYROLL-IKUNIKA FUNMILAYO,D108,HJ,30.21,,281030.03
6150,1/15/2021,1/15/2021,11521,82L-IMPORT PAYROLL-IKUNIKA FUNMILAYO,D108,HJ,56.25,,281086.28
6150,1/15/2021,1/15/2021,11521,82L-IMPORT PAYROLL-IKUNIKA FUNMILAYO,D108,HJ,129.17,,281215.45
6150,1/15/2021,1/15/2021,11521,82L-IMPORT PAYROLL-JONES JORDAN,D108,HJ,15.19,,281230.64
6150,1/15/2021,1/15/2021,11521,82L-IMPORT PAYROLL-JONES JORDAN,D108,HJ,64.95,,281295.59
6150,1/15/2021,1/15/2021,11521,82L-IMPORT PAYROLL-KHAN HUDA,D108,HJ,14.25,,281309.84
6150,1/15/2021,1/15/2021,11521,82L-IMPORT PAYROLL-KHAN HUDA,D108,HJ,26.53,,281336.37
6150,1/15/2021,1/15/2021,11521,82L-IMPORT PAYROLL-KHAN HUDA,D108,HJ,60.92,,281397.29
6150,1/15/2021,1/15/2021,11521,82L-IMPORT PAYROLL-KLOHR TIMOTHY JORDAN,D108,HJ,29,,281426.29
6150,1/15/2021,1/15/2021,11521,82L-IMPORT PAYROLL-KLOHR TIMOTHY JORDAN,D108,HJ,54,,281480.29
6150,1/15/2021,1/15/2021,11521,82L-IMPORT PAYROLL-KLOHR TIMOTHY JORDAN,D108,HJ,124,,281604.29
6150,1/15/2021,1/15/2021,11521,82L-IMPORT PAYROLL-KNOWLIN ZYLIA,D108,HJ,34.63,,281638.92
6150,1/15/2021,1/15/2021,11521,82L-IMPORT PAYROLL-KNOWLIN ZYLIA,D108,HJ,64.48,,281703.4
6150,1/15/2021,1/15/2021,11521,82L-IMPORT PAYROLL-KNOWLIN ZYLIA,D108,HJ,148.06,,281851.46
6150,1/15/2021,1/15/2021,11521,82L-IMPORT PAYROLL-KOPSHEVER MELISSA,D108,HJ,42.24,,281893.7
6150,1/15/2021,1/15/2021,11521,82L-IMPORT PAYROLL-KOPSHEVER MELISSA,D108,HJ,78.66,,281972.36
6150,1/15/2021,1/15/2021,11521,82L-IMPORT PAYROLL-KOPSHEVER MELISSA,D108,HJ,180.62,,282152.98
6150,1/15/2021,1/15/2021,11521,82L-IMPORT PAYROLL-LAI GRADY,D108,HJ,7.49,,282160.47
6150,1/15/2021,1/15/2021,11521,82L-IMPORT PAYROLL-LAI GRADY,D108,HJ,18.08,,282178.55
6150,1/15/2021,1/15/2021,11521,82L-IMPORT PAYROLL-LAI GRADY,D108,HJ,32.02,,282210.57
6150,1/15/2021,1/15/2021,11521,82L-IMPORT PAYROLL-LI SEN YUAN,D108,HJ,14.05,,282224.62
6150,1/15/2021,1/15/2021,11521,82L-IMPORT PAYROLL-LI SEN YUAN,D108,HJ,26.16,,282250.78
6150,1/15/2021,1/15/2021,11521,82L-IMPORT PAYROLL-LI SEN YUAN,D108,HJ,60.07,,282310.85
6150,1/15/2021,1/15/2021,11521,82L-IMPORT PAYROLL-LIPSCOMB STEPHEN,D108,HJ,33.58,,282344.43
6150,1/15/2021,1/15/2021,11521,82L-IMPORT PAYROLL-LIPSCOMB STEPHEN,D108,HJ,62.53,,282406.96
6150,1/15/2021,1/15/2021,11521,82L-IMPORT PAYROLL-LIPSCOMB STEPHEN,D108,HJ,143.59,,282550.55
6150,1/15/2021,1/15/2021,11521,82L-IMPORT PAYROLL-MALLECK JESSICA R,D108,HJ,15.19,,282565.74
6150,1/15/2021,1/15/2021,11521,82L-IMPORT PAYROLL-MALLECK JESSICA R,D108,HJ,64.95,,282630.69
6150,1/15/2021,1/15/2021,11521,82L-IMPORT PAYROLL-MCLAUGHLIN MARA,D108,HJ,8.41,,282639.1
6150,1/15/2021,1/15/2021,11521,82L-IMPORT PAYROLL-MCLAUGHLIN MARA,D108,HJ,12.18,,282651.28
6150,1/15/2021,1/15/2021,11521,82L-IMPORT PAYROLL-MCLAUGHLIN MARA,D108,HJ,35.97,,282687.25
6150,1/15/2021,1/15/2021,11521,82L-IMPORT PAYROLL-MEJIA ROSO CARLOS,D108,HJ,14.01,,282701.26
6150,1/15/2021,1/15/2021,11521,82L-IMPORT PAYROLL-MEJIA ROSO CARLOS,D108,HJ,26.08,,282727.34
6150,1/15/2021,1/15/2021,11521,82L-IMPORT PAYROLL-MEJIA ROSO CARLOS,D108,HJ,59.89,,282787.23
6150,1/15/2021,1/15/2021,11521,82L-IMPORT PAYROLL-MONROY-MEJIA JASON,D108,HJ,15.19,,282802.42
6150,1/15/2021,1/15/2021,11521,82L-IMPORT PAYROLL-MONROY-MEJIA JASON,D108,HJ,36.67,,282839.09
6150,1/15/2021,1/15/2021,11521,82L-IMPORT PAYROLL-MONROY-MEJIA JASON,D108,HJ,64.95,,282904.04
6150,1/15/2021,1/15/2021,11521,82L-IMPORT PAYROLL-O'FLYNN-PRUITT NATHAN COLYAR,D108,HJ,15.19,,282919.23
6150,1/15/2021,1/15/2021,11521,82L-IMPORT PAYROLL-O'FLYNN-PRUITT NATHAN COLYAR,D108,HJ,36.67,,282955.9
6150,1/15/2021,1/15/2021,11521,82L-IMPORT PAYROLL-O'FLYNN-PRUITT NATHAN COLYAR,D108,HJ,64.95,,283020.85
6150,1/15/2021,1/15/2021,11521,82L-IMPORT PAYROLL-OKRAH JULIAN O,D108,HJ,14.98,,283035.83
6150,1/15/2021,1/15/2021,11521,82L-IMPORT PAYROLL-OKRAH JULIAN O,D108,HJ,33.05,,283068.88
6150,1/15/2021,1/15/2021,11521,82L-IMPORT PAYROLL-OKRAH JULIAN O,D108,HJ,64.04,,283132.92
6150,1/15/2021,1/15/2021,11521,82L-IMPORT PAYROLL-PATTERSON STEVE,D108,HJ,15.19,,283148.11
6150,1/15/2021,1/15/2021,11521,82L-IMPORT PAYROLL-PATTERSON STEVE,D108,HJ,28.29,,283176.4
6150,1/15/2021,1/15/2021,11521,82L-IMPORT PAYROLL-PATTERSON STEVE,D108,HJ,64.95,,283241.35
6150,1/15/2021,1/15/2021,11521,82L-IMPORT PAYROLL-SCHMIESS RACHEL JOY,D108,HJ,10.69,,283252.04
6150,1/15/2021,1/15/2021,11521,82L-IMPORT PAYROLL-SCHMIESS RACHEL JOY,D108,HJ,15.19,,283267.23
6150,1/15/2021,1/15/2021,11521,82L-IMPORT PAYROLL-SCHMIESS RACHEL JOY,D108,HJ,64.95,,283332.18
6150,1/15/2021,1/15/2021,11521,82L-IMPORT PAYROLL-SCOTT KIRK DONOVAN,D108,HJ,14.05,,283346.23
6150,1/15/2021,1/15/2021,11521,82L-IMPORT PAYROLL-SCOTT KIRK DONOVAN,D108,HJ,26.16,,283372.39
6150,1/15/2021,1/15/2021,11521,82L-IMPORT PAYROLL-SCOTT KIRK DONOVAN,D108,HJ,60.07,,283432.46
6150,1/15/2021,1/15/2021,11521,82L-IMPORT PAYROLL-SILVER KELLY,D108,HJ,34.63,,283467.09
6150,1/15/2021,1/15/2021,11521,82L-IMPORT PAYROLL-SILVER KELLY,D108,HJ,64.48,,283531.57
6150,1/15/2021,1/15/2021,11521,82L-IMPORT PAYROLL-SILVER KELLY,D108,HJ,148.06,,283679.63
6150,1/15/2021,1/15/2021,11521,82L-IMPORT PAYROLL-SOLIMAN MARK,D108,HJ,15.19,,283694.82
6150,1/15/2021,1/15/2021,11521,82L-IMPORT PAYROLL-SOLIMAN MARK,D108,HJ,36.67,,283731.49
6150,1/15/2021,1/15/2021,11521,82L-IMPORT PAYROLL-SOLIMAN MARK,D108,HJ,64.95,,283796.44
6150,1/15/2021,1/15/2021,11521,82L-IMPORT PAYROLL-STEIN KYLE,D108,HJ,27.84,,283824.28
6150,1/15/2021,1/15/2021,11521,82L-IMPORT PAYROLL-STEIN KYLE,D108,HJ,51.84,,283876.12
6150,1/15/2021,1/15/2021,11521,82L-IMPORT PAYROLL-STEIN KYLE,D108,HJ,119.05,,283995.17
6150,1/15/2021,1/15/2021,11521,82L-IMPORT PAYROLL-STROUD DAVID,D108,HJ,14.65,,284009.82
6150,1/15/2021,1/15/2021,11521,82L-IMPORT PAYROLL-STROUD DAVID,D108,HJ,31.31,,284041.13
6150,1/15/2021,1/15/2021,11521,82L-IMPORT PAYROLL-STROUD DAVID,D108,HJ,62.62,,284103.75
6150,1/15/2021,1/15/2021,11521,82L-IMPORT PAYROLL-VALCIN SABRINA JEMIMAH,D108,HJ,14.25,,284118
6150,1/15/2021,1/15/2021,11521,82L-IMPORT PAYROLL-VALCIN SABRINA JEMIMAH,D108,HJ,26.53,,284144.53
6150,1/15/2021,1/15/2021,11521,82L-IMPORT PAYROLL-VALCIN SABRINA JEMIMAH,D108,HJ,60.92,,284205.45
6150,1/15/2021,1/15/2021,11521,82L-IMPORT PAYROLL-VALDES ERNEST L,D108,HJ,15.19,,284220.64
6150,1/15/2021,1/15/2021,11521,82L-IMPORT PAYROLL-VALDES ERNEST L,D108,HJ,36.67,,284257.31
6150,1/15/2021,1/15/2021,11521,82L-IMPORT PAYROLL-VALDES ERNEST L,D108,HJ,64.95,,284322.26
6150,1/15/2021,1/15/2021,11521,82L-IMPORT PAYROLL-WILLIAMS MACK ANTHONY,D108,HJ,15.02,,284337.28
6150,1/15/2021,1/15/2021,11521,82L-IMPORT PAYROLL-WILLIAMS MACK ANTHONY,D108,HJ,27.96,,284365.24
6150,1/15/2021,1/15/2021,11521,82L-IMPORT PAYROLL-WILLIAMS MACK ANTHONY,D108,HJ,64.21,,284429.45
6150,1/15/2021,1/15/2021,11521,82L-IMPORT PAYROLL-WILLIAMS MIL'YONTA,D108,HJ,15.19,,284444.64
6150,1/15/2021,1/15/2021,11521,82L-IMPORT PAYROLL-WILLIAMS MIL'YONTA,D108,HJ,28.29,,284472.93
6150,1/15/2021,1/15/2021,11521,82L-IMPORT PAYROLL-WILLIAMS MIL'YONTA,D108,HJ,64.95,,284537.88
6150,1/15/2021,1/15/2021,11521,82L-IMPORT PAYROLL-ANTHONY BETTY S,D108,HJ,41.85,,284579.73
6150,1/15/2021,1/15/2021,11521,82L-IMPORT PAYROLL-ANTHONY BETTY S,D108,HJ,178.96,,284758.69
6150,1/15/2021,1/15/2021,11521,82L-IMPORT PAYROLL-APULI LINDSAY,D108,HJ,34.16,,284792.85
6150,1/15/2021,1/15/2021,11521,82L-IMPORT PAYROLL-APULI LINDSAY,D108,HJ,146.08,,284938.93
6150,1/15/2021,1/15/2021,11521,82L-IMPORT PAYROLL-AUSTIN PERCY ANTONIO,D108,HJ,36.34,,284975.27
6150,1/15/2021,1/15/2021,11521,82L-IMPORT PAYROLL-AUSTIN PERCY ANTONIO,D108,HJ,155.39,,285130.66
6150,1/15/2021,1/15/2021,11521,82L-IMPORT PAYROLL-BUHMANN JENNIFER,D108,HJ,32.9,,285163.56
6150,1/15/2021,1/15/2021,11521,82L-IMPORT PAYROLL-BUHMANN JENNIFER,D108,HJ,140.68,,285304.24
6150,1/15/2021,1/15/2021,11521,82L-IMPORT PAYROLL-CAIN CORY,D108,HJ,36.32,,285340.56
6150,1/15/2021,1/15/2021,11521,82L-IMPORT PAYROLL-CAIN CORY,D108,HJ,155.3,,285495.86
6150,1/15/2021,1/15/2021,11521,82L-IMPORT PAYROLL-CHAPMAN CLAUDY EARL,D108,HJ,33.03,,285528.89
6150,1/15/2021,1/15/2021,11521,82L-IMPORT PAYROLL-CHAPMAN CLAUDY EARL,D108,HJ,141.23,,285670.12
6150,1/15/2021,1/15/2021,11521,82L-IMPORT PAYROLL-DADA ARIKPO E,D108,HJ,32.04,,285702.16
6150,1/15/2021,1/15/2021,11521,82L-IMPORT PAYROLL-DADA ARIKPO E,D108,HJ,137,,285839.16
6150,1/15/2021,1/15/2021,11521,82L-IMPORT PAYROLL-GUTHRIE LESLIE,D108,HJ,33.42,,285872.58
6150,1/15/2021,1/15/2021,11521,82L-IMPORT PAYROLL-GUTHRIE LESLIE,D108,HJ,142.9,,286015.48
6150,1/15/2021,1/15/2021,11521,82L-IMPORT PAYROLL-HOLMES JOREL ALEXANDER,D108,HJ,31.22,,286046.7
6150,1/15/2021,1/15/2021,11521,82L-IMPORT PAYROLL-HOLMES JOREL ALEXANDER,D108,HJ,133.51,,286180.21
6150,1/15/2021,1/15/2021,11521,82L-IMPORT PAYROLL-JORDAN TIFFANY T,D108,HJ,45.87,,286226.08
6150,1/15/2021,1/15/2021,11521,82L-IMPORT PAYROLL-JORDAN TIFFANY T,D108,HJ,196.13,,286422.21
6150,1/15/2021,1/15/2021,11521,82L-IMPORT PAYROLL-LANIGAN LISA A,D108,HJ,45.1,,286467.31
6150,1/15/2021,1/15/2021,11521,82L-IMPORT PAYROLL-LANIGAN LISA A,D108,HJ,192.83,,286660.14
6150,1/15/2021,1/15/2021,11521,82L-IMPORT PAYROLL-MCELWEE MELISSA,D108,HJ,38.67,,286698.81
6150,1/15/2021,1/15/2021,11521,82L-IMPORT PAYROLL-MCELWEE MELISSA,D108,HJ,165.33,,286864.14
6150,1/15/2021,1/15/2021,11521,82L-IMPORT PAYROLL-MCNICHOLAS MARY,D108,HJ,33.23,,286897.37
6150,1/15/2021,1/15/2021,11521,82L-IMPORT PAYROLL-MCNICHOLAS MARY,D108,HJ,142.08,,287039.45
6150,1/15/2021,1/15/2021,11521,82L-IMPORT PAYROLL-NWAKANMA NANCY,D108,HJ,44.18,,287083.63
6150,1/15/2021,1/15/2021,11521,82L-IMPORT PAYROLL-NWAKANMA NANCY,D108,HJ,188.89,,287272.52
6150,1/15/2021,1/15/2021,11521,82L-IMPORT PAYROLL-ONICA ANTHONY J,D108,HJ,32.86,,287305.38
6150,1/15/2021,1/15/2021,11521,82L-IMPORT PAYROLL-ONICA ANTHONY J,D108,HJ,140.49,,287445.87
6150,1/15/2021,1/15/2021,11521,82L-IMPORT PAYROLL-PRAHIN NICOLE M,D108,HJ,52.91,,287498.78
6150,1/15/2021,1/15/2021,11521,82L-IMPORT PAYROLL-PRAHIN NICOLE M,D108,HJ,226.22,,287725
6150,1/15/2021,1/15/2021,11521,82L-IMPORT PAYROLL-RIVERS QUIONNA DIANE,D108,HJ,39.27,,287764.27
6150,1/15/2021,1/15/2021,11521,82L-IMPORT PAYROLL-RIVERS QUIONNA DIANE,D108,HJ,167.92,,287932.19
6150,1/15/2021,1/15/2021,11521,82L-IMPORT PAYROLL-SALIM YASSER,D108,HJ,33.1,,287965.29
6150,1/15/2021,1/15/2021,11521,82L-IMPORT PAYROLL-SALIM YASSER,D108,HJ,141.55,,288106.84
6150,1/15/2021,1/15/2021,11521,82L-IMPORT PAYROLL-SEJOUR MAHALIAH,D108,HJ,34.07,,288140.91
6150,1/15/2021,1/15/2021,11521,82L-IMPORT PAYROLL-SEJOUR MAHALIAH,D108,HJ,145.66,,288286.57
6150,1/15/2021,1/15/2021,11521,82L-IMPORT PAYROLL-SKALSKI CHRISTOPHER,D108,HJ,33.86,,288320.43
6150,1/15/2021,1/15/2021,11521,82L-IMPORT PAYROLL-SKALSKI CHRISTOPHER,D108,HJ,144.76,,288465.19
6150,1/15/2021,1/15/2021,11521,82L-IMPORT PAYROLL-TUMENJARGAL ENKHJIN,D108,HJ,32.92,,288498.11
6150,1/15/2021,1/15/2021,11521,82L-IMPORT PAYROLL-TUMENJARGAL ENKHJIN,D108,HJ,140.75,,288638.86
6150,1/15/2021,1/15/2021,11521,82L-IMPORT PAYROLL-VILLEGAS EVELYN,D108,HJ,33.4,,288672.26
6150,1/15/2021,1/15/2021,11521,82L-IMPORT PAYROLL-VILLEGAS EVELYN,D108,HJ,142.81,,288815.07
6150,1/15/2021,1/15/2021,11521,82L-IMPORT PAYROLL-WOLF ANNA A,D108,HJ,36.3,,288851.37
6150,1/15/2021,1/15/2021,11521,82L-IMPORT PAYROLL-WOLF ANNA A,D108,HJ,155.19,,289006.56
6150,1/15/2021,1/15/2021,11521,82L-IMPORT PAYROLL-ACEVEDO MONIVETT,D107,HJ,72.42,,289078.98
6150,1/15/2021,1/15/2021,11521,82L-IMPORT PAYROLL-ACEVEDO MONIVETT,D107,HJ,134.84,,289213.82
6150,1/15/2021,1/15/2021,11521,82L-IMPORT PAYROLL-ACEVEDO MONIVETT,D107,HJ,155.84,,289369.66
6150,1/15/2021,1/15/2021,11521,82L-IMPORT PAYROLL-AKLESTAD ISABEL,D111,HJ,23.29,,289392.95
6150,1/15/2021,1/15/2021,11521,82L-IMPORT PAYROLL-AKLESTAD ISABEL,D111,HJ,99.58,,289492.53
6150,1/15/2021,1/15/2021,11521,82L-IMPORT PAYROLL-BIBB TIFFANI,D104,HJ,49.71,,289542.24
6150,1/15/2021,1/15/2021,11521,82L-IMPORT PAYROLL-BIBB TIFFANI,D104,HJ,92.56,,289634.8
6150,1/15/2021,1/15/2021,11521,82L-IMPORT PAYROLL-BIBB TIFFANI,D104,HJ,212.55,,289847.35
6150,1/15/2021,1/15/2021,11521,82L-IMPORT PAYROLL-BOWMAN HALLEY K,D101,HJ,50.61,,289897.96
6150,1/15/2021,1/15/2021,11521,82L-IMPORT PAYROLL-BOWMAN HALLEY K,D101,HJ,67.11,,289965.07
6150,1/15/2021,1/15/2021,11521,82L-IMPORT PAYROLL-BOWMAN HALLEY K,D101,HJ,216.38,,290181.45
6150,1/15/2021,1/15/2021,11521,82L-IMPORT PAYROLL-COOK CATHRYN ANNA,D105,HJ,49.87,,290231.32
6150,1/15/2021,1/15/2021,11521,82L-IMPORT PAYROLL-COOK CATHRYN ANNA,D105,HJ,151.84,,290383.16
6150,1/15/2021,1/15/2021,11521,82L-IMPORT PAYROLL-COOK CATHRYN ANNA,D105,HJ,213.25,,290596.41
6150,1/15/2021,1/15/2021,11521,82L-IMPORT PAYROLL-COOPER ASHLEE R,D101,HJ,33.51,,290629.92
6150,1/15/2021,1/15/2021,11521,82L-IMPORT PAYROLL-COOPER ASHLEE R,D101,HJ,143.3,,290773.22
6150,1/15/2021,1/15/2021,11521,82L-IMPORT PAYROLL-CORTEZ MIRANDA A,D111,HJ,38.45,,290811.67
6150,1/15/2021,1/15/2021,11521,82L-IMPORT PAYROLL-CORTEZ MIRANDA A,D111,HJ,72.16,,290883.83
6150,1/15/2021,1/15/2021,11521,82L-IMPORT PAYROLL-CORTEZ MIRANDA A,D111,HJ,164.42,,291048.25
6150,1/15/2021,1/15/2021,11521,82L-IMPORT PAYROLL-DAUGHERTY DEVIN W,D101,HJ,15.1,,291063.35
6150,1/15/2021,1/15/2021,11521,82L-IMPORT PAYROLL-DAUGHERTY DEVIN W,D101,HJ,28.13,,291091.48
6150,1/15/2021,1/15/2021,11521,82L-IMPORT PAYROLL-DAUGHERTY DEVIN W,D101,HJ,64.58,,291156.06
6150,1/15/2021,1/15/2021,11521,82L-IMPORT PAYROLL-DETONE KYRA MAYA,D102,HJ,39,,291195.06
6150,1/15/2021,1/15/2021,11521,82L-IMPORT PAYROLL-DETONE KYRA MAYA,D102,HJ,123.26,,291318.32
6150,1/15/2021,1/15/2021,11521,82L-IMPORT PAYROLL-DETONE KYRA MAYA,D102,HJ,166.75,,291485.07
6150,1/15/2021,1/15/2021,11521,82L-IMPORT PAYROLL-DUPUIS CHRISTOPHER M,D107,HJ,36.38,,291521.45
6150,1/15/2021,1/15/2021,11521,82L-IMPORT PAYROLL-DUPUIS CHRISTOPHER M,D107,HJ,52.36,,291573.81
6150,1/15/2021,1/15/2021,11521,82L-IMPORT PAYROLL-DUPUIS CHRISTOPHER M,D107,HJ,155.57,,291729.38
6150,1/15/2021,1/15/2021,11521,82L-IMPORT PAYROLL-DUPUIS CHRISTOPHER M,D107,HJ,223.88,,291953.26
6150,1/15/2021,1/15/2021,11521,82L-IMPORT PAYROLL-DUPUIS CHRISTOPHER M,D107,HJ,265.01,,292218.27
6150,1/15/2021,1/15/2021,11521,82L-IMPORT PAYROLL-DZIEDZIC JULIE K,D101,HJ,17.71,,292235.98
6150,1/15/2021,1/15/2021,11521,82L-IMPORT PAYROLL-DZIEDZIC JULIE K,D101,HJ,75.71,,292311.69
6150,1/15/2021,1/15/2021,11521,82L-IMPORT PAYROLL-FEENEY CLAIRE,D104,HJ,10.47,,292322.16
6150,1/15/2021,1/15/2021,11521,82L-IMPORT PAYROLL-FEENEY CLAIRE,D104,HJ,44.79,,292366.95
6150,1/15/2021,1/15/2021,11521,82L-IMPORT PAYROLL-FISCHABER THOMAS,D109,HJ,77.9,,292444.85
6150,1/15/2021,1/15/2021,11521,82L-IMPORT PAYROLL-FISCHABER THOMAS,D109,HJ,91.33,,292536.18
6150,1/15/2021,1/15/2021,11521,82L-IMPORT PAYROLL-FISCHABER THOMAS,D109,HJ,333.1,,292869.28
6150,1/15/2021,1/15/2021,11521,82L-IMPORT PAYROLL-FLORY MEGAN,D109,HJ,21.75,,292891.03
6150,1/15/2021,1/15/2021,11521,82L-IMPORT PAYROLL-FLORY MEGAN,D109,HJ,25.5,,292916.53
6150,1/15/2021,1/15/2021,11521,82L-IMPORT PAYROLL-FLORY MEGAN,D109,HJ,93,,293009.53
6150,1/15/2021,1/15/2021,11521,82L-IMPORT PAYROLL-GORNSTEIN STEVEN,D101,HJ,39.27,,293048.8
6150,1/15/2021,1/15/2021,11521,82L-IMPORT PAYROLL-GORNSTEIN STEVEN,D101,HJ,114.45,,293163.25
6150,1/15/2021,1/15/2021,11521,82L-IMPORT PAYROLL-GORNSTEIN STEVEN,D101,HJ,167.92,,293331.17
6150,1/15/2021,1/15/2021,11521,82L-IMPORT PAYROLL-GUADARRAMA-ALVAREZ URIEL A,D105,HJ,39.93,,293371.1
6150,1/15/2021,1/15/2021,11521,82L-IMPORT PAYROLL-GUADARRAMA-ALVAREZ URIEL A,D105,HJ,78.24,,293449.34
6150,1/15/2021,1/15/2021,11521,82L-IMPORT PAYROLL-GUADARRAMA-ALVAREZ URIEL A,D105,HJ,170.75,,293620.09
6150,1/15/2021,1/15/2021,11521,82L-IMPORT PAYROLL-GUTIERREZ ANTONIO J,D107,HJ,27.59,,293647.68
6150,1/15/2021,1/15/2021,11521,82L-IMPORT PAYROLL-GUTIERREZ ANTONIO J,D107,HJ,49.06,,293696.74
6150,1/15/2021,1/15/2021,11521,82L-IMPORT PAYROLL-GUTIERREZ ANTONIO J,D107,HJ,117.99,,293814.73
6150,1/15/2021,1/15/2021,11521,82L-IMPORT PAYROLL-GUTIERREZ ANTONIO J,D107,HJ,209.77,,294024.5
6150,1/15/2021,1/15/2021,11521,82L-IMPORT PAYROLL-GUTIERREZ ANTONIO J,D107,HJ,240.58,,294265.08
6150,1/15/2021,1/15/2021,11521,82L-IMPORT PAYROLL-HENRY GILLIAN,D102,HJ,29.17,,294294.25
6150,1/15/2021,1/15/2021,11521,82L-IMPORT PAYROLL-HENRY GILLIAN,D102,HJ,70.42,,294364.67
6150,1/15/2021,1/15/2021,11521,82L-IMPORT PAYROLL-HENRY GILLIAN,D102,HJ,124.74,,294489.41
6150,1/15/2021,1/15/2021,11521,82L-IMPORT PAYROLL-HERMAN ADAM,D102,HJ,28.2,,294517.61
6150,1/15/2021,1/15/2021,11521,82L-IMPORT PAYROLL-HERMAN ADAM,D102,HJ,120.56,,294638.17
6150,1/15/2021,1/15/2021,11521,82L-IMPORT PAYROLL-HERNANDEZ ANNA,D101,HJ,34.16,,294672.33
6150,1/15/2021,1/15/2021,11521,82L-IMPORT PAYROLL-HERNANDEZ ANNA,D101,HJ,58.9,,294731.23
6150,1/15/2021,1/15/2021,11521,82L-IMPORT PAYROLL-HERNANDEZ ANNA,D101,HJ,146.08,,294877.31
6150,1/15/2021,1/15/2021,11521,82L-IMPORT PAYROLL-HESTER TYLER CONRAD,D105,HJ,27.79,,294905.1
6150,1/15/2021,1/15/2021,11521,82L-IMPORT PAYROLL-HESTER TYLER CONRAD,D105,HJ,118.83,,295023.93
6150,1/15/2021,1/15/2021,11521,82L-IMPORT PAYROLL-HOLT ADAM,D109,HJ,58.24,,295082.17
6150,1/15/2021,1/15/2021,11521,82L-IMPORT PAYROLL-HOLT ADAM,D109,HJ,68.28,,295150.45
6150,1/15/2021,1/15/2021,11521,82L-IMPORT PAYROLL-HOLT ADAM,D109,HJ,249.03,,295399.48
6150,1/15/2021,1/15/2021,11521,82L-IMPORT PAYROLL-KELLY SEAN,D109,HJ,78.54,,295478.02
6150,1/15/2021,1/15/2021,11521,82L-IMPORT PAYROLL-KELLY SEAN,D109,HJ,92.08,,295570.1
6150,1/15/2021,1/15/2021,11521,82L-IMPORT PAYROLL-KELLY SEAN,D109,HJ,335.83,,295905.93
6150,1/15/2021,1/15/2021,11521,82L-IMPORT PAYROLL-KRUGER MARK,D109,HJ,72.5,,295978.43
6150,1/15/2021,1/15/2021,11521,82L-IMPORT PAYROLL-KRUGER MARK,D109,HJ,85,,296063.43
6150,1/15/2021,1/15/2021,11521,82L-IMPORT PAYROLL-KRUGER MARK,D109,HJ,310,,296373.43
6150,1/15/2021,1/15/2021,11521,82L-IMPORT PAYROLL-LIPORACE HERNAN LUIS,D103,HJ,33.06,,296406.49
6150,1/15/2021,1/15/2021,11521,82L-IMPORT PAYROLL-LIPORACE HERNAN LUIS,D103,HJ,61.55,,296468.04
6150,1/15/2021,1/15/2021,11521,82L-IMPORT PAYROLL-LIPORACE HERNAN LUIS,D103,HJ,141.34,,296609.38
6150,1/15/2021,1/15/2021,11521,82L-IMPORT PAYROLL-MARKS KRISTA,D109,HJ,76.2,,296685.58
6150,1/15/2021,1/15/2021,11521,82L-IMPORT PAYROLL-MARKS KRISTA,D109,HJ,89.33,,296774.91
6150,1/15/2021,1/15/2021,11521,82L-IMPORT PAYROLL-MARKS KRISTA,D109,HJ,325.8,,297100.71
6150,1/15/2021,1/15/2021,11521,82L-IMPORT PAYROLL-MELVIN DARNELL KEVIN,D109,HJ,48.2,,297148.91
6150,1/15/2021,1/15/2021,11521,82L-IMPORT PAYROLL-MELVIN DARNELL KEVIN,D109,HJ,55.91,,297204.82
6150,1/15/2021,1/15/2021,11521,82L-IMPORT PAYROLL-MELVIN DARNELL KEVIN,D109,HJ,239.08,,297443.9
6150,1/15/2021,1/15/2021,11521,82L-IMPORT PAYROLL-MESSING JENNIFER,D104,HJ,34.12,,297478.02
6150,1/15/2021,1/15/2021,11521,82L-IMPORT PAYROLL-MESSING JENNIFER,D104,HJ,63.54,,297541.56
6150,1/15/2021,1/15/2021,11521,82L-IMPORT PAYROLL-MESSING JENNIFER,D104,HJ,145.9,,297687.46
6150,1/15/2021,1/15/2021,11521,82L-IMPORT PAYROLL-MILNE ROGER,D109,HJ,76.2,,297763.66
6150,1/15/2021,1/15/2021,11521,82L-IMPORT PAYROLL-MILNE ROGER,D109,HJ,89.33,,297852.99
6150,1/15/2021,1/15/2021,11521,82L-IMPORT PAYROLL-MILNE ROGER,D109,HJ,325.8,,298178.79
6150,1/15/2021,1/15/2021,11521,82L-IMPORT PAYROLL-MOSTAFAVI YASAMAN,D109,HJ,10.21,,298189
6150,1/15/2021,1/15/2021,11521,82L-IMPORT PAYROLL-MOSTAFAVI YASAMAN,D109,HJ,16.73,,298205.73
6150,1/15/2021,1/15/2021,11521,82L-IMPORT PAYROLL-MOSTAFAVI YASAMAN,D109,HJ,43.65,,298249.38
6150,1/15/2021,1/15/2021,11521,82L-IMPORT PAYROLL-O'DONNELL STEPHEN,D104,HJ,39.26,,298288.64
6150,1/15/2021,1/15/2021,11521,82L-IMPORT PAYROLL-O'DONNELL STEPHEN,D104,HJ,67.69,,298356.33
6150,1/15/2021,1/15/2021,11521,82L-IMPORT PAYROLL-O'DONNELL STEPHEN,D104,HJ,167.87,,298524.2
6150,1/15/2021,1/15/2021,11521,82L-IMPORT PAYROLL-PARETS MALLORY GRACE,D101,HJ,17.57,,298541.77
6150,1/15/2021,1/15/2021,11521,82L-IMPORT PAYROLL-PARETS MALLORY GRACE,D101,HJ,41.08,,298582.85
6150,1/15/2021,1/15/2021,11521,82L-IMPORT PAYROLL-PARETS MALLORY GRACE,D101,HJ,76.5,,298659.35
6150,1/15/2021,1/15/2021,11521,82L-IMPORT PAYROLL-PARETS MALLORY GRACE,D101,HJ,175.67,,298835.02
6150,1/15/2021,1/15/2021,11521,82L-IMPORT PAYROLL-PARHAM-GANTT DENISE M,D112,HJ,37.96,,298872.98
6150,1/15/2021,1/15/2021,11521,82L-IMPORT PAYROLL-PARHAM-GANTT DENISE M,D112,HJ,162.32,,299035.3
6150,1/15/2021,1/15/2021,11521,82L-IMPORT PAYROLL-PEINADO ELIZABETH R,D111,HJ,52.29,,299087.59
6150,1/15/2021,1/15/2021,11521,82L-IMPORT PAYROLL-PEINADO ELIZABETH R,D111,HJ,223.58,,299311.17
6150,1/15/2021,1/15/2021,11521,82L-IMPORT PAYROLL-PERNIA JEFFREY,D109,HJ,56.19,,299367.36
6150,1/15/2021,1/15/2021,11521,82L-IMPORT PAYROLL-PERNIA JEFFREY,D109,HJ,108.59,,299475.95
6150,1/15/2021,1/15/2021,11521,82L-IMPORT PAYROLL-PERNIA JEFFREY,D109,HJ,240.25,,299716.2
6150,1/15/2021,1/15/2021,11521,82L-IMPORT PAYROLL-PIRES MANUEL AM,D103,HJ,29.56,,299745.76
6150,1/15/2021,1/15/2021,11521,82L-IMPORT PAYROLL-PIRES MANUEL AM,D103,HJ,86.14,,299831.9
6150,1/15/2021,1/15/2021,11521,82L-IMPORT PAYROLL-PIRES MANUEL AM,D103,HJ,126.38,,299958.28
6150,1/15/2021,1/15/2021,11521,82L-IMPORT PAYROLL-POLANCO ODALIS,D103,HJ,43.23,,300001.51
6150,1/15/2021,1/15/2021,11521,82L-IMPORT PAYROLL-POLANCO ODALIS,D103,HJ,80.49,,300082
6150,1/15/2021,1/15/2021,11521,82L-IMPORT PAYROLL-POLANCO ODALIS,D103,HJ,184.83,,300266.83
6150,1/15/2021,1/15/2021,11521,82L-IMPORT PAYROLL-QUINTAS JASHIVE,D105,HJ,25.57,,300292.4
6150,1/15/2021,1/15/2021,11521,82L-IMPORT PAYROLL-QUINTAS JASHIVE,D105,HJ,109.31,,300401.71
6150,1/15/2021,1/15/2021,11521,82L-IMPORT PAYROLL-RANDOLPH ALEXANDER,D111,HJ,11.63,,300413.34
6150,1/15/2021,1/15/2021,11521,82L-IMPORT PAYROLL-RANDOLPH ALEXANDER,D111,HJ,25.1,,300438.44
6150,1/15/2021,1/15/2021,11521,82L-IMPORT PAYROLL-RANDOLPH ALEXANDER,D111,HJ,50.63,,300489.07
6150,1/15/2021,1/15/2021,11521,82L-IMPORT PAYROLL-RANDOLPH ALEXANDER,D111,HJ,107.33,,300596.4
6150,1/15/2021,1/15/2021,11521,82L-IMPORT PAYROLL-RUBI PERLA,D101,HJ,15.92,,300612.32
6150,1/15/2021,1/15/2021,11521,82L-IMPORT PAYROLL-RUBI PERLA,D101,HJ,68.09,,300680.41
6150,1/15/2021,1/15/2021,11521,82L-IMPORT PAYROLL-SAFRAN ALAN P,D107,HJ,9.32,,300689.73
6150,1/15/2021,1/15/2021,11521,82L-IMPORT PAYROLL-SAFRAN ALAN P,D107,HJ,39.84,,300729.57
6150,1/15/2021,1/15/2021,11521,82L-IMPORT PAYROLL-SAFRAN ALAN P,D107,HJ,94.2,,300823.77
6150,1/15/2021,1/15/2021,11521,82L-IMPORT PAYROLL-SAFRAN ALAN P,D107,HJ,327.19,,301150.96
6150,1/15/2021,1/15/2021,11521,82L-IMPORT PAYROLL-SAFRAN ALAN P,D107,HJ,402.8,,301553.76
6150,1/15/2021,1/15/2021,11521,82L-IMPORT PAYROLL-SHENKMAN OLIVIA,D101,HJ,29,,301582.76
6150,1/15/2021,1/15/2021,11521,82L-IMPORT PAYROLL-SHENKMAN OLIVIA,D101,HJ,124,,301706.76
6150,1/15/2021,1/15/2021,11521,82L-IMPORT PAYROLL-SHI GRACE,D103,HJ,12.69,,301719.45
6150,1/15/2021,1/15/2021,11521,82L-IMPORT PAYROLL-SHI GRACE,D103,HJ,36.98,,301756.43
6150,1/15/2021,1/15/2021,11521,82L-IMPORT PAYROLL-SHI GRACE,D103,HJ,54.25,,301810.68
6150,1/15/2021,1/15/2021,11521,82L-IMPORT PAYROLL-VYAS SUNAINA,D104,HJ,13.11,,301823.79
6150,1/15/2021,1/15/2021,11521,82L-IMPORT PAYROLL-VYAS SUNAINA,D104,HJ,31.63,,301855.42
6150,1/15/2021,1/15/2021,11521,82L-IMPORT PAYROLL-VYAS SUNAINA,D104,HJ,56.04,,301911.46
6150,1/15/2021,1/15/2021,11521,82L-IMPORT PAYROLL-WALLACE AMENA,D104,HJ,28.93,,301940.39
6150,1/15/2021,1/15/2021,11521,82L-IMPORT PAYROLL-WALLACE AMENA,D104,HJ,123.72,,302064.11
6150,1/15/2021,1/15/2021,11521,82L-IMPORT PAYROLL-WARD JEFFREY,D109,HJ,78.54,,302142.65
6150,1/15/2021,1/15/2021,11521,82L-IMPORT PAYROLL-WARD JEFFREY,D109,HJ,92.08,,302234.73
6150,1/15/2021,1/15/2021,11521,82L-IMPORT PAYROLL-WARD JEFFREY,D109,HJ,335.83,,302570.56
6150,1/15/2021,1/15/2021,11521,82L-IMPORT PAYROLL-WARD JENNIFER,D109,HJ,13.21,,302583.77
6150,1/15/2021,1/15/2021,11521,82L-IMPORT PAYROLL-WARD JENNIFER,D109,HJ,15.49,,302599.26
6150,1/15/2021,1/15/2021,11521,82L-IMPORT PAYROLL-WARD JENNIFER,D109,HJ,56.5,,302655.76
6150,1/15/2021,1/15/2021,11521,82L-IMPORT PAYROLL-WEINSTOCK EMILY,D101,HJ,17.57,,302673.33
6150,1/15/2021,1/15/2021,11521,82L-IMPORT PAYROLL-WEINSTOCK EMILY,D101,HJ,38.11,,302711.44
6150,1/15/2021,1/15/2021,11521,82L-IMPORT PAYROLL-WEINSTOCK EMILY,D101,HJ,76.5,,302787.94
6150,1/15/2021,1/15/2021,11521,82L-IMPORT PAYROLL-WEINSTOCK EMILY,D101,HJ,162.94,,302950.88
6150,1/15/2021,1/15/2021,11521,82L-IMPORT PAYROLL-WINANS JENNIFER,D111,HJ,36.33,,302987.21
6150,1/15/2021,1/15/2021,11521,82L-IMPORT PAYROLL-WINANS JENNIFER,D111,HJ,67.65,,303054.86
6150,1/15/2021,1/15/2021,11521,82L-IMPORT PAYROLL-WINANS JENNIFER,D111,HJ,155.35,,303210.21
6150,1/15/2021,1/15/2021,11521,82L-IMPORT PAYROLL-ZARATE JOSEPH M,D105,HJ,31.18,,303241.39
6150,1/15/2021,1/15/2021,11521,82L-IMPORT PAYROLL-ZARATE JOSEPH M,D105,HJ,133.3,,303374.69
6150,1/15/2021,1/15/2021,11521,82L-IMPORT PAYROLL-AGUANNO JOSEPH,D108,HJ,16.23,,303390.92
6150,1/15/2021,1/15/2021,11521,82L-IMPORT PAYROLL-AGUANNO JOSEPH,D108,HJ,69.38,,303460.3
6150,1/15/2021,1/15/2021,11521,82L-IMPORT PAYROLL-AKESODE FEHINTOLA,D108,HJ,16.23,,303476.53
6150,1/15/2021,1/15/2021,11521,82L-IMPORT PAYROLL-AKESODE FEHINTOLA,D108,HJ,69.38,,303545.91
6150,1/15/2021,1/15/2021,11521,82L-IMPORT PAYROLL-BARTOLD DEANNA MARIE,D108,HJ,41.91,,303587.82
6150,1/15/2021,1/15/2021,11521,82L-IMPORT PAYROLL-BARTOLD DEANNA MARIE,D108,HJ,179.22,,303767.04
6150,1/15/2021,1/15/2021,11521,82L-IMPORT PAYROLL-BELLOT GENESIS,D108,HJ,32.36,,303799.4
6150,1/15/2021,1/15/2021,11521,82L-IMPORT PAYROLL-BELLOT GENESIS,D108,HJ,138.38,,303937.78
6150,1/15/2021,1/15/2021,11521,82L-IMPORT PAYROLL-BENNETT JAMES H,D108,HJ,16.23,,303954.01
6150,1/15/2021,1/15/2021,11521,82L-IMPORT PAYROLL-BENNETT JAMES H,D108,HJ,69.38,,304023.39
6150,1/15/2021,1/15/2021,11521,82L-IMPORT PAYROLL-BOWMAN ABIGAIL,D108,HJ,16.23,,304039.62
6150,1/15/2021,1/15/2021,11521,82L-IMPORT PAYROLL-BOWMAN ABIGAIL,D108,HJ,69.38,,304109
6150,1/15/2021,1/15/2021,11521,82L-IMPORT PAYROLL-BURRELL RUSSELL,D108,HJ,15.08,,304124.08
6150,1/15/2021,1/15/2021,11521,82L-IMPORT PAYROLL-BURRELL RUSSELL,D108,HJ,28.09,,304152.17
6150,1/15/2021,1/15/2021,11521,82L-IMPORT PAYROLL-BURRELL RUSSELL,D108,HJ,64.5,,304216.67
6150,1/15/2021,1/15/2021,11521,82L-IMPORT PAYROLL-CHUI KENT,D108,HJ,16.23,,304232.9
6150,1/15/2021,1/15/2021,11521,82L-IMPORT PAYROLL-CHUI KENT,D108,HJ,69.38,,304302.28
6150,1/15/2021,1/15/2021,11521,82L-IMPORT PAYROLL-CIRKER MIA,D108,HJ,32.63,,304334.91
6150,1/15/2021,1/15/2021,11521,82L-IMPORT PAYROLL-CIRKER MIA,D108,HJ,139.5,,304474.41
6150,1/15/2021,1/15/2021,11521,82L-IMPORT PAYROLL-DEWS CAMERYN,D108,HJ,33.23,,304507.64
6150,1/15/2021,1/15/2021,11521,82L-IMPORT PAYROLL-DEWS CAMERYN,D108,HJ,142.08,,304649.72
6150,1/15/2021,1/15/2021,11521,82L-IMPORT PAYROLL-DIETZ MARY,D108,HJ,16.23,,304665.95
6150,1/15/2021,1/15/2021,11521,82L-IMPORT PAYROLL-DIETZ MARY,D108,HJ,35.81,,304701.76
6150,1/15/2021,1/15/2021,11521,82L-IMPORT PAYROLL-DIETZ MARY,D108,HJ,69.38,,304771.14
6150,1/15/2021,1/15/2021,11521,82L-IMPORT PAYROLL-DOMINIQUE PRINCESSA,D108,HJ,16.23,,304787.37
6150,1/15/2021,1/15/2021,11521,82L-IMPORT PAYROLL-DOMINIQUE PRINCESSA,D108,HJ,69.38,,304856.75
6150,1/15/2021,1/15/2021,11521,82L-IMPORT PAYROLL-DONNELLY HOME,D108,HJ,6.94,,304863.69
6150,1/15/2021,1/15/2021,11521,82L-IMPORT PAYROLL-DONNELLY HOME,D108,HJ,16.23,,304879.92
6150,1/15/2021,1/15/2021,11521,82L-IMPORT PAYROLL-DONNELLY HOME,D108,HJ,30.21,,304910.13
6150,1/15/2021,1/15/2021,11521,82L-IMPORT PAYROLL-DONNELLY HOME,D108,HJ,69.38,,304979.51
6150,1/15/2021,1/15/2021,11521,82L-IMPORT PAYROLL-FEIGHERY JOHN,D108,HJ,30.56,,305010.07
6150,1/15/2021,1/15/2021,11521,82L-IMPORT PAYROLL-FEIGHERY JOHN,D108,HJ,130.69,,305140.76
6150,1/15/2021,1/15/2021,11521,82L-IMPORT PAYROLL-FORTH KYLE,D108,HJ,16.23,,305156.99
6150,1/15/2021,1/15/2021,11521,82L-IMPORT PAYROLL-FORTH KYLE,D108,HJ,69.38,,305226.37
6150,1/15/2021,1/15/2021,11521,82L-IMPORT PAYROLL-GARCIA MARILYN,D108,HJ,33.23,,305259.6
6150,1/15/2021,1/15/2021,11521,82L-IMPORT PAYROLL-GARCIA MARILYN,D108,HJ,142.08,,305401.68
6150,1/15/2021,1/15/2021,11521,82L-IMPORT PAYROLL-GREENE BROOKE,D108,HJ,15.28,,305416.96
6150,1/15/2021,1/15/2021,11521,82L-IMPORT PAYROLL-GREENE BROOKE,D108,HJ,65.35,,305482.31
6150,1/15/2021,1/15/2021,11521,82L-IMPORT PAYROLL-GRIFFIN ANDREW,D108,HJ,30.44,,305512.75
6150,1/15/2021,1/15/2021,11521,82L-IMPORT PAYROLL-GRIFFIN ANDREW,D108,HJ,74.25,,305587
6150,1/15/2021,1/15/2021,11521,82L-IMPORT PAYROLL-GRIFFIN ANDREW,D108,HJ,130.16,,305717.16
6150,1/15/2021,1/15/2021,11521,82L-IMPORT PAYROLL-GROSS EMILY,D108,HJ,14,,305731.16
6150,1/15/2021,1/15/2021,11521,82L-IMPORT PAYROLL-GROSS EMILY,D108,HJ,59.86,,305791.02
6150,1/15/2021,1/15/2021,11521,82L-IMPORT PAYROLL-GUERRERO LUIS,D108,HJ,19.85,,305810.87
6150,1/15/2021,1/15/2021,11521,82L-IMPORT PAYROLL-GUERRERO LUIS,D108,HJ,84.88,,305895.75
6150,1/15/2021,1/15/2021,11521,82L-IMPORT PAYROLL-HALLINAN GABRIEL,D108,HJ,34.79,,305930.54
6150,1/15/2021,1/15/2021,11521,82L-IMPORT PAYROLL-HALLINAN GABRIEL,D108,HJ,148.76,,306079.3
6150,1/15/2021,1/15/2021,11521,82L-IMPORT PAYROLL-HAMERSLY WILLIAM,D108,HJ,34.16,,306113.46
6150,1/15/2021,1/15/2021,11521,82L-IMPORT PAYROLL-HAMERSLY WILLIAM,D108,HJ,146.08,,306259.54
6150,1/15/2021,1/15/2021,11521,82L-IMPORT PAYROLL-HOSSAIN MYESHA,D108,HJ,35.1,,306294.64
6150,1/15/2021,1/15/2021,11521,82L-IMPORT PAYROLL-HOSSAIN MYESHA,D108,HJ,150.1,,306444.74
6150,1/15/2021,1/15/2021,11521,82L-IMPORT PAYROLL-JACKSON TASNIM F,D108,HJ,31,,306475.74
6150,1/15/2021,1/15/2021,11521,82L-IMPORT PAYROLL-JACKSON TASNIM F,D108,HJ,132.56,,306608.3
6150,1/15/2021,1/15/2021,11521,82L-IMPORT PAYROLL-KERKHOFF HARPER FAITH,D108,HJ,16.23,,306624.53
6150,1/15/2021,1/15/2021,11521,82L-IMPORT PAYROLL-KERKHOFF HARPER FAITH,D108,HJ,30.21,,306654.74
6150,1/15/2021,1/15/2021,11521,82L-IMPORT PAYROLL-KERKHOFF HARPER FAITH,D108,HJ,69.38,,306724.12
6150,1/15/2021,1/15/2021,11521,82L-IMPORT PAYROLL-LEARY AUBREY,D108,HJ,16.2,,306740.32
6150,1/15/2021,1/15/2021,11521,82L-IMPORT PAYROLL-LEARY AUBREY,D108,HJ,69.27,,306809.59
6150,1/15/2021,1/15/2021,11521,82L-IMPORT PAYROLL-LI BELLA,D108,HJ,33.96,,306843.55
6150,1/15/2021,1/15/2021,11521,82L-IMPORT PAYROLL-LI BELLA,D108,HJ,145.23,,306988.78
6150,1/15/2021,1/15/2021,11521,82L-IMPORT PAYROLL-LOUIE JORDAN,D108,HJ,16.23,,307005.01
6150,1/15/2021,1/15/2021,11521,82L-IMPORT PAYROLL-LOUIE JORDAN,D108,HJ,69.38,,307074.39
6150,1/15/2021,1/15/2021,11521,82L-IMPORT PAYROLL-MELCHOR OSBEIDY,D108,HJ,16.23,,307090.62
6150,1/15/2021,1/15/2021,11521,82L-IMPORT PAYROLL-MELCHOR OSBEIDY,D108,HJ,69.38,,307160
6150,1/15/2021,1/15/2021,11521,82L-IMPORT PAYROLL-MORRIS ZAKIYA,D108,HJ,16.23,,307176.23
6150,1/15/2021,1/15/2021,11521,82L-IMPORT PAYROLL-MORRIS ZAKIYA,D108,HJ,69.38,,307245.61
6150,1/15/2021,1/15/2021,11521,82L-IMPORT PAYROLL-MORSELETTO RAFAEL,D108,HJ,1.64,,307247.25
6150,1/15/2021,1/15/2021,11521,82L-IMPORT PAYROLL-MORSELETTO RAFAEL,D108,HJ,11.53,,307258.78
6150,1/15/2021,1/15/2021,11521,82L-IMPORT PAYROLL-MORSELETTO RAFAEL,D108,HJ,16.23,,307275.01
6150,1/15/2021,1/15/2021,11521,82L-IMPORT PAYROLL-MORSELETTO RAFAEL,D108,HJ,69.38,,307344.39
6150,1/15/2021,1/15/2021,11521,82L-IMPORT PAYROLL-OBI TOBECHUKWU,D108,HJ,16.23,,307360.62
6150,1/15/2021,1/15/2021,11521,82L-IMPORT PAYROLL-OBI TOBECHUKWU,D108,HJ,69.38,,307430
6150,1/15/2021,1/15/2021,11521,82L-IMPORT PAYROLL-OPUH NDIDI,D108,HJ,34.74,,307464.74
6150,1/15/2021,1/15/2021,11521,82L-IMPORT PAYROLL-OPUH NDIDI,D108,HJ,148.53,,307613.27
6150,1/15/2021,1/15/2021,11521,82L-IMPORT PAYROLL-PAULINO THAIRI,D108,HJ,16.23,,307629.5
6150,1/15/2021,1/15/2021,11521,82L-IMPORT PAYROLL-PAULINO THAIRI,D108,HJ,69.38,,307698.88
6150,1/15/2021,1/15/2021,11521,82L-IMPORT PAYROLL-REYES LATIVA M,D108,HJ,25.51,,307724.39
6150,1/15/2021,1/15/2021,11521,82L-IMPORT PAYROLL-REYES LATIVA M,D108,HJ,109.09,,307833.48
6150,1/15/2021,1/15/2021,11521,82L-IMPORT PAYROLL-ROSENBAUM MURRAY,D108,HJ,16.23,,307849.71
6150,1/15/2021,1/15/2021,11521,82L-IMPORT PAYROLL-ROSENBAUM MURRAY,D108,HJ,69.38,,307919.09
6150,1/15/2021,1/15/2021,11521,82L-IMPORT PAYROLL-SCHWETTMANN CLAIRE,D108,HJ,15.28,,307934.37
6150,1/15/2021,1/15/2021,11521,82L-IMPORT PAYROLL-SCHWETTMANN CLAIRE,D108,HJ,65.35,,307999.72
6150,1/15/2021,1/15/2021,11521,82L-IMPORT PAYROLL-SOBELMAN JUSTIN,D108,HJ,15.08,,308014.8
6150,1/15/2021,1/15/2021,11521,82L-IMPORT PAYROLL-SOBELMAN JUSTIN,D108,HJ,64.5,,308079.3
6150,1/15/2021,1/15/2021,11521,82L-IMPORT PAYROLL-TERRENCE-SMITH ZIHIR,D108,HJ,14.32,,308093.62
6150,1/15/2021,1/15/2021,11521,82L-IMPORT PAYROLL-TERRENCE-SMITH ZIHIR,D108,HJ,61.22,,308154.84
6150,1/15/2021,1/15/2021,11521,82L-IMPORT PAYROLL-TILLERY ASIA,D108,HJ,54.34,,308209.18
6150,1/15/2021,1/15/2021,11521,82L-IMPORT PAYROLL-TILLERY ASIA,D108,HJ,232.34,,308441.52
6150,1/15/2021,1/15/2021,11521,82L-IMPORT PAYROLL-WILLIAMS-MASSEY BRIANNA,D108,HJ,16.05,,308457.57
6150,1/15/2021,1/15/2021,11521,82L-IMPORT PAYROLL-WILLIAMS-MASSEY BRIANNA,D108,HJ,36.93,,308494.5
6150,1/15/2021,1/15/2021,11521,82L-IMPORT PAYROLL-WILLIAMS-MASSEY BRIANNA,D108,HJ,68.64,,308563.14
6150,1/15/2021,1/15/2021,11521,82L-IMPORT PAYROLL-XIAO CHENGYAO,D108,HJ,16.23,,308579.37
6150,1/15/2021,1/15/2021,11521,82L-IMPORT PAYROLL-XIAO CHENGYAO,D108,HJ,69.38,,308648.75
6150,1/15/2021,1/15/2021,11521,82L-IMPORT PAYROLL-ZIAUDDIN ABUTAHER,D108,HJ,16.23,,308664.98
6150,1/15/2021,1/15/2021,11521,82L-IMPORT PAYROLL-ZIAUDDIN ABUTAHER,D108,HJ,69.38,,308734.36
6150,1/15/2021,1/15/2021,11521,82L-IMPORT PAYROLL-BALASUBRAMANIAN SHARANYA,D108,HJ,16.53,,308750.89
6150,1/15/2021,1/15/2021,11521,82L-IMPORT PAYROLL-BALASUBRAMANIAN SHARANYA,D108,HJ,38.67,,308789.56
6150,1/15/2021,1/15/2021,11521,82L-IMPORT PAYROLL-BALASUBRAMANIAN SHARANYA,D108,HJ,72,,308861.56
6150,1/15/2021,1/15/2021,11521,82L-IMPORT PAYROLL-BALASUBRAMANIAN SHARANYA,D108,HJ,165.33,,309026.89
6150,1/15/2021,1/15/2021,11521,82L-IMPORT PAYROLL-COVENEY ALLISON,D108,HJ,38.07,,309064.96
6150,1/15/2021,1/15/2021,11521,82L-IMPORT PAYROLL-COVENEY ALLISON,D108,HJ,162.79,,309227.75
6150,1/15/2021,1/15/2021,11521,82L-IMPORT PAYROLL-JACKSON CLAICE M,D108,HJ,19.38,,309247.13
6150,1/15/2021,1/15/2021,11521,82L-IMPORT PAYROLL-JACKSON CLAICE M,D108,HJ,42.91,,309290.04
6150,1/15/2021,1/15/2021,11521,82L-IMPORT PAYROLL-JACKSON CLAICE M,D108,HJ,84.38,,309374.42
6150,1/15/2021,1/15/2021,11521,82L-IMPORT PAYROLL-JACKSON CLAICE M,D108,HJ,183.48,,309557.9
6150,1/15/2021,1/15/2021,11521,82L-IMPORT PAYROLL-JANG DANIEL,D108,HJ,37.75,,309595.65
6150,1/15/2021,1/15/2021,11521,82L-IMPORT PAYROLL-JANG DANIEL,D108,HJ,67.69,,309663.34
6150,1/15/2021,1/15/2021,11521,82L-IMPORT PAYROLL-JANG DANIEL,D108,HJ,161.4,,309824.74
6150,1/15/2021,1/15/2021,11521,82L-IMPORT PAYROLL-LENEGHAN MARYELLEN,D108,HJ,30.08,,309854.82
6150,1/15/2021,1/15/2021,11521,82L-IMPORT PAYROLL-LENEGHAN MARYELLEN,D108,HJ,36.76,,309891.58
6150,1/15/2021,1/15/2021,11521,82L-IMPORT PAYROLL-LENEGHAN MARYELLEN,D108,HJ,124.45,,310016.03
6150,1/15/2021,1/15/2021,11521,82L-IMPORT PAYROLL-LENEGHAN MARYELLEN,D108,HJ,128.6,,310144.63
6150,1/15/2021,1/15/2021,11521,82L-IMPORT PAYROLL-LENEGHAN MARYELLEN,D108,HJ,157.18,,310301.81
6150,1/29/2021,1/29/2021,12921,82L-IMPORT PAYROLL-BARTHELEMY RACHALIE,D108,HJ,14.01,,310315.82
6150,1/29/2021,1/29/2021,12921,82L-IMPORT PAYROLL-BARTHELEMY RACHALIE,D108,HJ,26.08,,310341.9
6150,1/29/2021,1/29/2021,12921,82L-IMPORT PAYROLL-BARTHELEMY RACHALIE,D108,HJ,59.89,,310401.79
6150,1/29/2021,1/29/2021,12921,82L-IMPORT PAYROLL-BOHLSEN GRACE ISABELLE,D108,HJ,15.16,,310416.95
6150,1/29/2021,1/29/2021,12921,82L-IMPORT PAYROLL-BOHLSEN GRACE ISABELLE,D108,HJ,64.84,,310481.79
6150,1/29/2021,1/29/2021,12921,82L-IMPORT PAYROLL-BOLIVAR ANDREA,D108,HJ,36.25,,310518.04
6150,1/29/2021,1/29/2021,12921,82L-IMPORT PAYROLL-BOLIVAR ANDREA,D108,HJ,67.5,,310585.54
6150,1/29/2021,1/29/2021,12921,82L-IMPORT PAYROLL-BOLIVAR ANDREA,D108,HJ,155,,310740.54
6150,1/29/2021,1/29/2021,12921,82L-IMPORT PAYROLL-BORCHART SPENCER,D108,HJ,15.19,,310755.73
6150,1/29/2021,1/29/2021,12921,82L-IMPORT PAYROLL-BORCHART SPENCER,D108,HJ,44.27,,310800
6150,1/29/2021,1/29/2021,12921,82L-IMPORT PAYROLL-BORCHART SPENCER,D108,HJ,64.95,,310864.95
6150,1/29/2021,1/29/2021,12921,82L-IMPORT PAYROLL-BROWN ISAAC,D108,HJ,14.01,,310878.96
6150,1/29/2021,1/29/2021,12921,82L-IMPORT PAYROLL-BROWN ISAAC,D108,HJ,20.14,,310899.1
6150,1/29/2021,1/29/2021,12921,82L-IMPORT PAYROLL-BROWN ISAAC,D108,HJ,59.89,,310958.99
6150,1/29/2021,1/29/2021,12921,82L-IMPORT PAYROLL-BURKE MARIAH,D108,HJ,15.19,,310974.18
6150,1/29/2021,1/29/2021,12921,82L-IMPORT PAYROLL-BURKE MARIAH,D108,HJ,64.95,,311039.13
6150,1/29/2021,1/29/2021,12921,82L-IMPORT PAYROLL-CASSADY JOSHUA LEWIS,D108,HJ,15.19,,311054.32
6150,1/29/2021,1/29/2021,12921,82L-IMPORT PAYROLL-CASSADY JOSHUA LEWIS,D108,HJ,28.29,,311082.61
6150,1/29/2021,1/29/2021,12921,82L-IMPORT PAYROLL-CASSADY JOSHUA LEWIS,D108,HJ,64.95,,311147.56
6150,1/29/2021,1/29/2021,12921,82L-IMPORT PAYROLL-DARKO OLIVIA,D108,HJ,15.19,,311162.75
6150,1/29/2021,1/29/2021,12921,82L-IMPORT PAYROLL-DARKO OLIVIA,D108,HJ,64.95,,311227.7
6150,1/29/2021,1/29/2021,12921,82L-IMPORT PAYROLL-ESCAMILLA OLGA,D108,HJ,15.19,,311242.89
6150,1/29/2021,1/29/2021,12921,82L-IMPORT PAYROLL-ESCAMILLA OLGA,D108,HJ,64.95,,311307.84
6150,1/29/2021,1/29/2021,12921,82L-IMPORT PAYROLL-GARCIA SANTIAGO,D108,HJ,29.6,,311337.44
6150,1/29/2021,1/29/2021,12921,82L-IMPORT PAYROLL-GARCIA SANTIAGO,D108,HJ,55.13,,311392.57
6150,1/29/2021,1/29/2021,12921,82L-IMPORT PAYROLL-GARCIA SANTIAGO,D108,HJ,126.58,,311519.15
6150,1/29/2021,1/29/2021,12921,82L-IMPORT PAYROLL-GILES SHAYLA,D108,HJ,15.19,,311534.34
6150,1/29/2021,1/29/2021,12921,82L-IMPORT PAYROLL-GILES SHAYLA,D108,HJ,28.29,,311562.63
6150,1/29/2021,1/29/2021,12921,82L-IMPORT PAYROLL-GILES SHAYLA,D108,HJ,64.95,,311627.58
6150,1/29/2021,1/29/2021,12921,82L-IMPORT PAYROLL-IKUNIKA FUNMILAYO,D108,HJ,30.21,,311657.79
6150,1/29/2021,1/29/2021,12921,82L-IMPORT PAYROLL-IKUNIKA FUNMILAYO,D108,HJ,56.25,,311714.04
6150,1/29/2021,1/29/2021,12921,82L-IMPORT PAYROLL-IKUNIKA FUNMILAYO,D108,HJ,129.17,,311843.21
6150,1/29/2021,1/29/2021,12921,82L-IMPORT PAYROLL-JONES JORDAN,D108,HJ,15.19,,311858.4
6150,1/29/2021,1/29/2021,12921,82L-IMPORT PAYROLL-JONES JORDAN,D108,HJ,64.95,,311923.35
6150,1/29/2021,1/29/2021,12921,82L-IMPORT PAYROLL-KHAN HUDA,D108,HJ,14.25,,311937.6
6150,1/29/2021,1/29/2021,12921,82L-IMPORT PAYROLL-KHAN HUDA,D108,HJ,26.53,,311964.13
6150,1/29/2021,1/29/2021,12921,82L-IMPORT PAYROLL-KHAN HUDA,D108,HJ,60.92,,312025.05
6150,1/29/2021,1/29/2021,12921,82L-IMPORT PAYROLL-KLOHR TIMOTHY JORDAN,D108,HJ,29,,312054.05
6150,1/29/2021,1/29/2021,12921,82L-IMPORT PAYROLL-KLOHR TIMOTHY JORDAN,D108,HJ,54,,312108.05
6150,1/29/2021,1/29/2021,12921,82L-IMPORT PAYROLL-KLOHR TIMOTHY JORDAN,D108,HJ,124,,312232.05
6150,1/29/2021,1/29/2021,12921,82L-IMPORT PAYROLL-KNOWLIN ZYLIA,D108,HJ,32.46,,312264.51
6150,1/29/2021,1/29/2021,12921,82L-IMPORT PAYROLL-KNOWLIN ZYLIA,D108,HJ,60.45,,312324.96
6150,1/29/2021,1/29/2021,12921,82L-IMPORT PAYROLL-KNOWLIN ZYLIA,D108,HJ,138.81,,312463.77
6150,1/29/2021,1/29/2021,12921,82L-IMPORT PAYROLL-KOPSHEVER MELISSA,D108,HJ,42.24,,312506.01
6150,1/29/2021,1/29/2021,12921,82L-IMPORT PAYROLL-KOPSHEVER MELISSA,D108,HJ,78.66,,312584.67
6150,1/29/2021,1/29/2021,12921,82L-IMPORT PAYROLL-KOPSHEVER MELISSA,D108,HJ,180.62,,312765.29
6150,1/29/2021,1/29/2021,12921,82L-IMPORT PAYROLL-LAI GRADY,D108,HJ,15.19,,312780.48
6150,1/29/2021,1/29/2021,12921,82L-IMPORT PAYROLL-LAI GRADY,D108,HJ,36.67,,312817.15
6150,1/29/2021,1/29/2021,12921,82L-IMPORT PAYROLL-LAI GRADY,D108,HJ,64.95,,312882.1
6150,1/29/2021,1/29/2021,12921,82L-IMPORT PAYROLL-LI SEN YUAN,D108,HJ,14.05,,312896.15
6150,1/29/2021,1/29/2021,12921,82L-IMPORT PAYROLL-LI SEN YUAN,D108,HJ,26.16,,312922.31
6150,1/29/2021,1/29/2021,12921,82L-IMPORT PAYROLL-LI SEN YUAN,D108,HJ,60.07,,312982.38
6150,1/29/2021,1/29/2021,12921,82L-IMPORT PAYROLL-LIPSCOMB STEPHEN,D108,HJ,33.58,,313015.96
6150,1/29/2021,1/29/2021,12921,82L-IMPORT PAYROLL-LIPSCOMB STEPHEN,D108,HJ,62.53,,313078.49
6150,1/29/2021,1/29/2021,12921,82L-IMPORT PAYROLL-LIPSCOMB STEPHEN,D108,HJ,143.59,,313222.08
6150,1/29/2021,1/29/2021,12921,82L-IMPORT PAYROLL-MALLECK JESSICA R,D108,HJ,15.19,,313237.27
6150,1/29/2021,1/29/2021,12921,82L-IMPORT PAYROLL-MALLECK JESSICA R,D108,HJ,64.95,,313302.22
6150,1/29/2021,1/29/2021,12921,82L-IMPORT PAYROLL-MEJIA ROSO CARLOS,D108,HJ,14.01,,313316.23
6150,1/29/2021,1/29/2021,12921,82L-IMPORT PAYROLL-MEJIA ROSO CARLOS,D108,HJ,26.08,,313342.31
6150,1/29/2021,1/29/2021,12921,82L-IMPORT PAYROLL-MEJIA ROSO CARLOS,D108,HJ,59.89,,313402.2
6150,1/29/2021,1/29/2021,12921,82L-IMPORT PAYROLL-MONROY-MEJIA JASON,D108,HJ,15.19,,313417.39
6150,1/29/2021,1/29/2021,12921,82L-IMPORT PAYROLL-MONROY-MEJIA JASON,D108,HJ,36.67,,313454.06
6150,1/29/2021,1/29/2021,12921,82L-IMPORT PAYROLL-MONROY-MEJIA JASON,D108,HJ,64.95,,313519.01
6150,1/29/2021,1/29/2021,12921,82L-IMPORT PAYROLL-O'FLYNN-PRUITT NATHAN COLYAR,D108,HJ,15.19,,313534.2
6150,1/29/2021,1/29/2021,12921,82L-IMPORT PAYROLL-O'FLYNN-PRUITT NATHAN COLYAR,D108,HJ,36.67,,313570.87
6150,1/29/2021,1/29/2021,12921,82L-IMPORT PAYROLL-O'FLYNN-PRUITT NATHAN COLYAR,D108,HJ,64.95,,313635.82
6150,1/29/2021,1/29/2021,12921,82L-IMPORT PAYROLL-OKRAH JULIAN O,D108,HJ,15.19,,313651.01
6150,1/29/2021,1/29/2021,12921,82L-IMPORT PAYROLL-OKRAH JULIAN O,D108,HJ,33.52,,313684.53
6150,1/29/2021,1/29/2021,12921,82L-IMPORT PAYROLL-OKRAH JULIAN O,D108,HJ,64.95,,313749.48
6150,1/29/2021,1/29/2021,12921,82L-IMPORT PAYROLL-PATTERSON STEVE,D108,HJ,15.19,,313764.67
6150,1/29/2021,1/29/2021,12921,82L-IMPORT PAYROLL-PATTERSON STEVE,D108,HJ,28.29,,313792.96
6150,1/29/2021,1/29/2021,12921,82L-IMPORT PAYROLL-PATTERSON STEVE,D108,HJ,64.95,,313857.91
6150,1/29/2021,1/29/2021,12921,82L-IMPORT PAYROLL-SCHMIESS RACHEL JOY,D108,HJ,10.69,,313868.6
6150,1/29/2021,1/29/2021,12921,82L-IMPORT PAYROLL-SCHMIESS RACHEL JOY,D108,HJ,15.19,,313883.79
6150,1/29/2021,1/29/2021,12921,82L-IMPORT PAYROLL-SCHMIESS RACHEL JOY,D108,HJ,64.95,,313948.74
6150,1/29/2021,1/29/2021,12921,82L-IMPORT PAYROLL-SCOTT KIRK DONOVAN,D108,HJ,14.05,,313962.79
6150,1/29/2021,1/29/2021,12921,82L-IMPORT PAYROLL-SCOTT KIRK DONOVAN,D108,HJ,26.16,,313988.95
6150,1/29/2021,1/29/2021,12921,82L-IMPORT PAYROLL-SCOTT KIRK DONOVAN,D108,HJ,60.07,,314049.02
6150,1/29/2021,1/29/2021,12921,82L-IMPORT PAYROLL-SILVER KELLY,D108,HJ,34.63,,314083.65
6150,1/29/2021,1/29/2021,12921,82L-IMPORT PAYROLL-SILVER KELLY,D108,HJ,64.48,,314148.13
6150,1/29/2021,1/29/2021,12921,82L-IMPORT PAYROLL-SILVER KELLY,D108,HJ,148.06,,314296.19
6150,1/29/2021,1/29/2021,12921,82L-IMPORT PAYROLL-SOLIMAN MARK,D108,HJ,15.19,,314311.38
6150,1/29/2021,1/29/2021,12921,82L-IMPORT PAYROLL-SOLIMAN MARK,D108,HJ,36.67,,314348.05
6150,1/29/2021,1/29/2021,12921,82L-IMPORT PAYROLL-SOLIMAN MARK,D108,HJ,64.95,,314413
6150,1/29/2021,1/29/2021,12921,82L-IMPORT PAYROLL-STEIN KYLE,D108,HJ,27.84,,314440.84
6150,1/29/2021,1/29/2021,12921,82L-IMPORT PAYROLL-STEIN KYLE,D108,HJ,51.84,,314492.68
6150,1/29/2021,1/29/2021,12921,82L-IMPORT PAYROLL-STEIN KYLE,D108,HJ,119.05,,314611.73
6150,1/29/2021,1/29/2021,12921,82L-IMPORT PAYROLL-STROUD DAVID,D108,HJ,14.66,,314626.39
6150,1/29/2021,1/29/2021,12921,82L-IMPORT PAYROLL-STROUD DAVID,D108,HJ,31.34,,314657.73
6150,1/29/2021,1/29/2021,12921,82L-IMPORT PAYROLL-STROUD DAVID,D108,HJ,62.68,,314720.41
6150,1/29/2021,1/29/2021,12921,82L-IMPORT PAYROLL-VALCIN SABRINA JEMIMAH,D108,HJ,14.25,,314734.66
6150,1/29/2021,1/29/2021,12921,82L-IMPORT PAYROLL-VALCIN SABRINA JEMIMAH,D108,HJ,26.53,,314761.19
6150,1/29/2021,1/29/2021,12921,82L-IMPORT PAYROLL-VALCIN SABRINA JEMIMAH,D108,HJ,60.92,,314822.11
6150,1/29/2021,1/29/2021,12921,82L-IMPORT PAYROLL-VALDES ERNEST L,D108,HJ,15.19,,314837.3
6150,1/29/2021,1/29/2021,12921,82L-IMPORT PAYROLL-VALDES ERNEST L,D108,HJ,36.67,,314873.97
6150,1/29/2021,1/29/2021,12921,82L-IMPORT PAYROLL-VALDES ERNEST L,D108,HJ,64.95,,314938.92
6150,1/29/2021,1/29/2021,12921,82L-IMPORT PAYROLL-WILLIAMS MACK ANTHONY,D108,HJ,15.02,,314953.94
6150,1/29/2021,1/29/2021,12921,82L-IMPORT PAYROLL-WILLIAMS MACK ANTHONY,D108,HJ,27.96,,314981.9
6150,1/29/2021,1/29/2021,12921,82L-IMPORT PAYROLL-WILLIAMS MACK ANTHONY,D108,HJ,64.21,,315046.11
6150,1/29/2021,1/29/2021,12921,82L-IMPORT PAYROLL-WILLIAMS MIL'YONTA,D108,HJ,15.19,,315061.3
6150,1/29/2021,1/29/2021,12921,82L-IMPORT PAYROLL-WILLIAMS MIL'YONTA,D108,HJ,28.29,,315089.59
6150,1/29/2021,1/29/2021,12921,82L-IMPORT PAYROLL-WILLIAMS MIL'YONTA,D108,HJ,64.95,,315154.54
6150,1/29/2021,1/29/2021,12921,82L-IMPORT PAYROLL-ANTHONY BETTY S,D108,HJ,41.85,,315196.39
6150,1/29/2021,1/29/2021,12921,82L-IMPORT PAYROLL-ANTHONY BETTY S,D108,HJ,178.96,,315375.35
6150,1/29/2021,1/29/2021,12921,82L-IMPORT PAYROLL-APULI LINDSAY,D108,HJ,34.16,,315409.51
6150,1/29/2021,1/29/2021,12921,82L-IMPORT PAYROLL-APULI LINDSAY,D108,HJ,146.08,,315555.59
6150,1/29/2021,1/29/2021,12921,82L-IMPORT PAYROLL-AUSTIN PERCY ANTONIO,D108,HJ,36.34,,315591.93
6150,1/29/2021,1/29/2021,12921,82L-IMPORT PAYROLL-AUSTIN PERCY ANTONIO,D108,HJ,155.39,,315747.32
6150,1/29/2021,1/29/2021,12921,82L-IMPORT PAYROLL-BUHMANN JENNIFER,D108,HJ,32.9,,315780.22
6150,1/29/2021,1/29/2021,12921,82L-IMPORT PAYROLL-BUHMANN JENNIFER,D108,HJ,140.68,,315920.9
6150,1/29/2021,1/29/2021,12921,82L-IMPORT PAYROLL-CAIN CORY,D108,HJ,36.32,,315957.22
6150,1/29/2021,1/29/2021,12921,82L-IMPORT PAYROLL-CAIN CORY,D108,HJ,155.3,,316112.52
6150,1/29/2021,1/29/2021,12921,82L-IMPORT PAYROLL-CHAPMAN CLAUDY EARL,D108,HJ,33.03,,316145.55
6150,1/29/2021,1/29/2021,12921,82L-IMPORT PAYROLL-CHAPMAN CLAUDY EARL,D108,HJ,141.23,,316286.78
6150,1/29/2021,1/29/2021,12921,82L-IMPORT PAYROLL-DADA ARIKPO E,D108,HJ,32.04,,316318.82
6150,1/29/2021,1/29/2021,12921,82L-IMPORT PAYROLL-DADA ARIKPO E,D108,HJ,137,,316455.82
6150,1/29/2021,1/29/2021,12921,82L-IMPORT PAYROLL-GUTHRIE LESLIE,D108,HJ,33.42,,316489.24
6150,1/29/2021,1/29/2021,12921,82L-IMPORT PAYROLL-GUTHRIE LESLIE,D108,HJ,142.9,,316632.14
6150,1/29/2021,1/29/2021,12921,82L-IMPORT PAYROLL-HOLMES JOREL ALEXANDER,D108,HJ,31.22,,316663.36
6150,1/29/2021,1/29/2021,12921,82L-IMPORT PAYROLL-HOLMES JOREL ALEXANDER,D108,HJ,133.51,,316796.87
6150,1/29/2021,1/29/2021,12921,82L-IMPORT PAYROLL-JORDAN TIFFANY T,D108,HJ,45.87,,316842.74
6150,1/29/2021,1/29/2021,12921,82L-IMPORT PAYROLL-JORDAN TIFFANY T,D108,HJ,196.13,,317038.87
6150,1/29/2021,1/29/2021,12921,82L-IMPORT PAYROLL-LANIGAN LISA A,D108,HJ,45.1,,317083.97
6150,1/29/2021,1/29/2021,12921,82L-IMPORT PAYROLL-LANIGAN LISA A,D108,HJ,192.83,,317276.8
6150,1/29/2021,1/29/2021,12921,82L-IMPORT PAYROLL-MCELWEE MELISSA,D108,HJ,38.67,,317315.47
6150,1/29/2021,1/29/2021,12921,82L-IMPORT PAYROLL-MCELWEE MELISSA,D108,HJ,165.33,,317480.8
6150,1/29/2021,1/29/2021,12921,82L-IMPORT PAYROLL-MCNICHOLAS MARY,D108,HJ,33.23,,317514.03
6150,1/29/2021,1/29/2021,12921,82L-IMPORT PAYROLL-MCNICHOLAS MARY,D108,HJ,142.08,,317656.11
6150,1/29/2021,1/29/2021,12921,82L-IMPORT PAYROLL-NWAKANMA NANCY,D108,HJ,44.18,,317700.29
6150,1/29/2021,1/29/2021,12921,82L-IMPORT PAYROLL-NWAKANMA NANCY,D108,HJ,188.89,,317889.18
6150,1/29/2021,1/29/2021,12921,82L-IMPORT PAYROLL-ONICA ANTHONY J,D108,HJ,32.86,,317922.04
6150,1/29/2021,1/29/2021,12921,82L-IMPORT PAYROLL-ONICA ANTHONY J,D108,HJ,140.49,,318062.53
6150,1/29/2021,1/29/2021,12921,82L-IMPORT PAYROLL-PRAHIN NICOLE M,D108,HJ,10.58,,318073.11
6150,1/29/2021,1/29/2021,12921,82L-IMPORT PAYROLL-PRAHIN NICOLE M,D108,HJ,42.33,,318115.44
6150,1/29/2021,1/29/2021,12921,82L-IMPORT PAYROLL-PRAHIN NICOLE M,D108,HJ,45.24,,318160.68
6150,1/29/2021,1/29/2021,12921,82L-IMPORT PAYROLL-PRAHIN NICOLE M,D108,HJ,180.98,,318341.66
6150,1/29/2021,1/29/2021,12921,82L-IMPORT PAYROLL-RIVERS QUIONNA DIANE,D108,HJ,39.27,,318380.93
6150,1/29/2021,1/29/2021,12921,82L-IMPORT PAYROLL-RIVERS QUIONNA DIANE,D108,HJ,167.92,,318548.85
6150,1/29/2021,1/29/2021,12921,82L-IMPORT PAYROLL-SALIM YASSER,D108,HJ,33.1,,318581.95
6150,1/29/2021,1/29/2021,12921,82L-IMPORT PAYROLL-SALIM YASSER,D108,HJ,141.55,,318723.5
6150,1/29/2021,1/29/2021,12921,82L-IMPORT PAYROLL-SEJOUR MAHALIAH,D108,HJ,34.07,,318757.57
6150,1/29/2021,1/29/2021,12921,82L-IMPORT PAYROLL-SEJOUR MAHALIAH,D108,HJ,145.66,,318903.23
6150,1/29/2021,1/29/2021,12921,82L-IMPORT PAYROLL-SKALSKI CHRISTOPHER,D108,HJ,33.86,,318937.09
6150,1/29/2021,1/29/2021,12921,82L-IMPORT PAYROLL-SKALSKI CHRISTOPHER,D108,HJ,144.76,,319081.85
6150,1/29/2021,1/29/2021,12921,82L-IMPORT PAYROLL-TUMENJARGAL ENKHJIN,D108,HJ,32.92,,319114.77
6150,1/29/2021,1/29/2021,12921,82L-IMPORT PAYROLL-TUMENJARGAL ENKHJIN,D108,HJ,140.75,,319255.52
6150,1/29/2021,1/29/2021,12921,82L-IMPORT PAYROLL-VILLEGAS EVELYN,D108,HJ,33.4,,319288.92
6150,1/29/2021,1/29/2021,12921,82L-IMPORT PAYROLL-VILLEGAS EVELYN,D108,HJ,142.81,,319431.73
6150,1/29/2021,1/29/2021,12921,82L-IMPORT PAYROLL-WOLF ANNA A,D108,HJ,36.3,,319468.03
6150,1/29/2021,1/29/2021,12921,82L-IMPORT PAYROLL-WOLF ANNA A,D108,HJ,155.19,,319623.22
6150,1/29/2021,1/29/2021,12921,82L-IMPORT PAYROLL-ACEVEDO MONIVETT,D107,HJ,54.16,,319677.38
6150,1/29/2021,1/29/2021,12921,82L-IMPORT PAYROLL-ACEVEDO MONIVETT,D107,HJ,72.42,,319749.8
6150,1/29/2021,1/29/2021,12921,82L-IMPORT PAYROLL-ACEVEDO MONIVETT,D107,HJ,309.64,,320059.44
6150,1/29/2021,1/29/2021,12921,82L-IMPORT PAYROLL-AKLESTAD ISABEL,D111,HJ,24.01,,320083.45
6150,1/29/2021,1/29/2021,12921,82L-IMPORT PAYROLL-AKLESTAD ISABEL,D111,HJ,102.68,,320186.13
6150,1/29/2021,1/29/2021,12921,82L-IMPORT PAYROLL-BIBB TIFFANI,D104,HJ,49.71,,320235.84
6150,1/29/2021,1/29/2021,12921,82L-IMPORT PAYROLL-BIBB TIFFANI,D104,HJ,92.56,,320328.4
6150,1/29/2021,1/29/2021,12921,82L-IMPORT PAYROLL-BIBB TIFFANI,D104,HJ,212.55,,320540.95
6150,1/29/2021,1/29/2021,12921,82L-IMPORT PAYROLL-BOWMAN HALLEY K,D101,HJ,49.84,,320590.79
6150,1/29/2021,1/29/2021,12921,82L-IMPORT PAYROLL-BOWMAN HALLEY K,D101,HJ,66.1,,320656.89
6150,1/29/2021,1/29/2021,12921,82L-IMPORT PAYROLL-BOWMAN HALLEY K,D101,HJ,213.13,,320870.02
6150,1/29/2021,1/29/2021,12921,82L-IMPORT PAYROLL-COOK CATHRYN ANNA,D105,HJ,49.87,,320919.89
6150,1/29/2021,1/29/2021,12921,82L-IMPORT PAYROLL-COOK CATHRYN ANNA,D105,HJ,151.84,,321071.73
6150,1/29/2021,1/29/2021,12921,82L-IMPORT PAYROLL-COOK CATHRYN ANNA,D105,HJ,213.25,,321284.98
6150,1/29/2021,1/29/2021,12921,82L-IMPORT PAYROLL-COOPER ASHLEE R,D101,HJ,33.51,,321318.49
6150,1/29/2021,1/29/2021,12921,82L-IMPORT PAYROLL-COOPER ASHLEE R,D101,HJ,143.3,,321461.79
6150,1/29/2021,1/29/2021,12921,82L-IMPORT PAYROLL-CORTEZ MIRANDA A,D111,HJ,39.18,,321500.97
6150,1/29/2021,1/29/2021,12921,82L-IMPORT PAYROLL-CORTEZ MIRANDA A,D111,HJ,73.51,,321574.48
6150,1/29/2021,1/29/2021,12921,82L-IMPORT PAYROLL-CORTEZ MIRANDA A,D111,HJ,167.52,,321742
6150,1/29/2021,1/29/2021,12921,82L-IMPORT PAYROLL-DAUGHERTY DEVIN W,D101,HJ,15.1,,321757.1
6150,1/29/2021,1/29/2021,12921,82L-IMPORT PAYROLL-DAUGHERTY DEVIN W,D101,HJ,28.13,,321785.23
6150,1/29/2021,1/29/2021,12921,82L-IMPORT PAYROLL-DAUGHERTY DEVIN W,D101,HJ,64.58,,321849.81
6150,1/29/2021,1/29/2021,12921,82L-IMPORT PAYROLL-DETONE KYRA MAYA,D102,HJ,39,,321888.81
6150,1/29/2021,1/29/2021,12921,82L-IMPORT PAYROLL-DETONE KYRA MAYA,D102,HJ,123.26,,322012.07
6150,1/29/2021,1/29/2021,12921,82L-IMPORT PAYROLL-DETONE KYRA MAYA,D102,HJ,166.75,,322178.82
6150,1/29/2021,1/29/2021,12921,82L-IMPORT PAYROLL-DUPUIS CHRISTOPHER M,D107,HJ,44.37,,322223.19
6150,1/29/2021,1/29/2021,12921,82L-IMPORT PAYROLL-DUPUIS CHRISTOPHER M,D107,HJ,44.37,,322267.56
6150,1/29/2021,1/29/2021,12921,82L-IMPORT PAYROLL-DUPUIS CHRISTOPHER M,D107,HJ,189.72,,322457.28
6150,1/29/2021,1/29/2021,12921,82L-IMPORT PAYROLL-DUPUIS CHRISTOPHER M,D107,HJ,189.73,,322647.01
6150,1/29/2021,1/29/2021,12921,82L-IMPORT PAYROLL-DUPUIS CHRISTOPHER M,D107,HJ,265.01,,322912.02
6150,1/29/2021,1/29/2021,12921,82L-IMPORT PAYROLL-DZIEDZIC JULIE K,D101,HJ,17.71,,322929.73
6150,1/29/2021,1/29/2021,12921,82L-IMPORT PAYROLL-DZIEDZIC JULIE K,D101,HJ,75.71,,323005.44
6150,1/29/2021,1/29/2021,12921,82L-IMPORT PAYROLL-FEENEY CLAIRE,D104,HJ,26.82,,323032.26
6150,1/29/2021,1/29/2021,12921,82L-IMPORT PAYROLL-FEENEY CLAIRE,D104,HJ,114.66,,323146.92
6150,1/29/2021,1/29/2021,12921,82L-IMPORT PAYROLL-FISCHABER THOMAS,D109,HJ,77.9,,323224.82
6150,1/29/2021,1/29/2021,12921,82L-IMPORT PAYROLL-FISCHABER THOMAS,D109,HJ,91.33,,323316.15
6150,1/29/2021,1/29/2021,12921,82L-IMPORT PAYROLL-FISCHABER THOMAS,D109,HJ,333.1,,323649.25
6150,1/29/2021,1/29/2021,12921,82L-IMPORT PAYROLL-FLORY MEGAN,D109,HJ,21.75,,323671
6150,1/29/2021,1/29/2021,12921,82L-IMPORT PAYROLL-FLORY MEGAN,D109,HJ,25.5,,323696.5
6150,1/29/2021,1/29/2021,12921,82L-IMPORT PAYROLL-FLORY MEGAN,D109,HJ,93,,323789.5
6150,1/29/2021,1/29/2021,12921,82L-IMPORT PAYROLL-GORNSTEIN STEVEN,D101,HJ,39.27,,323828.77
6150,1/29/2021,1/29/2021,12921,82L-IMPORT PAYROLL-GORNSTEIN STEVEN,D101,HJ,114.45,,323943.22
6150,1/29/2021,1/29/2021,12921,82L-IMPORT PAYROLL-GORNSTEIN STEVEN,D101,HJ,167.92,,324111.14
6150,1/29/2021,1/29/2021,12921,82L-IMPORT PAYROLL-GUADARRAMA-ALVAREZ URIEL A,D105,HJ,39.93,,324151.07
6150,1/29/2021,1/29/2021,12921,82L-IMPORT PAYROLL-GUADARRAMA-ALVAREZ URIEL A,D105,HJ,78.24,,324229.31
6150,1/29/2021,1/29/2021,12921,82L-IMPORT PAYROLL-GUADARRAMA-ALVAREZ URIEL A,D105,HJ,170.75,,324400.06
6150,1/29/2021,1/29/2021,12921,82L-IMPORT PAYROLL-GUTIERREZ ANTONIO J,D107,HJ,30.66,,324430.72
6150,1/29/2021,1/29/2021,12921,82L-IMPORT PAYROLL-GUTIERREZ ANTONIO J,D107,HJ,45.99,,324476.71
6150,1/29/2021,1/29/2021,12921,82L-IMPORT PAYROLL-GUTIERREZ ANTONIO J,D107,HJ,131.1,,324607.81
6150,1/29/2021,1/29/2021,12921,82L-IMPORT PAYROLL-GUTIERREZ ANTONIO J,D107,HJ,196.66,,324804.47
6150,1/29/2021,1/29/2021,12921,82L-IMPORT PAYROLL-GUTIERREZ ANTONIO J,D107,HJ,240.58,,325045.05
6150,1/29/2021,1/29/2021,12921,82L-IMPORT PAYROLL-HENRY GILLIAN,D102,HJ,29.17,,325074.22
6150,1/29/2021,1/29/2021,12921,82L-IMPORT PAYROLL-HENRY GILLIAN,D102,HJ,70.42,,325144.64
6150,1/29/2021,1/29/2021,12921,82L-IMPORT PAYROLL-HENRY GILLIAN,D102,HJ,124.74,,325269.38
6150,1/29/2021,1/29/2021,12921,82L-IMPORT PAYROLL-HERMAN ADAM,D102,HJ,28.2,,325297.58
6150,1/29/2021,1/29/2021,12921,82L-IMPORT PAYROLL-HERMAN ADAM,D102,HJ,120.56,,325418.14
6150,1/29/2021,1/29/2021,12921,82L-IMPORT PAYROLL-HERNANDEZ ANNA,D101,HJ,37.18,,325455.32
6150,1/29/2021,1/29/2021,12921,82L-IMPORT PAYROLL-HERNANDEZ ANNA,D101,HJ,64.11,,325519.43
6150,1/29/2021,1/29/2021,12921,82L-IMPORT PAYROLL-HERNANDEZ ANNA,D101,HJ,159,,325678.43
6150,1/29/2021,1/29/2021,12921,82L-IMPORT PAYROLL-HESTER TYLER CONRAD,D105,HJ,27.79,,325706.22
6150,1/29/2021,1/29/2021,12921,82L-IMPORT PAYROLL-HESTER TYLER CONRAD,D105,HJ,118.83,,325825.05
6150,1/29/2021,1/29/2021,12921,82L-IMPORT PAYROLL-HOLT ADAM,D109,HJ,58.24,,325883.29
6150,1/29/2021,1/29/2021,12921,82L-IMPORT PAYROLL-HOLT ADAM,D109,HJ,68.28,,325951.57
6150,1/29/2021,1/29/2021,12921,82L-IMPORT PAYROLL-HOLT ADAM,D109,HJ,249.03,,326200.6
6150,1/29/2021,1/29/2021,12921,82L-IMPORT PAYROLL-KELLY SEAN,D109,HJ,78.54,,326279.14
6150,1/29/2021,1/29/2021,12921,82L-IMPORT PAYROLL-KELLY SEAN,D109,HJ,92.08,,326371.22
6150,1/29/2021,1/29/2021,12921,82L-IMPORT PAYROLL-KELLY SEAN,D109,HJ,335.83,,326707.05
6150,1/29/2021,1/29/2021,12921,82L-IMPORT PAYROLL-KRUGER MARK,D109,HJ,72.5,,326779.55
6150,1/29/2021,1/29/2021,12921,82L-IMPORT PAYROLL-KRUGER MARK,D109,HJ,85,,326864.55
6150,1/29/2021,1/29/2021,12921,82L-IMPORT PAYROLL-KRUGER MARK,D109,HJ,310,,327174.55
6150,1/29/2021,1/29/2021,12921,82L-IMPORT PAYROLL-LIPORACE HERNAN LUIS,D103,HJ,33.06,,327207.61
6150,1/29/2021,1/29/2021,12921,82L-IMPORT PAYROLL-LIPORACE HERNAN LUIS,D103,HJ,61.55,,327269.16
6150,1/29/2021,1/29/2021,12921,82L-IMPORT PAYROLL-LIPORACE HERNAN LUIS,D103,HJ,141.34,,327410.5
6150,1/29/2021,1/29/2021,12921,82L-IMPORT PAYROLL-MARKS KRISTA,D109,HJ,76.2,,327486.7
6150,1/29/2021,1/29/2021,12921,82L-IMPORT PAYROLL-MARKS KRISTA,D109,HJ,89.33,,327576.03
6150,1/29/2021,1/29/2021,12921,82L-IMPORT PAYROLL-MARKS KRISTA,D109,HJ,325.8,,327901.83
6150,1/29/2021,1/29/2021,12921,82L-IMPORT PAYROLL-MELVIN DARNELL KEVIN,D109,HJ,48.2,,327950.03
6150,1/29/2021,1/29/2021,12921,82L-IMPORT PAYROLL-MELVIN DARNELL KEVIN,D109,HJ,55.91,,328005.94
6150,1/29/2021,1/29/2021,12921,82L-IMPORT PAYROLL-MELVIN DARNELL KEVIN,D109,HJ,239.08,,328245.02
6150,1/29/2021,1/29/2021,12921,82L-IMPORT PAYROLL-MESSING JENNIFER,D104,HJ,34.12,,328279.14
6150,1/29/2021,1/29/2021,12921,82L-IMPORT PAYROLL-MESSING JENNIFER,D104,HJ,63.54,,328342.68
6150,1/29/2021,1/29/2021,12921,82L-IMPORT PAYROLL-MESSING JENNIFER,D104,HJ,145.9,,328488.58
6150,1/29/2021,1/29/2021,12921,82L-IMPORT PAYROLL-MILNE ROGER,D109,HJ,76.2,,328564.78
6150,1/29/2021,1/29/2021,12921,82L-IMPORT PAYROLL-MILNE ROGER,D109,HJ,89.33,,328654.11
6150,1/29/2021,1/29/2021,12921,82L-IMPORT PAYROLL-MILNE ROGER,D109,HJ,325.8,,328979.91
6150,1/29/2021,1/29/2021,12921,82L-IMPORT PAYROLL-MOSTAFAVI YASAMAN,D109,HJ,7.66,,328987.57
6150,1/29/2021,1/29/2021,12921,82L-IMPORT PAYROLL-MOSTAFAVI YASAMAN,D109,HJ,12.55,,329000.12
6150,1/29/2021,1/29/2021,12921,82L-IMPORT PAYROLL-MOSTAFAVI YASAMAN,D109,HJ,32.74,,329032.86
6150,1/29/2021,1/29/2021,12921,82L-IMPORT PAYROLL-O'DONNELL STEPHEN,D104,HJ,37.03,,329069.89
6150,1/29/2021,1/29/2021,12921,82L-IMPORT PAYROLL-O'DONNELL STEPHEN,D104,HJ,63.85,,329133.74
6150,1/29/2021,1/29/2021,12921,82L-IMPORT PAYROLL-O'DONNELL STEPHEN,D104,HJ,158.35,,329292.09
6150,1/29/2021,1/29/2021,12921,82L-IMPORT PAYROLL-PARETS MALLORY GRACE,D101,HJ,17.57,,329309.66
6150,1/29/2021,1/29/2021,12921,82L-IMPORT PAYROLL-PARETS MALLORY GRACE,D101,HJ,41.08,,329350.74
6150,1/29/2021,1/29/2021,12921,82L-IMPORT PAYROLL-PARETS MALLORY GRACE,D101,HJ,76.5,,329427.24
6150,1/29/2021,1/29/2021,12921,82L-IMPORT PAYROLL-PARETS MALLORY GRACE,D101,HJ,175.67,,329602.91
6150,1/29/2021,1/29/2021,12921,82L-IMPORT PAYROLL-PARHAM-GANTT DENISE M,D112,HJ,37.96,,329640.87
6150,1/29/2021,1/29/2021,12921,82L-IMPORT PAYROLL-PARHAM-GANTT DENISE M,D112,HJ,162.32,,329803.19
6150,1/29/2021,1/29/2021,12921,82L-IMPORT PAYROLL-PEINADO ELIZABETH R,D111,HJ,53.01,,329856.2
6150,1/29/2021,1/29/2021,12921,82L-IMPORT PAYROLL-PEINADO ELIZABETH R,D111,HJ,226.68,,330082.88
6150,1/29/2021,1/29/2021,12921,82L-IMPORT PAYROLL-PERNIA JEFFREY,D109,HJ,56.19,,330139.07
6150,1/29/2021,1/29/2021,12921,82L-IMPORT PAYROLL-PERNIA JEFFREY,D109,HJ,108.59,,330247.66
6150,1/29/2021,1/29/2021,12921,82L-IMPORT PAYROLL-PERNIA JEFFREY,D109,HJ,240.25,,330487.91
6150,1/29/2021,1/29/2021,12921,82L-IMPORT PAYROLL-PIRES MANUEL,D103,HJ,31.08,,330518.99
6150,1/29/2021,1/29/2021,12921,82L-IMPORT PAYROLL-PIRES MANUEL,D103,HJ,93.32,,330612.31
6150,1/29/2021,1/29/2021,12921,82L-IMPORT PAYROLL-PIRES MANUEL,D103,HJ,132.89,,330745.2
6150,1/29/2021,1/29/2021,12921,82L-IMPORT PAYROLL-POLANCO ODALIS,D103,HJ,43.23,,330788.43
6150,1/29/2021,1/29/2021,12921,82L-IMPORT PAYROLL-POLANCO ODALIS,D103,HJ,80.49,,330868.92
6150,1/29/2021,1/29/2021,12921,82L-IMPORT PAYROLL-POLANCO ODALIS,D103,HJ,184.83,,331053.75
6150,1/29/2021,1/29/2021,12921,82L-IMPORT PAYROLL-QUINTAS JASHIVE,D105,HJ,25.57,,331079.32
6150,1/29/2021,1/29/2021,12921,82L-IMPORT PAYROLL-QUINTAS JASHIVE,D105,HJ,109.31,,331188.63
6150,1/29/2021,1/29/2021,12921,82L-IMPORT PAYROLL-RANDOLPH ALEXANDER,D111,HJ,11.94,,331200.57
6150,1/29/2021,1/29/2021,12921,82L-IMPORT PAYROLL-RANDOLPH ALEXANDER,D111,HJ,25.83,,331226.4
6150,1/29/2021,1/29/2021,12921,82L-IMPORT PAYROLL-RANDOLPH ALEXANDER,D111,HJ,51.98,,331278.38
6150,1/29/2021,1/29/2021,12921,82L-IMPORT PAYROLL-RANDOLPH ALEXANDER,D111,HJ,110.43,,331388.81
6150,1/29/2021,1/29/2021,12921,82L-IMPORT PAYROLL-RUBI PERLA,D101,HJ,15.92,,331404.73
6150,1/29/2021,1/29/2021,12921,82L-IMPORT PAYROLL-RUBI PERLA,D101,HJ,68.09,,331472.82
6150,1/29/2021,1/29/2021,12921,82L-IMPORT PAYROLL-SAFRAN ALAN P,D107,HJ,10.36,,331483.18
6150,1/29/2021,1/29/2021,12921,82L-IMPORT PAYROLL-SAFRAN ALAN P,D107,HJ,44.26,,331527.44
6150,1/29/2021,1/29/2021,12921,82L-IMPORT PAYROLL-SAFRAN ALAN P,D107,HJ,93.16,,331620.6
6150,1/29/2021,1/29/2021,12921,82L-IMPORT PAYROLL-SAFRAN ALAN P,D107,HJ,306.71,,331927.31
6150,1/29/2021,1/29/2021,12921,82L-IMPORT PAYROLL-SAFRAN ALAN P,D107,HJ,398.38,,332325.69
6150,1/29/2021,1/29/2021,12921,82L-IMPORT PAYROLL-SHENKMAN OLIVIA,D101,HJ,29,,332354.69
6150,1/29/2021,1/29/2021,12921,82L-IMPORT PAYROLL-SHENKMAN OLIVIA,D101,HJ,124,,332478.69
6150,1/29/2021,1/29/2021,12921,82L-IMPORT PAYROLL-SHI GRACE,D103,HJ,12.69,,332491.38
6150,1/29/2021,1/29/2021,12921,82L-IMPORT PAYROLL-SHI GRACE,D103,HJ,36.98,,332528.36
6150,1/29/2021,1/29/2021,12921,82L-IMPORT PAYROLL-SHI GRACE,D103,HJ,54.25,,332582.61
6150,1/29/2021,1/29/2021,12921,82L-IMPORT PAYROLL-VYAS SUNAINA,D104,HJ,29.12,,332611.73
6150,1/29/2021,1/29/2021,12921,82L-IMPORT PAYROLL-VYAS SUNAINA,D104,HJ,70.29,,332682.02
6150,1/29/2021,1/29/2021,12921,82L-IMPORT PAYROLL-VYAS SUNAINA,D104,HJ,124.52,,332806.54
6150,1/29/2021,1/29/2021,12921,82L-IMPORT PAYROLL-WALLACE AMENA,D104,HJ,28.93,,332835.47
6150,1/29/2021,1/29/2021,12921,82L-IMPORT PAYROLL-WALLACE AMENA,D104,HJ,123.72,,332959.19
6150,1/29/2021,1/29/2021,12921,82L-IMPORT PAYROLL-WARD JEFFREY,D109,HJ,78.54,,333037.73
6150,1/29/2021,1/29/2021,12921,82L-IMPORT PAYROLL-WARD JEFFREY,D109,HJ,92.08,,333129.81
6150,1/29/2021,1/29/2021,12921,82L-IMPORT PAYROLL-WARD JEFFREY,D109,HJ,335.83,,333465.64
6150,1/29/2021,1/29/2021,12921,82L-IMPORT PAYROLL-WARD JENNIFER,D109,HJ,15.27,,333480.91
6150,1/29/2021,1/29/2021,12921,82L-IMPORT PAYROLL-WARD JENNIFER,D109,HJ,17.9,,333498.81
6150,1/29/2021,1/29/2021,12921,82L-IMPORT PAYROLL-WARD JENNIFER,D109,HJ,65.29,,333564.1
6150,1/29/2021,1/29/2021,12921,82L-IMPORT PAYROLL-WEINSTOCK EMILY,D101,HJ,17.57,,333581.67
6150,1/29/2021,1/29/2021,12921,82L-IMPORT PAYROLL-WEINSTOCK EMILY,D101,HJ,38.11,,333619.78
6150,1/29/2021,1/29/2021,12921,82L-IMPORT PAYROLL-WEINSTOCK EMILY,D101,HJ,76.5,,333696.28
6150,1/29/2021,1/29/2021,12921,82L-IMPORT PAYROLL-WEINSTOCK EMILY,D101,HJ,162.94,,333859.22
6150,1/29/2021,1/29/2021,12921,82L-IMPORT PAYROLL-WINANS JENNIFER,D111,HJ,37.06,,333896.28
6150,1/29/2021,1/29/2021,12921,82L-IMPORT PAYROLL-WINANS JENNIFER,D111,HJ,69,,333965.28
6150,1/29/2021,1/29/2021,12921,82L-IMPORT PAYROLL-WINANS JENNIFER,D111,HJ,158.45,,334123.73
6150,1/29/2021,1/29/2021,12921,82L-IMPORT PAYROLL-ZARATE JOSEPH M,D105,HJ,31.18,,334154.91
6150,1/29/2021,1/29/2021,12921,82L-IMPORT PAYROLL-ZARATE JOSEPH M,D105,HJ,133.3,,334288.21
6150,1/29/2021,1/29/2021,12921,82L-IMPORT PAYROLL-AGUANNO JOSEPH,D108,HJ,16.23,,334304.44
6150,1/29/2021,1/29/2021,12921,82L-IMPORT PAYROLL-AGUANNO JOSEPH,D108,HJ,69.38,,334373.82
6150,1/29/2021,1/29/2021,12921,82L-IMPORT PAYROLL-AKESODE FEHINTOLA,D108,HJ,16.23,,334390.05
6150,1/29/2021,1/29/2021,12921,82L-IMPORT PAYROLL-AKESODE FEHINTOLA,D108,HJ,69.38,,334459.43
6150,1/29/2021,1/29/2021,12921,82L-IMPORT PAYROLL-BARTOLD DEANNA MARIE,D108,HJ,41.91,,334501.34
6150,1/29/2021,1/29/2021,12921,82L-IMPORT PAYROLL-BARTOLD DEANNA MARIE,D108,HJ,179.22,,334680.56
6150,1/29/2021,1/29/2021,12921,82L-IMPORT PAYROLL-BELLOT GENESIS,D108,HJ,32.36,,334712.92
6150,1/29/2021,1/29/2021,12921,82L-IMPORT PAYROLL-BELLOT GENESIS,D108,HJ,138.38,,334851.3
6150,1/29/2021,1/29/2021,12921,82L-IMPORT PAYROLL-BENNETT JAMES H,D108,HJ,16.23,,334867.53
6150,1/29/2021,1/29/2021,12921,82L-IMPORT PAYROLL-BENNETT JAMES H,D108,HJ,69.38,,334936.91
6150,1/29/2021,1/29/2021,12921,82L-IMPORT PAYROLL-BOWMAN ABIGAIL,D108,HJ,16.23,,334953.14
6150,1/29/2021,1/29/2021,12921,82L-IMPORT PAYROLL-BOWMAN ABIGAIL,D108,HJ,69.38,,335022.52
6150,1/29/2021,1/29/2021,12921,82L-IMPORT PAYROLL-BURRELL RUSSELL,D108,HJ,15.08,,335037.6
6150,1/29/2021,1/29/2021,12921,82L-IMPORT PAYROLL-BURRELL RUSSELL,D108,HJ,28.09,,335065.69
6150,1/29/2021,1/29/2021,12921,82L-IMPORT PAYROLL-BURRELL RUSSELL,D108,HJ,64.5,,335130.19
6150,1/29/2021,1/29/2021,12921,82L-IMPORT PAYROLL-CHUI KENT,D108,HJ,16.23,,335146.42
6150,1/29/2021,1/29/2021,12921,82L-IMPORT PAYROLL-CHUI KENT,D108,HJ,69.38,,335215.8
6150,1/29/2021,1/29/2021,12921,82L-IMPORT PAYROLL-CIRKER MIA,D108,HJ,32.63,,335248.43
6150,1/29/2021,1/29/2021,12921,82L-IMPORT PAYROLL-CIRKER MIA,D108,HJ,139.5,,335387.93
6150,1/29/2021,1/29/2021,12921,82L-IMPORT PAYROLL-DEWS CAMERYN,D108,HJ,33.23,,335421.16
6150,1/29/2021,1/29/2021,12921,82L-IMPORT PAYROLL-DEWS CAMERYN,D108,HJ,142.08,,335563.24
6150,1/29/2021,1/29/2021,12921,82L-IMPORT PAYROLL-DIETZ MARY,D108,HJ,16.23,,335579.47
6150,1/29/2021,1/29/2021,12921,82L-IMPORT PAYROLL-DIETZ MARY,D108,HJ,35.81,,335615.28
6150,1/29/2021,1/29/2021,12921,82L-IMPORT PAYROLL-DIETZ MARY,D108,HJ,69.38,,335684.66
6150,1/29/2021,1/29/2021,12921,82L-IMPORT PAYROLL-DOMINIQUE PRINCESSA,D108,HJ,16.23,,335700.89
6150,1/29/2021,1/29/2021,12921,82L-IMPORT PAYROLL-DOMINIQUE PRINCESSA,D108,HJ,69.38,,335770.27
6150,1/29/2021,1/29/2021,12921,82L-IMPORT PAYROLL-DONNELLY HOME,D108,HJ,6.94,,335777.21
6150,1/29/2021,1/29/2021,12921,82L-IMPORT PAYROLL-DONNELLY HOME,D108,HJ,16.23,,335793.44
6150,1/29/2021,1/29/2021,12921,82L-IMPORT PAYROLL-DONNELLY HOME,D108,HJ,30.21,,335823.65
6150,1/29/2021,1/29/2021,12921,82L-IMPORT PAYROLL-DONNELLY HOME,D108,HJ,69.38,,335893.03
6150,1/29/2021,1/29/2021,12921,82L-IMPORT PAYROLL-FEIGHERY JOHN,D108,HJ,30.56,,335923.59
6150,1/29/2021,1/29/2021,12921,82L-IMPORT PAYROLL-FEIGHERY JOHN,D108,HJ,130.69,,336054.28
6150,1/29/2021,1/29/2021,12921,82L-IMPORT PAYROLL-FORTH KYLE,D108,HJ,16.23,,336070.51
6150,1/29/2021,1/29/2021,12921,82L-IMPORT PAYROLL-FORTH KYLE,D108,HJ,69.38,,336139.89
6150,1/29/2021,1/29/2021,12921,82L-IMPORT PAYROLL-GARCIA MARILYN,D108,HJ,33.23,,336173.12
6150,1/29/2021,1/29/2021,12921,82L-IMPORT PAYROLL-GARCIA MARILYN,D108,HJ,142.08,,336315.2
6150,1/29/2021,1/29/2021,12921,82L-IMPORT PAYROLL-GREENE BROOKE,D108,HJ,15.28,,336330.48
6150,1/29/2021,1/29/2021,12921,82L-IMPORT PAYROLL-GREENE BROOKE,D108,HJ,65.35,,336395.83
6150,1/29/2021,1/29/2021,12921,82L-IMPORT PAYROLL-GRIFFIN ANDREW,D108,HJ,30.44,,336426.27
6150,1/29/2021,1/29/2021,12921,82L-IMPORT PAYROLL-GRIFFIN ANDREW,D108,HJ,74.25,,336500.52
6150,1/29/2021,1/29/2021,12921,82L-IMPORT PAYROLL-GRIFFIN ANDREW,D108,HJ,130.16,,336630.68
6150,1/29/2021,1/29/2021,12921,82L-IMPORT PAYROLL-GROSS EMILY,D108,HJ,14,,336644.68
6150,1/29/2021,1/29/2021,12921,82L-IMPORT PAYROLL-GROSS EMILY,D108,HJ,59.86,,336704.54
6150,1/29/2021,1/29/2021,12921,82L-IMPORT PAYROLL-GUERRERO LUIS,D108,HJ,16.23,,336720.77
6150,1/29/2021,1/29/2021,12921,82L-IMPORT PAYROLL-GUERRERO LUIS,D108,HJ,69.38,,336790.15
6150,1/29/2021,1/29/2021,12921,82L-IMPORT PAYROLL-HALLINAN GABRIEL,D108,HJ,34.79,,336824.94
6150,1/29/2021,1/29/2021,12921,82L-IMPORT PAYROLL-HALLINAN GABRIEL,D108,HJ,148.76,,336973.7
6150,1/29/2021,1/29/2021,12921,82L-IMPORT PAYROLL-HAMERSLY WILLIAM,D108,HJ,34.16,,337007.86
6150,1/29/2021,1/29/2021,12921,82L-IMPORT PAYROLL-HAMERSLY WILLIAM,D108,HJ,146.08,,337153.94
6150,1/29/2021,1/29/2021,12921,82L-IMPORT PAYROLL-HOSSAIN MYESHA,D108,HJ,35.1,,337189.04
6150,1/29/2021,1/29/2021,12921,82L-IMPORT PAYROLL-HOSSAIN MYESHA,D108,HJ,150.1,,337339.14
6150,1/29/2021,1/29/2021,12921,82L-IMPORT PAYROLL-JACKSON TASNIM F,D108,HJ,31,,337370.14
6150,1/29/2021,1/29/2021,12921,82L-IMPORT PAYROLL-JACKSON TASNIM F,D108,HJ,132.56,,337502.7
6150,1/29/2021,1/29/2021,12921,82L-IMPORT PAYROLL-KERKHOFF HARPER FAITH,D108,HJ,16.23,,337518.93
6150,1/29/2021,1/29/2021,12921,82L-IMPORT PAYROLL-KERKHOFF HARPER FAITH,D108,HJ,30.21,,337549.14
6150,1/29/2021,1/29/2021,12921,82L-IMPORT PAYROLL-KERKHOFF HARPER FAITH,D108,HJ,69.38,,337618.52
6150,1/29/2021,1/29/2021,12921,82L-IMPORT PAYROLL-LEARY AUBREY,D108,HJ,16.2,,337634.72
6150,1/29/2021,1/29/2021,12921,82L-IMPORT PAYROLL-LEARY AUBREY,D108,HJ,69.27,,337703.99
6150,1/29/2021,1/29/2021,12921,82L-IMPORT PAYROLL-LI BELLA,D108,HJ,33.96,,337737.95
6150,1/29/2021,1/29/2021,12921,82L-IMPORT PAYROLL-LI BELLA,D108,HJ,145.23,,337883.18
6150,1/29/2021,1/29/2021,12921,82L-IMPORT PAYROLL-LOUIE JORDAN,D108,HJ,16.23,,337899.41
6150,1/29/2021,1/29/2021,12921,82L-IMPORT PAYROLL-LOUIE JORDAN,D108,HJ,69.38,,337968.79
6150,1/29/2021,1/29/2021,12921,82L-IMPORT PAYROLL-MELCHOR OSBEIDY,D108,HJ,16.23,,337985.02
6150,1/29/2021,1/29/2021,12921,82L-IMPORT PAYROLL-MELCHOR OSBEIDY,D108,HJ,69.38,,338054.4
6150,1/29/2021,1/29/2021,12921,82L-IMPORT PAYROLL-MORRIS ZAKIYA,D108,HJ,16.23,,338070.63
6150,1/29/2021,1/29/2021,12921,82L-IMPORT PAYROLL-MORRIS ZAKIYA,D108,HJ,69.38,,338140.01
6150,1/29/2021,1/29/2021,12921,82L-IMPORT PAYROLL-MORSELETTO RAFAEL,D108,HJ,1.64,,338141.65
6150,1/29/2021,1/29/2021,12921,82L-IMPORT PAYROLL-MORSELETTO RAFAEL,D108,HJ,11.53,,338153.18
6150,1/29/2021,1/29/2021,12921,82L-IMPORT PAYROLL-MORSELETTO RAFAEL,D108,HJ,16.23,,338169.41
6150,1/29/2021,1/29/2021,12921,82L-IMPORT PAYROLL-MORSELETTO RAFAEL,D108,HJ,69.38,,338238.79
6150,1/29/2021,1/29/2021,12921,82L-IMPORT PAYROLL-OBI TOBECHUKWU,D108,HJ,16.23,,338255.02
6150,1/29/2021,1/29/2021,12921,82L-IMPORT PAYROLL-OBI TOBECHUKWU,D108,HJ,69.38,,338324.4
6150,1/29/2021,1/29/2021,12921,82L-IMPORT PAYROLL-OPUH NDIDI,D108,HJ,34.74,,338359.14
6150,1/29/2021,1/29/2021,12921,82L-IMPORT PAYROLL-OPUH NDIDI,D108,HJ,148.53,,338507.67
6150,1/29/2021,1/29/2021,12921,82L-IMPORT PAYROLL-PAULINO THAIRI,D108,HJ,16.23,,338523.9
6150,1/29/2021,1/29/2021,12921,82L-IMPORT PAYROLL-PAULINO THAIRI,D108,HJ,69.38,,338593.28
6150,1/29/2021,1/29/2021,12921,82L-IMPORT PAYROLL-ROSENBAUM MURRAY,D108,HJ,16.23,,338609.51
6150,1/29/2021,1/29/2021,12921,82L-IMPORT PAYROLL-ROSENBAUM MURRAY,D108,HJ,69.38,,338678.89
6150,1/29/2021,1/29/2021,12921,82L-IMPORT PAYROLL-SCHWETTMANN CLAIRE,D108,HJ,15.28,,338694.17
6150,1/29/2021,1/29/2021,12921,82L-IMPORT PAYROLL-SCHWETTMANN CLAIRE,D108,HJ,65.35,,338759.52
6150,1/29/2021,1/29/2021,12921,82L-IMPORT PAYROLL-SOBELMAN JUSTIN,D108,HJ,15.08,,338774.6
6150,1/29/2021,1/29/2021,12921,82L-IMPORT PAYROLL-SOBELMAN JUSTIN,D108,HJ,64.5,,338839.1
6150,1/29/2021,1/29/2021,12921,82L-IMPORT PAYROLL-TERRENCE-SMITH ZIHIR,D108,HJ,14.32,,338853.42
6150,1/29/2021,1/29/2021,12921,82L-IMPORT PAYROLL-TERRENCE-SMITH ZIHIR,D108,HJ,61.22,,338914.64
6150,1/29/2021,1/29/2021,12921,82L-IMPORT PAYROLL-TILLERY ASIA,D108,HJ,54.34,,338968.98
6150,1/29/2021,1/29/2021,12921,82L-IMPORT PAYROLL-TILLERY ASIA,D108,HJ,232.34,,339201.32
6150,1/29/2021,1/29/2021,12921,82L-IMPORT PAYROLL-WILLIAMS-MASSEY BRIANNA,D108,HJ,16.05,,339217.37
6150,1/29/2021,1/29/2021,12921,82L-IMPORT PAYROLL-WILLIAMS-MASSEY BRIANNA,D108,HJ,36.93,,339254.3
6150,1/29/2021,1/29/2021,12921,82L-IMPORT PAYROLL-WILLIAMS-MASSEY BRIANNA,D108,HJ,68.64,,339322.94
6150,1/29/2021,1/29/2021,12921,82L-IMPORT PAYROLL-XIAO CHENGYAO,D108,HJ,16.23,,339339.17
6150,1/29/2021,1/29/2021,12921,82L-IMPORT PAYROLL-XIAO CHENGYAO,D108,HJ,69.38,,339408.55
6150,1/29/2021,1/29/2021,12921,82L-IMPORT PAYROLL-ZIAUDDIN ABUTAHER,D108,HJ,16.23,,339424.78
6150,1/29/2021,1/29/2021,12921,82L-IMPORT PAYROLL-ZIAUDDIN ABUTAHER,D108,HJ,69.38,,339494.16
6150,1/29/2021,1/29/2021,12921,82L-IMPORT PAYROLL-BALASUBRAMANIAN SHARANYA,D108,HJ,16.53,,339510.69
6150,1/29/2021,1/29/2021,12921,82L-IMPORT PAYROLL-BALASUBRAMANIAN SHARANYA,D108,HJ,38.67,,339549.36
6150,1/29/2021,1/29/2021,12921,82L-IMPORT PAYROLL-BALASUBRAMANIAN SHARANYA,D108,HJ,72,,339621.36
6150,1/29/2021,1/29/2021,12921,82L-IMPORT PAYROLL-BALASUBRAMANIAN SHARANYA,D108,HJ,165.33,,339786.69
6150,1/29/2021,1/29/2021,12921,82L-IMPORT PAYROLL-COVENEY ALLISON,D108,HJ,38.07,,339824.76
6150,1/29/2021,1/29/2021,12921,82L-IMPORT PAYROLL-COVENEY ALLISON,D108,HJ,162.79,,339987.55
6150,1/29/2021,1/29/2021,12921,82L-IMPORT PAYROLL-JACKSON CLAICE M,D108,HJ,19.38,,340006.93
6150,1/29/2021,1/29/2021,12921,82L-IMPORT PAYROLL-JACKSON CLAICE M,D108,HJ,42.91,,340049.84
6150,1/29/2021,1/29/2021,12921,82L-IMPORT PAYROLL-JACKSON CLAICE M,D108,HJ,84.38,,340134.22
6150,1/29/2021,1/29/2021,12921,82L-IMPORT PAYROLL-JACKSON CLAICE M,D108,HJ,183.48,,340317.7
6150,1/29/2021,1/29/2021,12921,82L-IMPORT PAYROLL-JANG DANIEL,D108,HJ,37.75,,340355.45
6150,1/29/2021,1/29/2021,12921,82L-IMPORT PAYROLL-JANG DANIEL,D108,HJ,67.69,,340423.14
6150,1/29/2021,1/29/2021,12921,82L-IMPORT PAYROLL-JANG DANIEL,D108,HJ,161.4,,340584.54
6150,1/29/2021,1/29/2021,12921,82L-IMPORT PAYROLL-LENEGHAN MARYELLEN,D108,HJ,33.42,,340617.96
6150,1/29/2021,1/29/2021,12921,82L-IMPORT PAYROLL-LENEGHAN MARYELLEN,D108,HJ,33.42,,340651.38
6150,1/29/2021,1/29/2021,12921,82L-IMPORT PAYROLL-LENEGHAN MARYELLEN,D108,HJ,118.55,,340769.93
6150,1/29/2021,1/29/2021,12921,82L-IMPORT PAYROLL-LENEGHAN MARYELLEN,D108,HJ,142.89,,340912.82
6150,1/29/2021,1/29/2021,12921,82L-IMPORT PAYROLL-LENEGHAN MARYELLEN,D108,HJ,142.89,,341055.71
6150,2/12/2021,2/12/2021,21221,82L-IMPORT PAYROLL-BARTHELEMY RACHALIE,D108,HJ,14.01,,341069.72
6150,2/12/2021,2/12/2021,21221,82L-IMPORT PAYROLL-BARTHELEMY RACHALIE,D108,HJ,26.08,,341095.8
6150,2/12/2021,2/12/2021,21221,82L-IMPORT PAYROLL-BARTHELEMY RACHALIE,D108,HJ,59.89,,341155.69
6150,2/12/2021,2/12/2021,21221,82L-IMPORT PAYROLL-BOHLSEN GRACE ISABELLE,D108,HJ,15.16,,341170.85
6150,2/12/2021,2/12/2021,21221,82L-IMPORT PAYROLL-BOHLSEN GRACE ISABELLE,D108,HJ,64.84,,341235.69
6150,2/12/2021,2/12/2021,21221,82L-IMPORT PAYROLL-BOLIVAR ANDREA,D108,HJ,36.25,,341271.94
6150,2/12/2021,2/12/2021,21221,82L-IMPORT PAYROLL-BOLIVAR ANDREA,D108,HJ,54,,341325.94
6150,2/12/2021,2/12/2021,21221,82L-IMPORT PAYROLL-BOLIVAR ANDREA,D108,HJ,155,,341480.94
6150,2/12/2021,2/12/2021,21221,82L-IMPORT PAYROLL-BORCHART SPENCER,D108,HJ,15.19,,341496.13
6150,2/12/2021,2/12/2021,21221,82L-IMPORT PAYROLL-BORCHART SPENCER,D108,HJ,44.27,,341540.4
6150,2/12/2021,2/12/2021,21221,82L-IMPORT PAYROLL-BORCHART SPENCER,D108,HJ,64.95,,341605.35
6150,2/12/2021,2/12/2021,21221,82L-IMPORT PAYROLL-BRIANTE SAMUEL,D108,HJ,6.8,,341612.15
6150,2/12/2021,2/12/2021,21221,82L-IMPORT PAYROLL-BRIANTE SAMUEL,D108,HJ,16.4,,341628.55
6150,2/12/2021,2/12/2021,21221,82L-IMPORT PAYROLL-BRIANTE SAMUEL,D108,HJ,29.06,,341657.61
6150,2/12/2021,2/12/2021,21221,82L-IMPORT PAYROLL-BROWN ISAAC,D108,HJ,14.01,,341671.62
6150,2/12/2021,2/12/2021,21221,82L-IMPORT PAYROLL-BROWN ISAAC,D108,HJ,20.14,,341691.76
6150,2/12/2021,2/12/2021,21221,82L-IMPORT PAYROLL-BROWN ISAAC,D108,HJ,59.89,,341751.65
6150,2/12/2021,2/12/2021,21221,82L-IMPORT PAYROLL-BURKE MARIAH,D108,HJ,9.82,,341761.47
6150,2/12/2021,2/12/2021,21221,82L-IMPORT PAYROLL-BURKE MARIAH,D108,HJ,41.97,,341803.44
6150,2/12/2021,2/12/2021,21221,82L-IMPORT PAYROLL-CASSADY JOSHUA LEWIS,D108,HJ,15.19,,341818.63
6150,2/12/2021,2/12/2021,21221,82L-IMPORT PAYROLL-CASSADY JOSHUA LEWIS,D108,HJ,28.29,,341846.92
6150,2/12/2021,2/12/2021,21221,82L-IMPORT PAYROLL-CASSADY JOSHUA LEWIS,D108,HJ,64.95,,341911.87
6150,2/12/2021,2/12/2021,21221,82L-IMPORT PAYROLL-DARKO OLIVIA,D108,HJ,15.19,,341927.06
6150,2/12/2021,2/12/2021,21221,82L-IMPORT PAYROLL-DARKO OLIVIA,D108,HJ,64.95,,341992.01
6150,2/12/2021,2/12/2021,21221,82L-IMPORT PAYROLL-ESCAMILLA OLGA,D108,HJ,15.19,,342007.2
6150,2/12/2021,2/12/2021,21221,82L-IMPORT PAYROLL-ESCAMILLA OLGA,D108,HJ,64.95,,342072.15
6150,2/12/2021,2/12/2021,21221,82L-IMPORT PAYROLL-GARCIA SANTIAGO,D108,HJ,27.59,,342099.74
6150,2/12/2021,2/12/2021,21221,82L-IMPORT PAYROLL-GARCIA SANTIAGO,D108,HJ,51.38,,342151.12
6150,2/12/2021,2/12/2021,21221,82L-IMPORT PAYROLL-GARCIA SANTIAGO,D108,HJ,117.98,,342269.1
6150,2/12/2021,2/12/2021,21221,82L-IMPORT PAYROLL-GILES SHAYLA,D108,HJ,15.19,,342284.29
6150,2/12/2021,2/12/2021,21221,82L-IMPORT PAYROLL-GILES SHAYLA,D108,HJ,28.29,,342312.58
6150,2/12/2021,2/12/2021,21221,82L-IMPORT PAYROLL-GILES SHAYLA,D108,HJ,64.95,,342377.53
6150,2/12/2021,2/12/2021,21221,82L-IMPORT PAYROLL-IKUNIKA FUNMILAYO,D108,HJ,30.21,,342407.74
6150,2/12/2021,2/12/2021,21221,82L-IMPORT PAYROLL-IKUNIKA FUNMILAYO,D108,HJ,56.25,,342463.99
6150,2/12/2021,2/12/2021,21221,82L-IMPORT PAYROLL-IKUNIKA FUNMILAYO,D108,HJ,129.17,,342593.16
6150,2/12/2021,2/12/2021,21221,82L-IMPORT PAYROLL-JONES JORDAN,D108,HJ,15.19,,342608.35
6150,2/12/2021,2/12/2021,21221,82L-IMPORT PAYROLL-JONES JORDAN,D108,HJ,64.95,,342673.3
6150,2/12/2021,2/12/2021,21221,82L-IMPORT PAYROLL-KHAN HUDA,D108,HJ,14.25,,342687.55
6150,2/12/2021,2/12/2021,21221,82L-IMPORT PAYROLL-KHAN HUDA,D108,HJ,26.53,,342714.08
6150,2/12/2021,2/12/2021,21221,82L-IMPORT PAYROLL-KHAN HUDA,D108,HJ,60.92,,342775
6150,2/12/2021,2/12/2021,21221,82L-IMPORT PAYROLL-KLOHR TIMOTHY JORDAN,D108,HJ,29,,342804
6150,2/12/2021,2/12/2021,21221,82L-IMPORT PAYROLL-KLOHR TIMOTHY JORDAN,D108,HJ,54,,342858
6150,2/12/2021,2/12/2021,21221,82L-IMPORT PAYROLL-KLOHR TIMOTHY JORDAN,D108,HJ,124,,342982
6150,2/12/2021,2/12/2021,21221,82L-IMPORT PAYROLL-KNOWLIN ZYLIA,D108,HJ,32.46,,343014.46
6150,2/12/2021,2/12/2021,21221,82L-IMPORT PAYROLL-KNOWLIN ZYLIA,D108,HJ,60.45,,343074.91
6150,2/12/2021,2/12/2021,21221,82L-IMPORT PAYROLL-KNOWLIN ZYLIA,D108,HJ,138.81,,343213.72
6150,2/12/2021,2/12/2021,21221,82L-IMPORT PAYROLL-LAI GRADY,D108,HJ,15.19,,343228.91
6150,2/12/2021,2/12/2021,21221,82L-IMPORT PAYROLL-LAI GRADY,D108,HJ,36.67,,343265.58
6150,2/12/2021,2/12/2021,21221,82L-IMPORT PAYROLL-LAI GRADY,D108,HJ,64.95,,343330.53
6150,2/12/2021,2/12/2021,21221,82L-IMPORT PAYROLL-LI SEN YUAN,D108,HJ,14.05,,343344.58
6150,2/12/2021,2/12/2021,21221,82L-IMPORT PAYROLL-LI SEN YUAN,D108,HJ,26.16,,343370.74
6150,2/12/2021,2/12/2021,21221,82L-IMPORT PAYROLL-LI SEN YUAN,D108,HJ,60.07,,343430.81
6150,2/12/2021,2/12/2021,21221,82L-IMPORT PAYROLL-LIPSCOMB STEPHEN,D108,HJ,33.58,,343464.39
6150,2/12/2021,2/12/2021,21221,82L-IMPORT PAYROLL-LIPSCOMB STEPHEN,D108,HJ,62.53,,343526.92
6150,2/12/2021,2/12/2021,21221,82L-IMPORT PAYROLL-LIPSCOMB STEPHEN,D108,HJ,143.59,,343670.51
6150,2/12/2021,2/12/2021,21221,82L-IMPORT PAYROLL-MALLECK JESSICA R,D108,HJ,15.19,,343685.7
6150,2/12/2021,2/12/2021,21221,82L-IMPORT PAYROLL-MALLECK JESSICA R,D108,HJ,64.95,,343750.65
6150,2/12/2021,2/12/2021,21221,82L-IMPORT PAYROLL-MEJIA ROSO CARLOS,D108,HJ,14.01,,343764.66
6150,2/12/2021,2/12/2021,21221,82L-IMPORT PAYROLL-MEJIA ROSO CARLOS,D108,HJ,26.08,,343790.74
6150,2/12/2021,2/12/2021,21221,82L-IMPORT PAYROLL-MEJIA ROSO CARLOS,D108,HJ,59.89,,343850.63
6150,2/12/2021,2/12/2021,21221,82L-IMPORT PAYROLL-MONROY-MEJIA JASON,D108,HJ,15.19,,343865.82
6150,2/12/2021,2/12/2021,21221,82L-IMPORT PAYROLL-MONROY-MEJIA JASON,D108,HJ,36.67,,343902.49
6150,2/12/2021,2/12/2021,21221,82L-IMPORT PAYROLL-MONROY-MEJIA JASON,D108,HJ,64.95,,343967.44
6150,2/12/2021,2/12/2021,21221,82L-IMPORT PAYROLL-O'FLYNN-PRUITT NATHAN COLYAR,D108,HJ,15.19,,343982.63
6150,2/12/2021,2/12/2021,21221,82L-IMPORT PAYROLL-O'FLYNN-PRUITT NATHAN COLYAR,D108,HJ,36.67,,344019.3
6150,2/12/2021,2/12/2021,21221,82L-IMPORT PAYROLL-O'FLYNN-PRUITT NATHAN COLYAR,D108,HJ,64.95,,344084.25
6150,2/12/2021,2/12/2021,21221,82L-IMPORT PAYROLL-OKRAH JULIAN O,D108,HJ,15.19,,344099.44
6150,2/12/2021,2/12/2021,21221,82L-IMPORT PAYROLL-OKRAH JULIAN O,D108,HJ,33.52,,344132.96
6150,2/12/2021,2/12/2021,21221,82L-IMPORT PAYROLL-OKRAH JULIAN O,D108,HJ,64.95,,344197.91
6150,2/12/2021,2/12/2021,21221,82L-IMPORT PAYROLL-PATTERSON STEVE,D108,HJ,15.19,,344213.1
6150,2/12/2021,2/12/2021,21221,82L-IMPORT PAYROLL-PATTERSON STEVE,D108,HJ,28.29,,344241.39
6150,2/12/2021,2/12/2021,21221,82L-IMPORT PAYROLL-PATTERSON STEVE,D108,HJ,64.95,,344306.34
6150,2/12/2021,2/12/2021,21221,82L-IMPORT PAYROLL-SAINI BALJIT,D108,HJ,7.01,,344313.35
6150,2/12/2021,2/12/2021,21221,82L-IMPORT PAYROLL-SAINI BALJIT,D108,HJ,14.26,,344327.61
6150,2/12/2021,2/12/2021,21221,82L-IMPORT PAYROLL-SAINI BALJIT,D108,HJ,29.98,,344357.59
6150,2/12/2021,2/12/2021,21221,82L-IMPORT PAYROLL-SCHMIESS RACHEL JOY,D108,HJ,10.69,,344368.28
6150,2/12/2021,2/12/2021,21221,82L-IMPORT PAYROLL-SCHMIESS RACHEL JOY,D108,HJ,15.19,,344383.47
6150,2/12/2021,2/12/2021,21221,82L-IMPORT PAYROLL-SCHMIESS RACHEL JOY,D108,HJ,64.95,,344448.42
6150,2/12/2021,2/12/2021,21221,82L-IMPORT PAYROLL-SCOTT KIRK DONOVAN,D108,HJ,14.05,,344462.47
6150,2/12/2021,2/12/2021,21221,82L-IMPORT PAYROLL-SCOTT KIRK DONOVAN,D108,HJ,26.16,,344488.63
6150,2/12/2021,2/12/2021,21221,82L-IMPORT PAYROLL-SCOTT KIRK DONOVAN,D108,HJ,60.07,,344548.7
6150,2/12/2021,2/12/2021,21221,82L-IMPORT PAYROLL-SILVER KELLY,D108,HJ,34.63,,344583.33
6150,2/12/2021,2/12/2021,21221,82L-IMPORT PAYROLL-SILVER KELLY,D108,HJ,60.04,,344643.37
6150,2/12/2021,2/12/2021,21221,82L-IMPORT PAYROLL-SILVER KELLY,D108,HJ,148.06,,344791.43
6150,2/12/2021,2/12/2021,21221,82L-IMPORT PAYROLL-SOLIMAN MARK,D108,HJ,15.19,,344806.62
6150,2/12/2021,2/12/2021,21221,82L-IMPORT PAYROLL-SOLIMAN MARK,D108,HJ,36.67,,344843.29
6150,2/12/2021,2/12/2021,21221,82L-IMPORT PAYROLL-SOLIMAN MARK,D108,HJ,64.95,,344908.24
6150,2/12/2021,2/12/2021,21221,82L-IMPORT PAYROLL-STEIN KYLE,D108,HJ,27.84,,344936.08
6150,2/12/2021,2/12/2021,21221,82L-IMPORT PAYROLL-STEIN KYLE,D108,HJ,51.84,,344987.92
6150,2/12/2021,2/12/2021,21221,82L-IMPORT PAYROLL-STEIN KYLE,D108,HJ,119.05,,345106.97
6150,2/12/2021,2/12/2021,21221,82L-IMPORT PAYROLL-STROUD DAVID,D108,HJ,14.65,,345121.62
6150,2/12/2021,2/12/2021,21221,82L-IMPORT PAYROLL-STROUD DAVID,D108,HJ,31.31,,345152.93
6150,2/12/2021,2/12/2021,21221,82L-IMPORT PAYROLL-STROUD DAVID,D108,HJ,62.62,,345215.55
6150,2/12/2021,2/12/2021,21221,82L-IMPORT PAYROLL-VALCIN SABRINA JEMIMAH,D108,HJ,14.25,,345229.8
6150,2/12/2021,2/12/2021,21221,82L-IMPORT PAYROLL-VALCIN SABRINA JEMIMAH,D108,HJ,26.53,,345256.33
6150,2/12/2021,2/12/2021,21221,82L-IMPORT PAYROLL-VALCIN SABRINA JEMIMAH,D108,HJ,60.92,,345317.25
6150,2/12/2021,2/12/2021,21221,82L-IMPORT PAYROLL-VALDES ERNEST L,D108,HJ,15.19,,345332.44
6150,2/12/2021,2/12/2021,21221,82L-IMPORT PAYROLL-VALDES ERNEST L,D108,HJ,36.67,,345369.11
6150,2/12/2021,2/12/2021,21221,82L-IMPORT PAYROLL-VALDES ERNEST L,D108,HJ,64.95,,345434.06
6150,2/12/2021,2/12/2021,21221,82L-IMPORT PAYROLL-WILLIAMS MACK ANTHONY,D108,HJ,15.02,,345449.08
6150,2/12/2021,2/12/2021,21221,82L-IMPORT PAYROLL-WILLIAMS MACK ANTHONY,D108,HJ,27.96,,345477.04
6150,2/12/2021,2/12/2021,21221,82L-IMPORT PAYROLL-WILLIAMS MACK ANTHONY,D108,HJ,64.21,,345541.25
6150,2/12/2021,2/12/2021,21221,82L-IMPORT PAYROLL-WILLIAMS MIL'YONTA,D108,HJ,15.19,,345556.44
6150,2/12/2021,2/12/2021,21221,82L-IMPORT PAYROLL-WILLIAMS MIL'YONTA,D108,HJ,28.29,,345584.73
6150,2/12/2021,2/12/2021,21221,82L-IMPORT PAYROLL-WILLIAMS MIL'YONTA,D108,HJ,64.95,,345649.68
6150,2/12/2021,2/12/2021,21221,82L-IMPORT PAYROLL-ANTHONY BETTY S,D108,HJ,41.85,,345691.53
6150,2/12/2021,2/12/2021,21221,82L-IMPORT PAYROLL-ANTHONY BETTY S,D108,HJ,178.96,,345870.49
6150,2/12/2021,2/12/2021,21221,82L-IMPORT PAYROLL-APULI LINDSAY,D108,HJ,34.16,,345904.65
6150,2/12/2021,2/12/2021,21221,82L-IMPORT PAYROLL-APULI LINDSAY,D108,HJ,146.08,,346050.73
6150,2/12/2021,2/12/2021,21221,82L-IMPORT PAYROLL-AUSTIN PERCY ANTONIO,D108,HJ,36.34,,346087.07
6150,2/12/2021,2/12/2021,21221,82L-IMPORT PAYROLL-AUSTIN PERCY ANTONIO,D108,HJ,155.39,,346242.46
6150,2/12/2021,2/12/2021,21221,82L-IMPORT PAYROLL-BUHMANN JENNIFER,D108,HJ,32.9,,346275.36
6150,2/12/2021,2/12/2021,21221,82L-IMPORT PAYROLL-BUHMANN JENNIFER,D108,HJ,140.68,,346416.04
6150,2/12/2021,2/12/2021,21221,82L-IMPORT PAYROLL-CAIN CORY,D108,HJ,36.32,,346452.36
6150,2/12/2021,2/12/2021,21221,82L-IMPORT PAYROLL-CAIN CORY,D108,HJ,155.3,,346607.66
6150,2/12/2021,2/12/2021,21221,82L-IMPORT PAYROLL-CHAPMAN CLAUDY EARL,D108,HJ,33.03,,346640.69
6150,2/12/2021,2/12/2021,21221,82L-IMPORT PAYROLL-CHAPMAN CLAUDY EARL,D108,HJ,141.23,,346781.92
6150,2/12/2021,2/12/2021,21221,82L-IMPORT PAYROLL-DADA ARIKPO E,D108,HJ,32.04,,346813.96
6150,2/12/2021,2/12/2021,21221,82L-IMPORT PAYROLL-DADA ARIKPO E,D108,HJ,137,,346950.96
6150,2/12/2021,2/12/2021,21221,82L-IMPORT PAYROLL-GUTHRIE LESLIE,D108,HJ,33.42,,346984.38
6150,2/12/2021,2/12/2021,21221,82L-IMPORT PAYROLL-GUTHRIE LESLIE,D108,HJ,142.9,,347127.28
6150,2/12/2021,2/12/2021,21221,82L-IMPORT PAYROLL-HOLMES JOREL ALEXANDER,D108,HJ,31.22,,347158.5
6150,2/12/2021,2/12/2021,21221,82L-IMPORT PAYROLL-HOLMES JOREL ALEXANDER,D108,HJ,133.51,,347292.01
6150,2/12/2021,2/12/2021,21221,82L-IMPORT PAYROLL-JORDAN TIFFANY T,D108,HJ,45.87,,347337.88
6150,2/12/2021,2/12/2021,21221,82L-IMPORT PAYROLL-JORDAN TIFFANY T,D108,HJ,196.13,,347534.01
6150,2/12/2021,2/12/2021,21221,82L-IMPORT PAYROLL-LANIGAN LISA A,D108,HJ,45.1,,347579.11
6150,2/12/2021,2/12/2021,21221,82L-IMPORT PAYROLL-LANIGAN LISA A,D108,HJ,192.83,,347771.94
6150,2/12/2021,2/12/2021,21221,82L-IMPORT PAYROLL-MCELWEE MELISSA,D108,HJ,38.67,,347810.61
6150,2/12/2021,2/12/2021,21221,82L-IMPORT PAYROLL-MCELWEE MELISSA,D108,HJ,165.33,,347975.94
6150,2/12/2021,2/12/2021,21221,82L-IMPORT PAYROLL-MCNICHOLAS MARY,D108,HJ,33.23,,348009.17
6150,2/12/2021,2/12/2021,21221,82L-IMPORT PAYROLL-MCNICHOLAS MARY,D108,HJ,142.08,,348151.25
6150,2/12/2021,2/12/2021,21221,82L-IMPORT PAYROLL-NWAKANMA NANCY,D108,HJ,44.18,,348195.43
6150,2/12/2021,2/12/2021,21221,82L-IMPORT PAYROLL-NWAKANMA NANCY,D108,HJ,188.89,,348384.32
6150,2/12/2021,2/12/2021,21221,82L-IMPORT PAYROLL-ONICA ANTHONY J,D108,HJ,32.86,,348417.18
6150,2/12/2021,2/12/2021,21221,82L-IMPORT PAYROLL-ONICA ANTHONY J,D108,HJ,140.49,,348557.67
6150,2/12/2021,2/12/2021,21221,82L-IMPORT PAYROLL-PRAHIN NICOLE M,D108,HJ,52.91,,348610.58
6150,2/12/2021,2/12/2021,21221,82L-IMPORT PAYROLL-PRAHIN NICOLE M,D108,HJ,226.22,,348836.8
6150,2/12/2021,2/12/2021,21221,82L-IMPORT PAYROLL-RIVERS QUIONNA DIANE,D108,HJ,39.27,,348876.07
6150,2/12/2021,2/12/2021,21221,82L-IMPORT PAYROLL-RIVERS QUIONNA DIANE,D108,HJ,167.92,,349043.99
6150,2/12/2021,2/12/2021,21221,82L-IMPORT PAYROLL-SALIM YASSER,D108,HJ,33.1,,349077.09
6150,2/12/2021,2/12/2021,21221,82L-IMPORT PAYROLL-SALIM YASSER,D108,HJ,141.55,,349218.64
6150,2/12/2021,2/12/2021,21221,82L-IMPORT PAYROLL-SEJOUR MAHALIAH,D108,HJ,34.07,,349252.71
6150,2/12/2021,2/12/2021,21221,82L-IMPORT PAYROLL-SEJOUR MAHALIAH,D108,HJ,145.66,,349398.37
6150,2/12/2021,2/12/2021,21221,82L-IMPORT PAYROLL-SKALSKI CHRISTOPHER,D108,HJ,33.86,,349432.23
6150,2/12/2021,2/12/2021,21221,82L-IMPORT PAYROLL-SKALSKI CHRISTOPHER,D108,HJ,144.76,,349576.99
6150,2/12/2021,2/12/2021,21221,82L-IMPORT PAYROLL-TUMENJARGAL ENKHJIN,D108,HJ,32.92,,349609.91
6150,2/12/2021,2/12/2021,21221,82L-IMPORT PAYROLL-TUMENJARGAL ENKHJIN,D108,HJ,140.75,,349750.66
6150,2/12/2021,2/12/2021,21221,82L-IMPORT PAYROLL-VILLEGAS EVELYN,D108,HJ,33.4,,349784.06
6150,2/12/2021,2/12/2021,21221,82L-IMPORT PAYROLL-VILLEGAS EVELYN,D108,HJ,142.81,,349926.87
6150,2/12/2021,2/12/2021,21221,82L-IMPORT PAYROLL-WOLF ANNA A,D108,HJ,36.3,,349963.17
6150,2/12/2021,2/12/2021,21221,82L-IMPORT PAYROLL-WOLF ANNA A,D108,HJ,155.19,,350118.36
6150,2/12/2021,2/12/2021,21221,82L-IMPORT PAYROLL-ACEVEDO MONIVETT,D107,HJ,72.42,,350190.78
6150,2/12/2021,2/12/2021,21221,82L-IMPORT PAYROLL-ACEVEDO MONIVETT,D107,HJ,309.64,,350500.42
6150,2/12/2021,2/12/2021,21221,82L-IMPORT PAYROLL-AKLESTAD ISABEL,D111,HJ,23.29,,350523.71
6150,2/12/2021,2/12/2021,21221,82L-IMPORT PAYROLL-AKLESTAD ISABEL,D111,HJ,99.58,,350623.29
6150,2/12/2021,2/12/2021,21221,82L-IMPORT PAYROLL-BIBB TIFFANI,D104,HJ,3.88,,350627.17
6150,2/12/2021,2/12/2021,21221,82L-IMPORT PAYROLL-BIBB TIFFANI,D104,HJ,49.71,,350676.88
6150,2/12/2021,2/12/2021,21221,82L-IMPORT PAYROLL-BIBB TIFFANI,D104,HJ,212.55,,350889.43
6150,2/12/2021,2/12/2021,21221,82L-IMPORT PAYROLL-BOWMAN HALLEY K,D101,HJ,49.84,,350939.27
6150,2/12/2021,2/12/2021,21221,82L-IMPORT PAYROLL-BOWMAN HALLEY K,D101,HJ,59.08,,350998.35
6150,2/12/2021,2/12/2021,21221,82L-IMPORT PAYROLL-BOWMAN HALLEY K,D101,HJ,213.13,,351211.48
6150,2/12/2021,2/12/2021,21221,82L-IMPORT PAYROLL-COOK CATHRYN ANNA,D105,HJ,49.87,,351261.35
6150,2/12/2021,2/12/2021,21221,82L-IMPORT PAYROLL-COOK CATHRYN ANNA,D105,HJ,151.84,,351413.19
6150,2/12/2021,2/12/2021,21221,82L-IMPORT PAYROLL-COOK CATHRYN ANNA,D105,HJ,213.25,,351626.44
6150,2/12/2021,2/12/2021,21221,82L-IMPORT PAYROLL-COOPER ASHLEE R,D101,HJ,33.51,,351659.95
6150,2/12/2021,2/12/2021,21221,82L-IMPORT PAYROLL-COOPER ASHLEE R,D101,HJ,143.3,,351803.25
6150,2/12/2021,2/12/2021,21221,82L-IMPORT PAYROLL-CORTEZ MIRANDA A,D111,HJ,36.44,,351839.69
6150,2/12/2021,2/12/2021,21221,82L-IMPORT PAYROLL-CORTEZ MIRANDA A,D111,HJ,72.16,,351911.85
6150,2/12/2021,2/12/2021,21221,82L-IMPORT PAYROLL-CORTEZ MIRANDA A,D111,HJ,155.82,,352067.67
6150,2/12/2021,2/12/2021,21221,82L-IMPORT PAYROLL-DAUGHERTY DEVIN W,D101,HJ,22.66,,352090.33
6150,2/12/2021,2/12/2021,21221,82L-IMPORT PAYROLL-DAUGHERTY DEVIN W,D101,HJ,42.19,,352132.52
6150,2/12/2021,2/12/2021,21221,82L-IMPORT PAYROLL-DAUGHERTY DEVIN W,D101,HJ,96.88,,352229.4
6150,2/12/2021,2/12/2021,21221,82L-IMPORT PAYROLL-DETONE KYRA MAYA,D102,HJ,39,,352268.4
6150,2/12/2021,2/12/2021,21221,82L-IMPORT PAYROLL-DETONE KYRA MAYA,D102,HJ,123.26,,352391.66
6150,2/12/2021,2/12/2021,21221,82L-IMPORT PAYROLL-DETONE KYRA MAYA,D102,HJ,166.75,,352558.41
6150,2/12/2021,2/12/2021,21221,82L-IMPORT PAYROLL-DUPUIS CHRISTOPHER M,D107,HJ,39.93,,352598.34
6150,2/12/2021,2/12/2021,21221,82L-IMPORT PAYROLL-DUPUIS CHRISTOPHER M,D107,HJ,48.81,,352647.15
6150,2/12/2021,2/12/2021,21221,82L-IMPORT PAYROLL-DUPUIS CHRISTOPHER M,D107,HJ,103.89,,352751.04
6150,2/12/2021,2/12/2021,21221,82L-IMPORT PAYROLL-DUPUIS CHRISTOPHER M,D107,HJ,170.75,,352921.79
6150,2/12/2021,2/12/2021,21221,82L-IMPORT PAYROLL-DUPUIS CHRISTOPHER M,D107,HJ,208.7,,353130.49
6150,2/12/2021,2/12/2021,21221,82L-IMPORT PAYROLL-DZIEDZIC JULIE K,D101,HJ,17.71,,353148.2
6150,2/12/2021,2/12/2021,21221,82L-IMPORT PAYROLL-DZIEDZIC JULIE K,D101,HJ,75.71,,353223.91
6150,2/12/2021,2/12/2021,21221,82L-IMPORT PAYROLL-FEENEY CLAIRE,D104,HJ,26.09,,353250
6150,2/12/2021,2/12/2021,21221,82L-IMPORT PAYROLL-FEENEY CLAIRE,D104,HJ,111.56,,353361.56
6150,2/12/2021,2/12/2021,21221,82L-IMPORT PAYROLL-FISCHABER THOMAS,D109,HJ,48.53,,353410.09
6150,2/12/2021,2/12/2021,21221,82L-IMPORT PAYROLL-FISCHABER THOMAS,D109,HJ,77.9,,353487.99
6150,2/12/2021,2/12/2021,21221,82L-IMPORT PAYROLL-FISCHABER THOMAS,D109,HJ,333.1,,353821.09
6150,2/12/2021,2/12/2021,21221,82L-IMPORT PAYROLL-FLORY MEGAN,D109,HJ,21.75,,353842.84
6150,2/12/2021,2/12/2021,21221,82L-IMPORT PAYROLL-FLORY MEGAN,D109,HJ,25.5,,353868.34
6150,2/12/2021,2/12/2021,21221,82L-IMPORT PAYROLL-FLORY MEGAN,D109,HJ,93,,353961.34
6150,2/12/2021,2/12/2021,21221,82L-IMPORT PAYROLL-GORNSTEIN STEVEN,D101,HJ,39.27,,354000.61
6150,2/12/2021,2/12/2021,21221,82L-IMPORT PAYROLL-GORNSTEIN STEVEN,D101,HJ,114.45,,354115.06
6150,2/12/2021,2/12/2021,21221,82L-IMPORT PAYROLL-GORNSTEIN STEVEN,D101,HJ,167.92,,354282.98
6150,2/12/2021,2/12/2021,21221,82L-IMPORT PAYROLL-GUADARRAMA-ALVAREZ URIEL A,D105,HJ,39.93,,354322.91
6150,2/12/2021,2/12/2021,21221,82L-IMPORT PAYROLL-GUADARRAMA-ALVAREZ URIEL A,D105,HJ,78.24,,354401.15
6150,2/12/2021,2/12/2021,21221,82L-IMPORT PAYROLL-GUADARRAMA-ALVAREZ URIEL A,D105,HJ,170.75,,354571.9
6150,2/12/2021,2/12/2021,21221,82L-IMPORT PAYROLL-GUTIERREZ ANTONIO J,D107,HJ,27.59,,354599.49
6150,2/12/2021,2/12/2021,21221,82L-IMPORT PAYROLL-GUTIERREZ ANTONIO J,D107,HJ,49.06,,354648.55
6150,2/12/2021,2/12/2021,21221,82L-IMPORT PAYROLL-GUTIERREZ ANTONIO J,D107,HJ,117.99,,354766.54
6150,2/12/2021,2/12/2021,21221,82L-IMPORT PAYROLL-GUTIERREZ ANTONIO J,D107,HJ,152.73,,354919.27
6150,2/12/2021,2/12/2021,21221,82L-IMPORT PAYROLL-GUTIERREZ ANTONIO J,D107,HJ,209.77,,355129.04
6150,2/12/2021,2/12/2021,21221,82L-IMPORT PAYROLL-HENRY GILLIAN,D102,HJ,29.17,,355158.21
6150,2/12/2021,2/12/2021,21221,82L-IMPORT PAYROLL-HENRY GILLIAN,D102,HJ,70.42,,355228.63
6150,2/12/2021,2/12/2021,21221,82L-IMPORT PAYROLL-HENRY GILLIAN,D102,HJ,124.74,,355353.37
6150,2/12/2021,2/12/2021,21221,82L-IMPORT PAYROLL-HERMAN ADAM,D102,HJ,28.2,,355381.57
6150,2/12/2021,2/12/2021,21221,82L-IMPORT PAYROLL-HERMAN ADAM,D102,HJ,120.56,,355502.13
6150,2/12/2021,2/12/2021,21221,82L-IMPORT PAYROLL-HERNANDEZ ANNA,D101,HJ,37.18,,355539.31
6150,2/12/2021,2/12/2021,21221,82L-IMPORT PAYROLL-HERNANDEZ ANNA,D101,HJ,64.11,,355603.42
6150,2/12/2021,2/12/2021,21221,82L-IMPORT PAYROLL-HERNANDEZ ANNA,D101,HJ,159,,355762.42
6150,2/12/2021,2/12/2021,21221,82L-IMPORT PAYROLL-HESTER TYLER CONRAD,D105,HJ,27.79,,355790.21
6150,2/12/2021,2/12/2021,21221,82L-IMPORT PAYROLL-HESTER TYLER CONRAD,D105,HJ,118.83,,355909.04
6150,2/12/2021,2/12/2021,21221,82L-IMPORT PAYROLL-HOLT ADAM,D109,HJ,58.24,,355967.28
6150,2/12/2021,2/12/2021,21221,82L-IMPORT PAYROLL-HOLT ADAM,D109,HJ,68.28,,356035.56
6150,2/12/2021,2/12/2021,21221,82L-IMPORT PAYROLL-HOLT ADAM,D109,HJ,249.03,,356284.59
6150,2/12/2021,2/12/2021,21221,82L-IMPORT PAYROLL-IWASAKI MIKA,D101,HJ,29.24,,356313.83
6150,2/12/2021,2/12/2021,21221,82L-IMPORT PAYROLL-IWASAKI MIKA,D101,HJ,125.03,,356438.86
6150,2/12/2021,2/12/2021,21221,82L-IMPORT PAYROLL-KELLY SEAN,D109,HJ,47.03,,356485.89
6150,2/12/2021,2/12/2021,21221,82L-IMPORT PAYROLL-KELLY SEAN,D109,HJ,78.54,,356564.43
6150,2/12/2021,2/12/2021,21221,82L-IMPORT PAYROLL-KELLY SEAN,D109,HJ,335.83,,356900.26
6150,2/12/2021,2/12/2021,21221,82L-IMPORT PAYROLL-KRUGER MARK,D109,HJ,61.2,,356961.46
6150,2/12/2021,2/12/2021,21221,82L-IMPORT PAYROLL-KRUGER MARK,D109,HJ,72.5,,357033.96
6150,2/12/2021,2/12/2021,21221,82L-IMPORT PAYROLL-KRUGER MARK,D109,HJ,310,,357343.96
6150,2/12/2021,2/12/2021,21221,82L-IMPORT PAYROLL-LIPORACE HERNAN LUIS,D103,HJ,33.06,,357377.02
6150,2/12/2021,2/12/2021,21221,82L-IMPORT PAYROLL-LIPORACE HERNAN LUIS,D103,HJ,61.55,,357438.57
6150,2/12/2021,2/12/2021,21221,82L-IMPORT PAYROLL-LIPORACE HERNAN LUIS,D103,HJ,141.34,,357579.91
6150,2/12/2021,2/12/2021,21221,82L-IMPORT PAYROLL-MARKS KRISTA,D109,HJ,52.53,,357632.44
6150,2/12/2021,2/12/2021,21221,82L-IMPORT PAYROLL-MARKS KRISTA,D109,HJ,76.2,,357708.64
6150,2/12/2021,2/12/2021,21221,82L-IMPORT PAYROLL-MARKS KRISTA,D109,HJ,325.8,,358034.44
6150,2/12/2021,2/12/2021,21221,82L-IMPORT PAYROLL-MELVIN DARNELL KEVIN,D109,HJ,16.1,,358050.54
6150,2/12/2021,2/12/2021,21221,82L-IMPORT PAYROLL-MELVIN DARNELL KEVIN,D109,HJ,55.91,,358106.45
6150,2/12/2021,2/12/2021,21221,82L-IMPORT PAYROLL-MELVIN DARNELL KEVIN,D109,HJ,239.08,,358345.53
6150,2/12/2021,2/12/2021,21221,82L-IMPORT PAYROLL-MESSING JENNIFER,D104,HJ,34.12,,358379.65
6150,2/12/2021,2/12/2021,21221,82L-IMPORT PAYROLL-MESSING JENNIFER,D104,HJ,61.92,,358441.57
6150,2/12/2021,2/12/2021,21221,82L-IMPORT PAYROLL-MESSING JENNIFER,D104,HJ,145.9,,358587.47
6150,2/12/2021,2/12/2021,21221,82L-IMPORT PAYROLL-MILNE ROGER,D109,HJ,52.53,,358640
6150,2/12/2021,2/12/2021,21221,82L-IMPORT PAYROLL-MILNE ROGER,D109,HJ,76.2,,358716.2
6150,2/12/2021,2/12/2021,21221,82L-IMPORT PAYROLL-MILNE ROGER,D109,HJ,325.8,,359042
6150,2/12/2021,2/12/2021,21221,82L-IMPORT PAYROLL-MOSTAFAVI YASAMAN,D109,HJ,7.66,,359049.66
6150,2/12/2021,2/12/2021,21221,82L-IMPORT PAYROLL-MOSTAFAVI YASAMAN,D109,HJ,12.55,,359062.21
6150,2/12/2021,2/12/2021,21221,82L-IMPORT PAYROLL-MOSTAFAVI YASAMAN,D109,HJ,32.74,,359094.95
6150,2/12/2021,2/12/2021,21221,82L-IMPORT PAYROLL-O'DONNELL STEPHEN,D104,HJ,37.03,,359131.98
6150,2/12/2021,2/12/2021,21221,82L-IMPORT PAYROLL-O'DONNELL STEPHEN,D104,HJ,63.85,,359195.83
6150,2/12/2021,2/12/2021,21221,82L-IMPORT PAYROLL-O'DONNELL STEPHEN,D104,HJ,158.35,,359354.18
6150,2/12/2021,2/12/2021,21221,82L-IMPORT PAYROLL-PARETS MALLORY GRACE,D101,HJ,17.57,,359371.75
6150,2/12/2021,2/12/2021,21221,82L-IMPORT PAYROLL-PARETS MALLORY GRACE,D101,HJ,41.08,,359412.83
6150,2/12/2021,2/12/2021,21221,82L-IMPORT PAYROLL-PARETS MALLORY GRACE,D101,HJ,76.5,,359489.33
6150,2/12/2021,2/12/2021,21221,82L-IMPORT PAYROLL-PARETS MALLORY GRACE,D101,HJ,175.67,,359665
6150,2/12/2021,2/12/2021,21221,82L-IMPORT PAYROLL-PARHAM-GANTT DENISE M,D112,HJ,37.96,,359702.96
6150,2/12/2021,2/12/2021,21221,82L-IMPORT PAYROLL-PARHAM-GANTT DENISE M,D112,HJ,162.32,,359865.28
6150,2/12/2021,2/12/2021,21221,82L-IMPORT PAYROLL-PEINADO ELIZABETH R,D111,HJ,52.29,,359917.57
6150,2/12/2021,2/12/2021,21221,82L-IMPORT PAYROLL-PEINADO ELIZABETH R,D111,HJ,223.58,,360141.15
6150,2/12/2021,2/12/2021,21221,82L-IMPORT PAYROLL-PERNIA JEFFREY,D109,HJ,25.83,,360166.98
6150,2/12/2021,2/12/2021,21221,82L-IMPORT PAYROLL-PERNIA JEFFREY,D109,HJ,56.19,,360223.17
6150,2/12/2021,2/12/2021,21221,82L-IMPORT PAYROLL-PERNIA JEFFREY,D109,HJ,240.25,,360463.42
6150,2/12/2021,2/12/2021,21221,82L-IMPORT PAYROLL-PIRES MANUEL,D103,HJ,31.08,,360494.5
6150,2/12/2021,2/12/2021,21221,82L-IMPORT PAYROLL-PIRES MANUEL,D103,HJ,93.32,,360587.82
6150,2/12/2021,2/12/2021,21221,82L-IMPORT PAYROLL-PIRES MANUEL,D103,HJ,132.89,,360720.71
6150,2/12/2021,2/12/2021,21221,82L-IMPORT PAYROLL-POLANCO ODALIS,D103,HJ,28.02,,360748.73
6150,2/12/2021,2/12/2021,21221,82L-IMPORT PAYROLL-POLANCO ODALIS,D103,HJ,43.23,,360791.96
6150,2/12/2021,2/12/2021,21221,82L-IMPORT PAYROLL-POLANCO ODALIS,D103,HJ,184.83,,360976.79
6150,2/12/2021,2/12/2021,21221,82L-IMPORT PAYROLL-QUINTAS JASHIVE,D105,HJ,25.57,,361002.36
6150,2/12/2021,2/12/2021,21221,82L-IMPORT PAYROLL-QUINTAS JASHIVE,D105,HJ,109.31,,361111.67
6150,2/12/2021,2/12/2021,21221,82L-IMPORT PAYROLL-RANDOLPH ALEXANDER,D111,HJ,11.63,,361123.3
6150,2/12/2021,2/12/2021,21221,82L-IMPORT PAYROLL-RANDOLPH ALEXANDER,D111,HJ,25.1,,361148.4
6150,2/12/2021,2/12/2021,21221,82L-IMPORT PAYROLL-RANDOLPH ALEXANDER,D111,HJ,50.63,,361199.03
6150,2/12/2021,2/12/2021,21221,82L-IMPORT PAYROLL-RANDOLPH ALEXANDER,D111,HJ,107.33,,361306.36
6150,2/12/2021,2/12/2021,21221,82L-IMPORT PAYROLL-RUBI PERLA,D101,HJ,15.92,,361322.28
6150,2/12/2021,2/12/2021,21221,82L-IMPORT PAYROLL-RUBI PERLA,D101,HJ,68.09,,361390.37
6150,2/12/2021,2/12/2021,21221,82L-IMPORT PAYROLL-SAFRAN ALAN P,D107,HJ,9.31,,361399.68
6150,2/12/2021,2/12/2021,21221,82L-IMPORT PAYROLL-SAFRAN ALAN P,D107,HJ,39.83,,361439.51
6150,2/12/2021,2/12/2021,21221,82L-IMPORT PAYROLL-SAFRAN ALAN P,D107,HJ,94.21,,361533.72
6150,2/12/2021,2/12/2021,21221,82L-IMPORT PAYROLL-SAFRAN ALAN P,D107,HJ,402.81,,361936.53
6150,2/12/2021,2/12/2021,21221,82L-IMPORT PAYROLL-SHENKMAN OLIVIA,D101,HJ,29,,361965.53
6150,2/12/2021,2/12/2021,21221,82L-IMPORT PAYROLL-SHENKMAN OLIVIA,D101,HJ,124,,362089.53
6150,2/12/2021,2/12/2021,21221,82L-IMPORT PAYROLL-VYAS SUNAINA,D104,HJ,28.09,,362117.62
6150,2/12/2021,2/12/2021,21221,82L-IMPORT PAYROLL-VYAS SUNAINA,D104,HJ,67.81,,362185.43
6150,2/12/2021,2/12/2021,21221,82L-IMPORT PAYROLL-VYAS SUNAINA,D104,HJ,120.13,,362305.56
6150,2/12/2021,2/12/2021,21221,82L-IMPORT PAYROLL-WALLACE AMENA,D104,HJ,28.93,,362334.49
6150,2/12/2021,2/12/2021,21221,82L-IMPORT PAYROLL-WALLACE AMENA,D104,HJ,123.72,,362458.21
6150,2/12/2021,2/12/2021,21221,82L-IMPORT PAYROLL-WARD JEFFREY,D109,HJ,47.03,,362505.24
6150,2/12/2021,2/12/2021,21221,82L-IMPORT PAYROLL-WARD JEFFREY,D109,HJ,78.54,,362583.78
6150,2/12/2021,2/12/2021,21221,82L-IMPORT PAYROLL-WARD JEFFREY,D109,HJ,335.83,,362919.61
6150,2/12/2021,2/12/2021,21221,82L-IMPORT PAYROLL-WARD JENNIFER,D109,HJ,14.55,,362934.16
6150,2/12/2021,2/12/2021,21221,82L-IMPORT PAYROLL-WARD JENNIFER,D109,HJ,17.06,,362951.22
6150,2/12/2021,2/12/2021,21221,82L-IMPORT PAYROLL-WARD JENNIFER,D109,HJ,62.22,,363013.44
6150,2/12/2021,2/12/2021,21221,82L-IMPORT PAYROLL-WEINSTOCK EMILY,D101,HJ,17.57,,363031.01
6150,2/12/2021,2/12/2021,21221,82L-IMPORT PAYROLL-WEINSTOCK EMILY,D101,HJ,38.11,,363069.12
6150,2/12/2021,2/12/2021,21221,82L-IMPORT PAYROLL-WEINSTOCK EMILY,D101,HJ,76.5,,363145.62
6150,2/12/2021,2/12/2021,21221,82L-IMPORT PAYROLL-WEINSTOCK EMILY,D101,HJ,162.94,,363308.56
6150,2/12/2021,2/12/2021,21221,82L-IMPORT PAYROLL-WINANS JENNIFER,D111,HJ,36.33,,363344.89
6150,2/12/2021,2/12/2021,21221,82L-IMPORT PAYROLL-WINANS JENNIFER,D111,HJ,67.65,,363412.54
6150,2/12/2021,2/12/2021,21221,82L-IMPORT PAYROLL-WINANS JENNIFER,D111,HJ,155.35,,363567.89
6150,2/12/2021,2/12/2021,21221,82L-IMPORT PAYROLL-ZARATE JOSEPH M,D105,HJ,31.18,,363599.07
6150,2/12/2021,2/12/2021,21221,82L-IMPORT PAYROLL-ZARATE JOSEPH M,D105,HJ,133.3,,363732.37
6150,2/12/2021,2/12/2021,21221,82L-IMPORT PAYROLL-AGUANNO JOSEPH,D108,HJ,16.23,,363748.6
6150,2/12/2021,2/12/2021,21221,82L-IMPORT PAYROLL-AGUANNO JOSEPH,D108,HJ,69.38,,363817.98
6150,2/12/2021,2/12/2021,21221,82L-IMPORT PAYROLL-AKESODE FEHINTOLA,D108,HJ,16.23,,363834.21
6150,2/12/2021,2/12/2021,21221,82L-IMPORT PAYROLL-AKESODE FEHINTOLA,D108,HJ,69.38,,363903.59
6150,2/12/2021,2/12/2021,21221,82L-IMPORT PAYROLL-BARTOLD DEANNA MARIE,D108,HJ,41.91,,363945.5
6150,2/12/2021,2/12/2021,21221,82L-IMPORT PAYROLL-BARTOLD DEANNA MARIE,D108,HJ,179.22,,364124.72
6150,2/12/2021,2/12/2021,21221,82L-IMPORT PAYROLL-BELLOT GENESIS,D108,HJ,32.36,,364157.08
6150,2/12/2021,2/12/2021,21221,82L-IMPORT PAYROLL-BELLOT GENESIS,D108,HJ,138.38,,364295.46
6150,2/12/2021,2/12/2021,21221,82L-IMPORT PAYROLL-BENNETT JAMES H,D108,HJ,16.23,,364311.69
6150,2/12/2021,2/12/2021,21221,82L-IMPORT PAYROLL-BENNETT JAMES H,D108,HJ,69.38,,364381.07
6150,2/12/2021,2/12/2021,21221,82L-IMPORT PAYROLL-BOWMAN ABIGAIL,D108,HJ,16.23,,364397.3
6150,2/12/2021,2/12/2021,21221,82L-IMPORT PAYROLL-BOWMAN ABIGAIL,D108,HJ,69.38,,364466.68
6150,2/12/2021,2/12/2021,21221,82L-IMPORT PAYROLL-BURRELL RUSSELL,D108,HJ,15.08,,364481.76
6150,2/12/2021,2/12/2021,21221,82L-IMPORT PAYROLL-BURRELL RUSSELL,D108,HJ,28.09,,364509.85
6150,2/12/2021,2/12/2021,21221,82L-IMPORT PAYROLL-BURRELL RUSSELL,D108,HJ,64.5,,364574.35
6150,2/12/2021,2/12/2021,21221,82L-IMPORT PAYROLL-CHUI KENT,D108,HJ,16.23,,364590.58
6150,2/12/2021,2/12/2021,21221,82L-IMPORT PAYROLL-CHUI KENT,D108,HJ,69.38,,364659.96
6150,2/12/2021,2/12/2021,21221,82L-IMPORT PAYROLL-CIRKER MIA,D108,HJ,32.63,,364692.59
6150,2/12/2021,2/12/2021,21221,82L-IMPORT PAYROLL-CIRKER MIA,D108,HJ,139.5,,364832.09
6150,2/12/2021,2/12/2021,21221,82L-IMPORT PAYROLL-DEWS CAMERYN,D108,HJ,33.23,,364865.32
6150,2/12/2021,2/12/2021,21221,82L-IMPORT PAYROLL-DEWS CAMERYN,D108,HJ,142.08,,365007.4
6150,2/12/2021,2/12/2021,21221,82L-IMPORT PAYROLL-DIETZ MARY,D108,HJ,16.23,,365023.63
6150,2/12/2021,2/12/2021,21221,82L-IMPORT PAYROLL-DIETZ MARY,D108,HJ,35.81,,365059.44
6150,2/12/2021,2/12/2021,21221,82L-IMPORT PAYROLL-DIETZ MARY,D108,HJ,69.38,,365128.82
6150,2/12/2021,2/12/2021,21221,82L-IMPORT PAYROLL-DOMINIQUE PRINCESSA,D108,HJ,16.23,,365145.05
6150,2/12/2021,2/12/2021,21221,82L-IMPORT PAYROLL-DOMINIQUE PRINCESSA,D108,HJ,69.38,,365214.43
6150,2/12/2021,2/12/2021,21221,82L-IMPORT PAYROLL-DONNELLY HOME,D108,HJ,6.94,,365221.37
6150,2/12/2021,2/12/2021,21221,82L-IMPORT PAYROLL-DONNELLY HOME,D108,HJ,16.23,,365237.6
6150,2/12/2021,2/12/2021,21221,82L-IMPORT PAYROLL-DONNELLY HOME,D108,HJ,30.21,,365267.81
6150,2/12/2021,2/12/2021,21221,82L-IMPORT PAYROLL-DONNELLY HOME,D108,HJ,69.38,,365337.19
6150,2/12/2021,2/12/2021,21221,82L-IMPORT PAYROLL-FEIGHERY JOHN,D108,HJ,30.56,,365367.75
6150,2/12/2021,2/12/2021,21221,82L-IMPORT PAYROLL-FEIGHERY JOHN,D108,HJ,130.69,,365498.44
6150,2/12/2021,2/12/2021,21221,82L-IMPORT PAYROLL-FORTH KYLE,D108,HJ,16.23,,365514.67
6150,2/12/2021,2/12/2021,21221,82L-IMPORT PAYROLL-FORTH KYLE,D108,HJ,69.38,,365584.05
6150,2/12/2021,2/12/2021,21221,82L-IMPORT PAYROLL-GARCIA MARILYN,D108,HJ,33.23,,365617.28
6150,2/12/2021,2/12/2021,21221,82L-IMPORT PAYROLL-GARCIA MARILYN,D108,HJ,142.08,,365759.36
6150,2/12/2021,2/12/2021,21221,82L-IMPORT PAYROLL-GREENE BROOKE,D108,HJ,15.28,,365774.64
6150,2/12/2021,2/12/2021,21221,82L-IMPORT PAYROLL-GREENE BROOKE,D108,HJ,65.35,,365839.99
6150,2/12/2021,2/12/2021,21221,82L-IMPORT PAYROLL-GRIFFIN ANDREW,D108,HJ,30.44,,365870.43
6150,2/12/2021,2/12/2021,21221,82L-IMPORT PAYROLL-GRIFFIN ANDREW,D108,HJ,74.25,,365944.68
6150,2/12/2021,2/12/2021,21221,82L-IMPORT PAYROLL-GRIFFIN ANDREW,D108,HJ,130.16,,366074.84
6150,2/12/2021,2/12/2021,21221,82L-IMPORT PAYROLL-GROSS EMILY,D108,HJ,14,,366088.84
6150,2/12/2021,2/12/2021,21221,82L-IMPORT PAYROLL-GROSS EMILY,D108,HJ,59.86,,366148.7
6150,2/12/2021,2/12/2021,21221,82L-IMPORT PAYROLL-GUERRERO LUIS,D108,HJ,16.23,,366164.93
6150,2/12/2021,2/12/2021,21221,82L-IMPORT PAYROLL-GUERRERO LUIS,D108,HJ,69.38,,366234.31
6150,2/12/2021,2/12/2021,21221,82L-IMPORT PAYROLL-HALLINAN GABRIEL,D108,HJ,34.79,,366269.1
6150,2/12/2021,2/12/2021,21221,82L-IMPORT PAYROLL-HALLINAN GABRIEL,D108,HJ,148.76,,366417.86
6150,2/12/2021,2/12/2021,21221,82L-IMPORT PAYROLL-HAMERSLY WILLIAM,D108,HJ,34.16,,366452.02
6150,2/12/2021,2/12/2021,21221,82L-IMPORT PAYROLL-HAMERSLY WILLIAM,D108,HJ,146.08,,366598.1
6150,2/12/2021,2/12/2021,21221,82L-IMPORT PAYROLL-HOSSAIN MYESHA,D108,HJ,35.1,,366633.2
6150,2/12/2021,2/12/2021,21221,82L-IMPORT PAYROLL-HOSSAIN MYESHA,D108,HJ,150.1,,366783.3
6150,2/12/2021,2/12/2021,21221,82L-IMPORT PAYROLL-JACKSON TASNIM F,D108,HJ,31,,366814.3
6150,2/12/2021,2/12/2021,21221,82L-IMPORT PAYROLL-JACKSON TASNIM F,D108,HJ,132.56,,366946.86
6150,2/12/2021,2/12/2021,21221,82L-IMPORT PAYROLL-KERKHOFF HARPER FAITH,D108,HJ,14.98,,366961.84
6150,2/12/2021,2/12/2021,21221,82L-IMPORT PAYROLL-KERKHOFF HARPER FAITH,D108,HJ,27.89,,366989.73
6150,2/12/2021,2/12/2021,21221,82L-IMPORT PAYROLL-KERKHOFF HARPER FAITH,D108,HJ,64.04,,367053.77
6150,2/12/2021,2/12/2021,21221,82L-IMPORT PAYROLL-LEARY AUBREY,D108,HJ,16.2,,367069.97
6150,2/12/2021,2/12/2021,21221,82L-IMPORT PAYROLL-LEARY AUBREY,D108,HJ,69.27,,367139.24
6150,2/12/2021,2/12/2021,21221,82L-IMPORT PAYROLL-LI BELLA,D108,HJ,33.96,,367173.2
6150,2/12/2021,2/12/2021,21221,82L-IMPORT PAYROLL-LI BELLA,D108,HJ,145.23,,367318.43
6150,2/12/2021,2/12/2021,21221,82L-IMPORT PAYROLL-LOUIE JORDAN,D108,HJ,16.23,,367334.66
6150,2/12/2021,2/12/2021,21221,82L-IMPORT PAYROLL-LOUIE JORDAN,D108,HJ,69.38,,367404.04
6150,2/12/2021,2/12/2021,21221,82L-IMPORT PAYROLL-MELCHOR OSBEIDY,D108,HJ,16.23,,367420.27
6150,2/12/2021,2/12/2021,21221,82L-IMPORT PAYROLL-MELCHOR OSBEIDY,D108,HJ,69.38,,367489.65
6150,2/12/2021,2/12/2021,21221,82L-IMPORT PAYROLL-MORRIS ZAKIYA,D108,HJ,16.23,,367505.88
6150,2/12/2021,2/12/2021,21221,82L-IMPORT PAYROLL-MORRIS ZAKIYA,D108,HJ,69.38,,367575.26
6150,2/12/2021,2/12/2021,21221,82L-IMPORT PAYROLL-MORSELETTO RAFAEL,D108,HJ,1.64,,367576.9
6150,2/12/2021,2/12/2021,21221,82L-IMPORT PAYROLL-MORSELETTO RAFAEL,D108,HJ,11.53,,367588.43
6150,2/12/2021,2/12/2021,21221,82L-IMPORT PAYROLL-MORSELETTO RAFAEL,D108,HJ,16.23,,367604.66
6150,2/12/2021,2/12/2021,21221,82L-IMPORT PAYROLL-MORSELETTO RAFAEL,D108,HJ,69.38,,367674.04
6150,2/12/2021,2/12/2021,21221,82L-IMPORT PAYROLL-OBI TOBECHUKWU,D108,HJ,16.23,,367690.27
6150,2/12/2021,2/12/2021,21221,82L-IMPORT PAYROLL-OBI TOBECHUKWU,D108,HJ,69.38,,367759.65
6150,2/12/2021,2/12/2021,21221,82L-IMPORT PAYROLL-OPUH NDIDI,D108,HJ,34.74,,367794.39
6150,2/12/2021,2/12/2021,21221,82L-IMPORT PAYROLL-OPUH NDIDI,D108,HJ,148.53,,367942.92
6150,2/12/2021,2/12/2021,21221,82L-IMPORT PAYROLL-PAULINO THAIRI,D108,HJ,16.23,,367959.15
6150,2/12/2021,2/12/2021,21221,82L-IMPORT PAYROLL-PAULINO THAIRI,D108,HJ,69.38,,368028.53
6150,2/12/2021,2/12/2021,21221,82L-IMPORT PAYROLL-ROSENBAUM MURRAY,D108,HJ,16.23,,368044.76
6150,2/12/2021,2/12/2021,21221,82L-IMPORT PAYROLL-ROSENBAUM MURRAY,D108,HJ,69.38,,368114.14
6150,2/12/2021,2/12/2021,21221,82L-IMPORT PAYROLL-SCHWETTMANN CLAIRE,D108,HJ,15.28,,368129.42
6150,2/12/2021,2/12/2021,21221,82L-IMPORT PAYROLL-SCHWETTMANN CLAIRE,D108,HJ,65.35,,368194.77
6150,2/12/2021,2/12/2021,21221,82L-IMPORT PAYROLL-SOBELMAN JUSTIN,D108,HJ,15.08,,368209.85
6150,2/12/2021,2/12/2021,21221,82L-IMPORT PAYROLL-SOBELMAN JUSTIN,D108,HJ,64.5,,368274.35
6150,2/12/2021,2/12/2021,21221,82L-IMPORT PAYROLL-TERRENCE-SMITH ZIHIR,D108,HJ,14.32,,368288.67
6150,2/12/2021,2/12/2021,21221,82L-IMPORT PAYROLL-TERRENCE-SMITH ZIHIR,D108,HJ,61.22,,368349.89
6150,2/12/2021,2/12/2021,21221,82L-IMPORT PAYROLL-TILLERY ASIA,D108,HJ,54.34,,368404.23
6150,2/12/2021,2/12/2021,21221,82L-IMPORT PAYROLL-TILLERY ASIA,D108,HJ,232.34,,368636.57
6150,2/12/2021,2/12/2021,21221,82L-IMPORT PAYROLL-WILLIAMS-MASSEY BRIANNA,D108,HJ,16.05,,368652.62
6150,2/12/2021,2/12/2021,21221,82L-IMPORT PAYROLL-WILLIAMS-MASSEY BRIANNA,D108,HJ,36.93,,368689.55
6150,2/12/2021,2/12/2021,21221,82L-IMPORT PAYROLL-WILLIAMS-MASSEY BRIANNA,D108,HJ,68.64,,368758.19
6150,2/12/2021,2/12/2021,21221,82L-IMPORT PAYROLL-XIAO CHENGYAO,D108,HJ,16.23,,368774.42
6150,2/12/2021,2/12/2021,21221,82L-IMPORT PAYROLL-XIAO CHENGYAO,D108,HJ,69.38,,368843.8
6150,2/12/2021,2/12/2021,21221,82L-IMPORT PAYROLL-ZIAUDDIN ABUTAHER,D108,HJ,16.23,,368860.03
6150,2/12/2021,2/12/2021,21221,82L-IMPORT PAYROLL-ZIAUDDIN ABUTAHER,D108,HJ,69.38,,368929.41
6150,2/12/2021,2/12/2021,21221,82L-IMPORT PAYROLL-BALASUBRAMANIAN SHARANYA,D108,HJ,16.53,,368945.94
6150,2/12/2021,2/12/2021,21221,82L-IMPORT PAYROLL-BALASUBRAMANIAN SHARANYA,D108,HJ,38.67,,368984.61
6150,2/12/2021,2/12/2021,21221,82L-IMPORT PAYROLL-BALASUBRAMANIAN SHARANYA,D108,HJ,72,,369056.61
6150,2/12/2021,2/12/2021,21221,82L-IMPORT PAYROLL-BALASUBRAMANIAN SHARANYA,D108,HJ,165.33,,369221.94
6150,2/12/2021,2/12/2021,21221,82L-IMPORT PAYROLL-COVENEY ALLISON,D108,HJ,38.07,,369260.01
6150,2/12/2021,2/12/2021,21221,82L-IMPORT PAYROLL-COVENEY ALLISON,D108,HJ,162.79,,369422.8
6150,2/12/2021,2/12/2021,21221,82L-IMPORT PAYROLL-JACKSON CLAICE M,D108,HJ,19.38,,369442.18
6150,2/12/2021,2/12/2021,21221,82L-IMPORT PAYROLL-JACKSON CLAICE M,D108,HJ,42.91,,369485.09
6150,2/12/2021,2/12/2021,21221,82L-IMPORT PAYROLL-JACKSON CLAICE M,D108,HJ,74.25,,369559.34
6150,2/12/2021,2/12/2021,21221,82L-IMPORT PAYROLL-JACKSON CLAICE M,D108,HJ,183.48,,369742.82
6150,2/12/2021,2/12/2021,21221,82L-IMPORT PAYROLL-JANG DANIEL,D108,HJ,37.75,,369780.57
6150,2/12/2021,2/12/2021,21221,82L-IMPORT PAYROLL-JANG DANIEL,D108,HJ,67.69,,369848.26
6150,2/12/2021,2/12/2021,21221,82L-IMPORT PAYROLL-JANG DANIEL,D108,HJ,161.4,,370009.66
6150,2/12/2021,2/12/2021,21221,82L-IMPORT PAYROLL-LENEGHAN MARYELLEN,D108,HJ,12.41,,370022.07
6150,2/12/2021,2/12/2021,21221,82L-IMPORT PAYROLL-LENEGHAN MARYELLEN,D108,HJ,53.07,,370075.14
6150,2/12/2021,2/12/2021,21221,82L-IMPORT PAYROLL-LENEGHAN MARYELLEN,D108,HJ,56.55,,370131.69
6150,2/12/2021,2/12/2021,21221,82L-IMPORT PAYROLL-LENEGHAN MARYELLEN,D108,HJ,241.81,,370373.5
6150,2/26/2021,2/26/2021,22621,82L-IMPORT PAYROLL-BARTHELEMY RACHALIE,D108,HJ,14.01,,370387.51
6150,2/26/2021,2/26/2021,22621,82L-IMPORT PAYROLL-BARTHELEMY RACHALIE,D108,HJ,26.08,,370413.59
6150,2/26/2021,2/26/2021,22621,82L-IMPORT PAYROLL-BARTHELEMY RACHALIE,D108,HJ,59.89,,370473.48
6150,2/26/2021,2/26/2021,22621,82L-IMPORT PAYROLL-BOHLSEN GRACE ISABELLE,D108,HJ,15.16,,370488.64
6150,2/26/2021,2/26/2021,22621,82L-IMPORT PAYROLL-BOHLSEN GRACE ISABELLE,D108,HJ,64.84,,370553.48
6150,2/26/2021,2/26/2021,22621,82L-IMPORT PAYROLL-BOLIVAR ANDREA,D108,HJ,36.25,,370589.73
6150,2/26/2021,2/26/2021,22621,82L-IMPORT PAYROLL-BOLIVAR ANDREA,D108,HJ,155,,370744.73
6150,2/26/2021,2/26/2021,22621,82L-IMPORT PAYROLL-BORCHART SPENCER,D108,HJ,15.19,,370759.92
6150,2/26/2021,2/26/2021,22621,82L-IMPORT PAYROLL-BORCHART SPENCER,D108,HJ,44.27,,370804.19
6150,2/26/2021,2/26/2021,22621,82L-IMPORT PAYROLL-BORCHART SPENCER,D108,HJ,64.95,,370869.14
6150,2/26/2021,2/26/2021,22621,82L-IMPORT PAYROLL-BRIANTE SAMUEL,D108,HJ,14.98,,370884.12
6150,2/26/2021,2/26/2021,22621,82L-IMPORT PAYROLL-BRIANTE SAMUEL,D108,HJ,36.15,,370920.27
6150,2/26/2021,2/26/2021,22621,82L-IMPORT PAYROLL-BRIANTE SAMUEL,D108,HJ,64.03,,370984.3
6150,2/26/2021,2/26/2021,22621,82L-IMPORT PAYROLL-BROWN ISAAC,D108,HJ,14.01,,370998.31
6150,2/26/2021,2/26/2021,22621,82L-IMPORT PAYROLL-BROWN ISAAC,D108,HJ,20.14,,371018.45
6150,2/26/2021,2/26/2021,22621,82L-IMPORT PAYROLL-BROWN ISAAC,D108,HJ,59.89,,371078.34
6150,2/26/2021,2/26/2021,22621,82L-IMPORT PAYROLL-CASSADY JOSHUA LEWIS,D108,HJ,15.19,,371093.53
6150,2/26/2021,2/26/2021,22621,82L-IMPORT PAYROLL-CASSADY JOSHUA LEWIS,D108,HJ,28.29,,371121.82
6150,2/26/2021,2/26/2021,22621,82L-IMPORT PAYROLL-CASSADY JOSHUA LEWIS,D108,HJ,64.95,,371186.77
6150,2/26/2021,2/26/2021,22621,82L-IMPORT PAYROLL-DARKO OLIVIA,D108,HJ,15.19,,371201.96
6150,2/26/2021,2/26/2021,22621,82L-IMPORT PAYROLL-DARKO OLIVIA,D108,HJ,64.95,,371266.91
6150,2/26/2021,2/26/2021,22621,82L-IMPORT PAYROLL-ESCAMILLA OLGA,D108,HJ,15.56,,371282.47
6150,2/26/2021,2/26/2021,22621,82L-IMPORT PAYROLL-ESCAMILLA OLGA,D108,HJ,66.53,,371349
6150,2/26/2021,2/26/2021,22621,82L-IMPORT PAYROLL-GARCIA SANTIAGO,D108,HJ,27.37,,371376.37
6150,2/26/2021,2/26/2021,22621,82L-IMPORT PAYROLL-GARCIA SANTIAGO,D108,HJ,27.59,,371403.96
6150,2/26/2021,2/26/2021,22621,82L-IMPORT PAYROLL-GARCIA SANTIAGO,D108,HJ,117.98,,371521.94
6150,2/26/2021,2/26/2021,22621,82L-IMPORT PAYROLL-GILES SHAYLA,D108,HJ,15.78,,371537.72
6150,2/26/2021,2/26/2021,22621,82L-IMPORT PAYROLL-GILES SHAYLA,D108,HJ,29.38,,371567.1
6150,2/26/2021,2/26/2021,22621,82L-IMPORT PAYROLL-GILES SHAYLA,D108,HJ,67.46,,371634.56
6150,2/26/2021,2/26/2021,22621,82L-IMPORT PAYROLL-IKUNIKA FUNMILAYO,D108,HJ,20.25,,371654.81
6150,2/26/2021,2/26/2021,22621,82L-IMPORT PAYROLL-IKUNIKA FUNMILAYO,D108,HJ,30.21,,371685.02
6150,2/26/2021,2/26/2021,22621,82L-IMPORT PAYROLL-IKUNIKA FUNMILAYO,D108,HJ,129.17,,371814.19
6150,2/26/2021,2/26/2021,22621,82L-IMPORT PAYROLL-JONES JORDAN,D108,HJ,15.19,,371829.38
6150,2/26/2021,2/26/2021,22621,82L-IMPORT PAYROLL-JONES JORDAN,D108,HJ,64.95,,371894.33
6150,2/26/2021,2/26/2021,22621,82L-IMPORT PAYROLL-KHAN HUDA,D108,HJ,14.25,,371908.58
6150,2/26/2021,2/26/2021,22621,82L-IMPORT PAYROLL-KHAN HUDA,D108,HJ,26.53,,371935.11
6150,2/26/2021,2/26/2021,22621,82L-IMPORT PAYROLL-KHAN HUDA,D108,HJ,60.92,,371996.03
6150,2/26/2021,2/26/2021,22621,82L-IMPORT PAYROLL-KLOHR TIMOTHY JORDAN,D108,HJ,27,,372023.03
6150,2/26/2021,2/26/2021,22621,82L-IMPORT PAYROLL-KLOHR TIMOTHY JORDAN,D108,HJ,29,,372052.03
6150,2/26/2021,2/26/2021,22621,82L-IMPORT PAYROLL-KLOHR TIMOTHY JORDAN,D108,HJ,124,,372176.03
6150,2/26/2021,2/26/2021,22621,82L-IMPORT PAYROLL-KNOWLIN ZYLIA,D108,HJ,3.62,,372179.65
6150,2/26/2021,2/26/2021,22621,82L-IMPORT PAYROLL-KNOWLIN ZYLIA,D108,HJ,32.46,,372212.11
6150,2/26/2021,2/26/2021,22621,82L-IMPORT PAYROLL-KNOWLIN ZYLIA,D108,HJ,138.81,,372350.92
6150,2/26/2021,2/26/2021,22621,82L-IMPORT PAYROLL-LAI GRADY,D108,HJ,15.37,,372366.29
6150,2/26/2021,2/26/2021,22621,82L-IMPORT PAYROLL-LAI GRADY,D108,HJ,37.11,,372403.4
6150,2/26/2021,2/26/2021,22621,82L-IMPORT PAYROLL-LAI GRADY,D108,HJ,65.74,,372469.14
6150,2/26/2021,2/26/2021,22621,82L-IMPORT PAYROLL-LI SEN YUAN,D108,HJ,14.05,,372483.19
6150,2/26/2021,2/26/2021,22621,82L-IMPORT PAYROLL-LI SEN YUAN,D108,HJ,26.16,,372509.35
6150,2/26/2021,2/26/2021,22621,82L-IMPORT PAYROLL-LI SEN YUAN,D108,HJ,60.07,,372569.42
6150,2/26/2021,2/26/2021,22621,82L-IMPORT PAYROLL-LIPSCOMB STEPHEN,D108,HJ,1.4,,372570.82
6150,2/26/2021,2/26/2021,22621,82L-IMPORT PAYROLL-LIPSCOMB STEPHEN,D108,HJ,33.58,,372604.4
6150,2/26/2021,2/26/2021,22621,82L-IMPORT PAYROLL-LIPSCOMB STEPHEN,D108,HJ,143.59,,372747.99
6150,2/26/2021,2/26/2021,22621,82L-IMPORT PAYROLL-MALLECK JESSICA R,D108,HJ,15.19,,372763.18
6150,2/26/2021,2/26/2021,22621,82L-IMPORT PAYROLL-MALLECK JESSICA R,D108,HJ,64.95,,372828.13
6150,2/26/2021,2/26/2021,22621,82L-IMPORT PAYROLL-MEJIA ROSO CARLOS,D108,HJ,14.01,,372842.14
6150,2/26/2021,2/26/2021,22621,82L-IMPORT PAYROLL-MEJIA ROSO CARLOS,D108,HJ,26.08,,372868.22
6150,2/26/2021,2/26/2021,22621,82L-IMPORT PAYROLL-MEJIA ROSO CARLOS,D108,HJ,59.89,,372928.11
6150,2/26/2021,2/26/2021,22621,82L-IMPORT PAYROLL-MONROY-MEJIA JASON,D108,HJ,15.19,,372943.3
6150,2/26/2021,2/26/2021,22621,82L-IMPORT PAYROLL-MONROY-MEJIA JASON,D108,HJ,36.67,,372979.97
6150,2/26/2021,2/26/2021,22621,82L-IMPORT PAYROLL-MONROY-MEJIA JASON,D108,HJ,64.95,,373044.92
6150,2/26/2021,2/26/2021,22621,82L-IMPORT PAYROLL-O'FLYNN-PRUITT NATHAN COLYAR,D108,HJ,15.19,,373060.11
6150,2/26/2021,2/26/2021,22621,82L-IMPORT PAYROLL-O'FLYNN-PRUITT NATHAN COLYAR,D108,HJ,36.67,,373096.78
6150,2/26/2021,2/26/2021,22621,82L-IMPORT PAYROLL-O'FLYNN-PRUITT NATHAN COLYAR,D108,HJ,64.95,,373161.73
6150,2/26/2021,2/26/2021,22621,82L-IMPORT PAYROLL-OKRAH JULIAN O,D108,HJ,15.19,,373176.92
6150,2/26/2021,2/26/2021,22621,82L-IMPORT PAYROLL-OKRAH JULIAN O,D108,HJ,33.52,,373210.44
6150,2/26/2021,2/26/2021,22621,82L-IMPORT PAYROLL-OKRAH JULIAN O,D108,HJ,64.95,,373275.39
6150,2/26/2021,2/26/2021,22621,82L-IMPORT PAYROLL-PATTERSON STEVE,D108,HJ,15.19,,373290.58
6150,2/26/2021,2/26/2021,22621,82L-IMPORT PAYROLL-PATTERSON STEVE,D108,HJ,28.29,,373318.87
6150,2/26/2021,2/26/2021,22621,82L-IMPORT PAYROLL-PATTERSON STEVE,D108,HJ,64.95,,373383.82
6150,2/26/2021,2/26/2021,22621,82L-IMPORT PAYROLL-SCHMIESS RACHEL JOY,D108,HJ,10.69,,373394.51
6150,2/26/2021,2/26/2021,22621,82L-IMPORT PAYROLL-SCHMIESS RACHEL JOY,D108,HJ,15.19,,373409.7
6150,2/26/2021,2/26/2021,22621,82L-IMPORT PAYROLL-SCHMIESS RACHEL JOY,D108,HJ,64.95,,373474.65
6150,2/26/2021,2/26/2021,22621,82L-IMPORT PAYROLL-SCOTT KIRK DONOVAN,D108,HJ,14.05,,373488.7
6150,2/26/2021,2/26/2021,22621,82L-IMPORT PAYROLL-SCOTT KIRK DONOVAN,D108,HJ,26.16,,373514.86
6150,2/26/2021,2/26/2021,22621,82L-IMPORT PAYROLL-SCOTT KIRK DONOVAN,D108,HJ,60.07,,373574.93
6150,2/26/2021,2/26/2021,22621,82L-IMPORT PAYROLL-SILVER KELLY,D108,HJ,34.63,,373609.56
6150,2/26/2021,2/26/2021,22621,82L-IMPORT PAYROLL-SILVER KELLY,D108,HJ,148.06,,373757.62
6150,2/26/2021,2/26/2021,22621,82L-IMPORT PAYROLL-SOLIMAN MARK,D108,HJ,15.19,,373772.81
6150,2/26/2021,2/26/2021,22621,82L-IMPORT PAYROLL-SOLIMAN MARK,D108,HJ,36.67,,373809.48
6150,2/26/2021,2/26/2021,22621,82L-IMPORT PAYROLL-SOLIMAN MARK,D108,HJ,64.95,,373874.43
6150,2/26/2021,2/26/2021,22621,82L-IMPORT PAYROLL-STEIN KYLE,D108,HJ,27.84,,373902.27
6150,2/26/2021,2/26/2021,22621,82L-IMPORT PAYROLL-STEIN KYLE,D108,HJ,33.47,,373935.74
6150,2/26/2021,2/26/2021,22621,82L-IMPORT PAYROLL-STEIN KYLE,D108,HJ,119.05,,374054.79
6150,2/26/2021,2/26/2021,22621,82L-IMPORT PAYROLL-STROUD DAVID,D108,HJ,14.66,,374069.45
6150,2/26/2021,2/26/2021,22621,82L-IMPORT PAYROLL-STROUD DAVID,D108,HJ,31.34,,374100.79
6150,2/26/2021,2/26/2021,22621,82L-IMPORT PAYROLL-STROUD DAVID,D108,HJ,62.68,,374163.47
6150,2/26/2021,2/26/2021,22621,82L-IMPORT PAYROLL-VALCIN SABRINA JEMIMAH,D108,HJ,14.25,,374177.72
6150,2/26/2021,2/26/2021,22621,82L-IMPORT PAYROLL-VALCIN SABRINA JEMIMAH,D108,HJ,26.53,,374204.25
6150,2/26/2021,2/26/2021,22621,82L-IMPORT PAYROLL-VALCIN SABRINA JEMIMAH,D108,HJ,60.92,,374265.17
6150,2/26/2021,2/26/2021,22621,82L-IMPORT PAYROLL-VALDES ERNEST L,D108,HJ,15.19,,374280.36
6150,2/26/2021,2/26/2021,22621,82L-IMPORT PAYROLL-VALDES ERNEST L,D108,HJ,36.67,,374317.03
6150,2/26/2021,2/26/2021,22621,82L-IMPORT PAYROLL-VALDES ERNEST L,D108,HJ,64.95,,374381.98
6150,2/26/2021,2/26/2021,22621,82L-IMPORT PAYROLL-WILLIAMS MACK ANTHONY,D108,HJ,16.33,,374398.31
6150,2/26/2021,2/26/2021,22621,82L-IMPORT PAYROLL-WILLIAMS MACK ANTHONY,D108,HJ,30.41,,374428.72
6150,2/26/2021,2/26/2021,22621,82L-IMPORT PAYROLL-WILLIAMS MACK ANTHONY,D108,HJ,69.83,,374498.55
6150,2/26/2021,2/26/2021,22621,82L-IMPORT PAYROLL-WILLIAMS MIL'YONTA,D108,HJ,15.19,,374513.74
6150,2/26/2021,2/26/2021,22621,82L-IMPORT PAYROLL-WILLIAMS MIL'YONTA,D108,HJ,28.29,,374542.03
6150,2/26/2021,2/26/2021,22621,82L-IMPORT PAYROLL-WILLIAMS MIL'YONTA,D108,HJ,64.95,,374606.98
6150,2/26/2021,2/26/2021,22621,82L-IMPORT PAYROLL-ANTHONY BETTY S,D108,HJ,41.85,,374648.83
6150,2/26/2021,2/26/2021,22621,82L-IMPORT PAYROLL-ANTHONY BETTY S,D108,HJ,178.96,,374827.79
6150,2/26/2021,2/26/2021,22621,82L-IMPORT PAYROLL-APULI LINDSAY,D108,HJ,34.16,,374861.95
6150,2/26/2021,2/26/2021,22621,82L-IMPORT PAYROLL-APULI LINDSAY,D108,HJ,146.08,,375008.03
6150,2/26/2021,2/26/2021,22621,82L-IMPORT PAYROLL-AUSTIN PERCY,D108,HJ,36.34,,375044.37
6150,2/26/2021,2/26/2021,22621,82L-IMPORT PAYROLL-AUSTIN PERCY,D108,HJ,155.39,,375199.76
6150,2/26/2021,2/26/2021,22621,82L-IMPORT PAYROLL-BUHMANN JENNIFER,D108,HJ,32.9,,375232.66
6150,2/26/2021,2/26/2021,22621,82L-IMPORT PAYROLL-BUHMANN JENNIFER,D108,HJ,140.68,,375373.34
6150,2/26/2021,2/26/2021,22621,82L-IMPORT PAYROLL-CAIN CORY,D108,HJ,36.32,,375409.66
6150,2/26/2021,2/26/2021,22621,82L-IMPORT PAYROLL-CAIN CORY,D108,HJ,155.3,,375564.96
6150,2/26/2021,2/26/2021,22621,82L-IMPORT PAYROLL-CHAPMAN CLAUDY EARL,D108,HJ,33.03,,375597.99
6150,2/26/2021,2/26/2021,22621,82L-IMPORT PAYROLL-CHAPMAN CLAUDY EARL,D108,HJ,141.23,,375739.22
6150,2/26/2021,2/26/2021,22621,82L-IMPORT PAYROLL-DADA ARIKPO E,D108,HJ,32.04,,375771.26
6150,2/26/2021,2/26/2021,22621,82L-IMPORT PAYROLL-DADA ARIKPO E,D108,HJ,137,,375908.26
6150,2/26/2021,2/26/2021,22621,82L-IMPORT PAYROLL-GUTHRIE LESLIE,D108,HJ,33.42,,375941.68
6150,2/26/2021,2/26/2021,22621,82L-IMPORT PAYROLL-GUTHRIE LESLIE,D108,HJ,142.9,,376084.58
6150,2/26/2021,2/26/2021,22621,82L-IMPORT PAYROLL-HOLMES JOREL ALEXANDER,D108,HJ,31.22,,376115.8
6150,2/26/2021,2/26/2021,22621,82L-IMPORT PAYROLL-HOLMES JOREL ALEXANDER,D108,HJ,133.51,,376249.31
6150,2/26/2021,2/26/2021,22621,82L-IMPORT PAYROLL-JORDAN TIFFANY T,D108,HJ,45.87,,376295.18
6150,2/26/2021,2/26/2021,22621,82L-IMPORT PAYROLL-JORDAN TIFFANY T,D108,HJ,196.13,,376491.31
6150,2/26/2021,2/26/2021,22621,82L-IMPORT PAYROLL-LANIGAN LISA A,D108,HJ,45.1,,376536.41
6150,2/26/2021,2/26/2021,22621,82L-IMPORT PAYROLL-LANIGAN LISA A,D108,HJ,192.83,,376729.24
6150,2/26/2021,2/26/2021,22621,82L-IMPORT PAYROLL-MCELWEE MELISSA,D108,HJ,38.67,,376767.91
6150,2/26/2021,2/26/2021,22621,82L-IMPORT PAYROLL-MCELWEE MELISSA,D108,HJ,165.33,,376933.24
6150,2/26/2021,2/26/2021,22621,82L-IMPORT PAYROLL-MCNICHOLAS MARY,D108,HJ,33.23,,376966.47
6150,2/26/2021,2/26/2021,22621,82L-IMPORT PAYROLL-MCNICHOLAS MARY,D108,HJ,142.08,,377108.55
6150,2/26/2021,2/26/2021,22621,82L-IMPORT PAYROLL-NWAKANMA NANCY,D108,HJ,44.18,,377152.73
6150,2/26/2021,2/26/2021,22621,82L-IMPORT PAYROLL-NWAKANMA NANCY,D108,HJ,188.89,,377341.62
6150,2/26/2021,2/26/2021,22621,82L-IMPORT PAYROLL-ONICA ANTHONY J,D108,HJ,32.86,,377374.48
6150,2/26/2021,2/26/2021,22621,82L-IMPORT PAYROLL-ONICA ANTHONY J,D108,HJ,140.49,,377514.97
6150,2/26/2021,2/26/2021,22621,82L-IMPORT PAYROLL-PRAHIN NICOLE M,D108,HJ,52.91,,377567.88
6150,2/26/2021,2/26/2021,22621,82L-IMPORT PAYROLL-PRAHIN NICOLE M,D108,HJ,226.22,,377794.1
6150,2/26/2021,2/26/2021,22621,82L-IMPORT PAYROLL-RIVERS QUIONNA DIANE,D108,HJ,39.27,,377833.37
6150,2/26/2021,2/26/2021,22621,82L-IMPORT PAYROLL-RIVERS QUIONNA DIANE,D108,HJ,167.92,,378001.29
6150,2/26/2021,2/26/2021,22621,82L-IMPORT PAYROLL-SALIM YASSER,D108,HJ,33.1,,378034.39
6150,2/26/2021,2/26/2021,22621,82L-IMPORT PAYROLL-SALIM YASSER,D108,HJ,141.55,,378175.94
6150,2/26/2021,2/26/2021,22621,82L-IMPORT PAYROLL-SEJOUR MAHALIAH,D108,HJ,34.07,,378210.01
6150,2/26/2021,2/26/2021,22621,82L-IMPORT PAYROLL-SEJOUR MAHALIAH,D108,HJ,145.66,,378355.67
6150,2/26/2021,2/26/2021,22621,82L-IMPORT PAYROLL-SKALSKI CHRISTOPHER,D108,HJ,33.86,,378389.53
6150,2/26/2021,2/26/2021,22621,82L-IMPORT PAYROLL-SKALSKI CHRISTOPHER,D108,HJ,144.76,,378534.29
6150,2/26/2021,2/26/2021,22621,82L-IMPORT PAYROLL-TUMENJARGAL ENKHJIN,D108,HJ,32.92,,378567.21
6150,2/26/2021,2/26/2021,22621,82L-IMPORT PAYROLL-TUMENJARGAL ENKHJIN,D108,HJ,140.75,,378707.96
6150,2/26/2021,2/26/2021,22621,82L-IMPORT PAYROLL-VILLEGAS EVELYN,D108,HJ,33.4,,378741.36
6150,2/26/2021,2/26/2021,22621,82L-IMPORT PAYROLL-VILLEGAS EVELYN,D108,HJ,142.81,,378884.17
6150,2/26/2021,2/26/2021,22621,82L-IMPORT PAYROLL-WOLF ANNA A,D108,HJ,36.3,,378920.47
6150,2/26/2021,2/26/2021,22621,82L-IMPORT PAYROLL-WOLF ANNA A,D108,HJ,155.19,,379075.66
6150,2/26/2021,2/26/2021,22621,82L-IMPORT PAYROLL-ACEVEDO MONIVETT,D107,HJ,72.42,,379148.08
6150,2/26/2021,2/26/2021,22621,82L-IMPORT PAYROLL-ACEVEDO MONIVETT,D107,HJ,309.64,,379457.72
6150,2/26/2021,2/26/2021,22621,82L-IMPORT PAYROLL-AKLESTAD ISABEL,D111,HJ,24.01,,379481.73
6150,2/26/2021,2/26/2021,22621,82L-IMPORT PAYROLL-AKLESTAD ISABEL,D111,HJ,102.68,,379584.41
6150,2/26/2021,2/26/2021,22621,82L-IMPORT PAYROLL-BIBB TIFFANI,D104,HJ,49.71,,379634.12
6150,2/26/2021,2/26/2021,22621,82L-IMPORT PAYROLL-BIBB TIFFANI,D104,HJ,212.55,,379846.67
6150,2/26/2021,2/26/2021,22621,82L-IMPORT PAYROLL-BOWMAN HALLEY K,D101,HJ,49.84,,379896.51
6150,2/26/2021,2/26/2021,22621,82L-IMPORT PAYROLL-BOWMAN HALLEY K,D101,HJ,213.13,,380109.64
6150,2/26/2021,2/26/2021,22621,82L-IMPORT PAYROLL-CALVO FERNANDA,D104,HJ,12.44,,380122.08
6150,2/26/2021,2/26/2021,22621,82L-IMPORT PAYROLL-CALVO FERNANDA,D104,HJ,53.19,,380175.27
6150,2/26/2021,2/26/2021,22621,82L-IMPORT PAYROLL-COOK CATHRYN ANNA,D105,HJ,49.87,,380225.14
6150,2/26/2021,2/26/2021,22621,82L-IMPORT PAYROLL-COOK CATHRYN ANNA,D105,HJ,151.84,,380376.98
6150,2/26/2021,2/26/2021,22621,82L-IMPORT PAYROLL-COOK CATHRYN ANNA,D105,HJ,213.25,,380590.23
6150,2/26/2021,2/26/2021,22621,82L-IMPORT PAYROLL-COOPER ASHLEE R,D101,HJ,33.51,,380623.74
6150,2/26/2021,2/26/2021,22621,82L-IMPORT PAYROLL-COOPER ASHLEE R,D101,HJ,143.3,,380767.04
6150,2/26/2021,2/26/2021,22621,82L-IMPORT PAYROLL-CORTEZ MIRANDA A,D111,HJ,25.16,,380792.2
6150,2/26/2021,2/26/2021,22621,82L-IMPORT PAYROLL-CORTEZ MIRANDA A,D111,HJ,37.17,,380829.37
6150,2/26/2021,2/26/2021,22621,82L-IMPORT PAYROLL-CORTEZ MIRANDA A,D111,HJ,158.92,,380988.29
6150,2/26/2021,2/26/2021,22621,82L-IMPORT PAYROLL-DAUGHERTY DEVIN W,D101,HJ,22.66,,381010.95
6150,2/26/2021,2/26/2021,22621,82L-IMPORT PAYROLL-DAUGHERTY DEVIN W,D101,HJ,42.19,,381053.14
6150,2/26/2021,2/26/2021,22621,82L-IMPORT PAYROLL-DAUGHERTY DEVIN W,D101,HJ,96.88,,381150.02
6150,2/26/2021,2/26/2021,22621,82L-IMPORT PAYROLL-DETONE KYRA MAYA,D102,HJ,39,,381189.02
6150,2/26/2021,2/26/2021,22621,82L-IMPORT PAYROLL-DETONE KYRA MAYA,D102,HJ,123.26,,381312.28
6150,2/26/2021,2/26/2021,22621,82L-IMPORT PAYROLL-DETONE KYRA MAYA,D102,HJ,166.75,,381479.03
6150,2/26/2021,2/26/2021,22621,82L-IMPORT PAYROLL-DUPUIS CHRISTOPHER M,D107,HJ,39.05,,381518.08
6150,2/26/2021,2/26/2021,22621,82L-IMPORT PAYROLL-DUPUIS CHRISTOPHER M,D107,HJ,49.69,,381567.77
6150,2/26/2021,2/26/2021,22621,82L-IMPORT PAYROLL-DUPUIS CHRISTOPHER M,D107,HJ,166.96,,381734.73
6150,2/26/2021,2/26/2021,22621,82L-IMPORT PAYROLL-DUPUIS CHRISTOPHER M,D107,HJ,212.49,,381947.22
6150,2/26/2021,2/26/2021,22621,82L-IMPORT PAYROLL-DZIEDZIC JULIE K,D101,HJ,17.71,,381964.93
6150,2/26/2021,2/26/2021,22621,82L-IMPORT PAYROLL-DZIEDZIC JULIE K,D101,HJ,75.71,,382040.64
6150,2/26/2021,2/26/2021,22621,82L-IMPORT PAYROLL-FEENEY CLAIRE,D104,HJ,26.82,,382067.46
6150,2/26/2021,2/26/2021,22621,82L-IMPORT PAYROLL-FEENEY CLAIRE,D104,HJ,114.66,,382182.12
6150,2/26/2021,2/26/2021,22621,82L-IMPORT PAYROLL-FISCHABER THOMAS,D109,HJ,77.9,,382260.02
6150,2/26/2021,2/26/2021,22621,82L-IMPORT PAYROLL-FISCHABER THOMAS,D109,HJ,333.1,,382593.12
6150,2/26/2021,2/26/2021,22621,82L-IMPORT PAYROLL-FLORY MEGAN,D109,HJ,21.75,,382614.87
6150,2/26/2021,2/26/2021,22621,82L-IMPORT PAYROLL-FLORY MEGAN,D109,HJ,25.5,,382640.37
6150,2/26/2021,2/26/2021,22621,82L-IMPORT PAYROLL-FLORY MEGAN,D109,HJ,93,,382733.37
6150,2/26/2021,2/26/2021,22621,82L-IMPORT PAYROLL-GORNSTEIN STEVEN,D101,HJ,39.27,,382772.64
6150,2/26/2021,2/26/2021,22621,82L-IMPORT PAYROLL-GORNSTEIN STEVEN,D101,HJ,114.45,,382887.09
6150,2/26/2021,2/26/2021,22621,82L-IMPORT PAYROLL-GORNSTEIN STEVEN,D101,HJ,167.92,,383055.01
6150,2/26/2021,2/26/2021,22621,82L-IMPORT PAYROLL-GUADARRAMA-ALVAREZ URIEL A,D105,HJ,21.77,,383076.78
6150,2/26/2021,2/26/2021,22621,82L-IMPORT PAYROLL-GUADARRAMA-ALVAREZ URIEL A,D105,HJ,39.93,,383116.71
6150,2/26/2021,2/26/2021,22621,82L-IMPORT PAYROLL-GUADARRAMA-ALVAREZ URIEL A,D105,HJ,170.75,,383287.46
6150,2/26/2021,2/26/2021,22621,82L-IMPORT PAYROLL-GUTIERREZ ANTONIO J,D107,HJ,33.72,,383321.18
6150,2/26/2021,2/26/2021,22621,82L-IMPORT PAYROLL-GUTIERREZ ANTONIO J,D107,HJ,42.93,,383364.11
6150,2/26/2021,2/26/2021,22621,82L-IMPORT PAYROLL-GUTIERREZ ANTONIO J,D107,HJ,144.21,,383508.32
6150,2/26/2021,2/26/2021,22621,82L-IMPORT PAYROLL-GUTIERREZ ANTONIO J,D107,HJ,183.55,,383691.87
6150,2/26/2021,2/26/2021,22621,82L-IMPORT PAYROLL-HENRY GILLIAN,D102,HJ,29.17,,383721.04
6150,2/26/2021,2/26/2021,22621,82L-IMPORT PAYROLL-HENRY GILLIAN,D102,HJ,33.75,,383754.79
6150,2/26/2021,2/26/2021,22621,82L-IMPORT PAYROLL-HENRY GILLIAN,D102,HJ,124.74,,383879.53
6150,2/26/2021,2/26/2021,22621,82L-IMPORT PAYROLL-HERMAN ADAM,D102,HJ,28.2,,383907.73
6150,2/26/2021,2/26/2021,22621,82L-IMPORT PAYROLL-HERMAN ADAM,D102,HJ,120.56,,384028.29
6150,2/26/2021,2/26/2021,22621,82L-IMPORT PAYROLL-HERNANDEZ ANNA,D101,HJ,37.18,,384065.47
6150,2/26/2021,2/26/2021,22621,82L-IMPORT PAYROLL-HERNANDEZ ANNA,D101,HJ,50.37,,384115.84
6150,2/26/2021,2/26/2021,22621,82L-IMPORT PAYROLL-HERNANDEZ ANNA,D101,HJ,159,,384274.84
6150,2/26/2021,2/26/2021,22621,82L-IMPORT PAYROLL-HESTER TYLER CONRAD,D105,HJ,27.79,,384302.63
6150,2/26/2021,2/26/2021,22621,82L-IMPORT PAYROLL-HESTER TYLER CONRAD,D105,HJ,118.83,,384421.46
6150,2/26/2021,2/26/2021,22621,82L-IMPORT PAYROLL-HOLT ADAM,D109,HJ,26.35,,384447.81
6150,2/26/2021,2/26/2021,22621,82L-IMPORT PAYROLL-HOLT ADAM,D109,HJ,58.24,,384506.05
6150,2/26/2021,2/26/2021,22621,82L-IMPORT PAYROLL-HOLT ADAM,D109,HJ,249.03,,384755.08
6150,2/26/2021,2/26/2021,22621,82L-IMPORT PAYROLL-IWASAKI MIKA,D101,HJ,29.24,,384784.32
6150,2/26/2021,2/26/2021,22621,82L-IMPORT PAYROLL-IWASAKI MIKA,D101,HJ,125.03,,384909.35
6150,2/26/2021,2/26/2021,22621,82L-IMPORT PAYROLL-KELLY SEAN,D109,HJ,78.54,,384987.89
6150,2/26/2021,2/26/2021,22621,82L-IMPORT PAYROLL-KELLY SEAN,D109,HJ,335.83,,385323.72
6150,2/26/2021,2/26/2021,22621,82L-IMPORT PAYROLL-KRUGER MARK,D109,HJ,72.5,,385396.22
6150,2/26/2021,2/26/2021,22621,82L-IMPORT PAYROLL-KRUGER MARK,D109,HJ,310,,385706.22
6150,2/26/2021,2/26/2021,22621,82L-IMPORT PAYROLL-LIPORACE HERNAN LUIS,D103,HJ,4.34,,385710.56
6150,2/26/2021,2/26/2021,22621,82L-IMPORT PAYROLL-LIPORACE HERNAN LUIS,D103,HJ,33.06,,385743.62
6150,2/26/2021,2/26/2021,22621,82L-IMPORT PAYROLL-LIPORACE HERNAN LUIS,D103,HJ,141.34,,385884.96
6150,2/26/2021,2/26/2021,22621,82L-IMPORT PAYROLL-MARKS KRISTA,D109,HJ,76.2,,385961.16
6150,2/26/2021,2/26/2021,22621,82L-IMPORT PAYROLL-MARKS KRISTA,D109,HJ,325.8,,386286.96
6150,2/26/2021,2/26/2021,22621,82L-IMPORT PAYROLL-MELVIN DARNELL KEVIN,D109,HJ,55.91,,386342.87
6150,2/26/2021,2/26/2021,22621,82L-IMPORT PAYROLL-MELVIN DARNELL KEVIN,D109,HJ,239.08,,386581.95
6150,2/26/2021,2/26/2021,22621,82L-IMPORT PAYROLL-MESSING JENNIFER,D104,HJ,34.12,,386616.07
6150,2/26/2021,2/26/2021,22621,82L-IMPORT PAYROLL-MESSING JENNIFER,D104,HJ,145.9,,386761.97
6150,2/26/2021,2/26/2021,22621,82L-IMPORT PAYROLL-MILNE ROGER,D109,HJ,76.2,,386838.17
6150,2/26/2021,2/26/2021,22621,82L-IMPORT PAYROLL-MILNE ROGER,D109,HJ,325.8,,387163.97
6150,2/26/2021,2/26/2021,22621,82L-IMPORT PAYROLL-MOSTAFAVI YASAMAN,D109,HJ,7.66,,387171.63
6150,2/26/2021,2/26/2021,22621,82L-IMPORT PAYROLL-MOSTAFAVI YASAMAN,D109,HJ,12.55,,387184.18
6150,2/26/2021,2/26/2021,22621,82L-IMPORT PAYROLL-MOSTAFAVI YASAMAN,D109,HJ,32.74,,387216.92
6150,2/26/2021,2/26/2021,22621,82L-IMPORT PAYROLL-O'DONNELL STEPHEN,D104,HJ,37.03,,387253.95
6150,2/26/2021,2/26/2021,22621,82L-IMPORT PAYROLL-O'DONNELL STEPHEN,D104,HJ,42.11,,387296.06
6150,2/26/2021,2/26/2021,22621,82L-IMPORT PAYROLL-O'DONNELL STEPHEN,D104,HJ,158.35,,387454.41
6150,2/26/2021,2/26/2021,22621,82L-IMPORT PAYROLL-PARETS MALLORY GRACE,D101,HJ,13.5,,387467.91
6150,2/26/2021,2/26/2021,22621,82L-IMPORT PAYROLL-PARETS MALLORY GRACE,D101,HJ,17.57,,387485.48
6150,2/26/2021,2/26/2021,22621,82L-IMPORT PAYROLL-PARETS MALLORY GRACE,D101,HJ,41.08,,387526.56
6150,2/26/2021,2/26/2021,22621,82L-IMPORT PAYROLL-PARETS MALLORY GRACE,D101,HJ,175.67,,387702.23
6150,2/26/2021,2/26/2021,22621,82L-IMPORT PAYROLL-PARHAM-GANTT DENISE M,D112,HJ,37.96,,387740.19
6150,2/26/2021,2/26/2021,22621,82L-IMPORT PAYROLL-PARHAM-GANTT DENISE M,D112,HJ,162.32,,387902.51
6150,2/26/2021,2/26/2021,22621,82L-IMPORT PAYROLL-PEINADO ELIZABETH R,D111,HJ,53.01,,387955.52
6150,2/26/2021,2/26/2021,22621,82L-IMPORT PAYROLL-PEINADO ELIZABETH R,D111,HJ,226.68,,388182.2
6150,2/26/2021,2/26/2021,22621,82L-IMPORT PAYROLL-PERNIA JEFFREY,D109,HJ,56.19,,388238.39
6150,2/26/2021,2/26/2021,22621,82L-IMPORT PAYROLL-PERNIA JEFFREY,D109,HJ,240.25,,388478.64
6150,2/26/2021,2/26/2021,22621,82L-IMPORT PAYROLL-PIRES MANUEL,D103,HJ,31.08,,388509.72
6150,2/26/2021,2/26/2021,22621,82L-IMPORT PAYROLL-PIRES MANUEL,D103,HJ,93.32,,388603.04
6150,2/26/2021,2/26/2021,22621,82L-IMPORT PAYROLL-PIRES MANUEL,D103,HJ,132.89,,388735.93
6150,2/26/2021,2/26/2021,22621,82L-IMPORT PAYROLL-POLANCO ODALIS,D103,HJ,43.23,,388779.16
6150,2/26/2021,2/26/2021,22621,82L-IMPORT PAYROLL-POLANCO ODALIS,D103,HJ,184.83,,388963.99
6150,2/26/2021,2/26/2021,22621,82L-IMPORT PAYROLL-QUINTAS JASHIVE,D105,HJ,25.57,,388989.56
6150,2/26/2021,2/26/2021,22621,82L-IMPORT PAYROLL-QUINTAS JASHIVE,D105,HJ,109.31,,389098.87
6150,2/26/2021,2/26/2021,22621,82L-IMPORT PAYROLL-RANDOLPH ALEXANDER,D111,HJ,13.49,,389112.36
6150,2/26/2021,2/26/2021,22621,82L-IMPORT PAYROLL-RANDOLPH ALEXANDER,D111,HJ,29.45,,389141.81
6150,2/26/2021,2/26/2021,22621,82L-IMPORT PAYROLL-RANDOLPH ALEXANDER,D111,HJ,58.73,,389200.54
6150,2/26/2021,2/26/2021,22621,82L-IMPORT PAYROLL-RANDOLPH ALEXANDER,D111,HJ,125.93,,389326.47
6150,2/26/2021,2/26/2021,22621,82L-IMPORT PAYROLL-RUBI PERLA,D101,HJ,15.92,,389342.39
6150,2/26/2021,2/26/2021,22621,82L-IMPORT PAYROLL-RUBI PERLA,D101,HJ,68.09,,389410.48
6150,2/26/2021,2/26/2021,22621,82L-IMPORT PAYROLL-SAFRAN ALAN P,D107,HJ,11.38,,389421.86
6150,2/26/2021,2/26/2021,22621,82L-IMPORT PAYROLL-SAFRAN ALAN P,D107,HJ,48.69,,389470.55
6150,2/26/2021,2/26/2021,22621,82L-IMPORT PAYROLL-SAFRAN ALAN P,D107,HJ,92.14,,389562.69
6150,2/26/2021,2/26/2021,22621,82L-IMPORT PAYROLL-SAFRAN ALAN P,D107,HJ,393.95,,389956.64
6150,2/26/2021,2/26/2021,22621,82L-IMPORT PAYROLL-SHENKMAN OLIVIA,D101,HJ,29,,389985.64
6150,2/26/2021,2/26/2021,22621,82L-IMPORT PAYROLL-SHENKMAN OLIVIA,D101,HJ,124,,390109.64
6150,2/26/2021,2/26/2021,22621,82L-IMPORT PAYROLL-VYAS SUNAINA,D104,HJ,28.82,,390138.46
6150,2/26/2021,2/26/2021,22621,82L-IMPORT PAYROLL-VYAS SUNAINA,D104,HJ,69.56,,390208.02
6150,2/26/2021,2/26/2021,22621,82L-IMPORT PAYROLL-VYAS SUNAINA,D104,HJ,123.23,,390331.25
6150,2/26/2021,2/26/2021,22621,82L-IMPORT PAYROLL-WALLACE AMENA,D104,HJ,28.93,,390360.18
6150,2/26/2021,2/26/2021,22621,82L-IMPORT PAYROLL-WALLACE AMENA,D104,HJ,123.72,,390483.9
6150,2/26/2021,2/26/2021,22621,82L-IMPORT PAYROLL-WARD JEFFREY,D109,HJ,78.54,,390562.44
6150,2/26/2021,2/26/2021,22621,82L-IMPORT PAYROLL-WARD JEFFREY,D109,HJ,335.83,,390898.27
6150,2/26/2021,2/26/2021,22621,82L-IMPORT PAYROLL-WARD JENNIFER,D109,HJ,15.76,,390914.03
6150,2/26/2021,2/26/2021,22621,82L-IMPORT PAYROLL-WARD JENNIFER,D109,HJ,18.47,,390932.5
6150,2/26/2021,2/26/2021,22621,82L-IMPORT PAYROLL-WARD JENNIFER,D109,HJ,67.38,,390999.88
6150,2/26/2021,2/26/2021,22621,82L-IMPORT PAYROLL-WEINSTOCK EMILY,D101,HJ,13.5,,391013.38
6150,2/26/2021,2/26/2021,22621,82L-IMPORT PAYROLL-WEINSTOCK EMILY,D101,HJ,17.57,,391030.95
6150,2/26/2021,2/26/2021,22621,82L-IMPORT PAYROLL-WEINSTOCK EMILY,D101,HJ,38.11,,391069.06
6150,2/26/2021,2/26/2021,22621,82L-IMPORT PAYROLL-WEINSTOCK EMILY,D101,HJ,162.94,,391232
6150,2/26/2021,2/26/2021,22621,82L-IMPORT PAYROLL-WINANS JENNIFER,D111,HJ,37.06,,391269.06
6150,2/26/2021,2/26/2021,22621,82L-IMPORT PAYROLL-WINANS JENNIFER,D111,HJ,52.19,,391321.25
6150,2/26/2021,2/26/2021,22621,82L-IMPORT PAYROLL-WINANS JENNIFER,D111,HJ,158.45,,391479.7
6150,2/26/2021,2/26/2021,22621,82L-IMPORT PAYROLL-ZARATE JOSEPH M,D105,HJ,31.18,,391510.88
6150,2/26/2021,2/26/2021,22621,82L-IMPORT PAYROLL-ZARATE JOSEPH M,D105,HJ,133.3,,391644.18
6150,2/26/2021,2/26/2021,22621,82L-IMPORT PAYROLL-AGUANNO JOSEPH,D108,HJ,16.23,,391660.41
6150,2/26/2021,2/26/2021,22621,82L-IMPORT PAYROLL-AGUANNO JOSEPH,D108,HJ,69.38,,391729.79
6150,2/26/2021,2/26/2021,22621,82L-IMPORT PAYROLL-AKESODE FEHINTOLA,D108,HJ,16.23,,391746.02
6150,2/26/2021,2/26/2021,22621,82L-IMPORT PAYROLL-AKESODE FEHINTOLA,D108,HJ,69.38,,391815.4
6150,2/26/2021,2/26/2021,22621,82L-IMPORT PAYROLL-BARTOLD DEANNA MARIE,D108,HJ,41.91,,391857.31
6150,2/26/2021,2/26/2021,22621,82L-IMPORT PAYROLL-BARTOLD DEANNA MARIE,D108,HJ,179.22,,392036.53
6150,2/26/2021,2/26/2021,22621,82L-IMPORT PAYROLL-BELLOT GENESIS,D108,HJ,32.36,,392068.89
6150,2/26/2021,2/26/2021,22621,82L-IMPORT PAYROLL-BELLOT GENESIS,D108,HJ,138.38,,392207.27
6150,2/26/2021,2/26/2021,22621,82L-IMPORT PAYROLL-BENNETT JAMES H,D108,HJ,16.23,,392223.5
6150,2/26/2021,2/26/2021,22621,82L-IMPORT PAYROLL-BENNETT JAMES H,D108,HJ,69.38,,392292.88
6150,2/26/2021,2/26/2021,22621,82L-IMPORT PAYROLL-BOWMAN ABIGAIL,D108,HJ,16.23,,392309.11
6150,2/26/2021,2/26/2021,22621,82L-IMPORT PAYROLL-BOWMAN ABIGAIL,D108,HJ,69.38,,392378.49
6150,2/26/2021,2/26/2021,22621,82L-IMPORT PAYROLL-BURRELL RUSSELL,D108,HJ,15.08,,392393.57
6150,2/26/2021,2/26/2021,22621,82L-IMPORT PAYROLL-BURRELL RUSSELL,D108,HJ,28.09,,392421.66
6150,2/26/2021,2/26/2021,22621,82L-IMPORT PAYROLL-BURRELL RUSSELL,D108,HJ,64.5,,392486.16
6150,2/26/2021,2/26/2021,22621,82L-IMPORT PAYROLL-CHUI KENT,D108,HJ,16.23,,392502.39
6150,2/26/2021,2/26/2021,22621,82L-IMPORT PAYROLL-CHUI KENT,D108,HJ,69.38,,392571.77
6150,2/26/2021,2/26/2021,22621,82L-IMPORT PAYROLL-CIRKER MIA,D108,HJ,32.63,,392604.4
6150,2/26/2021,2/26/2021,22621,82L-IMPORT PAYROLL-CIRKER MIA,D108,HJ,139.5,,392743.9
6150,2/26/2021,2/26/2021,22621,82L-IMPORT PAYROLL-DEWS CAMERYN,D108,HJ,33.23,,392777.13
6150,2/26/2021,2/26/2021,22621,82L-IMPORT PAYROLL-DEWS CAMERYN,D108,HJ,142.08,,392919.21
6150,2/26/2021,2/26/2021,22621,82L-IMPORT PAYROLL-DIETZ MARY,D108,HJ,16.23,,392935.44
6150,2/26/2021,2/26/2021,22621,82L-IMPORT PAYROLL-DIETZ MARY,D108,HJ,35.81,,392971.25
6150,2/26/2021,2/26/2021,22621,82L-IMPORT PAYROLL-DIETZ MARY,D108,HJ,69.38,,393040.63
6150,2/26/2021,2/26/2021,22621,82L-IMPORT PAYROLL-DOMINIQUE PRINCESSA,D108,HJ,16.23,,393056.86
6150,2/26/2021,2/26/2021,22621,82L-IMPORT PAYROLL-DOMINIQUE PRINCESSA,D108,HJ,69.38,,393126.24
6150,2/26/2021,2/26/2021,22621,82L-IMPORT PAYROLL-DONNELLY HOME,D108,HJ,6.94,,393133.18
6150,2/26/2021,2/26/2021,22621,82L-IMPORT PAYROLL-DONNELLY HOME,D108,HJ,16.23,,393149.41
6150,2/26/2021,2/26/2021,22621,82L-IMPORT PAYROLL-DONNELLY HOME,D108,HJ,30.21,,393179.62
6150,2/26/2021,2/26/2021,22621,82L-IMPORT PAYROLL-DONNELLY HOME,D108,HJ,69.38,,393249
6150,2/26/2021,2/26/2021,22621,82L-IMPORT PAYROLL-FEIGHERY JOHN,D108,HJ,30.56,,393279.56
6150,2/26/2021,2/26/2021,22621,82L-IMPORT PAYROLL-FEIGHERY JOHN,D108,HJ,130.69,,393410.25
6150,2/26/2021,2/26/2021,22621,82L-IMPORT PAYROLL-FORTH KYLE,D108,HJ,16.23,,393426.48
6150,2/26/2021,2/26/2021,22621,82L-IMPORT PAYROLL-FORTH KYLE,D108,HJ,69.38,,393495.86
6150,2/26/2021,2/26/2021,22621,82L-IMPORT PAYROLL-GARCIA MARILYN,D108,HJ,33.23,,393529.09
6150,2/26/2021,2/26/2021,22621,82L-IMPORT PAYROLL-GARCIA MARILYN,D108,HJ,142.08,,393671.17
6150,2/26/2021,2/26/2021,22621,82L-IMPORT PAYROLL-GREENE BROOKE,D108,HJ,15.28,,393686.45
6150,2/26/2021,2/26/2021,22621,82L-IMPORT PAYROLL-GREENE BROOKE,D108,HJ,65.35,,393751.8
6150,2/26/2021,2/26/2021,22621,82L-IMPORT PAYROLL-GRIFFIN ANDREW,D108,HJ,30.44,,393782.24
6150,2/26/2021,2/26/2021,22621,82L-IMPORT PAYROLL-GRIFFIN ANDREW,D108,HJ,74.25,,393856.49
6150,2/26/2021,2/26/2021,22621,82L-IMPORT PAYROLL-GRIFFIN ANDREW,D108,HJ,130.16,,393986.65
6150,2/26/2021,2/26/2021,22621,82L-IMPORT PAYROLL-GROSS EMILY,D108,HJ,14,,394000.65
6150,2/26/2021,2/26/2021,22621,82L-IMPORT PAYROLL-GROSS EMILY,D108,HJ,59.86,,394060.51
6150,2/26/2021,2/26/2021,22621,82L-IMPORT PAYROLL-GUERRERO LUIS,D108,HJ,16.23,,394076.74
6150,2/26/2021,2/26/2021,22621,82L-IMPORT PAYROLL-GUERRERO LUIS,D108,HJ,69.38,,394146.12
6150,2/26/2021,2/26/2021,22621,82L-IMPORT PAYROLL-HALLINAN GABRIEL,D108,HJ,34.79,,394180.91
6150,2/26/2021,2/26/2021,22621,82L-IMPORT PAYROLL-HALLINAN GABRIEL,D108,HJ,148.76,,394329.67
6150,2/26/2021,2/26/2021,22621,82L-IMPORT PAYROLL-HAMERSLY WILLIAM,D108,HJ,34.16,,394363.83
6150,2/26/2021,2/26/2021,22621,82L-IMPORT PAYROLL-HAMERSLY WILLIAM,D108,HJ,146.08,,394509.91
6150,2/26/2021,2/26/2021,22621,82L-IMPORT PAYROLL-HOSSAIN MYESHA,D108,HJ,35.1,,394545.01
6150,2/26/2021,2/26/2021,22621,82L-IMPORT PAYROLL-HOSSAIN MYESHA,D108,HJ,150.1,,394695.11
6150,2/26/2021,2/26/2021,22621,82L-IMPORT PAYROLL-JACKSON TASNIM F,D108,HJ,31,,394726.11
6150,2/26/2021,2/26/2021,22621,82L-IMPORT PAYROLL-JACKSON TASNIM F,D108,HJ,132.56,,394858.67
6150,2/26/2021,2/26/2021,22621,82L-IMPORT PAYROLL-LEARY AUBREY,D108,HJ,16.2,,394874.87
6150,2/26/2021,2/26/2021,22621,82L-IMPORT PAYROLL-LEARY AUBREY,D108,HJ,69.27,,394944.14
6150,2/26/2021,2/26/2021,22621,82L-IMPORT PAYROLL-LI BELLA,D108,HJ,33.96,,394978.1
6150,2/26/2021,2/26/2021,22621,82L-IMPORT PAYROLL-LI BELLA,D108,HJ,145.23,,395123.33
6150,2/26/2021,2/26/2021,22621,82L-IMPORT PAYROLL-LOUIE JORDAN,D108,HJ,16.23,,395139.56
6150,2/26/2021,2/26/2021,22621,82L-IMPORT PAYROLL-LOUIE JORDAN,D108,HJ,69.38,,395208.94
6150,2/26/2021,2/26/2021,22621,82L-IMPORT PAYROLL-MELCHOR OSBEIDY,D108,HJ,16.23,,395225.17
6150,2/26/2021,2/26/2021,22621,82L-IMPORT PAYROLL-MELCHOR OSBEIDY,D108,HJ,69.38,,395294.55
6150,2/26/2021,2/26/2021,22621,82L-IMPORT PAYROLL-MORRIS ZAKIYA,D108,HJ,16.23,,395310.78
6150,2/26/2021,2/26/2021,22621,82L-IMPORT PAYROLL-MORRIS ZAKIYA,D108,HJ,69.38,,395380.16
6150,2/26/2021,2/26/2021,22621,82L-IMPORT PAYROLL-MORSELETTO RAFAEL,D108,HJ,1.64,,395381.8
6150,2/26/2021,2/26/2021,22621,82L-IMPORT PAYROLL-MORSELETTO RAFAEL,D108,HJ,16.23,,395398.03
6150,2/26/2021,2/26/2021,22621,82L-IMPORT PAYROLL-MORSELETTO RAFAEL,D108,HJ,21.49,,395419.52
6150,2/26/2021,2/26/2021,22621,82L-IMPORT PAYROLL-MORSELETTO RAFAEL,D108,HJ,69.38,,395488.9
6150,2/26/2021,2/26/2021,22621,82L-IMPORT PAYROLL-OBI TOBECHUKWU,D108,HJ,16.23,,395505.13
6150,2/26/2021,2/26/2021,22621,82L-IMPORT PAYROLL-OBI TOBECHUKWU,D108,HJ,69.38,,395574.51
6150,2/26/2021,2/26/2021,22621,82L-IMPORT PAYROLL-OPUH NDIDI,D108,HJ,34.74,,395609.25
6150,2/26/2021,2/26/2021,22621,82L-IMPORT PAYROLL-OPUH NDIDI,D108,HJ,148.53,,395757.78
6150,2/26/2021,2/26/2021,22621,82L-IMPORT PAYROLL-PAULINO THAIRI,D108,HJ,16.23,,395774.01
6150,2/26/2021,2/26/2021,22621,82L-IMPORT PAYROLL-PAULINO THAIRI,D108,HJ,69.38,,395843.39
6150,2/26/2021,2/26/2021,22621,82L-IMPORT PAYROLL-ROSENBAUM MURRAY,D108,HJ,16.23,,395859.62
6150,2/26/2021,2/26/2021,22621,82L-IMPORT PAYROLL-ROSENBAUM MURRAY,D108,HJ,69.38,,395929
6150,2/26/2021,2/26/2021,22621,82L-IMPORT PAYROLL-SCHWETTMANN CLAIRE,D108,HJ,15.28,,395944.28
6150,2/26/2021,2/26/2021,22621,82L-IMPORT PAYROLL-SCHWETTMANN CLAIRE,D108,HJ,65.35,,396009.63
6150,2/26/2021,2/26/2021,22621,82L-IMPORT PAYROLL-SOBELMAN JUSTIN,D108,HJ,15.08,,396024.71
6150,2/26/2021,2/26/2021,22621,82L-IMPORT PAYROLL-SOBELMAN JUSTIN,D108,HJ,64.5,,396089.21
6150,2/26/2021,2/26/2021,22621,82L-IMPORT PAYROLL-TERRENCE-SMITH ZIHIR,D108,HJ,14.32,,396103.53
6150,2/26/2021,2/26/2021,22621,82L-IMPORT PAYROLL-TERRENCE-SMITH ZIHIR,D108,HJ,61.22,,396164.75
6150,2/26/2021,2/26/2021,22621,82L-IMPORT PAYROLL-TILLERY ASIA,D108,HJ,54.34,,396219.09
6150,2/26/2021,2/26/2021,22621,82L-IMPORT PAYROLL-TILLERY ASIA,D108,HJ,232.34,,396451.43
6150,2/26/2021,2/26/2021,22621,82L-IMPORT PAYROLL-WILLIAMS-MASSEY BRIANNA,D108,HJ,16.05,,396467.48
6150,2/26/2021,2/26/2021,22621,82L-IMPORT PAYROLL-WILLIAMS-MASSEY BRIANNA,D108,HJ,36.93,,396504.41
6150,2/26/2021,2/26/2021,22621,82L-IMPORT PAYROLL-WILLIAMS-MASSEY BRIANNA,D108,HJ,68.64,,396573.05
6150,2/26/2021,2/26/2021,22621,82L-IMPORT PAYROLL-XIAO CHENGYAO,D108,HJ,16.23,,396589.28
6150,2/26/2021,2/26/2021,22621,82L-IMPORT PAYROLL-XIAO CHENGYAO,D108,HJ,69.38,,396658.66
6150,2/26/2021,2/26/2021,22621,82L-IMPORT PAYROLL-ZIAUDDIN ABUTAHER,D108,HJ,16.23,,396674.89
6150,2/26/2021,2/26/2021,22621,82L-IMPORT PAYROLL-ZIAUDDIN ABUTAHER,D108,HJ,69.38,,396744.27
6150,2/26/2021,2/26/2021,22621,82L-IMPORT PAYROLL-BALASUBRAMANIAN SHARANYA,D108,HJ,16.53,,396760.8
6150,2/26/2021,2/26/2021,22621,82L-IMPORT PAYROLL-BALASUBRAMANIAN SHARANYA,D108,HJ,27,,396787.8
6150,2/26/2021,2/26/2021,22621,82L-IMPORT PAYROLL-BALASUBRAMANIAN SHARANYA,D108,HJ,38.67,,396826.47
6150,2/26/2021,2/26/2021,22621,82L-IMPORT PAYROLL-BALASUBRAMANIAN SHARANYA,D108,HJ,165.33,,396991.8
6150,2/26/2021,2/26/2021,22621,82L-IMPORT PAYROLL-COVENEY ALLISON,D108,HJ,38.07,,397029.87
6150,2/26/2021,2/26/2021,22621,82L-IMPORT PAYROLL-COVENEY ALLISON,D108,HJ,162.79,,397192.66
6150,2/26/2021,2/26/2021,22621,82L-IMPORT PAYROLL-JACKSON CLAICE M,D108,HJ,19.38,,397212.04
6150,2/26/2021,2/26/2021,22621,82L-IMPORT PAYROLL-JACKSON CLAICE M,D108,HJ,42.91,,397254.95
6150,2/26/2021,2/26/2021,22621,82L-IMPORT PAYROLL-JACKSON CLAICE M,D108,HJ,183.48,,397438.43
6150,2/26/2021,2/26/2021,22621,82L-IMPORT PAYROLL-JANG DANIEL,D108,HJ,17.94,,397456.37
6150,2/26/2021,2/26/2021,22621,82L-IMPORT PAYROLL-JANG DANIEL,D108,HJ,37.75,,397494.12
6150,2/26/2021,2/26/2021,22621,82L-IMPORT PAYROLL-JANG DANIEL,D108,HJ,161.4,,397655.52
6150,2/26/2021,2/26/2021,22621,82L-IMPORT PAYROLL-LENEGHAN MARYELLEN,D108,HJ,30.34,,397685.86
6150,2/26/2021,2/26/2021,22621,82L-IMPORT PAYROLL-LENEGHAN MARYELLEN,D108,HJ,38.62,,397724.48
6150,2/26/2021,2/26/2021,22621,82L-IMPORT PAYROLL-LENEGHAN MARYELLEN,D108,HJ,129.74,,397854.22
6150,2/26/2021,2/26/2021,22621,82L-IMPORT PAYROLL-LENEGHAN MARYELLEN,D108,HJ,165.14,,398019.36
6150,3/15/2021,3/15/2021,31521,82L-IMPORT PAYROLL,D108,HJ,7.47,,398026.83
6150,3/15/2021,3/15/2021,31521,82L-IMPORT PAYROLL,D108,HJ,8.41,,398035.24
6150,3/15/2021,3/15/2021,31521,82L-IMPORT PAYROLL,D108,HJ,8.41,,398043.65
6150,3/15/2021,3/15/2021,31521,82L-IMPORT PAYROLL,D108,HJ,8.41,,398052.06
6150,3/15/2021,3/15/2021,31521,82L-IMPORT PAYROLL,D108,HJ,10.69,,398062.75
6150,3/15/2021,3/15/2021,31521,82L-IMPORT PAYROLL,D108,HJ,13.79,,398076.54
6150,3/15/2021,3/15/2021,31521,82L-IMPORT PAYROLL,D108,HJ,13.91,,398090.45
6150,3/15/2021,3/15/2021,31521,82L-IMPORT PAYROLL,D108,HJ,14.01,,398104.46
6150,3/15/2021,3/15/2021,31521,82L-IMPORT PAYROLL,D108,HJ,14.01,,398118.47
6150,3/15/2021,3/15/2021,31521,82L-IMPORT PAYROLL,D108,HJ,14.01,,398132.48
6150,3/15/2021,3/15/2021,31521,82L-IMPORT PAYROLL,D108,HJ,14.05,,398146.53
6150,3/15/2021,3/15/2021,31521,82L-IMPORT PAYROLL,D108,HJ,14.05,,398160.58
6150,3/15/2021,3/15/2021,31521,82L-IMPORT PAYROLL,D108,HJ,14.25,,398174.83
6150,3/15/2021,3/15/2021,31521,82L-IMPORT PAYROLL,D108,HJ,14.25,,398189.08
6150,3/15/2021,3/15/2021,31521,82L-IMPORT PAYROLL,D108,HJ,14.65,,398203.73
6150,3/15/2021,3/15/2021,31521,82L-IMPORT PAYROLL,D108,HJ,14.98,,398218.71
6150,3/15/2021,3/15/2021,31521,82L-IMPORT PAYROLL,D108,HJ,15.02,,398233.73
6150,3/15/2021,3/15/2021,31521,82L-IMPORT PAYROLL,D108,HJ,15.16,,398248.89
6150,3/15/2021,3/15/2021,31521,82L-IMPORT PAYROLL,D108,HJ,15.19,,398264.08
6150,3/15/2021,3/15/2021,31521,82L-IMPORT PAYROLL,D108,HJ,15.19,,398279.27
6150,3/15/2021,3/15/2021,31521,82L-IMPORT PAYROLL,D108,HJ,15.19,,398294.46
6150,3/15/2021,3/15/2021,31521,82L-IMPORT PAYROLL,D108,HJ,15.19,,398309.65
6150,3/15/2021,3/15/2021,31521,82L-IMPORT PAYROLL,D108,HJ,15.19,,398324.84
6150,3/15/2021,3/15/2021,31521,82L-IMPORT PAYROLL,D108,HJ,15.19,,398340.03
6150,3/15/2021,3/15/2021,31521,82L-IMPORT PAYROLL,D108,HJ,15.19,,398355.22
6150,3/15/2021,3/15/2021,31521,82L-IMPORT PAYROLL,D108,HJ,15.19,,398370.41
6150,3/15/2021,3/15/2021,31521,82L-IMPORT PAYROLL,D108,HJ,15.19,,398385.6
6150,3/15/2021,3/15/2021,31521,82L-IMPORT PAYROLL,D108,HJ,15.19,,398400.79
6150,3/15/2021,3/15/2021,31521,82L-IMPORT PAYROLL,D108,HJ,15.19,,398415.98
6150,3/15/2021,3/15/2021,31521,82L-IMPORT PAYROLL,D108,HJ,15.19,,398431.17
6150,3/15/2021,3/15/2021,31521,82L-IMPORT PAYROLL,D108,HJ,15.19,,398446.36
6150,3/15/2021,3/15/2021,31521,82L-IMPORT PAYROLL,D108,HJ,15.27,,398461.63
6150,3/15/2021,3/15/2021,31521,82L-IMPORT PAYROLL,D108,HJ,15.28,,398476.91
6150,3/15/2021,3/15/2021,31521,82L-IMPORT PAYROLL,D108,HJ,15.67,,398492.58
6150,3/15/2021,3/15/2021,31521,82L-IMPORT PAYROLL,D108,HJ,19.84,,398512.42
6150,3/15/2021,3/15/2021,31521,82L-IMPORT PAYROLL,D108,HJ,20.14,,398532.56
6150,3/15/2021,3/15/2021,31521,82L-IMPORT PAYROLL,D108,HJ,26.08,,398558.64
6150,3/15/2021,3/15/2021,31521,82L-IMPORT PAYROLL,D108,HJ,26.08,,398584.72
6150,3/15/2021,3/15/2021,31521,82L-IMPORT PAYROLL,D108,HJ,26.16,,398610.88
6150,3/15/2021,3/15/2021,31521,82L-IMPORT PAYROLL,D108,HJ,26.16,,398637.04
6150,3/15/2021,3/15/2021,31521,82L-IMPORT PAYROLL,D108,HJ,26.53,,398663.57
6150,3/15/2021,3/15/2021,31521,82L-IMPORT PAYROLL,D108,HJ,26.53,,398690.1
6150,3/15/2021,3/15/2021,31521,82L-IMPORT PAYROLL,D108,HJ,27.59,,398717.69
6150,3/15/2021,3/15/2021,31521,82L-IMPORT PAYROLL,D108,HJ,27.84,,398745.53
6150,3/15/2021,3/15/2021,31521,82L-IMPORT PAYROLL,D108,HJ,27.96,,398773.49
6150,3/15/2021,3/15/2021,31521,82L-IMPORT PAYROLL,D108,HJ,28.29,,398801.78
6150,3/15/2021,3/15/2021,31521,82L-IMPORT PAYROLL,D108,HJ,28.29,,398830.07
6150,3/15/2021,3/15/2021,31521,82L-IMPORT PAYROLL,D108,HJ,28.29,,398858.36
6150,3/15/2021,3/15/2021,31521,82L-IMPORT PAYROLL,D108,HJ,29,,398887.36
6150,3/15/2021,3/15/2021,31521,82L-IMPORT PAYROLL,D108,HJ,30.21,,398917.57
6150,3/15/2021,3/15/2021,31521,82L-IMPORT PAYROLL,D108,HJ,31.31,,398948.88
6150,3/15/2021,3/15/2021,31521,82L-IMPORT PAYROLL,D108,HJ,31.94,,398980.82
6150,3/15/2021,3/15/2021,31521,82L-IMPORT PAYROLL,D108,HJ,32.46,,399013.28
6150,3/15/2021,3/15/2021,31521,82L-IMPORT PAYROLL,D108,HJ,33.52,,399046.8
6150,3/15/2021,3/15/2021,31521,82L-IMPORT PAYROLL,D108,HJ,33.58,,399080.38
6150,3/15/2021,3/15/2021,31521,82L-IMPORT PAYROLL,D108,HJ,34.63,,399115.01
6150,3/15/2021,3/15/2021,31521,82L-IMPORT PAYROLL,D108,HJ,35.97,,399150.98
6150,3/15/2021,3/15/2021,31521,82L-IMPORT PAYROLL,D108,HJ,35.97,,399186.95
6150,3/15/2021,3/15/2021,31521,82L-IMPORT PAYROLL,D108,HJ,35.97,,399222.92
6150,3/15/2021,3/15/2021,31521,82L-IMPORT PAYROLL,D108,HJ,36.15,,399259.07
6150,3/15/2021,3/15/2021,31521,82L-IMPORT PAYROLL,D108,HJ,36.25,,399295.32
6150,3/15/2021,3/15/2021,31521,82L-IMPORT PAYROLL,D108,HJ,36.67,,399331.99
6150,3/15/2021,3/15/2021,31521,82L-IMPORT PAYROLL,D108,HJ,36.67,,399368.66
6150,3/15/2021,3/15/2021,31521,82L-IMPORT PAYROLL,D108,HJ,36.67,,399405.33
6150,3/15/2021,3/15/2021,31521,82L-IMPORT PAYROLL,D108,HJ,36.67,,399442
6150,3/15/2021,3/15/2021,31521,82L-IMPORT PAYROLL,D108,HJ,36.88,,399478.88
6150,3/15/2021,3/15/2021,31521,82L-IMPORT PAYROLL,D108,HJ,36.95,,399515.83
6150,3/15/2021,3/15/2021,31521,82L-IMPORT PAYROLL,D108,HJ,44.27,,399560.1
6150,3/15/2021,3/15/2021,31521,82L-IMPORT PAYROLL,D108,HJ,59.89,,399619.99
6150,3/15/2021,3/15/2021,31521,82L-IMPORT PAYROLL,D108,HJ,59.89,,399679.88
6150,3/15/2021,3/15/2021,31521,82L-IMPORT PAYROLL,D108,HJ,59.89,,399739.77
6150,3/15/2021,3/15/2021,31521,82L-IMPORT PAYROLL,D108,HJ,60.07,,399799.84
6150,3/15/2021,3/15/2021,31521,82L-IMPORT PAYROLL,D108,HJ,60.07,,399859.91
6150,3/15/2021,3/15/2021,31521,82L-IMPORT PAYROLL,D108,HJ,60.92,,399920.83
6150,3/15/2021,3/15/2021,31521,82L-IMPORT PAYROLL,D108,HJ,60.92,,399981.75
6150,3/15/2021,3/15/2021,31521,82L-IMPORT PAYROLL,D108,HJ,62.62,,400044.37
6150,3/15/2021,3/15/2021,31521,82L-IMPORT PAYROLL,D108,HJ,64.03,,400108.4
6150,3/15/2021,3/15/2021,31521,82L-IMPORT PAYROLL,D108,HJ,64.21,,400172.61
6150,3/15/2021,3/15/2021,31521,82L-IMPORT PAYROLL,D108,HJ,64.84,,400237.45
6150,3/15/2021,3/15/2021,31521,82L-IMPORT PAYROLL,D108,HJ,64.95,,400302.4
6150,3/15/2021,3/15/2021,31521,82L-IMPORT PAYROLL,D108,HJ,64.95,,400367.35
6150,3/15/2021,3/15/2021,31521,82L-IMPORT PAYROLL,D108,HJ,64.95,,400432.3
6150,3/15/2021,3/15/2021,31521,82L-IMPORT PAYROLL,D108,HJ,64.95,,400497.25
6150,3/15/2021,3/15/2021,31521,82L-IMPORT PAYROLL,D108,HJ,64.95,,400562.2
6150,3/15/2021,3/15/2021,31521,82L-IMPORT PAYROLL,D108,HJ,64.95,,400627.15
6150,3/15/2021,3/15/2021,31521,82L-IMPORT PAYROLL,D108,HJ,64.95,,400692.1
6150,3/15/2021,3/15/2021,31521,82L-IMPORT PAYROLL,D108,HJ,64.95,,400757.05
6150,3/15/2021,3/15/2021,31521,82L-IMPORT PAYROLL,D108,HJ,64.95,,400822
6150,3/15/2021,3/15/2021,31521,82L-IMPORT PAYROLL,D108,HJ,64.95,,400886.95
6150,3/15/2021,3/15/2021,31521,82L-IMPORT PAYROLL,D108,HJ,64.95,,400951.9
6150,3/15/2021,3/15/2021,31521,82L-IMPORT PAYROLL,D108,HJ,64.95,,401016.85
6150,3/15/2021,3/15/2021,31521,82L-IMPORT PAYROLL,D108,HJ,64.95,,401081.8
6150,3/15/2021,3/15/2021,31521,82L-IMPORT PAYROLL,D108,HJ,65.29,,401147.09
6150,3/15/2021,3/15/2021,31521,82L-IMPORT PAYROLL,D108,HJ,65.32,,401212.41
6150,3/15/2021,3/15/2021,31521,82L-IMPORT PAYROLL,D108,HJ,84.85,,401297.26
6150,3/15/2021,3/15/2021,31521,82L-IMPORT PAYROLL,D108,HJ,117.98,,401415.24
6150,3/15/2021,3/15/2021,31521,82L-IMPORT PAYROLL,D108,HJ,119.05,,401534.29
6150,3/15/2021,3/15/2021,31521,82L-IMPORT PAYROLL,D108,HJ,124,,401658.29
6150,3/15/2021,3/15/2021,31521,82L-IMPORT PAYROLL,D108,HJ,129.17,,401787.46
6150,3/15/2021,3/15/2021,31521,82L-IMPORT PAYROLL,D108,HJ,138.81,,401926.27
6150,3/15/2021,3/15/2021,31521,82L-IMPORT PAYROLL,D108,HJ,143.59,,402069.86
6150,3/15/2021,3/15/2021,31521,82L-IMPORT PAYROLL,D108,HJ,148.06,,402217.92
6150,3/15/2021,3/15/2021,31521,82L-IMPORT PAYROLL,D108,HJ,155,,402372.92
6150,3/15/2021,3/15/2021,31521,82L-IMPORT PAYROLL,D108,HJ,31.22,,402404.14
6150,3/15/2021,3/15/2021,31521,82L-IMPORT PAYROLL,D108,HJ,32.04,,402436.18
6150,3/15/2021,3/15/2021,31521,82L-IMPORT PAYROLL,D108,HJ,32.86,,402469.04
6150,3/15/2021,3/15/2021,31521,82L-IMPORT PAYROLL,D108,HJ,32.9,,402501.94
6150,3/15/2021,3/15/2021,31521,82L-IMPORT PAYROLL,D108,HJ,32.92,,402534.86
6150,3/15/2021,3/15/2021,31521,82L-IMPORT PAYROLL,D108,HJ,33.03,,402567.89
6150,3/15/2021,3/15/2021,31521,82L-IMPORT PAYROLL,D108,HJ,33.1,,402600.99
6150,3/15/2021,3/15/2021,31521,82L-IMPORT PAYROLL,D108,HJ,33.23,,402634.22
6150,3/15/2021,3/15/2021,31521,82L-IMPORT PAYROLL,D108,HJ,33.4,,402667.62
6150,3/15/2021,3/15/2021,31521,82L-IMPORT PAYROLL,D108,HJ,33.42,,402701.04
6150,3/15/2021,3/15/2021,31521,82L-IMPORT PAYROLL,D108,HJ,33.86,,402734.9
6150,3/15/2021,3/15/2021,31521,82L-IMPORT PAYROLL,D108,HJ,34.07,,402768.97
6150,3/15/2021,3/15/2021,31521,82L-IMPORT PAYROLL,D108,HJ,34.16,,402803.13
6150,3/15/2021,3/15/2021,31521,82L-IMPORT PAYROLL,D108,HJ,36.3,,402839.43
6150,3/15/2021,3/15/2021,31521,82L-IMPORT PAYROLL,D108,HJ,36.32,,402875.75
6150,3/15/2021,3/15/2021,31521,82L-IMPORT PAYROLL,D108,HJ,36.34,,402912.09
6150,3/15/2021,3/15/2021,31521,82L-IMPORT PAYROLL,D108,HJ,38.67,,402950.76
6150,3/15/2021,3/15/2021,31521,82L-IMPORT PAYROLL,D108,HJ,39.27,,402990.03
6150,3/15/2021,3/15/2021,31521,82L-IMPORT PAYROLL,D108,HJ,41.85,,403031.88
6150,3/15/2021,3/15/2021,31521,82L-IMPORT PAYROLL,D108,HJ,45.1,,403076.98
6150,3/15/2021,3/15/2021,31521,82L-IMPORT PAYROLL,D108,HJ,45.87,,403122.85
6150,3/15/2021,3/15/2021,31521,82L-IMPORT PAYROLL,D108,HJ,46.52,,403169.37
6150,3/15/2021,3/15/2021,31521,82L-IMPORT PAYROLL,D108,HJ,52.91,,403222.28
6150,3/15/2021,3/15/2021,31521,82L-IMPORT PAYROLL,D108,HJ,133.51,,403355.79
6150,3/15/2021,3/15/2021,31521,82L-IMPORT PAYROLL,D108,HJ,137,,403492.79
6150,3/15/2021,3/15/2021,31521,82L-IMPORT PAYROLL,D108,HJ,140.49,,403633.28
6150,3/15/2021,3/15/2021,31521,82L-IMPORT PAYROLL,D108,HJ,140.68,,403773.96
6150,3/15/2021,3/15/2021,31521,82L-IMPORT PAYROLL,D108,HJ,140.75,,403914.71
6150,3/15/2021,3/15/2021,31521,82L-IMPORT PAYROLL,D108,HJ,141.23,,404055.94
6150,3/15/2021,3/15/2021,31521,82L-IMPORT PAYROLL,D108,HJ,141.55,,404197.49
6150,3/15/2021,3/15/2021,31521,82L-IMPORT PAYROLL,D108,HJ,142.08,,404339.57
6150,3/15/2021,3/15/2021,31521,82L-IMPORT PAYROLL,D108,HJ,142.81,,404482.38
6150,3/15/2021,3/15/2021,31521,82L-IMPORT PAYROLL,D108,HJ,142.9,,404625.28
6150,3/15/2021,3/15/2021,31521,82L-IMPORT PAYROLL,D108,HJ,144.76,,404770.04
6150,3/15/2021,3/15/2021,31521,82L-IMPORT PAYROLL,D108,HJ,145.66,,404915.7
6150,3/15/2021,3/15/2021,31521,82L-IMPORT PAYROLL,D108,HJ,146.08,,405061.78
6150,3/15/2021,3/15/2021,31521,82L-IMPORT PAYROLL,D108,HJ,155.19,,405216.97
6150,3/15/2021,3/15/2021,31521,82L-IMPORT PAYROLL,D108,HJ,155.3,,405372.27
6150,3/15/2021,3/15/2021,31521,82L-IMPORT PAYROLL,D108,HJ,155.39,,405527.66
6150,3/15/2021,3/15/2021,31521,82L-IMPORT PAYROLL,D108,HJ,165.33,,405692.99
6150,3/15/2021,3/15/2021,31521,82L-IMPORT PAYROLL,D108,HJ,167.92,,405860.91
6150,3/15/2021,3/15/2021,31521,82L-IMPORT PAYROLL,D108,HJ,178.96,,406039.87
6150,3/15/2021,3/15/2021,31521,82L-IMPORT PAYROLL,D108,HJ,192.83,,406232.7
6150,3/15/2021,3/15/2021,31521,82L-IMPORT PAYROLL,D108,HJ,196.13,,406428.83
6150,3/15/2021,3/15/2021,31521,82L-IMPORT PAYROLL,D108,HJ,198.92,,406627.75
6150,3/15/2021,3/15/2021,31521,82L-IMPORT PAYROLL,D108,HJ,226.22,,406853.97
6150,3/15/2021,3/15/2021,31521,82L-IMPORT PAYROLL,D101,HJ,15.92,,406869.89
6150,3/15/2021,3/15/2021,31521,82L-IMPORT PAYROLL,D101,HJ,17.57,,406887.46
6150,3/15/2021,3/15/2021,31521,82L-IMPORT PAYROLL,D101,HJ,17.57,,406905.03
6150,3/15/2021,3/15/2021,31521,82L-IMPORT PAYROLL,D101,HJ,17.71,,406922.74
6150,3/15/2021,3/15/2021,31521,82L-IMPORT PAYROLL,D101,HJ,20.57,,406943.31
6150,3/15/2021,3/15/2021,31521,82L-IMPORT PAYROLL,D101,HJ,29,,406972.31
6150,3/15/2021,3/15/2021,31521,82L-IMPORT PAYROLL,D101,HJ,29.24,,407001.55
6150,3/15/2021,3/15/2021,31521,82L-IMPORT PAYROLL,D101,HJ,33.51,,407035.06
6150,3/15/2021,3/15/2021,31521,82L-IMPORT PAYROLL,D101,HJ,37.18,,407072.24
6150,3/15/2021,3/15/2021,31521,82L-IMPORT PAYROLL,D101,HJ,38.11,,407110.35
6150,3/15/2021,3/15/2021,31521,82L-IMPORT PAYROLL,D101,HJ,38.3,,407148.65
6150,3/15/2021,3/15/2021,31521,82L-IMPORT PAYROLL,D101,HJ,39.27,,407187.92
6150,3/15/2021,3/15/2021,31521,82L-IMPORT PAYROLL,D101,HJ,41.08,,407229
6150,3/15/2021,3/15/2021,31521,82L-IMPORT PAYROLL,D101,HJ,49.84,,407278.84
6150,3/15/2021,3/15/2021,31521,82L-IMPORT PAYROLL,D101,HJ,68.09,,407346.93
6150,3/15/2021,3/15/2021,31521,82L-IMPORT PAYROLL,D101,HJ,75.71,,407422.64
6150,3/15/2021,3/15/2021,31521,82L-IMPORT PAYROLL,D101,HJ,87.94,,407510.58
6150,3/15/2021,3/15/2021,31521,82L-IMPORT PAYROLL,D101,HJ,114.45,,407625.03
6150,3/15/2021,3/15/2021,31521,82L-IMPORT PAYROLL,D101,HJ,124,,407749.03
6150,3/15/2021,3/15/2021,31521,82L-IMPORT PAYROLL,D101,HJ,125.03,,407874.06
6150,3/15/2021,3/15/2021,31521,82L-IMPORT PAYROLL,D101,HJ,143.3,,408017.36
6150,3/15/2021,3/15/2021,31521,82L-IMPORT PAYROLL,D101,HJ,159,,408176.36
6150,3/15/2021,3/15/2021,31521,82L-IMPORT PAYROLL,D101,HJ,162.94,,408339.3
6150,3/15/2021,3/15/2021,31521,82L-IMPORT PAYROLL,D101,HJ,167.92,,408507.22
6150,3/15/2021,3/15/2021,31521,82L-IMPORT PAYROLL,D101,HJ,175.67,,408682.89
6150,3/15/2021,3/15/2021,31521,82L-IMPORT PAYROLL,D101,HJ,213.13,,408896.02
6150,3/15/2021,3/15/2021,31521,82L-IMPORT PAYROLL,D102,HJ,29.41,,408925.43
6150,3/15/2021,3/15/2021,31521,82L-IMPORT PAYROLL,D102,HJ,30.38,,408955.81
6150,3/15/2021,3/15/2021,31521,82L-IMPORT PAYROLL,D102,HJ,39,,408994.81
6150,3/15/2021,3/15/2021,31521,82L-IMPORT PAYROLL,D102,HJ,123.26,,409118.07
6150,3/15/2021,3/15/2021,31521,82L-IMPORT PAYROLL,D102,HJ,125.74,,409243.81
6150,3/15/2021,3/15/2021,31521,82L-IMPORT PAYROLL,D102,HJ,129.91,,409373.72
6150,3/15/2021,3/15/2021,31521,82L-IMPORT PAYROLL,D102,HJ,166.75,,409540.47
6150,3/15/2021,3/15/2021,31521,82L-IMPORT PAYROLL,D103,HJ,31.08,,409571.55
6150,3/15/2021,3/15/2021,31521,82L-IMPORT PAYROLL,D103,HJ,33.06,,409604.61
6150,3/15/2021,3/15/2021,31521,82L-IMPORT PAYROLL,D103,HJ,43.23,,409647.84
6150,3/15/2021,3/15/2021,31521,82L-IMPORT PAYROLL,D103,HJ,93.32,,409741.16
6150,3/15/2021,3/15/2021,31521,82L-IMPORT PAYROLL,D103,HJ,132.89,,409874.05
6150,3/15/2021,3/15/2021,31521,82L-IMPORT PAYROLL,D103,HJ,141.34,,410015.39
6150,3/15/2021,3/15/2021,31521,82L-IMPORT PAYROLL,D103,HJ,184.83,,410200.22
6150,3/15/2021,3/15/2021,31521,82L-IMPORT PAYROLL,D104,HJ,4.07,,410204.29
6150,3/15/2021,3/15/2021,31521,82L-IMPORT PAYROLL,D104,HJ,5.7,,410209.99
6150,3/15/2021,3/15/2021,31521,82L-IMPORT PAYROLL,D104,HJ,17.41,,410227.4
6150,3/15/2021,3/15/2021,31521,82L-IMPORT PAYROLL,D104,HJ,26.09,,410253.49
6150,3/15/2021,3/15/2021,31521,82L-IMPORT PAYROLL,D104,HJ,27.98,,410281.47
6150,3/15/2021,3/15/2021,31521,82L-IMPORT PAYROLL,D104,HJ,28.09,,410309.56
6150,3/15/2021,3/15/2021,31521,82L-IMPORT PAYROLL,D104,HJ,28.93,,410338.49
6150,3/15/2021,3/15/2021,31521,82L-IMPORT PAYROLL,D104,HJ,34.12,,410372.61
6150,3/15/2021,3/15/2021,31521,82L-IMPORT PAYROLL,D104,HJ,37.03,,410409.64
6150,3/15/2021,3/15/2021,31521,82L-IMPORT PAYROLL,D104,HJ,87.96,,410497.6
6150,3/15/2021,3/15/2021,31521,82L-IMPORT PAYROLL,D104,HJ,111.56,,410609.16
6150,3/15/2021,3/15/2021,31521,82L-IMPORT PAYROLL,D104,HJ,119.65,,410728.81
6150,3/15/2021,3/15/2021,31521,82L-IMPORT PAYROLL,D104,HJ,120.13,,410848.94
6150,3/15/2021,3/15/2021,31521,82L-IMPORT PAYROLL,D104,HJ,123.72,,410972.66
6150,3/15/2021,3/15/2021,31521,82L-IMPORT PAYROLL,D104,HJ,145.9,,411118.56
6150,3/15/2021,3/15/2021,31521,82L-IMPORT PAYROLL,D104,HJ,158.35,,411276.91
6150,3/15/2021,3/15/2021,31521,82L-IMPORT PAYROLL,D104,HJ,376.1,,411653.01
6150,3/15/2021,3/15/2021,31521,82L-IMPORT PAYROLL,D105,HJ,25.57,,411678.58
6150,3/15/2021,3/15/2021,31521,82L-IMPORT PAYROLL,D105,HJ,26.53,,411705.11
6150,3/15/2021,3/15/2021,31521,82L-IMPORT PAYROLL,D105,HJ,27.79,,411732.9
6150,3/15/2021,3/15/2021,31521,82L-IMPORT PAYROLL,D105,HJ,31.18,,411764.08
6150,3/15/2021,3/15/2021,31521,82L-IMPORT PAYROLL,D105,HJ,39.93,,411804.01
6150,3/15/2021,3/15/2021,31521,82L-IMPORT PAYROLL,D105,HJ,49.87,,411853.88
6150,3/15/2021,3/15/2021,31521,82L-IMPORT PAYROLL,D105,HJ,109.31,,411963.19
6150,3/15/2021,3/15/2021,31521,82L-IMPORT PAYROLL,D105,HJ,118.83,,412082.02
6150,3/15/2021,3/15/2021,31521,82L-IMPORT PAYROLL,D105,HJ,133.3,,412215.32
6150,3/15/2021,3/15/2021,31521,82L-IMPORT PAYROLL,D105,HJ,170.75,,412386.07
6150,3/15/2021,3/15/2021,31521,82L-IMPORT PAYROLL,D105,HJ,213.25,,412599.32
6150,3/15/2021,3/15/2021,31521,82L-IMPORT PAYROLL,D107,HJ,9.31,,412608.63
6150,3/15/2021,3/15/2021,31521,82L-IMPORT PAYROLL,D107,HJ,27.59,,412636.22
6150,3/15/2021,3/15/2021,31521,82L-IMPORT PAYROLL,D107,HJ,39.83,,412676.05
6150,3/15/2021,3/15/2021,31521,82L-IMPORT PAYROLL,D107,HJ,42.59,,412718.64
6150,3/15/2021,3/15/2021,31521,82L-IMPORT PAYROLL,D107,HJ,46.14,,412764.78
6150,3/15/2021,3/15/2021,31521,82L-IMPORT PAYROLL,D107,HJ,49.05,,412813.83
6150,3/15/2021,3/15/2021,31521,82L-IMPORT PAYROLL,D107,HJ,72.42,,412886.25
6150,3/15/2021,3/15/2021,31521,82L-IMPORT PAYROLL,D107,HJ,94.2,,412980.45
6150,3/15/2021,3/15/2021,31521,82L-IMPORT PAYROLL,D107,HJ,117.99,,413098.44
6150,3/15/2021,3/15/2021,31521,82L-IMPORT PAYROLL,D107,HJ,182.13,,413280.57
6150,3/15/2021,3/15/2021,31521,82L-IMPORT PAYROLL,D107,HJ,197.31,,413477.88
6150,3/15/2021,3/15/2021,31521,82L-IMPORT PAYROLL,D107,HJ,209.76,,413687.64
6150,3/15/2021,3/15/2021,31521,82L-IMPORT PAYROLL,D107,HJ,309.64,,413997.28
6150,3/15/2021,3/15/2021,31521,82L-IMPORT PAYROLL,D107,HJ,402.8,,414400.08
6150,3/15/2021,3/15/2021,31521,82L-IMPORT PAYROLL,D109,HJ,7.66,,414407.74
6150,3/15/2021,3/15/2021,31521,82L-IMPORT PAYROLL,D109,HJ,12.55,,414420.29
6150,3/15/2021,3/15/2021,31521,82L-IMPORT PAYROLL,D109,HJ,17.65,,414437.94
6150,3/15/2021,3/15/2021,31521,82L-IMPORT PAYROLL,D109,HJ,20.69,,414458.63
6150,3/15/2021,3/15/2021,31521,82L-IMPORT PAYROLL,D109,HJ,21.75,,414480.38
6150,3/15/2021,3/15/2021,31521,82L-IMPORT PAYROLL,D109,HJ,25.5,,414505.88
6150,3/15/2021,3/15/2021,31521,82L-IMPORT PAYROLL,D109,HJ,32.74,,414538.62
6150,3/15/2021,3/15/2021,31521,82L-IMPORT PAYROLL,D109,HJ,55.91,,414594.53
6150,3/15/2021,3/15/2021,31521,82L-IMPORT PAYROLL,D109,HJ,56.19,,414650.72
6150,3/15/2021,3/15/2021,31521,82L-IMPORT PAYROLL,D109,HJ,58.24,,414708.96
6150,3/15/2021,3/15/2021,31521,82L-IMPORT PAYROLL,D109,HJ,72.5,,414781.46
6150,3/15/2021,3/15/2021,31521,82L-IMPORT PAYROLL,D109,HJ,75.46,,414856.92
6150,3/15/2021,3/15/2021,31521,82L-IMPORT PAYROLL,D109,HJ,76.2,,414933.12
6150,3/15/2021,3/15/2021,31521,82L-IMPORT PAYROLL,D109,HJ,76.2,,415009.32
6150,3/15/2021,3/15/2021,31521,82L-IMPORT PAYROLL,D109,HJ,77.9,,415087.22
6150,3/15/2021,3/15/2021,31521,82L-IMPORT PAYROLL,D109,HJ,78.54,,415165.76
6150,3/15/2021,3/15/2021,31521,82L-IMPORT PAYROLL,D109,HJ,78.54,,415244.3
6150,3/15/2021,3/15/2021,31521,82L-IMPORT PAYROLL,D109,HJ,93,,415337.3
6150,3/15/2021,3/15/2021,31521,82L-IMPORT PAYROLL,D109,HJ,239.08,,415576.38
6150,3/15/2021,3/15/2021,31521,82L-IMPORT PAYROLL,D109,HJ,240.25,,415816.63
6150,3/15/2021,3/15/2021,31521,82L-IMPORT PAYROLL,D109,HJ,249.03,,416065.66
6150,3/15/2021,3/15/2021,31521,82L-IMPORT PAYROLL,D109,HJ,310,,416375.66
6150,3/15/2021,3/15/2021,31521,82L-IMPORT PAYROLL,D109,HJ,325.8,,416701.46
6150,3/15/2021,3/15/2021,31521,82L-IMPORT PAYROLL,D109,HJ,325.8,,417027.26
6150,3/15/2021,3/15/2021,31521,82L-IMPORT PAYROLL,D109,HJ,333.1,,417360.36
6150,3/15/2021,3/15/2021,31521,82L-IMPORT PAYROLL,D109,HJ,335.83,,417696.19
6150,3/15/2021,3/15/2021,31521,82L-IMPORT PAYROLL,D109,HJ,335.83,,418032.02
6150,3/15/2021,3/15/2021,31521,82L-IMPORT PAYROLL,D111,HJ,13.18,,418045.2
6150,3/15/2021,3/15/2021,31521,82L-IMPORT PAYROLL,D111,HJ,23.29,,418068.49
6150,3/15/2021,3/15/2021,31521,82L-IMPORT PAYROLL,D111,HJ,28.73,,418097.22
6150,3/15/2021,3/15/2021,31521,82L-IMPORT PAYROLL,D111,HJ,31.05,,418128.27
6150,3/15/2021,3/15/2021,31521,82L-IMPORT PAYROLL,D111,HJ,36.33,,418164.6
6150,3/15/2021,3/15/2021,31521,82L-IMPORT PAYROLL,D111,HJ,36.44,,418201.04
6150,3/15/2021,3/15/2021,31521,82L-IMPORT PAYROLL,D111,HJ,52.29,,418253.33
6150,3/15/2021,3/15/2021,31521,82L-IMPORT PAYROLL,D111,HJ,99.58,,418352.91
6150,3/15/2021,3/15/2021,31521,82L-IMPORT PAYROLL,D111,HJ,122.83,,418475.74
6150,3/15/2021,3/15/2021,31521,82L-IMPORT PAYROLL,D111,HJ,155.35,,418631.09
6150,3/15/2021,3/15/2021,31521,82L-IMPORT PAYROLL,D111,HJ,155.82,,418786.91
6150,3/15/2021,3/15/2021,31521,82L-IMPORT PAYROLL,D111,HJ,223.58,,419010.49
6150,3/15/2021,3/15/2021,31521,82L-IMPORT PAYROLL,D112,HJ,37.96,,419048.45
6150,3/15/2021,3/15/2021,31521,82L-IMPORT PAYROLL,D112,HJ,162.32,,419210.77
6150,3/15/2021,3/15/2021,31521,82L-IMPORT PAYROLL,D108,HJ,1.64,,419212.41
6150,3/15/2021,3/15/2021,31521,82L-IMPORT PAYROLL,D108,HJ,6.94,,419219.35
6150,3/15/2021,3/15/2021,31521,82L-IMPORT PAYROLL,D108,HJ,11.98,,419231.33
6150,3/15/2021,3/15/2021,31521,82L-IMPORT PAYROLL,D108,HJ,14,,419245.33
6150,3/15/2021,3/15/2021,31521,82L-IMPORT PAYROLL,D108,HJ,14.51,,419259.84
6150,3/15/2021,3/15/2021,31521,82L-IMPORT PAYROLL,D108,HJ,15.08,,419274.92
6150,3/15/2021,3/15/2021,31521,82L-IMPORT PAYROLL,D108,HJ,15.08,,419290
6150,3/15/2021,3/15/2021,31521,82L-IMPORT PAYROLL,D108,HJ,15.28,,419305.28
6150,3/15/2021,3/15/2021,31521,82L-IMPORT PAYROLL,D108,HJ,15.28,,419320.56
6150,3/15/2021,3/15/2021,31521,82L-IMPORT PAYROLL,D108,HJ,16.05,,419336.61
6150,3/15/2021,3/15/2021,31521,82L-IMPORT PAYROLL,D108,HJ,16.2,,419352.81
6150,3/15/2021,3/15/2021,31521,82L-IMPORT PAYROLL,D108,HJ,16.23,,419369.04
6150,3/15/2021,3/15/2021,31521,82L-IMPORT PAYROLL,D108,HJ,16.23,,419385.27
6150,3/15/2021,3/15/2021,31521,82L-IMPORT PAYROLL,D108,HJ,16.23,,419401.5
6150,3/15/2021,3/15/2021,31521,82L-IMPORT PAYROLL,D108,HJ,16.23,,419417.73
6150,3/15/2021,3/15/2021,31521,82L-IMPORT PAYROLL,D108,HJ,16.23,,419433.96
6150,3/15/2021,3/15/2021,31521,82L-IMPORT PAYROLL,D108,HJ,16.23,,419450.19
6150,3/15/2021,3/15/2021,31521,82L-IMPORT PAYROLL,D108,HJ,16.23,,419466.42
6150,3/15/2021,3/15/2021,31521,82L-IMPORT PAYROLL,D108,HJ,16.23,,419482.65
6150,3/15/2021,3/15/2021,31521,82L-IMPORT PAYROLL,D108,HJ,16.23,,419498.88
6150,3/15/2021,3/15/2021,31521,82L-IMPORT PAYROLL,D108,HJ,16.23,,419515.11
6150,3/15/2021,3/15/2021,31521,82L-IMPORT PAYROLL,D108,HJ,16.23,,419531.34
6150,3/15/2021,3/15/2021,31521,82L-IMPORT PAYROLL,D108,HJ,16.23,,419547.57
6150,3/15/2021,3/15/2021,31521,82L-IMPORT PAYROLL,D108,HJ,16.23,,419563.8
6150,3/15/2021,3/15/2021,31521,82L-IMPORT PAYROLL,D108,HJ,16.23,,419580.03
6150,3/15/2021,3/15/2021,31521,82L-IMPORT PAYROLL,D108,HJ,16.23,,419596.26
6150,3/15/2021,3/15/2021,31521,82L-IMPORT PAYROLL,D108,HJ,16.23,,419612.49
6150,3/15/2021,3/15/2021,31521,82L-IMPORT PAYROLL,D108,HJ,16.23,,419628.72
6150,3/15/2021,3/15/2021,31521,82L-IMPORT PAYROLL,D108,HJ,16.26,,419644.98
6150,3/15/2021,3/15/2021,31521,82L-IMPORT PAYROLL,D108,HJ,21.49,,419666.47
6150,3/15/2021,3/15/2021,31521,82L-IMPORT PAYROLL,D108,HJ,28.09,,419694.56
6150,3/15/2021,3/15/2021,31521,82L-IMPORT PAYROLL,D108,HJ,30.21,,419724.77
6150,3/15/2021,3/15/2021,31521,82L-IMPORT PAYROLL,D108,HJ,30.44,,419755.21
6150,3/15/2021,3/15/2021,31521,82L-IMPORT PAYROLL,D108,HJ,30.56,,419785.77
6150,3/15/2021,3/15/2021,31521,82L-IMPORT PAYROLL,D108,HJ,31,,419816.77
6150,3/15/2021,3/15/2021,31521,82L-IMPORT PAYROLL,D108,HJ,32.36,,419849.13
6150,3/15/2021,3/15/2021,31521,82L-IMPORT PAYROLL,D108,HJ,32.63,,419881.76
6150,3/15/2021,3/15/2021,31521,82L-IMPORT PAYROLL,D108,HJ,33.23,,419914.99
6150,3/15/2021,3/15/2021,31521,82L-IMPORT PAYROLL,D108,HJ,33.23,,419948.22
6150,3/15/2021,3/15/2021,31521,82L-IMPORT PAYROLL,D108,HJ,33.96,,419982.18
6150,3/15/2021,3/15/2021,31521,82L-IMPORT PAYROLL,D108,HJ,34.16,,420016.34
6150,3/15/2021,3/15/2021,31521,82L-IMPORT PAYROLL,D108,HJ,34.74,,420051.08
6150,3/15/2021,3/15/2021,31521,82L-IMPORT PAYROLL,D108,HJ,34.79,,420085.87
6150,3/15/2021,3/15/2021,31521,82L-IMPORT PAYROLL,D108,HJ,35.1,,420120.97
6150,3/15/2021,3/15/2021,31521,82L-IMPORT PAYROLL,D108,HJ,35.81,,420156.78
6150,3/15/2021,3/15/2021,31521,82L-IMPORT PAYROLL,D108,HJ,36.93,,420193.71
6150,3/15/2021,3/15/2021,31521,82L-IMPORT PAYROLL,D108,HJ,41.91,,420235.62
6150,3/15/2021,3/15/2021,31521,82L-IMPORT PAYROLL,D108,HJ,51.23,,420286.85
6150,3/15/2021,3/15/2021,31521,82L-IMPORT PAYROLL,D108,HJ,54.34,,420341.19
6150,3/15/2021,3/15/2021,31521,82L-IMPORT PAYROLL,D108,HJ,59.86,,420401.05
6150,3/15/2021,3/15/2021,31521,82L-IMPORT PAYROLL,D108,HJ,62.06,,420463.11
6150,3/15/2021,3/15/2021,31521,82L-IMPORT PAYROLL,D108,HJ,64.5,,420527.61
6150,3/15/2021,3/15/2021,31521,82L-IMPORT PAYROLL,D108,HJ,64.5,,420592.11
6150,3/15/2021,3/15/2021,31521,82L-IMPORT PAYROLL,D108,HJ,65.35,,420657.46
6150,3/15/2021,3/15/2021,31521,82L-IMPORT PAYROLL,D108,HJ,65.35,,420722.81
6150,3/15/2021,3/15/2021,31521,82L-IMPORT PAYROLL,D108,HJ,68.64,,420791.45
6150,3/15/2021,3/15/2021,31521,82L-IMPORT PAYROLL,D108,HJ,69.27,,420860.72
6150,3/15/2021,3/15/2021,31521,82L-IMPORT PAYROLL,D108,HJ,69.38,,420930.1
6150,3/15/2021,3/15/2021,31521,82L-IMPORT PAYROLL,D108,HJ,69.38,,420999.48
6150,3/15/2021,3/15/2021,31521,82L-IMPORT PAYROLL,D108,HJ,69.38,,421068.86
6150,3/15/2021,3/15/2021,31521,82L-IMPORT PAYROLL,D108,HJ,69.38,,421138.24
6150,3/15/2021,3/15/2021,31521,82L-IMPORT PAYROLL,D108,HJ,69.38,,421207.62
6150,3/15/2021,3/15/2021,31521,82L-IMPORT PAYROLL,D108,HJ,69.38,,421277
6150,3/15/2021,3/15/2021,31521,82L-IMPORT PAYROLL,D108,HJ,69.38,,421346.38
6150,3/15/2021,3/15/2021,31521,82L-IMPORT PAYROLL,D108,HJ,69.38,,421415.76
6150,3/15/2021,3/15/2021,31521,82L-IMPORT PAYROLL,D108,HJ,69.38,,421485.14
6150,3/15/2021,3/15/2021,31521,82L-IMPORT PAYROLL,D108,HJ,69.38,,421554.52
6150,3/15/2021,3/15/2021,31521,82L-IMPORT PAYROLL,D108,HJ,69.38,,421623.9
6150,3/15/2021,3/15/2021,31521,82L-IMPORT PAYROLL,D108,HJ,69.38,,421693.28
6150,3/15/2021,3/15/2021,31521,82L-IMPORT PAYROLL,D108,HJ,69.38,,421762.66
6150,3/15/2021,3/15/2021,31521,82L-IMPORT PAYROLL,D108,HJ,69.38,,421832.04
6150,3/15/2021,3/15/2021,31521,82L-IMPORT PAYROLL,D108,HJ,69.38,,421901.42
6150,3/15/2021,3/15/2021,31521,82L-IMPORT PAYROLL,D108,HJ,69.38,,421970.8
6150,3/15/2021,3/15/2021,31521,82L-IMPORT PAYROLL,D108,HJ,69.38,,422040.18
6150,3/15/2021,3/15/2021,31521,82L-IMPORT PAYROLL,D108,HJ,69.52,,422109.7
6150,3/15/2021,3/15/2021,31521,82L-IMPORT PAYROLL,D108,HJ,74.25,,422183.95
6150,3/15/2021,3/15/2021,31521,82L-IMPORT PAYROLL,D108,HJ,130.16,,422314.11
6150,3/15/2021,3/15/2021,31521,82L-IMPORT PAYROLL,D108,HJ,130.69,,422444.8
6150,3/15/2021,3/15/2021,31521,82L-IMPORT PAYROLL,D108,HJ,132.56,,422577.36
6150,3/15/2021,3/15/2021,31521,82L-IMPORT PAYROLL,D108,HJ,138.38,,422715.74
6150,3/15/2021,3/15/2021,31521,82L-IMPORT PAYROLL,D108,HJ,139.5,,422855.24
6150,3/15/2021,3/15/2021,31521,82L-IMPORT PAYROLL,D108,HJ,142.08,,422997.32
6150,3/15/2021,3/15/2021,31521,82L-IMPORT PAYROLL,D108,HJ,142.08,,423139.4
6150,3/15/2021,3/15/2021,31521,82L-IMPORT PAYROLL,D108,HJ,145.23,,423284.63
6150,3/15/2021,3/15/2021,31521,82L-IMPORT PAYROLL,D108,HJ,146.08,,423430.71
6150,3/15/2021,3/15/2021,31521,82L-IMPORT PAYROLL,D108,HJ,148.53,,423579.24
6150,3/15/2021,3/15/2021,31521,82L-IMPORT PAYROLL,D108,HJ,148.76,,423728
6150,3/15/2021,3/15/2021,31521,82L-IMPORT PAYROLL,D108,HJ,150.1,,423878.1
6150,3/15/2021,3/15/2021,31521,82L-IMPORT PAYROLL,D108,HJ,179.22,,424057.32
6150,3/15/2021,3/15/2021,31521,82L-IMPORT PAYROLL,D108,HJ,232.34,,424289.66
6150,3/15/2021,3/15/2021,31521,82L-IMPORT PAYROLL,D108,HJ,16.53,,424306.19
6150,3/15/2021,3/15/2021,31521,82L-IMPORT PAYROLL,D108,HJ,19.38,,424325.57
6150,3/15/2021,3/15/2021,31521,82L-IMPORT PAYROLL,D108,HJ,37.75,,424363.32
6150,3/15/2021,3/15/2021,31521,82L-IMPORT PAYROLL,D108,HJ,38.07,,424401.39
6150,3/15/2021,3/15/2021,31521,82L-IMPORT PAYROLL,D108,HJ,38.67,,424440.06
6150,3/15/2021,3/15/2021,31521,82L-IMPORT PAYROLL,D108,HJ,42.91,,424482.97
6150,3/15/2021,3/15/2021,31521,82L-IMPORT PAYROLL,D108,HJ,68.96,,424551.93
6150,3/15/2021,3/15/2021,31521,82L-IMPORT PAYROLL,D108,HJ,161.4,,424713.33
6150,3/15/2021,3/15/2021,31521,82L-IMPORT PAYROLL,D108,HJ,162.79,,424876.12
6150,3/15/2021,3/15/2021,31521,82L-IMPORT PAYROLL,D108,HJ,165.33,,425041.45
6150,3/15/2021,3/15/2021,31521,82L-IMPORT PAYROLL,D108,HJ,183.48,,425224.93
6150,3/15/2021,3/15/2021,31521,82L-IMPORT PAYROLL,D108,HJ,294.88,,425519.81
6150,3/31/2021,3/31/2021,33121,82L-IMPORT PAYROLL,D108,HJ,5.61,,425525.42
6150,3/31/2021,3/31/2021,33121,82L-IMPORT PAYROLL,D108,HJ,10.44,,425535.86
6150,3/31/2021,3/31/2021,33121,82L-IMPORT PAYROLL,D108,HJ,10.69,,425546.55
6150,3/31/2021,3/31/2021,33121,82L-IMPORT PAYROLL,D108,HJ,14.01,,425560.56
6150,3/31/2021,3/31/2021,33121,82L-IMPORT PAYROLL,D108,HJ,14.01,,425574.57
6150,3/31/2021,3/31/2021,33121,82L-IMPORT PAYROLL,D108,HJ,14.01,,425588.58
6150,3/31/2021,3/31/2021,33121,82L-IMPORT PAYROLL,D108,HJ,14.05,,425602.63
6150,3/31/2021,3/31/2021,33121,82L-IMPORT PAYROLL,D108,HJ,14.25,,425616.88
6150,3/31/2021,3/31/2021,33121,82L-IMPORT PAYROLL,D108,HJ,14.35,,425631.23
6150,3/31/2021,3/31/2021,33121,82L-IMPORT PAYROLL,D108,HJ,14.66,,425645.89
6150,3/31/2021,3/31/2021,33121,82L-IMPORT PAYROLL,D108,HJ,14.92,,425660.81
6150,3/31/2021,3/31/2021,33121,82L-IMPORT PAYROLL,D108,HJ,14.98,,425675.79
6150,3/31/2021,3/31/2021,33121,82L-IMPORT PAYROLL,D108,HJ,14.99,,425690.78
6150,3/31/2021,3/31/2021,33121,82L-IMPORT PAYROLL,D108,HJ,15.16,,425705.94
6150,3/31/2021,3/31/2021,33121,82L-IMPORT PAYROLL,D108,HJ,15.19,,425721.13
6150,3/31/2021,3/31/2021,33121,82L-IMPORT PAYROLL,D108,HJ,15.19,,425736.32
6150,3/31/2021,3/31/2021,33121,82L-IMPORT PAYROLL,D108,HJ,15.19,,425751.51
6150,3/31/2021,3/31/2021,33121,82L-IMPORT PAYROLL,D108,HJ,15.19,,425766.7
6150,3/31/2021,3/31/2021,33121,82L-IMPORT PAYROLL,D108,HJ,15.19,,425781.89
6150,3/31/2021,3/31/2021,33121,82L-IMPORT PAYROLL,D108,HJ,15.19,,425797.08
6150,3/31/2021,3/31/2021,33121,82L-IMPORT PAYROLL,D108,HJ,15.19,,425812.27
6150,3/31/2021,3/31/2021,33121,82L-IMPORT PAYROLL,D108,HJ,15.19,,425827.46
6150,3/31/2021,3/31/2021,33121,82L-IMPORT PAYROLL,D108,HJ,15.19,,425842.65
6150,3/31/2021,3/31/2021,33121,82L-IMPORT PAYROLL,D108,HJ,15.19,,425857.84
6150,3/31/2021,3/31/2021,33121,82L-IMPORT PAYROLL,D108,HJ,15.19,,425873.03
6150,3/31/2021,3/31/2021,33121,82L-IMPORT PAYROLL,D108,HJ,15.19,,425888.22
6150,3/31/2021,3/31/2021,33121,82L-IMPORT PAYROLL,D108,HJ,15.19,,425903.41
6150,3/31/2021,3/31/2021,33121,82L-IMPORT PAYROLL,D108,HJ,15.2,,425918.61
6150,3/31/2021,3/31/2021,33121,82L-IMPORT PAYROLL,D108,HJ,15.26,,425933.87
6150,3/31/2021,3/31/2021,33121,82L-IMPORT PAYROLL,D108,HJ,15.3,,425949.17
6150,3/31/2021,3/31/2021,33121,82L-IMPORT PAYROLL,D108,HJ,16.03,,425965.2
6150,3/31/2021,3/31/2021,33121,82L-IMPORT PAYROLL,D108,HJ,17.65,,425982.85
6150,3/31/2021,3/31/2021,33121,82L-IMPORT PAYROLL,D108,HJ,20.14,,426002.99
6150,3/31/2021,3/31/2021,33121,82L-IMPORT PAYROLL,D108,HJ,23.98,,426026.97
6150,3/31/2021,3/31/2021,33121,82L-IMPORT PAYROLL,D108,HJ,24.56,,426051.53
6150,3/31/2021,3/31/2021,33121,82L-IMPORT PAYROLL,D108,HJ,26.08,,426077.61
6150,3/31/2021,3/31/2021,33121,82L-IMPORT PAYROLL,D108,HJ,26.08,,426103.69
6150,3/31/2021,3/31/2021,33121,82L-IMPORT PAYROLL,D108,HJ,26.16,,426129.85
6150,3/31/2021,3/31/2021,33121,82L-IMPORT PAYROLL,D108,HJ,26.53,,426156.38
6150,3/31/2021,3/31/2021,33121,82L-IMPORT PAYROLL,D108,HJ,26.71,,426183.09
6150,3/31/2021,3/31/2021,33121,82L-IMPORT PAYROLL,D108,HJ,27.59,,426210.68
6150,3/31/2021,3/31/2021,33121,82L-IMPORT PAYROLL,D108,HJ,27.78,,426238.46
6150,3/31/2021,3/31/2021,33121,82L-IMPORT PAYROLL,D108,HJ,27.84,,426266.3
6150,3/31/2021,3/31/2021,33121,82L-IMPORT PAYROLL,D108,HJ,28.29,,426294.59
6150,3/31/2021,3/31/2021,33121,82L-IMPORT PAYROLL,D108,HJ,28.29,,426322.88
6150,3/31/2021,3/31/2021,33121,82L-IMPORT PAYROLL,D108,HJ,28.49,,426351.37
6150,3/31/2021,3/31/2021,33121,82L-IMPORT PAYROLL,D108,HJ,29,,426380.37
6150,3/31/2021,3/31/2021,33121,82L-IMPORT PAYROLL,D108,HJ,29.84,,426410.21
6150,3/31/2021,3/31/2021,33121,82L-IMPORT PAYROLL,D108,HJ,30.21,,426440.42
6150,3/31/2021,3/31/2021,33121,82L-IMPORT PAYROLL,D108,HJ,31.34,,426471.76
6150,3/31/2021,3/31/2021,33121,82L-IMPORT PAYROLL,D108,HJ,32.46,,426504.22
6150,3/31/2021,3/31/2021,33121,82L-IMPORT PAYROLL,D108,HJ,32.86,,426537.08
6150,3/31/2021,3/31/2021,33121,82L-IMPORT PAYROLL,D108,HJ,33.52,,426570.6
6150,3/31/2021,3/31/2021,33121,82L-IMPORT PAYROLL,D108,HJ,33.58,,426604.18
6150,3/31/2021,3/31/2021,33121,82L-IMPORT PAYROLL,D108,HJ,34.63,,426638.81
6150,3/31/2021,3/31/2021,33121,82L-IMPORT PAYROLL,D108,HJ,36.15,,426674.96
6150,3/31/2021,3/31/2021,33121,82L-IMPORT PAYROLL,D108,HJ,36.25,,426711.21
6150,3/31/2021,3/31/2021,33121,82L-IMPORT PAYROLL,D108,HJ,36.67,,426747.88
6150,3/31/2021,3/31/2021,33121,82L-IMPORT PAYROLL,D108,HJ,36.67,,426784.55
6150,3/31/2021,3/31/2021,33121,82L-IMPORT PAYROLL,D108,HJ,36.67,,426821.22
6150,3/31/2021,3/31/2021,33121,82L-IMPORT PAYROLL,D108,HJ,36.67,,426857.89
6150,3/31/2021,3/31/2021,33121,82L-IMPORT PAYROLL,D108,HJ,36.83,,426894.72
6150,3/31/2021,3/31/2021,33121,82L-IMPORT PAYROLL,D108,HJ,38.17,,426932.89
6150,3/31/2021,3/31/2021,33121,82L-IMPORT PAYROLL,D108,HJ,44.27,,426977.16
6150,3/31/2021,3/31/2021,33121,82L-IMPORT PAYROLL,D108,HJ,59.89,,427037.05
6150,3/31/2021,3/31/2021,33121,82L-IMPORT PAYROLL,D108,HJ,59.89,,427096.94
6150,3/31/2021,3/31/2021,33121,82L-IMPORT PAYROLL,D108,HJ,59.89,,427156.83
6150,3/31/2021,3/31/2021,33121,82L-IMPORT PAYROLL,D108,HJ,60.07,,427216.9
6150,3/31/2021,3/31/2021,33121,82L-IMPORT PAYROLL,D108,HJ,60.92,,427277.82
6150,3/31/2021,3/31/2021,33121,82L-IMPORT PAYROLL,D108,HJ,61.34,,427339.16
6150,3/31/2021,3/31/2021,33121,82L-IMPORT PAYROLL,D108,HJ,62.68,,427401.84
6150,3/31/2021,3/31/2021,33121,82L-IMPORT PAYROLL,D108,HJ,63.79,,427465.63
6150,3/31/2021,3/31/2021,33121,82L-IMPORT PAYROLL,D108,HJ,64.03,,427529.66
6150,3/31/2021,3/31/2021,33121,82L-IMPORT PAYROLL,D108,HJ,64.1,,427593.76
6150,3/31/2021,3/31/2021,33121,82L-IMPORT PAYROLL,D108,HJ,64.84,,427658.6
6150,3/31/2021,3/31/2021,33121,82L-IMPORT PAYROLL,D108,HJ,64.95,,427723.55
6150,3/31/2021,3/31/2021,33121,82L-IMPORT PAYROLL,D108,HJ,64.95,,427788.5
6150,3/31/2021,3/31/2021,33121,82L-IMPORT PAYROLL,D108,HJ,64.95,,427853.45
6150,3/31/2021,3/31/2021,33121,82L-IMPORT PAYROLL,D108,HJ,64.95,,427918.4
6150,3/31/2021,3/31/2021,33121,82L-IMPORT PAYROLL,D108,HJ,64.95,,427983.35
6150,3/31/2021,3/31/2021,33121,82L-IMPORT PAYROLL,D108,HJ,64.95,,428048.3
6150,3/31/2021,3/31/2021,33121,82L-IMPORT PAYROLL,D108,HJ,64.95,,428113.25
6150,3/31/2021,3/31/2021,33121,82L-IMPORT PAYROLL,D108,HJ,64.95,,428178.2
6150,3/31/2021,3/31/2021,33121,82L-IMPORT PAYROLL,D108,HJ,64.95,,428243.15
6150,3/31/2021,3/31/2021,33121,82L-IMPORT PAYROLL,D108,HJ,64.95,,428308.1
6150,3/31/2021,3/31/2021,33121,82L-IMPORT PAYROLL,D108,HJ,64.95,,428373.05
6150,3/31/2021,3/31/2021,33121,82L-IMPORT PAYROLL,D108,HJ,64.95,,428438
6150,3/31/2021,3/31/2021,33121,82L-IMPORT PAYROLL,D108,HJ,64.95,,428502.95
6150,3/31/2021,3/31/2021,33121,82L-IMPORT PAYROLL,D108,HJ,65.01,,428567.96
6150,3/31/2021,3/31/2021,33121,82L-IMPORT PAYROLL,D108,HJ,65.23,,428633.19
6150,3/31/2021,3/31/2021,33121,82L-IMPORT PAYROLL,D108,HJ,65.42,,428698.61
6150,3/31/2021,3/31/2021,33121,82L-IMPORT PAYROLL,D108,HJ,68.53,,428767.14
6150,3/31/2021,3/31/2021,33121,82L-IMPORT PAYROLL,D108,HJ,71.08,,428838.22
6150,3/31/2021,3/31/2021,33121,82L-IMPORT PAYROLL,D108,HJ,75.45,,428913.67
6150,3/31/2021,3/31/2021,33121,82L-IMPORT PAYROLL,D108,HJ,117.98,,429031.65
6150,3/31/2021,3/31/2021,33121,82L-IMPORT PAYROLL,D108,HJ,119.05,,429150.7
6150,3/31/2021,3/31/2021,33121,82L-IMPORT PAYROLL,D108,HJ,124,,429274.7
6150,3/31/2021,3/31/2021,33121,82L-IMPORT PAYROLL,D108,HJ,129.17,,429403.87
6150,3/31/2021,3/31/2021,33121,82L-IMPORT PAYROLL,D108,HJ,138.81,,429542.68
6150,3/31/2021,3/31/2021,33121,82L-IMPORT PAYROLL,D108,HJ,143.59,,429686.27
6150,3/31/2021,3/31/2021,33121,82L-IMPORT PAYROLL,D108,HJ,148.06,,429834.33
6150,3/31/2021,3/31/2021,33121,82L-IMPORT PAYROLL,D108,HJ,155,,429989.33
6150,3/31/2021,3/31/2021,33121,82L-IMPORT PAYROLL,D108,HJ,163.23,,430152.56
6150,3/31/2021,3/31/2021,33121,82L-IMPORT PAYROLL,D108,HJ,31.22,,430183.78
6150,3/31/2021,3/31/2021,33121,82L-IMPORT PAYROLL,D108,HJ,32.04,,430215.82
6150,3/31/2021,3/31/2021,33121,82L-IMPORT PAYROLL,D108,HJ,32.86,,430248.68
6150,3/31/2021,3/31/2021,33121,82L-IMPORT PAYROLL,D108,HJ,32.9,,430281.58
6150,3/31/2021,3/31/2021,33121,82L-IMPORT PAYROLL,D108,HJ,32.92,,430314.5
6150,3/31/2021,3/31/2021,33121,82L-IMPORT PAYROLL,D108,HJ,33.03,,430347.53
6150,3/31/2021,3/31/2021,33121,82L-IMPORT PAYROLL,D108,HJ,33.1,,430380.63
6150,3/31/2021,3/31/2021,33121,82L-IMPORT PAYROLL,D108,HJ,33.23,,430413.86
6150,3/31/2021,3/31/2021,33121,82L-IMPORT PAYROLL,D108,HJ,33.4,,430447.26
6150,3/31/2021,3/31/2021,33121,82L-IMPORT PAYROLL,D108,HJ,33.42,,430480.68
6150,3/31/2021,3/31/2021,33121,82L-IMPORT PAYROLL,D108,HJ,33.86,,430514.54
6150,3/31/2021,3/31/2021,33121,82L-IMPORT PAYROLL,D108,HJ,34.07,,430548.61
6150,3/31/2021,3/31/2021,33121,82L-IMPORT PAYROLL,D108,HJ,34.16,,430582.77
6150,3/31/2021,3/31/2021,33121,82L-IMPORT PAYROLL,D108,HJ,36.3,,430619.07
6150,3/31/2021,3/31/2021,33121,82L-IMPORT PAYROLL,D108,HJ,36.32,,430655.39
6150,3/31/2021,3/31/2021,33121,82L-IMPORT PAYROLL,D108,HJ,36.34,,430691.73
6150,3/31/2021,3/31/2021,33121,82L-IMPORT PAYROLL,D108,HJ,38.67,,430730.4
6150,3/31/2021,3/31/2021,33121,82L-IMPORT PAYROLL,D108,HJ,39.27,,430769.67
6150,3/31/2021,3/31/2021,33121,82L-IMPORT PAYROLL,D108,HJ,41.85,,430811.52
6150,3/31/2021,3/31/2021,33121,82L-IMPORT PAYROLL,D108,HJ,45.1,,430856.62
6150,3/31/2021,3/31/2021,33121,82L-IMPORT PAYROLL,D108,HJ,45.87,,430902.49
6150,3/31/2021,3/31/2021,33121,82L-IMPORT PAYROLL,D108,HJ,46.52,,430949.01
6150,3/31/2021,3/31/2021,33121,82L-IMPORT PAYROLL,D108,HJ,52.91,,431001.92
6150,3/31/2021,3/31/2021,33121,82L-IMPORT PAYROLL,D108,HJ,133.51,,431135.43
6150,3/31/2021,3/31/2021,33121,82L-IMPORT PAYROLL,D108,HJ,137,,431272.43
6150,3/31/2021,3/31/2021,33121,82L-IMPORT PAYROLL,D108,HJ,140.49,,431412.92
6150,3/31/2021,3/31/2021,33121,82L-IMPORT PAYROLL,D108,HJ,140.68,,431553.6
6150,3/31/2021,3/31/2021,33121,82L-IMPORT PAYROLL,D108,HJ,140.75,,431694.35
6150,3/31/2021,3/31/2021,33121,82L-IMPORT PAYROLL,D108,HJ,141.23,,431835.58
6150,3/31/2021,3/31/2021,33121,82L-IMPORT PAYROLL,D108,HJ,141.55,,431977.13
6150,3/31/2021,3/31/2021,33121,82L-IMPORT PAYROLL,D108,HJ,142.08,,432119.21
6150,3/31/2021,3/31/2021,33121,82L-IMPORT PAYROLL,D108,HJ,142.81,,432262.02
6150,3/31/2021,3/31/2021,33121,82L-IMPORT PAYROLL,D108,HJ,142.9,,432404.92
6150,3/31/2021,3/31/2021,33121,82L-IMPORT PAYROLL,D108,HJ,144.76,,432549.68
6150,3/31/2021,3/31/2021,33121,82L-IMPORT PAYROLL,D108,HJ,145.66,,432695.34
6150,3/31/2021,3/31/2021,33121,82L-IMPORT PAYROLL,D108,HJ,146.08,,432841.42
6150,3/31/2021,3/31/2021,33121,82L-IMPORT PAYROLL,D108,HJ,155.19,,432996.61
6150,3/31/2021,3/31/2021,33121,82L-IMPORT PAYROLL,D108,HJ,155.3,,433151.91
6150,3/31/2021,3/31/2021,33121,82L-IMPORT PAYROLL,D108,HJ,155.39,,433307.3
6150,3/31/2021,3/31/2021,33121,82L-IMPORT PAYROLL,D108,HJ,165.33,,433472.63
6150,3/31/2021,3/31/2021,33121,82L-IMPORT PAYROLL,D108,HJ,167.92,,433640.55
6150,3/31/2021,3/31/2021,33121,82L-IMPORT PAYROLL,D108,HJ,178.96,,433819.51
6150,3/31/2021,3/31/2021,33121,82L-IMPORT PAYROLL,D108,HJ,192.83,,434012.34
6150,3/31/2021,3/31/2021,33121,82L-IMPORT PAYROLL,D108,HJ,196.13,,434208.47
6150,3/31/2021,3/31/2021,33121,82L-IMPORT PAYROLL,D108,HJ,198.92,,434407.39
6150,3/31/2021,3/31/2021,33121,82L-IMPORT PAYROLL,D108,HJ,226.22,,434633.61
6150,3/31/2021,3/31/2021,33121,82L-IMPORT PAYROLL,D101,HJ,15.92,,434649.53
6150,3/31/2021,3/31/2021,33121,82L-IMPORT PAYROLL,D101,HJ,17.57,,434667.1
6150,3/31/2021,3/31/2021,33121,82L-IMPORT PAYROLL,D101,HJ,17.57,,434684.67
6150,3/31/2021,3/31/2021,33121,82L-IMPORT PAYROLL,D101,HJ,17.71,,434702.38
6150,3/31/2021,3/31/2021,33121,82L-IMPORT PAYROLL,D101,HJ,29,,434731.38
6150,3/31/2021,3/31/2021,33121,82L-IMPORT PAYROLL,D101,HJ,29.24,,434760.62
6150,3/31/2021,3/31/2021,33121,82L-IMPORT PAYROLL,D101,HJ,33.51,,434794.13
6150,3/31/2021,3/31/2021,33121,82L-IMPORT PAYROLL,D101,HJ,37.18,,434831.31
6150,3/31/2021,3/31/2021,33121,82L-IMPORT PAYROLL,D101,HJ,38.11,,434869.42
6150,3/31/2021,3/31/2021,33121,82L-IMPORT PAYROLL,D101,HJ,39.27,,434908.69
6150,3/31/2021,3/31/2021,33121,82L-IMPORT PAYROLL,D101,HJ,41.08,,434949.77
6150,3/31/2021,3/31/2021,33121,82L-IMPORT PAYROLL,D101,HJ,49.84,,434999.61
6150,3/31/2021,3/31/2021,33121,82L-IMPORT PAYROLL,D101,HJ,61.63,,435061.24
6150,3/31/2021,3/31/2021,33121,82L-IMPORT PAYROLL,D101,HJ,68.09,,435129.33
6150,3/31/2021,3/31/2021,33121,82L-IMPORT PAYROLL,D101,HJ,75.71,,435205.04
6150,3/31/2021,3/31/2021,33121,82L-IMPORT PAYROLL,D101,HJ,124,,435329.04
6150,3/31/2021,3/31/2021,33121,82L-IMPORT PAYROLL,D101,HJ,125.03,,435454.07
6150,3/31/2021,3/31/2021,33121,82L-IMPORT PAYROLL,D101,HJ,143.3,,435597.37
6150,3/31/2021,3/31/2021,33121,82L-IMPORT PAYROLL,D101,HJ,159,,435756.37
6150,3/31/2021,3/31/2021,33121,82L-IMPORT PAYROLL,D101,HJ,162.94,,435919.31
6150,3/31/2021,3/31/2021,33121,82L-IMPORT PAYROLL,D101,HJ,167.92,,436087.23
6150,3/31/2021,3/31/2021,33121,82L-IMPORT PAYROLL,D101,HJ,175.67,,436262.9
6150,3/31/2021,3/31/2021,33121,82L-IMPORT PAYROLL,D101,HJ,213.13,,436476.03
6150,3/31/2021,3/31/2021,33121,82L-IMPORT PAYROLL,D102,HJ,17.61,,436493.64
6150,3/31/2021,3/31/2021,33121,82L-IMPORT PAYROLL,D102,HJ,29.41,,436523.05
6150,3/31/2021,3/31/2021,33121,82L-IMPORT PAYROLL,D102,HJ,39,,436562.05
6150,3/31/2021,3/31/2021,33121,82L-IMPORT PAYROLL,D102,HJ,61.01,,436623.06
6150,3/31/2021,3/31/2021,33121,82L-IMPORT PAYROLL,D102,HJ,125.74,,436748.8
6150,3/31/2021,3/31/2021,33121,82L-IMPORT PAYROLL,D102,HJ,166.75,,436915.55
6150,3/31/2021,3/31/2021,33121,82L-IMPORT PAYROLL,D102,HJ,260.88,,437176.43
6150,3/31/2021,3/31/2021,33121,82L-IMPORT PAYROLL,D103,HJ,31.08,,437207.51
6150,3/31/2021,3/31/2021,33121,82L-IMPORT PAYROLL,D103,HJ,33.06,,437240.57
6150,3/31/2021,3/31/2021,33121,82L-IMPORT PAYROLL,D103,HJ,43.23,,437283.8
6150,3/31/2021,3/31/2021,33121,82L-IMPORT PAYROLL,D103,HJ,93.32,,437377.12
6150,3/31/2021,3/31/2021,33121,82L-IMPORT PAYROLL,D103,HJ,132.89,,437510.01
6150,3/31/2021,3/31/2021,33121,82L-IMPORT PAYROLL,D103,HJ,141.34,,437651.35
6150,3/31/2021,3/31/2021,33121,82L-IMPORT PAYROLL,D103,HJ,184.83,,437836.18
6150,3/31/2021,3/31/2021,33121,82L-IMPORT PAYROLL,D104,HJ,26.82,,437863
6150,3/31/2021,3/31/2021,33121,82L-IMPORT PAYROLL,D104,HJ,28.71,,437891.71
6150,3/31/2021,3/31/2021,33121,82L-IMPORT PAYROLL,D104,HJ,28.82,,437920.53
6150,3/31/2021,3/31/2021,33121,82L-IMPORT PAYROLL,D104,HJ,28.93,,437949.46
6150,3/31/2021,3/31/2021,33121,82L-IMPORT PAYROLL,D104,HJ,34.12,,437983.58
6150,3/31/2021,3/31/2021,33121,82L-IMPORT PAYROLL,D104,HJ,37.03,,438020.61
6150,3/31/2021,3/31/2021,33121,82L-IMPORT PAYROLL,D104,HJ,44.1,,438064.71
6150,3/31/2021,3/31/2021,33121,82L-IMPORT PAYROLL,D104,HJ,48.16,,438112.87
6150,3/31/2021,3/31/2021,33121,82L-IMPORT PAYROLL,D104,HJ,49.71,,438162.58
6150,3/31/2021,3/31/2021,33121,82L-IMPORT PAYROLL,D104,HJ,89.68,,438252.26
6150,3/31/2021,3/31/2021,33121,82L-IMPORT PAYROLL,D104,HJ,114.66,,438366.92
6150,3/31/2021,3/31/2021,33121,82L-IMPORT PAYROLL,D104,HJ,122.75,,438489.67
6150,3/31/2021,3/31/2021,33121,82L-IMPORT PAYROLL,D104,HJ,123.23,,438612.9
6150,3/31/2021,3/31/2021,33121,82L-IMPORT PAYROLL,D104,HJ,123.72,,438736.62
6150,3/31/2021,3/31/2021,33121,82L-IMPORT PAYROLL,D104,HJ,145.9,,438882.52
6150,3/31/2021,3/31/2021,33121,82L-IMPORT PAYROLL,D104,HJ,158.35,,439040.87
6150,3/31/2021,3/31/2021,33121,82L-IMPORT PAYROLL,D104,HJ,188.58,,439229.45
6150,3/31/2021,3/31/2021,33121,82L-IMPORT PAYROLL,D104,HJ,205.92,,439435.37
6150,3/31/2021,3/31/2021,33121,82L-IMPORT PAYROLL,D104,HJ,212.55,,439647.92
6150,3/31/2021,3/31/2021,33121,82L-IMPORT PAYROLL,D105,HJ,25.57,,439673.49
6150,3/31/2021,3/31/2021,33121,82L-IMPORT PAYROLL,D105,HJ,27.79,,439701.28
6150,3/31/2021,3/31/2021,33121,82L-IMPORT PAYROLL,D105,HJ,31.18,,439732.46
6150,3/31/2021,3/31/2021,33121,82L-IMPORT PAYROLL,D105,HJ,39.93,,439772.39
6150,3/31/2021,3/31/2021,33121,82L-IMPORT PAYROLL,D105,HJ,49.87,,439822.26
6150,3/31/2021,3/31/2021,33121,82L-IMPORT PAYROLL,D105,HJ,109.31,,439931.57
6150,3/31/2021,3/31/2021,33121,82L-IMPORT PAYROLL,D105,HJ,118.83,,440050.4
6150,3/31/2021,3/31/2021,33121,82L-IMPORT PAYROLL,D105,HJ,133.3,,440183.7
6150,3/31/2021,3/31/2021,33121,82L-IMPORT PAYROLL,D105,HJ,170.75,,440354.45
6150,3/31/2021,3/31/2021,33121,82L-IMPORT PAYROLL,D105,HJ,213.25,,440567.7
6150,3/31/2021,3/31/2021,33121,82L-IMPORT PAYROLL,D107,HJ,8.28,,440575.98
6150,3/31/2021,3/31/2021,33121,82L-IMPORT PAYROLL,D107,HJ,29.28,,440605.26
6150,3/31/2021,3/31/2021,33121,82L-IMPORT PAYROLL,D107,HJ,32.19,,440637.45
6150,3/31/2021,3/31/2021,33121,82L-IMPORT PAYROLL,D107,HJ,35.41,,440672.86
6150,3/31/2021,3/31/2021,33121,82L-IMPORT PAYROLL,D107,HJ,44.45,,440717.31
6150,3/31/2021,3/31/2021,33121,82L-IMPORT PAYROLL,D107,HJ,59.45,,440776.76
6150,3/31/2021,3/31/2021,33121,82L-IMPORT PAYROLL,D107,HJ,72.42,,440849.18
6150,3/31/2021,3/31/2021,33121,82L-IMPORT PAYROLL,D107,HJ,95.23,,440944.41
6150,3/31/2021,3/31/2021,33121,82L-IMPORT PAYROLL,D107,HJ,125.21,,441069.62
6150,3/31/2021,3/31/2021,33121,82L-IMPORT PAYROLL,D107,HJ,137.65,,441207.27
6150,3/31/2021,3/31/2021,33121,82L-IMPORT PAYROLL,D107,HJ,190.1,,441397.37
6150,3/31/2021,3/31/2021,33121,82L-IMPORT PAYROLL,D107,HJ,254.23,,441651.6
6150,3/31/2021,3/31/2021,33121,82L-IMPORT PAYROLL,D107,HJ,309.64,,441961.24
6150,3/31/2021,3/31/2021,33121,82L-IMPORT PAYROLL,D107,HJ,407.22,,442368.46
6150,3/31/2021,3/31/2021,33121,82L-IMPORT PAYROLL,D109,HJ,7.66,,442376.12
6150,3/31/2021,3/31/2021,33121,82L-IMPORT PAYROLL,D109,HJ,12.55,,442388.67
6150,3/31/2021,3/31/2021,33121,82L-IMPORT PAYROLL,D109,HJ,13.42,,442402.09
6150,3/31/2021,3/31/2021,33121,82L-IMPORT PAYROLL,D109,HJ,16.5,,442418.59
6150,3/31/2021,3/31/2021,33121,82L-IMPORT PAYROLL,D109,HJ,17.68,,442436.27
6150,3/31/2021,3/31/2021,33121,82L-IMPORT PAYROLL,D109,HJ,21.75,,442458.02
6150,3/31/2021,3/31/2021,33121,82L-IMPORT PAYROLL,D109,HJ,32.74,,442490.76
6150,3/31/2021,3/31/2021,33121,82L-IMPORT PAYROLL,D109,HJ,55.91,,442546.67
6150,3/31/2021,3/31/2021,33121,82L-IMPORT PAYROLL,D109,HJ,56.19,,442602.86
6150,3/31/2021,3/31/2021,33121,82L-IMPORT PAYROLL,D109,HJ,58.24,,442661.1
6150,3/31/2021,3/31/2021,33121,82L-IMPORT PAYROLL,D109,HJ,72.5,,442733.6
6150,3/31/2021,3/31/2021,33121,82L-IMPORT PAYROLL,D109,HJ,75.61,,442809.21
6150,3/31/2021,3/31/2021,33121,82L-IMPORT PAYROLL,D109,HJ,76.2,,442885.41
6150,3/31/2021,3/31/2021,33121,82L-IMPORT PAYROLL,D109,HJ,76.2,,442961.61
6150,3/31/2021,3/31/2021,33121,82L-IMPORT PAYROLL,D109,HJ,77.94,,443039.55
6150,3/31/2021,3/31/2021,33121,82L-IMPORT PAYROLL,D109,HJ,78.54,,443118.09
6150,3/31/2021,3/31/2021,33121,82L-IMPORT PAYROLL,D109,HJ,87.24,,443205.33
6150,3/31/2021,3/31/2021,33121,82L-IMPORT PAYROLL,D109,HJ,93,,443298.33
6150,3/31/2021,3/31/2021,33121,82L-IMPORT PAYROLL,D109,HJ,239.08,,443537.41
6150,3/31/2021,3/31/2021,33121,82L-IMPORT PAYROLL,D109,HJ,240.25,,443777.66
6150,3/31/2021,3/31/2021,33121,82L-IMPORT PAYROLL,D109,HJ,249.03,,444026.69
6150,3/31/2021,3/31/2021,33121,82L-IMPORT PAYROLL,D109,HJ,310,,444336.69
6150,3/31/2021,3/31/2021,33121,82L-IMPORT PAYROLL,D109,HJ,325.8,,444662.49
6150,3/31/2021,3/31/2021,33121,82L-IMPORT PAYROLL,D109,HJ,325.8,,444988.29
6150,3/31/2021,3/31/2021,33121,82L-IMPORT PAYROLL,D109,HJ,333.27,,445321.56
6150,3/31/2021,3/31/2021,33121,82L-IMPORT PAYROLL,D109,HJ,335.83,,445657.39
6150,3/31/2021,3/31/2021,33121,82L-IMPORT PAYROLL,D109,HJ,373.03,,446030.42
6150,3/31/2021,3/31/2021,33121,82L-IMPORT PAYROLL,D111,HJ,13.49,,446043.91
6150,3/31/2021,3/31/2021,33121,82L-IMPORT PAYROLL,D111,HJ,24.01,,446067.92
6150,3/31/2021,3/31/2021,33121,82L-IMPORT PAYROLL,D111,HJ,29.45,,446097.37
6150,3/31/2021,3/31/2021,33121,82L-IMPORT PAYROLL,D111,HJ,37.06,,446134.43
6150,3/31/2021,3/31/2021,33121,82L-IMPORT PAYROLL,D111,HJ,37.17,,446171.6
6150,3/31/2021,3/31/2021,33121,82L-IMPORT PAYROLL,D111,HJ,53.01,,446224.61
6150,3/31/2021,3/31/2021,33121,82L-IMPORT PAYROLL,D111,HJ,102.68,,446327.29
6150,3/31/2021,3/31/2021,33121,82L-IMPORT PAYROLL,D111,HJ,125.93,,446453.22
6150,3/31/2021,3/31/2021,33121,82L-IMPORT PAYROLL,D111,HJ,158.45,,446611.67
6150,3/31/2021,3/31/2021,33121,82L-IMPORT PAYROLL,D111,HJ,158.92,,446770.59
6150,3/31/2021,3/31/2021,33121,82L-IMPORT PAYROLL,D111,HJ,226.68,,446997.27
6150,3/31/2021,3/31/2021,33121,82L-IMPORT PAYROLL,D112,HJ,37.96,,447035.23
6150,3/31/2021,3/31/2021,33121,82L-IMPORT PAYROLL,D112,HJ,162.32,,447197.55
6150,3/31/2021,3/31/2021,33121,82L-IMPORT PAYROLL,D108,HJ,1.64,,447199.19
6150,3/31/2021,3/31/2021,33121,82L-IMPORT PAYROLL,D108,HJ,6.95,,447206.14
6150,3/31/2021,3/31/2021,33121,82L-IMPORT PAYROLL,D108,HJ,14,,447220.14
6150,3/31/2021,3/31/2021,33121,82L-IMPORT PAYROLL,D108,HJ,14.32,,447234.46
6150,3/31/2021,3/31/2021,33121,82L-IMPORT PAYROLL,D108,HJ,15.08,,447249.54
6150,3/31/2021,3/31/2021,33121,82L-IMPORT PAYROLL,D108,HJ,15.08,,447264.62
6150,3/31/2021,3/31/2021,33121,82L-IMPORT PAYROLL,D108,HJ,15.28,,447279.9
6150,3/31/2021,3/31/2021,33121,82L-IMPORT PAYROLL,D108,HJ,15.28,,447295.18
6150,3/31/2021,3/31/2021,33121,82L-IMPORT PAYROLL,D108,HJ,15.33,,447310.51
6150,3/31/2021,3/31/2021,33121,82L-IMPORT PAYROLL,D108,HJ,16.05,,447326.56
6150,3/31/2021,3/31/2021,33121,82L-IMPORT PAYROLL,D108,HJ,16.2,,447342.76
6150,3/31/2021,3/31/2021,33121,82L-IMPORT PAYROLL,D108,HJ,16.23,,447358.99
6150,3/31/2021,3/31/2021,33121,82L-IMPORT PAYROLL,D108,HJ,16.23,,447375.22
6150,3/31/2021,3/31/2021,33121,82L-IMPORT PAYROLL,D108,HJ,16.23,,447391.45
6150,3/31/2021,3/31/2021,33121,82L-IMPORT PAYROLL,D108,HJ,16.23,,447407.68
6150,3/31/2021,3/31/2021,33121,82L-IMPORT PAYROLL,D108,HJ,16.23,,447423.91
6150,3/31/2021,3/31/2021,33121,82L-IMPORT PAYROLL,D108,HJ,16.23,,447440.14
6150,3/31/2021,3/31/2021,33121,82L-IMPORT PAYROLL,D108,HJ,16.23,,447456.37
6150,3/31/2021,3/31/2021,33121,82L-IMPORT PAYROLL,D108,HJ,16.23,,447472.6
6150,3/31/2021,3/31/2021,33121,82L-IMPORT PAYROLL,D108,HJ,16.23,,447488.83
6150,3/31/2021,3/31/2021,33121,82L-IMPORT PAYROLL,D108,HJ,16.23,,447505.06
6150,3/31/2021,3/31/2021,33121,82L-IMPORT PAYROLL,D108,HJ,16.23,,447521.29
6150,3/31/2021,3/31/2021,33121,82L-IMPORT PAYROLL,D108,HJ,16.23,,447537.52
6150,3/31/2021,3/31/2021,33121,82L-IMPORT PAYROLL,D108,HJ,16.23,,447553.75
6150,3/31/2021,3/31/2021,33121,82L-IMPORT PAYROLL,D108,HJ,16.23,,447569.98
6150,3/31/2021,3/31/2021,33121,82L-IMPORT PAYROLL,D108,HJ,16.23,,447586.21
6150,3/31/2021,3/31/2021,33121,82L-IMPORT PAYROLL,D108,HJ,16.25,,447602.46
6150,3/31/2021,3/31/2021,33121,82L-IMPORT PAYROLL,D108,HJ,16.33,,447618.79
6150,3/31/2021,3/31/2021,33121,82L-IMPORT PAYROLL,D108,HJ,16.36,,447635.15
6150,3/31/2021,3/31/2021,33121,82L-IMPORT PAYROLL,D108,HJ,28.09,,447663.24
6150,3/31/2021,3/31/2021,33121,82L-IMPORT PAYROLL,D108,HJ,30.25,,447693.49
6150,3/31/2021,3/31/2021,33121,82L-IMPORT PAYROLL,D108,HJ,32.36,,447725.85
6150,3/31/2021,3/31/2021,33121,82L-IMPORT PAYROLL,D108,HJ,33.96,,447759.81
6150,3/31/2021,3/31/2021,33121,82L-IMPORT PAYROLL,D108,HJ,34.16,,447793.97
6150,3/31/2021,3/31/2021,33121,82L-IMPORT PAYROLL,D108,HJ,34.74,,447828.71
6150,3/31/2021,3/31/2021,33121,82L-IMPORT PAYROLL,D108,HJ,34.79,,447863.5
6150,3/31/2021,3/31/2021,33121,82L-IMPORT PAYROLL,D108,HJ,35.1,,447898.6
6150,3/31/2021,3/31/2021,33121,82L-IMPORT PAYROLL,D108,HJ,35.81,,447934.41
6150,3/31/2021,3/31/2021,33121,82L-IMPORT PAYROLL,D108,HJ,36.93,,447971.34
6150,3/31/2021,3/31/2021,33121,82L-IMPORT PAYROLL,D108,HJ,41.91,,448013.25
6150,3/31/2021,3/31/2021,33121,82L-IMPORT PAYROLL,D108,HJ,54.34,,448067.59
6150,3/31/2021,3/31/2021,33121,82L-IMPORT PAYROLL,D108,HJ,59.86,,448127.45
6150,3/31/2021,3/31/2021,33121,82L-IMPORT PAYROLL,D108,HJ,61.22,,448188.67
6150,3/31/2021,3/31/2021,33121,82L-IMPORT PAYROLL,D108,HJ,64.5,,448253.17
6150,3/31/2021,3/31/2021,33121,82L-IMPORT PAYROLL,D108,HJ,64.5,,448317.67
6150,3/31/2021,3/31/2021,33121,82L-IMPORT PAYROLL,D108,HJ,65.35,,448383.02
6150,3/31/2021,3/31/2021,33121,82L-IMPORT PAYROLL,D108,HJ,65.35,,448448.37
6150,3/31/2021,3/31/2021,33121,82L-IMPORT PAYROLL,D108,HJ,68.64,,448517.01
6150,3/31/2021,3/31/2021,33121,82L-IMPORT PAYROLL,D108,HJ,69.27,,448586.28
6150,3/31/2021,3/31/2021,33121,82L-IMPORT PAYROLL,D108,HJ,69.38,,448655.66
6150,3/31/2021,3/31/2021,33121,82L-IMPORT PAYROLL,D108,HJ,69.38,,448725.04
6150,3/31/2021,3/31/2021,33121,82L-IMPORT PAYROLL,D108,HJ,69.38,,448794.42
6150,3/31/2021,3/31/2021,33121,82L-IMPORT PAYROLL,D108,HJ,69.38,,448863.8
6150,3/31/2021,3/31/2021,33121,82L-IMPORT PAYROLL,D108,HJ,69.38,,448933.18
6150,3/31/2021,3/31/2021,33121,82L-IMPORT PAYROLL,D108,HJ,69.38,,449002.56
6150,3/31/2021,3/31/2021,33121,82L-IMPORT PAYROLL,D108,HJ,69.38,,449071.94
6150,3/31/2021,3/31/2021,33121,82L-IMPORT PAYROLL,D108,HJ,69.38,,449141.32
6150,3/31/2021,3/31/2021,33121,82L-IMPORT PAYROLL,D108,HJ,69.38,,449210.7
6150,3/31/2021,3/31/2021,33121,82L-IMPORT PAYROLL,D108,HJ,69.38,,449280.08
6150,3/31/2021,3/31/2021,33121,82L-IMPORT PAYROLL,D108,HJ,69.38,,449349.46
6150,3/31/2021,3/31/2021,33121,82L-IMPORT PAYROLL,D108,HJ,69.38,,449418.84
6150,3/31/2021,3/31/2021,33121,82L-IMPORT PAYROLL,D108,HJ,69.38,,449488.22
6150,3/31/2021,3/31/2021,33121,82L-IMPORT PAYROLL,D108,HJ,69.38,,449557.6
6150,3/31/2021,3/31/2021,33121,82L-IMPORT PAYROLL,D108,HJ,69.38,,449626.98
6150,3/31/2021,3/31/2021,33121,82L-IMPORT PAYROLL,D108,HJ,69.47,,449696.45
6150,3/31/2021,3/31/2021,33121,82L-IMPORT PAYROLL,D108,HJ,69.84,,449766.29
6150,3/31/2021,3/31/2021,33121,82L-IMPORT PAYROLL,D108,HJ,69.95,,449836.24
6150,3/31/2021,3/31/2021,33121,82L-IMPORT PAYROLL,D108,HJ,81.75,,449917.99
6150,3/31/2021,3/31/2021,33121,82L-IMPORT PAYROLL,D108,HJ,83.98,,450001.97
6150,3/31/2021,3/31/2021,33121,82L-IMPORT PAYROLL,D108,HJ,83.98,,450085.95
6150,3/31/2021,3/31/2021,33121,82L-IMPORT PAYROLL,D108,HJ,95.69,,450181.64
6150,3/31/2021,3/31/2021,33121,82L-IMPORT PAYROLL,D108,HJ,95.81,,450277.45
6150,3/31/2021,3/31/2021,33121,82L-IMPORT PAYROLL,D108,HJ,97.88,,450375.33
6150,3/31/2021,3/31/2021,33121,82L-IMPORT PAYROLL,D108,HJ,138.38,,450513.71
6150,3/31/2021,3/31/2021,33121,82L-IMPORT PAYROLL,D108,HJ,145.23,,450658.94
6150,3/31/2021,3/31/2021,33121,82L-IMPORT PAYROLL,D108,HJ,146.08,,450805.02
6150,3/31/2021,3/31/2021,33121,82L-IMPORT PAYROLL,D108,HJ,148.53,,450953.55
6150,3/31/2021,3/31/2021,33121,82L-IMPORT PAYROLL,D108,HJ,148.76,,451102.31
6150,3/31/2021,3/31/2021,33121,82L-IMPORT PAYROLL,D108,HJ,150.1,,451252.41
6150,3/31/2021,3/31/2021,33121,82L-IMPORT PAYROLL,D108,HJ,179.22,,451431.63
6150,3/31/2021,3/31/2021,33121,82L-IMPORT PAYROLL,D108,HJ,222.75,,451654.38
6150,3/31/2021,3/31/2021,33121,82L-IMPORT PAYROLL,D108,HJ,232.34,,451886.72
6150,3/31/2021,3/31/2021,33121,82L-IMPORT PAYROLL,D108,HJ,349.56,,452236.28
6150,3/31/2021,3/31/2021,33121,82L-IMPORT PAYROLL,D108,HJ,359.08,,452595.36
6150,3/31/2021,3/31/2021,33121,82L-IMPORT PAYROLL,D108,HJ,359.08,,452954.44
6150,3/31/2021,3/31/2021,33121,82L-IMPORT PAYROLL,D108,HJ,409.16,,453363.6
6150,3/31/2021,3/31/2021,33121,82L-IMPORT PAYROLL,D108,HJ,409.69,,453773.29
6150,3/31/2021,3/31/2021,33121,82L-IMPORT PAYROLL,D108,HJ,418.5,,454191.79
6150,3/31/2021,3/31/2021,33121,82L-IMPORT PAYROLL,D108,HJ,16.53,,454208.32
6150,3/31/2021,3/31/2021,33121,82L-IMPORT PAYROLL,D108,HJ,19.38,,454227.7
6150,3/31/2021,3/31/2021,33121,82L-IMPORT PAYROLL,D108,HJ,37.75,,454265.45
6150,3/31/2021,3/31/2021,33121,82L-IMPORT PAYROLL,D108,HJ,38.07,,454303.52
6150,3/31/2021,3/31/2021,33121,82L-IMPORT PAYROLL,D108,HJ,38.67,,454342.19
6150,3/31/2021,3/31/2021,33121,82L-IMPORT PAYROLL,D108,HJ,42.91,,454385.1
6150,3/31/2021,3/31/2021,33121,82L-IMPORT PAYROLL,D108,HJ,75.91,,454461.01
6150,3/31/2021,3/31/2021,33121,82L-IMPORT PAYROLL,D108,HJ,161.4,,454622.41
6150,3/31/2021,3/31/2021,33121,82L-IMPORT PAYROLL,D108,HJ,162.79,,454785.2
6150,3/31/2021,3/31/2021,33121,82L-IMPORT PAYROLL,D108,HJ,165.33,,454950.53
6150,3/31/2021,3/31/2021,33121,82L-IMPORT PAYROLL,D108,HJ,183.48,,455134.01
6150,3/31/2021,3/31/2021,33121,82L-IMPORT PAYROLL,D108,HJ,324.59,,455458.6
6150,4/7/2021,4/7/2021,ADP,ADP state UI filings and penalties April 2021,D104,HJ,34.87,,455493.47
6150,4/7/2021,4/7/2021,ADP,ADP state UI filings and penalties April 2021,D104,HJ,151.08,,455644.55
6150,4/7/2021,4/7/2021,ADP,ADP state UI filings and penalties April 2021,D104,HJ,976.24,,456620.79
6150,4/12/2021,4/12/2021,ADP,ADP state UI filings and penalties April 2021,D104,HJ,41.89,,456662.68
6150,4/12/2021,4/12/2021,ADP,ADP state UI filings and penalties April 2021,D104,HJ,181.52,,456844.2
6150,4/12/2021,4/12/2021,ADP,ADP state UI filings and penalties April 2021,D104,HJ,1172.9,,458017.1
6150,4/15/2021,4/15/2021,41521,82L-IMPORT PAYROLL,D108,HJ,10.69,,458027.79
6150,4/15/2021,4/15/2021,41521,82L-IMPORT PAYROLL,D108,HJ,13.88,,458041.67
6150,4/15/2021,4/15/2021,41521,82L-IMPORT PAYROLL,D108,HJ,14.01,,458055.68
6150,4/15/2021,4/15/2021,41521,82L-IMPORT PAYROLL,D108,HJ,14.01,,458069.69
6150,4/15/2021,4/15/2021,41521,82L-IMPORT PAYROLL,D108,HJ,14.01,,458083.7
6150,4/15/2021,4/15/2021,41521,82L-IMPORT PAYROLL,D108,HJ,14.05,,458097.75
6150,4/15/2021,4/15/2021,41521,82L-IMPORT PAYROLL,D108,HJ,14.25,,458112
6150,4/15/2021,4/15/2021,41521,82L-IMPORT PAYROLL,D108,HJ,14.25,,458126.25
6150,4/15/2021,4/15/2021,41521,82L-IMPORT PAYROLL,D108,HJ,14.25,,458140.5
6150,4/15/2021,4/15/2021,41521,82L-IMPORT PAYROLL,D108,HJ,14.65,,458155.15
6150,4/15/2021,4/15/2021,41521,82L-IMPORT PAYROLL,D108,HJ,14.98,,458170.13
6150,4/15/2021,4/15/2021,41521,82L-IMPORT PAYROLL,D108,HJ,14.99,,458185.12
6150,4/15/2021,4/15/2021,41521,82L-IMPORT PAYROLL,D108,HJ,15.16,,458200.28
6150,4/15/2021,4/15/2021,41521,82L-IMPORT PAYROLL,D108,HJ,15.19,,458215.47
6150,4/15/2021,4/15/2021,41521,82L-IMPORT PAYROLL,D108,HJ,15.19,,458230.66
6150,4/15/2021,4/15/2021,41521,82L-IMPORT PAYROLL,D108,HJ,15.19,,458245.85
6150,4/15/2021,4/15/2021,41521,82L-IMPORT PAYROLL,D108,HJ,15.19,,458261.04
6150,4/15/2021,4/15/2021,41521,82L-IMPORT PAYROLL,D108,HJ,15.19,,458276.23
6150,4/15/2021,4/15/2021,41521,82L-IMPORT PAYROLL,D108,HJ,15.19,,458291.42
6150,4/15/2021,4/15/2021,41521,82L-IMPORT PAYROLL,D108,HJ,15.19,,458306.61
6150,4/15/2021,4/15/2021,41521,82L-IMPORT PAYROLL,D108,HJ,15.19,,458321.8
6150,4/15/2021,4/15/2021,41521,82L-IMPORT PAYROLL,D108,HJ,15.19,,458336.99
6150,4/15/2021,4/15/2021,41521,82L-IMPORT PAYROLL,D108,HJ,15.19,,458352.18
6150,4/15/2021,4/15/2021,41521,82L-IMPORT PAYROLL,D108,HJ,15.19,,458367.37
6150,4/15/2021,4/15/2021,41521,82L-IMPORT PAYROLL,D108,HJ,15.19,,458382.56
6150,4/15/2021,4/15/2021,41521,82L-IMPORT PAYROLL,D108,HJ,15.19,,458397.75
6150,4/15/2021,4/15/2021,41521,82L-IMPORT PAYROLL,D108,HJ,15.19,,458412.94
6150,4/15/2021,4/15/2021,41521,82L-IMPORT PAYROLL,D108,HJ,15.19,,458428.13
6150,4/15/2021,4/15/2021,41521,82L-IMPORT PAYROLL,D108,HJ,15.19,,458443.32
6150,4/15/2021,4/15/2021,41521,82L-IMPORT PAYROLL,D108,HJ,15.72,,458459.04
6150,4/15/2021,4/15/2021,41521,82L-IMPORT PAYROLL,D108,HJ,15.81,,458474.85
6150,4/15/2021,4/15/2021,41521,82L-IMPORT PAYROLL,D108,HJ,17.99,,458492.84
6150,4/15/2021,4/15/2021,41521,82L-IMPORT PAYROLL,D108,HJ,19.29,,458512.13
6150,4/15/2021,4/15/2021,41521,82L-IMPORT PAYROLL,D108,HJ,20.14,,458532.27
6150,4/15/2021,4/15/2021,41521,82L-IMPORT PAYROLL,D108,HJ,24.56,,458556.83
6150,4/15/2021,4/15/2021,41521,82L-IMPORT PAYROLL,D108,HJ,25,,458581.83
6150,4/15/2021,4/15/2021,41521,82L-IMPORT PAYROLL,D108,HJ,25,,458606.83
6150,4/15/2021,4/15/2021,41521,82L-IMPORT PAYROLL,D108,HJ,25,,458631.83
6150,4/15/2021,4/15/2021,41521,82L-IMPORT PAYROLL,D108,HJ,25,,458656.83
6150,4/15/2021,4/15/2021,41521,82L-IMPORT PAYROLL,D108,HJ,26.08,,458682.91
6150,4/15/2021,4/15/2021,41521,82L-IMPORT PAYROLL,D108,HJ,26.08,,458708.99
6150,4/15/2021,4/15/2021,41521,82L-IMPORT PAYROLL,D108,HJ,26.16,,458735.15
6150,4/15/2021,4/15/2021,41521,82L-IMPORT PAYROLL,D108,HJ,26.53,,458761.68
6150,4/15/2021,4/15/2021,41521,82L-IMPORT PAYROLL,D108,HJ,26.53,,458788.21
6150,4/15/2021,4/15/2021,41521,82L-IMPORT PAYROLL,D108,HJ,26.53,,458814.74
6150,4/15/2021,4/15/2021,41521,82L-IMPORT PAYROLL,D108,HJ,27.59,,458842.33
6150,4/15/2021,4/15/2021,41521,82L-IMPORT PAYROLL,D108,HJ,27.84,,458870.17
6150,4/15/2021,4/15/2021,41521,82L-IMPORT PAYROLL,D108,HJ,28.29,,458898.46
6150,4/15/2021,4/15/2021,41521,82L-IMPORT PAYROLL,D108,HJ,28.29,,458926.75
6150,4/15/2021,4/15/2021,41521,82L-IMPORT PAYROLL,D108,HJ,29,,458955.75
6150,4/15/2021,4/15/2021,41521,82L-IMPORT PAYROLL,D108,HJ,30.21,,458985.96
6150,4/15/2021,4/15/2021,41521,82L-IMPORT PAYROLL,D108,HJ,31.31,,459017.27
6150,4/15/2021,4/15/2021,41521,82L-IMPORT PAYROLL,D108,HJ,31.43,,459048.7
6150,4/15/2021,4/15/2021,41521,82L-IMPORT PAYROLL,D108,HJ,32.46,,459081.16
6150,4/15/2021,4/15/2021,41521,82L-IMPORT PAYROLL,D108,HJ,33.58,,459114.74
6150,4/15/2021,4/15/2021,41521,82L-IMPORT PAYROLL,D108,HJ,34.63,,459149.37
6150,4/15/2021,4/15/2021,41521,82L-IMPORT PAYROLL,D108,HJ,36.15,,459185.52
6150,4/15/2021,4/15/2021,41521,82L-IMPORT PAYROLL,D108,HJ,36.25,,459221.77
6150,4/15/2021,4/15/2021,41521,82L-IMPORT PAYROLL,D108,HJ,36.67,,459258.44
6150,4/15/2021,4/15/2021,41521,82L-IMPORT PAYROLL,D108,HJ,38.17,,459296.61
6150,4/15/2021,4/15/2021,41521,82L-IMPORT PAYROLL,D108,HJ,59.89,,459356.5
6150,4/15/2021,4/15/2021,41521,82L-IMPORT PAYROLL,D108,HJ,59.89,,459416.39
6150,4/15/2021,4/15/2021,41521,82L-IMPORT PAYROLL,D108,HJ,59.89,,459476.28
6150,4/15/2021,4/15/2021,41521,82L-IMPORT PAYROLL,D108,HJ,60.07,,459536.35
6150,4/15/2021,4/15/2021,41521,82L-IMPORT PAYROLL,D108,HJ,60.92,,459597.27
6150,4/15/2021,4/15/2021,41521,82L-IMPORT PAYROLL,D108,HJ,60.92,,459658.19
6150,4/15/2021,4/15/2021,41521,82L-IMPORT PAYROLL,D108,HJ,60.92,,459719.11
6150,4/15/2021,4/15/2021,41521,82L-IMPORT PAYROLL,D108,HJ,62.62,,459781.73
6150,4/15/2021,4/15/2021,41521,82L-IMPORT PAYROLL,D108,HJ,64.03,,459845.76
6150,4/15/2021,4/15/2021,41521,82L-IMPORT PAYROLL,D108,HJ,64.1,,459909.86
6150,4/15/2021,4/15/2021,41521,82L-IMPORT PAYROLL,D108,HJ,64.84,,459974.7
6150,4/15/2021,4/15/2021,41521,82L-IMPORT PAYROLL,D108,HJ,64.95,,460039.65
6150,4/15/2021,4/15/2021,41521,82L-IMPORT PAYROLL,D108,HJ,64.95,,460104.6
6150,4/15/2021,4/15/2021,41521,82L-IMPORT PAYROLL,D108,HJ,64.95,,460169.55
6150,4/15/2021,4/15/2021,41521,82L-IMPORT PAYROLL,D108,HJ,64.95,,460234.5
6150,4/15/2021,4/15/2021,41521,82L-IMPORT PAYROLL,D108,HJ,64.95,,460299.45
6150,4/15/2021,4/15/2021,41521,82L-IMPORT PAYROLL,D108,HJ,64.95,,460364.4
6150,4/15/2021,4/15/2021,41521,82L-IMPORT PAYROLL,D108,HJ,64.95,,460429.35
6150,4/15/2021,4/15/2021,41521,82L-IMPORT PAYROLL,D108,HJ,64.95,,460494.3
6150,4/15/2021,4/15/2021,41521,82L-IMPORT PAYROLL,D108,HJ,64.95,,460559.25
6150,4/15/2021,4/15/2021,41521,82L-IMPORT PAYROLL,D108,HJ,64.95,,460624.2
6150,4/15/2021,4/15/2021,41521,82L-IMPORT PAYROLL,D108,HJ,64.95,,460689.15
6150,4/15/2021,4/15/2021,41521,82L-IMPORT PAYROLL,D108,HJ,64.95,,460754.1
6150,4/15/2021,4/15/2021,41521,82L-IMPORT PAYROLL,D108,HJ,64.95,,460819.05
6150,4/15/2021,4/15/2021,41521,82L-IMPORT PAYROLL,D108,HJ,64.95,,460884
6150,4/15/2021,4/15/2021,41521,82L-IMPORT PAYROLL,D108,HJ,64.95,,460948.95
6150,4/15/2021,4/15/2021,41521,82L-IMPORT PAYROLL,D108,HJ,64.95,,461013.9
6150,4/15/2021,4/15/2021,41521,82L-IMPORT PAYROLL,D108,HJ,67.22,,461081.12
6150,4/15/2021,4/15/2021,41521,82L-IMPORT PAYROLL,D108,HJ,67.58,,461148.7
6150,4/15/2021,4/15/2021,41521,82L-IMPORT PAYROLL,D108,HJ,71.08,,461219.78
6150,4/15/2021,4/15/2021,41521,82L-IMPORT PAYROLL,D108,HJ,80.62,,461300.4
6150,4/15/2021,4/15/2021,41521,82L-IMPORT PAYROLL,D108,HJ,117.98,,461418.38
6150,4/15/2021,4/15/2021,41521,82L-IMPORT PAYROLL,D108,HJ,119.05,,461537.43
6150,4/15/2021,4/15/2021,41521,82L-IMPORT PAYROLL,D108,HJ,124,,461661.43
6150,4/15/2021,4/15/2021,41521,82L-IMPORT PAYROLL,D108,HJ,129.17,,461790.6
6150,4/15/2021,4/15/2021,41521,82L-IMPORT PAYROLL,D108,HJ,138.81,,461929.41
6150,4/15/2021,4/15/2021,41521,82L-IMPORT PAYROLL,D108,HJ,143.59,,462073
6150,4/15/2021,4/15/2021,41521,82L-IMPORT PAYROLL,D108,HJ,148.06,,462221.06
6150,4/15/2021,4/15/2021,41521,82L-IMPORT PAYROLL,D108,HJ,155,,462376.06
6150,4/15/2021,4/15/2021,41521,82L-IMPORT PAYROLL,D108,HJ,163.23,,462539.29
6150,4/15/2021,4/15/2021,41521,82L-IMPORT PAYROLL,D108,HJ,28.43,,462567.72
6150,4/15/2021,4/15/2021,41521,82L-IMPORT PAYROLL,D108,HJ,29.69,,462597.41
6150,4/15/2021,4/15/2021,41521,82L-IMPORT PAYROLL,D108,HJ,31.22,,462628.63
6150,4/15/2021,4/15/2021,41521,82L-IMPORT PAYROLL,D108,HJ,32.04,,462660.67
6150,4/15/2021,4/15/2021,41521,82L-IMPORT PAYROLL,D108,HJ,32.86,,462693.53
6150,4/15/2021,4/15/2021,41521,82L-IMPORT PAYROLL,D108,HJ,32.9,,462726.43
6150,4/15/2021,4/15/2021,41521,82L-IMPORT PAYROLL,D108,HJ,33.03,,462759.46
6150,4/15/2021,4/15/2021,41521,82L-IMPORT PAYROLL,D108,HJ,33.1,,462792.56
6150,4/15/2021,4/15/2021,41521,82L-IMPORT PAYROLL,D108,HJ,33.23,,462825.79
6150,4/15/2021,4/15/2021,41521,82L-IMPORT PAYROLL,D108,HJ,33.4,,462859.19
6150,4/15/2021,4/15/2021,41521,82L-IMPORT PAYROLL,D108,HJ,33.42,,462892.61
6150,4/15/2021,4/15/2021,41521,82L-IMPORT PAYROLL,D108,HJ,33.86,,462926.47
6150,4/15/2021,4/15/2021,41521,82L-IMPORT PAYROLL,D108,HJ,34.07,,462960.54
6150,4/15/2021,4/15/2021,41521,82L-IMPORT PAYROLL,D108,HJ,34.16,,462994.7
6150,4/15/2021,4/15/2021,41521,82L-IMPORT PAYROLL,D108,HJ,36.3,,463031
6150,4/15/2021,4/15/2021,41521,82L-IMPORT PAYROLL,D108,HJ,36.32,,463067.32
6150,4/15/2021,4/15/2021,41521,82L-IMPORT PAYROLL,D108,HJ,36.34,,463103.66
6150,4/15/2021,4/15/2021,41521,82L-IMPORT PAYROLL,D108,HJ,38.67,,463142.33
6150,4/15/2021,4/15/2021,41521,82L-IMPORT PAYROLL,D108,HJ,39.27,,463181.6
6150,4/15/2021,4/15/2021,41521,82L-IMPORT PAYROLL,D108,HJ,41.85,,463223.45
6150,4/15/2021,4/15/2021,41521,82L-IMPORT PAYROLL,D108,HJ,45.87,,463269.32
6150,4/15/2021,4/15/2021,41521,82L-IMPORT PAYROLL,D108,HJ,46.52,,463315.84
6150,4/15/2021,4/15/2021,41521,82L-IMPORT PAYROLL,D108,HJ,52.91,,463368.75
6150,4/15/2021,4/15/2021,41521,82L-IMPORT PAYROLL,D108,HJ,121.55,,463490.3
6150,4/15/2021,4/15/2021,41521,82L-IMPORT PAYROLL,D108,HJ,126.93,,463617.23
6150,4/15/2021,4/15/2021,41521,82L-IMPORT PAYROLL,D108,HJ,133.51,,463750.74
6150,4/15/2021,4/15/2021,41521,82L-IMPORT PAYROLL,D108,HJ,137,,463887.74
6150,4/15/2021,4/15/2021,41521,82L-IMPORT PAYROLL,D108,HJ,140.49,,464028.23
6150,4/15/2021,4/15/2021,41521,82L-IMPORT PAYROLL,D108,HJ,140.68,,464168.91
6150,4/15/2021,4/15/2021,41521,82L-IMPORT PAYROLL,D108,HJ,141.23,,464310.14
6150,4/15/2021,4/15/2021,41521,82L-IMPORT PAYROLL,D108,HJ,141.55,,464451.69
6150,4/15/2021,4/15/2021,41521,82L-IMPORT PAYROLL,D108,HJ,142.08,,464593.77
6150,4/15/2021,4/15/2021,41521,82L-IMPORT PAYROLL,D108,HJ,142.81,,464736.58
6150,4/15/2021,4/15/2021,41521,82L-IMPORT PAYROLL,D108,HJ,142.9,,464879.48
6150,4/15/2021,4/15/2021,41521,82L-IMPORT PAYROLL,D108,HJ,144.76,,465024.24
6150,4/15/2021,4/15/2021,41521,82L-IMPORT PAYROLL,D108,HJ,145.66,,465169.9
6150,4/15/2021,4/15/2021,41521,82L-IMPORT PAYROLL,D108,HJ,146.08,,465315.98
6150,4/15/2021,4/15/2021,41521,82L-IMPORT PAYROLL,D108,HJ,155.19,,465471.17
6150,4/15/2021,4/15/2021,41521,82L-IMPORT PAYROLL,D108,HJ,155.3,,465626.47
6150,4/15/2021,4/15/2021,41521,82L-IMPORT PAYROLL,D108,HJ,155.39,,465781.86
6150,4/15/2021,4/15/2021,41521,82L-IMPORT PAYROLL,D108,HJ,165.33,,465947.19
6150,4/15/2021,4/15/2021,41521,82L-IMPORT PAYROLL,D108,HJ,167.92,,466115.11
6150,4/15/2021,4/15/2021,41521,82L-IMPORT PAYROLL,D108,HJ,178.96,,466294.07
6150,4/15/2021,4/15/2021,41521,82L-IMPORT PAYROLL,D108,HJ,196.13,,466490.2
6150,4/15/2021,4/15/2021,41521,82L-IMPORT PAYROLL,D108,HJ,198.92,,466689.12
6150,4/15/2021,4/15/2021,41521,82L-IMPORT PAYROLL,D108,HJ,226.22,,466915.34
6150,4/15/2021,4/15/2021,41521,82L-IMPORT PAYROLL,D101,HJ,15.92,,466931.26
6150,4/15/2021,4/15/2021,41521,82L-IMPORT PAYROLL,D101,HJ,17.57,,466948.83
6150,4/15/2021,4/15/2021,41521,82L-IMPORT PAYROLL,D101,HJ,17.57,,466966.4
6150,4/15/2021,4/15/2021,41521,82L-IMPORT PAYROLL,D101,HJ,17.71,,466984.11
6150,4/15/2021,4/15/2021,41521,82L-IMPORT PAYROLL,D101,HJ,29,,467013.11
6150,4/15/2021,4/15/2021,41521,82L-IMPORT PAYROLL,D101,HJ,29.5,,467042.61
6150,4/15/2021,4/15/2021,41521,82L-IMPORT PAYROLL,D101,HJ,33.51,,467076.12
6150,4/15/2021,4/15/2021,41521,82L-IMPORT PAYROLL,D101,HJ,37.18,,467113.3
6150,4/15/2021,4/15/2021,41521,82L-IMPORT PAYROLL,D101,HJ,38.11,,467151.41
6150,4/15/2021,4/15/2021,41521,82L-IMPORT PAYROLL,D101,HJ,39.27,,467190.68
6150,4/15/2021,4/15/2021,41521,82L-IMPORT PAYROLL,D101,HJ,41.08,,467231.76
6150,4/15/2021,4/15/2021,41521,82L-IMPORT PAYROLL,D101,HJ,49.84,,467281.6
6150,4/15/2021,4/15/2021,41521,82L-IMPORT PAYROLL,D101,HJ,68.09,,467349.69
6150,4/15/2021,4/15/2021,41521,82L-IMPORT PAYROLL,D101,HJ,75.71,,467425.4
6150,4/15/2021,4/15/2021,41521,82L-IMPORT PAYROLL,D101,HJ,124,,467549.4
6150,4/15/2021,4/15/2021,41521,82L-IMPORT PAYROLL,D101,HJ,126.14,,467675.54
6150,4/15/2021,4/15/2021,41521,82L-IMPORT PAYROLL,D101,HJ,143.3,,467818.84
6150,4/15/2021,4/15/2021,41521,82L-IMPORT PAYROLL,D101,HJ,159,,467977.84
6150,4/15/2021,4/15/2021,41521,82L-IMPORT PAYROLL,D101,HJ,162.94,,468140.78
6150,4/15/2021,4/15/2021,41521,82L-IMPORT PAYROLL,D101,HJ,167.92,,468308.7
6150,4/15/2021,4/15/2021,41521,82L-IMPORT PAYROLL,D101,HJ,175.67,,468484.37
6150,4/15/2021,4/15/2021,41521,82L-IMPORT PAYROLL,D101,HJ,213.13,,468697.5
6150,4/15/2021,4/15/2021,41521,82L-IMPORT PAYROLL,D102,HJ,29.41,,468726.91
6150,4/15/2021,4/15/2021,41521,82L-IMPORT PAYROLL,D102,HJ,30.38,,468757.29
6150,4/15/2021,4/15/2021,41521,82L-IMPORT PAYROLL,D102,HJ,39,,468796.29
6150,4/15/2021,4/15/2021,41521,82L-IMPORT PAYROLL,D102,HJ,125.74,,468922.03
6150,4/15/2021,4/15/2021,41521,82L-IMPORT PAYROLL,D102,HJ,129.91,,469051.94
6150,4/15/2021,4/15/2021,41521,82L-IMPORT PAYROLL,D102,HJ,166.75,,469218.69
6150,4/15/2021,4/15/2021,41521,82L-IMPORT PAYROLL,D103,HJ,31.08,,469249.77
6150,4/15/2021,4/15/2021,41521,82L-IMPORT PAYROLL,D103,HJ,33.06,,469282.83
6150,4/15/2021,4/15/2021,41521,82L-IMPORT PAYROLL,D103,HJ,55.31,,469338.14
6150,4/15/2021,4/15/2021,41521,82L-IMPORT PAYROLL,D103,HJ,132.89,,469471.03
6150,4/15/2021,4/15/2021,41521,82L-IMPORT PAYROLL,D103,HJ,141.34,,469612.37
6150,4/15/2021,4/15/2021,41521,82L-IMPORT PAYROLL,D103,HJ,147.76,,469760.13
6150,4/15/2021,4/15/2021,41521,82L-IMPORT PAYROLL,D103,HJ,236.5,,469996.63
6150,4/15/2021,4/15/2021,41521,82L-IMPORT PAYROLL,D104,HJ,26.09,,470022.72
6150,4/15/2021,4/15/2021,41521,82L-IMPORT PAYROLL,D104,HJ,27.98,,470050.7
6150,4/15/2021,4/15/2021,41521,82L-IMPORT PAYROLL,D104,HJ,28.09,,470078.79
6150,4/15/2021,4/15/2021,41521,82L-IMPORT PAYROLL,D104,HJ,28.93,,470107.72
6150,4/15/2021,4/15/2021,41521,82L-IMPORT PAYROLL,D104,HJ,34.12,,470141.84
6150,4/15/2021,4/15/2021,41521,82L-IMPORT PAYROLL,D104,HJ,37.03,,470178.87
6150,4/15/2021,4/15/2021,41521,82L-IMPORT PAYROLL,D104,HJ,38.13,,470217
6150,4/15/2021,4/15/2021,41521,82L-IMPORT PAYROLL,D104,HJ,40.2,,470257.2
6150,4/15/2021,4/15/2021,41521,82L-IMPORT PAYROLL,D104,HJ,49.71,,470306.91
6150,4/15/2021,4/15/2021,41521,82L-IMPORT PAYROLL,D104,HJ,74.85,,470381.76
6150,4/15/2021,4/15/2021,41521,82L-IMPORT PAYROLL,D104,HJ,111.56,,470493.32
6150,4/15/2021,4/15/2021,41521,82L-IMPORT PAYROLL,D104,HJ,119.65,,470612.97
6150,4/15/2021,4/15/2021,41521,82L-IMPORT PAYROLL,D104,HJ,120.13,,470733.1
6150,4/15/2021,4/15/2021,41521,82L-IMPORT PAYROLL,D104,HJ,123.72,,470856.82
6150,4/15/2021,4/15/2021,41521,82L-IMPORT PAYROLL,D104,HJ,145.9,,471002.72
6150,4/15/2021,4/15/2021,41521,82L-IMPORT PAYROLL,D104,HJ,158.35,,471161.07
6150,4/15/2021,4/15/2021,41521,82L-IMPORT PAYROLL,D104,HJ,163.06,,471324.13
6150,4/15/2021,4/15/2021,41521,82L-IMPORT PAYROLL,D104,HJ,171.87,,471496
6150,4/15/2021,4/15/2021,41521,82L-IMPORT PAYROLL,D104,HJ,212.55,,471708.55
6150,4/15/2021,4/15/2021,41521,82L-IMPORT PAYROLL,D105,HJ,25.57,,471734.12
6150,4/15/2021,4/15/2021,41521,82L-IMPORT PAYROLL,D105,HJ,27.79,,471761.91
6150,4/15/2021,4/15/2021,41521,82L-IMPORT PAYROLL,D105,HJ,31.18,,471793.09
6150,4/15/2021,4/15/2021,41521,82L-IMPORT PAYROLL,D105,HJ,39.93,,471833.02
6150,4/15/2021,4/15/2021,41521,82L-IMPORT PAYROLL,D105,HJ,49.87,,471882.89
6150,4/15/2021,4/15/2021,41521,82L-IMPORT PAYROLL,D105,HJ,109.31,,471992.2
6150,4/15/2021,4/15/2021,41521,82L-IMPORT PAYROLL,D105,HJ,118.83,,472111.03
6150,4/15/2021,4/15/2021,41521,82L-IMPORT PAYROLL,D105,HJ,133.3,,472244.33
6150,4/15/2021,4/15/2021,41521,82L-IMPORT PAYROLL,D105,HJ,170.75,,472415.08
6150,4/15/2021,4/15/2021,41521,82L-IMPORT PAYROLL,D105,HJ,213.25,,472628.33
6150,4/15/2021,4/15/2021,41521,82L-IMPORT PAYROLL,D107,HJ,9.32,,472637.65
6150,4/15/2021,4/15/2021,41521,82L-IMPORT PAYROLL,D107,HJ,28.4,,472666.05
6150,4/15/2021,4/15/2021,41521,82L-IMPORT PAYROLL,D107,HJ,34.5,,472700.55
6150,4/15/2021,4/15/2021,41521,82L-IMPORT PAYROLL,D107,HJ,39.84,,472740.39
6150,4/15/2021,4/15/2021,41521,82L-IMPORT PAYROLL,D107,HJ,42.15,,472782.54
6150,4/15/2021,4/15/2021,41521,82L-IMPORT PAYROLL,D107,HJ,60.34,,472842.88
6150,4/15/2021,4/15/2021,41521,82L-IMPORT PAYROLL,D107,HJ,72.42,,472915.3
6150,4/15/2021,4/15/2021,41521,82L-IMPORT PAYROLL,D107,HJ,94.2,,473009.5
6150,4/15/2021,4/15/2021,41521,82L-IMPORT PAYROLL,D107,HJ,121.43,,473130.93
6150,4/15/2021,4/15/2021,41521,82L-IMPORT PAYROLL,D107,HJ,147.5,,473278.43
6150,4/15/2021,4/15/2021,41521,82L-IMPORT PAYROLL,D107,HJ,180.26,,473458.69
6150,4/15/2021,4/15/2021,41521,82L-IMPORT PAYROLL,D107,HJ,258.02,,473716.71
6150,4/15/2021,4/15/2021,41521,82L-IMPORT PAYROLL,D107,HJ,309.64,,474026.35
6150,4/15/2021,4/15/2021,41521,82L-IMPORT PAYROLL,D107,HJ,402.8,,474429.15
6150,4/15/2021,4/15/2021,41521,82L-IMPORT PAYROLL,D109,HJ,7.98,,474437.13
6150,4/15/2021,4/15/2021,41521,82L-IMPORT PAYROLL,D109,HJ,13.07,,474450.2
6150,4/15/2021,4/15/2021,41521,82L-IMPORT PAYROLL,D109,HJ,16.06,,474466.26
6150,4/15/2021,4/15/2021,41521,82L-IMPORT PAYROLL,D109,HJ,16.5,,474482.76
6150,4/15/2021,4/15/2021,41521,82L-IMPORT PAYROLL,D109,HJ,21.17,,474503.93
6150,4/15/2021,4/15/2021,41521,82L-IMPORT PAYROLL,D109,HJ,21.75,,474525.68
6150,4/15/2021,4/15/2021,41521,82L-IMPORT PAYROLL,D109,HJ,34.1,,474559.78
6150,4/15/2021,4/15/2021,41521,82L-IMPORT PAYROLL,D109,HJ,55.91,,474615.69
6150,4/15/2021,4/15/2021,41521,82L-IMPORT PAYROLL,D109,HJ,56.19,,474671.88
6150,4/15/2021,4/15/2021,41521,82L-IMPORT PAYROLL,D109,HJ,58.24,,474730.12
6150,4/15/2021,4/15/2021,41521,82L-IMPORT PAYROLL,D109,HJ,72.5,,474802.62
6150,4/15/2021,4/15/2021,41521,82L-IMPORT PAYROLL,D109,HJ,76.2,,474878.82
6150,4/15/2021,4/15/2021,41521,82L-IMPORT PAYROLL,D109,HJ,76.2,,474955.02
6150,4/15/2021,4/15/2021,41521,82L-IMPORT PAYROLL,D109,HJ,77.94,,475032.96
6150,4/15/2021,4/15/2021,41521,82L-IMPORT PAYROLL,D109,HJ,78.54,,475111.5
6150,4/15/2021,4/15/2021,41521,82L-IMPORT PAYROLL,D109,HJ,79.99,,475191.49
6150,4/15/2021,4/15/2021,41521,82L-IMPORT PAYROLL,D109,HJ,90.53,,475282.02
6150,4/15/2021,4/15/2021,41521,82L-IMPORT PAYROLL,D109,HJ,93,,475375.02
6150,4/15/2021,4/15/2021,41521,82L-IMPORT PAYROLL,D109,HJ,239.08,,475614.1
6150,4/15/2021,4/15/2021,41521,82L-IMPORT PAYROLL,D109,HJ,240.25,,475854.35
6150,4/15/2021,4/15/2021,41521,82L-IMPORT PAYROLL,D109,HJ,249.03,,476103.38
6150,4/15/2021,4/15/2021,41521,82L-IMPORT PAYROLL,D109,HJ,310,,476413.38
6150,4/15/2021,4/15/2021,41521,82L-IMPORT PAYROLL,D109,HJ,325.8,,476739.18
6150,4/15/2021,4/15/2021,41521,82L-IMPORT PAYROLL,D109,HJ,325.8,,477064.98
6150,4/15/2021,4/15/2021,41521,82L-IMPORT PAYROLL,D109,HJ,333.27,,477398.25
6150,4/15/2021,4/15/2021,41521,82L-IMPORT PAYROLL,D109,HJ,335.83,,477734.08
6150,4/15/2021,4/15/2021,41521,82L-IMPORT PAYROLL,D109,HJ,342.03,,478076.11
6150,4/15/2021,4/15/2021,41521,82L-IMPORT PAYROLL,D111,HJ,13.18,,478089.29
6150,4/15/2021,4/15/2021,41521,82L-IMPORT PAYROLL,D111,HJ,23.29,,478112.58
6150,4/15/2021,4/15/2021,41521,82L-IMPORT PAYROLL,D111,HJ,28.73,,478141.31
6150,4/15/2021,4/15/2021,41521,82L-IMPORT PAYROLL,D111,HJ,36.33,,478177.64
6150,4/15/2021,4/15/2021,41521,82L-IMPORT PAYROLL,D111,HJ,36.44,,478214.08
6150,4/15/2021,4/15/2021,41521,82L-IMPORT PAYROLL,D111,HJ,52.29,,478266.37
6150,4/15/2021,4/15/2021,41521,82L-IMPORT PAYROLL,D111,HJ,99.58,,478365.95
6150,4/15/2021,4/15/2021,41521,82L-IMPORT PAYROLL,D111,HJ,122.83,,478488.78
6150,4/15/2021,4/15/2021,41521,82L-IMPORT PAYROLL,D111,HJ,155.35,,478644.13
6150,4/15/2021,4/15/2021,41521,82L-IMPORT PAYROLL,D111,HJ,155.82,,478799.95
6150,4/15/2021,4/15/2021,41521,82L-IMPORT PAYROLL,D111,HJ,223.58,,479023.53
6150,4/15/2021,4/15/2021,41521,82L-IMPORT PAYROLL,D112,HJ,37.96,,479061.49
6150,4/15/2021,4/15/2021,41521,82L-IMPORT PAYROLL,D112,HJ,162.32,,479223.81
6150,4/15/2021,4/15/2021,41521,82L-IMPORT PAYROLL,D108,HJ,1.64,,479225.45
6150,4/15/2021,4/15/2021,41521,82L-IMPORT PAYROLL,D108,HJ,6.94,,479232.39
6150,4/15/2021,4/15/2021,41521,82L-IMPORT PAYROLL,D108,HJ,10,,479242.39
6150,4/15/2021,4/15/2021,41521,82L-IMPORT PAYROLL,D108,HJ,14,,479256.39
6150,4/15/2021,4/15/2021,41521,82L-IMPORT PAYROLL,D108,HJ,14.54,,479270.93
6150,4/15/2021,4/15/2021,41521,82L-IMPORT PAYROLL,D108,HJ,15.08,,479286.01
6150,4/15/2021,4/15/2021,41521,82L-IMPORT PAYROLL,D108,HJ,15.08,,479301.09
6150,4/15/2021,4/15/2021,41521,82L-IMPORT PAYROLL,D108,HJ,15.28,,479316.37
6150,4/15/2021,4/15/2021,41521,82L-IMPORT PAYROLL,D108,HJ,15.29,,479331.66
6150,4/15/2021,4/15/2021,41521,82L-IMPORT PAYROLL,D108,HJ,15.33,,479346.99
6150,4/15/2021,4/15/2021,41521,82L-IMPORT PAYROLL,D108,HJ,16.05,,479363.04
6150,4/15/2021,4/15/2021,41521,82L-IMPORT PAYROLL,D108,HJ,16.2,,479379.24
6150,4/15/2021,4/15/2021,41521,82L-IMPORT PAYROLL,D108,HJ,16.23,,479395.47
6150,4/15/2021,4/15/2021,41521,82L-IMPORT PAYROLL,D108,HJ,16.23,,479411.7
6150,4/15/2021,4/15/2021,41521,82L-IMPORT PAYROLL,D108,HJ,16.23,,479427.93
6150,4/15/2021,4/15/2021,41521,82L-IMPORT PAYROLL,D108,HJ,16.23,,479444.16
6150,4/15/2021,4/15/2021,41521,82L-IMPORT PAYROLL,D108,HJ,16.23,,479460.39
6150,4/15/2021,4/15/2021,41521,82L-IMPORT PAYROLL,D108,HJ,16.23,,479476.62
6150,4/15/2021,4/15/2021,41521,82L-IMPORT PAYROLL,D108,HJ,16.23,,479492.85
6150,4/15/2021,4/15/2021,41521,82L-IMPORT PAYROLL,D108,HJ,16.23,,479509.08
6150,4/15/2021,4/15/2021,41521,82L-IMPORT PAYROLL,D108,HJ,16.23,,479525.31
6150,4/15/2021,4/15/2021,41521,82L-IMPORT PAYROLL,D108,HJ,16.23,,479541.54
6150,4/15/2021,4/15/2021,41521,82L-IMPORT PAYROLL,D108,HJ,16.23,,479557.77
6150,4/15/2021,4/15/2021,41521,82L-IMPORT PAYROLL,D108,HJ,16.23,,479574
6150,4/15/2021,4/15/2021,41521,82L-IMPORT PAYROLL,D108,HJ,16.23,,479590.23
6150,4/15/2021,4/15/2021,41521,82L-IMPORT PAYROLL,D108,HJ,16.23,,479606.46
6150,4/15/2021,4/15/2021,41521,82L-IMPORT PAYROLL,D108,HJ,16.23,,479622.69
6150,4/15/2021,4/15/2021,41521,82L-IMPORT PAYROLL,D108,HJ,16.23,,479638.92
6150,4/15/2021,4/15/2021,41521,82L-IMPORT PAYROLL,D108,HJ,16.25,,479655.17
6150,4/15/2021,4/15/2021,41521,82L-IMPORT PAYROLL,D108,HJ,16.33,,479671.5
6150,4/15/2021,4/15/2021,41521,82L-IMPORT PAYROLL,D108,HJ,28.09,,479699.59
6150,4/15/2021,4/15/2021,41521,82L-IMPORT PAYROLL,D108,HJ,30.21,,479729.8
6150,4/15/2021,4/15/2021,41521,82L-IMPORT PAYROLL,D108,HJ,30.44,,479760.24
6150,4/15/2021,4/15/2021,41521,82L-IMPORT PAYROLL,D108,HJ,30.56,,479790.8
6150,4/15/2021,4/15/2021,41521,82L-IMPORT PAYROLL,D108,HJ,31,,479821.8
6150,4/15/2021,4/15/2021,41521,82L-IMPORT PAYROLL,D108,HJ,32.36,,479854.16
6150,4/15/2021,4/15/2021,41521,82L-IMPORT PAYROLL,D108,HJ,32.63,,479886.79
6150,4/15/2021,4/15/2021,41521,82L-IMPORT PAYROLL,D108,HJ,33.23,,479920.02
6150,4/15/2021,4/15/2021,41521,82L-IMPORT PAYROLL,D108,HJ,33.23,,479953.25
6150,4/15/2021,4/15/2021,41521,82L-IMPORT PAYROLL,D108,HJ,33.57,,479986.82
6150,4/15/2021,4/15/2021,41521,82L-IMPORT PAYROLL,D108,HJ,33.96,,480020.78
6150,4/15/2021,4/15/2021,41521,82L-IMPORT PAYROLL,D108,HJ,34.16,,480054.94
6150,4/15/2021,4/15/2021,41521,82L-IMPORT PAYROLL,D108,HJ,34.74,,480089.68
6150,4/15/2021,4/15/2021,41521,82L-IMPORT PAYROLL,D108,HJ,34.79,,480124.47
6150,4/15/2021,4/15/2021,41521,82L-IMPORT PAYROLL,D108,HJ,35.1,,480159.57
6150,4/15/2021,4/15/2021,41521,82L-IMPORT PAYROLL,D108,HJ,36.93,,480196.5
6150,4/15/2021,4/15/2021,41521,82L-IMPORT PAYROLL,D108,HJ,46.26,,480242.76
6150,4/15/2021,4/15/2021,41521,82L-IMPORT PAYROLL,D108,HJ,54.34,,480297.1
6150,4/15/2021,4/15/2021,41521,82L-IMPORT PAYROLL,D108,HJ,59.86,,480356.96
6150,4/15/2021,4/15/2021,41521,82L-IMPORT PAYROLL,D108,HJ,62.16,,480419.12
6150,4/15/2021,4/15/2021,41521,82L-IMPORT PAYROLL,D108,HJ,64.5,,480483.62
6150,4/15/2021,4/15/2021,41521,82L-IMPORT PAYROLL,D108,HJ,64.5,,480548.12
6150,4/15/2021,4/15/2021,41521,82L-IMPORT PAYROLL,D108,HJ,65.35,,480613.47
6150,4/15/2021,4/15/2021,41521,82L-IMPORT PAYROLL,D108,HJ,65.38,,480678.85
6150,4/15/2021,4/15/2021,41521,82L-IMPORT PAYROLL,D108,HJ,68.64,,480747.49
6150,4/15/2021,4/15/2021,41521,82L-IMPORT PAYROLL,D108,HJ,69.27,,480816.76
6150,4/15/2021,4/15/2021,41521,82L-IMPORT PAYROLL,D108,HJ,69.38,,480886.14
6150,4/15/2021,4/15/2021,41521,82L-IMPORT PAYROLL,D108,HJ,69.38,,480955.52
6150,4/15/2021,4/15/2021,41521,82L-IMPORT PAYROLL,D108,HJ,69.38,,481024.9
6150,4/15/2021,4/15/2021,41521,82L-IMPORT PAYROLL,D108,HJ,69.38,,481094.28
6150,4/15/2021,4/15/2021,41521,82L-IMPORT PAYROLL,D108,HJ,69.38,,481163.66
6150,4/15/2021,4/15/2021,41521,82L-IMPORT PAYROLL,D108,HJ,69.38,,481233.04
6150,4/15/2021,4/15/2021,41521,82L-IMPORT PAYROLL,D108,HJ,69.38,,481302.42
6150,4/15/2021,4/15/2021,41521,82L-IMPORT PAYROLL,D108,HJ,69.38,,481371.8
6150,4/15/2021,4/15/2021,41521,82L-IMPORT PAYROLL,D108,HJ,69.38,,481441.18
6150,4/15/2021,4/15/2021,41521,82L-IMPORT PAYROLL,D108,HJ,69.38,,481510.56
6150,4/15/2021,4/15/2021,41521,82L-IMPORT PAYROLL,D108,HJ,69.38,,481579.94
6150,4/15/2021,4/15/2021,41521,82L-IMPORT PAYROLL,D108,HJ,69.38,,481649.32
6150,4/15/2021,4/15/2021,41521,82L-IMPORT PAYROLL,D108,HJ,69.38,,481718.7
6150,4/15/2021,4/15/2021,41521,82L-IMPORT PAYROLL,D108,HJ,69.38,,481788.08
6150,4/15/2021,4/15/2021,41521,82L-IMPORT PAYROLL,D108,HJ,69.38,,481857.46
6150,4/15/2021,4/15/2021,41521,82L-IMPORT PAYROLL,D108,HJ,69.38,,481926.84
6150,4/15/2021,4/15/2021,41521,82L-IMPORT PAYROLL,D108,HJ,69.48,,481996.32
6150,4/15/2021,4/15/2021,41521,82L-IMPORT PAYROLL,D108,HJ,69.84,,482066.16
6150,4/15/2021,4/15/2021,41521,82L-IMPORT PAYROLL,D108,HJ,74.25,,482140.41
6150,4/15/2021,4/15/2021,41521,82L-IMPORT PAYROLL,D108,HJ,130.16,,482270.57
6150,4/15/2021,4/15/2021,41521,82L-IMPORT PAYROLL,D108,HJ,130.69,,482401.26
6150,4/15/2021,4/15/2021,41521,82L-IMPORT PAYROLL,D108,HJ,132.56,,482533.82
6150,4/15/2021,4/15/2021,41521,82L-IMPORT PAYROLL,D108,HJ,138.38,,482672.2
6150,4/15/2021,4/15/2021,41521,82L-IMPORT PAYROLL,D108,HJ,139.5,,482811.7
6150,4/15/2021,4/15/2021,41521,82L-IMPORT PAYROLL,D108,HJ,142.08,,482953.78
6150,4/15/2021,4/15/2021,41521,82L-IMPORT PAYROLL,D108,HJ,142.08,,483095.86
6150,4/15/2021,4/15/2021,41521,82L-IMPORT PAYROLL,D108,HJ,145.23,,483241.09
6150,4/15/2021,4/15/2021,41521,82L-IMPORT PAYROLL,D108,HJ,146.08,,483387.17
6150,4/15/2021,4/15/2021,41521,82L-IMPORT PAYROLL,D108,HJ,148.53,,483535.7
6150,4/15/2021,4/15/2021,41521,82L-IMPORT PAYROLL,D108,HJ,148.76,,483684.46
6150,4/15/2021,4/15/2021,41521,82L-IMPORT PAYROLL,D108,HJ,150.1,,483834.56
6150,4/15/2021,4/15/2021,41521,82L-IMPORT PAYROLL,D108,HJ,197.82,,484032.38
6150,4/15/2021,4/15/2021,41521,82L-IMPORT PAYROLL,D108,HJ,232.34,,484264.72
6150,4/15/2021,4/15/2021,41521,82L-IMPORT PAYROLL,D108,HJ,16.53,,484281.25
6150,4/15/2021,4/15/2021,41521,82L-IMPORT PAYROLL,D108,HJ,19.38,,484300.63
6150,4/15/2021,4/15/2021,41521,82L-IMPORT PAYROLL,D108,HJ,37.75,,484338.38
6150,4/15/2021,4/15/2021,41521,82L-IMPORT PAYROLL,D108,HJ,38.07,,484376.45
6150,4/15/2021,4/15/2021,41521,82L-IMPORT PAYROLL,D108,HJ,38.67,,484415.12
6150,4/15/2021,4/15/2021,41521,82L-IMPORT PAYROLL,D108,HJ,42.91,,484458.03
6150,4/15/2021,4/15/2021,41521,82L-IMPORT PAYROLL,D108,HJ,75.8,,484533.83
6150,4/15/2021,4/15/2021,41521,82L-IMPORT PAYROLL,D108,HJ,161.4,,484695.23
6150,4/15/2021,4/15/2021,41521,82L-IMPORT PAYROLL,D108,HJ,162.79,,484858.02
6150,4/15/2021,4/15/2021,41521,82L-IMPORT PAYROLL,D108,HJ,165.33,,485023.35
6150,4/15/2021,4/15/2021,41521,82L-IMPORT PAYROLL,D108,HJ,183.48,,485206.83
6150,4/15/2021,4/15/2021,41521,82L-IMPORT PAYROLL,D108,HJ,324.12,,485530.95
6150,4/19/2021,4/19/2021,20210419,82L Special Payroll 2021-04-20,D103,HJ,497.76,,486028.71
6150,4/23/2021,4/23/2021,20210423,82L Special Payroll 2021-04-23,D104,HJ,216.49,,486245.2
6150,4/23/2021,4/23/2021,ADP,ADP state UI filings and penalties April 2021,D104,HJ,7.65,,486252.85
6150,4/23/2021,4/23/2021,ADP,ADP state UI filings and penalties April 2021,D104,HJ,19.04,,486271.89
6150,4/23/2021,4/23/2021,ADP,ADP state UI filings and penalties April 2021,D104,HJ,25.96,,486297.85
6150,4/23/2021,4/23/2021,ADP,ADP state UI filings and penalties April 2021,D104,HJ,33.18,,486331.03
6150,4/23/2021,4/23/2021,ADP,ADP state UI filings and penalties April 2021,D104,HJ,82.48,,486413.51
6150,4/23/2021,4/23/2021,ADP,ADP state UI filings and penalties April 2021,D104,HJ,214.38,,486627.89
6150,4/23/2021,4/23/2021,ADP,ADP state UI filings and penalties April 2021,D104,HJ,532.96,,487160.85
6150,4/23/2021,4/23/2021,ADP,ADP state UI filings and penalties April 2021,D104,HJ,115.68,,487276.53
6150,4/23/2021,4/23/2021,ADP,ADP state UI filings and penalties April 2021,D104,HJ,501.24,,487777.77
6150,4/23/2021,4/23/2021,ADP,ADP state UI filings and penalties April 2021,D104,HJ,3238.8,,491016.57
6150,4/28/2021,4/28/2021,ADP,ADP state UI filings and penalties April 2021,D104,HJ,3.11,,491019.68
6150,4/28/2021,4/28/2021,ADP,ADP state UI filings and penalties April 2021,D104,HJ,13.47,,491033.15
6150,4/28/2021,4/28/2021,ADP,ADP state UI filings and penalties April 2021,D104,HJ,87.06,,491120.21
6150,4/30/2021,4/30/2021,1,ADJ to Reclass funding source,D109,HJ,,2460.93,488659.28
6150,4/30/2021,4/30/2021,1,ADJ to Reclass funding source,D109,HJ,2460.93,,491120.21
6150,4/30/2021,4/30/2021,1,ADJ to Reclass funding source,D109,HJ,,9600.78,481519.43
6150,4/30/2021,4/30/2021,1,ADJ to Reclass funding source,D109,HJ,9600.78,,491120.21
6150,4/30/2021,4/30/2021,43021,82L-IMPORT PAYROLL,D108,HJ,2.04,,491122.25
6150,4/30/2021,4/30/2021,43021,82L-IMPORT PAYROLL,D108,HJ,3.28,,491125.53
6150,4/30/2021,4/30/2021,43021,82L-IMPORT PAYROLL,D108,HJ,5.88,,491131.41
6150,4/30/2021,4/30/2021,43021,82L-IMPORT PAYROLL,D108,HJ,6.11,,491137.52
6150,4/30/2021,4/30/2021,43021,82L-IMPORT PAYROLL,D108,HJ,6.42,,491143.94
6150,4/30/2021,4/30/2021,43021,82L-IMPORT PAYROLL,D108,HJ,6.42,,491150.36
6150,4/30/2021,4/30/2021,43021,82L-IMPORT PAYROLL,D108,HJ,8.2,,491158.56
6150,4/30/2021,4/30/2021,43021,82L-IMPORT PAYROLL,D108,HJ,9.89,,491168.45
6150,4/30/2021,4/30/2021,43021,82L-IMPORT PAYROLL,D108,HJ,10.69,,491179.14
6150,4/30/2021,4/30/2021,43021,82L-IMPORT PAYROLL,D108,HJ,14.01,,491193.15
6150,4/30/2021,4/30/2021,43021,82L-IMPORT PAYROLL,D108,HJ,14.01,,491207.16
6150,4/30/2021,4/30/2021,43021,82L-IMPORT PAYROLL,D108,HJ,14.01,,491221.17
6150,4/30/2021,4/30/2021,43021,82L-IMPORT PAYROLL,D108,HJ,14.05,,491235.22
6150,4/30/2021,4/30/2021,43021,82L-IMPORT PAYROLL,D108,HJ,14.25,,491249.47
6150,4/30/2021,4/30/2021,43021,82L-IMPORT PAYROLL,D108,HJ,14.25,,491263.72
6150,4/30/2021,4/30/2021,43021,82L-IMPORT PAYROLL,D108,HJ,14.25,,491277.97
6150,4/30/2021,4/30/2021,43021,82L-IMPORT PAYROLL,D108,HJ,14.66,,491292.63
6150,4/30/2021,4/30/2021,43021,82L-IMPORT PAYROLL,D108,HJ,14.99,,491307.62
6150,4/30/2021,4/30/2021,43021,82L-IMPORT PAYROLL,D108,HJ,15.16,,491322.78
6150,4/30/2021,4/30/2021,43021,82L-IMPORT PAYROLL,D108,HJ,15.19,,491337.97
6150,4/30/2021,4/30/2021,43021,82L-IMPORT PAYROLL,D108,HJ,15.19,,491353.16
6150,4/30/2021,4/30/2021,43021,82L-IMPORT PAYROLL,D108,HJ,15.19,,491368.35
6150,4/30/2021,4/30/2021,43021,82L-IMPORT PAYROLL,D108,HJ,15.19,,491383.54
6150,4/30/2021,4/30/2021,43021,82L-IMPORT PAYROLL,D108,HJ,15.19,,491398.73
6150,4/30/2021,4/30/2021,43021,82L-IMPORT PAYROLL,D108,HJ,15.19,,491413.92
6150,4/30/2021,4/30/2021,43021,82L-IMPORT PAYROLL,D108,HJ,15.19,,491429.11
6150,4/30/2021,4/30/2021,43021,82L-IMPORT PAYROLL,D108,HJ,15.19,,491444.3
6150,4/30/2021,4/30/2021,43021,82L-IMPORT PAYROLL,D108,HJ,15.19,,491459.49
6150,4/30/2021,4/30/2021,43021,82L-IMPORT PAYROLL,D108,HJ,15.19,,491474.68
6150,4/30/2021,4/30/2021,43021,82L-IMPORT PAYROLL,D108,HJ,15.19,,491489.87
6150,4/30/2021,4/30/2021,43021,82L-IMPORT PAYROLL,D108,HJ,15.19,,491505.06
6150,4/30/2021,4/30/2021,43021,82L-IMPORT PAYROLL,D108,HJ,15.19,,491520.25
6150,4/30/2021,4/30/2021,43021,82L-IMPORT PAYROLL,D108,HJ,15.19,,491535.44
6150,4/30/2021,4/30/2021,43021,82L-IMPORT PAYROLL,D108,HJ,15.19,,491550.63
6150,4/30/2021,4/30/2021,43021,82L-IMPORT PAYROLL,D108,HJ,15.19,,491565.82
6150,4/30/2021,4/30/2021,43021,82L-IMPORT PAYROLL,D108,HJ,15.2,,491581.02
6150,4/30/2021,4/30/2021,43021,82L-IMPORT PAYROLL,D108,HJ,17.25,,491598.27
6150,4/30/2021,4/30/2021,43021,82L-IMPORT PAYROLL,D108,HJ,19.79,,491618.06
6150,4/30/2021,4/30/2021,43021,82L-IMPORT PAYROLL,D108,HJ,20.14,,491638.2
6150,4/30/2021,4/30/2021,43021,82L-IMPORT PAYROLL,D108,HJ,24.56,,491662.76
6150,4/30/2021,4/30/2021,43021,82L-IMPORT PAYROLL,D108,HJ,26.53,,491689.29
6150,4/30/2021,4/30/2021,43021,82L-IMPORT PAYROLL,D108,HJ,27.59,,491716.88
6150,4/30/2021,4/30/2021,43021,82L-IMPORT PAYROLL,D108,HJ,27.84,,491744.72
6150,4/30/2021,4/30/2021,43021,82L-IMPORT PAYROLL,D108,HJ,28.29,,491773.01
6150,4/30/2021,4/30/2021,43021,82L-IMPORT PAYROLL,D108,HJ,28.29,,491801.3
6150,4/30/2021,4/30/2021,43021,82L-IMPORT PAYROLL,D108,HJ,29,,491830.3
6150,4/30/2021,4/30/2021,43021,82L-IMPORT PAYROLL,D108,HJ,30.21,,491860.51
6150,4/30/2021,4/30/2021,43021,82L-IMPORT PAYROLL,D108,HJ,31.34,,491891.85
6150,4/30/2021,4/30/2021,43021,82L-IMPORT PAYROLL,D108,HJ,31.43,,491923.28
6150,4/30/2021,4/30/2021,43021,82L-IMPORT PAYROLL,D108,HJ,32.46,,491955.74
6150,4/30/2021,4/30/2021,43021,82L-IMPORT PAYROLL,D108,HJ,33.58,,491989.32
6150,4/30/2021,4/30/2021,43021,82L-IMPORT PAYROLL,D108,HJ,34.63,,492023.95
6150,4/30/2021,4/30/2021,43021,82L-IMPORT PAYROLL,D108,HJ,35.05,,492059
6150,4/30/2021,4/30/2021,43021,82L-IMPORT PAYROLL,D108,HJ,36.25,,492095.25
6150,4/30/2021,4/30/2021,43021,82L-IMPORT PAYROLL,D108,HJ,38.17,,492133.42
6150,4/30/2021,4/30/2021,43021,82L-IMPORT PAYROLL,D108,HJ,59.89,,492193.31
6150,4/30/2021,4/30/2021,43021,82L-IMPORT PAYROLL,D108,HJ,59.89,,492253.2
6150,4/30/2021,4/30/2021,43021,82L-IMPORT PAYROLL,D108,HJ,59.89,,492313.09
6150,4/30/2021,4/30/2021,43021,82L-IMPORT PAYROLL,D108,HJ,60.07,,492373.16
6150,4/30/2021,4/30/2021,43021,82L-IMPORT PAYROLL,D108,HJ,60.92,,492434.08
6150,4/30/2021,4/30/2021,43021,82L-IMPORT PAYROLL,D108,HJ,60.92,,492495
6150,4/30/2021,4/30/2021,43021,82L-IMPORT PAYROLL,D108,HJ,60.92,,492555.92
6150,4/30/2021,4/30/2021,43021,82L-IMPORT PAYROLL,D108,HJ,62.68,,492618.6
6150,4/30/2021,4/30/2021,43021,82L-IMPORT PAYROLL,D108,HJ,64.1,,492682.7
6150,4/30/2021,4/30/2021,43021,82L-IMPORT PAYROLL,D108,HJ,64.84,,492747.54
6150,4/30/2021,4/30/2021,43021,82L-IMPORT PAYROLL,D108,HJ,64.95,,492812.49
6150,4/30/2021,4/30/2021,43021,82L-IMPORT PAYROLL,D108,HJ,64.95,,492877.44
6150,4/30/2021,4/30/2021,43021,82L-IMPORT PAYROLL,D108,HJ,64.95,,492942.39
6150,4/30/2021,4/30/2021,43021,82L-IMPORT PAYROLL,D108,HJ,64.95,,493007.34
6150,4/30/2021,4/30/2021,43021,82L-IMPORT PAYROLL,D108,HJ,64.95,,493072.29
6150,4/30/2021,4/30/2021,43021,82L-IMPORT PAYROLL,D108,HJ,64.95,,493137.24
6150,4/30/2021,4/30/2021,43021,82L-IMPORT PAYROLL,D108,HJ,64.95,,493202.19
6150,4/30/2021,4/30/2021,43021,82L-IMPORT PAYROLL,D108,HJ,64.95,,493267.14
6150,4/30/2021,4/30/2021,43021,82L-IMPORT PAYROLL,D108,HJ,64.95,,493332.09
6150,4/30/2021,4/30/2021,43021,82L-IMPORT PAYROLL,D108,HJ,64.95,,493397.04
6150,4/30/2021,4/30/2021,43021,82L-IMPORT PAYROLL,D108,HJ,64.95,,493461.99
6150,4/30/2021,4/30/2021,43021,82L-IMPORT PAYROLL,D108,HJ,64.95,,493526.94
6150,4/30/2021,4/30/2021,43021,82L-IMPORT PAYROLL,D108,HJ,64.95,,493591.89
6150,4/30/2021,4/30/2021,43021,82L-IMPORT PAYROLL,D108,HJ,64.95,,493656.84
6150,4/30/2021,4/30/2021,43021,82L-IMPORT PAYROLL,D108,HJ,64.95,,493721.79
6150,4/30/2021,4/30/2021,43021,82L-IMPORT PAYROLL,D108,HJ,64.95,,493786.74
6150,4/30/2021,4/30/2021,43021,82L-IMPORT PAYROLL,D108,HJ,64.99,,493851.73
6150,4/30/2021,4/30/2021,43021,82L-IMPORT PAYROLL,D108,HJ,73.77,,493925.5
6150,4/30/2021,4/30/2021,43021,82L-IMPORT PAYROLL,D108,HJ,80.62,,494006.12
6150,4/30/2021,4/30/2021,43021,82L-IMPORT PAYROLL,D108,HJ,117.98,,494124.1
6150,4/30/2021,4/30/2021,43021,82L-IMPORT PAYROLL,D108,HJ,119.05,,494243.15
6150,4/30/2021,4/30/2021,43021,82L-IMPORT PAYROLL,D108,HJ,124,,494367.15
6150,4/30/2021,4/30/2021,43021,82L-IMPORT PAYROLL,D108,HJ,129.17,,494496.32
6150,4/30/2021,4/30/2021,43021,82L-IMPORT PAYROLL,D108,HJ,138.81,,494635.13
6150,4/30/2021,4/30/2021,43021,82L-IMPORT PAYROLL,D108,HJ,143.59,,494778.72
6150,4/30/2021,4/30/2021,43021,82L-IMPORT PAYROLL,D108,HJ,148.06,,494926.78
6150,4/30/2021,4/30/2021,43021,82L-IMPORT PAYROLL,D108,HJ,155,,495081.78
6150,4/30/2021,4/30/2021,43021,82L-IMPORT PAYROLL,D108,HJ,163.23,,495245.01
6150,4/30/2021,4/30/2021,43021,82L-IMPORT PAYROLL,D108,HJ,9.85,,495254.86
6150,4/30/2021,4/30/2021,43021,82L-IMPORT PAYROLL,D108,HJ,31.22,,495286.08
6150,4/30/2021,4/30/2021,43021,82L-IMPORT PAYROLL,D108,HJ,32.04,,495318.12
6150,4/30/2021,4/30/2021,43021,82L-IMPORT PAYROLL,D108,HJ,32.86,,495350.98
6150,4/30/2021,4/30/2021,43021,82L-IMPORT PAYROLL,D108,HJ,32.9,,495383.88
6150,4/30/2021,4/30/2021,43021,82L-IMPORT PAYROLL,D108,HJ,33.03,,495416.91
6150,4/30/2021,4/30/2021,43021,82L-IMPORT PAYROLL,D108,HJ,33.1,,495450.01
6150,4/30/2021,4/30/2021,43021,82L-IMPORT PAYROLL,D108,HJ,33.23,,495483.24
6150,4/30/2021,4/30/2021,43021,82L-IMPORT PAYROLL,D108,HJ,33.4,,495516.64
6150,4/30/2021,4/30/2021,43021,82L-IMPORT PAYROLL,D108,HJ,33.42,,495550.06
6150,4/30/2021,4/30/2021,43021,82L-IMPORT PAYROLL,D108,HJ,33.86,,495583.92
6150,4/30/2021,4/30/2021,43021,82L-IMPORT PAYROLL,D108,HJ,34.07,,495617.99
6150,4/30/2021,4/30/2021,43021,82L-IMPORT PAYROLL,D108,HJ,34.16,,495652.15
6150,4/30/2021,4/30/2021,43021,82L-IMPORT PAYROLL,D108,HJ,36.3,,495688.45
6150,4/30/2021,4/30/2021,43021,82L-IMPORT PAYROLL,D108,HJ,36.32,,495724.77
6150,4/30/2021,4/30/2021,43021,82L-IMPORT PAYROLL,D108,HJ,36.34,,495761.11
6150,4/30/2021,4/30/2021,43021,82L-IMPORT PAYROLL,D108,HJ,39.27,,495800.38
6150,4/30/2021,4/30/2021,43021,82L-IMPORT PAYROLL,D108,HJ,41.85,,495842.23
6150,4/30/2021,4/30/2021,43021,82L-IMPORT PAYROLL,D108,HJ,42.1,,495884.33
6150,4/30/2021,4/30/2021,43021,82L-IMPORT PAYROLL,D108,HJ,45.87,,495930.2
6150,4/30/2021,4/30/2021,43021,82L-IMPORT PAYROLL,D108,HJ,46.52,,495976.72
6150,4/30/2021,4/30/2021,43021,82L-IMPORT PAYROLL,D108,HJ,47.37,,496024.09
6150,4/30/2021,4/30/2021,43021,82L-IMPORT PAYROLL,D108,HJ,52.91,,496077
6150,4/30/2021,4/30/2021,43021,82L-IMPORT PAYROLL,D108,HJ,133.51,,496210.51
6150,4/30/2021,4/30/2021,43021,82L-IMPORT PAYROLL,D108,HJ,137,,496347.51
6150,4/30/2021,4/30/2021,43021,82L-IMPORT PAYROLL,D108,HJ,140.49,,496488
6150,4/30/2021,4/30/2021,43021,82L-IMPORT PAYROLL,D108,HJ,140.68,,496628.68
6150,4/30/2021,4/30/2021,43021,82L-IMPORT PAYROLL,D108,HJ,141.23,,496769.91
6150,4/30/2021,4/30/2021,43021,82L-IMPORT PAYROLL,D108,HJ,141.55,,496911.46
6150,4/30/2021,4/30/2021,43021,82L-IMPORT PAYROLL,D108,HJ,142.08,,497053.54
6150,4/30/2021,4/30/2021,43021,82L-IMPORT PAYROLL,D108,HJ,142.81,,497196.35
6150,4/30/2021,4/30/2021,43021,82L-IMPORT PAYROLL,D108,HJ,142.9,,497339.25
6150,4/30/2021,4/30/2021,43021,82L-IMPORT PAYROLL,D108,HJ,144.76,,497484.01
6150,4/30/2021,4/30/2021,43021,82L-IMPORT PAYROLL,D108,HJ,145.66,,497629.67
6150,4/30/2021,4/30/2021,43021,82L-IMPORT PAYROLL,D108,HJ,146.08,,497775.75
6150,4/30/2021,4/30/2021,43021,82L-IMPORT PAYROLL,D108,HJ,155.19,,497930.94
6150,4/30/2021,4/30/2021,43021,82L-IMPORT PAYROLL,D108,HJ,155.3,,498086.24
6150,4/30/2021,4/30/2021,43021,82L-IMPORT PAYROLL,D108,HJ,155.39,,498241.63
6150,4/30/2021,4/30/2021,43021,82L-IMPORT PAYROLL,D108,HJ,167.92,,498409.55
6150,4/30/2021,4/30/2021,43021,82L-IMPORT PAYROLL,D108,HJ,178.96,,498588.51
6150,4/30/2021,4/30/2021,43021,82L-IMPORT PAYROLL,D108,HJ,196.13,,498784.64
6150,4/30/2021,4/30/2021,43021,82L-IMPORT PAYROLL,D108,HJ,198.92,,498983.56
6150,4/30/2021,4/30/2021,43021,82L-IMPORT PAYROLL,D108,HJ,202.53,,499186.09
6150,4/30/2021,4/30/2021,43021,82L-IMPORT PAYROLL,D108,HJ,226.22,,499412.31
6150,4/30/2021,4/30/2021,43021,82L-IMPORT PAYROLL,D101,HJ,15.92,,499428.23
6150,4/30/2021,4/30/2021,43021,82L-IMPORT PAYROLL,D101,HJ,17.57,,499445.8
6150,4/30/2021,4/30/2021,43021,82L-IMPORT PAYROLL,D101,HJ,17.57,,499463.37
6150,4/30/2021,4/30/2021,43021,82L-IMPORT PAYROLL,D101,HJ,17.71,,499481.08
6150,4/30/2021,4/30/2021,43021,82L-IMPORT PAYROLL,D101,HJ,29,,499510.08
6150,4/30/2021,4/30/2021,43021,82L-IMPORT PAYROLL,D101,HJ,29.38,,499539.46
6150,4/30/2021,4/30/2021,43021,82L-IMPORT PAYROLL,D101,HJ,33.51,,499572.97
6150,4/30/2021,4/30/2021,43021,82L-IMPORT PAYROLL,D101,HJ,37.18,,499610.15
6150,4/30/2021,4/30/2021,43021,82L-IMPORT PAYROLL,D101,HJ,38.11,,499648.26
6150,4/30/2021,4/30/2021,43021,82L-IMPORT PAYROLL,D101,HJ,39.27,,499687.53
6150,4/30/2021,4/30/2021,43021,82L-IMPORT PAYROLL,D101,HJ,41.08,,499728.61
6150,4/30/2021,4/30/2021,43021,82L-IMPORT PAYROLL,D101,HJ,49.84,,499778.45
6150,4/30/2021,4/30/2021,43021,82L-IMPORT PAYROLL,D101,HJ,68.09,,499846.54
6150,4/30/2021,4/30/2021,43021,82L-IMPORT PAYROLL,D101,HJ,75.71,,499922.25
6150,4/30/2021,4/30/2021,43021,82L-IMPORT PAYROLL,D101,HJ,124,,500046.25
6150,4/30/2021,4/30/2021,43021,82L-IMPORT PAYROLL,D101,HJ,125.61,,500171.86
6150,4/30/2021,4/30/2021,43021,82L-IMPORT PAYROLL,D101,HJ,143.3,,500315.16
6150,4/30/2021,4/30/2021,43021,82L-IMPORT PAYROLL,D101,HJ,159,,500474.16
6150,4/30/2021,4/30/2021,43021,82L-IMPORT PAYROLL,D101,HJ,162.94,,500637.1
6150,4/30/2021,4/30/2021,43021,82L-IMPORT PAYROLL,D101,HJ,167.92,,500805.02
6150,4/30/2021,4/30/2021,43021,82L-IMPORT PAYROLL,D101,HJ,175.67,,500980.69
6150,4/30/2021,4/30/2021,43021,82L-IMPORT PAYROLL,D101,HJ,213.13,,501193.82
6150,4/30/2021,4/30/2021,43021,82L-IMPORT PAYROLL,D102,HJ,30.17,,501223.99
6150,4/30/2021,4/30/2021,43021,82L-IMPORT PAYROLL,D102,HJ,35.05,,501259.04
6150,4/30/2021,4/30/2021,43021,82L-IMPORT PAYROLL,D102,HJ,39,,501298.04
6150,4/30/2021,4/30/2021,43021,82L-IMPORT PAYROLL,D102,HJ,129.02,,501427.06
6150,4/30/2021,4/30/2021,43021,82L-IMPORT PAYROLL,D102,HJ,149.86,,501576.92
6150,4/30/2021,4/30/2021,43021,82L-IMPORT PAYROLL,D102,HJ,166.75,,501743.67
6150,4/30/2021,4/30/2021,43021,82L-IMPORT PAYROLL,D103,HJ,13.99,,501757.66
6150,4/30/2021,4/30/2021,43021,82L-IMPORT PAYROLL,D103,HJ,20.17,,501777.83
6150,4/30/2021,4/30/2021,43021,82L-IMPORT PAYROLL,D103,HJ,31.08,,501808.91
6150,4/30/2021,4/30/2021,43021,82L-IMPORT PAYROLL,D103,HJ,33.06,,501841.97
6150,4/30/2021,4/30/2021,43021,82L-IMPORT PAYROLL,D103,HJ,49.27,,501891.24
6150,4/30/2021,4/30/2021,43021,82L-IMPORT PAYROLL,D103,HJ,59.81,,501951.05
6150,4/30/2021,4/30/2021,43021,82L-IMPORT PAYROLL,D103,HJ,132.89,,502083.94
6150,4/30/2021,4/30/2021,43021,82L-IMPORT PAYROLL,D103,HJ,141.34,,502225.28
6150,4/30/2021,4/30/2021,43021,82L-IMPORT PAYROLL,D103,HJ,210.66,,502435.94
6150,4/30/2021,4/30/2021,43021,82L-IMPORT PAYROLL,D104,HJ,24.48,,502460.42
6150,4/30/2021,4/30/2021,43021,82L-IMPORT PAYROLL,D104,HJ,26.82,,502487.24
6150,4/30/2021,4/30/2021,43021,82L-IMPORT PAYROLL,D104,HJ,28.71,,502515.95
6150,4/30/2021,4/30/2021,43021,82L-IMPORT PAYROLL,D104,HJ,28.82,,502544.77
6150,4/30/2021,4/30/2021,43021,82L-IMPORT PAYROLL,D104,HJ,34.12,,502578.89
6150,4/30/2021,4/30/2021,43021,82L-IMPORT PAYROLL,D104,HJ,37.03,,502615.92
6150,4/30/2021,4/30/2021,43021,82L-IMPORT PAYROLL,D104,HJ,38.13,,502654.05
6150,4/30/2021,4/30/2021,43021,82L-IMPORT PAYROLL,D104,HJ,40.2,,502694.25
6150,4/30/2021,4/30/2021,43021,82L-IMPORT PAYROLL,D104,HJ,49.71,,502743.96
6150,4/30/2021,4/30/2021,43021,82L-IMPORT PAYROLL,D104,HJ,114.66,,502858.62
6150,4/30/2021,4/30/2021,43021,82L-IMPORT PAYROLL,D104,HJ,122.75,,502981.37
6150,4/30/2021,4/30/2021,43021,82L-IMPORT PAYROLL,D104,HJ,123.23,,503104.6
6150,4/30/2021,4/30/2021,43021,82L-IMPORT PAYROLL,D104,HJ,145.9,,503250.5
6150,4/30/2021,4/30/2021,43021,82L-IMPORT PAYROLL,D104,HJ,158.35,,503408.85
6150,4/30/2021,4/30/2021,43021,82L-IMPORT PAYROLL,D104,HJ,163.06,,503571.91
6150,4/30/2021,4/30/2021,43021,82L-IMPORT PAYROLL,D104,HJ,171.87,,503743.78
6150,4/30/2021,4/30/2021,43021,82L-IMPORT PAYROLL,D104,HJ,212.55,,503956.33
6150,4/30/2021,4/30/2021,43021,82L-IMPORT PAYROLL,D105,HJ,25.57,,503981.9
6150,4/30/2021,4/30/2021,43021,82L-IMPORT PAYROLL,D105,HJ,27.79,,504009.69
6150,4/30/2021,4/30/2021,43021,82L-IMPORT PAYROLL,D105,HJ,31.18,,504040.87
6150,4/30/2021,4/30/2021,43021,82L-IMPORT PAYROLL,D105,HJ,39.93,,504080.8
6150,4/30/2021,4/30/2021,43021,82L-IMPORT PAYROLL,D105,HJ,49.87,,504130.67
6150,4/30/2021,4/30/2021,43021,82L-IMPORT PAYROLL,D105,HJ,109.31,,504239.98
6150,4/30/2021,4/30/2021,43021,82L-IMPORT PAYROLL,D105,HJ,118.83,,504358.81
6150,4/30/2021,4/30/2021,43021,82L-IMPORT PAYROLL,D105,HJ,133.3,,504492.11
6150,4/30/2021,4/30/2021,43021,82L-IMPORT PAYROLL,D105,HJ,170.75,,504662.86
6150,4/30/2021,4/30/2021,43021,82L-IMPORT PAYROLL,D105,HJ,213.25,,504876.11
6150,4/30/2021,4/30/2021,43021,82L-IMPORT PAYROLL,D107,HJ,9.32,,504885.43
6150,4/30/2021,4/30/2021,43021,82L-IMPORT PAYROLL,D107,HJ,31.95,,504917.38
6150,4/30/2021,4/30/2021,43021,82L-IMPORT PAYROLL,D107,HJ,34.5,,504951.88
6150,4/30/2021,4/30/2021,43021,82L-IMPORT PAYROLL,D107,HJ,39.84,,504991.72
6150,4/30/2021,4/30/2021,43021,82L-IMPORT PAYROLL,D107,HJ,42.15,,505033.87
6150,4/30/2021,4/30/2021,43021,82L-IMPORT PAYROLL,D107,HJ,56.79,,505090.66
6150,4/30/2021,4/30/2021,43021,82L-IMPORT PAYROLL,D107,HJ,72.42,,505163.08
6150,4/30/2021,4/30/2021,43021,82L-IMPORT PAYROLL,D107,HJ,94.2,,505257.28
6150,4/30/2021,4/30/2021,43021,82L-IMPORT PAYROLL,D107,HJ,136.61,,505393.89
6150,4/30/2021,4/30/2021,43021,82L-IMPORT PAYROLL,D107,HJ,147.5,,505541.39
6150,4/30/2021,4/30/2021,43021,82L-IMPORT PAYROLL,D107,HJ,180.26,,505721.65
6150,4/30/2021,4/30/2021,43021,82L-IMPORT PAYROLL,D107,HJ,242.84,,505964.49
6150,4/30/2021,4/30/2021,43021,82L-IMPORT PAYROLL,D107,HJ,309.64,,506274.13
6150,4/30/2021,4/30/2021,43021,82L-IMPORT PAYROLL,D107,HJ,402.8,,506676.93
6150,4/30/2021,4/30/2021,43021,82L-IMPORT PAYROLL,D109,HJ,8.61,,506685.54
6150,4/30/2021,4/30/2021,43021,82L-IMPORT PAYROLL,D109,HJ,14.11,,506699.65
6150,4/30/2021,4/30/2021,43021,82L-IMPORT PAYROLL,D109,HJ,16.5,,506716.15
6150,4/30/2021,4/30/2021,43021,82L-IMPORT PAYROLL,D109,HJ,21.75,,506737.9
6150,4/30/2021,4/30/2021,43021,82L-IMPORT PAYROLL,D109,HJ,26.28,,506764.18
6150,4/30/2021,4/30/2021,43021,82L-IMPORT PAYROLL,D109,HJ,34.65,,506798.83
6150,4/30/2021,4/30/2021,43021,82L-IMPORT PAYROLL,D109,HJ,36.83,,506835.66
6150,4/30/2021,4/30/2021,43021,82L-IMPORT PAYROLL,D109,HJ,55.91,,506891.57
6150,4/30/2021,4/30/2021,43021,82L-IMPORT PAYROLL,D109,HJ,56.19,,506947.76
6150,4/30/2021,4/30/2021,43021,82L-IMPORT PAYROLL,D109,HJ,58.24,,507006
6150,4/30/2021,4/30/2021,43021,82L-IMPORT PAYROLL,D109,HJ,72.5,,507078.5
6150,4/30/2021,4/30/2021,43021,82L-IMPORT PAYROLL,D109,HJ,76.2,,507154.7
6150,4/30/2021,4/30/2021,43021,82L-IMPORT PAYROLL,D109,HJ,76.2,,507230.9
6150,4/30/2021,4/30/2021,43021,82L-IMPORT PAYROLL,D109,HJ,77.94,,507308.84
6150,4/30/2021,4/30/2021,43021,82L-IMPORT PAYROLL,D109,HJ,78.54,,507387.38
6150,4/30/2021,4/30/2021,43021,82L-IMPORT PAYROLL,D109,HJ,79.99,,507467.37
6150,4/30/2021,4/30/2021,43021,82L-IMPORT PAYROLL,D109,HJ,93,,507560.37
6150,4/30/2021,4/30/2021,43021,82L-IMPORT PAYROLL,D109,HJ,148.15,,507708.52
6150,4/30/2021,4/30/2021,43021,82L-IMPORT PAYROLL,D109,HJ,239.08,,507947.6
6150,4/30/2021,4/30/2021,43021,82L-IMPORT PAYROLL,D109,HJ,240.25,,508187.85
6150,4/30/2021,4/30/2021,43021,82L-IMPORT PAYROLL,D109,HJ,249.03,,508436.88
6150,4/30/2021,4/30/2021,43021,82L-IMPORT PAYROLL,D109,HJ,310,,508746.88
6150,4/30/2021,4/30/2021,43021,82L-IMPORT PAYROLL,D109,HJ,325.8,,509072.68
6150,4/30/2021,4/30/2021,43021,82L-IMPORT PAYROLL,D109,HJ,325.8,,509398.48
6150,4/30/2021,4/30/2021,43021,82L-IMPORT PAYROLL,D109,HJ,333.27,,509731.75
6150,4/30/2021,4/30/2021,43021,82L-IMPORT PAYROLL,D109,HJ,335.83,,510067.58
6150,4/30/2021,4/30/2021,43021,82L-IMPORT PAYROLL,D109,HJ,342.03,,510409.61
6150,4/30/2021,4/30/2021,43021,82L-IMPORT PAYROLL,D111,HJ,13.49,,510423.1
6150,4/30/2021,4/30/2021,43021,82L-IMPORT PAYROLL,D111,HJ,24.01,,510447.11
6150,4/30/2021,4/30/2021,43021,82L-IMPORT PAYROLL,D111,HJ,29.45,,510476.56
6150,4/30/2021,4/30/2021,43021,82L-IMPORT PAYROLL,D111,HJ,37.06,,510513.62
6150,4/30/2021,4/30/2021,43021,82L-IMPORT PAYROLL,D111,HJ,37.17,,510550.79
6150,4/30/2021,4/30/2021,43021,82L-IMPORT PAYROLL,D111,HJ,53.01,,510603.8
6150,4/30/2021,4/30/2021,43021,82L-IMPORT PAYROLL,D111,HJ,102.68,,510706.48
6150,4/30/2021,4/30/2021,43021,82L-IMPORT PAYROLL,D111,HJ,125.93,,510832.41
6150,4/30/2021,4/30/2021,43021,82L-IMPORT PAYROLL,D111,HJ,158.45,,510990.86
6150,4/30/2021,4/30/2021,43021,82L-IMPORT PAYROLL,D111,HJ,158.92,,511149.78
6150,4/30/2021,4/30/2021,43021,82L-IMPORT PAYROLL,D111,HJ,226.68,,511376.46
6150,4/30/2021,4/30/2021,43021,82L-IMPORT PAYROLL,D112,HJ,37.96,,511414.42
6150,4/30/2021,4/30/2021,43021,82L-IMPORT PAYROLL,D112,HJ,162.32,,511576.74
6150,4/30/2021,4/30/2021,43021,82L-IMPORT PAYROLL,D108,HJ,1.64,,511578.38
6150,4/30/2021,4/30/2021,43021,82L-IMPORT PAYROLL,D108,HJ,6.94,,511585.32
6150,4/30/2021,4/30/2021,43021,82L-IMPORT PAYROLL,D108,HJ,12.83,,511598.15
6150,4/30/2021,4/30/2021,43021,82L-IMPORT PAYROLL,D108,HJ,14,,511612.15
6150,4/30/2021,4/30/2021,43021,82L-IMPORT PAYROLL,D108,HJ,15.08,,511627.23
6150,4/30/2021,4/30/2021,43021,82L-IMPORT PAYROLL,D108,HJ,15.08,,511642.31
6150,4/30/2021,4/30/2021,43021,82L-IMPORT PAYROLL,D108,HJ,15.28,,511657.59
6150,4/30/2021,4/30/2021,43021,82L-IMPORT PAYROLL,D108,HJ,15.28,,511672.87
6150,4/30/2021,4/30/2021,43021,82L-IMPORT PAYROLL,D108,HJ,15.33,,511688.2
6150,4/30/2021,4/30/2021,43021,82L-IMPORT PAYROLL,D108,HJ,16.05,,511704.25
6150,4/30/2021,4/30/2021,43021,82L-IMPORT PAYROLL,D108,HJ,16.2,,511720.45
6150,4/30/2021,4/30/2021,43021,82L-IMPORT PAYROLL,D108,HJ,16.23,,511736.68
6150,4/30/2021,4/30/2021,43021,82L-IMPORT PAYROLL,D108,HJ,16.23,,511752.91
6150,4/30/2021,4/30/2021,43021,82L-IMPORT PAYROLL,D108,HJ,16.23,,511769.14
6150,4/30/2021,4/30/2021,43021,82L-IMPORT PAYROLL,D108,HJ,16.23,,511785.37
6150,4/30/2021,4/30/2021,43021,82L-IMPORT PAYROLL,D108,HJ,16.23,,511801.6
6150,4/30/2021,4/30/2021,43021,82L-IMPORT PAYROLL,D108,HJ,16.23,,511817.83
6150,4/30/2021,4/30/2021,43021,82L-IMPORT PAYROLL,D108,HJ,16.23,,511834.06
6150,4/30/2021,4/30/2021,43021,82L-IMPORT PAYROLL,D108,HJ,16.23,,511850.29
6150,4/30/2021,4/30/2021,43021,82L-IMPORT PAYROLL,D108,HJ,16.23,,511866.52
6150,4/30/2021,4/30/2021,43021,82L-IMPORT PAYROLL,D108,HJ,16.23,,511882.75
6150,4/30/2021,4/30/2021,43021,82L-IMPORT PAYROLL,D108,HJ,16.23,,511898.98
6150,4/30/2021,4/30/2021,43021,82L-IMPORT PAYROLL,D108,HJ,16.23,,511915.21
6150,4/30/2021,4/30/2021,43021,82L-IMPORT PAYROLL,D108,HJ,16.23,,511931.44
6150,4/30/2021,4/30/2021,43021,82L-IMPORT PAYROLL,D108,HJ,16.23,,511947.67
6150,4/30/2021,4/30/2021,43021,82L-IMPORT PAYROLL,D108,HJ,16.23,,511963.9
6150,4/30/2021,4/30/2021,43021,82L-IMPORT PAYROLL,D108,HJ,16.23,,511980.13
6150,4/30/2021,4/30/2021,43021,82L-IMPORT PAYROLL,D108,HJ,16.23,,511996.36
6150,4/30/2021,4/30/2021,43021,82L-IMPORT PAYROLL,D108,HJ,16.23,,512012.59
6150,4/30/2021,4/30/2021,43021,82L-IMPORT PAYROLL,D108,HJ,28.09,,512040.68
6150,4/30/2021,4/30/2021,43021,82L-IMPORT PAYROLL,D108,HJ,30.21,,512070.89
6150,4/30/2021,4/30/2021,43021,82L-IMPORT PAYROLL,D108,HJ,30.44,,512101.33
6150,4/30/2021,4/30/2021,43021,82L-IMPORT PAYROLL,D108,HJ,30.56,,512131.89
6150,4/30/2021,4/30/2021,43021,82L-IMPORT PAYROLL,D108,HJ,31,,512162.89
6150,4/30/2021,4/30/2021,43021,82L-IMPORT PAYROLL,D108,HJ,32.36,,512195.25
6150,4/30/2021,4/30/2021,43021,82L-IMPORT PAYROLL,D108,HJ,32.63,,512227.88
6150,4/30/2021,4/30/2021,43021,82L-IMPORT PAYROLL,D108,HJ,33.23,,512261.11
6150,4/30/2021,4/30/2021,43021,82L-IMPORT PAYROLL,D108,HJ,33.57,,512294.68
6150,4/30/2021,4/30/2021,43021,82L-IMPORT PAYROLL,D108,HJ,33.96,,512328.64
6150,4/30/2021,4/30/2021,43021,82L-IMPORT PAYROLL,D108,HJ,34.16,,512362.8
6150,4/30/2021,4/30/2021,43021,82L-IMPORT PAYROLL,D108,HJ,34.74,,512397.54
6150,4/30/2021,4/30/2021,43021,82L-IMPORT PAYROLL,D108,HJ,34.79,,512432.33
6150,4/30/2021,4/30/2021,43021,82L-IMPORT PAYROLL,D108,HJ,35.1,,512467.43
6150,4/30/2021,4/30/2021,43021,82L-IMPORT PAYROLL,D108,HJ,36.93,,512504.36
6150,4/30/2021,4/30/2021,43021,82L-IMPORT PAYROLL,D108,HJ,38.29,,512542.65
6150,4/30/2021,4/30/2021,43021,82L-IMPORT PAYROLL,D108,HJ,50.61,,512593.26
6150,4/30/2021,4/30/2021,43021,82L-IMPORT PAYROLL,D108,HJ,54.34,,512647.6
6150,4/30/2021,4/30/2021,43021,82L-IMPORT PAYROLL,D108,HJ,54.88,,512702.48
6150,4/30/2021,4/30/2021,43021,82L-IMPORT PAYROLL,D108,HJ,59.86,,512762.34
6150,4/30/2021,4/30/2021,43021,82L-IMPORT PAYROLL,D108,HJ,64.5,,512826.84
6150,4/30/2021,4/30/2021,43021,82L-IMPORT PAYROLL,D108,HJ,64.5,,512891.34
6150,4/30/2021,4/30/2021,43021,82L-IMPORT PAYROLL,D108,HJ,65.35,,512956.69
6150,4/30/2021,4/30/2021,43021,82L-IMPORT PAYROLL,D108,HJ,65.35,,513022.04
6150,4/30/2021,4/30/2021,43021,82L-IMPORT PAYROLL,D108,HJ,68.64,,513090.68
6150,4/30/2021,4/30/2021,43021,82L-IMPORT PAYROLL,D108,HJ,69.27,,513159.95
6150,4/30/2021,4/30/2021,43021,82L-IMPORT PAYROLL,D108,HJ,69.38,,513229.33
6150,4/30/2021,4/30/2021,43021,82L-IMPORT PAYROLL,D108,HJ,69.38,,513298.71
6150,4/30/2021,4/30/2021,43021,82L-IMPORT PAYROLL,D108,HJ,69.38,,513368.09
6150,4/30/2021,4/30/2021,43021,82L-IMPORT PAYROLL,D108,HJ,69.38,,513437.47
6150,4/30/2021,4/30/2021,43021,82L-IMPORT PAYROLL,D108,HJ,69.38,,513506.85
6150,4/30/2021,4/30/2021,43021,82L-IMPORT PAYROLL,D108,HJ,69.38,,513576.23
6150,4/30/2021,4/30/2021,43021,82L-IMPORT PAYROLL,D108,HJ,69.38,,513645.61
6150,4/30/2021,4/30/2021,43021,82L-IMPORT PAYROLL,D108,HJ,69.38,,513714.99
6150,4/30/2021,4/30/2021,43021,82L-IMPORT PAYROLL,D108,HJ,69.38,,513784.37
6150,4/30/2021,4/30/2021,43021,82L-IMPORT PAYROLL,D108,HJ,69.38,,513853.75
6150,4/30/2021,4/30/2021,43021,82L-IMPORT PAYROLL,D108,HJ,69.38,,513923.13
6150,4/30/2021,4/30/2021,43021,82L-IMPORT PAYROLL,D108,HJ,69.38,,513992.51
6150,4/30/2021,4/30/2021,43021,82L-IMPORT PAYROLL,D108,HJ,69.38,,514061.89
6150,4/30/2021,4/30/2021,43021,82L-IMPORT PAYROLL,D108,HJ,69.38,,514131.27
6150,4/30/2021,4/30/2021,43021,82L-IMPORT PAYROLL,D108,HJ,69.38,,514200.65
6150,4/30/2021,4/30/2021,43021,82L-IMPORT PAYROLL,D108,HJ,69.38,,514270.03
6150,4/30/2021,4/30/2021,43021,82L-IMPORT PAYROLL,D108,HJ,69.38,,514339.41
6150,4/30/2021,4/30/2021,43021,82L-IMPORT PAYROLL,D108,HJ,69.42,,514408.83
6150,4/30/2021,4/30/2021,43021,82L-IMPORT PAYROLL,D108,HJ,74.25,,514483.08
6150,4/30/2021,4/30/2021,43021,82L-IMPORT PAYROLL,D108,HJ,130.16,,514613.24
6150,4/30/2021,4/30/2021,43021,82L-IMPORT PAYROLL,D108,HJ,130.69,,514743.93
6150,4/30/2021,4/30/2021,43021,82L-IMPORT PAYROLL,D108,HJ,132.56,,514876.49
6150,4/30/2021,4/30/2021,43021,82L-IMPORT PAYROLL,D108,HJ,138.38,,515014.87
6150,4/30/2021,4/30/2021,43021,82L-IMPORT PAYROLL,D108,HJ,139.5,,515154.37
6150,4/30/2021,4/30/2021,43021,82L-IMPORT PAYROLL,D108,HJ,142.08,,515296.45
6150,4/30/2021,4/30/2021,43021,82L-IMPORT PAYROLL,D108,HJ,145.23,,515441.68
6150,4/30/2021,4/30/2021,43021,82L-IMPORT PAYROLL,D108,HJ,146.08,,515587.76
6150,4/30/2021,4/30/2021,43021,82L-IMPORT PAYROLL,D108,HJ,148.53,,515736.29
6150,4/30/2021,4/30/2021,43021,82L-IMPORT PAYROLL,D108,HJ,148.76,,515885.05
6150,4/30/2021,4/30/2021,43021,82L-IMPORT PAYROLL,D108,HJ,150.1,,516035.15
6150,4/30/2021,4/30/2021,43021,82L-IMPORT PAYROLL,D108,HJ,163.74,,516198.89
6150,4/30/2021,4/30/2021,43021,82L-IMPORT PAYROLL,D108,HJ,216.42,,516415.31
6150,4/30/2021,4/30/2021,43021,82L-IMPORT PAYROLL,D108,HJ,232.34,,516647.65
6150,4/30/2021,4/30/2021,43021,82L-IMPORT PAYROLL,D108,HJ,19.38,,516667.03
6150,4/30/2021,4/30/2021,43021,82L-IMPORT PAYROLL,D108,HJ,20.25,,516687.28
6150,4/30/2021,4/30/2021,43021,82L-IMPORT PAYROLL,D108,HJ,37.75,,516725.03
6150,4/30/2021,4/30/2021,43021,82L-IMPORT PAYROLL,D108,HJ,38.07,,516763.1
6150,4/30/2021,4/30/2021,43021,82L-IMPORT PAYROLL,D108,HJ,42.91,,516806.01
6150,4/30/2021,4/30/2021,43021,82L-IMPORT PAYROLL,D108,HJ,47.37,,516853.38
6150,4/30/2021,4/30/2021,43021,82L-IMPORT PAYROLL,D108,HJ,75.8,,516929.18
6150,4/30/2021,4/30/2021,43021,82L-IMPORT PAYROLL,D108,HJ,161.4,,517090.58
6150,4/30/2021,4/30/2021,43021,82L-IMPORT PAYROLL,D108,HJ,162.79,,517253.37
6150,4/30/2021,4/30/2021,43021,82L-IMPORT PAYROLL,D108,HJ,183.48,,517436.85
6150,4/30/2021,4/30/2021,43021,82L-IMPORT PAYROLL,D108,HJ,202.53,,517639.38
6150,4/30/2021,4/30/2021,43021,82L-IMPORT PAYROLL,D108,HJ,324.12,,517963.5
6150,5/12/2021,5/12/2021,ADP,ADP state UI filings and penatlies May 2021,D104,HJ,3.12,,517966.62
6150,5/12/2021,5/12/2021,ADP,ADP state UI filings and penatlies May 2021,D104,HJ,13.54,,517980.16
6150,5/12/2021,5/12/2021,ADP,ADP state UI filings and penatlies May 2021,D104,HJ,87.48,,518067.64
6150,5/14/2021,5/14/2021,51421,82L-IMPORT PAYROLL,D108,HJ,10.69,,518078.33
6150,5/14/2021,5/14/2021,51421,82L-IMPORT PAYROLL,D108,HJ,14.01,,518092.34
6150,5/14/2021,5/14/2021,51421,82L-IMPORT PAYROLL,D108,HJ,14.01,,518106.35
6150,5/14/2021,5/14/2021,51421,82L-IMPORT PAYROLL,D108,HJ,14.01,,518120.36
6150,5/14/2021,5/14/2021,51421,82L-IMPORT PAYROLL,D108,HJ,14.05,,518134.41
6150,5/14/2021,5/14/2021,51421,82L-IMPORT PAYROLL,D108,HJ,14.25,,518148.66
6150,5/14/2021,5/14/2021,51421,82L-IMPORT PAYROLL,D108,HJ,14.25,,518162.91
6150,5/14/2021,5/14/2021,51421,82L-IMPORT PAYROLL,D108,HJ,14.25,,518177.16
6150,5/14/2021,5/14/2021,51421,82L-IMPORT PAYROLL,D108,HJ,14.65,,518191.81
6150,5/14/2021,5/14/2021,51421,82L-IMPORT PAYROLL,D108,HJ,14.99,,518206.8
6150,5/14/2021,5/14/2021,51421,82L-IMPORT PAYROLL,D108,HJ,15.16,,518221.96
6150,5/14/2021,5/14/2021,51421,82L-IMPORT PAYROLL,D108,HJ,15.19,,518237.15
6150,5/14/2021,5/14/2021,51421,82L-IMPORT PAYROLL,D108,HJ,15.19,,518252.34
6150,5/14/2021,5/14/2021,51421,82L-IMPORT PAYROLL,D108,HJ,15.19,,518267.53
6150,5/14/2021,5/14/2021,51421,82L-IMPORT PAYROLL,D108,HJ,15.19,,518282.72
6150,5/14/2021,5/14/2021,51421,82L-IMPORT PAYROLL,D108,HJ,15.19,,518297.91
6150,5/14/2021,5/14/2021,51421,82L-IMPORT PAYROLL,D108,HJ,15.19,,518313.1
6150,5/14/2021,5/14/2021,51421,82L-IMPORT PAYROLL,D108,HJ,15.19,,518328.29
6150,5/14/2021,5/14/2021,51421,82L-IMPORT PAYROLL,D108,HJ,15.19,,518343.48
6150,5/14/2021,5/14/2021,51421,82L-IMPORT PAYROLL,D108,HJ,15.19,,518358.67
6150,5/14/2021,5/14/2021,51421,82L-IMPORT PAYROLL,D108,HJ,15.19,,518373.86
6150,5/14/2021,5/14/2021,51421,82L-IMPORT PAYROLL,D108,HJ,15.19,,518389.05
6150,5/14/2021,5/14/2021,51421,82L-IMPORT PAYROLL,D108,HJ,15.19,,518404.24
6150,5/14/2021,5/14/2021,51421,82L-IMPORT PAYROLL,D108,HJ,15.19,,518419.43
6150,5/14/2021,5/14/2021,51421,82L-IMPORT PAYROLL,D108,HJ,15.19,,518434.62
6150,5/14/2021,5/14/2021,51421,82L-IMPORT PAYROLL,D108,HJ,15.19,,518449.81
6150,5/14/2021,5/14/2021,51421,82L-IMPORT PAYROLL,D108,HJ,15.19,,518465
6150,5/14/2021,5/14/2021,51421,82L-IMPORT PAYROLL,D108,HJ,15.19,,518480.19
6150,5/14/2021,5/14/2021,51421,82L-IMPORT PAYROLL,D108,HJ,16.33,,518496.52
6150,5/14/2021,5/14/2021,51421,82L-IMPORT PAYROLL,D108,HJ,20.14,,518516.66
6150,5/14/2021,5/14/2021,51421,82L-IMPORT PAYROLL,D108,HJ,24.56,,518541.22
6150,5/14/2021,5/14/2021,51421,82L-IMPORT PAYROLL,D108,HJ,26.53,,518567.75
6150,5/14/2021,5/14/2021,51421,82L-IMPORT PAYROLL,D108,HJ,27.59,,518595.34
6150,5/14/2021,5/14/2021,51421,82L-IMPORT PAYROLL,D108,HJ,27.84,,518623.18
6150,5/14/2021,5/14/2021,51421,82L-IMPORT PAYROLL,D108,HJ,28.29,,518651.47
6150,5/14/2021,5/14/2021,51421,82L-IMPORT PAYROLL,D108,HJ,28.29,,518679.76
6150,5/14/2021,5/14/2021,51421,82L-IMPORT PAYROLL,D108,HJ,29,,518708.76
6150,5/14/2021,5/14/2021,51421,82L-IMPORT PAYROLL,D108,HJ,30.21,,518738.97
6150,5/14/2021,5/14/2021,51421,82L-IMPORT PAYROLL,D108,HJ,31.31,,518770.28
6150,5/14/2021,5/14/2021,51421,82L-IMPORT PAYROLL,D108,HJ,31.43,,518801.71
6150,5/14/2021,5/14/2021,51421,82L-IMPORT PAYROLL,D108,HJ,32.46,,518834.17
6150,5/14/2021,5/14/2021,51421,82L-IMPORT PAYROLL,D108,HJ,33.58,,518867.75
6150,5/14/2021,5/14/2021,51421,82L-IMPORT PAYROLL,D108,HJ,34.63,,518902.38
6150,5/14/2021,5/14/2021,51421,82L-IMPORT PAYROLL,D108,HJ,36.25,,518938.63
6150,5/14/2021,5/14/2021,51421,82L-IMPORT PAYROLL,D108,HJ,38.17,,518976.8
6150,5/14/2021,5/14/2021,51421,82L-IMPORT PAYROLL,D108,HJ,59.89,,519036.69
6150,5/14/2021,5/14/2021,51421,82L-IMPORT PAYROLL,D108,HJ,59.89,,519096.58
6150,5/14/2021,5/14/2021,51421,82L-IMPORT PAYROLL,D108,HJ,59.89,,519156.47
6150,5/14/2021,5/14/2021,51421,82L-IMPORT PAYROLL,D108,HJ,60.07,,519216.54
6150,5/14/2021,5/14/2021,51421,82L-IMPORT PAYROLL,D108,HJ,60.92,,519277.46
6150,5/14/2021,5/14/2021,51421,82L-IMPORT PAYROLL,D108,HJ,60.92,,519338.38
6150,5/14/2021,5/14/2021,51421,82L-IMPORT PAYROLL,D108,HJ,60.92,,519399.3
6150,5/14/2021,5/14/2021,51421,82L-IMPORT PAYROLL,D108,HJ,62.62,,519461.92
6150,5/14/2021,5/14/2021,51421,82L-IMPORT PAYROLL,D108,HJ,64.1,,519526.02
6150,5/14/2021,5/14/2021,51421,82L-IMPORT PAYROLL,D108,HJ,64.84,,519590.86
6150,5/14/2021,5/14/2021,51421,82L-IMPORT PAYROLL,D108,HJ,64.95,,519655.81
6150,5/14/2021,5/14/2021,51421,82L-IMPORT PAYROLL,D108,HJ,64.95,,519720.76
6150,5/14/2021,5/14/2021,51421,82L-IMPORT PAYROLL,D108,HJ,64.95,,519785.71
6150,5/14/2021,5/14/2021,51421,82L-IMPORT PAYROLL,D108,HJ,64.95,,519850.66
6150,5/14/2021,5/14/2021,51421,82L-IMPORT PAYROLL,D108,HJ,64.95,,519915.61
6150,5/14/2021,5/14/2021,51421,82L-IMPORT PAYROLL,D108,HJ,64.95,,519980.56
6150,5/14/2021,5/14/2021,51421,82L-IMPORT PAYROLL,D108,HJ,64.95,,520045.51
6150,5/14/2021,5/14/2021,51421,82L-IMPORT PAYROLL,D108,HJ,64.95,,520110.46
6150,5/14/2021,5/14/2021,51421,82L-IMPORT PAYROLL,D108,HJ,64.95,,520175.41
6150,5/14/2021,5/14/2021,51421,82L-IMPORT PAYROLL,D108,HJ,64.95,,520240.36
6150,5/14/2021,5/14/2021,51421,82L-IMPORT PAYROLL,D108,HJ,64.95,,520305.31
6150,5/14/2021,5/14/2021,51421,82L-IMPORT PAYROLL,D108,HJ,64.95,,520370.26
6150,5/14/2021,5/14/2021,51421,82L-IMPORT PAYROLL,D108,HJ,64.95,,520435.21
6150,5/14/2021,5/14/2021,51421,82L-IMPORT PAYROLL,D108,HJ,64.95,,520500.16
6150,5/14/2021,5/14/2021,51421,82L-IMPORT PAYROLL,D108,HJ,64.95,,520565.11
6150,5/14/2021,5/14/2021,51421,82L-IMPORT PAYROLL,D108,HJ,64.95,,520630.06
6150,5/14/2021,5/14/2021,51421,82L-IMPORT PAYROLL,D108,HJ,64.95,,520695.01
6150,5/14/2021,5/14/2021,51421,82L-IMPORT PAYROLL,D108,HJ,69.83,,520764.84
6150,5/14/2021,5/14/2021,51421,82L-IMPORT PAYROLL,D108,HJ,80.62,,520845.46
6150,5/14/2021,5/14/2021,51421,82L-IMPORT PAYROLL,D108,HJ,117.98,,520963.44
6150,5/14/2021,5/14/2021,51421,82L-IMPORT PAYROLL,D108,HJ,119.05,,521082.49
6150,5/14/2021,5/14/2021,51421,82L-IMPORT PAYROLL,D108,HJ,124,,521206.49
6150,5/14/2021,5/14/2021,51421,82L-IMPORT PAYROLL,D108,HJ,129.17,,521335.66
6150,5/14/2021,5/14/2021,51421,82L-IMPORT PAYROLL,D108,HJ,138.81,,521474.47
6150,5/14/2021,5/14/2021,51421,82L-IMPORT PAYROLL,D108,HJ,143.59,,521618.06
6150,5/14/2021,5/14/2021,51421,82L-IMPORT PAYROLL,D108,HJ,148.06,,521766.12
6150,5/14/2021,5/14/2021,51421,82L-IMPORT PAYROLL,D108,HJ,155,,521921.12
6150,5/14/2021,5/14/2021,51421,82L-IMPORT PAYROLL,D108,HJ,163.23,,522084.35
6150,5/14/2021,5/14/2021,51421,82L-IMPORT PAYROLL,D108,HJ,20.79,,522105.14
6150,5/14/2021,5/14/2021,51421,82L-IMPORT PAYROLL,D108,HJ,31.22,,522136.36
6150,5/14/2021,5/14/2021,51421,82L-IMPORT PAYROLL,D108,HJ,32.04,,522168.4
6150,5/14/2021,5/14/2021,51421,82L-IMPORT PAYROLL,D108,HJ,32.86,,522201.26
6150,5/14/2021,5/14/2021,51421,82L-IMPORT PAYROLL,D108,HJ,32.9,,522234.16
6150,5/14/2021,5/14/2021,51421,82L-IMPORT PAYROLL,D108,HJ,33.03,,522267.19
6150,5/14/2021,5/14/2021,51421,82L-IMPORT PAYROLL,D108,HJ,33.1,,522300.29
6150,5/14/2021,5/14/2021,51421,82L-IMPORT PAYROLL,D108,HJ,33.23,,522333.52
6150,5/14/2021,5/14/2021,51421,82L-IMPORT PAYROLL,D108,HJ,33.4,,522366.92
6150,5/14/2021,5/14/2021,51421,82L-IMPORT PAYROLL,D108,HJ,33.42,,522400.34
6150,5/14/2021,5/14/2021,51421,82L-IMPORT PAYROLL,D108,HJ,33.86,,522434.2
6150,5/14/2021,5/14/2021,51421,82L-IMPORT PAYROLL,D108,HJ,34.07,,522468.27
6150,5/14/2021,5/14/2021,51421,82L-IMPORT PAYROLL,D108,HJ,34.16,,522502.43
6150,5/14/2021,5/14/2021,51421,82L-IMPORT PAYROLL,D108,HJ,36.3,,522538.73
6150,5/14/2021,5/14/2021,51421,82L-IMPORT PAYROLL,D108,HJ,36.32,,522575.05
6150,5/14/2021,5/14/2021,51421,82L-IMPORT PAYROLL,D108,HJ,36.34,,522611.39
6150,5/14/2021,5/14/2021,51421,82L-IMPORT PAYROLL,D108,HJ,38.67,,522650.06
6150,5/14/2021,5/14/2021,51421,82L-IMPORT PAYROLL,D108,HJ,39.27,,522689.33
6150,5/14/2021,5/14/2021,51421,82L-IMPORT PAYROLL,D108,HJ,41.85,,522731.18
6150,5/14/2021,5/14/2021,51421,82L-IMPORT PAYROLL,D108,HJ,45.87,,522777.05
6150,5/14/2021,5/14/2021,51421,82L-IMPORT PAYROLL,D108,HJ,46.52,,522823.57
6150,5/14/2021,5/14/2021,51421,82L-IMPORT PAYROLL,D108,HJ,88.88,,522912.45
6150,5/14/2021,5/14/2021,51421,82L-IMPORT PAYROLL,D108,HJ,102.45,,523014.9
6150,5/14/2021,5/14/2021,51421,82L-IMPORT PAYROLL,D108,HJ,133.51,,523148.41
6150,5/14/2021,5/14/2021,51421,82L-IMPORT PAYROLL,D108,HJ,137,,523285.41
6150,5/14/2021,5/14/2021,51421,82L-IMPORT PAYROLL,D108,HJ,140.49,,523425.9
6150,5/14/2021,5/14/2021,51421,82L-IMPORT PAYROLL,D108,HJ,140.68,,523566.58
6150,5/14/2021,5/14/2021,51421,82L-IMPORT PAYROLL,D108,HJ,141.23,,523707.81
6150,5/14/2021,5/14/2021,51421,82L-IMPORT PAYROLL,D108,HJ,141.55,,523849.36
6150,5/14/2021,5/14/2021,51421,82L-IMPORT PAYROLL,D108,HJ,142.08,,523991.44
6150,5/14/2021,5/14/2021,51421,82L-IMPORT PAYROLL,D108,HJ,142.81,,524134.25
6150,5/14/2021,5/14/2021,51421,82L-IMPORT PAYROLL,D108,HJ,142.9,,524277.15
6150,5/14/2021,5/14/2021,51421,82L-IMPORT PAYROLL,D108,HJ,144.76,,524421.91
6150,5/14/2021,5/14/2021,51421,82L-IMPORT PAYROLL,D108,HJ,145.66,,524567.57
6150,5/14/2021,5/14/2021,51421,82L-IMPORT PAYROLL,D108,HJ,146.08,,524713.65
6150,5/14/2021,5/14/2021,51421,82L-IMPORT PAYROLL,D108,HJ,155.19,,524868.84
6150,5/14/2021,5/14/2021,51421,82L-IMPORT PAYROLL,D108,HJ,155.3,,525024.14
6150,5/14/2021,5/14/2021,51421,82L-IMPORT PAYROLL,D108,HJ,155.39,,525179.53
6150,5/14/2021,5/14/2021,51421,82L-IMPORT PAYROLL,D108,HJ,165.33,,525344.86
6150,5/14/2021,5/14/2021,51421,82L-IMPORT PAYROLL,D108,HJ,167.92,,525512.78
6150,5/14/2021,5/14/2021,51421,82L-IMPORT PAYROLL,D108,HJ,178.96,,525691.74
6150,5/14/2021,5/14/2021,51421,82L-IMPORT PAYROLL,D108,HJ,196.13,,525887.87
6150,5/14/2021,5/14/2021,51421,82L-IMPORT PAYROLL,D108,HJ,198.92,,526086.79
6150,5/14/2021,5/14/2021,51421,82L-IMPORT PAYROLL,D108,HJ,438.05,,526524.84
6150,5/14/2021,5/14/2021,51421,82L-IMPORT PAYROLL,D101,HJ,15.92,,526540.76
6150,5/14/2021,5/14/2021,51421,82L-IMPORT PAYROLL,D101,HJ,17.57,,526558.33
6150,5/14/2021,5/14/2021,51421,82L-IMPORT PAYROLL,D101,HJ,17.57,,526575.9
6150,5/14/2021,5/14/2021,51421,82L-IMPORT PAYROLL,D101,HJ,17.71,,526593.61
6150,5/14/2021,5/14/2021,51421,82L-IMPORT PAYROLL,D101,HJ,29.26,,526622.87
6150,5/14/2021,5/14/2021,51421,82L-IMPORT PAYROLL,D101,HJ,33.47,,526656.34
6150,5/14/2021,5/14/2021,51421,82L-IMPORT PAYROLL,D101,HJ,33.51,,526689.85
6150,5/14/2021,5/14/2021,51421,82L-IMPORT PAYROLL,D101,HJ,37.18,,526727.03
6150,5/14/2021,5/14/2021,51421,82L-IMPORT PAYROLL,D101,HJ,38.11,,526765.14
6150,5/14/2021,5/14/2021,51421,82L-IMPORT PAYROLL,D101,HJ,39.27,,526804.41
6150,5/14/2021,5/14/2021,51421,82L-IMPORT PAYROLL,D101,HJ,41.08,,526845.49
6150,5/14/2021,5/14/2021,51421,82L-IMPORT PAYROLL,D101,HJ,49.84,,526895.33
6150,5/14/2021,5/14/2021,51421,82L-IMPORT PAYROLL,D101,HJ,68.09,,526963.42
6150,5/14/2021,5/14/2021,51421,82L-IMPORT PAYROLL,D101,HJ,75.71,,527039.13
6150,5/14/2021,5/14/2021,51421,82L-IMPORT PAYROLL,D101,HJ,125.1,,527164.23
6150,5/14/2021,5/14/2021,51421,82L-IMPORT PAYROLL,D101,HJ,143.12,,527307.35
6150,5/14/2021,5/14/2021,51421,82L-IMPORT PAYROLL,D101,HJ,143.3,,527450.65
6150,5/14/2021,5/14/2021,51421,82L-IMPORT PAYROLL,D101,HJ,159,,527609.65
6150,5/14/2021,5/14/2021,51421,82L-IMPORT PAYROLL,D101,HJ,162.94,,527772.59
6150,5/14/2021,5/14/2021,51421,82L-IMPORT PAYROLL,D101,HJ,167.92,,527940.51
6150,5/14/2021,5/14/2021,51421,82L-IMPORT PAYROLL,D101,HJ,175.67,,528116.18
6150,5/14/2021,5/14/2021,51421,82L-IMPORT PAYROLL,D101,HJ,213.13,,528329.31
6150,5/14/2021,5/14/2021,51421,82L-IMPORT PAYROLL,D102,HJ,30.04,,528359.35
6150,5/14/2021,5/14/2021,51421,82L-IMPORT PAYROLL,D102,HJ,36.96,,528396.31
6150,5/14/2021,5/14/2021,51421,82L-IMPORT PAYROLL,D102,HJ,39,,528435.31
6150,5/14/2021,5/14/2021,51421,82L-IMPORT PAYROLL,D102,HJ,128.43,,528563.74
6150,5/14/2021,5/14/2021,51421,82L-IMPORT PAYROLL,D102,HJ,158.02,,528721.76
6150,5/14/2021,5/14/2021,51421,82L-IMPORT PAYROLL,D102,HJ,166.75,,528888.51
6150,5/14/2021,5/14/2021,51421,82L-IMPORT PAYROLL,D103,HJ,31.08,,528919.59
6150,5/14/2021,5/14/2021,51421,82L-IMPORT PAYROLL,D103,HJ,32.86,,528952.45
6150,5/14/2021,5/14/2021,51421,82L-IMPORT PAYROLL,D103,HJ,33.06,,528985.51
6150,5/14/2021,5/14/2021,51421,82L-IMPORT PAYROLL,D103,HJ,47.38,,529032.89
6150,5/14/2021,5/14/2021,51421,82L-IMPORT PAYROLL,D103,HJ,49.27,,529082.16
6150,5/14/2021,5/14/2021,51421,82L-IMPORT PAYROLL,D103,HJ,132.89,,529215.05
6150,5/14/2021,5/14/2021,51421,82L-IMPORT PAYROLL,D103,HJ,140.49,,529355.54
6150,5/14/2021,5/14/2021,51421,82L-IMPORT PAYROLL,D103,HJ,141.34,,529496.88
6150,5/14/2021,5/14/2021,51421,82L-IMPORT PAYROLL,D103,HJ,210.66,,529707.54
6150,5/14/2021,5/14/2021,51421,82L-IMPORT PAYROLL,D104,HJ,26.09,,529733.63
6150,5/14/2021,5/14/2021,51421,82L-IMPORT PAYROLL,D104,HJ,27.98,,529761.61
6150,5/14/2021,5/14/2021,51421,82L-IMPORT PAYROLL,D104,HJ,28.09,,529789.7
6150,5/14/2021,5/14/2021,51421,82L-IMPORT PAYROLL,D104,HJ,34.12,,529823.82
6150,5/14/2021,5/14/2021,51421,82L-IMPORT PAYROLL,D104,HJ,37.03,,529860.85
6150,5/14/2021,5/14/2021,51421,82L-IMPORT PAYROLL,D104,HJ,38.13,,529898.98
6150,5/14/2021,5/14/2021,51421,82L-IMPORT PAYROLL,D104,HJ,40.2,,529939.18
6150,5/14/2021,5/14/2021,51421,82L-IMPORT PAYROLL,D104,HJ,49.71,,529988.89
6150,5/14/2021,5/14/2021,51421,82L-IMPORT PAYROLL,D104,HJ,111.56,,530100.45
6150,5/14/2021,5/14/2021,51421,82L-IMPORT PAYROLL,D104,HJ,119.65,,530220.1
6150,5/14/2021,5/14/2021,51421,82L-IMPORT PAYROLL,D104,HJ,120.13,,530340.23
6150,5/14/2021,5/14/2021,51421,82L-IMPORT PAYROLL,D104,HJ,145.9,,530486.13
6150,5/14/2021,5/14/2021,51421,82L-IMPORT PAYROLL,D104,HJ,158.35,,530644.48
6150,5/14/2021,5/14/2021,51421,82L-IMPORT PAYROLL,D104,HJ,163.06,,530807.54
6150,5/14/2021,5/14/2021,51421,82L-IMPORT PAYROLL,D104,HJ,171.87,,530979.41
6150,5/14/2021,5/14/2021,51421,82L-IMPORT PAYROLL,D104,HJ,212.55,,531191.96
6150,5/14/2021,5/14/2021,51421,82L-IMPORT PAYROLL,D105,HJ,25.57,,531217.53
6150,5/14/2021,5/14/2021,51421,82L-IMPORT PAYROLL,D105,HJ,27.79,,531245.32
6150,5/14/2021,5/14/2021,51421,82L-IMPORT PAYROLL,D105,HJ,31.18,,531276.5
6150,5/14/2021,5/14/2021,51421,82L-IMPORT PAYROLL,D105,HJ,39.93,,531316.43
6150,5/14/2021,5/14/2021,51421,82L-IMPORT PAYROLL,D105,HJ,49.87,,531366.3
6150,5/14/2021,5/14/2021,51421,82L-IMPORT PAYROLL,D105,HJ,109.31,,531475.61
6150,5/14/2021,5/14/2021,51421,82L-IMPORT PAYROLL,D105,HJ,118.83,,531594.44
6150,5/14/2021,5/14/2021,51421,82L-IMPORT PAYROLL,D105,HJ,133.3,,531727.74
6150,5/14/2021,5/14/2021,51421,82L-IMPORT PAYROLL,D105,HJ,170.75,,531898.49
6150,5/14/2021,5/14/2021,51421,82L-IMPORT PAYROLL,D105,HJ,213.25,,532111.74
6150,5/14/2021,5/14/2021,51421,82L-IMPORT PAYROLL,D107,HJ,10.35,,532122.09
6150,5/14/2021,5/14/2021,51421,82L-IMPORT PAYROLL,D107,HJ,21.75,,532143.84
6150,5/14/2021,5/14/2021,51421,82L-IMPORT PAYROLL,D107,HJ,30.66,,532174.5
6150,5/14/2021,5/14/2021,51421,82L-IMPORT PAYROLL,D107,HJ,31.36,,532205.86
6150,5/14/2021,5/14/2021,51421,82L-IMPORT PAYROLL,D107,HJ,44.26,,532250.12
6150,5/14/2021,5/14/2021,51421,82L-IMPORT PAYROLL,D107,HJ,44.37,,532294.49
6150,5/14/2021,5/14/2021,51421,82L-IMPORT PAYROLL,D107,HJ,44.37,,532338.86
6150,5/14/2021,5/14/2021,51421,82L-IMPORT PAYROLL,D107,HJ,45.99,,532384.85
6150,5/14/2021,5/14/2021,51421,82L-IMPORT PAYROLL,D107,HJ,72.42,,532457.27
6150,5/14/2021,5/14/2021,51421,82L-IMPORT PAYROLL,D107,HJ,93,,532550.27
6150,5/14/2021,5/14/2021,51421,82L-IMPORT PAYROLL,D107,HJ,93.17,,532643.44
6150,5/14/2021,5/14/2021,51421,82L-IMPORT PAYROLL,D107,HJ,131.1,,532774.54
6150,5/14/2021,5/14/2021,51421,82L-IMPORT PAYROLL,D107,HJ,189.72,,532964.26
6150,5/14/2021,5/14/2021,51421,82L-IMPORT PAYROLL,D107,HJ,189.73,,533153.99
6150,5/14/2021,5/14/2021,51421,82L-IMPORT PAYROLL,D107,HJ,196.66,,533350.65
6150,5/14/2021,5/14/2021,51421,82L-IMPORT PAYROLL,D107,HJ,309.64,,533660.29
6150,5/14/2021,5/14/2021,51421,82L-IMPORT PAYROLL,D107,HJ,398.38,,534058.67
6150,5/14/2021,5/14/2021,51421,82L-IMPORT PAYROLL,D109,HJ,3.83,,534062.5
6150,5/14/2021,5/14/2021,51421,82L-IMPORT PAYROLL,D109,HJ,6.27,,534068.77
6150,5/14/2021,5/14/2021,51421,82L-IMPORT PAYROLL,D109,HJ,16.36,,534085.13
6150,5/14/2021,5/14/2021,51421,82L-IMPORT PAYROLL,D109,HJ,16.37,,534101.5
6150,5/14/2021,5/14/2021,51421,82L-IMPORT PAYROLL,D109,HJ,16.5,,534118
6150,5/14/2021,5/14/2021,51421,82L-IMPORT PAYROLL,D109,HJ,21.56,,534139.56
6150,5/14/2021,5/14/2021,51421,82L-IMPORT PAYROLL,D109,HJ,21.75,,534161.31
6150,5/14/2021,5/14/2021,51421,82L-IMPORT PAYROLL,D109,HJ,55.91,,534217.22
6150,5/14/2021,5/14/2021,51421,82L-IMPORT PAYROLL,D109,HJ,56.19,,534273.41
6150,5/14/2021,5/14/2021,51421,82L-IMPORT PAYROLL,D109,HJ,58.24,,534331.65
6150,5/14/2021,5/14/2021,51421,82L-IMPORT PAYROLL,D109,HJ,72.5,,534404.15
6150,5/14/2021,5/14/2021,51421,82L-IMPORT PAYROLL,D109,HJ,76.2,,534480.35
6150,5/14/2021,5/14/2021,51421,82L-IMPORT PAYROLL,D109,HJ,76.2,,534556.55
6150,5/14/2021,5/14/2021,51421,82L-IMPORT PAYROLL,D109,HJ,77.94,,534634.49
6150,5/14/2021,5/14/2021,51421,82L-IMPORT PAYROLL,D109,HJ,78.54,,534713.03
6150,5/14/2021,5/14/2021,51421,82L-IMPORT PAYROLL,D109,HJ,79.99,,534793.02
6150,5/14/2021,5/14/2021,51421,82L-IMPORT PAYROLL,D109,HJ,92.2,,534885.22
6150,5/14/2021,5/14/2021,51421,82L-IMPORT PAYROLL,D109,HJ,93,,534978.22
6150,5/14/2021,5/14/2021,51421,82L-IMPORT PAYROLL,D109,HJ,239.08,,535217.3
6150,5/14/2021,5/14/2021,51421,82L-IMPORT PAYROLL,D109,HJ,240.25,,535457.55
6150,5/14/2021,5/14/2021,51421,82L-IMPORT PAYROLL,D109,HJ,249.03,,535706.58
6150,5/14/2021,5/14/2021,51421,82L-IMPORT PAYROLL,D109,HJ,310,,536016.58
6150,5/14/2021,5/14/2021,51421,82L-IMPORT PAYROLL,D109,HJ,325.8,,536342.38
6150,5/14/2021,5/14/2021,51421,82L-IMPORT PAYROLL,D109,HJ,325.8,,536668.18
6150,5/14/2021,5/14/2021,51421,82L-IMPORT PAYROLL,D109,HJ,333.27,,537001.45
6150,5/14/2021,5/14/2021,51421,82L-IMPORT PAYROLL,D109,HJ,335.83,,537337.28
6150,5/14/2021,5/14/2021,51421,82L-IMPORT PAYROLL,D109,HJ,342.03,,537679.31
6150,5/14/2021,5/14/2021,51421,82L-IMPORT PAYROLL,D111,HJ,13.18,,537692.49
6150,5/14/2021,5/14/2021,51421,82L-IMPORT PAYROLL,D111,HJ,23.29,,537715.78
6150,5/14/2021,5/14/2021,51421,82L-IMPORT PAYROLL,D111,HJ,28.73,,537744.51
6150,5/14/2021,5/14/2021,51421,82L-IMPORT PAYROLL,D111,HJ,34.25,,537778.76
6150,5/14/2021,5/14/2021,51421,82L-IMPORT PAYROLL,D111,HJ,36.44,,537815.2
6150,5/14/2021,5/14/2021,51421,82L-IMPORT PAYROLL,D111,HJ,52.29,,537867.49
6150,5/14/2021,5/14/2021,51421,82L-IMPORT PAYROLL,D111,HJ,99.58,,537967.07
6150,5/14/2021,5/14/2021,51421,82L-IMPORT PAYROLL,D111,HJ,122.83,,538089.9
6150,5/14/2021,5/14/2021,51421,82L-IMPORT PAYROLL,D111,HJ,146.43,,538236.33
6150,5/14/2021,5/14/2021,51421,82L-IMPORT PAYROLL,D111,HJ,155.82,,538392.15
6150,5/14/2021,5/14/2021,51421,82L-IMPORT PAYROLL,D111,HJ,223.58,,538615.73
6150,5/14/2021,5/14/2021,51421,82L-IMPORT PAYROLL,D112,HJ,37.96,,538653.69
6150,5/14/2021,5/14/2021,51421,82L-IMPORT PAYROLL,D112,HJ,162.32,,538816.01
6150,5/14/2021,5/14/2021,51421,82L-IMPORT PAYROLL,D108,HJ,1.25,,538817.26
6150,5/14/2021,5/14/2021,51421,82L-IMPORT PAYROLL,D108,HJ,1.64,,538818.9
6150,5/14/2021,5/14/2021,51421,82L-IMPORT PAYROLL,D108,HJ,6.94,,538825.84
6150,5/14/2021,5/14/2021,51421,82L-IMPORT PAYROLL,D108,HJ,14,,538839.84
6150,5/14/2021,5/14/2021,51421,82L-IMPORT PAYROLL,D108,HJ,14.43,,538854.27
6150,5/14/2021,5/14/2021,51421,82L-IMPORT PAYROLL,D108,HJ,15.08,,538869.35
6150,5/14/2021,5/14/2021,51421,82L-IMPORT PAYROLL,D108,HJ,15.08,,538884.43
6150,5/14/2021,5/14/2021,51421,82L-IMPORT PAYROLL,D108,HJ,15.28,,538899.71
6150,5/14/2021,5/14/2021,51421,82L-IMPORT PAYROLL,D108,HJ,15.28,,538914.99
6150,5/14/2021,5/14/2021,51421,82L-IMPORT PAYROLL,D108,HJ,15.33,,538930.32
6150,5/14/2021,5/14/2021,51421,82L-IMPORT PAYROLL,D108,HJ,16.05,,538946.37
6150,5/14/2021,5/14/2021,51421,82L-IMPORT PAYROLL,D108,HJ,16.2,,538962.57
6150,5/14/2021,5/14/2021,51421,82L-IMPORT PAYROLL,D108,HJ,16.23,,538978.8
6150,5/14/2021,5/14/2021,51421,82L-IMPORT PAYROLL,D108,HJ,16.23,,538995.03
6150,5/14/2021,5/14/2021,51421,82L-IMPORT PAYROLL,D108,HJ,16.23,,539011.26
6150,5/14/2021,5/14/2021,51421,82L-IMPORT PAYROLL,D108,HJ,16.23,,539027.49
6150,5/14/2021,5/14/2021,51421,82L-IMPORT PAYROLL,D108,HJ,16.23,,539043.72
6150,5/14/2021,5/14/2021,51421,82L-IMPORT PAYROLL,D108,HJ,16.23,,539059.95
6150,5/14/2021,5/14/2021,51421,82L-IMPORT PAYROLL,D108,HJ,16.23,,539076.18
6150,5/14/2021,5/14/2021,51421,82L-IMPORT PAYROLL,D108,HJ,16.23,,539092.41
6150,5/14/2021,5/14/2021,51421,82L-IMPORT PAYROLL,D108,HJ,16.23,,539108.64
6150,5/14/2021,5/14/2021,51421,82L-IMPORT PAYROLL,D108,HJ,16.23,,539124.87
6150,5/14/2021,5/14/2021,51421,82L-IMPORT PAYROLL,D108,HJ,16.23,,539141.1
6150,5/14/2021,5/14/2021,51421,82L-IMPORT PAYROLL,D108,HJ,16.23,,539157.33
6150,5/14/2021,5/14/2021,51421,82L-IMPORT PAYROLL,D108,HJ,16.23,,539173.56
6150,5/14/2021,5/14/2021,51421,82L-IMPORT PAYROLL,D108,HJ,16.23,,539189.79
6150,5/14/2021,5/14/2021,51421,82L-IMPORT PAYROLL,D108,HJ,16.23,,539206.02
6150,5/14/2021,5/14/2021,51421,82L-IMPORT PAYROLL,D108,HJ,16.23,,539222.25
6150,5/14/2021,5/14/2021,51421,82L-IMPORT PAYROLL,D108,HJ,16.23,,539238.48
6150,5/14/2021,5/14/2021,51421,82L-IMPORT PAYROLL,D108,HJ,16.23,,539254.71
6150,5/14/2021,5/14/2021,51421,82L-IMPORT PAYROLL,D108,HJ,16.24,,539270.95
6150,5/14/2021,5/14/2021,51421,82L-IMPORT PAYROLL,D108,HJ,28.09,,539299.04
6150,5/14/2021,5/14/2021,51421,82L-IMPORT PAYROLL,D108,HJ,30.44,,539329.48
6150,5/14/2021,5/14/2021,51421,82L-IMPORT PAYROLL,D108,HJ,30.56,,539360.04
6150,5/14/2021,5/14/2021,51421,82L-IMPORT PAYROLL,D108,HJ,31,,539391.04
6150,5/14/2021,5/14/2021,51421,82L-IMPORT PAYROLL,D108,HJ,31.04,,539422.08
6150,5/14/2021,5/14/2021,51421,82L-IMPORT PAYROLL,D108,HJ,32.36,,539454.44
6150,5/14/2021,5/14/2021,51421,82L-IMPORT PAYROLL,D108,HJ,32.63,,539487.07
6150,5/14/2021,5/14/2021,51421,82L-IMPORT PAYROLL,D108,HJ,33.23,,539520.3
6150,5/14/2021,5/14/2021,51421,82L-IMPORT PAYROLL,D108,HJ,33.57,,539553.87
6150,5/14/2021,5/14/2021,51421,82L-IMPORT PAYROLL,D108,HJ,33.96,,539587.83
6150,5/14/2021,5/14/2021,51421,82L-IMPORT PAYROLL,D108,HJ,34.16,,539621.99
6150,5/14/2021,5/14/2021,51421,82L-IMPORT PAYROLL,D108,HJ,34.74,,539656.73
6150,5/14/2021,5/14/2021,51421,82L-IMPORT PAYROLL,D108,HJ,34.79,,539691.52
6150,5/14/2021,5/14/2021,51421,82L-IMPORT PAYROLL,D108,HJ,35.1,,539726.62
6150,5/14/2021,5/14/2021,51421,82L-IMPORT PAYROLL,D108,HJ,36.93,,539763.55
6150,5/14/2021,5/14/2021,51421,82L-IMPORT PAYROLL,D108,HJ,41.91,,539805.46
6150,5/14/2021,5/14/2021,51421,82L-IMPORT PAYROLL,D108,HJ,54.34,,539859.8
6150,5/14/2021,5/14/2021,51421,82L-IMPORT PAYROLL,D108,HJ,59.86,,539919.66
6150,5/14/2021,5/14/2021,51421,82L-IMPORT PAYROLL,D108,HJ,61.7,,539981.36
6150,5/14/2021,5/14/2021,51421,82L-IMPORT PAYROLL,D108,HJ,64.5,,540045.86
6150,5/14/2021,5/14/2021,51421,82L-IMPORT PAYROLL,D108,HJ,64.5,,540110.36
6150,5/14/2021,5/14/2021,51421,82L-IMPORT PAYROLL,D108,HJ,65.35,,540175.71
6150,5/14/2021,5/14/2021,51421,82L-IMPORT PAYROLL,D108,HJ,65.35,,540241.06
6150,5/14/2021,5/14/2021,51421,82L-IMPORT PAYROLL,D108,HJ,68.64,,540309.7
6150,5/14/2021,5/14/2021,51421,82L-IMPORT PAYROLL,D108,HJ,69.27,,540378.97
6150,5/14/2021,5/14/2021,51421,82L-IMPORT PAYROLL,D108,HJ,69.38,,540448.35
6150,5/14/2021,5/14/2021,51421,82L-IMPORT PAYROLL,D108,HJ,69.38,,540517.73
6150,5/14/2021,5/14/2021,51421,82L-IMPORT PAYROLL,D108,HJ,69.38,,540587.11
6150,5/14/2021,5/14/2021,51421,82L-IMPORT PAYROLL,D108,HJ,69.38,,540656.49
6150,5/14/2021,5/14/2021,51421,82L-IMPORT PAYROLL,D108,HJ,69.38,,540725.87
6150,5/14/2021,5/14/2021,51421,82L-IMPORT PAYROLL,D108,HJ,69.38,,540795.25
6150,5/14/2021,5/14/2021,51421,82L-IMPORT PAYROLL,D108,HJ,69.38,,540864.63
6150,5/14/2021,5/14/2021,51421,82L-IMPORT PAYROLL,D108,HJ,69.38,,540934.01
6150,5/14/2021,5/14/2021,51421,82L-IMPORT PAYROLL,D108,HJ,69.38,,541003.39
6150,5/14/2021,5/14/2021,51421,82L-IMPORT PAYROLL,D108,HJ,69.38,,541072.77
6150,5/14/2021,5/14/2021,51421,82L-IMPORT PAYROLL,D108,HJ,69.38,,541142.15
6150,5/14/2021,5/14/2021,51421,82L-IMPORT PAYROLL,D108,HJ,69.38,,541211.53
6150,5/14/2021,5/14/2021,51421,82L-IMPORT PAYROLL,D108,HJ,69.38,,541280.91
6150,5/14/2021,5/14/2021,51421,82L-IMPORT PAYROLL,D108,HJ,69.38,,541350.29
6150,5/14/2021,5/14/2021,51421,82L-IMPORT PAYROLL,D108,HJ,69.38,,541419.67
6150,5/14/2021,5/14/2021,51421,82L-IMPORT PAYROLL,D108,HJ,69.38,,541489.05
6150,5/14/2021,5/14/2021,51421,82L-IMPORT PAYROLL,D108,HJ,69.41,,541558.46
6150,5/14/2021,5/14/2021,51421,82L-IMPORT PAYROLL,D108,HJ,69.41,,541627.87
6150,5/14/2021,5/14/2021,51421,82L-IMPORT PAYROLL,D108,HJ,69.44,,541697.31
6150,5/14/2021,5/14/2021,51421,82L-IMPORT PAYROLL,D108,HJ,74.25,,541771.56
6150,5/14/2021,5/14/2021,51421,82L-IMPORT PAYROLL,D108,HJ,130.16,,541901.72
6150,5/14/2021,5/14/2021,51421,82L-IMPORT PAYROLL,D108,HJ,130.69,,542032.41
6150,5/14/2021,5/14/2021,51421,82L-IMPORT PAYROLL,D108,HJ,132.56,,542164.97
6150,5/14/2021,5/14/2021,51421,82L-IMPORT PAYROLL,D108,HJ,132.74,,542297.71
6150,5/14/2021,5/14/2021,51421,82L-IMPORT PAYROLL,D108,HJ,138.38,,542436.09
6150,5/14/2021,5/14/2021,51421,82L-IMPORT PAYROLL,D108,HJ,139.5,,542575.59
6150,5/14/2021,5/14/2021,51421,82L-IMPORT PAYROLL,D108,HJ,142.08,,542717.67
6150,5/14/2021,5/14/2021,51421,82L-IMPORT PAYROLL,D108,HJ,145.23,,542862.9
6150,5/14/2021,5/14/2021,51421,82L-IMPORT PAYROLL,D108,HJ,146.08,,543008.98
6150,5/14/2021,5/14/2021,51421,82L-IMPORT PAYROLL,D108,HJ,148.53,,543157.51
6150,5/14/2021,5/14/2021,51421,82L-IMPORT PAYROLL,D108,HJ,148.76,,543306.27
6150,5/14/2021,5/14/2021,51421,82L-IMPORT PAYROLL,D108,HJ,150.1,,543456.37
6150,5/14/2021,5/14/2021,51421,82L-IMPORT PAYROLL,D108,HJ,179.22,,543635.59
6150,5/14/2021,5/14/2021,51421,82L-IMPORT PAYROLL,D108,HJ,232.34,,543867.93
6150,5/14/2021,5/14/2021,51421,82L-IMPORT PAYROLL,D108,HJ,16.53,,543884.46
6150,5/14/2021,5/14/2021,51421,82L-IMPORT PAYROLL,D108,HJ,19.38,,543903.84
6150,5/14/2021,5/14/2021,51421,82L-IMPORT PAYROLL,D108,HJ,37.75,,543941.59
6150,5/14/2021,5/14/2021,51421,82L-IMPORT PAYROLL,D108,HJ,38.07,,543979.66
6150,5/14/2021,5/14/2021,51421,82L-IMPORT PAYROLL,D108,HJ,38.67,,544018.33
6150,5/14/2021,5/14/2021,51421,82L-IMPORT PAYROLL,D108,HJ,42.91,,544061.24
6150,5/14/2021,5/14/2021,51421,82L-IMPORT PAYROLL,D108,HJ,78.85,,544140.09
6150,5/14/2021,5/14/2021,51421,82L-IMPORT PAYROLL,D108,HJ,161.4,,544301.49
6150,5/14/2021,5/14/2021,51421,82L-IMPORT PAYROLL,D108,HJ,162.79,,544464.28
6150,5/14/2021,5/14/2021,51421,82L-IMPORT PAYROLL,D108,HJ,165.33,,544629.61
6150,5/14/2021,5/14/2021,51421,82L-IMPORT PAYROLL,D108,HJ,183.48,,544813.09
6150,5/14/2021,5/14/2021,51421,82L-IMPORT PAYROLL,D108,HJ,337.14,,545150.23
6150,5/14/2021,5/14/2021,ADP,ADP state UI filings and penatlies May 2021,D104,HJ,4.3,,545154.53
6150,5/14/2021,5/14/2021,ADP,ADP state UI filings and penatlies May 2021,D104,HJ,6.45,,545160.98
6150,5/14/2021,5/14/2021,ADP,ADP state UI filings and penatlies May 2021,D104,HJ,18.62,,545179.6
6150,5/14/2021,5/14/2021,ADP,ADP state UI filings and penatlies May 2021,D104,HJ,27.93,,545207.53
6150,5/14/2021,5/14/2021,ADP,ADP state UI filings and penatlies May 2021,D104,HJ,120.32,,545327.85
6150,5/14/2021,5/14/2021,ADP,ADP state UI filings and penatlies May 2021,D104,HJ,180.48,,545508.33
6150,5/26/2021,5/26/2021,ADP,ADP state UI filings and penatlies May 2021,D104,HJ,4.17,,545512.5
6150,5/26/2021,5/26/2021,ADP,ADP state UI filings and penatlies May 2021,D104,HJ,18.07,,545530.57
6150,5/26/2021,5/26/2021,ADP,ADP state UI filings and penatlies May 2021,D104,HJ,54.86,,545585.43
6150,5/26/2021,5/26/2021,ADP,ADP state UI filings and penatlies May 2021,D104,HJ,116.76,,545702.19
6150,5/26/2021,5/26/2021,ADP,ADP state UI filings and penatlies May 2021,D104,HJ,237.74,,545939.93
6150,5/26/2021,5/26/2021,ADP,ADP state UI filings and penatlies May 2021,D104,HJ,1536.19,,547476.12
6150,5/28/2021,5/28/2021,52821,82L-IMPORT PAYROLL,D108,HJ,0.37,,547476.49
6150,5/28/2021,5/28/2021,52821,82L-IMPORT PAYROLL,D108,HJ,7.01,,547483.5
6150,5/28/2021,5/28/2021,52821,82L-IMPORT PAYROLL,D108,HJ,10.99,,547494.49
6150,5/28/2021,5/28/2021,52821,82L-IMPORT PAYROLL,D108,HJ,13.25,,547507.74
6150,5/28/2021,5/28/2021,52821,82L-IMPORT PAYROLL,D108,HJ,14.01,,547521.75
6150,5/28/2021,5/28/2021,52821,82L-IMPORT PAYROLL,D108,HJ,14.01,,547535.76
6150,5/28/2021,5/28/2021,52821,82L-IMPORT PAYROLL,D108,HJ,14.01,,547549.77
6150,5/28/2021,5/28/2021,52821,82L-IMPORT PAYROLL,D108,HJ,14.05,,547563.82
6150,5/28/2021,5/28/2021,52821,82L-IMPORT PAYROLL,D108,HJ,14.25,,547578.07
6150,5/28/2021,5/28/2021,52821,82L-IMPORT PAYROLL,D108,HJ,14.25,,547592.32
6150,5/28/2021,5/28/2021,52821,82L-IMPORT PAYROLL,D108,HJ,14.25,,547606.57
6150,5/28/2021,5/28/2021,52821,82L-IMPORT PAYROLL,D108,HJ,14.66,,547621.23
6150,5/28/2021,5/28/2021,52821,82L-IMPORT PAYROLL,D108,HJ,14.99,,547636.22
6150,5/28/2021,5/28/2021,52821,82L-IMPORT PAYROLL,D108,HJ,15.16,,547651.38
6150,5/28/2021,5/28/2021,52821,82L-IMPORT PAYROLL,D108,HJ,15.19,,547666.57
6150,5/28/2021,5/28/2021,52821,82L-IMPORT PAYROLL,D108,HJ,15.19,,547681.76
6150,5/28/2021,5/28/2021,52821,82L-IMPORT PAYROLL,D108,HJ,15.19,,547696.95
6150,5/28/2021,5/28/2021,52821,82L-IMPORT PAYROLL,D108,HJ,15.19,,547712.14
6150,5/28/2021,5/28/2021,52821,82L-IMPORT PAYROLL,D108,HJ,15.19,,547727.33
6150,5/28/2021,5/28/2021,52821,82L-IMPORT PAYROLL,D108,HJ,15.19,,547742.52
6150,5/28/2021,5/28/2021,52821,82L-IMPORT PAYROLL,D108,HJ,15.19,,547757.71
6150,5/28/2021,5/28/2021,52821,82L-IMPORT PAYROLL,D108,HJ,15.19,,547772.9
6150,5/28/2021,5/28/2021,52821,82L-IMPORT PAYROLL,D108,HJ,15.19,,547788.09
6150,5/28/2021,5/28/2021,52821,82L-IMPORT PAYROLL,D108,HJ,15.19,,547803.28
6150,5/28/2021,5/28/2021,52821,82L-IMPORT PAYROLL,D108,HJ,15.19,,547818.47
6150,5/28/2021,5/28/2021,52821,82L-IMPORT PAYROLL,D108,HJ,15.19,,547833.66
6150,5/28/2021,5/28/2021,52821,82L-IMPORT PAYROLL,D108,HJ,15.19,,547848.85
6150,5/28/2021,5/28/2021,52821,82L-IMPORT PAYROLL,D108,HJ,15.19,,547864.04
6150,5/28/2021,5/28/2021,52821,82L-IMPORT PAYROLL,D108,HJ,15.19,,547879.23
6150,5/28/2021,5/28/2021,52821,82L-IMPORT PAYROLL,D108,HJ,15.19,,547894.42
6150,5/28/2021,5/28/2021,52821,82L-IMPORT PAYROLL,D108,HJ,17.65,,547912.07
6150,5/28/2021,5/28/2021,52821,82L-IMPORT PAYROLL,D108,HJ,24.56,,547936.63
6150,5/28/2021,5/28/2021,52821,82L-IMPORT PAYROLL,D108,HJ,26.53,,547963.16
6150,5/28/2021,5/28/2021,52821,82L-IMPORT PAYROLL,D108,HJ,27.59,,547990.75
6150,5/28/2021,5/28/2021,52821,82L-IMPORT PAYROLL,D108,HJ,27.84,,548018.59
6150,5/28/2021,5/28/2021,52821,82L-IMPORT PAYROLL,D108,HJ,28.08,,548046.67
6150,5/28/2021,5/28/2021,52821,82L-IMPORT PAYROLL,D108,HJ,28.29,,548074.96
6150,5/28/2021,5/28/2021,52821,82L-IMPORT PAYROLL,D108,HJ,29,,548103.96
6150,5/28/2021,5/28/2021,52821,82L-IMPORT PAYROLL,D108,HJ,29.98,,548133.94
6150,5/28/2021,5/28/2021,52821,82L-IMPORT PAYROLL,D108,HJ,30.21,,548164.15
6150,5/28/2021,5/28/2021,52821,82L-IMPORT PAYROLL,D108,HJ,31.43,,548195.58
6150,5/28/2021,5/28/2021,52821,82L-IMPORT PAYROLL,D108,HJ,32.46,,548228.04
6150,5/28/2021,5/28/2021,52821,82L-IMPORT PAYROLL,D108,HJ,33.58,,548261.62
6150,5/28/2021,5/28/2021,52821,82L-IMPORT PAYROLL,D108,HJ,34.63,,548296.25
6150,5/28/2021,5/28/2021,52821,82L-IMPORT PAYROLL,D108,HJ,36.25,,548332.5
6150,5/28/2021,5/28/2021,52821,82L-IMPORT PAYROLL,D108,HJ,38.17,,548370.67
6150,5/28/2021,5/28/2021,52821,82L-IMPORT PAYROLL,D108,HJ,59.89,,548430.56
6150,5/28/2021,5/28/2021,52821,82L-IMPORT PAYROLL,D108,HJ,59.89,,548490.45
6150,5/28/2021,5/28/2021,52821,82L-IMPORT PAYROLL,D108,HJ,59.89,,548550.34
6150,5/28/2021,5/28/2021,52821,82L-IMPORT PAYROLL,D108,HJ,60.07,,548610.41
6150,5/28/2021,5/28/2021,52821,82L-IMPORT PAYROLL,D108,HJ,60.92,,548671.33
6150,5/28/2021,5/28/2021,52821,82L-IMPORT PAYROLL,D108,HJ,60.92,,548732.25
6150,5/28/2021,5/28/2021,52821,82L-IMPORT PAYROLL,D108,HJ,60.92,,548793.17
6150,5/28/2021,5/28/2021,52821,82L-IMPORT PAYROLL,D108,HJ,62.68,,548855.85
6150,5/28/2021,5/28/2021,52821,82L-IMPORT PAYROLL,D108,HJ,64.1,,548919.95
6150,5/28/2021,5/28/2021,52821,82L-IMPORT PAYROLL,D108,HJ,64.84,,548984.79
6150,5/28/2021,5/28/2021,52821,82L-IMPORT PAYROLL,D108,HJ,64.95,,549049.74
6150,5/28/2021,5/28/2021,52821,82L-IMPORT PAYROLL,D108,HJ,64.95,,549114.69
6150,5/28/2021,5/28/2021,52821,82L-IMPORT PAYROLL,D108,HJ,64.95,,549179.64
6150,5/28/2021,5/28/2021,52821,82L-IMPORT PAYROLL,D108,HJ,64.95,,549244.59
6150,5/28/2021,5/28/2021,52821,82L-IMPORT PAYROLL,D108,HJ,64.95,,549309.54
6150,5/28/2021,5/28/2021,52821,82L-IMPORT PAYROLL,D108,HJ,64.95,,549374.49
6150,5/28/2021,5/28/2021,52821,82L-IMPORT PAYROLL,D108,HJ,64.95,,549439.44
6150,5/28/2021,5/28/2021,52821,82L-IMPORT PAYROLL,D108,HJ,64.95,,549504.39
6150,5/28/2021,5/28/2021,52821,82L-IMPORT PAYROLL,D108,HJ,64.95,,549569.34
6150,5/28/2021,5/28/2021,52821,82L-IMPORT PAYROLL,D108,HJ,64.95,,549634.29
6150,5/28/2021,5/28/2021,52821,82L-IMPORT PAYROLL,D108,HJ,64.95,,549699.24
6150,5/28/2021,5/28/2021,52821,82L-IMPORT PAYROLL,D108,HJ,64.95,,549764.19
6150,5/28/2021,5/28/2021,52821,82L-IMPORT PAYROLL,D108,HJ,64.95,,549829.14
6150,5/28/2021,5/28/2021,52821,82L-IMPORT PAYROLL,D108,HJ,64.95,,549894.09
6150,5/28/2021,5/28/2021,52821,82L-IMPORT PAYROLL,D108,HJ,64.95,,549959.04
6150,5/28/2021,5/28/2021,52821,82L-IMPORT PAYROLL,D108,HJ,64.95,,550023.99
6150,5/28/2021,5/28/2021,52821,82L-IMPORT PAYROLL,D108,HJ,75.45,,550099.44
6150,5/28/2021,5/28/2021,52821,82L-IMPORT PAYROLL,D108,HJ,80.62,,550180.06
6150,5/28/2021,5/28/2021,52821,82L-IMPORT PAYROLL,D108,HJ,117.98,,550298.04
6150,5/28/2021,5/28/2021,52821,82L-IMPORT PAYROLL,D108,HJ,119.05,,550417.09
6150,5/28/2021,5/28/2021,52821,82L-IMPORT PAYROLL,D108,HJ,124,,550541.09
6150,5/28/2021,5/28/2021,52821,82L-IMPORT PAYROLL,D108,HJ,129.17,,550670.26
6150,5/28/2021,5/28/2021,52821,82L-IMPORT PAYROLL,D108,HJ,138.81,,550809.07
6150,5/28/2021,5/28/2021,52821,82L-IMPORT PAYROLL,D108,HJ,143.59,,550952.66
6150,5/28/2021,5/28/2021,52821,82L-IMPORT PAYROLL,D108,HJ,148.06,,551100.72
6150,5/28/2021,5/28/2021,52821,82L-IMPORT PAYROLL,D108,HJ,155,,551255.72
6150,5/28/2021,5/28/2021,52821,82L-IMPORT PAYROLL,D108,HJ,163.23,,551418.95
6150,5/28/2021,5/28/2021,52821,82L-IMPORT PAYROLL,D108,HJ,31.22,,551450.17
6150,5/28/2021,5/28/2021,52821,82L-IMPORT PAYROLL,D108,HJ,32.04,,551482.21
6150,5/28/2021,5/28/2021,52821,82L-IMPORT PAYROLL,D108,HJ,32.86,,551515.07
6150,5/28/2021,5/28/2021,52821,82L-IMPORT PAYROLL,D108,HJ,32.9,,551547.97
6150,5/28/2021,5/28/2021,52821,82L-IMPORT PAYROLL,D108,HJ,33.03,,551581
6150,5/28/2021,5/28/2021,52821,82L-IMPORT PAYROLL,D108,HJ,33.1,,551614.1
6150,5/28/2021,5/28/2021,52821,82L-IMPORT PAYROLL,D108,HJ,33.23,,551647.33
6150,5/28/2021,5/28/2021,52821,82L-IMPORT PAYROLL,D108,HJ,33.4,,551680.73
6150,5/28/2021,5/28/2021,52821,82L-IMPORT PAYROLL,D108,HJ,33.42,,551714.15
6150,5/28/2021,5/28/2021,52821,82L-IMPORT PAYROLL,D108,HJ,33.86,,551748.01
6150,5/28/2021,5/28/2021,52821,82L-IMPORT PAYROLL,D108,HJ,34.07,,551782.08
6150,5/28/2021,5/28/2021,52821,82L-IMPORT PAYROLL,D108,HJ,34.16,,551816.24
6150,5/28/2021,5/28/2021,52821,82L-IMPORT PAYROLL,D108,HJ,36.27,,551852.51
6150,5/28/2021,5/28/2021,52821,82L-IMPORT PAYROLL,D108,HJ,36.3,,551888.81
6150,5/28/2021,5/28/2021,52821,82L-IMPORT PAYROLL,D108,HJ,36.32,,551925.13
6150,5/28/2021,5/28/2021,52821,82L-IMPORT PAYROLL,D108,HJ,36.34,,551961.47
6150,5/28/2021,5/28/2021,52821,82L-IMPORT PAYROLL,D108,HJ,38.67,,552000.14
6150,5/28/2021,5/28/2021,52821,82L-IMPORT PAYROLL,D108,HJ,39.27,,552039.41
6150,5/28/2021,5/28/2021,52821,82L-IMPORT PAYROLL,D108,HJ,41.85,,552081.26
6150,5/28/2021,5/28/2021,52821,82L-IMPORT PAYROLL,D108,HJ,43.25,,552124.51
6150,5/28/2021,5/28/2021,52821,82L-IMPORT PAYROLL,D108,HJ,46.52,,552171.03
6150,5/28/2021,5/28/2021,52821,82L-IMPORT PAYROLL,D108,HJ,51.5,,552222.53
6150,5/28/2021,5/28/2021,52821,82L-IMPORT PAYROLL,D108,HJ,65.29,,552287.82
6150,5/28/2021,5/28/2021,52821,82L-IMPORT PAYROLL,D108,HJ,133.51,,552421.33
6150,5/28/2021,5/28/2021,52821,82L-IMPORT PAYROLL,D108,HJ,137,,552558.33
6150,5/28/2021,5/28/2021,52821,82L-IMPORT PAYROLL,D108,HJ,140.49,,552698.82
6150,5/28/2021,5/28/2021,52821,82L-IMPORT PAYROLL,D108,HJ,140.68,,552839.5
6150,5/28/2021,5/28/2021,52821,82L-IMPORT PAYROLL,D108,HJ,141.23,,552980.73
6150,5/28/2021,5/28/2021,52821,82L-IMPORT PAYROLL,D108,HJ,141.55,,553122.28
6150,5/28/2021,5/28/2021,52821,82L-IMPORT PAYROLL,D108,HJ,142.08,,553264.36
6150,5/28/2021,5/28/2021,52821,82L-IMPORT PAYROLL,D108,HJ,142.81,,553407.17
6150,5/28/2021,5/28/2021,52821,82L-IMPORT PAYROLL,D108,HJ,142.9,,553550.07
6150,5/28/2021,5/28/2021,52821,82L-IMPORT PAYROLL,D108,HJ,144.76,,553694.83
6150,5/28/2021,5/28/2021,52821,82L-IMPORT PAYROLL,D108,HJ,145.66,,553840.49
6150,5/28/2021,5/28/2021,52821,82L-IMPORT PAYROLL,D108,HJ,146.08,,553986.57
6150,5/28/2021,5/28/2021,52821,82L-IMPORT PAYROLL,D108,HJ,155.09,,554141.66
6150,5/28/2021,5/28/2021,52821,82L-IMPORT PAYROLL,D108,HJ,155.19,,554296.85
6150,5/28/2021,5/28/2021,52821,82L-IMPORT PAYROLL,D108,HJ,155.3,,554452.15
6150,5/28/2021,5/28/2021,52821,82L-IMPORT PAYROLL,D108,HJ,155.39,,554607.54
6150,5/28/2021,5/28/2021,52821,82L-IMPORT PAYROLL,D108,HJ,165.33,,554772.87
6150,5/28/2021,5/28/2021,52821,82L-IMPORT PAYROLL,D108,HJ,167.92,,554940.79
6150,5/28/2021,5/28/2021,52821,82L-IMPORT PAYROLL,D108,HJ,178.96,,555119.75
6150,5/28/2021,5/28/2021,52821,82L-IMPORT PAYROLL,D108,HJ,184.93,,555304.68
6150,5/28/2021,5/28/2021,52821,82L-IMPORT PAYROLL,D108,HJ,198.92,,555503.6
6150,5/28/2021,5/28/2021,52821,82L-IMPORT PAYROLL,D108,HJ,220.21,,555723.81
6150,5/28/2021,5/28/2021,52821,82L-IMPORT PAYROLL,D108,HJ,279.17,,556002.98
6150,5/28/2021,5/28/2021,52821,82L-IMPORT PAYROLL,D101,HJ,15.92,,556018.9
6150,5/28/2021,5/28/2021,52821,82L-IMPORT PAYROLL,D101,HJ,17.57,,556036.47
6150,5/28/2021,5/28/2021,52821,82L-IMPORT PAYROLL,D101,HJ,17.57,,556054.04
6150,5/28/2021,5/28/2021,52821,82L-IMPORT PAYROLL,D101,HJ,17.71,,556071.75
6150,5/28/2021,5/28/2021,52821,82L-IMPORT PAYROLL,D101,HJ,29.31,,556101.06
6150,5/28/2021,5/28/2021,52821,82L-IMPORT PAYROLL,D101,HJ,33.23,,556134.29
6150,5/28/2021,5/28/2021,52821,82L-IMPORT PAYROLL,D101,HJ,33.51,,556167.8
6150,5/28/2021,5/28/2021,52821,82L-IMPORT PAYROLL,D101,HJ,37.18,,556204.98
6150,5/28/2021,5/28/2021,52821,82L-IMPORT PAYROLL,D101,HJ,38.11,,556243.09
6150,5/28/2021,5/28/2021,52821,82L-IMPORT PAYROLL,D101,HJ,39.27,,556282.36
6150,5/28/2021,5/28/2021,52821,82L-IMPORT PAYROLL,D101,HJ,41.08,,556323.44
6150,5/28/2021,5/28/2021,52821,82L-IMPORT PAYROLL,D101,HJ,49.84,,556373.28
6150,5/28/2021,5/28/2021,52821,82L-IMPORT PAYROLL,D101,HJ,68.09,,556441.37
6150,5/28/2021,5/28/2021,52821,82L-IMPORT PAYROLL,D101,HJ,75.71,,556517.08
6150,5/28/2021,5/28/2021,52821,82L-IMPORT PAYROLL,D101,HJ,125.33,,556642.41
6150,5/28/2021,5/28/2021,52821,82L-IMPORT PAYROLL,D101,HJ,142.08,,556784.49
6150,5/28/2021,5/28/2021,52821,82L-IMPORT PAYROLL,D101,HJ,143.3,,556927.79
6150,5/28/2021,5/28/2021,52821,82L-IMPORT PAYROLL,D101,HJ,159,,557086.79
6150,5/28/2021,5/28/2021,52821,82L-IMPORT PAYROLL,D101,HJ,162.94,,557249.73
6150,5/28/2021,5/28/2021,52821,82L-IMPORT PAYROLL,D101,HJ,167.92,,557417.65
6150,5/28/2021,5/28/2021,52821,82L-IMPORT PAYROLL,D101,HJ,175.67,,557593.32
6150,5/28/2021,5/28/2021,52821,82L-IMPORT PAYROLL,D101,HJ,213.13,,557806.45
6150,5/28/2021,5/28/2021,52821,82L-IMPORT PAYROLL,D102,HJ,29.41,,557835.86
6150,5/28/2021,5/28/2021,52821,82L-IMPORT PAYROLL,D102,HJ,30.38,,557866.24
6150,5/28/2021,5/28/2021,52821,82L-IMPORT PAYROLL,D102,HJ,39,,557905.24
6150,5/28/2021,5/28/2021,52821,82L-IMPORT PAYROLL,D102,HJ,125.74,,558030.98
6150,5/28/2021,5/28/2021,52821,82L-IMPORT PAYROLL,D102,HJ,129.91,,558160.89
6150,5/28/2021,5/28/2021,52821,82L-IMPORT PAYROLL,D102,HJ,166.75,,558327.64
6150,5/28/2021,5/28/2021,52821,82L-IMPORT PAYROLL,D103,HJ,31.08,,558358.72
6150,5/28/2021,5/28/2021,52821,82L-IMPORT PAYROLL,D103,HJ,32.86,,558391.58
6150,5/28/2021,5/28/2021,52821,82L-IMPORT PAYROLL,D103,HJ,33.06,,558424.64
6150,5/28/2021,5/28/2021,52821,82L-IMPORT PAYROLL,D103,HJ,47.38,,558472.02
6150,5/28/2021,5/28/2021,52821,82L-IMPORT PAYROLL,D103,HJ,49.27,,558521.29
6150,5/28/2021,5/28/2021,52821,82L-IMPORT PAYROLL,D103,HJ,132.89,,558654.18
6150,5/28/2021,5/28/2021,52821,82L-IMPORT PAYROLL,D103,HJ,140.49,,558794.67
6150,5/28/2021,5/28/2021,52821,82L-IMPORT PAYROLL,D103,HJ,141.34,,558936.01
6150,5/28/2021,5/28/2021,52821,82L-IMPORT PAYROLL,D103,HJ,210.66,,559146.67
6150,5/28/2021,5/28/2021,52821,82L-IMPORT PAYROLL,D104,HJ,26.82,,559173.49
6150,5/28/2021,5/28/2021,52821,82L-IMPORT PAYROLL,D104,HJ,28.71,,559202.2
6150,5/28/2021,5/28/2021,52821,82L-IMPORT PAYROLL,D104,HJ,28.82,,559231.02
6150,5/28/2021,5/28/2021,52821,82L-IMPORT PAYROLL,D104,HJ,34.12,,559265.14
6150,5/28/2021,5/28/2021,52821,82L-IMPORT PAYROLL,D104,HJ,37.03,,559302.17
6150,5/28/2021,5/28/2021,52821,82L-IMPORT PAYROLL,D104,HJ,38.13,,559340.3
6150,5/28/2021,5/28/2021,52821,82L-IMPORT PAYROLL,D104,HJ,40.2,,559380.5
6150,5/28/2021,5/28/2021,52821,82L-IMPORT PAYROLL,D104,HJ,98.33,,559478.83
6150,5/28/2021,5/28/2021,52821,82L-IMPORT PAYROLL,D104,HJ,114.66,,559593.49
6150,5/28/2021,5/28/2021,52821,82L-IMPORT PAYROLL,D104,HJ,122.75,,559716.24
6150,5/28/2021,5/28/2021,52821,82L-IMPORT PAYROLL,D104,HJ,123.23,,559839.47
6150,5/28/2021,5/28/2021,52821,82L-IMPORT PAYROLL,D104,HJ,145.9,,559985.37
6150,5/28/2021,5/28/2021,52821,82L-IMPORT PAYROLL,D104,HJ,158.35,,560143.72
6150,5/28/2021,5/28/2021,52821,82L-IMPORT PAYROLL,D104,HJ,163.06,,560306.78
6150,5/28/2021,5/28/2021,52821,82L-IMPORT PAYROLL,D104,HJ,171.87,,560478.65
6150,5/28/2021,5/28/2021,52821,82L-IMPORT PAYROLL,D104,HJ,420.45,,560899.1
6150,5/28/2021,5/28/2021,52821,82L-IMPORT PAYROLL,D105,HJ,25.57,,560924.67
6150,5/28/2021,5/28/2021,52821,82L-IMPORT PAYROLL,D105,HJ,27.79,,560952.46
6150,5/28/2021,5/28/2021,52821,82L-IMPORT PAYROLL,D105,HJ,31.18,,560983.64
6150,5/28/2021,5/28/2021,52821,82L-IMPORT PAYROLL,D105,HJ,39.93,,561023.57
6150,5/28/2021,5/28/2021,52821,82L-IMPORT PAYROLL,D105,HJ,49.87,,561073.44
6150,5/28/2021,5/28/2021,52821,82L-IMPORT PAYROLL,D105,HJ,109.31,,561182.75
6150,5/28/2021,5/28/2021,52821,82L-IMPORT PAYROLL,D105,HJ,118.83,,561301.58
6150,5/28/2021,5/28/2021,52821,82L-IMPORT PAYROLL,D105,HJ,133.3,,561434.88
6150,5/28/2021,5/28/2021,52821,82L-IMPORT PAYROLL,D105,HJ,170.75,,561605.63
6150,5/28/2021,5/28/2021,52821,82L-IMPORT PAYROLL,D105,HJ,213.25,,561818.88
6150,5/28/2021,5/28/2021,52821,82L-IMPORT PAYROLL,D107,HJ,4.71,,561823.59
6150,5/28/2021,5/28/2021,52821,82L-IMPORT PAYROLL,D107,HJ,5.19,,561828.78
6150,5/28/2021,5/28/2021,52821,82L-IMPORT PAYROLL,D107,HJ,9.31,,561838.09
6150,5/28/2021,5/28/2021,52821,82L-IMPORT PAYROLL,D107,HJ,20.12,,561858.21
6150,5/28/2021,5/28/2021,52821,82L-IMPORT PAYROLL,D107,HJ,27.59,,561885.8
6150,5/28/2021,5/28/2021,52821,82L-IMPORT PAYROLL,D107,HJ,30.11,,561915.91
6150,5/28/2021,5/28/2021,52821,82L-IMPORT PAYROLL,D107,HJ,39.83,,561955.74
6150,5/28/2021,5/28/2021,52821,82L-IMPORT PAYROLL,D107,HJ,39.93,,561995.67
6150,5/28/2021,5/28/2021,52821,82L-IMPORT PAYROLL,D107,HJ,41.75,,562037.42
6150,5/28/2021,5/28/2021,52821,82L-IMPORT PAYROLL,D107,HJ,48.81,,562086.23
6150,5/28/2021,5/28/2021,52821,82L-IMPORT PAYROLL,D107,HJ,49.06,,562135.29
6150,5/28/2021,5/28/2021,52821,82L-IMPORT PAYROLL,D107,HJ,56.07,,562191.36
6150,5/28/2021,5/28/2021,52821,82L-IMPORT PAYROLL,D107,HJ,60.2,,562251.56
6150,5/28/2021,5/28/2021,52821,82L-IMPORT PAYROLL,D107,HJ,72.42,,562323.98
6150,5/28/2021,5/28/2021,52821,82L-IMPORT PAYROLL,D107,HJ,94.21,,562418.19
6150,5/28/2021,5/28/2021,52821,82L-IMPORT PAYROLL,D107,HJ,118,,562536.19
6150,5/28/2021,5/28/2021,52821,82L-IMPORT PAYROLL,D107,HJ,128.76,,562664.95
6150,5/28/2021,5/28/2021,52821,82L-IMPORT PAYROLL,D107,HJ,170.76,,562835.71
6150,5/28/2021,5/28/2021,52821,82L-IMPORT PAYROLL,D107,HJ,178.51,,563014.22
6150,5/28/2021,5/28/2021,52821,82L-IMPORT PAYROLL,D107,HJ,208.69,,563222.91
6150,5/28/2021,5/28/2021,52821,82L-IMPORT PAYROLL,D107,HJ,209.76,,563432.67
6150,5/28/2021,5/28/2021,52821,82L-IMPORT PAYROLL,D107,HJ,309.64,,563742.31
6150,5/28/2021,5/28/2021,52821,82L-IMPORT PAYROLL,D107,HJ,402.81,,564145.12
6150,5/28/2021,5/28/2021,52821,82L-IMPORT PAYROLL,D109,HJ,1.1,,564146.22
6150,5/28/2021,5/28/2021,52821,82L-IMPORT PAYROLL,D109,HJ,13.56,,564159.78
6150,5/28/2021,5/28/2021,52821,82L-IMPORT PAYROLL,D109,HJ,17.88,,564177.66
6150,5/28/2021,5/28/2021,52821,82L-IMPORT PAYROLL,D109,HJ,21.75,,564199.41
6150,5/28/2021,5/28/2021,52821,82L-IMPORT PAYROLL,D109,HJ,55.91,,564255.32
6150,5/28/2021,5/28/2021,52821,82L-IMPORT PAYROLL,D109,HJ,56.19,,564311.51
6150,5/28/2021,5/28/2021,52821,82L-IMPORT PAYROLL,D109,HJ,58.24,,564369.75
6150,5/28/2021,5/28/2021,52821,82L-IMPORT PAYROLL,D109,HJ,72.5,,564442.25
6150,5/28/2021,5/28/2021,52821,82L-IMPORT PAYROLL,D109,HJ,76.2,,564518.45
6150,5/28/2021,5/28/2021,52821,82L-IMPORT PAYROLL,D109,HJ,76.2,,564594.65
6150,5/28/2021,5/28/2021,52821,82L-IMPORT PAYROLL,D109,HJ,76.45,,564671.1
6150,5/28/2021,5/28/2021,52821,82L-IMPORT PAYROLL,D109,HJ,77.94,,564749.04
6150,5/28/2021,5/28/2021,52821,82L-IMPORT PAYROLL,D109,HJ,78.54,,564827.58
6150,5/28/2021,5/28/2021,52821,82L-IMPORT PAYROLL,D109,HJ,79.99,,564907.57
6150,5/28/2021,5/28/2021,52821,82L-IMPORT PAYROLL,D109,HJ,93,,565000.57
6150,5/28/2021,5/28/2021,52821,82L-IMPORT PAYROLL,D109,HJ,239.08,,565239.65
6150,5/28/2021,5/28/2021,52821,82L-IMPORT PAYROLL,D109,HJ,240.25,,565479.9
6150,5/28/2021,5/28/2021,52821,82L-IMPORT PAYROLL,D109,HJ,249.03,,565728.93
6150,5/28/2021,5/28/2021,52821,82L-IMPORT PAYROLL,D109,HJ,310,,566038.93
6150,5/28/2021,5/28/2021,52821,82L-IMPORT PAYROLL,D109,HJ,325.8,,566364.73
6150,5/28/2021,5/28/2021,52821,82L-IMPORT PAYROLL,D109,HJ,325.8,,566690.53
6150,5/28/2021,5/28/2021,52821,82L-IMPORT PAYROLL,D109,HJ,333.27,,567023.8
6150,5/28/2021,5/28/2021,52821,82L-IMPORT PAYROLL,D109,HJ,335.83,,567359.63
6150,5/28/2021,5/28/2021,52821,82L-IMPORT PAYROLL,D109,HJ,342.03,,567701.66
6150,5/28/2021,5/28/2021,52821,82L-IMPORT PAYROLL,D111,HJ,13.49,,567715.15
6150,5/28/2021,5/28/2021,52821,82L-IMPORT PAYROLL,D111,HJ,24.01,,567739.16
6150,5/28/2021,5/28/2021,52821,82L-IMPORT PAYROLL,D111,HJ,29.45,,567768.61
6150,5/28/2021,5/28/2021,52821,82L-IMPORT PAYROLL,D111,HJ,34.97,,567803.58
6150,5/28/2021,5/28/2021,52821,82L-IMPORT PAYROLL,D111,HJ,37.17,,567840.75
6150,5/28/2021,5/28/2021,52821,82L-IMPORT PAYROLL,D111,HJ,53.01,,567893.76
6150,5/28/2021,5/28/2021,52821,82L-IMPORT PAYROLL,D111,HJ,102.68,,567996.44
6150,5/28/2021,5/28/2021,52821,82L-IMPORT PAYROLL,D111,HJ,125.93,,568122.37
6150,5/28/2021,5/28/2021,52821,82L-IMPORT PAYROLL,D111,HJ,149.53,,568271.9
6150,5/28/2021,5/28/2021,52821,82L-IMPORT PAYROLL,D111,HJ,158.92,,568430.82
6150,5/28/2021,5/28/2021,52821,82L-IMPORT PAYROLL,D111,HJ,226.68,,568657.5
6150,5/28/2021,5/28/2021,52821,82L-IMPORT PAYROLL,D112,HJ,37.96,,568695.46
6150,5/28/2021,5/28/2021,52821,82L-IMPORT PAYROLL,D112,HJ,162.32,,568857.78
6150,5/28/2021,5/28/2021,52821,82L-IMPORT PAYROLL,D108,HJ,1.64,,568859.42
6150,5/28/2021,5/28/2021,52821,82L-IMPORT PAYROLL,D108,HJ,3.7,,568863.12
6150,5/28/2021,5/28/2021,52821,82L-IMPORT PAYROLL,D108,HJ,6.94,,568870.06
6150,5/28/2021,5/28/2021,52821,82L-IMPORT PAYROLL,D108,HJ,14,,568884.06
6150,5/28/2021,5/28/2021,52821,82L-IMPORT PAYROLL,D108,HJ,14.32,,568898.38
6150,5/28/2021,5/28/2021,52821,82L-IMPORT PAYROLL,D108,HJ,15.08,,568913.46
6150,5/28/2021,5/28/2021,52821,82L-IMPORT PAYROLL,D108,HJ,15.08,,568928.54
6150,5/28/2021,5/28/2021,52821,82L-IMPORT PAYROLL,D108,HJ,15.28,,568943.82
6150,5/28/2021,5/28/2021,52821,82L-IMPORT PAYROLL,D108,HJ,15.29,,568959.11
6150,5/28/2021,5/28/2021,52821,82L-IMPORT PAYROLL,D108,HJ,15.33,,568974.44
6150,5/28/2021,5/28/2021,52821,82L-IMPORT PAYROLL,D108,HJ,16.05,,568990.49
6150,5/28/2021,5/28/2021,52821,82L-IMPORT PAYROLL,D108,HJ,16.2,,569006.69
6150,5/28/2021,5/28/2021,52821,82L-IMPORT PAYROLL,D108,HJ,16.23,,569022.92
6150,5/28/2021,5/28/2021,52821,82L-IMPORT PAYROLL,D108,HJ,16.23,,569039.15
6150,5/28/2021,5/28/2021,52821,82L-IMPORT PAYROLL,D108,HJ,16.23,,569055.38
6150,5/28/2021,5/28/2021,52821,82L-IMPORT PAYROLL,D108,HJ,16.23,,569071.61
6150,5/28/2021,5/28/2021,52821,82L-IMPORT PAYROLL,D108,HJ,16.23,,569087.84
6150,5/28/2021,5/28/2021,52821,82L-IMPORT PAYROLL,D108,HJ,16.23,,569104.07
6150,5/28/2021,5/28/2021,52821,82L-IMPORT PAYROLL,D108,HJ,16.23,,569120.3
6150,5/28/2021,5/28/2021,52821,82L-IMPORT PAYROLL,D108,HJ,16.23,,569136.53
6150,5/28/2021,5/28/2021,52821,82L-IMPORT PAYROLL,D108,HJ,16.23,,569152.76
6150,5/28/2021,5/28/2021,52821,82L-IMPORT PAYROLL,D108,HJ,16.23,,569168.99
6150,5/28/2021,5/28/2021,52821,82L-IMPORT PAYROLL,D108,HJ,16.23,,569185.22
6150,5/28/2021,5/28/2021,52821,82L-IMPORT PAYROLL,D108,HJ,16.23,,569201.45
6150,5/28/2021,5/28/2021,52821,82L-IMPORT PAYROLL,D108,HJ,16.23,,569217.68
6150,5/28/2021,5/28/2021,52821,82L-IMPORT PAYROLL,D108,HJ,16.23,,569233.91
6150,5/28/2021,5/28/2021,52821,82L-IMPORT PAYROLL,D108,HJ,16.23,,569250.14
6150,5/28/2021,5/28/2021,52821,82L-IMPORT PAYROLL,D108,HJ,16.23,,569266.37
6150,5/28/2021,5/28/2021,52821,82L-IMPORT PAYROLL,D108,HJ,16.23,,569282.6
6150,5/28/2021,5/28/2021,52821,82L-IMPORT PAYROLL,D108,HJ,16.23,,569298.83
6150,5/28/2021,5/28/2021,52821,82L-IMPORT PAYROLL,D108,HJ,16.23,,569315.06
6150,5/28/2021,5/28/2021,52821,82L-IMPORT PAYROLL,D108,HJ,30.44,,569345.5
6150,5/28/2021,5/28/2021,52821,82L-IMPORT PAYROLL,D108,HJ,30.56,,569376.06
6150,5/28/2021,5/28/2021,52821,82L-IMPORT PAYROLL,D108,HJ,31,,569407.06
6150,5/28/2021,5/28/2021,52821,82L-IMPORT PAYROLL,D108,HJ,31.04,,569438.1
6150,5/28/2021,5/28/2021,52821,82L-IMPORT PAYROLL,D108,HJ,32.36,,569470.46
6150,5/28/2021,5/28/2021,52821,82L-IMPORT PAYROLL,D108,HJ,32.63,,569503.09
6150,5/28/2021,5/28/2021,52821,82L-IMPORT PAYROLL,D108,HJ,33.23,,569536.32
6150,5/28/2021,5/28/2021,52821,82L-IMPORT PAYROLL,D108,HJ,33.57,,569569.89
6150,5/28/2021,5/28/2021,52821,82L-IMPORT PAYROLL,D108,HJ,33.96,,569603.85
6150,5/28/2021,5/28/2021,52821,82L-IMPORT PAYROLL,D108,HJ,34.16,,569638.01
6150,5/28/2021,5/28/2021,52821,82L-IMPORT PAYROLL,D108,HJ,34.74,,569672.75
6150,5/28/2021,5/28/2021,52821,82L-IMPORT PAYROLL,D108,HJ,34.79,,569707.54
6150,5/28/2021,5/28/2021,52821,82L-IMPORT PAYROLL,D108,HJ,36.93,,569744.47
6150,5/28/2021,5/28/2021,52821,82L-IMPORT PAYROLL,D108,HJ,50.65,,569795.12
6150,5/28/2021,5/28/2021,52821,82L-IMPORT PAYROLL,D108,HJ,53.62,,569848.74
6150,5/28/2021,5/28/2021,52821,82L-IMPORT PAYROLL,D108,HJ,54.34,,569903.08
6150,5/28/2021,5/28/2021,52821,82L-IMPORT PAYROLL,D108,HJ,59.86,,569962.94
6150,5/28/2021,5/28/2021,52821,82L-IMPORT PAYROLL,D108,HJ,61.25,,570024.19
6150,5/28/2021,5/28/2021,52821,82L-IMPORT PAYROLL,D108,HJ,64.5,,570088.69
6150,5/28/2021,5/28/2021,52821,82L-IMPORT PAYROLL,D108,HJ,64.5,,570153.19
6150,5/28/2021,5/28/2021,52821,82L-IMPORT PAYROLL,D108,HJ,65.35,,570218.54
6150,5/28/2021,5/28/2021,52821,82L-IMPORT PAYROLL,D108,HJ,65.39,,570283.93
6150,5/28/2021,5/28/2021,52821,82L-IMPORT PAYROLL,D108,HJ,68.64,,570352.57
6150,5/28/2021,5/28/2021,52821,82L-IMPORT PAYROLL,D108,HJ,69.27,,570421.84
6150,5/28/2021,5/28/2021,52821,82L-IMPORT PAYROLL,D108,HJ,69.38,,570491.22
6150,5/28/2021,5/28/2021,52821,82L-IMPORT PAYROLL,D108,HJ,69.38,,570560.6
6150,5/28/2021,5/28/2021,52821,82L-IMPORT PAYROLL,D108,HJ,69.38,,570629.98
6150,5/28/2021,5/28/2021,52821,82L-IMPORT PAYROLL,D108,HJ,69.38,,570699.36
6150,5/28/2021,5/28/2021,52821,82L-IMPORT PAYROLL,D108,HJ,69.38,,570768.74
6150,5/28/2021,5/28/2021,52821,82L-IMPORT PAYROLL,D108,HJ,69.38,,570838.12
6150,5/28/2021,5/28/2021,52821,82L-IMPORT PAYROLL,D108,HJ,69.38,,570907.5
6150,5/28/2021,5/28/2021,52821,82L-IMPORT PAYROLL,D108,HJ,69.38,,570976.88
6150,5/28/2021,5/28/2021,52821,82L-IMPORT PAYROLL,D108,HJ,69.38,,571046.26
6150,5/28/2021,5/28/2021,52821,82L-IMPORT PAYROLL,D108,HJ,69.38,,571115.64
6150,5/28/2021,5/28/2021,52821,82L-IMPORT PAYROLL,D108,HJ,69.38,,571185.02
6150,5/28/2021,5/28/2021,52821,82L-IMPORT PAYROLL,D108,HJ,69.38,,571254.4
6150,5/28/2021,5/28/2021,52821,82L-IMPORT PAYROLL,D108,HJ,69.38,,571323.78
6150,5/28/2021,5/28/2021,52821,82L-IMPORT PAYROLL,D108,HJ,69.38,,571393.16
6150,5/28/2021,5/28/2021,52821,82L-IMPORT PAYROLL,D108,HJ,69.38,,571462.54
6150,5/28/2021,5/28/2021,52821,82L-IMPORT PAYROLL,D108,HJ,69.38,,571531.92
6150,5/28/2021,5/28/2021,52821,82L-IMPORT PAYROLL,D108,HJ,69.38,,571601.3
6150,5/28/2021,5/28/2021,52821,82L-IMPORT PAYROLL,D108,HJ,69.38,,571670.68
6150,5/28/2021,5/28/2021,52821,82L-IMPORT PAYROLL,D108,HJ,69.41,,571740.09
6150,5/28/2021,5/28/2021,52821,82L-IMPORT PAYROLL,D108,HJ,74.25,,571814.34
6150,5/28/2021,5/28/2021,52821,82L-IMPORT PAYROLL,D108,HJ,130.16,,571944.5
6150,5/28/2021,5/28/2021,52821,82L-IMPORT PAYROLL,D108,HJ,130.69,,572075.19
6150,5/28/2021,5/28/2021,52821,82L-IMPORT PAYROLL,D108,HJ,132.56,,572207.75
6150,5/28/2021,5/28/2021,52821,82L-IMPORT PAYROLL,D108,HJ,132.74,,572340.49
6150,5/28/2021,5/28/2021,52821,82L-IMPORT PAYROLL,D108,HJ,138.38,,572478.87
6150,5/28/2021,5/28/2021,52821,82L-IMPORT PAYROLL,D108,HJ,139.5,,572618.37
6150,5/28/2021,5/28/2021,52821,82L-IMPORT PAYROLL,D108,HJ,142.08,,572760.45
6150,5/28/2021,5/28/2021,52821,82L-IMPORT PAYROLL,D108,HJ,145.23,,572905.68
6150,5/28/2021,5/28/2021,52821,82L-IMPORT PAYROLL,D108,HJ,146.08,,573051.76
6150,5/28/2021,5/28/2021,52821,82L-IMPORT PAYROLL,D108,HJ,148.53,,573200.29
6150,5/28/2021,5/28/2021,52821,82L-IMPORT PAYROLL,D108,HJ,148.76,,573349.05
6150,5/28/2021,5/28/2021,52821,82L-IMPORT PAYROLL,D108,HJ,216.59,,573565.64
6150,5/28/2021,5/28/2021,52821,82L-IMPORT PAYROLL,D108,HJ,229.26,,573794.9
6150,5/28/2021,5/28/2021,52821,82L-IMPORT PAYROLL,D108,HJ,232.34,,574027.24
6150,5/28/2021,5/28/2021,52821,82L-IMPORT PAYROLL,D108,HJ,18.86,,574046.1
6150,5/28/2021,5/28/2021,52821,82L-IMPORT PAYROLL,D108,HJ,19.38,,574065.48
6150,5/28/2021,5/28/2021,52821,82L-IMPORT PAYROLL,D108,HJ,37.75,,574103.23
6150,5/28/2021,5/28/2021,52821,82L-IMPORT PAYROLL,D108,HJ,38.07,,574141.3
6150,5/28/2021,5/28/2021,52821,82L-IMPORT PAYROLL,D108,HJ,42.91,,574184.21
6150,5/28/2021,5/28/2021,52821,82L-IMPORT PAYROLL,D108,HJ,44.1,,574228.31
6150,5/28/2021,5/28/2021,52821,82L-IMPORT PAYROLL,D108,HJ,78.85,,574307.16
6150,5/28/2021,5/28/2021,52821,82L-IMPORT PAYROLL,D108,HJ,161.4,,574468.56
6150,5/28/2021,5/28/2021,52821,82L-IMPORT PAYROLL,D108,HJ,162.79,,574631.35
6150,5/28/2021,5/28/2021,52821,82L-IMPORT PAYROLL,D108,HJ,183.48,,574814.83
6150,5/28/2021,5/28/2021,52821,82L-IMPORT PAYROLL,D108,HJ,188.58,,575003.41
6150,5/28/2021,5/28/2021,52821,82L-IMPORT PAYROLL,D108,HJ,337.14,,575340.55
6150,6/1/2021,6/1/2021,1,To reclassify Expenses bet departments,D107,HJ,,4287.37,571053.18
6150,6/1/2021,6/1/2021,1,To reclassify Expenses bet departments,D107,HJ,4287.37,,575340.55
6150,6/14/2021,6/14/2021,ADP,ADP state UI filings and penalties June 2021,D104,HJ,14.35,,575354.9
6150,6/14/2021,6/14/2021,ADP,ADP state UI filings and penalties June 2021,D104,HJ,29.75,,575384.65
6150,6/14/2021,6/14/2021,ADP,ADP state UI filings and penalties June 2021,D104,HJ,62.16,,575446.81
6150,6/14/2021,6/14/2021,ADP,ADP state UI filings and penalties June 2021,D104,HJ,128.94,,575575.75
6150,6/14/2021,6/14/2021,ADP,ADP state UI filings and penalties June 2021,D104,HJ,401.66,,575977.41
6150,6/14/2021,6/14/2021,ADP,ADP state UI filings and penalties June 2021,D104,HJ,833.14,,576810.55
6150,6/15/2021,6/15/2021,61521,82L-IMPORT PAYROLL,D108,HJ,13.25,,576823.8
6150,6/15/2021,6/15/2021,61521,82L-IMPORT PAYROLL,D108,HJ,14.01,,576837.81
6150,6/15/2021,6/15/2021,61521,82L-IMPORT PAYROLL,D108,HJ,14.01,,576851.82
6150,6/15/2021,6/15/2021,61521,82L-IMPORT PAYROLL,D108,HJ,14.01,,576865.83
6150,6/15/2021,6/15/2021,61521,82L-IMPORT PAYROLL,D108,HJ,14.05,,576879.88
6150,6/15/2021,6/15/2021,61521,82L-IMPORT PAYROLL,D108,HJ,14.25,,576894.13
6150,6/15/2021,6/15/2021,61521,82L-IMPORT PAYROLL,D108,HJ,14.25,,576908.38
6150,6/15/2021,6/15/2021,61521,82L-IMPORT PAYROLL,D108,HJ,14.65,,576923.03
6150,6/15/2021,6/15/2021,61521,82L-IMPORT PAYROLL,D108,HJ,14.99,,576938.02
6150,6/15/2021,6/15/2021,61521,82L-IMPORT PAYROLL,D108,HJ,15.16,,576953.18
6150,6/15/2021,6/15/2021,61521,82L-IMPORT PAYROLL,D108,HJ,15.19,,576968.37
6150,6/15/2021,6/15/2021,61521,82L-IMPORT PAYROLL,D108,HJ,15.19,,576983.56
6150,6/15/2021,6/15/2021,61521,82L-IMPORT PAYROLL,D108,HJ,15.19,,576998.75
6150,6/15/2021,6/15/2021,61521,82L-IMPORT PAYROLL,D108,HJ,15.19,,577013.94
6150,6/15/2021,6/15/2021,61521,82L-IMPORT PAYROLL,D108,HJ,15.19,,577029.13
6150,6/15/2021,6/15/2021,61521,82L-IMPORT PAYROLL,D108,HJ,15.19,,577044.32
6150,6/15/2021,6/15/2021,61521,82L-IMPORT PAYROLL,D108,HJ,15.19,,577059.51
6150,6/15/2021,6/15/2021,61521,82L-IMPORT PAYROLL,D108,HJ,15.19,,577074.7
6150,6/15/2021,6/15/2021,61521,82L-IMPORT PAYROLL,D108,HJ,15.19,,577089.89
6150,6/15/2021,6/15/2021,61521,82L-IMPORT PAYROLL,D108,HJ,15.19,,577105.08
6150,6/15/2021,6/15/2021,61521,82L-IMPORT PAYROLL,D108,HJ,15.19,,577120.27
6150,6/15/2021,6/15/2021,61521,82L-IMPORT PAYROLL,D108,HJ,15.19,,577135.46
6150,6/15/2021,6/15/2021,61521,82L-IMPORT PAYROLL,D108,HJ,15.19,,577150.65
6150,6/15/2021,6/15/2021,61521,82L-IMPORT PAYROLL,D108,HJ,15.19,,577165.84
6150,6/15/2021,6/15/2021,61521,82L-IMPORT PAYROLL,D108,HJ,15.19,,577181.03
6150,6/15/2021,6/15/2021,61521,82L-IMPORT PAYROLL,D108,HJ,17.57,,577198.6
6150,6/15/2021,6/15/2021,61521,82L-IMPORT PAYROLL,D108,HJ,17.87,,577216.47
6150,6/15/2021,6/15/2021,61521,82L-IMPORT PAYROLL,D108,HJ,18.82,,577235.29
6150,6/15/2021,6/15/2021,61521,82L-IMPORT PAYROLL,D108,HJ,24.56,,577259.85
6150,6/15/2021,6/15/2021,61521,82L-IMPORT PAYROLL,D108,HJ,24.99,,577284.84
6150,6/15/2021,6/15/2021,61521,82L-IMPORT PAYROLL,D108,HJ,26.53,,577311.37
6150,6/15/2021,6/15/2021,61521,82L-IMPORT PAYROLL,D108,HJ,27.59,,577338.96
6150,6/15/2021,6/15/2021,61521,82L-IMPORT PAYROLL,D108,HJ,27.84,,577366.8
6150,6/15/2021,6/15/2021,61521,82L-IMPORT PAYROLL,D108,HJ,28.29,,577395.09
6150,6/15/2021,6/15/2021,61521,82L-IMPORT PAYROLL,D108,HJ,29,,577424.09
6150,6/15/2021,6/15/2021,61521,82L-IMPORT PAYROLL,D108,HJ,30.21,,577454.3
6150,6/15/2021,6/15/2021,61521,82L-IMPORT PAYROLL,D108,HJ,31.43,,577485.73
6150,6/15/2021,6/15/2021,61521,82L-IMPORT PAYROLL,D108,HJ,32.46,,577518.19
6150,6/15/2021,6/15/2021,61521,82L-IMPORT PAYROLL,D108,HJ,33.58,,577551.77
6150,6/15/2021,6/15/2021,61521,82L-IMPORT PAYROLL,D108,HJ,36.25,,577588.02
6150,6/15/2021,6/15/2021,61521,82L-IMPORT PAYROLL,D108,HJ,38.17,,577626.19
6150,6/15/2021,6/15/2021,61521,82L-IMPORT PAYROLL,D108,HJ,59.89,,577686.08
6150,6/15/2021,6/15/2021,61521,82L-IMPORT PAYROLL,D108,HJ,59.89,,577745.97
6150,6/15/2021,6/15/2021,61521,82L-IMPORT PAYROLL,D108,HJ,59.89,,577805.86
6150,6/15/2021,6/15/2021,61521,82L-IMPORT PAYROLL,D108,HJ,60.07,,577865.93
6150,6/15/2021,6/15/2021,61521,82L-IMPORT PAYROLL,D108,HJ,60.92,,577926.85
6150,6/15/2021,6/15/2021,61521,82L-IMPORT PAYROLL,D108,HJ,60.92,,577987.77
6150,6/15/2021,6/15/2021,61521,82L-IMPORT PAYROLL,D108,HJ,62.62,,578050.39
6150,6/15/2021,6/15/2021,61521,82L-IMPORT PAYROLL,D108,HJ,64.1,,578114.49
6150,6/15/2021,6/15/2021,61521,82L-IMPORT PAYROLL,D108,HJ,64.84,,578179.33
6150,6/15/2021,6/15/2021,61521,82L-IMPORT PAYROLL,D108,HJ,64.95,,578244.28
6150,6/15/2021,6/15/2021,61521,82L-IMPORT PAYROLL,D108,HJ,64.95,,578309.23
6150,6/15/2021,6/15/2021,61521,82L-IMPORT PAYROLL,D108,HJ,64.95,,578374.18
6150,6/15/2021,6/15/2021,61521,82L-IMPORT PAYROLL,D108,HJ,64.95,,578439.13
6150,6/15/2021,6/15/2021,61521,82L-IMPORT PAYROLL,D108,HJ,64.95,,578504.08
6150,6/15/2021,6/15/2021,61521,82L-IMPORT PAYROLL,D108,HJ,64.95,,578569.03
6150,6/15/2021,6/15/2021,61521,82L-IMPORT PAYROLL,D108,HJ,64.95,,578633.98
6150,6/15/2021,6/15/2021,61521,82L-IMPORT PAYROLL,D108,HJ,64.95,,578698.93
6150,6/15/2021,6/15/2021,61521,82L-IMPORT PAYROLL,D108,HJ,64.95,,578763.88
6150,6/15/2021,6/15/2021,61521,82L-IMPORT PAYROLL,D108,HJ,64.95,,578828.83
6150,6/15/2021,6/15/2021,61521,82L-IMPORT PAYROLL,D108,HJ,64.95,,578893.78
6150,6/15/2021,6/15/2021,61521,82L-IMPORT PAYROLL,D108,HJ,64.95,,578958.73
6150,6/15/2021,6/15/2021,61521,82L-IMPORT PAYROLL,D108,HJ,64.95,,579023.68
6150,6/15/2021,6/15/2021,61521,82L-IMPORT PAYROLL,D108,HJ,64.95,,579088.63
6150,6/15/2021,6/15/2021,61521,82L-IMPORT PAYROLL,D108,HJ,64.95,,579153.58
6150,6/15/2021,6/15/2021,61521,82L-IMPORT PAYROLL,D108,HJ,75.12,,579228.7
6150,6/15/2021,6/15/2021,61521,82L-IMPORT PAYROLL,D108,HJ,76.42,,579305.12
6150,6/15/2021,6/15/2021,61521,82L-IMPORT PAYROLL,D108,HJ,80.45,,579385.57
6150,6/15/2021,6/15/2021,61521,82L-IMPORT PAYROLL,D108,HJ,80.62,,579466.19
6150,6/15/2021,6/15/2021,61521,82L-IMPORT PAYROLL,D108,HJ,106.85,,579573.04
6150,6/15/2021,6/15/2021,61521,82L-IMPORT PAYROLL,D108,HJ,117.98,,579691.02
6150,6/15/2021,6/15/2021,61521,82L-IMPORT PAYROLL,D108,HJ,119.05,,579810.07
6150,6/15/2021,6/15/2021,61521,82L-IMPORT PAYROLL,D108,HJ,124,,579934.07
6150,6/15/2021,6/15/2021,61521,82L-IMPORT PAYROLL,D108,HJ,129.17,,580063.24
6150,6/15/2021,6/15/2021,61521,82L-IMPORT PAYROLL,D108,HJ,138.81,,580202.05
6150,6/15/2021,6/15/2021,61521,82L-IMPORT PAYROLL,D108,HJ,143.59,,580345.64
6150,6/15/2021,6/15/2021,61521,82L-IMPORT PAYROLL,D108,HJ,155,,580500.64
6150,6/15/2021,6/15/2021,61521,82L-IMPORT PAYROLL,D108,HJ,163.23,,580663.87
6150,6/15/2021,6/15/2021,61521,82L-IMPORT PAYROLL,D108,HJ,31.22,,580695.09
6150,6/15/2021,6/15/2021,61521,82L-IMPORT PAYROLL,D108,HJ,32.04,,580727.13
6150,6/15/2021,6/15/2021,61521,82L-IMPORT PAYROLL,D108,HJ,32.86,,580759.99
6150,6/15/2021,6/15/2021,61521,82L-IMPORT PAYROLL,D108,HJ,32.9,,580792.89
6150,6/15/2021,6/15/2021,61521,82L-IMPORT PAYROLL,D108,HJ,33.03,,580825.92
6150,6/15/2021,6/15/2021,61521,82L-IMPORT PAYROLL,D108,HJ,33.1,,580859.02
6150,6/15/2021,6/15/2021,61521,82L-IMPORT PAYROLL,D108,HJ,33.23,,580892.25
6150,6/15/2021,6/15/2021,61521,82L-IMPORT PAYROLL,D108,HJ,33.4,,580925.65
6150,6/15/2021,6/15/2021,61521,82L-IMPORT PAYROLL,D108,HJ,33.42,,580959.07
6150,6/15/2021,6/15/2021,61521,82L-IMPORT PAYROLL,D108,HJ,33.86,,580992.93
6150,6/15/2021,6/15/2021,61521,82L-IMPORT PAYROLL,D108,HJ,34.07,,581027
6150,6/15/2021,6/15/2021,61521,82L-IMPORT PAYROLL,D108,HJ,34.16,,581061.16
6150,6/15/2021,6/15/2021,61521,82L-IMPORT PAYROLL,D108,HJ,35.08,,581096.24
6150,6/15/2021,6/15/2021,61521,82L-IMPORT PAYROLL,D108,HJ,36.3,,581132.54
6150,6/15/2021,6/15/2021,61521,82L-IMPORT PAYROLL,D108,HJ,36.32,,581168.86
6150,6/15/2021,6/15/2021,61521,82L-IMPORT PAYROLL,D108,HJ,36.34,,581205.2
6150,6/15/2021,6/15/2021,61521,82L-IMPORT PAYROLL,D108,HJ,38.67,,581243.87
6150,6/15/2021,6/15/2021,61521,82L-IMPORT PAYROLL,D108,HJ,46.25,,581290.12
6150,6/15/2021,6/15/2021,61521,82L-IMPORT PAYROLL,D108,HJ,46.47,,581336.59
6150,6/15/2021,6/15/2021,61521,82L-IMPORT PAYROLL,D108,HJ,46.52,,581383.11
6150,6/15/2021,6/15/2021,61521,82L-IMPORT PAYROLL,D108,HJ,51.5,,581434.61
6150,6/15/2021,6/15/2021,61521,82L-IMPORT PAYROLL,D108,HJ,54.35,,581488.96
6150,6/15/2021,6/15/2021,61521,82L-IMPORT PAYROLL,D108,HJ,65.29,,581554.25
6150,6/15/2021,6/15/2021,61521,82L-IMPORT PAYROLL,D108,HJ,101.25,,581655.5
6150,6/15/2021,6/15/2021,61521,82L-IMPORT PAYROLL,D108,HJ,133.51,,581789.01
6150,6/15/2021,6/15/2021,61521,82L-IMPORT PAYROLL,D108,HJ,137,,581926.01
6150,6/15/2021,6/15/2021,61521,82L-IMPORT PAYROLL,D108,HJ,140.49,,582066.5
6150,6/15/2021,6/15/2021,61521,82L-IMPORT PAYROLL,D108,HJ,140.68,,582207.18
6150,6/15/2021,6/15/2021,61521,82L-IMPORT PAYROLL,D108,HJ,141.23,,582348.41
6150,6/15/2021,6/15/2021,61521,82L-IMPORT PAYROLL,D108,HJ,141.55,,582489.96
6150,6/15/2021,6/15/2021,61521,82L-IMPORT PAYROLL,D108,HJ,142.08,,582632.04
6150,6/15/2021,6/15/2021,61521,82L-IMPORT PAYROLL,D108,HJ,142.81,,582774.85
6150,6/15/2021,6/15/2021,61521,82L-IMPORT PAYROLL,D108,HJ,142.9,,582917.75
6150,6/15/2021,6/15/2021,61521,82L-IMPORT PAYROLL,D108,HJ,144.76,,583062.51
6150,6/15/2021,6/15/2021,61521,82L-IMPORT PAYROLL,D108,HJ,145.66,,583208.17
6150,6/15/2021,6/15/2021,61521,82L-IMPORT PAYROLL,D108,HJ,146.08,,583354.25
6150,6/15/2021,6/15/2021,61521,82L-IMPORT PAYROLL,D108,HJ,149.98,,583504.23
6150,6/15/2021,6/15/2021,61521,82L-IMPORT PAYROLL,D108,HJ,155.19,,583659.42
6150,6/15/2021,6/15/2021,61521,82L-IMPORT PAYROLL,D108,HJ,155.3,,583814.72
6150,6/15/2021,6/15/2021,61521,82L-IMPORT PAYROLL,D108,HJ,155.39,,583970.11
6150,6/15/2021,6/15/2021,61521,82L-IMPORT PAYROLL,D108,HJ,165.33,,584135.44
6150,6/15/2021,6/15/2021,61521,82L-IMPORT PAYROLL,D108,HJ,197.75,,584333.19
6150,6/15/2021,6/15/2021,61521,82L-IMPORT PAYROLL,D108,HJ,198.7,,584531.89
6150,6/15/2021,6/15/2021,61521,82L-IMPORT PAYROLL,D108,HJ,198.92,,584730.81
6150,6/15/2021,6/15/2021,61521,82L-IMPORT PAYROLL,D108,HJ,220.21,,584951.02
6150,6/15/2021,6/15/2021,61521,82L-IMPORT PAYROLL,D108,HJ,232.39,,585183.41
6150,6/15/2021,6/15/2021,61521,82L-IMPORT PAYROLL,D108,HJ,279.17,,585462.58
6150,6/15/2021,6/15/2021,61521,82L-IMPORT PAYROLL,D101,HJ,15.92,,585478.5
6150,6/15/2021,6/15/2021,61521,82L-IMPORT PAYROLL,D101,HJ,17.57,,585496.07
6150,6/15/2021,6/15/2021,61521,82L-IMPORT PAYROLL,D101,HJ,17.57,,585513.64
6150,6/15/2021,6/15/2021,61521,82L-IMPORT PAYROLL,D101,HJ,17.71,,585531.35
6150,6/15/2021,6/15/2021,61521,82L-IMPORT PAYROLL,D101,HJ,29.24,,585560.59
6150,6/15/2021,6/15/2021,61521,82L-IMPORT PAYROLL,D101,HJ,33.23,,585593.82
6150,6/15/2021,6/15/2021,61521,82L-IMPORT PAYROLL,D101,HJ,33.51,,585627.33
6150,6/15/2021,6/15/2021,61521,82L-IMPORT PAYROLL,D101,HJ,37.18,,585664.51
6150,6/15/2021,6/15/2021,61521,82L-IMPORT PAYROLL,D101,HJ,38.11,,585702.62
6150,6/15/2021,6/15/2021,61521,82L-IMPORT PAYROLL,D101,HJ,39.27,,585741.89
6150,6/15/2021,6/15/2021,61521,82L-IMPORT PAYROLL,D101,HJ,41.08,,585782.97
6150,6/15/2021,6/15/2021,61521,82L-IMPORT PAYROLL,D101,HJ,49.84,,585832.81
6150,6/15/2021,6/15/2021,61521,82L-IMPORT PAYROLL,D101,HJ,68.09,,585900.9
6150,6/15/2021,6/15/2021,61521,82L-IMPORT PAYROLL,D101,HJ,75.71,,585976.61
6150,6/15/2021,6/15/2021,61521,82L-IMPORT PAYROLL,D101,HJ,125.03,,586101.64
6150,6/15/2021,6/15/2021,61521,82L-IMPORT PAYROLL,D101,HJ,142.08,,586243.72
6150,6/15/2021,6/15/2021,61521,82L-IMPORT PAYROLL,D101,HJ,143.3,,586387.02
6150,6/15/2021,6/15/2021,61521,82L-IMPORT PAYROLL,D101,HJ,159,,586546.02
6150,6/15/2021,6/15/2021,61521,82L-IMPORT PAYROLL,D101,HJ,162.94,,586708.96
6150,6/15/2021,6/15/2021,61521,82L-IMPORT PAYROLL,D101,HJ,167.92,,586876.88
6150,6/15/2021,6/15/2021,61521,82L-IMPORT PAYROLL,D101,HJ,175.67,,587052.55
6150,6/15/2021,6/15/2021,61521,82L-IMPORT PAYROLL,D101,HJ,213.13,,587265.68
6150,6/15/2021,6/15/2021,61521,82L-IMPORT PAYROLL,D102,HJ,29.87,,587295.55
6150,6/15/2021,6/15/2021,61521,82L-IMPORT PAYROLL,D102,HJ,30.38,,587325.93
6150,6/15/2021,6/15/2021,61521,82L-IMPORT PAYROLL,D102,HJ,39,,587364.93
6150,6/15/2021,6/15/2021,61521,82L-IMPORT PAYROLL,D102,HJ,127.71,,587492.64
6150,6/15/2021,6/15/2021,61521,82L-IMPORT PAYROLL,D102,HJ,129.91,,587622.55
6150,6/15/2021,6/15/2021,61521,82L-IMPORT PAYROLL,D102,HJ,166.75,,587789.3
6150,6/15/2021,6/15/2021,61521,82L-IMPORT PAYROLL,D103,HJ,31.08,,587820.38
6150,6/15/2021,6/15/2021,61521,82L-IMPORT PAYROLL,D103,HJ,32.86,,587853.24
6150,6/15/2021,6/15/2021,61521,82L-IMPORT PAYROLL,D103,HJ,33.06,,587886.3
6150,6/15/2021,6/15/2021,61521,82L-IMPORT PAYROLL,D103,HJ,45.31,,587931.61
6150,6/15/2021,6/15/2021,61521,82L-IMPORT PAYROLL,D103,HJ,49.27,,587980.88
6150,6/15/2021,6/15/2021,61521,82L-IMPORT PAYROLL,D103,HJ,132.89,,588113.77
6150,6/15/2021,6/15/2021,61521,82L-IMPORT PAYROLL,D103,HJ,140.49,,588254.26
6150,6/15/2021,6/15/2021,61521,82L-IMPORT PAYROLL,D103,HJ,141.34,,588395.6
6150,6/15/2021,6/15/2021,61521,82L-IMPORT PAYROLL,D103,HJ,193.75,,588589.35
6150,6/15/2021,6/15/2021,61521,82L-IMPORT PAYROLL,D103,HJ,210.66,,588800.01
6150,6/15/2021,6/15/2021,61521,82L-IMPORT PAYROLL,D104,HJ,26.09,,588826.1
6150,6/15/2021,6/15/2021,61521,82L-IMPORT PAYROLL,D104,HJ,27.98,,588854.08
6150,6/15/2021,6/15/2021,61521,82L-IMPORT PAYROLL,D104,HJ,28.09,,588882.17
6150,6/15/2021,6/15/2021,61521,82L-IMPORT PAYROLL,D104,HJ,34.12,,588916.29
6150,6/15/2021,6/15/2021,61521,82L-IMPORT PAYROLL,D104,HJ,37.03,,588953.32
6150,6/15/2021,6/15/2021,61521,82L-IMPORT PAYROLL,D104,HJ,38.13,,588991.45
6150,6/15/2021,6/15/2021,61521,82L-IMPORT PAYROLL,D104,HJ,40.2,,589031.65
6150,6/15/2021,6/15/2021,61521,82L-IMPORT PAYROLL,D104,HJ,49.71,,589081.36
6150,6/15/2021,6/15/2021,61521,82L-IMPORT PAYROLL,D104,HJ,111.56,,589192.92
6150,6/15/2021,6/15/2021,61521,82L-IMPORT PAYROLL,D104,HJ,119.65,,589312.57
6150,6/15/2021,6/15/2021,61521,82L-IMPORT PAYROLL,D104,HJ,120.13,,589432.7
6150,6/15/2021,6/15/2021,61521,82L-IMPORT PAYROLL,D104,HJ,145.9,,589578.6
6150,6/15/2021,6/15/2021,61521,82L-IMPORT PAYROLL,D104,HJ,158.35,,589736.95
6150,6/15/2021,6/15/2021,61521,82L-IMPORT PAYROLL,D104,HJ,163.06,,589900.01
6150,6/15/2021,6/15/2021,61521,82L-IMPORT PAYROLL,D104,HJ,171.87,,590071.88
6150,6/15/2021,6/15/2021,61521,82L-IMPORT PAYROLL,D104,HJ,212.55,,590284.43
6150,6/15/2021,6/15/2021,61521,82L-IMPORT PAYROLL,D105,HJ,25.57,,590310
6150,6/15/2021,6/15/2021,61521,82L-IMPORT PAYROLL,D105,HJ,27.79,,590337.79
6150,6/15/2021,6/15/2021,61521,82L-IMPORT PAYROLL,D105,HJ,31.18,,590368.97
6150,6/15/2021,6/15/2021,61521,82L-IMPORT PAYROLL,D105,HJ,39.93,,590408.9
6150,6/15/2021,6/15/2021,61521,82L-IMPORT PAYROLL,D105,HJ,49.87,,590458.77
6150,6/15/2021,6/15/2021,61521,82L-IMPORT PAYROLL,D105,HJ,109.31,,590568.08
6150,6/15/2021,6/15/2021,61521,82L-IMPORT PAYROLL,D105,HJ,118.83,,590686.91
6150,6/15/2021,6/15/2021,61521,82L-IMPORT PAYROLL,D105,HJ,133.3,,590820.21
6150,6/15/2021,6/15/2021,61521,82L-IMPORT PAYROLL,D105,HJ,170.75,,590990.96
6150,6/15/2021,6/15/2021,61521,82L-IMPORT PAYROLL,D105,HJ,213.25,,591204.21
6150,6/15/2021,6/15/2021,61521,82L-IMPORT PAYROLL,D107,HJ,9.32,,591213.53
6150,6/15/2021,6/15/2021,61521,82L-IMPORT PAYROLL,D107,HJ,13.07,,591226.6
6150,6/15/2021,6/15/2021,61521,82L-IMPORT PAYROLL,D107,HJ,13.79,,591240.39
6150,6/15/2021,6/15/2021,61521,82L-IMPORT PAYROLL,D107,HJ,14.42,,591254.81
6150,6/15/2021,6/15/2021,61521,82L-IMPORT PAYROLL,D107,HJ,39.84,,591294.65
6150,6/15/2021,6/15/2021,61521,82L-IMPORT PAYROLL,D107,HJ,41.75,,591336.4
6150,6/15/2021,6/15/2021,61521,82L-IMPORT PAYROLL,D107,HJ,43.25,,591379.65
6150,6/15/2021,6/15/2021,61521,82L-IMPORT PAYROLL,D107,HJ,44.37,,591424.02
6150,6/15/2021,6/15/2021,61521,82L-IMPORT PAYROLL,D107,HJ,44.37,,591468.39
6150,6/15/2021,6/15/2021,61521,82L-IMPORT PAYROLL,D107,HJ,55.89,,591524.28
6150,6/15/2021,6/15/2021,61521,82L-IMPORT PAYROLL,D107,HJ,58.99,,591583.27
6150,6/15/2021,6/15/2021,61521,82L-IMPORT PAYROLL,D107,HJ,62.86,,591646.13
6150,6/15/2021,6/15/2021,61521,82L-IMPORT PAYROLL,D107,HJ,72.42,,591718.55
6150,6/15/2021,6/15/2021,61521,82L-IMPORT PAYROLL,D107,HJ,94.2,,591812.75
6150,6/15/2021,6/15/2021,61521,82L-IMPORT PAYROLL,D107,HJ,178.51,,591991.26
6150,6/15/2021,6/15/2021,61521,82L-IMPORT PAYROLL,D107,HJ,184.93,,592176.19
6150,6/15/2021,6/15/2021,61521,82L-IMPORT PAYROLL,D107,HJ,189.72,,592365.91
6150,6/15/2021,6/15/2021,61521,82L-IMPORT PAYROLL,D107,HJ,189.73,,592555.64
6150,6/15/2021,6/15/2021,61521,82L-IMPORT PAYROLL,D107,HJ,268.77,,592824.41
6150,6/15/2021,6/15/2021,61521,82L-IMPORT PAYROLL,D107,HJ,309.64,,593134.05
6150,6/15/2021,6/15/2021,61521,82L-IMPORT PAYROLL,D107,HJ,402.8,,593536.85
6150,6/15/2021,6/15/2021,61521,82L-IMPORT PAYROLL,D109,HJ,5.93,,593542.78
6150,6/15/2021,6/15/2021,61521,82L-IMPORT PAYROLL,D109,HJ,18.37,,593561.15
6150,6/15/2021,6/15/2021,61521,82L-IMPORT PAYROLL,D109,HJ,54.38,,593615.53
6150,6/15/2021,6/15/2021,61521,82L-IMPORT PAYROLL,D109,HJ,55.91,,593671.44
6150,6/15/2021,6/15/2021,61521,82L-IMPORT PAYROLL,D109,HJ,56.19,,593727.63
6150,6/15/2021,6/15/2021,61521,82L-IMPORT PAYROLL,D109,HJ,58.24,,593785.87
6150,6/15/2021,6/15/2021,61521,82L-IMPORT PAYROLL,D109,HJ,72.5,,593858.37
6150,6/15/2021,6/15/2021,61521,82L-IMPORT PAYROLL,D109,HJ,76.2,,593934.57
6150,6/15/2021,6/15/2021,61521,82L-IMPORT PAYROLL,D109,HJ,76.2,,594010.77
6150,6/15/2021,6/15/2021,61521,82L-IMPORT PAYROLL,D109,HJ,77.94,,594088.71
6150,6/15/2021,6/15/2021,61521,82L-IMPORT PAYROLL,D109,HJ,78.54,,594167.25
6150,6/15/2021,6/15/2021,61521,82L-IMPORT PAYROLL,D109,HJ,78.54,,594245.79
6150,6/15/2021,6/15/2021,61521,82L-IMPORT PAYROLL,D109,HJ,79.99,,594325.78
6150,6/15/2021,6/15/2021,61521,82L-IMPORT PAYROLL,D109,HJ,232.5,,594558.28
6150,6/15/2021,6/15/2021,61521,82L-IMPORT PAYROLL,D109,HJ,239.08,,594797.36
6150,6/15/2021,6/15/2021,61521,82L-IMPORT PAYROLL,D109,HJ,240.25,,595037.61
6150,6/15/2021,6/15/2021,61521,82L-IMPORT PAYROLL,D109,HJ,249.03,,595286.64
6150,6/15/2021,6/15/2021,61521,82L-IMPORT PAYROLL,D109,HJ,310,,595596.64
6150,6/15/2021,6/15/2021,61521,82L-IMPORT PAYROLL,D109,HJ,325.8,,595922.44
6150,6/15/2021,6/15/2021,61521,82L-IMPORT PAYROLL,D109,HJ,325.8,,596248.24
6150,6/15/2021,6/15/2021,61521,82L-IMPORT PAYROLL,D109,HJ,333.27,,596581.51
6150,6/15/2021,6/15/2021,61521,82L-IMPORT PAYROLL,D109,HJ,335.83,,596917.34
6150,6/15/2021,6/15/2021,61521,82L-IMPORT PAYROLL,D109,HJ,342.03,,597259.37
6150,6/15/2021,6/15/2021,61521,82L-IMPORT PAYROLL,D111,HJ,13.18,,597272.55
6150,6/15/2021,6/15/2021,61521,82L-IMPORT PAYROLL,D111,HJ,23.29,,597295.84
6150,6/15/2021,6/15/2021,61521,82L-IMPORT PAYROLL,D111,HJ,28.73,,597324.57
6150,6/15/2021,6/15/2021,61521,82L-IMPORT PAYROLL,D111,HJ,34.25,,597358.82
6150,6/15/2021,6/15/2021,61521,82L-IMPORT PAYROLL,D111,HJ,36.44,,597395.26
6150,6/15/2021,6/15/2021,61521,82L-IMPORT PAYROLL,D111,HJ,52.29,,597447.55
6150,6/15/2021,6/15/2021,61521,82L-IMPORT PAYROLL,D111,HJ,99.58,,597547.13
6150,6/15/2021,6/15/2021,61521,82L-IMPORT PAYROLL,D111,HJ,122.83,,597669.96
6150,6/15/2021,6/15/2021,61521,82L-IMPORT PAYROLL,D111,HJ,146.43,,597816.39
6150,6/15/2021,6/15/2021,61521,82L-IMPORT PAYROLL,D111,HJ,155.82,,597972.21
6150,6/15/2021,6/15/2021,61521,82L-IMPORT PAYROLL,D111,HJ,223.58,,598195.79
6150,6/15/2021,6/15/2021,61521,82L-IMPORT PAYROLL,D112,HJ,37.96,,598233.75
6150,6/15/2021,6/15/2021,61521,82L-IMPORT PAYROLL,D112,HJ,162.32,,598396.07
6150,6/15/2021,6/15/2021,61521,82L-IMPORT PAYROLL,D108,HJ,1.64,,598397.71
6150,6/15/2021,6/15/2021,61521,82L-IMPORT PAYROLL,D108,HJ,6.94,,598404.65
6150,6/15/2021,6/15/2021,61521,82L-IMPORT PAYROLL,D108,HJ,15.08,,598419.73
6150,6/15/2021,6/15/2021,61521,82L-IMPORT PAYROLL,D108,HJ,15.28,,598435.01
6150,6/15/2021,6/15/2021,61521,82L-IMPORT PAYROLL,D108,HJ,15.33,,598450.34
6150,6/15/2021,6/15/2021,61521,82L-IMPORT PAYROLL,D108,HJ,16.05,,598466.39
6150,6/15/2021,6/15/2021,61521,82L-IMPORT PAYROLL,D108,HJ,16.2,,598482.59
6150,6/15/2021,6/15/2021,61521,82L-IMPORT PAYROLL,D108,HJ,16.23,,598498.82
6150,6/15/2021,6/15/2021,61521,82L-IMPORT PAYROLL,D108,HJ,16.23,,598515.05
6150,6/15/2021,6/15/2021,61521,82L-IMPORT PAYROLL,D108,HJ,16.23,,598531.28
6150,6/15/2021,6/15/2021,61521,82L-IMPORT PAYROLL,D108,HJ,17.63,,598548.91
6150,6/15/2021,6/15/2021,61521,82L-IMPORT PAYROLL,D108,HJ,17.98,,598566.89
6150,6/15/2021,6/15/2021,61521,82L-IMPORT PAYROLL,D108,HJ,18.71,,598585.6
6150,6/15/2021,6/15/2021,61521,82L-IMPORT PAYROLL,D108,HJ,18.91,,598604.51
6150,6/15/2021,6/15/2021,61521,82L-IMPORT PAYROLL,D108,HJ,19.85,,598624.36
6150,6/15/2021,6/15/2021,61521,82L-IMPORT PAYROLL,D108,HJ,19.85,,598644.21
6150,6/15/2021,6/15/2021,61521,82L-IMPORT PAYROLL,D108,HJ,19.85,,598664.06
6150,6/15/2021,6/15/2021,61521,82L-IMPORT PAYROLL,D108,HJ,19.85,,598683.91
6150,6/15/2021,6/15/2021,61521,82L-IMPORT PAYROLL,D108,HJ,19.85,,598703.76
6150,6/15/2021,6/15/2021,61521,82L-IMPORT PAYROLL,D108,HJ,19.85,,598723.61
6150,6/15/2021,6/15/2021,61521,82L-IMPORT PAYROLL,D108,HJ,19.85,,598743.46
6150,6/15/2021,6/15/2021,61521,82L-IMPORT PAYROLL,D108,HJ,19.85,,598763.31
6150,6/15/2021,6/15/2021,61521,82L-IMPORT PAYROLL,D108,HJ,19.85,,598783.16
6150,6/15/2021,6/15/2021,61521,82L-IMPORT PAYROLL,D108,HJ,19.85,,598803.01
6150,6/15/2021,6/15/2021,61521,82L-IMPORT PAYROLL,D108,HJ,19.85,,598822.86
6150,6/15/2021,6/15/2021,61521,82L-IMPORT PAYROLL,D108,HJ,19.85,,598842.71
6150,6/15/2021,6/15/2021,61521,82L-IMPORT PAYROLL,D108,HJ,19.85,,598862.56
6150,6/15/2021,6/15/2021,61521,82L-IMPORT PAYROLL,D108,HJ,19.85,,598882.41
6150,6/15/2021,6/15/2021,61521,82L-IMPORT PAYROLL,D108,HJ,19.85,,598902.26
6150,6/15/2021,6/15/2021,61521,82L-IMPORT PAYROLL,D108,HJ,19.86,,598922.12
6150,6/15/2021,6/15/2021,61521,82L-IMPORT PAYROLL,D108,HJ,30.44,,598952.56
6150,6/15/2021,6/15/2021,61521,82L-IMPORT PAYROLL,D108,HJ,30.56,,598983.12
6150,6/15/2021,6/15/2021,61521,82L-IMPORT PAYROLL,D108,HJ,31,,599014.12
6150,6/15/2021,6/15/2021,61521,82L-IMPORT PAYROLL,D108,HJ,31.04,,599045.16
6150,6/15/2021,6/15/2021,61521,82L-IMPORT PAYROLL,D108,HJ,32.36,,599077.52
6150,6/15/2021,6/15/2021,61521,82L-IMPORT PAYROLL,D108,HJ,32.63,,599110.15
6150,6/15/2021,6/15/2021,61521,82L-IMPORT PAYROLL,D108,HJ,33.23,,599143.38
6150,6/15/2021,6/15/2021,61521,82L-IMPORT PAYROLL,D108,HJ,33.57,,599176.95
6150,6/15/2021,6/15/2021,61521,82L-IMPORT PAYROLL,D108,HJ,33.96,,599210.91
6150,6/15/2021,6/15/2021,61521,82L-IMPORT PAYROLL,D108,HJ,34.16,,599245.07
6150,6/15/2021,6/15/2021,61521,82L-IMPORT PAYROLL,D108,HJ,34.74,,599279.81
6150,6/15/2021,6/15/2021,61521,82L-IMPORT PAYROLL,D108,HJ,34.79,,599314.6
6150,6/15/2021,6/15/2021,61521,82L-IMPORT PAYROLL,D108,HJ,35.81,,599350.41
6150,6/15/2021,6/15/2021,61521,82L-IMPORT PAYROLL,D108,HJ,36.93,,599387.34
6150,6/15/2021,6/15/2021,61521,82L-IMPORT PAYROLL,D108,HJ,49.27,,599436.61
6150,6/15/2021,6/15/2021,61521,82L-IMPORT PAYROLL,D108,HJ,54.34,,599490.95
6150,6/15/2021,6/15/2021,61521,82L-IMPORT PAYROLL,D108,HJ,64.5,,599555.45
6150,6/15/2021,6/15/2021,61521,82L-IMPORT PAYROLL,D108,HJ,65.35,,599620.8
6150,6/15/2021,6/15/2021,61521,82L-IMPORT PAYROLL,D108,HJ,68.64,,599689.44
6150,6/15/2021,6/15/2021,61521,82L-IMPORT PAYROLL,D108,HJ,69.27,,599758.71
6150,6/15/2021,6/15/2021,61521,82L-IMPORT PAYROLL,D108,HJ,69.38,,599828.09
6150,6/15/2021,6/15/2021,61521,82L-IMPORT PAYROLL,D108,HJ,69.38,,599897.47
6150,6/15/2021,6/15/2021,61521,82L-IMPORT PAYROLL,D108,HJ,69.42,,599966.89
6150,6/15/2021,6/15/2021,61521,82L-IMPORT PAYROLL,D108,HJ,74.25,,600041.14
6150,6/15/2021,6/15/2021,61521,82L-IMPORT PAYROLL,D108,HJ,75.36,,600116.5
6150,6/15/2021,6/15/2021,61521,82L-IMPORT PAYROLL,D108,HJ,76.87,,600193.37
6150,6/15/2021,6/15/2021,61521,82L-IMPORT PAYROLL,D108,HJ,80,,600273.37
6150,6/15/2021,6/15/2021,61521,82L-IMPORT PAYROLL,D108,HJ,80.85,,600354.22
6150,6/15/2021,6/15/2021,61521,82L-IMPORT PAYROLL,D108,HJ,84.88,,600439.1
6150,6/15/2021,6/15/2021,61521,82L-IMPORT PAYROLL,D108,HJ,84.88,,600523.98
6150,6/15/2021,6/15/2021,61521,82L-IMPORT PAYROLL,D108,HJ,84.88,,600608.86
6150,6/15/2021,6/15/2021,61521,82L-IMPORT PAYROLL,D108,HJ,84.88,,600693.74
6150,6/15/2021,6/15/2021,61521,82L-IMPORT PAYROLL,D108,HJ,84.88,,600778.62
6150,6/15/2021,6/15/2021,61521,82L-IMPORT PAYROLL,D108,HJ,84.88,,600863.5
6150,6/15/2021,6/15/2021,61521,82L-IMPORT PAYROLL,D108,HJ,84.88,,600948.38
6150,6/15/2021,6/15/2021,61521,82L-IMPORT PAYROLL,D108,HJ,84.88,,601033.26
6150,6/15/2021,6/15/2021,61521,82L-IMPORT PAYROLL,D108,HJ,84.88,,601118.14
6150,6/15/2021,6/15/2021,61521,82L-IMPORT PAYROLL,D108,HJ,84.88,,601203.02
6150,6/15/2021,6/15/2021,61521,82L-IMPORT PAYROLL,D108,HJ,84.88,,601287.9
6150,6/15/2021,6/15/2021,61521,82L-IMPORT PAYROLL,D108,HJ,84.88,,601372.78
6150,6/15/2021,6/15/2021,61521,82L-IMPORT PAYROLL,D108,HJ,84.88,,601457.66
6150,6/15/2021,6/15/2021,61521,82L-IMPORT PAYROLL,D108,HJ,84.88,,601542.54
6150,6/15/2021,6/15/2021,61521,82L-IMPORT PAYROLL,D108,HJ,84.88,,601627.42
6150,6/15/2021,6/15/2021,61521,82L-IMPORT PAYROLL,D108,HJ,84.91,,601712.33
6150,6/15/2021,6/15/2021,61521,82L-IMPORT PAYROLL,D108,HJ,130.16,,601842.49
6150,6/15/2021,6/15/2021,61521,82L-IMPORT PAYROLL,D108,HJ,130.69,,601973.18
6150,6/15/2021,6/15/2021,61521,82L-IMPORT PAYROLL,D108,HJ,132.56,,602105.74
6150,6/15/2021,6/15/2021,61521,82L-IMPORT PAYROLL,D108,HJ,132.74,,602238.48
6150,6/15/2021,6/15/2021,61521,82L-IMPORT PAYROLL,D108,HJ,138.38,,602376.86
6150,6/15/2021,6/15/2021,61521,82L-IMPORT PAYROLL,D108,HJ,139.5,,602516.36
6150,6/15/2021,6/15/2021,61521,82L-IMPORT PAYROLL,D108,HJ,142.08,,602658.44
6150,6/15/2021,6/15/2021,61521,82L-IMPORT PAYROLL,D108,HJ,145.23,,602803.67
6150,6/15/2021,6/15/2021,61521,82L-IMPORT PAYROLL,D108,HJ,146.08,,602949.75
6150,6/15/2021,6/15/2021,61521,82L-IMPORT PAYROLL,D108,HJ,148.53,,603098.28
6150,6/15/2021,6/15/2021,61521,82L-IMPORT PAYROLL,D108,HJ,148.76,,603247.04
6150,6/15/2021,6/15/2021,61521,82L-IMPORT PAYROLL,D108,HJ,153.12,,603400.16
6150,6/15/2021,6/15/2021,61521,82L-IMPORT PAYROLL,D108,HJ,210.66,,603610.82
6150,6/15/2021,6/15/2021,61521,82L-IMPORT PAYROLL,D108,HJ,232.34,,603843.16
6150,6/15/2021,6/15/2021,61521,82L-IMPORT PAYROLL,D108,HJ,16.53,,603859.69
6150,6/15/2021,6/15/2021,61521,82L-IMPORT PAYROLL,D108,HJ,19.38,,603879.07
6150,6/15/2021,6/15/2021,61521,82L-IMPORT PAYROLL,D108,HJ,37.75,,603916.82
6150,6/15/2021,6/15/2021,61521,82L-IMPORT PAYROLL,D108,HJ,38.07,,603954.89
6150,6/15/2021,6/15/2021,61521,82L-IMPORT PAYROLL,D108,HJ,38.67,,603993.56
6150,6/15/2021,6/15/2021,61521,82L-IMPORT PAYROLL,D108,HJ,41.85,,604035.41
6150,6/15/2021,6/15/2021,61521,82L-IMPORT PAYROLL,D108,HJ,42.91,,604078.32
6150,6/15/2021,6/15/2021,61521,82L-IMPORT PAYROLL,D108,HJ,71.67,,604149.99
6150,6/15/2021,6/15/2021,61521,82L-IMPORT PAYROLL,D108,HJ,161.4,,604311.39
6150,6/15/2021,6/15/2021,61521,82L-IMPORT PAYROLL,D108,HJ,162.79,,604474.18
6150,6/15/2021,6/15/2021,61521,82L-IMPORT PAYROLL,D108,HJ,165.33,,604639.51
6150,6/15/2021,6/15/2021,61521,82L-IMPORT PAYROLL,D108,HJ,178.96,,604818.47
6150,6/15/2021,6/15/2021,61521,82L-IMPORT PAYROLL,D108,HJ,183.48,,605001.95
6150,6/15/2021,6/15/2021,61521,82L-IMPORT PAYROLL,D108,HJ,306.45,,605308.4
6150,6/16/2021,6/16/2021,ADP,ADP state UI filings and penalties June 2021,D104,HJ,7.68,,605316.08
6150,6/17/2021,6/17/2021,ADP,ADP state UI filings and penalties June 2021,D104,HJ,204.98,,605521.06
6150,6/24/2021,6/24/2021,ADP,ADP state UI filings and penalties June 2021,D104,HJ,4.58,,605525.64
6150,6/30/2021,6/30/2021,63021,82L-IMPORT PAYROLL,D108,HJ,2.68,,605528.32
6150,6/30/2021,6/30/2021,63021,82L-IMPORT PAYROLL,D108,HJ,5,,605533.32
6150,6/30/2021,6/30/2021,63021,82L-IMPORT PAYROLL,D108,HJ,11.47,,605544.79
6150,6/30/2021,6/30/2021,63021,82L-IMPORT PAYROLL,D108,HJ,15.19,,605559.98
6150,6/30/2021,6/30/2021,63021,82L-IMPORT PAYROLL,D108,HJ,27.59,,605587.57
6150,6/30/2021,6/30/2021,63021,82L-IMPORT PAYROLL,D108,HJ,27.84,,605615.41
6150,6/30/2021,6/30/2021,63021,82L-IMPORT PAYROLL,D108,HJ,28.83,,605644.24
6150,6/30/2021,6/30/2021,63021,82L-IMPORT PAYROLL,D108,HJ,29,,605673.24
6150,6/30/2021,6/30/2021,63021,82L-IMPORT PAYROLL,D108,HJ,30.21,,605703.45
6150,6/30/2021,6/30/2021,63021,82L-IMPORT PAYROLL,D108,HJ,32.46,,605735.91
6150,6/30/2021,6/30/2021,63021,82L-IMPORT PAYROLL,D108,HJ,33.58,,605769.49
6150,6/30/2021,6/30/2021,63021,82L-IMPORT PAYROLL,D108,HJ,36.25,,605805.74
6150,6/30/2021,6/30/2021,63021,82L-IMPORT PAYROLL,D108,HJ,38.17,,605843.91
6150,6/30/2021,6/30/2021,63021,82L-IMPORT PAYROLL,D108,HJ,64.95,,605908.86
6150,6/30/2021,6/30/2021,63021,82L-IMPORT PAYROLL,D108,HJ,80.62,,605989.48
6150,6/30/2021,6/30/2021,63021,82L-IMPORT PAYROLL,D108,HJ,117.98,,606107.46
6150,6/30/2021,6/30/2021,63021,82L-IMPORT PAYROLL,D108,HJ,119.05,,606226.51
6150,6/30/2021,6/30/2021,63021,82L-IMPORT PAYROLL,D108,HJ,123.26,,606349.77
6150,6/30/2021,6/30/2021,63021,82L-IMPORT PAYROLL,D108,HJ,124,,606473.77
6150,6/30/2021,6/30/2021,63021,82L-IMPORT PAYROLL,D108,HJ,129.17,,606602.94
6150,6/30/2021,6/30/2021,63021,82L-IMPORT PAYROLL,D108,HJ,138.81,,606741.75
6150,6/30/2021,6/30/2021,63021,82L-IMPORT PAYROLL,D108,HJ,143.59,,606885.34
6150,6/30/2021,6/30/2021,63021,82L-IMPORT PAYROLL,D108,HJ,155,,607040.34
6150,6/30/2021,6/30/2021,63021,82L-IMPORT PAYROLL,D108,HJ,163.23,,607203.57
6150,6/30/2021,6/30/2021,63021,82L-IMPORT PAYROLL,D108,HJ,15.66,,607219.23
6150,6/30/2021,6/30/2021,63021,82L-IMPORT PAYROLL,D108,HJ,31.22,,607250.45
6150,6/30/2021,6/30/2021,63021,82L-IMPORT PAYROLL,D108,HJ,32.04,,607282.49
6150,6/30/2021,6/30/2021,63021,82L-IMPORT PAYROLL,D108,HJ,32.86,,607315.35
6150,6/30/2021,6/30/2021,63021,82L-IMPORT PAYROLL,D108,HJ,32.9,,607348.25
6150,6/30/2021,6/30/2021,63021,82L-IMPORT PAYROLL,D108,HJ,33.03,,607381.28
6150,6/30/2021,6/30/2021,63021,82L-IMPORT PAYROLL,D108,HJ,33.1,,607414.38
6150,6/30/2021,6/30/2021,63021,82L-IMPORT PAYROLL,D108,HJ,33.23,,607447.61
6150,6/30/2021,6/30/2021,63021,82L-IMPORT PAYROLL,D108,HJ,33.4,,607481.01
6150,6/30/2021,6/30/2021,63021,82L-IMPORT PAYROLL,D108,HJ,33.42,,607514.43
6150,6/30/2021,6/30/2021,63021,82L-IMPORT PAYROLL,D108,HJ,33.86,,607548.29
6150,6/30/2021,6/30/2021,63021,82L-IMPORT PAYROLL,D108,HJ,34.07,,607582.36
6150,6/30/2021,6/30/2021,63021,82L-IMPORT PAYROLL,D108,HJ,34.16,,607616.52
6150,6/30/2021,6/30/2021,63021,82L-IMPORT PAYROLL,D108,HJ,36.3,,607652.82
6150,6/30/2021,6/30/2021,63021,82L-IMPORT PAYROLL,D108,HJ,36.32,,607689.14
6150,6/30/2021,6/30/2021,63021,82L-IMPORT PAYROLL,D108,HJ,36.34,,607725.48
6150,6/30/2021,6/30/2021,63021,82L-IMPORT PAYROLL,D108,HJ,37.8,,607763.28
6150,6/30/2021,6/30/2021,63021,82L-IMPORT PAYROLL,D108,HJ,39,,607802.28
6150,6/30/2021,6/30/2021,63021,82L-IMPORT PAYROLL,D108,HJ,43.36,,607845.64
6150,6/30/2021,6/30/2021,63021,82L-IMPORT PAYROLL,D108,HJ,46.25,,607891.89
6150,6/30/2021,6/30/2021,63021,82L-IMPORT PAYROLL,D108,HJ,46.47,,607938.36
6150,6/30/2021,6/30/2021,63021,82L-IMPORT PAYROLL,D108,HJ,46.52,,607984.88
6150,6/30/2021,6/30/2021,63021,82L-IMPORT PAYROLL,D108,HJ,51.5,,608036.38
6150,6/30/2021,6/30/2021,63021,82L-IMPORT PAYROLL,D108,HJ,54.35,,608090.73
6150,6/30/2021,6/30/2021,63021,82L-IMPORT PAYROLL,D108,HJ,65.29,,608156.02
6150,6/30/2021,6/30/2021,63021,82L-IMPORT PAYROLL,D108,HJ,66.96,,608222.98
6150,6/30/2021,6/30/2021,63021,82L-IMPORT PAYROLL,D108,HJ,85.68,,608308.66
6150,6/30/2021,6/30/2021,63021,82L-IMPORT PAYROLL,D108,HJ,133.51,,608442.17
6150,6/30/2021,6/30/2021,63021,82L-IMPORT PAYROLL,D108,HJ,137,,608579.17
6150,6/30/2021,6/30/2021,63021,82L-IMPORT PAYROLL,D108,HJ,140.49,,608719.66
6150,6/30/2021,6/30/2021,63021,82L-IMPORT PAYROLL,D108,HJ,140.68,,608860.34
6150,6/30/2021,6/30/2021,63021,82L-IMPORT PAYROLL,D108,HJ,141.23,,609001.57
6150,6/30/2021,6/30/2021,63021,82L-IMPORT PAYROLL,D108,HJ,141.55,,609143.12
6150,6/30/2021,6/30/2021,63021,82L-IMPORT PAYROLL,D108,HJ,142.08,,609285.2
6150,6/30/2021,6/30/2021,63021,82L-IMPORT PAYROLL,D108,HJ,142.81,,609428.01
6150,6/30/2021,6/30/2021,63021,82L-IMPORT PAYROLL,D108,HJ,142.9,,609570.91
6150,6/30/2021,6/30/2021,63021,82L-IMPORT PAYROLL,D108,HJ,144.76,,609715.67
6150,6/30/2021,6/30/2021,63021,82L-IMPORT PAYROLL,D108,HJ,145.66,,609861.33
6150,6/30/2021,6/30/2021,63021,82L-IMPORT PAYROLL,D108,HJ,146.08,,610007.41
6150,6/30/2021,6/30/2021,63021,82L-IMPORT PAYROLL,D108,HJ,155.19,,610162.6
6150,6/30/2021,6/30/2021,63021,82L-IMPORT PAYROLL,D108,HJ,155.3,,610317.9
6150,6/30/2021,6/30/2021,63021,82L-IMPORT PAYROLL,D108,HJ,155.39,,610473.29
6150,6/30/2021,6/30/2021,63021,82L-IMPORT PAYROLL,D108,HJ,166.74,,610640.03
6150,6/30/2021,6/30/2021,63021,82L-IMPORT PAYROLL,D108,HJ,185.41,,610825.44
6150,6/30/2021,6/30/2021,63021,82L-IMPORT PAYROLL,D108,HJ,197.75,,611023.19
6150,6/30/2021,6/30/2021,63021,82L-IMPORT PAYROLL,D108,HJ,198.7,,611221.89
6150,6/30/2021,6/30/2021,63021,82L-IMPORT PAYROLL,D108,HJ,198.92,,611420.81
6150,6/30/2021,6/30/2021,63021,82L-IMPORT PAYROLL,D108,HJ,220.21,,611641.02
6150,6/30/2021,6/30/2021,63021,82L-IMPORT PAYROLL,D108,HJ,232.39,,611873.41
6150,6/30/2021,6/30/2021,63021,82L-IMPORT PAYROLL,D108,HJ,279.17,,612152.58
6150,6/30/2021,6/30/2021,63021,82L-IMPORT PAYROLL,D101,HJ,15.92,,612168.5
6150,6/30/2021,6/30/2021,63021,82L-IMPORT PAYROLL,D101,HJ,17.57,,612186.07
6150,6/30/2021,6/30/2021,63021,82L-IMPORT PAYROLL,D101,HJ,17.57,,612203.64
6150,6/30/2021,6/30/2021,63021,82L-IMPORT PAYROLL,D101,HJ,17.71,,612221.35
6150,6/30/2021,6/30/2021,63021,82L-IMPORT PAYROLL,D101,HJ,29.27,,612250.62
6150,6/30/2021,6/30/2021,63021,82L-IMPORT PAYROLL,D101,HJ,33.23,,612283.85
6150,6/30/2021,6/30/2021,63021,82L-IMPORT PAYROLL,D101,HJ,33.51,,612317.36
6150,6/30/2021,6/30/2021,63021,82L-IMPORT PAYROLL,D101,HJ,37.18,,612354.54
6150,6/30/2021,6/30/2021,63021,82L-IMPORT PAYROLL,D101,HJ,38.11,,612392.65
6150,6/30/2021,6/30/2021,63021,82L-IMPORT PAYROLL,D101,HJ,39.27,,612431.92
6150,6/30/2021,6/30/2021,63021,82L-IMPORT PAYROLL,D101,HJ,41.08,,612473
6150,6/30/2021,6/30/2021,63021,82L-IMPORT PAYROLL,D101,HJ,49.84,,612522.84
6150,6/30/2021,6/30/2021,63021,82L-IMPORT PAYROLL,D101,HJ,68.09,,612590.93
6150,6/30/2021,6/30/2021,63021,82L-IMPORT PAYROLL,D101,HJ,75.71,,612666.64
6150,6/30/2021,6/30/2021,63021,82L-IMPORT PAYROLL,D101,HJ,125.14,,612791.78
6150,6/30/2021,6/30/2021,63021,82L-IMPORT PAYROLL,D101,HJ,142.08,,612933.86
6150,6/30/2021,6/30/2021,63021,82L-IMPORT PAYROLL,D101,HJ,143.3,,613077.16
6150,6/30/2021,6/30/2021,63021,82L-IMPORT PAYROLL,D101,HJ,159,,613236.16
6150,6/30/2021,6/30/2021,63021,82L-IMPORT PAYROLL,D101,HJ,162.94,,613399.1
6150,6/30/2021,6/30/2021,63021,82L-IMPORT PAYROLL,D101,HJ,167.92,,613567.02
6150,6/30/2021,6/30/2021,63021,82L-IMPORT PAYROLL,D101,HJ,175.67,,613742.69
6150,6/30/2021,6/30/2021,63021,82L-IMPORT PAYROLL,D101,HJ,213.13,,613955.82
6150,6/30/2021,6/30/2021,63021,82L-IMPORT PAYROLL,D102,HJ,29.6,,613985.42
6150,6/30/2021,6/30/2021,63021,82L-IMPORT PAYROLL,D102,HJ,30.45,,614015.87
6150,6/30/2021,6/30/2021,63021,82L-IMPORT PAYROLL,D102,HJ,39,,614054.87
6150,6/30/2021,6/30/2021,63021,82L-IMPORT PAYROLL,D102,HJ,43.21,,614098.08
6150,6/30/2021,6/30/2021,63021,82L-IMPORT PAYROLL,D102,HJ,87,,614185.08
6150,6/30/2021,6/30/2021,63021,82L-IMPORT PAYROLL,D102,HJ,126.57,,614311.65
6150,6/30/2021,6/30/2021,63021,82L-IMPORT PAYROLL,D102,HJ,166.75,,614478.4
6150,6/30/2021,6/30/2021,63021,82L-IMPORT PAYROLL,D103,HJ,8.37,,614486.77
6150,6/30/2021,6/30/2021,63021,82L-IMPORT PAYROLL,D103,HJ,31.08,,614517.85
6150,6/30/2021,6/30/2021,63021,82L-IMPORT PAYROLL,D103,HJ,32.86,,614550.71
6150,6/30/2021,6/30/2021,63021,82L-IMPORT PAYROLL,D103,HJ,33.06,,614583.77
6150,6/30/2021,6/30/2021,63021,82L-IMPORT PAYROLL,D103,HJ,35.77,,614619.54
6150,6/30/2021,6/30/2021,63021,82L-IMPORT PAYROLL,D103,HJ,49.27,,614668.81
6150,6/30/2021,6/30/2021,63021,82L-IMPORT PAYROLL,D103,HJ,132.89,,614801.7
6150,6/30/2021,6/30/2021,63021,82L-IMPORT PAYROLL,D103,HJ,140.49,,614942.19
6150,6/30/2021,6/30/2021,63021,82L-IMPORT PAYROLL,D103,HJ,141.34,,615083.53
6150,6/30/2021,6/30/2021,63021,82L-IMPORT PAYROLL,D103,HJ,210.66,,615294.19
6150,6/30/2021,6/30/2021,63021,82L-IMPORT PAYROLL,D104,HJ,26.82,,615321.01
6150,6/30/2021,6/30/2021,63021,82L-IMPORT PAYROLL,D104,HJ,28.71,,615349.72
6150,6/30/2021,6/30/2021,63021,82L-IMPORT PAYROLL,D104,HJ,28.82,,615378.54
6150,6/30/2021,6/30/2021,63021,82L-IMPORT PAYROLL,D104,HJ,34.12,,615412.66
6150,6/30/2021,6/30/2021,63021,82L-IMPORT PAYROLL,D104,HJ,37.03,,615449.69
6150,6/30/2021,6/30/2021,63021,82L-IMPORT PAYROLL,D104,HJ,38.13,,615487.82
6150,6/30/2021,6/30/2021,63021,82L-IMPORT PAYROLL,D104,HJ,40.2,,615528.02
6150,6/30/2021,6/30/2021,63021,82L-IMPORT PAYROLL,D104,HJ,69.16,,615597.18
6150,6/30/2021,6/30/2021,63021,82L-IMPORT PAYROLL,D104,HJ,114.66,,615711.84
6150,6/30/2021,6/30/2021,63021,82L-IMPORT PAYROLL,D104,HJ,122.75,,615834.59
6150,6/30/2021,6/30/2021,63021,82L-IMPORT PAYROLL,D104,HJ,123.23,,615957.82
6150,6/30/2021,6/30/2021,63021,82L-IMPORT PAYROLL,D104,HJ,145.9,,616103.72
6150,6/30/2021,6/30/2021,63021,82L-IMPORT PAYROLL,D104,HJ,158.35,,616262.07
6150,6/30/2021,6/30/2021,63021,82L-IMPORT PAYROLL,D104,HJ,163.06,,616425.13
6150,6/30/2021,6/30/2021,63021,82L-IMPORT PAYROLL,D104,HJ,171.87,,616597
6150,6/30/2021,6/30/2021,63021,82L-IMPORT PAYROLL,D104,HJ,295.71,,616892.71
6150,6/30/2021,6/30/2021,63021,82L-IMPORT PAYROLL,D105,HJ,25.57,,616918.28
6150,6/30/2021,6/30/2021,63021,82L-IMPORT PAYROLL,D105,HJ,27.79,,616946.07
6150,6/30/2021,6/30/2021,63021,82L-IMPORT PAYROLL,D105,HJ,31.18,,616977.25
6150,6/30/2021,6/30/2021,63021,82L-IMPORT PAYROLL,D105,HJ,39.93,,617017.18
6150,6/30/2021,6/30/2021,63021,82L-IMPORT PAYROLL,D105,HJ,49.87,,617067.05
6150,6/30/2021,6/30/2021,63021,82L-IMPORT PAYROLL,D105,HJ,109.31,,617176.36
6150,6/30/2021,6/30/2021,63021,82L-IMPORT PAYROLL,D105,HJ,118.83,,617295.19
6150,6/30/2021,6/30/2021,63021,82L-IMPORT PAYROLL,D105,HJ,133.3,,617428.49
6150,6/30/2021,6/30/2021,63021,82L-IMPORT PAYROLL,D105,HJ,170.75,,617599.24
6150,6/30/2021,6/30/2021,63021,82L-IMPORT PAYROLL,D105,HJ,213.25,,617812.49
6150,6/30/2021,6/30/2021,63021,82L-IMPORT PAYROLL,D107,HJ,9.32,,617821.81
6150,6/30/2021,6/30/2021,63021,82L-IMPORT PAYROLL,D107,HJ,11.04,,617832.85
6150,6/30/2021,6/30/2021,63021,82L-IMPORT PAYROLL,D107,HJ,25.13,,617857.98
6150,6/30/2021,6/30/2021,63021,82L-IMPORT PAYROLL,D107,HJ,34.49,,617892.47
6150,6/30/2021,6/30/2021,63021,82L-IMPORT PAYROLL,D107,HJ,39.84,,617932.31
6150,6/30/2021,6/30/2021,63021,82L-IMPORT PAYROLL,D107,HJ,39.93,,617972.24
6150,6/30/2021,6/30/2021,63021,82L-IMPORT PAYROLL,D107,HJ,41.75,,618013.99
6150,6/30/2021,6/30/2021,63021,82L-IMPORT PAYROLL,D107,HJ,42.16,,618056.15
6150,6/30/2021,6/30/2021,63021,82L-IMPORT PAYROLL,D107,HJ,43.25,,618099.4
6150,6/30/2021,6/30/2021,63021,82L-IMPORT PAYROLL,D107,HJ,45.31,,618144.71
6150,6/30/2021,6/30/2021,63021,82L-IMPORT PAYROLL,D107,HJ,47.21,,618191.92
6150,6/30/2021,6/30/2021,63021,82L-IMPORT PAYROLL,D107,HJ,48.81,,618240.73
6150,6/30/2021,6/30/2021,63021,82L-IMPORT PAYROLL,D107,HJ,50,,618290.73
6150,6/30/2021,6/30/2021,63021,82L-IMPORT PAYROLL,D107,HJ,72.42,,618363.15
6150,6/30/2021,6/30/2021,63021,82L-IMPORT PAYROLL,D107,HJ,94.2,,618457.35
6150,6/30/2021,6/30/2021,63021,82L-IMPORT PAYROLL,D107,HJ,147.49,,618604.84
6150,6/30/2021,6/30/2021,63021,82L-IMPORT PAYROLL,D107,HJ,170.75,,618775.59
6150,6/30/2021,6/30/2021,63021,82L-IMPORT PAYROLL,D107,HJ,178.51,,618954.1
6150,6/30/2021,6/30/2021,63021,82L-IMPORT PAYROLL,D107,HJ,180.27,,619134.37
6150,6/30/2021,6/30/2021,63021,82L-IMPORT PAYROLL,D107,HJ,184.93,,619319.3
6150,6/30/2021,6/30/2021,63021,82L-IMPORT PAYROLL,D107,HJ,193.75,,619513.05
6150,6/30/2021,6/30/2021,63021,82L-IMPORT PAYROLL,D107,HJ,208.7,,619721.75
6150,6/30/2021,6/30/2021,63021,82L-IMPORT PAYROLL,D107,HJ,309.64,,620031.39
6150,6/30/2021,6/30/2021,63021,82L-IMPORT PAYROLL,D107,HJ,402.8,,620434.19
6150,6/30/2021,6/30/2021,63021,82L-IMPORT PAYROLL,D109,HJ,18.2,,620452.39
6150,6/30/2021,6/30/2021,63021,82L-IMPORT PAYROLL,D109,HJ,27.19,,620479.58
6150,6/30/2021,6/30/2021,63021,82L-IMPORT PAYROLL,D109,HJ,55.91,,620535.49
6150,6/30/2021,6/30/2021,63021,82L-IMPORT PAYROLL,D109,HJ,56.19,,620591.68
6150,6/30/2021,6/30/2021,63021,82L-IMPORT PAYROLL,D109,HJ,58.24,,620649.92
6150,6/30/2021,6/30/2021,63021,82L-IMPORT PAYROLL,D109,HJ,72.5,,620722.42
6150,6/30/2021,6/30/2021,63021,82L-IMPORT PAYROLL,D109,HJ,76.2,,620798.62
6150,6/30/2021,6/30/2021,63021,82L-IMPORT PAYROLL,D109,HJ,77.81,,620876.43
6150,6/30/2021,6/30/2021,63021,82L-IMPORT PAYROLL,D109,HJ,116.25,,620992.68
6150,6/30/2021,6/30/2021,63021,82L-IMPORT PAYROLL,D109,HJ,239.08,,621231.76
6150,6/30/2021,6/30/2021,63021,82L-IMPORT PAYROLL,D109,HJ,240.25,,621472.01
6150,6/30/2021,6/30/2021,63021,82L-IMPORT PAYROLL,D109,HJ,249.03,,621721.04
6150,6/30/2021,6/30/2021,63021,82L-IMPORT PAYROLL,D109,HJ,310,,622031.04
6150,6/30/2021,6/30/2021,63021,82L-IMPORT PAYROLL,D109,HJ,325.8,,622356.84
6150,6/30/2021,6/30/2021,63021,82L-IMPORT PAYROLL,D109,HJ,366.2,,622723.04
6150,6/30/2021,6/30/2021,63021,82L-IMPORT PAYROLL,D109,HJ,367.94,,623090.98
6150,6/30/2021,6/30/2021,63021,82L-IMPORT PAYROLL,D109,HJ,368.54,,623459.52
6150,6/30/2021,6/30/2021,63021,82L-IMPORT PAYROLL,D109,HJ,369.99,,623829.51
6150,6/30/2021,6/30/2021,63021,82L-IMPORT PAYROLL,D109,HJ,1565.8,,625395.31
6150,6/30/2021,6/30/2021,63021,82L-IMPORT PAYROLL,D109,HJ,1573.27,,626968.58
6150,6/30/2021,6/30/2021,63021,82L-IMPORT PAYROLL,D109,HJ,1575.83,,628544.41
6150,6/30/2021,6/30/2021,63021,82L-IMPORT PAYROLL,D109,HJ,1582.03,,630126.44
6150,6/30/2021,6/30/2021,63021,82L-IMPORT PAYROLL,D111,HJ,13.49,,630139.93
6150,6/30/2021,6/30/2021,63021,82L-IMPORT PAYROLL,D111,HJ,24.01,,630163.94
6150,6/30/2021,6/30/2021,63021,82L-IMPORT PAYROLL,D111,HJ,29.45,,630193.39
6150,6/30/2021,6/30/2021,63021,82L-IMPORT PAYROLL,D111,HJ,34.97,,630228.36
6150,6/30/2021,6/30/2021,63021,82L-IMPORT PAYROLL,D111,HJ,37.17,,630265.53
6150,6/30/2021,6/30/2021,63021,82L-IMPORT PAYROLL,D111,HJ,53.01,,630318.54
6150,6/30/2021,6/30/2021,63021,82L-IMPORT PAYROLL,D111,HJ,102.68,,630421.22
6150,6/30/2021,6/30/2021,63021,82L-IMPORT PAYROLL,D111,HJ,125.93,,630547.15
6150,6/30/2021,6/30/2021,63021,82L-IMPORT PAYROLL,D111,HJ,149.53,,630696.68
6150,6/30/2021,6/30/2021,63021,82L-IMPORT PAYROLL,D111,HJ,158.92,,630855.6
6150,6/30/2021,6/30/2021,63021,82L-IMPORT PAYROLL,D111,HJ,226.68,,631082.28
6150,6/30/2021,6/30/2021,63021,82L-IMPORT PAYROLL,D112,HJ,37.96,,631120.24
6150,6/30/2021,6/30/2021,63021,82L-IMPORT PAYROLL,D112,HJ,162.32,,631282.56
6150,6/30/2021,6/30/2021,63021,82L-IMPORT PAYROLL,D108,HJ,1.64,,631284.2
6150,6/30/2021,6/30/2021,63021,82L-IMPORT PAYROLL,D108,HJ,6.94,,631291.14
6150,6/30/2021,6/30/2021,63021,82L-IMPORT PAYROLL,D108,HJ,14,,631305.14
6150,6/30/2021,6/30/2021,63021,82L-IMPORT PAYROLL,D108,HJ,14.32,,631319.46
6150,6/30/2021,6/30/2021,63021,82L-IMPORT PAYROLL,D108,HJ,15.08,,631334.54
6150,6/30/2021,6/30/2021,63021,82L-IMPORT PAYROLL,D108,HJ,15.08,,631349.62
6150,6/30/2021,6/30/2021,63021,82L-IMPORT PAYROLL,D108,HJ,15.28,,631364.9
6150,6/30/2021,6/30/2021,63021,82L-IMPORT PAYROLL,D108,HJ,15.28,,631380.18
6150,6/30/2021,6/30/2021,63021,82L-IMPORT PAYROLL,D108,HJ,15.33,,631395.51
6150,6/30/2021,6/30/2021,63021,82L-IMPORT PAYROLL,D108,HJ,16.05,,631411.56
6150,6/30/2021,6/30/2021,63021,82L-IMPORT PAYROLL,D108,HJ,16.2,,631427.76
6150,6/30/2021,6/30/2021,63021,82L-IMPORT PAYROLL,D108,HJ,16.23,,631443.99
6150,6/30/2021,6/30/2021,63021,82L-IMPORT PAYROLL,D108,HJ,16.23,,631460.22
6150,6/30/2021,6/30/2021,63021,82L-IMPORT PAYROLL,D108,HJ,16.23,,631476.45
6150,6/30/2021,6/30/2021,63021,82L-IMPORT PAYROLL,D108,HJ,16.23,,631492.68
6150,6/30/2021,6/30/2021,63021,82L-IMPORT PAYROLL,D108,HJ,16.23,,631508.91
6150,6/30/2021,6/30/2021,63021,82L-IMPORT PAYROLL,D108,HJ,16.23,,631525.14
6150,6/30/2021,6/30/2021,63021,82L-IMPORT PAYROLL,D108,HJ,16.23,,631541.37
6150,6/30/2021,6/30/2021,63021,82L-IMPORT PAYROLL,D108,HJ,16.23,,631557.6
6150,6/30/2021,6/30/2021,63021,82L-IMPORT PAYROLL,D108,HJ,16.23,,631573.83
6150,6/30/2021,6/30/2021,63021,82L-IMPORT PAYROLL,D108,HJ,16.23,,631590.06
6150,6/30/2021,6/30/2021,63021,82L-IMPORT PAYROLL,D108,HJ,16.23,,631606.29
6150,6/30/2021,6/30/2021,63021,82L-IMPORT PAYROLL,D108,HJ,16.23,,631622.52
6150,6/30/2021,6/30/2021,63021,82L-IMPORT PAYROLL,D108,HJ,16.23,,631638.75
6150,6/30/2021,6/30/2021,63021,82L-IMPORT PAYROLL,D108,HJ,16.23,,631654.98
6150,6/30/2021,6/30/2021,63021,82L-IMPORT PAYROLL,D108,HJ,16.23,,631671.21
6150,6/30/2021,6/30/2021,63021,82L-IMPORT PAYROLL,D108,HJ,16.23,,631687.44
6150,6/30/2021,6/30/2021,63021,82L-IMPORT PAYROLL,D108,HJ,16.23,,631703.67
6150,6/30/2021,6/30/2021,63021,82L-IMPORT PAYROLL,D108,HJ,16.23,,631719.9
6150,6/30/2021,6/30/2021,63021,82L-IMPORT PAYROLL,D108,HJ,16.26,,631736.16
6150,6/30/2021,6/30/2021,63021,82L-IMPORT PAYROLL,D108,HJ,22.88,,631759.04
6150,6/30/2021,6/30/2021,63021,82L-IMPORT PAYROLL,D108,HJ,30.44,,631789.48
6150,6/30/2021,6/30/2021,63021,82L-IMPORT PAYROLL,D108,HJ,30.56,,631820.04
6150,6/30/2021,6/30/2021,63021,82L-IMPORT PAYROLL,D108,HJ,31,,631851.04
6150,6/30/2021,6/30/2021,63021,82L-IMPORT PAYROLL,D108,HJ,31.04,,631882.08
6150,6/30/2021,6/30/2021,63021,82L-IMPORT PAYROLL,D108,HJ,32.63,,631914.71
6150,6/30/2021,6/30/2021,63021,82L-IMPORT PAYROLL,D108,HJ,33.23,,631947.94
6150,6/30/2021,6/30/2021,63021,82L-IMPORT PAYROLL,D108,HJ,33.57,,631981.51
6150,6/30/2021,6/30/2021,63021,82L-IMPORT PAYROLL,D108,HJ,33.96,,632015.47
6150,6/30/2021,6/30/2021,63021,82L-IMPORT PAYROLL,D108,HJ,34.16,,632049.63
6150,6/30/2021,6/30/2021,63021,82L-IMPORT PAYROLL,D108,HJ,34.74,,632084.37
6150,6/30/2021,6/30/2021,63021,82L-IMPORT PAYROLL,D108,HJ,34.79,,632119.16
6150,6/30/2021,6/30/2021,63021,82L-IMPORT PAYROLL,D108,HJ,35.81,,632154.97
6150,6/30/2021,6/30/2021,63021,82L-IMPORT PAYROLL,D108,HJ,36.93,,632191.9
6150,6/30/2021,6/30/2021,63021,82L-IMPORT PAYROLL,D108,HJ,44.59,,632236.49
6150,6/30/2021,6/30/2021,63021,82L-IMPORT PAYROLL,D108,HJ,54.34,,632290.83
6150,6/30/2021,6/30/2021,63021,82L-IMPORT PAYROLL,D108,HJ,59.86,,632350.69
6150,6/30/2021,6/30/2021,63021,82L-IMPORT PAYROLL,D108,HJ,61.22,,632411.91
6150,6/30/2021,6/30/2021,63021,82L-IMPORT PAYROLL,D108,HJ,64.5,,632476.41
6150,6/30/2021,6/30/2021,63021,82L-IMPORT PAYROLL,D108,HJ,64.5,,632540.91
6150,6/30/2021,6/30/2021,63021,82L-IMPORT PAYROLL,D108,HJ,65.35,,632606.26
6150,6/30/2021,6/30/2021,63021,82L-IMPORT PAYROLL,D108,HJ,65.35,,632671.61
6150,6/30/2021,6/30/2021,63021,82L-IMPORT PAYROLL,D108,HJ,68.64,,632740.25
6150,6/30/2021,6/30/2021,63021,82L-IMPORT PAYROLL,D108,HJ,69.27,,632809.52
6150,6/30/2021,6/30/2021,63021,82L-IMPORT PAYROLL,D108,HJ,69.38,,632878.9
6150,6/30/2021,6/30/2021,63021,82L-IMPORT PAYROLL,D108,HJ,69.38,,632948.28
6150,6/30/2021,6/30/2021,63021,82L-IMPORT PAYROLL,D108,HJ,69.38,,633017.66
6150,6/30/2021,6/30/2021,63021,82L-IMPORT PAYROLL,D108,HJ,69.38,,633087.04
6150,6/30/2021,6/30/2021,63021,82L-IMPORT PAYROLL,D108,HJ,69.38,,633156.42
6150,6/30/2021,6/30/2021,63021,82L-IMPORT PAYROLL,D108,HJ,69.38,,633225.8
6150,6/30/2021,6/30/2021,63021,82L-IMPORT PAYROLL,D108,HJ,69.38,,633295.18
6150,6/30/2021,6/30/2021,63021,82L-IMPORT PAYROLL,D108,HJ,69.38,,633364.56
6150,6/30/2021,6/30/2021,63021,82L-IMPORT PAYROLL,D108,HJ,69.38,,633433.94
6150,6/30/2021,6/30/2021,63021,82L-IMPORT PAYROLL,D108,HJ,69.38,,633503.32
6150,6/30/2021,6/30/2021,63021,82L-IMPORT PAYROLL,D108,HJ,69.38,,633572.7
6150,6/30/2021,6/30/2021,63021,82L-IMPORT PAYROLL,D108,HJ,69.38,,633642.08
6150,6/30/2021,6/30/2021,63021,82L-IMPORT PAYROLL,D108,HJ,69.38,,633711.46
6150,6/30/2021,6/30/2021,63021,82L-IMPORT PAYROLL,D108,HJ,69.38,,633780.84
6150,6/30/2021,6/30/2021,63021,82L-IMPORT PAYROLL,D108,HJ,69.38,,633850.22
6150,6/30/2021,6/30/2021,63021,82L-IMPORT PAYROLL,D108,HJ,69.38,,633919.6
6150,6/30/2021,6/30/2021,63021,82L-IMPORT PAYROLL,D108,HJ,69.38,,633988.98
6150,6/30/2021,6/30/2021,63021,82L-IMPORT PAYROLL,D108,HJ,69.38,,634058.36
6150,6/30/2021,6/30/2021,63021,82L-IMPORT PAYROLL,D108,HJ,69.52,,634127.88
6150,6/30/2021,6/30/2021,63021,82L-IMPORT PAYROLL,D108,HJ,74.25,,634202.13
6150,6/30/2021,6/30/2021,63021,82L-IMPORT PAYROLL,D108,HJ,97.83,,634299.96
6150,6/30/2021,6/30/2021,63021,82L-IMPORT PAYROLL,D108,HJ,130.16,,634430.12
6150,6/30/2021,6/30/2021,63021,82L-IMPORT PAYROLL,D108,HJ,130.69,,634560.81
6150,6/30/2021,6/30/2021,63021,82L-IMPORT PAYROLL,D108,HJ,132.56,,634693.37
6150,6/30/2021,6/30/2021,63021,82L-IMPORT PAYROLL,D108,HJ,132.74,,634826.11
6150,6/30/2021,6/30/2021,63021,82L-IMPORT PAYROLL,D108,HJ,139.5,,634965.61
6150,6/30/2021,6/30/2021,63021,82L-IMPORT PAYROLL,D108,HJ,142.08,,635107.69
6150,6/30/2021,6/30/2021,63021,82L-IMPORT PAYROLL,D108,HJ,145.23,,635252.92
6150,6/30/2021,6/30/2021,63021,82L-IMPORT PAYROLL,D108,HJ,146.08,,635399
6150,6/30/2021,6/30/2021,63021,82L-IMPORT PAYROLL,D108,HJ,148.53,,635547.53
6150,6/30/2021,6/30/2021,63021,82L-IMPORT PAYROLL,D108,HJ,148.76,,635696.29
6150,6/30/2021,6/30/2021,63021,82L-IMPORT PAYROLL,D108,HJ,153.12,,635849.41
6150,6/30/2021,6/30/2021,63021,82L-IMPORT PAYROLL,D108,HJ,190.65,,636040.06
6150,6/30/2021,6/30/2021,63021,82L-IMPORT PAYROLL,D108,HJ,232.34,,636272.4
6150,6/30/2021,6/30/2021,63021,82L-IMPORT PAYROLL,D108,HJ,16.53,,636288.93
6150,6/30/2021,6/30/2021,63021,82L-IMPORT PAYROLL,D108,HJ,19.38,,636308.31
6150,6/30/2021,6/30/2021,63021,82L-IMPORT PAYROLL,D108,HJ,37.75,,636346.06
6150,6/30/2021,6/30/2021,63021,82L-IMPORT PAYROLL,D108,HJ,38.07,,636384.13
6150,6/30/2021,6/30/2021,63021,82L-IMPORT PAYROLL,D108,HJ,38.67,,636422.8
6150,6/30/2021,6/30/2021,63021,82L-IMPORT PAYROLL,D108,HJ,41.85,,636464.65
6150,6/30/2021,6/30/2021,63021,82L-IMPORT PAYROLL,D108,HJ,42.91,,636507.56
6150,6/30/2021,6/30/2021,63021,82L-IMPORT PAYROLL,D108,HJ,71.67,,636579.23
6150,6/30/2021,6/30/2021,63021,82L-IMPORT PAYROLL,D108,HJ,161.4,,636740.63
6150,6/30/2021,6/30/2021,63021,82L-IMPORT PAYROLL,D108,HJ,162.79,,636903.42
6150,6/30/2021,6/30/2021,63021,82L-IMPORT PAYROLL,D108,HJ,165.33,,637068.75
6150,6/30/2021,6/30/2021,63021,82L-IMPORT PAYROLL,D108,HJ,178.96,,637247.71
6150,6/30/2021,6/30/2021,63021,82L-IMPORT PAYROLL,D108,HJ,183.48,,637431.19
6150,6/30/2021,6/30/2021,63021,82L-IMPORT PAYROLL,D108,HJ,306.45,,637737.64
6150,6/30/2021,6/30/2021,Entry to correct the expense amount base,Entry to correct the expense amount based on ADP Timecard using SPARKMATH as activity code,D999,GJ,,1679.97,636057.67
6150,6/30/2021,6/30/2021,Entry to correct the expense amount base,Entry to correct the expense amount based on ADP Timecard using SPARKMATH as activity code,D999,GJ,1679.97,,637737.64
6150, Totals for 6150 - PR Taxes for Staff Salaries,,,,,,732296.7,94559.06,637737.64
6160,6160 - Staff Insurances (Balance forward As of 07/01/2020) ,,,,,,,,0
6160,7/13/2020,7/13/2020,Ohio Indemnity,Bill.Com Import-2Q2020 Unemployment Cost in 2Q2020 coupon,D107,HJ,3821.17,,3821.17
6160,7/15/2020,7/15/2020,71520,82L-PRPD-071520 -Import Payroll (GENERL)-Import Payroll,D108,HJ,3.5,,3824.67
6160,7/15/2020,7/15/2020,71520,82L-PRPD-071520 -Import Payroll (GENERL)-Import Payroll,D108,HJ,646.56,,4471.23
6160,7/15/2020,7/15/2020,71520,To reverse 82L payroll 0715 JE-21-0008-Reverse payroll entry 07152020 IMPORT PAYROLL,D108,HJ,,3.5,4467.73
6160,7/15/2020,7/15/2020,71520,To reverse 82L payroll 0715 JE-21-0008-Reverse payroll entry 07152020 IMPORT PAYROLL,D108,HJ,,646.56,3821.17
6160,7/17/2020,7/17/2020,The Hanover Ins,Hanover Ins. Partial Payment of Invoice FY21-Hanover Ins. Partial Payment of Invoice FY21,D107,HJ,1423,,5244.17
6160,7/24/2020,7/24/2020,The Hanover Ins,Bill.Com Import-FY21 Commercial Umbrella Policy UHN A512176 & Coomercial Package ZDN A512098,D107,HJ,5858.25,,11102.42
6160,7/31/2020,7/31/2020,73120,82L-PRPD-073120 -Import Payroll-DUPUIS CHRISTOPHER M,D108,HJ,640.02,,11742.44
6160,7/31/2020,7/31/2020,73120,To reverse 82L payroll 73120-To reverse 82L payroll of 73120 JE-21-0003,D108,HJ,,640.02,11102.42
6160,7/31/2020,7/31/2020,73120,82L-IMPORT PAYROLL-DUPUIS CHRISTOPHER M,D107,HJ,640.02,,11742.44
6160,8/4/2020,8/4/2020,Department of Labor,Bill.Com Import-Penalty for not filling 19-3 Q,D107,HJ,35,,11777.44
6160,8/14/2020,8/14/2020,81420,82L-IMPORT PAYROLL-Workers comp,D107,HJ,632.27,,12409.71
6160,8/14/2020,8/14/2020,82L-PRPD-081520,82L-PRPD-081520 -IMPORT PAYROLL-Workers Comp,D107,HJ,632.27,,13041.98
6160,8/15/2020,8/15/2020,82L-PRPD-081520,To reverse 82L payroll 0815 JE-21-0020-To reverse 82L Payroll of 8152020,D107,HJ,,632.27,12409.71
6160,8/18/2020,8/18/2020,The Hartford,NY State disability insurance-NY State disability insurance,D108,HJ,583.46,,12993.17
6160,8/31/2020,8/31/2020,82L-PRPD-083120,82L-PRPD-083120 -IMPORT PAYROLL-Workers Comp,D107,HJ,758.84,,13752.01
6160,8/31/2020,8/31/2020,82L-PRPD-083120,Reverse 82L payroll of 83120 JE-21-0021-IMPORT PAYROLL,D107,HJ,,758.84,12993.17
6160,10/1/2020,10/1/2020,20201001,To expense the prepaid expenses-COBRA and FSA administration fees and renewal for FY21,D107,HJ,2619.72,,15612.89
6160,10/1/2020,10/1/2020,20201001,To expense the prepaid expenses-FY21 unemployment cost management service,D107,HJ,2325,,17937.89
6160,10/1/2020,10/1/2020,20201001,To expense the prepaid expenses-To expense the prepaid expenses,D107,HJ,0.02,,17937.91
6160,10/21/2020,10/21/2020,The Hartford,NY Employee PFL insurance-NY Employee PFL insurance,D107,HJ,723.39,,18661.3
6160,12/31/2020,12/31/2020,20201231,Actual vs Budget Reclass as of 12/31/2020-Actual vs Budget Reclass as of 12/31/2020,D107,HJ,9936.42,,28597.72
6160,1/7/2021,1/7/2021,The Hartford,NY Employee PFL Insurance-NY Employee PFL Insurance,D107,HJ,723.39,,29321.11
6160,1/21/2021,1/21/2021,20201106,Refund from Simbulus Insurance-Refund from Simbulus Insurance,D107,HJ,,384.37,28936.74
6160,2/18/2021,2/18/2021,Ohio Indemnity,Bill.Com Import-Unemployment Cost from July 2020 Q1 to March 2021 Q3 for NYC and CHI,D107,HJ,24299.12,,53235.86
6160,2/18/2021,2/18/2021,Ohio Indemnity,Bill.Com Import-Unemployment Cost from July 2020 Q1 to March 2021 Q3 for NYC and CHI,D107,HJ,35593.41,,88829.27
6160,3/31/2021,3/31/2021,33121,82L-IMPORT PAYROLL,D107,HJ,911.81,,89741.08
6160,4/19/2021,4/19/2021,20210419,82L Special Payroll 2021-04-20,D103,HJ,37.21,,89778.29
6160,4/23/2021,4/23/2021,20210423,82L Special Payroll 2021-04-23,D104,HJ,2.83,,89781.12
6160,4/23/2021,4/23/2021,Ohio Indemnity,Bill.Com Import,D107,HJ,9727.78,,99508.9
6160,4/23/2021,4/23/2021,Ohio Indemnity,Bill.Com Import,D107,HJ,12380.82,,111889.72
6160,5/20/2021,5/20/2021,The Hanover Ins,Employee PFL Insurance coverage period 03.03.21,D107,HJ,1240.28,,113130
6160,5/21/2021,5/21/2021,Traveler's WC,Deposit 20210521,D107,HJ,,470,112660
6160, Totals for 6160 - Staff Insurances,,,,,,116195.56,3535.56,112660
6170,6170 - Staff Health Insurance (Balance forward As of 07/01/2020) ,,,,,,,,0
6170,7/1/2020,7/1/2020,BCBS -July,BCBS- July - BCBS Health Insurance-July -BCBS Health Insurance,D108,HJ,10970.14,,10970.14
6170,7/1/2020,7/1/2020,BCBS -July,BCBS- July - BCBS Health Insurance-July -BCBS Health Insurance,D107,HJ,2136.26,,13106.4
6170,7/1/2020,7/1/2020,BCBS -July,BCBS- July - BCBS Health Insurance-July -BCBS Health Insurance,D107,HJ,5595.47,,18701.87
6170,7/1/2020,7/1/2020,BCBS -July,BCBS- July - BCBS Health Insurance-July -BCBS Health Insurance,D108,HJ,2136.26,,20838.13
6170,7/1/2020,7/1/2020,BCBS -July,BCBS- July - BCBS Health Insurance-July -BCBS Health Insurance,D108,HJ,2108.99,,22947.12
6170,7/15/2020,7/15/2020,71520,82L-PRPD-071520 -Import Payroll (GENERL)-AKLESTAD ISABEL,D108,HJ,,130.11,22817.01
6170,7/15/2020,7/15/2020,71520,82L-PRPD-071520 -Import Payroll (GENERL)-AUSTIN PERCY,D108,HJ,,130.11,22686.9
6170,7/15/2020,7/15/2020,71520,82L-PRPD-071520 -Import Payroll (GENERL)-BARTOLD DEANNA MARIE,D108,HJ,,130.11,22556.79
6170,7/15/2020,7/15/2020,71520,82L-PRPD-071520 -Import Payroll (GENERL)-BAUSH DANIEL,D108,HJ,,130.11,22426.68
6170,7/15/2020,7/15/2020,71520,82L-PRPD-071520 -Import Payroll (GENERL)-COOPER ASHLEE R,D108,HJ,,136.92,22289.76
6170,7/15/2020,7/15/2020,71520,82L-PRPD-071520 -Import Payroll (GENERL)-COVENEY ALLISON,D108,HJ,,136.92,22152.84
6170,7/15/2020,7/15/2020,71520,82L-PRPD-071520 -Import Payroll (GENERL)-DADA ARIKPO E,D108,HJ,,390.22,21762.62
6170,7/15/2020,7/15/2020,71520,82L-PRPD-071520 -Import Payroll (GENERL)-FEIGHERY JOHN,D108,HJ,,130.11,21632.51
6170,7/15/2020,7/15/2020,71520,82L-PRPD-071520 -Import Payroll (GENERL)-GRAVES KAMIESHIA,D108,HJ,,240.7,21391.81
6170,7/15/2020,7/15/2020,71520,82L-PRPD-071520 -Import Payroll (GENERL)-GRAVES KIRA B,D108,HJ,,130.11,21261.7
6170,7/15/2020,7/15/2020,71520,82L-PRPD-071520 -Import Payroll (GENERL)-GUADARRAMA-ALVAREZ URIEL A,D108,HJ,,130.11,21131.59
6170,7/15/2020,7/15/2020,71520,82L-PRPD-071520 -Import Payroll (GENERL)-GUTHRIE LESLIE,D108,HJ,,136.92,20994.67
6170,7/15/2020,7/15/2020,71520,82L-PRPD-071520 -Import Payroll (GENERL)-HALLINAN GABRIEL B,D108,HJ,,136.92,20857.75
6170,7/15/2020,7/15/2020,71520,82L-PRPD-071520 -Import Payroll (GENERL)-HOLMES JOREL ALEXANDER,D108,HJ,,136.92,20720.83
6170,7/15/2020,7/15/2020,71520,82L-PRPD-071520 -Import Payroll (GENERL)-JACKSON CLAICE M,D108,HJ,,136.92,20583.91
6170,7/15/2020,7/15/2020,71520,82L-PRPD-071520 -Import Payroll (GENERL)-JACKSON TASNIM F,D108,HJ,,136.92,20446.99
6170,7/15/2020,7/15/2020,71520,82L-PRPD-071520 -Import Payroll (GENERL)-JANG DANIEL,D108,HJ,,130.11,20316.88
6170,7/15/2020,7/15/2020,71520,82L-PRPD-071520 -Import Payroll (GENERL)-JORDAN TIFFANY T,D108,HJ,,240.7,20076.18
6170,7/15/2020,7/15/2020,71520,82L-PRPD-071520 -Import Payroll (GENERL)-KAMYA MIRIAM L,D108,HJ,,136.92,19939.26
6170,7/15/2020,7/15/2020,71520,82L-PRPD-071520 -Import Payroll (GENERL)-LACEY DEQUITA,D108,HJ,,136.92,19802.34
6170,7/15/2020,7/15/2020,71520,82L-PRPD-071520 -Import Payroll (GENERL)-LENEGHAN MARYELLEN B,D108,HJ,,130.11,19672.23
6170,7/15/2020,7/15/2020,71520,82L-PRPD-071520 -Import Payroll (GENERL)-LI BELLA,D108,HJ,,130.11,19542.12
6170,7/15/2020,7/15/2020,71520,82L-PRPD-071520 -Import Payroll (GENERL)-MOSELEY ARIELLE,D108,HJ,,130.11,19412.01
6170,7/15/2020,7/15/2020,71520,82L-PRPD-071520 -Import Payroll (GENERL)-ONICA ANTHONY J,D108,HJ,,136.92,19275.09
6170,7/15/2020,7/15/2020,71520,82L-PRPD-071520 -Import Payroll (GENERL)-PARHAM-GANTT DENISE M,D108,HJ,,273.84,19001.25
6170,7/15/2020,7/15/2020,71520,82L-PRPD-071520 -Import Payroll (GENERL)-PEINADO ELIZABETH R,D108,HJ,,130.11,18871.14
6170,7/15/2020,7/15/2020,71520,82L-PRPD-071520 -Import Payroll (GENERL)-PRAHIN NICOLE M,D108,HJ,,130.11,18741.03
6170,7/15/2020,7/15/2020,71520,82L-PRPD-071520 -Import Payroll (GENERL)-RANDOLPH ALEXANDER,D108,HJ,,130.11,18610.92
6170,7/15/2020,7/15/2020,71520,82L-PRPD-071520 -Import Payroll (GENERL)-SALIM YASSER,D108,HJ,,136.92,18474
6170,7/15/2020,7/15/2020,71520,82L-PRPD-071520 -Import Payroll (GENERL)-SEJOUR MAHALIAH,D108,HJ,,136.92,18337.08
6170,7/15/2020,7/15/2020,71520,82L-PRPD-071520 -Import Payroll (GENERL)-SKALSKI CHRISTOPHER,D108,HJ,,130.11,18206.97
6170,7/15/2020,7/15/2020,71520,82L-PRPD-071520 -Import Payroll (GENERL)-TAM CW RYAN,D108,HJ,,65,18141.97
6170,7/15/2020,7/15/2020,71520,82L-PRPD-071520 -Import Payroll (GENERL)-TUMENJARGAL ENKHJIN,D108,HJ,,130.11,18011.86
6170,7/15/2020,7/15/2020,71520,82L-PRPD-071520 -Import Payroll (GENERL)-VILLEGAS EVELYN,D108,HJ,,390.22,17621.64
6170,7/15/2020,7/15/2020,71520,82L-PRPD-071520 -Import Payroll (GENERL)-WALLACE AMENA T,D108,HJ,,130.11,17491.53
6170,7/15/2020,7/15/2020,71520,82L-PRPD-071520 -Import Payroll (GENERL)-WOLF ANNA A,D108,HJ,,130.11,17361.42
6170,7/15/2020,7/15/2020,71520,To reverse 82L payroll 0715 JE-21-0008-Reverse payroll entry 07152020 IMPORT PAYROLL,D108,HJ,65,,17426.42
6170,7/15/2020,7/15/2020,71520,To reverse 82L payroll 0715 JE-21-0008-Reverse payroll entry 07152020 IMPORT PAYROLL,D108,HJ,130.11,,17556.53
6170,7/15/2020,7/15/2020,71520,To reverse 82L payroll 0715 JE-21-0008-Reverse payroll entry 07152020 IMPORT PAYROLL,D108,HJ,130.11,,17686.64
6170,7/15/2020,7/15/2020,71520,To reverse 82L payroll 0715 JE-21-0008-Reverse payroll entry 07152020 IMPORT PAYROLL,D108,HJ,130.11,,17816.75
6170,7/15/2020,7/15/2020,71520,To reverse 82L payroll 0715 JE-21-0008-Reverse payroll entry 07152020 IMPORT PAYROLL,D108,HJ,130.11,,17946.86
6170,7/15/2020,7/15/2020,71520,To reverse 82L payroll 0715 JE-21-0008-Reverse payroll entry 07152020 IMPORT PAYROLL,D108,HJ,130.11,,18076.97
6170,7/15/2020,7/15/2020,71520,To reverse 82L payroll 0715 JE-21-0008-Reverse payroll entry 07152020 IMPORT PAYROLL,D108,HJ,130.11,,18207.08
6170,7/15/2020,7/15/2020,71520,To reverse 82L payroll 0715 JE-21-0008-Reverse payroll entry 07152020 IMPORT PAYROLL,D108,HJ,130.11,,18337.19
6170,7/15/2020,7/15/2020,71520,To reverse 82L payroll 0715 JE-21-0008-Reverse payroll entry 07152020 IMPORT PAYROLL,D108,HJ,130.11,,18467.3
6170,7/15/2020,7/15/2020,71520,To reverse 82L payroll 0715 JE-21-0008-Reverse payroll entry 07152020 IMPORT PAYROLL,D108,HJ,130.11,,18597.41
6170,7/15/2020,7/15/2020,71520,To reverse 82L payroll 0715 JE-21-0008-Reverse payroll entry 07152020 IMPORT PAYROLL,D108,HJ,130.11,,18727.52
6170,7/15/2020,7/15/2020,71520,To reverse 82L payroll 0715 JE-21-0008-Reverse payroll entry 07152020 IMPORT PAYROLL,D108,HJ,130.11,,18857.63
6170,7/15/2020,7/15/2020,71520,To reverse 82L payroll 0715 JE-21-0008-Reverse payroll entry 07152020 IMPORT PAYROLL,D108,HJ,130.11,,18987.74
6170,7/15/2020,7/15/2020,71520,To reverse 82L payroll 0715 JE-21-0008-Reverse payroll entry 07152020 IMPORT PAYROLL,D108,HJ,130.11,,19117.85
6170,7/15/2020,7/15/2020,71520,To reverse 82L payroll 0715 JE-21-0008-Reverse payroll entry 07152020 IMPORT PAYROLL,D108,HJ,130.11,,19247.96
6170,7/15/2020,7/15/2020,71520,To reverse 82L payroll 0715 JE-21-0008-Reverse payroll entry 07152020 IMPORT PAYROLL,D108,HJ,130.11,,19378.07
6170,7/15/2020,7/15/2020,71520,To reverse 82L payroll 0715 JE-21-0008-Reverse payroll entry 07152020 IMPORT PAYROLL,D108,HJ,130.11,,19508.18
6170,7/15/2020,7/15/2020,71520,To reverse 82L payroll 0715 JE-21-0008-Reverse payroll entry 07152020 IMPORT PAYROLL,D108,HJ,130.11,,19638.29
6170,7/15/2020,7/15/2020,71520,To reverse 82L payroll 0715 JE-21-0008-Reverse payroll entry 07152020 IMPORT PAYROLL,D108,HJ,130.11,,19768.4
6170,7/15/2020,7/15/2020,71520,To reverse 82L payroll 0715 JE-21-0008-Reverse payroll entry 07152020 IMPORT PAYROLL,D108,HJ,136.92,,19905.32
6170,7/15/2020,7/15/2020,71520,To reverse 82L payroll 0715 JE-21-0008-Reverse payroll entry 07152020 IMPORT PAYROLL,D108,HJ,136.92,,20042.24
6170,7/15/2020,7/15/2020,71520,To reverse 82L payroll 0715 JE-21-0008-Reverse payroll entry 07152020 IMPORT PAYROLL,D108,HJ,136.92,,20179.16
6170,7/15/2020,7/15/2020,71520,To reverse 82L payroll 0715 JE-21-0008-Reverse payroll entry 07152020 IMPORT PAYROLL,D108,HJ,136.92,,20316.08
6170,7/15/2020,7/15/2020,71520,To reverse 82L payroll 0715 JE-21-0008-Reverse payroll entry 07152020 IMPORT PAYROLL,D108,HJ,136.92,,20453
6170,7/15/2020,7/15/2020,71520,To reverse 82L payroll 0715 JE-21-0008-Reverse payroll entry 07152020 IMPORT PAYROLL,D108,HJ,136.92,,20589.92
6170,7/15/2020,7/15/2020,71520,To reverse 82L payroll 0715 JE-21-0008-Reverse payroll entry 07152020 IMPORT PAYROLL,D108,HJ,136.92,,20726.84
6170,7/15/2020,7/15/2020,71520,To reverse 82L payroll 0715 JE-21-0008-Reverse payroll entry 07152020 IMPORT PAYROLL,D108,HJ,136.92,,20863.76
6170,7/15/2020,7/15/2020,71520,To reverse 82L payroll 0715 JE-21-0008-Reverse payroll entry 07152020 IMPORT PAYROLL,D108,HJ,136.92,,21000.68
6170,7/15/2020,7/15/2020,71520,To reverse 82L payroll 0715 JE-21-0008-Reverse payroll entry 07152020 IMPORT PAYROLL,D108,HJ,136.92,,21137.6
6170,7/15/2020,7/15/2020,71520,To reverse 82L payroll 0715 JE-21-0008-Reverse payroll entry 07152020 IMPORT PAYROLL,D108,HJ,136.92,,21274.52
6170,7/15/2020,7/15/2020,71520,To reverse 82L payroll 0715 JE-21-0008-Reverse payroll entry 07152020 IMPORT PAYROLL,D108,HJ,136.92,,21411.44
6170,7/15/2020,7/15/2020,71520,To reverse 82L payroll 0715 JE-21-0008-Reverse payroll entry 07152020 IMPORT PAYROLL,D108,HJ,240.7,,21652.14
6170,7/15/2020,7/15/2020,71520,To reverse 82L payroll 0715 JE-21-0008-Reverse payroll entry 07152020 IMPORT PAYROLL,D108,HJ,240.7,,21892.84
6170,7/15/2020,7/15/2020,71520,To reverse 82L payroll 0715 JE-21-0008-Reverse payroll entry 07152020 IMPORT PAYROLL,D108,HJ,273.84,,22166.68
6170,7/15/2020,7/15/2020,71520,To reverse 82L payroll 0715 JE-21-0008-Reverse payroll entry 07152020 IMPORT PAYROLL,D108,HJ,390.22,,22556.9
6170,7/15/2020,7/15/2020,71520,To reverse 82L payroll 0715 JE-21-0008-Reverse payroll entry 07152020 IMPORT PAYROLL,D108,HJ,390.22,,22947.12
6170,7/15/2020,7/15/2020,71520,82L-IMPORT PAYROLL-AUSTIN PERCY,D108,HJ,,130.11,22817.01
6170,7/15/2020,7/15/2020,71520,82L-IMPORT PAYROLL-BAUSH DANIEL,D108,HJ,,130.11,22686.9
6170,7/15/2020,7/15/2020,71520,82L-IMPORT PAYROLL-DADA ARIKPO E,D108,HJ,,390.22,22296.68
6170,7/15/2020,7/15/2020,71520,82L-IMPORT PAYROLL-GUTHRIE LESLIE,D108,HJ,,136.92,22159.76
6170,7/15/2020,7/15/2020,71520,82L-IMPORT PAYROLL-HOLMES JOREL ALEXANDER,D108,HJ,,136.92,22022.84
6170,7/15/2020,7/15/2020,71520,82L-IMPORT PAYROLL-JORDAN TIFFANY T,D108,HJ,,240.7,21782.14
6170,7/15/2020,7/15/2020,71520,82L-IMPORT PAYROLL-KAMYA MIRIAM L,D108,HJ,,136.92,21645.22
6170,7/15/2020,7/15/2020,71520,82L-IMPORT PAYROLL-ONICA ANTHONY J,D108,HJ,,136.92,21508.3
6170,7/15/2020,7/15/2020,71520,82L-IMPORT PAYROLL-PRAHIN NICOLE M,D108,HJ,,130.11,21378.19
6170,7/15/2020,7/15/2020,71520,82L-IMPORT PAYROLL-SALIM YASSER,D108,HJ,,136.92,21241.27
6170,7/15/2020,7/15/2020,71520,82L-IMPORT PAYROLL-SEJOUR MAHALIAH,D108,HJ,,136.92,21104.35
6170,7/15/2020,7/15/2020,71520,82L-IMPORT PAYROLL-SKALSKI CHRISTOPHER,D108,HJ,,130.11,20974.24
6170,7/15/2020,7/15/2020,71520,82L-IMPORT PAYROLL-TAM CW RYAN,D108,HJ,,65,20909.24
6170,7/15/2020,7/15/2020,71520,82L-IMPORT PAYROLL-TUMENJARGAL ENKHJIN,D108,HJ,,130.11,20779.13
6170,7/15/2020,7/15/2020,71520,82L-IMPORT PAYROLL-VILLEGAS EVELYN,D108,HJ,,390.22,20388.91
6170,7/15/2020,7/15/2020,71520,82L-IMPORT PAYROLL-WOLF ANNA A,D108,HJ,,130.11,20258.8
6170,7/15/2020,7/15/2020,71520,82L-PRPD-071520 -Import Payroll (PPP)-ACEVEDO MONIVETT,D103,HJ,,240.7,20018.1
6170,7/15/2020,7/15/2020,71520,82L-PRPD-071520 -Import Payroll (PPP)-COOK CATHRYN ANNA,D105,HJ,,136.92,19881.18
6170,7/15/2020,7/15/2020,71520,82L-PRPD-071520 -Import Payroll (PPP)-DETONE KYRA MAYA,D102,HJ,,130.11,19751.07
6170,7/15/2020,7/15/2020,71520,82L-PRPD-071520 -Import Payroll (PPP)-DUPUIS CHRISTOPHER M,D108,HJ,,136.92,19614.15
6170,7/15/2020,7/15/2020,71520,82L-PRPD-071520 -Import Payroll (PPP)-GUTIERREZ ANTONIO J,D102,HJ,,370.8,19243.35
6170,7/15/2020,7/15/2020,71520,82L-PRPD-071520 -Import Payroll (PPP)-MASON ANGELA,D111,HJ,,240.7,19002.65
6170,7/15/2020,7/15/2020,71520,82L-PRPD-071520 -Import Payroll (PPP)-POLANCO ODALIS,D103,HJ,,130.11,18872.54
6170,7/15/2020,7/15/2020,71520,82L-IMPORT PAYROLL-AKLESTAD ISABEL,D111,HJ,,130.11,18742.43
6170,7/15/2020,7/15/2020,71520,82L-IMPORT PAYROLL-COOPER ASHLEE R,D101,HJ,,136.92,18605.51
6170,7/15/2020,7/15/2020,71520,82L-IMPORT PAYROLL-GRAVES KAMIESHIA,D101,HJ,,240.7,18364.81
6170,7/15/2020,7/15/2020,71520,82L-IMPORT PAYROLL-GUADARRAMA-ALVAREZ URIEL A,D105,HJ,,130.11,18234.7
6170,7/15/2020,7/15/2020,71520,82L-IMPORT PAYROLL-LACEY DEQUITA,D107,HJ,,136.92,18097.78
6170,7/15/2020,7/15/2020,71520,82L-IMPORT PAYROLL-PARHAM-GANTT DENISE M,D112,HJ,,273.84,17823.94
6170,7/15/2020,7/15/2020,71520,82L-IMPORT PAYROLL-PEINADO ELIZABETH R,D111,HJ,,130.11,17693.83
6170,7/15/2020,7/15/2020,71520,82L-IMPORT PAYROLL-RANDOLPH ALEXANDER,D111,HJ,,130.11,17563.72
6170,7/15/2020,7/15/2020,71520,82L-IMPORT PAYROLL-WALLACE AMENA T,D104,HJ,,130.11,17433.61
6170,7/15/2020,7/15/2020,71520,82L-IMPORT PAYROLL-BARTOLD DEANNA MARIE,D108,HJ,,130.11,17303.5
6170,7/15/2020,7/15/2020,71520,82L-IMPORT PAYROLL-FEIGHERY JOHN,D108,HJ,,130.11,17173.39
6170,7/15/2020,7/15/2020,71520,82L-IMPORT PAYROLL-HALLINAN GABRIEL B,D108,HJ,,136.92,17036.47
6170,7/15/2020,7/15/2020,71520,82L-IMPORT PAYROLL-JACKSON TASNIM F,D108,HJ,,136.92,16899.55
6170,7/15/2020,7/15/2020,71520,82L-IMPORT PAYROLL-LI BELLA,D108,HJ,,130.11,16769.44
6170,7/15/2020,7/15/2020,71520,82L-IMPORT PAYROLL-MOSELEY ARIELLE,D108,HJ,,130.11,16639.33
6170,7/15/2020,7/15/2020,71520,82L-IMPORT PAYROLL-COVENEY ALLISON,D108,HJ,,136.92,16502.41
6170,7/15/2020,7/15/2020,71520,82L-IMPORT PAYROLL-GRAVES KIRA B,D101,HJ,,130.11,16372.3
6170,7/15/2020,7/15/2020,71520,82L-IMPORT PAYROLL-JACKSON CLAICE M,D108,HJ,,136.92,16235.38
6170,7/15/2020,7/15/2020,71520,82L-IMPORT PAYROLL-JANG DANIEL,D108,HJ,,130.11,16105.27
6170,7/15/2020,7/15/2020,71520,82L-IMPORT PAYROLL-LENEGHAN MARYELLEN B,D108,HJ,,130.11,15975.16
6170,7/31/2020,7/31/2020,73120,82L-IMPORT PAYROLL-LIPSCOMB STEPHEN,D108,HJ,,136.92,15838.24
6170,7/31/2020,7/31/2020,73120,82L-IMPORT PAYROLL-SILVER KELLY,D108,HJ,,136.92,15701.32
6170,7/31/2020,7/31/2020,73120,82L-PRPD-073120 -Import Payroll-ACEVEDO MONIVETT,D108,HJ,,240.7,15460.62
6170,7/31/2020,7/31/2020,73120,82L-PRPD-073120 -Import Payroll-AKLESTAD ISABEL,D108,HJ,,130.11,15330.51
6170,7/31/2020,7/31/2020,73120,82L-PRPD-073120 -Import Payroll-AUSTIN PERCY,D108,HJ,,130.11,15200.4
6170,7/31/2020,7/31/2020,73120,82L-PRPD-073120 -Import Payroll-BARTOLD DEANNA MARIE,D108,HJ,,130.11,15070.29
6170,7/31/2020,7/31/2020,73120,82L-PRPD-073120 -Import Payroll-BAUSH DANIEL,D108,HJ,,130.11,14940.18
6170,7/31/2020,7/31/2020,73120,82L-PRPD-073120 -Import Payroll-COOK CATHRYN ANNA,D108,HJ,,136.92,14803.26
6170,7/31/2020,7/31/2020,73120,82L-PRPD-073120 -Import Payroll-COOPER ASHLEE R,D108,HJ,,136.92,14666.34
6170,7/31/2020,7/31/2020,73120,82L-PRPD-073120 -Import Payroll-COVENEY ALLISON,D108,HJ,,136.92,14529.42
6170,7/31/2020,7/31/2020,73120,82L-PRPD-073120 -Import Payroll-DADA ARIKPO E,D108,HJ,,390.22,14139.2
6170,7/31/2020,7/31/2020,73120,82L-PRPD-073120 -Import Payroll-DETONE KYRA MAYA,D108,HJ,,130.11,14009.09
6170,7/31/2020,7/31/2020,73120,82L-PRPD-073120 -Import Payroll-DUPUIS CHRISTOPHER M,D108,HJ,,136.92,13872.17
6170,7/31/2020,7/31/2020,73120,82L-PRPD-073120 -Import Payroll-FEIGHERY JOHN,D108,HJ,,130.11,13742.06
6170,7/31/2020,7/31/2020,73120,82L-PRPD-073120 -Import Payroll-GRAVES KAMIESHIA,D108,HJ,,240.7,13501.36
6170,7/31/2020,7/31/2020,73120,82L-PRPD-073120 -Import Payroll-GRIFFIN ANDREW,D108,HJ,,136.92,13364.44
6170,7/31/2020,7/31/2020,73120,82L-PRPD-073120 -Import Payroll-GUADARRAMA-ALVAREZ URIEL A,D108,HJ,,130.11,13234.33
6170,7/31/2020,7/31/2020,73120,82L-PRPD-073120 -Import Payroll-GUTHRIE LESLIE,D108,HJ,,136.92,13097.41
6170,7/31/2020,7/31/2020,73120,82L-PRPD-073120 -Import Payroll-GUTIERREZ ANTONIO J,D108,HJ,,370.8,12726.61
6170,7/31/2020,7/31/2020,73120,82L-PRPD-073120 -Import Payroll-HALLINAN GABRIEL B,D108,HJ,,136.92,12589.69
6170,7/31/2020,7/31/2020,73120,82L-PRPD-073120 -Import Payroll-HOLMES JOREL ALEXANDER,D108,HJ,,136.92,12452.77
6170,7/31/2020,7/31/2020,73120,82L-PRPD-073120 -Import Payroll-JACKSON CLAICE M,D108,HJ,,136.92,12315.85
6170,7/31/2020,7/31/2020,73120,82L-PRPD-073120 -Import Payroll-JACKSON TASNIM F,D108,HJ,,136.92,12178.93
6170,7/31/2020,7/31/2020,73120,82L-PRPD-073120 -Import Payroll-JANG DANIEL,D108,HJ,,130.11,12048.82
6170,7/31/2020,7/31/2020,73120,82L-PRPD-073120 -Import Payroll-JORDAN TIFFANY T,D108,HJ,,240.7,11808.12
6170,7/31/2020,7/31/2020,73120,82L-PRPD-073120 -Import Payroll-LACEY DEQUITA,D108,HJ,,136.92,11671.2
6170,7/31/2020,7/31/2020,73120,82L-PRPD-073120 -Import Payroll-LENEGHAN MARYELLEN B,D108,HJ,,130.11,11541.09
6170,7/31/2020,7/31/2020,73120,82L-PRPD-073120 -Import Payroll-LI BELLA,D108,HJ,,130.11,11410.98
6170,7/31/2020,7/31/2020,73120,82L-PRPD-073120 -Import Payroll-LIPSCOMB STEPHEN,D108,HJ,,136.92,11274.06
6170,7/31/2020,7/31/2020,73120,82L-PRPD-073120 -Import Payroll-MASON ANGELA,D108,HJ,,240.7,11033.36
6170,7/31/2020,7/31/2020,73120,82L-PRPD-073120 -Import Payroll-MOSELEY ARIELLE,D108,HJ,,130.11,10903.25
6170,7/31/2020,7/31/2020,73120,82L-PRPD-073120 -Import Payroll-ONICA ANTHONY J,D108,HJ,,136.92,10766.33
6170,7/31/2020,7/31/2020,73120,82L-PRPD-073120 -Import Payroll-PARHAM-GANTT DENISE M,D108,HJ,,273.84,10492.49
6170,7/31/2020,7/31/2020,73120,82L-PRPD-073120 -Import Payroll-PEINADO ELIZABETH R,D108,HJ,,130.11,10362.38
6170,7/31/2020,7/31/2020,73120,82L-PRPD-073120 -Import Payroll-POLANCO ODALIS,D108,HJ,,130.11,10232.27
6170,7/31/2020,7/31/2020,73120,82L-PRPD-073120 -Import Payroll-PRAHIN NICOLE M,D108,HJ,,130.11,10102.16
6170,7/31/2020,7/31/2020,73120,82L-PRPD-073120 -Import Payroll-RANDOLPH ALEXANDER,D108,HJ,,130.11,9972.05
6170,7/31/2020,7/31/2020,73120,82L-PRPD-073120 -Import Payroll-SALIM YASSER,D108,HJ,,136.92,9835.13
6170,7/31/2020,7/31/2020,73120,82L-PRPD-073120 -Import Payroll-SEJOUR MAHALIAH,D108,HJ,,136.92,9698.21
6170,7/31/2020,7/31/2020,73120,82L-PRPD-073120 -Import Payroll-SILVER KELLY,D108,HJ,,136.92,9561.29
6170,7/31/2020,7/31/2020,73120,82L-PRPD-073120 -Import Payroll-SKALSKI CHRISTOPHER,D108,HJ,,130.11,9431.18
6170,7/31/2020,7/31/2020,73120,82L-PRPD-073120 -Import Payroll-TUMENJARGAL ENKHJIN,D108,HJ,,130.11,9301.07
6170,7/31/2020,7/31/2020,73120,82L-PRPD-073120 -Import Payroll-VILLEGAS EVELYN,D108,HJ,,390.22,8910.85
6170,7/31/2020,7/31/2020,73120,82L-PRPD-073120 -Import Payroll-WALLACE AMENA T,D108,HJ,,130.11,8780.74
6170,7/31/2020,7/31/2020,73120,82L-PRPD-073120 -Import Payroll-WOLF ANNA A,D108,HJ,,130.11,8650.63
6170,7/31/2020,7/31/2020,73120,To reverse 82L payroll 73120-To reverse 82L payroll of 73120 JE-21-0003,D108,HJ,130.11,,8780.74
6170,7/31/2020,7/31/2020,73120,To reverse 82L payroll 73120-To reverse 82L payroll of 73120 JE-21-0003,D108,HJ,130.11,,8910.85
6170,7/31/2020,7/31/2020,73120,To reverse 82L payroll 73120-To reverse 82L payroll of 73120 JE-21-0003,D108,HJ,130.11,,9040.96
6170,7/31/2020,7/31/2020,73120,To reverse 82L payroll 73120-To reverse 82L payroll of 73120 JE-21-0003,D108,HJ,130.11,,9171.07
6170,7/31/2020,7/31/2020,73120,To reverse 82L payroll 73120-To reverse 82L payroll of 73120 JE-21-0003,D108,HJ,130.11,,9301.18
6170,7/31/2020,7/31/2020,73120,To reverse 82L payroll 73120-To reverse 82L payroll of 73120 JE-21-0003,D108,HJ,130.11,,9431.29
6170,7/31/2020,7/31/2020,73120,To reverse 82L payroll 73120-To reverse 82L payroll of 73120 JE-21-0003,D108,HJ,130.11,,9561.4
6170,7/31/2020,7/31/2020,73120,To reverse 82L payroll 73120-To reverse 82L payroll of 73120 JE-21-0003,D108,HJ,130.11,,9691.51
6170,7/31/2020,7/31/2020,73120,To reverse 82L payroll 73120-To reverse 82L payroll of 73120 JE-21-0003,D108,HJ,130.11,,9821.62
6170,7/31/2020,7/31/2020,73120,To reverse 82L payroll 73120-To reverse 82L payroll of 73120 JE-21-0003,D108,HJ,130.11,,9951.73
6170,7/31/2020,7/31/2020,73120,To reverse 82L payroll 73120-To reverse 82L payroll of 73120 JE-21-0003,D108,HJ,130.11,,10081.84
6170,7/31/2020,7/31/2020,73120,To reverse 82L payroll 73120-To reverse 82L payroll of 73120 JE-21-0003,D108,HJ,130.11,,10211.95
6170,7/31/2020,7/31/2020,73120,To reverse 82L payroll 73120-To reverse 82L payroll of 73120 JE-21-0003,D108,HJ,130.11,,10342.06
6170,7/31/2020,7/31/2020,73120,To reverse 82L payroll 73120-To reverse 82L payroll of 73120 JE-21-0003,D108,HJ,130.11,,10472.17
6170,7/31/2020,7/31/2020,73120,To reverse 82L payroll 73120-To reverse 82L payroll of 73120 JE-21-0003,D108,HJ,130.11,,10602.28
6170,7/31/2020,7/31/2020,73120,To reverse 82L payroll 73120-To reverse 82L payroll of 73120 JE-21-0003,D108,HJ,130.11,,10732.39
6170,7/31/2020,7/31/2020,73120,To reverse 82L payroll 73120-To reverse 82L payroll of 73120 JE-21-0003,D108,HJ,130.11,,10862.5
6170,7/31/2020,7/31/2020,73120,To reverse 82L payroll 73120-To reverse 82L payroll of 73120 JE-21-0003,D108,HJ,130.11,,10992.61
6170,7/31/2020,7/31/2020,73120,To reverse 82L payroll 73120-To reverse 82L payroll of 73120 JE-21-0003,D108,HJ,130.11,,11122.72
6170,7/31/2020,7/31/2020,73120,To reverse 82L payroll 73120-To reverse 82L payroll of 73120 JE-21-0003,D108,HJ,136.92,,11259.64
6170,7/31/2020,7/31/2020,73120,To reverse 82L payroll 73120-To reverse 82L payroll of 73120 JE-21-0003,D108,HJ,136.92,,11396.56
6170,7/31/2020,7/31/2020,73120,To reverse 82L payroll 73120-To reverse 82L payroll of 73120 JE-21-0003,D108,HJ,136.92,,11533.48
6170,7/31/2020,7/31/2020,73120,To reverse 82L payroll 73120-To reverse 82L payroll of 73120 JE-21-0003,D108,HJ,136.92,,11670.4
6170,7/31/2020,7/31/2020,73120,To reverse 82L payroll 73120-To reverse 82L payroll of 73120 JE-21-0003,D108,HJ,136.92,,11807.32
6170,7/31/2020,7/31/2020,73120,To reverse 82L payroll 73120-To reverse 82L payroll of 73120 JE-21-0003,D108,HJ,136.92,,11944.24
6170,7/31/2020,7/31/2020,73120,To reverse 82L payroll 73120-To reverse 82L payroll of 73120 JE-21-0003,D108,HJ,136.92,,12081.16
6170,7/31/2020,7/31/2020,73120,To reverse 82L payroll 73120-To reverse 82L payroll of 73120 JE-21-0003,D108,HJ,136.92,,12218.08
6170,7/31/2020,7/31/2020,73120,To reverse 82L payroll 73120-To reverse 82L payroll of 73120 JE-21-0003,D108,HJ,136.92,,12355
6170,7/31/2020,7/31/2020,73120,To reverse 82L payroll 73120-To reverse 82L payroll of 73120 JE-21-0003,D108,HJ,136.92,,12491.92
6170,7/31/2020,7/31/2020,73120,To reverse 82L payroll 73120-To reverse 82L payroll of 73120 JE-21-0003,D108,HJ,136.92,,12628.84
6170,7/31/2020,7/31/2020,73120,To reverse 82L payroll 73120-To reverse 82L payroll of 73120 JE-21-0003,D108,HJ,136.92,,12765.76
6170,7/31/2020,7/31/2020,73120,To reverse 82L payroll 73120-To reverse 82L payroll of 73120 JE-21-0003,D108,HJ,136.92,,12902.68
6170,7/31/2020,7/31/2020,73120,To reverse 82L payroll 73120-To reverse 82L payroll of 73120 JE-21-0003,D108,HJ,136.92,,13039.6
6170,7/31/2020,7/31/2020,73120,To reverse 82L payroll 73120-To reverse 82L payroll of 73120 JE-21-0003,D108,HJ,136.92,,13176.52
6170,7/31/2020,7/31/2020,73120,To reverse 82L payroll 73120-To reverse 82L payroll of 73120 JE-21-0003,D108,HJ,136.92,,13313.44
6170,7/31/2020,7/31/2020,73120,To reverse 82L payroll 73120-To reverse 82L payroll of 73120 JE-21-0003,D108,HJ,240.7,,13554.14
6170,7/31/2020,7/31/2020,73120,To reverse 82L payroll 73120-To reverse 82L payroll of 73120 JE-21-0003,D108,HJ,240.7,,13794.84
6170,7/31/2020,7/31/2020,73120,To reverse 82L payroll 73120-To reverse 82L payroll of 73120 JE-21-0003,D108,HJ,240.7,,14035.54
6170,7/31/2020,7/31/2020,73120,To reverse 82L payroll 73120-To reverse 82L payroll of 73120 JE-21-0003,D108,HJ,240.7,,14276.24
6170,7/31/2020,7/31/2020,73120,To reverse 82L payroll 73120-To reverse 82L payroll of 73120 JE-21-0003,D108,HJ,273.84,,14550.08
6170,7/31/2020,7/31/2020,73120,To reverse 82L payroll 73120-To reverse 82L payroll of 73120 JE-21-0003,D108,HJ,370.8,,14920.88
6170,7/31/2020,7/31/2020,73120,To reverse 82L payroll 73120-To reverse 82L payroll of 73120 JE-21-0003,D108,HJ,390.22,,15311.1
6170,7/31/2020,7/31/2020,73120,To reverse 82L payroll 73120-To reverse 82L payroll of 73120 JE-21-0003,D108,HJ,390.22,,15701.32
6170,7/31/2020,7/31/2020,73120,82L-IMPORT PAYROLL-AUSTIN PERCY,D108,HJ,,130.11,15571.21
6170,7/31/2020,7/31/2020,73120,82L-IMPORT PAYROLL-BAUSH DANIEL,D108,HJ,,130.11,15441.1
6170,7/31/2020,7/31/2020,73120,82L-IMPORT PAYROLL-DADA ARIKPO E,D108,HJ,,390.22,15050.88
6170,7/31/2020,7/31/2020,73120,82L-IMPORT PAYROLL-GUTHRIE LESLIE,D108,HJ,,136.92,14913.96
6170,7/31/2020,7/31/2020,73120,82L-IMPORT PAYROLL-HOLMES JOREL ALEXANDER,D108,HJ,,136.92,14777.04
6170,7/31/2020,7/31/2020,73120,82L-IMPORT PAYROLL-JORDAN TIFFANY T,D108,HJ,,240.7,14536.34
6170,7/31/2020,7/31/2020,73120,82L-IMPORT PAYROLL-ONICA ANTHONY J,D108,HJ,,136.92,14399.42
6170,7/31/2020,7/31/2020,73120,82L-IMPORT PAYROLL-PRAHIN NICOLE M,D108,HJ,,130.11,14269.31
6170,7/31/2020,7/31/2020,73120,82L-IMPORT PAYROLL-SALIM YASSER,D108,HJ,,136.92,14132.39
6170,7/31/2020,7/31/2020,73120,82L-IMPORT PAYROLL-SEJOUR MAHALIAH,D108,HJ,,136.92,13995.47
6170,7/31/2020,7/31/2020,73120,82L-IMPORT PAYROLL-SKALSKI CHRISTOPHER,D108,HJ,,130.11,13865.36
6170,7/31/2020,7/31/2020,73120,82L-IMPORT PAYROLL-TUMENJARGAL ENKHJIN,D108,HJ,,130.11,13735.25
6170,7/31/2020,7/31/2020,73120,82L-IMPORT PAYROLL-VILLEGAS EVELYN,D108,HJ,,390.22,13345.03
6170,7/31/2020,7/31/2020,73120,82L-IMPORT PAYROLL-WOLF ANNA A,D108,HJ,,130.11,13214.92
6170,7/31/2020,7/31/2020,73120,82L-IMPORT PAYROLL-ACEVEDO MONIVETT,D107,HJ,,240.7,12974.22
6170,7/31/2020,7/31/2020,73120,82L-IMPORT PAYROLL-AKLESTAD ISABEL,D111,HJ,,130.11,12844.11
6170,7/31/2020,7/31/2020,73120,82L-IMPORT PAYROLL-COOK CATHRYN ANNA,D105,HJ,,136.92,12707.19
6170,7/31/2020,7/31/2020,73120,82L-IMPORT PAYROLL-COOPER ASHLEE R,D101,HJ,,136.92,12570.27
6170,7/31/2020,7/31/2020,73120,82L-IMPORT PAYROLL-DETONE KYRA MAYA,D102,HJ,,130.11,12440.16
6170,7/31/2020,7/31/2020,73120,82L-IMPORT PAYROLL-DUPUIS CHRISTOPHER M,D107,HJ,,136.92,12303.24
6170,7/31/2020,7/31/2020,73120,82L-IMPORT PAYROLL-GRAVES KAMIESHIA,D101,HJ,,240.7,12062.54
6170,7/31/2020,7/31/2020,73120,82L-IMPORT PAYROLL-GUADARRAMA-ALVAREZ URIEL A,D105,HJ,,130.11,11932.43
6170,7/31/2020,7/31/2020,73120,82L-IMPORT PAYROLL-GUTIERREZ ANTONIO J,D107,HJ,,370.8,11561.63
6170,7/31/2020,7/31/2020,73120,82L-IMPORT PAYROLL-LACEY DEQUITA,D107,HJ,,136.92,11424.71
6170,7/31/2020,7/31/2020,73120,82L-IMPORT PAYROLL-MASON ANGELA,D107,HJ,,240.7,11184.01
6170,7/31/2020,7/31/2020,73120,82L-IMPORT PAYROLL-PARHAM-GANTT DENISE M,D112,HJ,,273.84,10910.17
6170,7/31/2020,7/31/2020,73120,82L-IMPORT PAYROLL-PEINADO ELIZABETH R,D111,HJ,,130.11,10780.06
6170,7/31/2020,7/31/2020,73120,82L-IMPORT PAYROLL-POLANCO ODALIS,D103,HJ,,130.11,10649.95
6170,7/31/2020,7/31/2020,73120,82L-IMPORT PAYROLL-RANDOLPH ALEXANDER,D111,HJ,,130.11,10519.84
6170,7/31/2020,7/31/2020,73120,82L-IMPORT PAYROLL-WALLACE AMENA T,D104,HJ,,130.11,10389.73
6170,7/31/2020,7/31/2020,73120,82L-IMPORT PAYROLL-BARTOLD DEANNA MARIE,D108,HJ,,130.11,10259.62
6170,7/31/2020,7/31/2020,73120,82L-IMPORT PAYROLL-FEIGHERY JOHN,D108,HJ,,130.11,10129.51
6170,7/31/2020,7/31/2020,73120,82L-IMPORT PAYROLL-GRIFFIN ANDREW,D108,HJ,,136.92,9992.59
6170,7/31/2020,7/31/2020,73120,82L-IMPORT PAYROLL-HALLINAN GABRIEL B,D108,HJ,,136.92,9855.67
6170,7/31/2020,7/31/2020,73120,82L-IMPORT PAYROLL-JACKSON TASNIM F,D108,HJ,,136.92,9718.75
6170,7/31/2020,7/31/2020,73120,82L-IMPORT PAYROLL-LI BELLA,D108,HJ,,130.11,9588.64
6170,7/31/2020,7/31/2020,73120,82L-IMPORT PAYROLL-MOSELEY ARIELLE,D108,HJ,,130.11,9458.53
6170,7/31/2020,7/31/2020,73120,82L-IMPORT PAYROLL-COVENEY ALLISON,D108,HJ,,136.92,9321.61
6170,7/31/2020,7/31/2020,73120,82L-IMPORT PAYROLL-JACKSON CLAICE M,D108,HJ,,136.92,9184.69
6170,7/31/2020,7/31/2020,73120,82L-IMPORT PAYROLL-JANG DANIEL,D108,HJ,,130.11,9054.58
6170,7/31/2020,7/31/2020,73120,82L-IMPORT PAYROLL-LENEGHAN MARYELLEN B,D108,HJ,,130.11,8924.47
6170,8/3/2020,8/3/2020,BCBS -August,BCBS - August Health Insurance-August -BCBS Health Insurance,D108,HJ,11588.7,,20513.17
6170,8/3/2020,8/3/2020,BCBS -August,BCBS - August Health Insurance-August -BCBS Health Insurance,D107,HJ,8671.71,,29184.88
6170,8/3/2020,8/3/2020,BCBS -August,BCBS - August Health Insurance-August -BCBS Health Insurance,D108,HJ,4272.52,,33457.4
6170,8/3/2020,8/3/2020,BCBS -August,BCBS - August Health Insurance-August -BCBS Health Insurance,D108,HJ,2108.99,,35566.39
6170,8/7/2020,8/7/2020,20200807,Insurance payment from Sara and Julia-Insurance payment from Sara and Julia,D107,HJ,,1128.69,34437.7
6170,8/14/2020,8/14/2020,81420,82L-IMPORT PAYROLL-ALVAREZ-MORINE LISIS,D108,HJ,,136.92,34300.78
6170,8/14/2020,8/14/2020,81420,82L-IMPORT PAYROLL-BARTHELEMY RACHALIE,D108,HJ,,65,34235.78
6170,8/14/2020,8/14/2020,81420,82L-IMPORT PAYROLL-LI SEN YUAN,D108,HJ,,65,34170.78
6170,8/14/2020,8/14/2020,81420,82L-IMPORT PAYROLL-LIPSCOMB STEPHEN,D108,HJ,,136.92,34033.86
6170,8/14/2020,8/14/2020,81420,82L-IMPORT PAYROLL-MEJIA CARLOS MANUEL,D108,HJ,,65,33968.86
6170,8/14/2020,8/14/2020,81420,82L-IMPORT PAYROLL-SCOTT KIRK DONOVAN,D108,HJ,,65,33903.86
6170,8/14/2020,8/14/2020,81420,82L-IMPORT PAYROLL-SILVER KELLY,D108,HJ,,136.92,33766.94
6170,8/14/2020,8/14/2020,81420,82L-IMPORT PAYROLL-VALCIN SABRINA JEMIMAH,D108,HJ,,65,33701.94
6170,8/14/2020,8/14/2020,81420,82L-IMPORT PAYROLL-WILLIAMS MACK ANTHONY,D108,HJ,,65,33636.94
6170,8/14/2020,8/14/2020,81420,82L-IMPORT PAYROLL-AUSTIN PERCY,D108,HJ,,130.11,33506.83
6170,8/14/2020,8/14/2020,81420,82L-IMPORT PAYROLL-BAUSH DANIEL,D108,HJ,,130.11,33376.72
6170,8/14/2020,8/14/2020,81420,82L-IMPORT PAYROLL-DADA ARIKPO E,D108,HJ,,390.22,32986.5
6170,8/14/2020,8/14/2020,81420,82L-IMPORT PAYROLL-GUTHRIE LESLIE,D108,HJ,,136.92,32849.58
6170,8/14/2020,8/14/2020,81420,82L-IMPORT PAYROLL-HOLMES JOREL ALEXANDER,D108,HJ,,136.92,32712.66
6170,8/14/2020,8/14/2020,81420,82L-IMPORT PAYROLL-JORDAN TIFFANY T,D108,HJ,,240.7,32471.96
6170,8/14/2020,8/14/2020,81420,82L-IMPORT PAYROLL-ONICA ANTHONY J,D108,HJ,,136.92,32335.04
6170,8/14/2020,8/14/2020,81420,82L-IMPORT PAYROLL-PRAHIN NICOLE M,D108,HJ,,130.11,32204.93
6170,8/14/2020,8/14/2020,81420,82L-IMPORT PAYROLL-SALIM YASSER,D108,HJ,,136.92,32068.01
6170,8/14/2020,8/14/2020,81420,82L-IMPORT PAYROLL-SEJOUR MAHALIAH,D108,HJ,,136.92,31931.09
6170,8/14/2020,8/14/2020,81420,82L-IMPORT PAYROLL-SKALSKI CHRISTOPHER,D108,HJ,,130.11,31800.98
6170,8/14/2020,8/14/2020,81420,82L-IMPORT PAYROLL-TAM CW RYAN,D108,HJ,65,,31865.98
6170,8/14/2020,8/14/2020,81420,82L-IMPORT PAYROLL-TUMENJARGAL ENKHJIN,D108,HJ,,130.11,31735.87
6170,8/14/2020,8/14/2020,81420,82L-IMPORT PAYROLL-VILLEGAS EVELYN,D108,HJ,,390.22,31345.65
6170,8/14/2020,8/14/2020,81420,82L-IMPORT PAYROLL-WOLF ANNA A,D108,HJ,,130.11,31215.54
6170,8/14/2020,8/14/2020,81420,82L-IMPORT PAYROLL-ACEVEDO MONIVETT,D107,HJ,,240.7,30974.84
6170,8/14/2020,8/14/2020,81420,82L-IMPORT PAYROLL-AKLESTAD ISABEL,D111,HJ,,130.11,30844.73
6170,8/14/2020,8/14/2020,81420,82L-IMPORT PAYROLL-COOK CATHRYN ANNA,D105,HJ,,136.92,30707.81
6170,8/14/2020,8/14/2020,81420,82L-IMPORT PAYROLL-COOPER ASHLEE R,D101,HJ,,136.92,30570.89
6170,8/14/2020,8/14/2020,81420,82L-IMPORT PAYROLL-DETONE KYRA MAYA,D102,HJ,,130.11,30440.78
6170,8/14/2020,8/14/2020,81420,82L-IMPORT PAYROLL-DUPUIS CHRISTOPHER M,D107,HJ,,136.92,30303.86
6170,8/14/2020,8/14/2020,81420,82L-IMPORT PAYROLL-GRAVES KAMIESHIA,D101,HJ,,240.7,30063.16
6170,8/14/2020,8/14/2020,81420,82L-IMPORT PAYROLL-GUADARRAMA-ALVAREZ URIEL A,D105,HJ,,130.11,29933.05
6170,8/14/2020,8/14/2020,81420,82L-IMPORT PAYROLL-GUTIERREZ ANTONIO J,D107,HJ,,370.8,29562.25
6170,8/14/2020,8/14/2020,81420,82L-IMPORT PAYROLL-LACEY DEQUITA,D107,HJ,,136.92,29425.33
6170,8/14/2020,8/14/2020,81420,82L-IMPORT PAYROLL-MASON ANGELA,D107,HJ,,240.7,29184.63
6170,8/14/2020,8/14/2020,81420,82L-IMPORT PAYROLL-PARHAM-GANTT DENISE M,D112,HJ,,273.84,28910.79
6170,8/14/2020,8/14/2020,81420,82L-IMPORT PAYROLL-PEINADO ELIZABETH R,D111,HJ,,130.11,28780.68
6170,8/14/2020,8/14/2020,81420,82L-IMPORT PAYROLL-POLANCO ODALIS,D103,HJ,,130.11,28650.57
6170,8/14/2020,8/14/2020,81420,82L-IMPORT PAYROLL-RANDOLPH ALEXANDER,D111,HJ,,130.11,28520.46
6170,8/14/2020,8/14/2020,81420,82L-IMPORT PAYROLL-WALLACE AMENA T,D104,HJ,,130.11,28390.35
6170,8/14/2020,8/14/2020,81420,82L-IMPORT PAYROLL-WEINSTOCK EMILY,D101,HJ,,136.92,28253.43
6170,8/14/2020,8/14/2020,81420,82L-IMPORT PAYROLL-BARTOLD DEANNA MARIE,D108,HJ,,130.11,28123.32
6170,8/14/2020,8/14/2020,81420,82L-IMPORT PAYROLL-FEIGHERY JOHN,D108,HJ,,130.11,27993.21
6170,8/14/2020,8/14/2020,81420,82L-IMPORT PAYROLL-GRIFFIN ANDREW,D108,HJ,,136.92,27856.29
6170,8/14/2020,8/14/2020,81420,82L-IMPORT PAYROLL-HALLINAN GABRIEL B,D108,HJ,,136.92,27719.37
6170,8/14/2020,8/14/2020,81420,82L-IMPORT PAYROLL-JACKSON TASNIM F,D108,HJ,,136.92,27582.45
6170,8/14/2020,8/14/2020,81420,82L-IMPORT PAYROLL-LI BELLA,D108,HJ,,130.11,27452.34
6170,8/14/2020,8/14/2020,81420,82L-IMPORT PAYROLL-MOSELEY ARIELLE,D108,HJ,,130.11,27322.23
6170,8/14/2020,8/14/2020,81420,82L-IMPORT PAYROLL-COVENEY ALLISON,D108,HJ,,136.92,27185.31
6170,8/14/2020,8/14/2020,81420,82L-IMPORT PAYROLL-JACKSON CLAICE M,D108,HJ,,136.92,27048.39
6170,8/14/2020,8/14/2020,81420,82L-IMPORT PAYROLL-JANG DANIEL,D108,HJ,,130.11,26918.28
6170,8/14/2020,8/14/2020,81420,82L-IMPORT PAYROLL-LENEGHAN MARYELLEN B,D108,HJ,,130.11,26788.17
6170,8/14/2020,8/14/2020,82L-PRPD-081520,82L-PRPD-081520 -IMPORT PAYROLL-AUSTIN PERCY,D108,HJ,,130.11,26658.06
6170,8/14/2020,8/14/2020,82L-PRPD-081520,82L-PRPD-081520 -IMPORT PAYROLL-BAUSH DANIEL,D108,HJ,,130.11,26527.95
6170,8/14/2020,8/14/2020,82L-PRPD-081520,82L-PRPD-081520 -IMPORT PAYROLL-DADA ARIKPO E,D108,HJ,,390.22,26137.73
6170,8/14/2020,8/14/2020,82L-PRPD-081520,82L-PRPD-081520 -IMPORT PAYROLL-GUTHRIE LESLIE,D108,HJ,,136.92,26000.81
6170,8/14/2020,8/14/2020,82L-PRPD-081520,82L-PRPD-081520 -IMPORT PAYROLL-HOLMES JOREL ALEXANDER,D108,HJ,,136.92,25863.89
6170,8/14/2020,8/14/2020,82L-PRPD-081520,82L-PRPD-081520 -IMPORT PAYROLL-JORDAN TIFFANY T,D108,HJ,,240.7,25623.19
6170,8/14/2020,8/14/2020,82L-PRPD-081520,82L-PRPD-081520 -IMPORT PAYROLL-ONICA ANTHONY J,D108,HJ,,136.92,25486.27
6170,8/14/2020,8/14/2020,82L-PRPD-081520,82L-PRPD-081520 -IMPORT PAYROLL-PRAHIN NICOLE M,D108,HJ,,130.11,25356.16
6170,8/14/2020,8/14/2020,82L-PRPD-081520,82L-PRPD-081520 -IMPORT PAYROLL-SALIM YASSER,D108,HJ,,136.92,25219.24
6170,8/14/2020,8/14/2020,82L-PRPD-081520,82L-PRPD-081520 -IMPORT PAYROLL-SEJOUR MAHALIAH,D108,HJ,,136.92,25082.32
6170,8/14/2020,8/14/2020,82L-PRPD-081520,82L-PRPD-081520 -IMPORT PAYROLL-SKALSKI CHRISTOPHER,D108,HJ,,130.11,24952.21
6170,8/14/2020,8/14/2020,82L-PRPD-081520,82L-PRPD-081520 -IMPORT PAYROLL-TAM CW RYAN,D105,HJ,65,,25017.21
6170,8/14/2020,8/14/2020,82L-PRPD-081520,82L-PRPD-081520 -IMPORT PAYROLL-TUMENJARGAL ENKHJIN,D108,HJ,,130.11,24887.1
6170,8/14/2020,8/14/2020,82L-PRPD-081520,82L-PRPD-081520 -IMPORT PAYROLL-VILLEGAS EVELYN,D108,HJ,,390.22,24496.88
6170,8/14/2020,8/14/2020,82L-PRPD-081520,82L-PRPD-081520 -IMPORT PAYROLL-WALLACE AMENA T,D108,HJ,,130.11,24366.77
6170,8/14/2020,8/14/2020,82L-PRPD-081520,82L-PRPD-081520 -IMPORT PAYROLL-WOLF ANNA A,D108,HJ,,130.11,24236.66
6170,8/14/2020,8/14/2020,82L-PRPD-081520,82L-PRPD-081520 -IMPORT PAYROLL-ACEVEDO MONIVETT,D103,HJ,,240.7,23995.96
6170,8/14/2020,8/14/2020,82L-PRPD-081520,82L-PRPD-081520 -IMPORT PAYROLL-AKLESTAD ISABEL,D107,HJ,,130.11,23865.85
6170,8/14/2020,8/14/2020,82L-PRPD-081520,82L-PRPD-081520 -IMPORT PAYROLL-ALVAREZ-MORINE LISIS,D107,HJ,,136.92,23728.93
6170,8/14/2020,8/14/2020,82L-PRPD-081520,82L-PRPD-081520 -IMPORT PAYROLL-BARTHELEMY RACHALIE,D107,HJ,,65,23663.93
6170,8/14/2020,8/14/2020,82L-PRPD-081520,82L-PRPD-081520 -IMPORT PAYROLL-COOK CATHRYN ANNA,D107,HJ,,136.92,23527.01
6170,8/14/2020,8/14/2020,82L-PRPD-081520,82L-PRPD-081520 -IMPORT PAYROLL-COOPER ASHLEE R,D107,HJ,,136.92,23390.09
6170,8/14/2020,8/14/2020,82L-PRPD-081520,82L-PRPD-081520 -IMPORT PAYROLL-DETONE KYRA MAYA,D102,HJ,,130.11,23259.98
6170,8/14/2020,8/14/2020,82L-PRPD-081520,82L-PRPD-081520 -IMPORT PAYROLL-DUPUIS CHRISTOPHER M,D107,HJ,,136.92,23123.06
6170,8/14/2020,8/14/2020,82L-PRPD-081520,82L-PRPD-081520 -IMPORT PAYROLL-GRAVES KAMIESHIA,D107,HJ,,240.7,22882.36
6170,8/14/2020,8/14/2020,82L-PRPD-081520,82L-PRPD-081520 -IMPORT PAYROLL-GUADARRAMA-ALVAREZ URIEL A,D107,HJ,,130.11,22752.25
6170,8/14/2020,8/14/2020,82L-PRPD-081520,82L-PRPD-081520 -IMPORT PAYROLL-GUTIERREZ ANTONIO J,D102,HJ,,370.8,22381.45
6170,8/14/2020,8/14/2020,82L-PRPD-081520,82L-PRPD-081520 -IMPORT PAYROLL-LACEY DEQUITA,D108,HJ,,136.92,22244.53
6170,8/14/2020,8/14/2020,82L-PRPD-081520,82L-PRPD-081520 -IMPORT PAYROLL-LI SEN YUAN,D107,HJ,,65,22179.53
6170,8/14/2020,8/14/2020,82L-PRPD-081520,82L-PRPD-081520 -IMPORT PAYROLL-LIPSCOMB STEPHEN,D107,HJ,,136.92,22042.61
6170,8/14/2020,8/14/2020,82L-PRPD-081520,82L-PRPD-081520 -IMPORT PAYROLL-MASON ANGELA,D107,HJ,,240.7,21801.91
6170,8/14/2020,8/14/2020,82L-PRPD-081520,82L-PRPD-081520 -IMPORT PAYROLL-MEJIA CARLOS MANUEL,D107,HJ,,65,21736.91
6170,8/14/2020,8/14/2020,82L-PRPD-081520,82L-PRPD-081520 -IMPORT PAYROLL-PARHAM-GANTT DENISE M,D108,HJ,,273.84,21463.07
6170,8/14/2020,8/14/2020,82L-PRPD-081520,82L-PRPD-081520 -IMPORT PAYROLL-PEINADO ELIZABETH R,D107,HJ,,130.11,21332.96
6170,8/14/2020,8/14/2020,82L-PRPD-081520,82L-PRPD-081520 -IMPORT PAYROLL-POLANCO ODALIS,D103,HJ,,130.11,21202.85
6170,8/14/2020,8/14/2020,82L-PRPD-081520,82L-PRPD-081520 -IMPORT PAYROLL-RANDOLPH ALEXANDER,D107,HJ,,130.11,21072.74
6170,8/14/2020,8/14/2020,82L-PRPD-081520,82L-PRPD-081520 -IMPORT PAYROLL-SCOTT KIRK DONOVAN,D107,HJ,,65,21007.74
6170,8/14/2020,8/14/2020,82L-PRPD-081520,82L-PRPD-081520 -IMPORT PAYROLL-SILVER KELLY,D107,HJ,,136.92,20870.82
6170,8/14/2020,8/14/2020,82L-PRPD-081520,82L-PRPD-081520 -IMPORT PAYROLL-VALCIN SABRINA JEMIMAH,D107,HJ,,65,20805.82
6170,8/14/2020,8/14/2020,82L-PRPD-081520,82L-PRPD-081520 -IMPORT PAYROLL-WEINSTOCK EMILY,D107,HJ,,136.92,20668.9
6170,8/14/2020,8/14/2020,82L-PRPD-081520,82L-PRPD-081520 -IMPORT PAYROLL-WILLIAMS MACK ANTHONY,D107,HJ,,65,20603.9
6170,8/14/2020,8/14/2020,82L-PRPD-081520,82L-PRPD-081520 -IMPORT PAYROLL-BARTOLD DEANNA MARIE,D108,HJ,,130.11,20473.79
6170,8/14/2020,8/14/2020,82L-PRPD-081520,82L-PRPD-081520 -IMPORT PAYROLL-FEIGHERY JOHN,D108,HJ,,130.11,20343.68
6170,8/14/2020,8/14/2020,82L-PRPD-081520,82L-PRPD-081520 -IMPORT PAYROLL-GRIFFIN ANDREW,D108,HJ,,136.92,20206.76
6170,8/14/2020,8/14/2020,82L-PRPD-081520,82L-PRPD-081520 -IMPORT PAYROLL-HALLINAN GABRIEL B,D108,HJ,,136.92,20069.84
6170,8/14/2020,8/14/2020,82L-PRPD-081520,82L-PRPD-081520 -IMPORT PAYROLL-JACKSON TASNIM F,D108,HJ,,136.92,19932.92
6170,8/14/2020,8/14/2020,82L-PRPD-081520,82L-PRPD-081520 -IMPORT PAYROLL-LI BELLA,D108,HJ,,130.11,19802.81
6170,8/14/2020,8/14/2020,82L-PRPD-081520,82L-PRPD-081520 -IMPORT PAYROLL-MOSELEY ARIELLE,D108,HJ,,130.11,19672.7
6170,8/14/2020,8/14/2020,82L-PRPD-081520,82L-PRPD-081520 -IMPORT PAYROLL-COVENEY ALLISON,D108,HJ,,136.92,19535.78
6170,8/14/2020,8/14/2020,82L-PRPD-081520,82L-PRPD-081520 -IMPORT PAYROLL-JACKSON CLAICE M,D108,HJ,,136.92,19398.86
6170,8/14/2020,8/14/2020,82L-PRPD-081520,82L-PRPD-081520 -IMPORT PAYROLL-JANG DANIEL,D108,HJ,,130.11,19268.75
6170,8/14/2020,8/14/2020,82L-PRPD-081520,82L-PRPD-081520 -IMPORT PAYROLL-LENEGHAN MARYELLEN B,D108,HJ,,130.11,19138.64
6170,8/15/2020,8/15/2020,82L-PRPD-081520,To reverse 82L payroll 0815 JE-21-0020-To reverse 82L Payroll of 8152020,D105,HJ,,65,19073.64
6170,8/15/2020,8/15/2020,82L-PRPD-081520,To reverse 82L payroll 0815 JE-21-0020-To reverse 82L Payroll of 8152020,D108,HJ,130.11,,19203.75
6170,8/15/2020,8/15/2020,82L-PRPD-081520,To reverse 82L payroll 0815 JE-21-0020-To reverse 82L Payroll of 8152020,D108,HJ,130.11,,19333.86
6170,8/15/2020,8/15/2020,82L-PRPD-081520,To reverse 82L payroll 0815 JE-21-0020-To reverse 82L Payroll of 8152020,D108,HJ,130.11,,19463.97
6170,8/15/2020,8/15/2020,82L-PRPD-081520,To reverse 82L payroll 0815 JE-21-0020-To reverse 82L Payroll of 8152020,D108,HJ,130.11,,19594.08
6170,8/15/2020,8/15/2020,82L-PRPD-081520,To reverse 82L payroll 0815 JE-21-0020-To reverse 82L Payroll of 8152020,D108,HJ,130.11,,19724.19
6170,8/15/2020,8/15/2020,82L-PRPD-081520,To reverse 82L payroll 0815 JE-21-0020-To reverse 82L Payroll of 8152020,D108,HJ,130.11,,19854.3
6170,8/15/2020,8/15/2020,82L-PRPD-081520,To reverse 82L payroll 0815 JE-21-0020-To reverse 82L Payroll of 8152020,D108,HJ,130.11,,19984.41
6170,8/15/2020,8/15/2020,82L-PRPD-081520,To reverse 82L payroll 0815 JE-21-0020-To reverse 82L Payroll of 8152020,D108,HJ,136.92,,20121.33
6170,8/15/2020,8/15/2020,82L-PRPD-081520,To reverse 82L payroll 0815 JE-21-0020-To reverse 82L Payroll of 8152020,D108,HJ,136.92,,20258.25
6170,8/15/2020,8/15/2020,82L-PRPD-081520,To reverse 82L payroll 0815 JE-21-0020-To reverse 82L Payroll of 8152020,D108,HJ,136.92,,20395.17
6170,8/15/2020,8/15/2020,82L-PRPD-081520,To reverse 82L payroll 0815 JE-21-0020-To reverse 82L Payroll of 8152020,D108,HJ,136.92,,20532.09
6170,8/15/2020,8/15/2020,82L-PRPD-081520,To reverse 82L payroll 0815 JE-21-0020-To reverse 82L Payroll of 8152020,D108,HJ,136.92,,20669.01
6170,8/15/2020,8/15/2020,82L-PRPD-081520,To reverse 82L payroll 0815 JE-21-0020-To reverse 82L Payroll of 8152020,D108,HJ,240.7,,20909.71
6170,8/15/2020,8/15/2020,82L-PRPD-081520,To reverse 82L payroll 0815 JE-21-0020-To reverse 82L Payroll of 8152020,D108,HJ,390.22,,21299.93
6170,8/15/2020,8/15/2020,82L-PRPD-081520,To reverse 82L payroll 0815 JE-21-0020-To reverse 82L Payroll of 8152020,D108,HJ,390.22,,21690.15
6170,8/15/2020,8/15/2020,82L-PRPD-081520,To reverse 82L payroll 0815 JE-21-0020-To reverse 82L Payroll of 8152020,D102,HJ,130.11,,21820.26
6170,8/15/2020,8/15/2020,82L-PRPD-081520,To reverse 82L payroll 0815 JE-21-0020-To reverse 82L Payroll of 8152020,D102,HJ,370.8,,22191.06
6170,8/15/2020,8/15/2020,82L-PRPD-081520,To reverse 82L payroll 0815 JE-21-0020-To reverse 82L Payroll of 8152020,D103,HJ,130.11,,22321.17
6170,8/15/2020,8/15/2020,82L-PRPD-081520,To reverse 82L payroll 0815 JE-21-0020-To reverse 82L Payroll of 8152020,D103,HJ,240.7,,22561.87
6170,8/15/2020,8/15/2020,82L-PRPD-081520,To reverse 82L payroll 0815 JE-21-0020-To reverse 82L Payroll of 8152020,D107,HJ,65,,22626.87
6170,8/15/2020,8/15/2020,82L-PRPD-081520,To reverse 82L payroll 0815 JE-21-0020-To reverse 82L Payroll of 8152020,D107,HJ,65,,22691.87
6170,8/15/2020,8/15/2020,82L-PRPD-081520,To reverse 82L payroll 0815 JE-21-0020-To reverse 82L Payroll of 8152020,D107,HJ,65,,22756.87
6170,8/15/2020,8/15/2020,82L-PRPD-081520,To reverse 82L payroll 0815 JE-21-0020-To reverse 82L Payroll of 8152020,D107,HJ,65,,22821.87
6170,8/15/2020,8/15/2020,82L-PRPD-081520,To reverse 82L payroll 0815 JE-21-0020-To reverse 82L Payroll of 8152020,D107,HJ,65,,22886.87
6170,8/15/2020,8/15/2020,82L-PRPD-081520,To reverse 82L payroll 0815 JE-21-0020-To reverse 82L Payroll of 8152020,D107,HJ,65,,22951.87
6170,8/15/2020,8/15/2020,82L-PRPD-081520,To reverse 82L payroll 0815 JE-21-0020-To reverse 82L Payroll of 8152020,D107,HJ,130.11,,23081.98
6170,8/15/2020,8/15/2020,82L-PRPD-081520,To reverse 82L payroll 0815 JE-21-0020-To reverse 82L Payroll of 8152020,D107,HJ,130.11,,23212.09
6170,8/15/2020,8/15/2020,82L-PRPD-081520,To reverse 82L payroll 0815 JE-21-0020-To reverse 82L Payroll of 8152020,D107,HJ,130.11,,23342.2
6170,8/15/2020,8/15/2020,82L-PRPD-081520,To reverse 82L payroll 0815 JE-21-0020-To reverse 82L Payroll of 8152020,D107,HJ,130.11,,23472.31
6170,8/15/2020,8/15/2020,82L-PRPD-081520,To reverse 82L payroll 0815 JE-21-0020-To reverse 82L Payroll of 8152020,D107,HJ,136.92,,23609.23
6170,8/15/2020,8/15/2020,82L-PRPD-081520,To reverse 82L payroll 0815 JE-21-0020-To reverse 82L Payroll of 8152020,D107,HJ,136.92,,23746.15
6170,8/15/2020,8/15/2020,82L-PRPD-081520,To reverse 82L payroll 0815 JE-21-0020-To reverse 82L Payroll of 8152020,D107,HJ,136.92,,23883.07
6170,8/15/2020,8/15/2020,82L-PRPD-081520,To reverse 82L payroll 0815 JE-21-0020-To reverse 82L Payroll of 8152020,D107,HJ,136.92,,24019.99
6170,8/15/2020,8/15/2020,82L-PRPD-081520,To reverse 82L payroll 0815 JE-21-0020-To reverse 82L Payroll of 8152020,D107,HJ,136.92,,24156.91
6170,8/15/2020,8/15/2020,82L-PRPD-081520,To reverse 82L payroll 0815 JE-21-0020-To reverse 82L Payroll of 8152020,D107,HJ,136.92,,24293.83
6170,8/15/2020,8/15/2020,82L-PRPD-081520,To reverse 82L payroll 0815 JE-21-0020-To reverse 82L Payroll of 8152020,D107,HJ,136.92,,24430.75
6170,8/15/2020,8/15/2020,82L-PRPD-081520,To reverse 82L payroll 0815 JE-21-0020-To reverse 82L Payroll of 8152020,D107,HJ,240.7,,24671.45
6170,8/15/2020,8/15/2020,82L-PRPD-081520,To reverse 82L payroll 0815 JE-21-0020-To reverse 82L Payroll of 8152020,D107,HJ,240.7,,24912.15
6170,8/15/2020,8/15/2020,82L-PRPD-081520,To reverse 82L payroll 0815 JE-21-0020-To reverse 82L Payroll of 8152020,D108,HJ,136.92,,25049.07
6170,8/15/2020,8/15/2020,82L-PRPD-081520,To reverse 82L payroll 0815 JE-21-0020-To reverse 82L Payroll of 8152020,D108,HJ,273.84,,25322.91
6170,8/15/2020,8/15/2020,82L-PRPD-081520,To reverse 82L payroll 0815 JE-21-0020-To reverse 82L Payroll of 8152020,D108,HJ,130.11,,25453.02
6170,8/15/2020,8/15/2020,82L-PRPD-081520,To reverse 82L payroll 0815 JE-21-0020-To reverse 82L Payroll of 8152020,D108,HJ,130.11,,25583.13
6170,8/15/2020,8/15/2020,82L-PRPD-081520,To reverse 82L payroll 0815 JE-21-0020-To reverse 82L Payroll of 8152020,D108,HJ,130.11,,25713.24
6170,8/15/2020,8/15/2020,82L-PRPD-081520,To reverse 82L payroll 0815 JE-21-0020-To reverse 82L Payroll of 8152020,D108,HJ,130.11,,25843.35
6170,8/15/2020,8/15/2020,82L-PRPD-081520,To reverse 82L payroll 0815 JE-21-0020-To reverse 82L Payroll of 8152020,D108,HJ,136.92,,25980.27
6170,8/15/2020,8/15/2020,82L-PRPD-081520,To reverse 82L payroll 0815 JE-21-0020-To reverse 82L Payroll of 8152020,D108,HJ,136.92,,26117.19
6170,8/15/2020,8/15/2020,82L-PRPD-081520,To reverse 82L payroll 0815 JE-21-0020-To reverse 82L Payroll of 8152020,D108,HJ,136.92,,26254.11
6170,8/15/2020,8/15/2020,82L-PRPD-081520,To reverse 82L payroll 0815 JE-21-0020-To reverse 82L Payroll of 8152020,D108,HJ,130.11,,26384.22
6170,8/15/2020,8/15/2020,82L-PRPD-081520,To reverse 82L payroll 0815 JE-21-0020-To reverse 82L Payroll of 8152020,D108,HJ,130.11,,26514.33
6170,8/15/2020,8/15/2020,82L-PRPD-081520,To reverse 82L payroll 0815 JE-21-0020-To reverse 82L Payroll of 8152020,D108,HJ,136.92,,26651.25
6170,8/15/2020,8/15/2020,82L-PRPD-081520,To reverse 82L payroll 0815 JE-21-0020-To reverse 82L Payroll of 8152020,D108,HJ,136.92,,26788.17
6170,8/31/2020,8/31/2020,83120,82L-IMPORT PAYROLL-ALVAREZ-MORINE LISIS,D108,HJ,,136.92,26651.25
6170,8/31/2020,8/31/2020,83120,82L-IMPORT PAYROLL-BARTHELEMY RACHALIE,D108,HJ,,65,26586.25
6170,8/31/2020,8/31/2020,83120,82L-IMPORT PAYROLL-BASHAM WILLIAM EDWARD,D108,HJ,,65,26521.25
6170,8/31/2020,8/31/2020,83120,82L-IMPORT PAYROLL-BROWN ISAAC,D108,HJ,,65,26456.25
6170,8/31/2020,8/31/2020,83120,82L-IMPORT PAYROLL-KHAN HUDA,D108,HJ,,65,26391.25
6170,8/31/2020,8/31/2020,83120,82L-IMPORT PAYROLL-KOPSHEVER MELISSA,D108,HJ,,240.7,26150.55
6170,8/31/2020,8/31/2020,83120,82L-IMPORT PAYROLL-LI SEN YUAN,D108,HJ,,65,26085.55
6170,8/31/2020,8/31/2020,83120,82L-IMPORT PAYROLL-LIPSCOMB STEPHEN,D108,HJ,,136.92,25948.63
6170,8/31/2020,8/31/2020,83120,82L-IMPORT PAYROLL-MEJIA CARLOS MANUEL,D108,HJ,,65,25883.63
6170,8/31/2020,8/31/2020,83120,82L-IMPORT PAYROLL-SCOTT KIRK DONOVAN,D108,HJ,,65,25818.63
6170,8/31/2020,8/31/2020,83120,82L-IMPORT PAYROLL-SILVER KELLY,D108,HJ,,136.92,25681.71
6170,8/31/2020,8/31/2020,83120,82L-IMPORT PAYROLL-VALCIN SABRINA JEMIMAH,D108,HJ,,65,25616.71
6170,8/31/2020,8/31/2020,83120,82L-IMPORT PAYROLL-AUSTIN PERCY,D108,HJ,,130.11,25486.6
6170,8/31/2020,8/31/2020,83120,82L-IMPORT PAYROLL-BAUSH DANIEL,D108,HJ,,130.11,25356.49
6170,8/31/2020,8/31/2020,83120,82L-IMPORT PAYROLL-DADA ARIKPO E,D108,HJ,,390.22,24966.27
6170,8/31/2020,8/31/2020,83120,82L-IMPORT PAYROLL-GUTHRIE LESLIE,D108,HJ,,136.92,24829.35
6170,8/31/2020,8/31/2020,83120,82L-IMPORT PAYROLL-HOLMES JOREL ALEXANDER,D108,HJ,,136.92,24692.43
6170,8/31/2020,8/31/2020,83120,82L-IMPORT PAYROLL-JORDAN TIFFANY T,D108,HJ,,240.7,24451.73
6170,8/31/2020,8/31/2020,83120,82L-IMPORT PAYROLL-ONICA ANTHONY J,D108,HJ,,136.92,24314.81
6170,8/31/2020,8/31/2020,83120,82L-IMPORT PAYROLL-PRAHIN NICOLE M,D108,HJ,,130.11,24184.7
6170,8/31/2020,8/31/2020,83120,82L-IMPORT PAYROLL-SALIM YASSER,D108,HJ,,136.92,24047.78
6170,8/31/2020,8/31/2020,83120,82L-IMPORT PAYROLL-SEJOUR MAHALIAH,D108,HJ,,136.92,23910.86
6170,8/31/2020,8/31/2020,83120,82L-IMPORT PAYROLL-SKALSKI CHRISTOPHER,D108,HJ,,130.11,23780.75
6170,8/31/2020,8/31/2020,83120,82L-IMPORT PAYROLL-TUMENJARGAL ENKHJIN,D108,HJ,,130.11,23650.64
6170,8/31/2020,8/31/2020,83120,82L-IMPORT PAYROLL-VILLEGAS EVELYN,D108,HJ,,390.22,23260.42
6170,8/31/2020,8/31/2020,83120,82L-IMPORT PAYROLL-WOLF ANNA A,D108,HJ,,130.11,23130.31
6170,8/31/2020,8/31/2020,83120,82L-IMPORT PAYROLL-ACEVEDO MONIVETT,D107,HJ,,240.7,22889.61
6170,8/31/2020,8/31/2020,83120,82L-IMPORT PAYROLL-AKLESTAD ISABEL,D111,HJ,,130.11,22759.5
6170,8/31/2020,8/31/2020,83120,82L-IMPORT PAYROLL-COOK CATHRYN ANNA,D105,HJ,,136.92,22622.58
6170,8/31/2020,8/31/2020,83120,82L-IMPORT PAYROLL-COOPER ASHLEE R,D101,HJ,,136.92,22485.66
6170,8/31/2020,8/31/2020,83120,82L-IMPORT PAYROLL-DETONE KYRA MAYA,D102,HJ,,130.11,22355.55
6170,8/31/2020,8/31/2020,83120,82L-IMPORT PAYROLL-DUPUIS CHRISTOPHER M,D107,HJ,,136.92,22218.63
6170,8/31/2020,8/31/2020,83120,82L-IMPORT PAYROLL-GRAVES KAMIESHIA,D101,HJ,,240.7,21977.93
6170,8/31/2020,8/31/2020,83120,82L-IMPORT PAYROLL-GUADARRAMA-ALVAREZ URIEL A,D105,HJ,,130.11,21847.82
6170,8/31/2020,8/31/2020,83120,82L-IMPORT PAYROLL-GUTIERREZ ANTONIO J,D107,HJ,,370.8,21477.02
6170,8/31/2020,8/31/2020,83120,82L-IMPORT PAYROLL-LACEY DEQUITA,D107,HJ,,136.92,21340.1
6170,8/31/2020,8/31/2020,83120,82L-IMPORT PAYROLL-MASON ANGELA,D107,HJ,,240.7,21099.4
6170,8/31/2020,8/31/2020,83120,82L-IMPORT PAYROLL-PARHAM-GANTT DENISE M,D112,HJ,,273.84,20825.56
6170,8/31/2020,8/31/2020,83120,82L-IMPORT PAYROLL-PEINADO ELIZABETH R,D111,HJ,,130.11,20695.45
6170,8/31/2020,8/31/2020,83120,82L-IMPORT PAYROLL-POLANCO ODALIS,D103,HJ,,130.11,20565.34
6170,8/31/2020,8/31/2020,83120,82L-IMPORT PAYROLL-QUINTAS JASHIVE,D105,HJ,,136.92,20428.42
6170,8/31/2020,8/31/2020,83120,82L-IMPORT PAYROLL-RANDOLPH ALEXANDER,D111,HJ,,130.11,20298.31
6170,8/31/2020,8/31/2020,83120,82L-IMPORT PAYROLL-WALLACE AMENA,D104,HJ,,130.11,20168.2
6170,8/31/2020,8/31/2020,83120,82L-IMPORT PAYROLL-WEINSTOCK EMILY,D101,HJ,,136.92,20031.28
6170,8/31/2020,8/31/2020,83120,82L-IMPORT PAYROLL-BARTOLD DEANNA MARIE,D108,HJ,,130.11,19901.17
6170,8/31/2020,8/31/2020,83120,82L-IMPORT PAYROLL-DEFREITAS NOEL,D108,HJ,,65,19836.17
6170,8/31/2020,8/31/2020,83120,82L-IMPORT PAYROLL-FEIGHERY JOHN,D108,HJ,,130.11,19706.06
6170,8/31/2020,8/31/2020,83120,82L-IMPORT PAYROLL-GRIFFIN ANDREW,D108,HJ,,136.92,19569.14
6170,8/31/2020,8/31/2020,83120,82L-IMPORT PAYROLL-GROSS EMILY,D108,HJ,,136.92,19432.22
6170,8/31/2020,8/31/2020,83120,82L-IMPORT PAYROLL-HALLINAN GABRIEL B,D108,HJ,,136.92,19295.3
6170,8/31/2020,8/31/2020,83120,82L-IMPORT PAYROLL-HAMERSLY WILLIAM,D108,HJ,,130.11,19165.19
6170,8/31/2020,8/31/2020,83120,82L-IMPORT PAYROLL-JACKSON TASNIM F,D108,HJ,,136.92,19028.27
6170,8/31/2020,8/31/2020,83120,82L-IMPORT PAYROLL-LI BELLA,D108,HJ,,130.11,18898.16
6170,8/31/2020,8/31/2020,83120,82L-IMPORT PAYROLL-SCHWETTMANN CLAIRE,D108,HJ,,65,18833.16
6170,8/31/2020,8/31/2020,83120,82L-IMPORT PAYROLL-SOBELMAN JUSTIN,D108,HJ,,109.44,18723.72
6170,8/31/2020,8/31/2020,83120,82L-IMPORT PAYROLL-TERRENCE-SMITH ZI,D108,HJ,,65,18658.72
6170,8/31/2020,8/31/2020,83120,82L-IMPORT PAYROLL-COVENEY ALLISON,D108,HJ,,136.92,18521.8
6170,8/31/2020,8/31/2020,83120,82L-IMPORT PAYROLL-JACKSON CLAICE M,D108,HJ,,136.92,18384.88
6170,8/31/2020,8/31/2020,83120,82L-IMPORT PAYROLL-JANG DANIEL,D108,HJ,,130.11,18254.77
6170,8/31/2020,8/31/2020,83120,82L-IMPORT PAYROLL-LENEGHAN MARYELLEN,D108,HJ,,130.11,18124.66
6170,8/31/2020,8/31/2020,82L-PRPD-083120,82L-PRPD-083120 -IMPORT PAYROLL-AUSTIN PERCY,D108,HJ,,130.11,17994.55
6170,8/31/2020,8/31/2020,82L-PRPD-083120,82L-PRPD-083120 -IMPORT PAYROLL-BAUSH DANIEL,D108,HJ,,130.11,17864.44
6170,8/31/2020,8/31/2020,82L-PRPD-083120,82L-PRPD-083120 -IMPORT PAYROLL-DADA ARIKPO E,D108,HJ,,390.22,17474.22
6170,8/31/2020,8/31/2020,82L-PRPD-083120,82L-PRPD-083120 -IMPORT PAYROLL-GUTHRIE LESLIE,D108,HJ,,136.92,17337.3
6170,8/31/2020,8/31/2020,82L-PRPD-083120,82L-PRPD-083120 -IMPORT PAYROLL-HOLMES JOREL ALEXANDER,D108,HJ,,136.92,17200.38
6170,8/31/2020,8/31/2020,82L-PRPD-083120,82L-PRPD-083120 -IMPORT PAYROLL-JORDAN TIFFANY T,D108,HJ,,240.7,16959.68
6170,8/31/2020,8/31/2020,82L-PRPD-083120,82L-PRPD-083120 -IMPORT PAYROLL-ONICA ANTHONY J,D108,HJ,,136.92,16822.76
6170,8/31/2020,8/31/2020,82L-PRPD-083120,82L-PRPD-083120 -IMPORT PAYROLL-PRAHIN NICOLE M,D108,HJ,,130.11,16692.65
6170,8/31/2020,8/31/2020,82L-PRPD-083120,82L-PRPD-083120 -IMPORT PAYROLL-SALIM YASSER,D108,HJ,,136.92,16555.73
6170,8/31/2020,8/31/2020,82L-PRPD-083120,82L-PRPD-083120 -IMPORT PAYROLL-SEJOUR MAHALIAH,D108,HJ,,136.92,16418.81
6170,8/31/2020,8/31/2020,82L-PRPD-083120,82L-PRPD-083120 -IMPORT PAYROLL-SKALSKI CHRISTOPHER,D108,HJ,,130.11,16288.7
6170,8/31/2020,8/31/2020,82L-PRPD-083120,82L-PRPD-083120 -IMPORT PAYROLL-TAM CW RYAN,D105,HJ,65,,16353.7
6170,8/31/2020,8/31/2020,82L-PRPD-083120,82L-PRPD-083120 -IMPORT PAYROLL-TUMENJARGAL ENKHJIN,D108,HJ,,130.11,16223.59
6170,8/31/2020,8/31/2020,82L-PRPD-083120,82L-PRPD-083120 -IMPORT PAYROLL-VILLEGAS EVELYN,D108,HJ,,390.22,15833.37
6170,8/31/2020,8/31/2020,82L-PRPD-083120,82L-PRPD-083120 -IMPORT PAYROLL-WALLACE AMENA T,D108,HJ,,130.11,15703.26
6170,8/31/2020,8/31/2020,82L-PRPD-083120,82L-PRPD-083120 -IMPORT PAYROLL-WOLF ANNA A,D108,HJ,,130.11,15573.15
6170,8/31/2020,8/31/2020,82L-PRPD-083120,Reverse 82L payroll of 83120 JE-21-0021-IMPORT PAYROLL,D105,HJ,,65,15508.15
6170,8/31/2020,8/31/2020,82L-PRPD-083120,Reverse 82L payroll of 83120 JE-21-0021-IMPORT PAYROLL,D108,HJ,130.11,,15638.26
6170,8/31/2020,8/31/2020,82L-PRPD-083120,Reverse 82L payroll of 83120 JE-21-0021-IMPORT PAYROLL,D108,HJ,130.11,,15768.37
6170,8/31/2020,8/31/2020,82L-PRPD-083120,Reverse 82L payroll of 83120 JE-21-0021-IMPORT PAYROLL,D108,HJ,130.11,,15898.48
6170,8/31/2020,8/31/2020,82L-PRPD-083120,Reverse 82L payroll of 83120 JE-21-0021-IMPORT PAYROLL,D108,HJ,130.11,,16028.59
6170,8/31/2020,8/31/2020,82L-PRPD-083120,Reverse 82L payroll of 83120 JE-21-0021-IMPORT PAYROLL,D108,HJ,130.11,,16158.7
6170,8/31/2020,8/31/2020,82L-PRPD-083120,Reverse 82L payroll of 83120 JE-21-0021-IMPORT PAYROLL,D108,HJ,130.11,,16288.81
6170,8/31/2020,8/31/2020,82L-PRPD-083120,Reverse 82L payroll of 83120 JE-21-0021-IMPORT PAYROLL,D108,HJ,130.11,,16418.92
6170,8/31/2020,8/31/2020,82L-PRPD-083120,Reverse 82L payroll of 83120 JE-21-0021-IMPORT PAYROLL,D108,HJ,136.92,,16555.84
6170,8/31/2020,8/31/2020,82L-PRPD-083120,Reverse 82L payroll of 83120 JE-21-0021-IMPORT PAYROLL,D108,HJ,136.92,,16692.76
6170,8/31/2020,8/31/2020,82L-PRPD-083120,Reverse 82L payroll of 83120 JE-21-0021-IMPORT PAYROLL,D108,HJ,136.92,,16829.68
6170,8/31/2020,8/31/2020,82L-PRPD-083120,Reverse 82L payroll of 83120 JE-21-0021-IMPORT PAYROLL,D108,HJ,136.92,,16966.6
6170,8/31/2020,8/31/2020,82L-PRPD-083120,Reverse 82L payroll of 83120 JE-21-0021-IMPORT PAYROLL,D108,HJ,136.92,,17103.52
6170,8/31/2020,8/31/2020,82L-PRPD-083120,Reverse 82L payroll of 83120 JE-21-0021-IMPORT PAYROLL,D108,HJ,240.7,,17344.22
6170,8/31/2020,8/31/2020,82L-PRPD-083120,Reverse 82L payroll of 83120 JE-21-0021-IMPORT PAYROLL,D108,HJ,390.22,,17734.44
6170,8/31/2020,8/31/2020,82L-PRPD-083120,Reverse 82L payroll of 83120 JE-21-0021-IMPORT PAYROLL,D108,HJ,390.22,,18124.66
6170,8/31/2020,8/31/2020,82L-PRPD-083120,82L-PRPD-083120 -IMPORT PAYROLL-ACEVEDO MONIVETT,D103,HJ,,240.7,17883.96
6170,8/31/2020,8/31/2020,82L-PRPD-083120,82L-PRPD-083120 -IMPORT PAYROLL-AKLESTAD ISABEL,D107,HJ,,130.11,17753.85
6170,8/31/2020,8/31/2020,82L-PRPD-083120,82L-PRPD-083120 -IMPORT PAYROLL-ALVAREZ-MORINE LISIS,D107,HJ,,136.92,17616.93
6170,8/31/2020,8/31/2020,82L-PRPD-083120,82L-PRPD-083120 -IMPORT PAYROLL-BARTHELEMY RACHALIE,D107,HJ,,65,17551.93
6170,8/31/2020,8/31/2020,82L-PRPD-083120,82L-PRPD-083120 -IMPORT PAYROLL-COOK CATHRYN ANNA,D107,HJ,,136.92,17415.01
6170,8/31/2020,8/31/2020,82L-PRPD-083120,82L-PRPD-083120 -IMPORT PAYROLL-COOPER ASHLEE R,D107,HJ,,136.92,17278.09
6170,8/31/2020,8/31/2020,82L-PRPD-083120,82L-PRPD-083120 -IMPORT PAYROLL-DETONE KYRA MAYA,D102,HJ,,130.11,17147.98
6170,8/31/2020,8/31/2020,82L-PRPD-083120,82L-PRPD-083120 -IMPORT PAYROLL-DUPUIS CHRISTOPHER M,D107,HJ,,136.92,17011.06
6170,8/31/2020,8/31/2020,82L-PRPD-083120,82L-PRPD-083120 -IMPORT PAYROLL-GRAVES KAMIESHIA,D107,HJ,,240.7,16770.36
6170,8/31/2020,8/31/2020,82L-PRPD-083120,82L-PRPD-083120 -IMPORT PAYROLL-GUADARRAMA-ALVAREZ URIEL A,D107,HJ,,130.11,16640.25
6170,8/31/2020,8/31/2020,82L-PRPD-083120,82L-PRPD-083120 -IMPORT PAYROLL-GUTIERREZ ANTONIO J,D102,HJ,,370.8,16269.45
6170,8/31/2020,8/31/2020,82L-PRPD-083120,82L-PRPD-083120 -IMPORT PAYROLL-LACEY DEQUITA,D108,HJ,,136.92,16132.53
6170,8/31/2020,8/31/2020,82L-PRPD-083120,82L-PRPD-083120 -IMPORT PAYROLL-LI SEN YUAN,D107,HJ,,65,16067.53
6170,8/31/2020,8/31/2020,82L-PRPD-083120,82L-PRPD-083120 -IMPORT PAYROLL-LIPSCOMB STEPHEN,D107,HJ,,136.92,15930.61
6170,8/31/2020,8/31/2020,82L-PRPD-083120,82L-PRPD-083120 -IMPORT PAYROLL-MASON ANGELA,D107,HJ,,240.7,15689.91
6170,8/31/2020,8/31/2020,82L-PRPD-083120,82L-PRPD-083120 -IMPORT PAYROLL-MEJIA CARLOS MANUEL,D107,HJ,,65,15624.91
6170,8/31/2020,8/31/2020,82L-PRPD-083120,82L-PRPD-083120 -IMPORT PAYROLL-PARHAM-GANTT DENISE M,D108,HJ,,273.84,15351.07
6170,8/31/2020,8/31/2020,82L-PRPD-083120,82L-PRPD-083120 -IMPORT PAYROLL-PEINADO ELIZABETH R,D107,HJ,,130.11,15220.96
6170,8/31/2020,8/31/2020,82L-PRPD-083120,82L-PRPD-083120 -IMPORT PAYROLL-POLANCO ODALIS,D103,HJ,,130.11,15090.85
6170,8/31/2020,8/31/2020,82L-PRPD-083120,82L-PRPD-083120 -IMPORT PAYROLL-RANDOLPH ALEXANDER,D107,HJ,,130.11,14960.74
6170,8/31/2020,8/31/2020,82L-PRPD-083120,82L-PRPD-083120 -IMPORT PAYROLL-SCOTT KIRK DONOVAN,D107,HJ,,65,14895.74
6170,8/31/2020,8/31/2020,82L-PRPD-083120,82L-PRPD-083120 -IMPORT PAYROLL-SILVER KELLY,D107,HJ,,136.92,14758.82
6170,8/31/2020,8/31/2020,82L-PRPD-083120,82L-PRPD-083120 -IMPORT PAYROLL-VALCIN SABRINA JEMIMAH,D107,HJ,,65,14693.82
6170,8/31/2020,8/31/2020,82L-PRPD-083120,82L-PRPD-083120 -IMPORT PAYROLL-WEINSTOCK EMILY,D107,HJ,,136.92,14556.9
6170,8/31/2020,8/31/2020,82L-PRPD-083120,82L-PRPD-083120 -IMPORT PAYROLL-WILLIAMS MACK ANTHONY,D107,HJ,,65,14491.9
6170,8/31/2020,8/31/2020,82L-PRPD-083120,Reverse 82L payroll of 83120 JE-21-0021-IMPORT PAYROLL,D102,HJ,130.11,,14622.01
6170,8/31/2020,8/31/2020,82L-PRPD-083120,Reverse 82L payroll of 83120 JE-21-0021-IMPORT PAYROLL,D102,HJ,370.8,,14992.81
6170,8/31/2020,8/31/2020,82L-PRPD-083120,Reverse 82L payroll of 83120 JE-21-0021-IMPORT PAYROLL,D103,HJ,130.11,,15122.92
6170,8/31/2020,8/31/2020,82L-PRPD-083120,Reverse 82L payroll of 83120 JE-21-0021-IMPORT PAYROLL,D103,HJ,240.7,,15363.62
6170,8/31/2020,8/31/2020,82L-PRPD-083120,Reverse 82L payroll of 83120 JE-21-0021-IMPORT PAYROLL,D107,HJ,65,,15428.62
6170,8/31/2020,8/31/2020,82L-PRPD-083120,Reverse 82L payroll of 83120 JE-21-0021-IMPORT PAYROLL,D107,HJ,65,,15493.62
6170,8/31/2020,8/31/2020,82L-PRPD-083120,Reverse 82L payroll of 83120 JE-21-0021-IMPORT PAYROLL,D107,HJ,65,,15558.62
6170,8/31/2020,8/31/2020,82L-PRPD-083120,Reverse 82L payroll of 83120 JE-21-0021-IMPORT PAYROLL,D107,HJ,65,,15623.62
6170,8/31/2020,8/31/2020,82L-PRPD-083120,Reverse 82L payroll of 83120 JE-21-0021-IMPORT PAYROLL,D107,HJ,65,,15688.62
6170,8/31/2020,8/31/2020,82L-PRPD-083120,Reverse 82L payroll of 83120 JE-21-0021-IMPORT PAYROLL,D107,HJ,65,,15753.62
6170,8/31/2020,8/31/2020,82L-PRPD-083120,Reverse 82L payroll of 83120 JE-21-0021-IMPORT PAYROLL,D107,HJ,130.11,,15883.73
6170,8/31/2020,8/31/2020,82L-PRPD-083120,Reverse 82L payroll of 83120 JE-21-0021-IMPORT PAYROLL,D107,HJ,130.11,,16013.84
6170,8/31/2020,8/31/2020,82L-PRPD-083120,Reverse 82L payroll of 83120 JE-21-0021-IMPORT PAYROLL,D107,HJ,130.11,,16143.95
6170,8/31/2020,8/31/2020,82L-PRPD-083120,Reverse 82L payroll of 83120 JE-21-0021-IMPORT PAYROLL,D107,HJ,130.11,,16274.06
6170,8/31/2020,8/31/2020,82L-PRPD-083120,Reverse 82L payroll of 83120 JE-21-0021-IMPORT PAYROLL,D107,HJ,136.92,,16410.98
6170,8/31/2020,8/31/2020,82L-PRPD-083120,Reverse 82L payroll of 83120 JE-21-0021-IMPORT PAYROLL,D107,HJ,136.92,,16547.9
6170,8/31/2020,8/31/2020,82L-PRPD-083120,Reverse 82L payroll of 83120 JE-21-0021-IMPORT PAYROLL,D107,HJ,136.92,,16684.82
6170,8/31/2020,8/31/2020,82L-PRPD-083120,Reverse 82L payroll of 83120 JE-21-0021-IMPORT PAYROLL,D107,HJ,136.92,,16821.74
6170,8/31/2020,8/31/2020,82L-PRPD-083120,Reverse 82L payroll of 83120 JE-21-0021-IMPORT PAYROLL,D107,HJ,136.92,,16958.66
6170,8/31/2020,8/31/2020,82L-PRPD-083120,Reverse 82L payroll of 83120 JE-21-0021-IMPORT PAYROLL,D107,HJ,136.92,,17095.58
6170,8/31/2020,8/31/2020,82L-PRPD-083120,Reverse 82L payroll of 83120 JE-21-0021-IMPORT PAYROLL,D107,HJ,136.92,,17232.5
6170,8/31/2020,8/31/2020,82L-PRPD-083120,Reverse 82L payroll of 83120 JE-21-0021-IMPORT PAYROLL,D107,HJ,240.7,,17473.2
6170,8/31/2020,8/31/2020,82L-PRPD-083120,Reverse 82L payroll of 83120 JE-21-0021-IMPORT PAYROLL,D107,HJ,240.7,,17713.9
6170,8/31/2020,8/31/2020,82L-PRPD-083120,Reverse 82L payroll of 83120 JE-21-0021-IMPORT PAYROLL,D108,HJ,136.92,,17850.82
6170,8/31/2020,8/31/2020,82L-PRPD-083120,Reverse 82L payroll of 83120 JE-21-0021-IMPORT PAYROLL,D108,HJ,273.84,,18124.66
6170,8/31/2020,8/31/2020,82L-PRPD-083120,82L-PRPD-083120 -IMPORT PAYROLL-BARTOLD DEANNA MARIE,D108,HJ,,130.11,17994.55
6170,8/31/2020,8/31/2020,82L-PRPD-083120,82L-PRPD-083120 -IMPORT PAYROLL-FEIGHERY JOHN,D108,HJ,,130.11,17864.44
6170,8/31/2020,8/31/2020,82L-PRPD-083120,82L-PRPD-083120 -IMPORT PAYROLL-GRIFFIN ANDREW,D108,HJ,,136.92,17727.52
6170,8/31/2020,8/31/2020,82L-PRPD-083120,82L-PRPD-083120 -IMPORT PAYROLL-HALLINAN GABRIEL B,D108,HJ,,136.92,17590.6
6170,8/31/2020,8/31/2020,82L-PRPD-083120,82L-PRPD-083120 -IMPORT PAYROLL-JACKSON TASNIM F,D108,HJ,,136.92,17453.68
6170,8/31/2020,8/31/2020,82L-PRPD-083120,82L-PRPD-083120 -IMPORT PAYROLL-LI BELLA,D108,HJ,,130.11,17323.57
6170,8/31/2020,8/31/2020,82L-PRPD-083120,82L-PRPD-083120 -IMPORT PAYROLL-MOSELEY ARIELLE,D108,HJ,,130.11,17193.46
6170,8/31/2020,8/31/2020,82L-PRPD-083120,Reverse 82L payroll of 83120 JE-21-0021-IMPORT PAYROLL,D108,HJ,130.11,,17323.57
6170,8/31/2020,8/31/2020,82L-PRPD-083120,Reverse 82L payroll of 83120 JE-21-0021-IMPORT PAYROLL,D108,HJ,130.11,,17453.68
6170,8/31/2020,8/31/2020,82L-PRPD-083120,Reverse 82L payroll of 83120 JE-21-0021-IMPORT PAYROLL,D108,HJ,130.11,,17583.79
6170,8/31/2020,8/31/2020,82L-PRPD-083120,Reverse 82L payroll of 83120 JE-21-0021-IMPORT PAYROLL,D108,HJ,130.11,,17713.9
6170,8/31/2020,8/31/2020,82L-PRPD-083120,Reverse 82L payroll of 83120 JE-21-0021-IMPORT PAYROLL,D108,HJ,136.92,,17850.82
6170,8/31/2020,8/31/2020,82L-PRPD-083120,Reverse 82L payroll of 83120 JE-21-0021-IMPORT PAYROLL,D108,HJ,136.92,,17987.74
6170,8/31/2020,8/31/2020,82L-PRPD-083120,Reverse 82L payroll of 83120 JE-21-0021-IMPORT PAYROLL,D108,HJ,136.92,,18124.66
6170,8/31/2020,8/31/2020,82L-PRPD-083120,82L-PRPD-083120 -IMPORT PAYROLL-COVENEY ALLISON,D108,HJ,,136.92,17987.74
6170,8/31/2020,8/31/2020,82L-PRPD-083120,82L-PRPD-083120 -IMPORT PAYROLL-JACKSON CLAICE M,D108,HJ,,136.92,17850.82
6170,8/31/2020,8/31/2020,82L-PRPD-083120,82L-PRPD-083120 -IMPORT PAYROLL-JANG DANIEL,D108,HJ,,130.11,17720.71
6170,8/31/2020,8/31/2020,82L-PRPD-083120,82L-PRPD-083120 -IMPORT PAYROLL-LENEGHAN MARYELLEN B,D108,HJ,,130.11,17590.6
6170,8/31/2020,8/31/2020,82L-PRPD-083120,Reverse 82L payroll of 83120 JE-21-0021-IMPORT PAYROLL,D108,HJ,130.11,,17720.71
6170,8/31/2020,8/31/2020,82L-PRPD-083120,Reverse 82L payroll of 83120 JE-21-0021-IMPORT PAYROLL,D108,HJ,130.11,,17850.82
6170,8/31/2020,8/31/2020,82L-PRPD-083120,Reverse 82L payroll of 83120 JE-21-0021-IMPORT PAYROLL,D108,HJ,136.92,,17987.74
6170,8/31/2020,8/31/2020,82L-PRPD-083120,Reverse 82L payroll of 83120 JE-21-0021-IMPORT PAYROLL,D108,HJ,136.92,,18124.66
6170,9/1/2020,9/1/2020,BCBS,BCBS - September 82L Invoices-BCBS - September 82L Invoices,D108,HJ,3580.26,,21704.92
6170,9/1/2020,9/1/2020,BCBS,BCBS - September 82L Invoices-BCBS - September 82L Invoices,D108,HJ,13204.53,,34909.45
6170,9/1/2020,9/1/2020,BCBS,BCBS - September 82L Invoices-BCBS - September 82L Invoices,D107,HJ,9714.34,,44623.79
6170,9/1/2020,9/1/2020,BCBS,BCBS - September 82L Invoices-BCBS - September 82L Invoices,D108,HJ,,0.46,44623.33
6170,9/1/2020,9/1/2020,BCBS,BCBS - September 82L Invoices-BCBS - September 82L Invoices,D108,HJ,8009.16,,52632.49
6170,9/10/2020,9/10/2020,BCBS,BCBS - September LUX Invoices-BCBS - September LUX Invoices,D108,HJ,1561.29,,54193.78
6170,9/10/2020,9/10/2020,TASC,Insurance credit for from Sara & Julia-Insurance credit for Sara & Julia,D107,HJ,,1128.69,53065.09
6170,9/15/2020,9/15/2020,91520,82L-IMPORT PAYROLL-ALVAREZ-MORINE LISIS,D108,HJ,,136.92,52928.17
6170,9/15/2020,9/15/2020,91520,82L-IMPORT PAYROLL-BARTHELEMY RACHALIE,D108,HJ,,65,52863.17
6170,9/15/2020,9/15/2020,91520,82L-IMPORT PAYROLL-BASHAM WILLIAM EDWARD,D108,HJ,,65,52798.17
6170,9/15/2020,9/15/2020,91520,82L-IMPORT PAYROLL-BROWN ISAAC,D108,HJ,,65,52733.17
6170,9/15/2020,9/15/2020,91520,82L-IMPORT PAYROLL-IKUNIKA FUNMILAYO,D108,HJ,,240.7,52492.47
6170,9/15/2020,9/15/2020,91520,82L-IMPORT PAYROLL-KHAN HUDA,D108,HJ,,65,52427.47
6170,9/15/2020,9/15/2020,91520,82L-IMPORT PAYROLL-KOPSHEVER MELISSA,D108,HJ,,240.7,52186.77
6170,9/15/2020,9/15/2020,91520,82L-IMPORT PAYROLL-LI SEN,D108,HJ,,65,52121.77
6170,9/15/2020,9/15/2020,91520,82L-IMPORT PAYROLL-LIPSCOMB STEPHEN,D108,HJ,,136.92,51984.85
6170,9/15/2020,9/15/2020,91520,82L-IMPORT PAYROLL-MEJIA CARLOS MANUEL,D108,HJ,,65,51919.85
6170,9/15/2020,9/15/2020,91520,82L-IMPORT PAYROLL-SCOTT KIRK,D108,HJ,,65,51854.85
6170,9/15/2020,9/15/2020,91520,82L-IMPORT PAYROLL-SILVER KELLY,D108,HJ,,136.92,51717.93
6170,9/15/2020,9/15/2020,91520,82L-IMPORT PAYROLL-STEIN KYLE,D108,HJ,,136.92,51581.01
6170,9/15/2020,9/15/2020,91520,82L-IMPORT PAYROLL-VALCIN SABRINA JEMIMAH,D108,HJ,,65,51516.01
6170,9/15/2020,9/15/2020,91520,82L-IMPORT PAYROLL-AUSTIN PERCY,D108,HJ,,130.11,51385.9
6170,9/15/2020,9/15/2020,91520,82L-IMPORT PAYROLL-DADA ARIKPO,D108,HJ,,390.22,50995.68
6170,9/15/2020,9/15/2020,91520,82L-IMPORT PAYROLL-GUTHRIE LESLIE,D108,HJ,,136.92,50858.76
6170,9/15/2020,9/15/2020,91520,82L-IMPORT PAYROLL-HOLMES JOREL ALEXANDER,D108,HJ,,136.92,50721.84
6170,9/15/2020,9/15/2020,91520,82L-IMPORT PAYROLL-JORDAN TIFFANY T,D108,HJ,,240.7,50481.14
6170,9/15/2020,9/15/2020,91520,82L-IMPORT PAYROLL-ONICA ANTHONY J,D108,HJ,,136.92,50344.22
6170,9/15/2020,9/15/2020,91520,82L-IMPORT PAYROLL-PRAHIN NICOLE M,D108,HJ,,130.11,50214.11
6170,9/15/2020,9/15/2020,91520,82L-IMPORT PAYROLL-SALIM YASSER,D108,HJ,,136.92,50077.19
6170,9/15/2020,9/15/2020,91520,82L-IMPORT PAYROLL-SEJOUR MAHALIAH,D108,HJ,,136.92,49940.27
6170,9/15/2020,9/15/2020,91520,82L-IMPORT PAYROLL-SKALSKI CHRISTOPHER,D108,HJ,,130.11,49810.16
6170,9/15/2020,9/15/2020,91520,82L-IMPORT PAYROLL-TUMENJARGAL ENKHJIN,D108,HJ,,130.11,49680.05
6170,9/15/2020,9/15/2020,91520,82L-IMPORT PAYROLL-VILLEGAS EVELYN,D108,HJ,,390.22,49289.83
6170,9/15/2020,9/15/2020,91520,82L-IMPORT PAYROLL-WOLF ANNA A,D108,HJ,,130.11,49159.72
6170,9/15/2020,9/15/2020,91520,82L-IMPORT PAYROLL-ACEVEDO MONIVETT,D107,HJ,,240.7,48919.02
6170,9/15/2020,9/15/2020,91520,82L-IMPORT PAYROLL-AKLESTAD ISABEL,D111,HJ,,130.11,48788.91
6170,9/15/2020,9/15/2020,91520,82L-IMPORT PAYROLL-BIBB TIFFANI,D104,HJ,,370.8,48418.11
6170,9/15/2020,9/15/2020,91520,82L-IMPORT PAYROLL-COOK CATHRYN ANNA,D105,HJ,,136.92,48281.19
6170,9/15/2020,9/15/2020,91520,82L-IMPORT PAYROLL-COOPER ASHLEE R,D101,HJ,,136.92,48144.27
6170,9/15/2020,9/15/2020,91520,82L-IMPORT PAYROLL-DETONE KYRA MAYA,D102,HJ,,130.11,48014.16
6170,9/15/2020,9/15/2020,91520,82L-IMPORT PAYROLL-DUPUIS CHRISTOPHER M,D107,HJ,,136.92,47877.24
6170,9/15/2020,9/15/2020,91520,82L-IMPORT PAYROLL-GUADARRAMA-ALVAREZ URIEL A,D105,HJ,,130.11,47747.13
6170,9/15/2020,9/15/2020,91520,82L-IMPORT PAYROLL-GUTIERREZ ANTONIO J,D107,HJ,,370.8,47376.33
6170,9/15/2020,9/15/2020,91520,82L-IMPORT PAYROLL-LACEY DEQUITA,D104,HJ,,136.92,47239.41
6170,9/15/2020,9/15/2020,91520,82L-IMPORT PAYROLL-MASON ANGELA,D107,HJ,,240.7,46998.71
6170,9/15/2020,9/15/2020,91520,82L-IMPORT PAYROLL-PARHAM-GANTT DENISE M,D112,HJ,,273.84,46724.87
6170,9/15/2020,9/15/2020,91520,82L-IMPORT PAYROLL-PEINADO ELIZABETH R,D111,HJ,,130.11,46594.76
6170,9/15/2020,9/15/2020,91520,82L-IMPORT PAYROLL-POLANCO ODALIS,D103,HJ,,130.11,46464.65
6170,9/15/2020,9/15/2020,91520,82L-IMPORT PAYROLL-QUINTAS JASHIVE,D105,HJ,,136.92,46327.73
6170,9/15/2020,9/15/2020,91520,82L-IMPORT PAYROLL-RANDOLPH ALEXANDER,D111,HJ,,130.11,46197.62
6170,9/15/2020,9/15/2020,91520,82L-IMPORT PAYROLL-RUBI PERLA,D101,HJ,,136.92,46060.7
6170,9/15/2020,9/15/2020,91520,82L-IMPORT PAYROLL-WALLACE AMENA,D104,HJ,,130.11,45930.59
6170,9/15/2020,9/15/2020,91520,82L-IMPORT PAYROLL-WEINSTOCK EMILY,D101,HJ,,136.92,45793.67
6170,9/15/2020,9/15/2020,91520,82L-IMPORT PAYROLL-BARTOLD DEANNA MARIE,D108,HJ,,130.11,45663.56
6170,9/15/2020,9/15/2020,91520,82L-IMPORT PAYROLL-BELLOT GENESIS,D108,HJ,,136.92,45526.64
6170,9/15/2020,9/15/2020,91520,82L-IMPORT PAYROLL-FEIGHERY JOHN,D108,HJ,,130.11,45396.53
6170,9/15/2020,9/15/2020,91520,82L-IMPORT PAYROLL-GREENE BROOKE,D108,HJ,,65,45331.53
6170,9/15/2020,9/15/2020,91520,82L-IMPORT PAYROLL-GRIFFIN ANDREW,D108,HJ,,136.92,45194.61
6170,9/15/2020,9/15/2020,91520,82L-IMPORT PAYROLL-GROSS EMILY,D108,HJ,,136.92,45057.69
6170,9/15/2020,9/15/2020,91520,82L-IMPORT PAYROLL-HALLINAN GABRIEL B,D108,HJ,,136.92,44920.77
6170,9/15/2020,9/15/2020,91520,82L-IMPORT PAYROLL-HAMERSLY WILLIAM,D108,HJ,,130.11,44790.66
6170,9/15/2020,9/15/2020,91520,82L-IMPORT PAYROLL-JACKSON TASNIM,D108,HJ,,136.92,44653.74
6170,9/15/2020,9/15/2020,91520,82L-IMPORT PAYROLL-LI BELLA,D108,HJ,,130.11,44523.63
6170,9/15/2020,9/15/2020,91520,82L-IMPORT PAYROLL-OPUH NDIDI,D108,HJ,,390.22,44133.41
6170,9/15/2020,9/15/2020,91520,82L-IMPORT PAYROLL-SCHWETTMANN CLAIRE,D108,HJ,,65,44068.41
6170,9/15/2020,9/15/2020,91520,82L-IMPORT PAYROLL-SOBELMAN JUSTIN,D108,HJ,,109.44,43958.97
6170,9/15/2020,9/15/2020,91520,82L-IMPORT PAYROLL-TERRENCE-SMITH ZIHIR UNIQUE,D108,HJ,,65,43893.97
6170,9/15/2020,9/15/2020,91520,82L-IMPORT PAYROLL-COVENEY ALLISON,D108,HJ,,136.92,43757.05
6170,9/15/2020,9/15/2020,91520,82L-IMPORT PAYROLL-JACKSON CLAICE,D108,HJ,,136.92,43620.13
6170,9/15/2020,9/15/2020,91520,82L-IMPORT PAYROLL-JANG DANIEL,D108,HJ,,130.11,43490.02
6170,9/15/2020,9/15/2020,91520,82L-IMPORT PAYROLL-LENEGHAN MARYELLEN,D108,HJ,,130.11,43359.91
6170,9/30/2020,9/30/2020,93020,82L-IMPORT PAYROLL-ALVAREZ-MORINE LISIS,D108,HJ,,136.92,43222.99
6170,9/30/2020,9/30/2020,93020,82L-IMPORT PAYROLL-BARTHELEMY RACHALIE,D108,HJ,,65,43157.99
6170,9/30/2020,9/30/2020,93020,82L-IMPORT PAYROLL-BASHAM WILLIAM EDWARD,D108,HJ,,65,43092.99
6170,9/30/2020,9/30/2020,93020,82L-IMPORT PAYROLL-BROWN ISAAC,D108,HJ,,65,43027.99
6170,9/30/2020,9/30/2020,93020,82L-IMPORT PAYROLL-KHAN HUDA,D108,HJ,,65,42962.99
6170,9/30/2020,9/30/2020,93020,82L-IMPORT PAYROLL-KNOWLIN ZYLIA,D108,HJ,,136.92,42826.07
6170,9/30/2020,9/30/2020,93020,82L-IMPORT PAYROLL-KOPSHEVER MELISSA,D108,HJ,,240.7,42585.37
6170,9/30/2020,9/30/2020,93020,82L-IMPORT PAYROLL-LI SEN,D108,HJ,,65,42520.37
6170,9/30/2020,9/30/2020,93020,82L-IMPORT PAYROLL-LIPSCOMB STEPHEN,D108,HJ,,136.92,42383.45
6170,9/30/2020,9/30/2020,93020,82L-IMPORT PAYROLL-MEJIA CARLOS MANUEL,D108,HJ,,65,42318.45
6170,9/30/2020,9/30/2020,93020,82L-IMPORT PAYROLL-SCOTT KIRK,D108,HJ,,65,42253.45
6170,9/30/2020,9/30/2020,93020,82L-IMPORT PAYROLL-SILVER KELLY,D108,HJ,,136.92,42116.53
6170,9/30/2020,9/30/2020,93020,82L-IMPORT PAYROLL-STEIN KYLE,D108,HJ,,136.92,41979.61
6170,9/30/2020,9/30/2020,93020,82L-IMPORT PAYROLL-VALCIN SABRINA JEMIMAH,D108,HJ,,65,41914.61
6170,9/30/2020,9/30/2020,93020,82L-IMPORT PAYROLL-AUSTIN PERCY,D108,HJ,,130.11,41784.5
6170,9/30/2020,9/30/2020,93020,82L-IMPORT PAYROLL-DADA ARIKPO,D108,HJ,,390.22,41394.28
6170,9/30/2020,9/30/2020,93020,82L-IMPORT PAYROLL-GUTHRIE LESLIE,D108,HJ,,136.92,41257.36
6170,9/30/2020,9/30/2020,93020,82L-IMPORT PAYROLL-HOLMES JOREL ALEXANDER,D108,HJ,,136.92,41120.44
6170,9/30/2020,9/30/2020,93020,82L-IMPORT PAYROLL-JORDAN TIFFANY T,D108,HJ,,240.7,40879.74
6170,9/30/2020,9/30/2020,93020,82L-IMPORT PAYROLL-ONICA ANTHONY J,D108,HJ,,136.92,40742.82
6170,9/30/2020,9/30/2020,93020,82L-IMPORT PAYROLL-PRAHIN NICOLE M,D108,HJ,,130.11,40612.71
6170,9/30/2020,9/30/2020,93020,82L-IMPORT PAYROLL-SALIM YASSER,D108,HJ,,136.92,40475.79
6170,9/30/2020,9/30/2020,93020,82L-IMPORT PAYROLL-SEJOUR MAHALIAH,D108,HJ,,136.92,40338.87
6170,9/30/2020,9/30/2020,93020,82L-IMPORT PAYROLL-SKALSKI CHRISTOPHER,D108,HJ,,130.11,40208.76
6170,9/30/2020,9/30/2020,93020,82L-IMPORT PAYROLL-TUMENJARGAL ENKHJIN,D108,HJ,,130.11,40078.65
6170,9/30/2020,9/30/2020,93020,82L-IMPORT PAYROLL-VILLEGAS EVELYN,D108,HJ,,390.22,39688.43
6170,9/30/2020,9/30/2020,93020,82L-IMPORT PAYROLL-WOLF ANNA A,D108,HJ,,130.11,39558.32
6170,9/30/2020,9/30/2020,93020,82L-IMPORT PAYROLL-ACEVEDO MONIVETT,D107,HJ,,240.7,39317.62
6170,9/30/2020,9/30/2020,93020,82L-IMPORT PAYROLL-AKLESTAD ISABEL,D111,HJ,,130.11,39187.51
6170,9/30/2020,9/30/2020,93020,82L-IMPORT PAYROLL-BIBB TIFFANI,D104,HJ,,370.8,38816.71
6170,9/30/2020,9/30/2020,93020,82L-IMPORT PAYROLL-COOK CATHRYN ANNA,D105,HJ,,136.92,38679.79
6170,9/30/2020,9/30/2020,93020,82L-IMPORT PAYROLL-COOPER ASHLEE R,D101,HJ,,136.92,38542.87
6170,9/30/2020,9/30/2020,93020,82L-IMPORT PAYROLL-DETONE KYRA MAYA,D102,HJ,,130.11,38412.76
6170,9/30/2020,9/30/2020,93020,82L-IMPORT PAYROLL-DUPUIS CHRISTOPHER M,D107,HJ,,136.92,38275.84
6170,9/30/2020,9/30/2020,93020,82L-IMPORT PAYROLL-GUADARRAMA-ALVAREZ URIEL A,D105,HJ,,130.11,38145.73
6170,9/30/2020,9/30/2020,93020,82L-IMPORT PAYROLL-GUTIERREZ ANTONIO J,D107,HJ,,370.8,37774.93
6170,9/30/2020,9/30/2020,93020,82L-IMPORT PAYROLL-LACEY DEQUITA,D104,HJ,,50.55,37724.38
6170,9/30/2020,9/30/2020,93020,82L-IMPORT PAYROLL-MASON ANGELA,D107,HJ,,240.7,37483.68
6170,9/30/2020,9/30/2020,93020,82L-IMPORT PAYROLL-PARHAM-GANTT DENISE M,D112,HJ,,273.84,37209.84
6170,9/30/2020,9/30/2020,93020,82L-IMPORT PAYROLL-PEINADO ELIZABETH R,D111,HJ,,130.11,37079.73
6170,9/30/2020,9/30/2020,93020,82L-IMPORT PAYROLL-POLANCO ODALIS,D103,HJ,,130.11,36949.62
6170,9/30/2020,9/30/2020,93020,82L-IMPORT PAYROLL-QUINTAS JASHIVE,D105,HJ,,136.92,36812.7
6170,9/30/2020,9/30/2020,93020,82L-IMPORT PAYROLL-RANDOLPH ALEXANDER,D111,HJ,,130.11,36682.59
6170,9/30/2020,9/30/2020,93020,82L-IMPORT PAYROLL-RUBI PERLA,D101,HJ,,136.92,36545.67
6170,9/30/2020,9/30/2020,93020,82L-IMPORT PAYROLL-WALLACE AMENA,D104,HJ,,130.11,36415.56
6170,9/30/2020,9/30/2020,93020,82L-IMPORT PAYROLL-WEINSTOCK EMILY,D101,HJ,,136.92,36278.64
6170,9/30/2020,9/30/2020,93020,82L-IMPORT PAYROLL-BARTOLD DEANNA MARIE,D108,HJ,,130.11,36148.53
6170,9/30/2020,9/30/2020,93020,82L-IMPORT PAYROLL-BELLOT GENESIS,D108,HJ,,136.92,36011.61
6170,9/30/2020,9/30/2020,93020,82L-IMPORT PAYROLL-BURRELL RUSSELL,D108,HJ,,65,35946.61
6170,9/30/2020,9/30/2020,93020,82L-IMPORT PAYROLL-FEIGHERY JOHN,D108,HJ,,130.11,35816.5
6170,9/30/2020,9/30/2020,93020,82L-IMPORT PAYROLL-GREENE BROOKE,D108,HJ,,65,35751.5
6170,9/30/2020,9/30/2020,93020,82L-IMPORT PAYROLL-GRIFFIN ANDREW,D108,HJ,,136.92,35614.58
6170,9/30/2020,9/30/2020,93020,82L-IMPORT PAYROLL-GROSS EMILY,D108,HJ,,136.92,35477.66
6170,9/30/2020,9/30/2020,93020,82L-IMPORT PAYROLL-HALLINAN GABRIEL B,D108,HJ,,136.92,35340.74
6170,9/30/2020,9/30/2020,93020,82L-IMPORT PAYROLL-HAMERSLY WILLIAM,D108,HJ,,130.11,35210.63
6170,9/30/2020,9/30/2020,93020,82L-IMPORT PAYROLL-JACKSON TASNIM,D108,HJ,,136.92,35073.71
6170,9/30/2020,9/30/2020,93020,82L-IMPORT PAYROLL-LI BELLA,D108,HJ,,130.11,34943.6
6170,9/30/2020,9/30/2020,93020,82L-IMPORT PAYROLL-OPUH NDIDI,D108,HJ,,390.22,34553.38
6170,9/30/2020,9/30/2020,93020,82L-IMPORT PAYROLL-SCHWETTMANN CLAIRE,D108,HJ,,65,34488.38
6170,9/30/2020,9/30/2020,93020,82L-IMPORT PAYROLL-SOBELMAN JUSTIN,D108,HJ,,17.63,34470.75
6170,9/30/2020,9/30/2020,93020,82L-IMPORT PAYROLL-TERRENCE-SMITH ZIHIR UNIQUE,D108,HJ,,65,34405.75
6170,9/30/2020,9/30/2020,93020,82L-IMPORT PAYROLL-COVENEY ALLISON,D108,HJ,,136.92,34268.83
6170,9/30/2020,9/30/2020,93020,82L-IMPORT PAYROLL-JACKSON CLAICE,D108,HJ,,136.92,34131.91
6170,9/30/2020,9/30/2020,93020,82L-IMPORT PAYROLL-JANG DANIEL,D108,HJ,,130.11,34001.8
6170,9/30/2020,9/30/2020,93020,82L-IMPORT PAYROLL-LENEGHAN MARYELLEN,D108,HJ,,130.11,33871.69
6170,9/30/2020,9/30/2020,202009,Adj to reallocate Salaries FICA and benefits from GM3 - ACY2 to G-BL-To reallocate PR 0915 & 0930 Benefits to CPS,D104,HJ,,878.52,32993.17
6170,9/30/2020,9/30/2020,202009,Adj to reallocate Salaries FICA and benefits from GM3 - ACY2 to G-BL-To reallocate PR 0915 & 0930 Benefits to CPS,D104,HJ,878.52,,33871.69
6170,9/30/2020,9/30/2020,202009,Adj to reallocate Salaries FICA and benefits from GM3 - ACY2 to G-BL-To reallocate PR 0915 & 0930 Benefits to CPS A Wallace,D104,HJ,,260.22,33611.47
6170,9/30/2020,9/30/2020,202009,Adj to reallocate Salaries FICA and benefits from GM3 - ACY2 to G-BL-To reallocate PR 0915 & 0930 Benefits to CPS A Wallace,D104,HJ,260.22,,33871.69
6170,10/1/2020,10/1/2020,BCBS,October BCBS Payment-BCBS - October BCBS,D108,HJ,15477.45,,49349.14
6170,10/1/2020,10/1/2020,BCBS,October BCBS Payment-BCBS - October BCBS,D108,HJ,9452.89,,58802.03
6170,10/1/2020,10/1/2020,BCBS,October BCBS Payment-BCBS - October BCBS,D107,HJ,12140.84,,70942.87
6170,10/1/2020,10/1/2020,BCBS,October BCBS Payment-BCBS - October BCBS,D108,HJ,7420.09,,78362.96
6170,10/1/2020,10/1/2020,BCBS,October BCBS Payment-BCBS - October BCBS,D108,HJ,3646.74,,82009.7
6170,10/7/2020,10/7/2020,ins-Oct,Insurance credit from Julia Martin-Insurance credit from Julia Martin,D108,HJ,,527.54,81482.16
6170,10/15/2020,10/15/2020,101520,82L-IMPORT PAYROLL-BARTHELEMY RACHALIE,D108,HJ,,65,81417.16
6170,10/15/2020,10/15/2020,101520,82L-IMPORT PAYROLL-BASHAM WILLIAM EDWARD,D108,HJ,,65,81352.16
6170,10/15/2020,10/15/2020,101520,82L-IMPORT PAYROLL-BROWN ISAAC,D108,HJ,,65,81287.16
6170,10/15/2020,10/15/2020,101520,82L-IMPORT PAYROLL-KHAN HUDA,D108,HJ,,65,81222.16
6170,10/15/2020,10/15/2020,101520,82L-IMPORT PAYROLL-KNOWLIN ZYLIA,D108,HJ,,136.92,81085.24
6170,10/15/2020,10/15/2020,101520,82L-IMPORT PAYROLL-KOPSHEVER MELISSA,D108,HJ,,240.7,80844.54
6170,10/15/2020,10/15/2020,101520,82L-IMPORT PAYROLL-LI SEN,D108,HJ,,65,80779.54
6170,10/15/2020,10/15/2020,101520,82L-IMPORT PAYROLL-LIPSCOMB STEPHEN,D108,HJ,,136.92,80642.62
6170,10/15/2020,10/15/2020,101520,82L-IMPORT PAYROLL-MEJIA CARLOS MANUEL,D108,HJ,,65,80577.62
6170,10/15/2020,10/15/2020,101520,82L-IMPORT PAYROLL-SCOTT KIRK,D108,HJ,,65,80512.62
6170,10/15/2020,10/15/2020,101520,82L-IMPORT PAYROLL-SILVER KELLY,D108,HJ,,136.92,80375.7
6170,10/15/2020,10/15/2020,101520,82L-IMPORT PAYROLL-STEIN KYLE,D108,HJ,,136.92,80238.78
6170,10/15/2020,10/15/2020,101520,82L-IMPORT PAYROLL-VALCIN SABRINA JEMIMAH,D108,HJ,,65,80173.78
6170,10/15/2020,10/15/2020,101520,82L-IMPORT PAYROLL-APULI LINDSAY,D108,HJ,,130.11,80043.67
6170,10/15/2020,10/15/2020,101520,82L-IMPORT PAYROLL-AUSTIN PERCY,D108,HJ,,130.11,79913.56
6170,10/15/2020,10/15/2020,101520,82L-IMPORT PAYROLL-CAIN CORY,D108,HJ,,136.92,79776.64
6170,10/15/2020,10/15/2020,101520,82L-IMPORT PAYROLL-DADA ARIKPO,D108,HJ,,390.22,79386.42
6170,10/15/2020,10/15/2020,101520,82L-IMPORT PAYROLL-GUTHRIE LESLIE,D108,HJ,,136.92,79249.5
6170,10/15/2020,10/15/2020,101520,82L-IMPORT PAYROLL-HOLMES JOREL ALEXANDER,D108,HJ,,136.92,79112.58
6170,10/15/2020,10/15/2020,101520,82L-IMPORT PAYROLL-JORDAN TIFFANY T,D108,HJ,,240.7,78871.88
6170,10/15/2020,10/15/2020,101520,82L-IMPORT PAYROLL-ONICA ANTHONY J,D108,HJ,,136.92,78734.96
6170,10/15/2020,10/15/2020,101520,82L-IMPORT PAYROLL-PRAHIN NICOLE M,D108,HJ,,130.11,78604.85
6170,10/15/2020,10/15/2020,101520,82L-IMPORT PAYROLL-SALIM YASSER,D108,HJ,,136.92,78467.93
6170,10/15/2020,10/15/2020,101520,82L-IMPORT PAYROLL-SEJOUR MAHALIAH,D108,HJ,,136.92,78331.01
6170,10/15/2020,10/15/2020,101520,82L-IMPORT PAYROLL-SKALSKI CHRISTOPHER,D108,HJ,,130.11,78200.9
6170,10/15/2020,10/15/2020,101520,82L-IMPORT PAYROLL-TUMENJARGAL ENKHJIN,D108,HJ,,130.11,78070.79
6170,10/15/2020,10/15/2020,101520,82L-IMPORT PAYROLL-VILLEGAS EVELYN,D108,HJ,,390.22,77680.57
6170,10/15/2020,10/15/2020,101520,82L-IMPORT PAYROLL-WOLF ANNA A,D108,HJ,,130.11,77550.46
6170,10/15/2020,10/15/2020,101520,82L-IMPORT PAYROLL-ACEVEDO MONIVETT,D107,HJ,,240.7,77309.76
6170,10/15/2020,10/15/2020,101520,82L-IMPORT PAYROLL-AKLESTAD ISABEL,D111,HJ,,130.11,77179.65
6170,10/15/2020,10/15/2020,101520,82L-IMPORT PAYROLL-BIBB TIFFANI,D104,HJ,,370.8,76808.85
6170,10/15/2020,10/15/2020,101520,82L-IMPORT PAYROLL-COOK CATHRYN ANNA,D105,HJ,,136.92,76671.93
6170,10/15/2020,10/15/2020,101520,82L-IMPORT PAYROLL-COOPER ASHLEE R,D101,HJ,,136.92,76535.01
6170,10/15/2020,10/15/2020,101520,82L-IMPORT PAYROLL-DETONE KYRA MAYA,D102,HJ,,130.11,76404.9
6170,10/15/2020,10/15/2020,101520,82L-IMPORT PAYROLL-DUPUIS CHRISTOPHER M,D107,HJ,,136.92,76267.98
6170,10/15/2020,10/15/2020,101520,82L-IMPORT PAYROLL-GUADARRAMA-ALVAREZ URIEL A,D105,HJ,,130.11,76137.87
6170,10/15/2020,10/15/2020,101520,82L-IMPORT PAYROLL-GUTIERREZ ANTONIO J,D107,HJ,,370.8,75767.07
6170,10/15/2020,10/15/2020,101520,82L-IMPORT PAYROLL-MASON ANGELA,D107,HJ,,240.7,75526.37
6170,10/15/2020,10/15/2020,101520,82L-IMPORT PAYROLL-PARHAM-GANTT DENISE M,D112,HJ,,273.84,75252.53
6170,10/15/2020,10/15/2020,101520,82L-IMPORT PAYROLL-PEINADO ELIZABETH R,D111,HJ,,130.11,75122.42
6170,10/15/2020,10/15/2020,101520,82L-IMPORT PAYROLL-POLANCO ODALIS,D103,HJ,,130.11,74992.31
6170,10/15/2020,10/15/2020,101520,82L-IMPORT PAYROLL-QUINTAS JASHIVE,D105,HJ,,136.92,74855.39
6170,10/15/2020,10/15/2020,101520,82L-IMPORT PAYROLL-RANDOLPH ALEXANDER,D111,HJ,,130.11,74725.28
6170,10/15/2020,10/15/2020,101520,82L-IMPORT PAYROLL-RUBI PERLA,D101,HJ,,136.92,74588.36
6170,10/15/2020,10/15/2020,101520,82L-IMPORT PAYROLL-WALLACE AMENA,D104,HJ,,130.11,74458.25
6170,10/15/2020,10/15/2020,101520,82L-IMPORT PAYROLL-WEINSTOCK EMILY,D101,HJ,,136.92,74321.33
6170,10/15/2020,10/15/2020,101520,82L-IMPORT PAYROLL-BARTOLD DEANNA MARIE,D108,HJ,,130.11,74191.22
6170,10/15/2020,10/15/2020,101520,82L-IMPORT PAYROLL-BELLOT GENESIS,D108,HJ,,136.92,74054.3
6170,10/15/2020,10/15/2020,101520,82L-IMPORT PAYROLL-BURRELL RUSSELL,D108,HJ,,65,73989.3
6170,10/15/2020,10/15/2020,101520,82L-IMPORT PAYROLL-FEIGHERY JOHN,D108,HJ,,130.11,73859.19
6170,10/15/2020,10/15/2020,101520,82L-IMPORT PAYROLL-GREENE BROOKE,D108,HJ,,65,73794.19
6170,10/15/2020,10/15/2020,101520,82L-IMPORT PAYROLL-GRIFFIN ANDREW,D108,HJ,,136.92,73657.27
6170,10/15/2020,10/15/2020,101520,82L-IMPORT PAYROLL-GROSS EMILY,D108,HJ,,136.92,73520.35
6170,10/15/2020,10/15/2020,101520,82L-IMPORT PAYROLL-HALLINAN GABRIEL B,D108,HJ,,136.92,73383.43
6170,10/15/2020,10/15/2020,101520,82L-IMPORT PAYROLL-HAMERSLY WILLIAM,D108,HJ,,130.11,73253.32
6170,10/15/2020,10/15/2020,101520,82L-IMPORT PAYROLL-JACKSON TASNIM,D108,HJ,,136.92,73116.4
6170,10/15/2020,10/15/2020,101520,82L-IMPORT PAYROLL-LI BELLA,D108,HJ,,130.11,72986.29
6170,10/15/2020,10/15/2020,101520,82L-IMPORT PAYROLL-OPUH NDIDI,D108,HJ,,390.22,72596.07
6170,10/15/2020,10/15/2020,101520,82L-IMPORT PAYROLL-SCHWETTMANN CLAIRE,D108,HJ,,65,72531.07
6170,10/15/2020,10/15/2020,101520,82L-IMPORT PAYROLL-SOBELMAN JUSTIN,D108,HJ,,65,72466.07
6170,10/15/2020,10/15/2020,101520,82L-IMPORT PAYROLL-TERRENCE-SMITH ZIHIR UNIQUE,D108,HJ,,65,72401.07
6170,10/15/2020,10/15/2020,101520,82L-IMPORT PAYROLL-COVENEY ALLISON,D108,HJ,,136.92,72264.15
6170,10/15/2020,10/15/2020,101520,82L-IMPORT PAYROLL-JACKSON CLAICE,D108,HJ,,136.92,72127.23
6170,10/15/2020,10/15/2020,101520,82L-IMPORT PAYROLL-JANG DANIEL,D108,HJ,,130.11,71997.12
6170,10/15/2020,10/15/2020,101520,82L-IMPORT PAYROLL-LENEGHAN MARYELLEN,D108,HJ,,130.11,71867.01
6170,10/30/2020,10/30/2020,103120,82L-IMPORT PAYROLL-BARTHELEMY RACHALIE,D108,HJ,,65,71802.01
6170,10/30/2020,10/30/2020,103120,82L-IMPORT PAYROLL-BASHAM WILLIAM EDWARD,D108,HJ,,65,71737.01
6170,10/30/2020,10/30/2020,103120,82L-IMPORT PAYROLL-BROWN ISAAC,D108,HJ,,65,71672.01
6170,10/30/2020,10/30/2020,103120,82L-IMPORT PAYROLL-KHAN HUDA,D108,HJ,,65,71607.01
6170,10/30/2020,10/30/2020,103120,82L-IMPORT PAYROLL-KNOWLIN ZYLIA,D108,HJ,,136.92,71470.09
6170,10/30/2020,10/30/2020,103120,82L-IMPORT PAYROLL-KOPSHEVER MELISSA,D108,HJ,,240.7,71229.39
6170,10/30/2020,10/30/2020,103120,82L-IMPORT PAYROLL-LI SEN YUAN,D108,HJ,,65,71164.39
6170,10/30/2020,10/30/2020,103120,82L-IMPORT PAYROLL-LIPSCOMB STEPHEN,D108,HJ,,136.92,71027.47
6170,10/30/2020,10/30/2020,103120,82L-IMPORT PAYROLL-MEJIA ROSO CARLOS,D108,HJ,,65,70962.47
6170,10/30/2020,10/30/2020,103120,82L-IMPORT PAYROLL-SCOTT KIRK DONOVAN,D108,HJ,,65,70897.47
6170,10/30/2020,10/30/2020,103120,82L-IMPORT PAYROLL-SILVER KELLY,D108,HJ,,136.92,70760.55
6170,10/30/2020,10/30/2020,103120,82L-IMPORT PAYROLL-STEIN KYLE,D108,HJ,,136.92,70623.63
6170,10/30/2020,10/30/2020,103120,82L-IMPORT PAYROLL-VALCIN SABRINA JEMIMAH,D108,HJ,,65,70558.63
6170,10/30/2020,10/30/2020,103120,82L-IMPORT PAYROLL-APULI LINDSAY,D108,HJ,,130.11,70428.52
6170,10/30/2020,10/30/2020,103120,82L-IMPORT PAYROLL-AUSTIN PERCY ANTONIO,D108,HJ,,130.11,70298.41
6170,10/30/2020,10/30/2020,103120,82L-IMPORT PAYROLL-CAIN CORY,D108,HJ,,136.92,70161.49
6170,10/30/2020,10/30/2020,103120,82L-IMPORT PAYROLL-DADA ARIKPO E,D108,HJ,,284,69877.49
6170,10/30/2020,10/30/2020,103120,82L-IMPORT PAYROLL-GUTHRIE LESLIE,D108,HJ,,136.92,69740.57
6170,10/30/2020,10/30/2020,103120,82L-IMPORT PAYROLL-HOLMES JOREL ALEXANDER,D108,HJ,,30.7,69709.87
6170,10/30/2020,10/30/2020,103120,82L-IMPORT PAYROLL-JORDAN TIFFANY T,D108,HJ,,134.48,69575.39
6170,10/30/2020,10/30/2020,103120,82L-IMPORT PAYROLL-ONICA ANTHONY J,D108,HJ,,30.7,69544.69
6170,10/30/2020,10/30/2020,103120,82L-IMPORT PAYROLL-PRAHIN NICOLE M,D108,HJ,,23.89,69520.8
6170,10/30/2020,10/30/2020,103120,82L-IMPORT PAYROLL-SALIM YASSER,D108,HJ,,30.7,69490.1
6170,10/30/2020,10/30/2020,103120,82L-IMPORT PAYROLL-SEJOUR MAHALIAH,D108,HJ,,30.7,69459.4
6170,10/30/2020,10/30/2020,103120,82L-IMPORT PAYROLL-SKALSKI CHRISTOPHER,D108,HJ,,23.89,69435.51
6170,10/30/2020,10/30/2020,103120,82L-IMPORT PAYROLL-TUMENJARGAL ENKHJIN,D108,HJ,,23.89,69411.62
6170,10/30/2020,10/30/2020,103120,82L-IMPORT PAYROLL-VILLEGAS EVELYN,D108,HJ,,284,69127.62
6170,10/30/2020,10/30/2020,103120,82L-IMPORT PAYROLL-WOLF ANNA A,D108,HJ,,23.89,69103.73
6170,10/30/2020,10/30/2020,103120,82L-IMPORT PAYROLL-ACEVEDO MONIVETT,D107,HJ,,134.48,68969.25
6170,10/30/2020,10/30/2020,103120,82L-IMPORT PAYROLL-AKLESTAD ISABEL,D111,HJ,,130.11,68839.14
6170,10/30/2020,10/30/2020,103120,82L-IMPORT PAYROLL-BIBB TIFFANI,D104,HJ,,370.8,68468.34
6170,10/30/2020,10/30/2020,103120,82L-IMPORT PAYROLL-COOK CATHRYN ANNA,D105,HJ,,30.7,68437.64
6170,10/30/2020,10/30/2020,103120,82L-IMPORT PAYROLL-COOPER ASHLEE R,D101,HJ,,30.7,68406.94
6170,10/30/2020,10/30/2020,103120,82L-IMPORT PAYROLL-DETONE KYRA MAYA,D102,HJ,,23.89,68383.05
6170,10/30/2020,10/30/2020,103120,82L-IMPORT PAYROLL-DUPUIS CHRISTOPHER M,D107,HJ,,30.7,68352.35
6170,10/30/2020,10/30/2020,103120,82L-IMPORT PAYROLL-GUADARRAMA-ALVAREZ URIEL A,D105,HJ,,23.89,68328.46
6170,10/30/2020,10/30/2020,103120,82L-IMPORT PAYROLL-GUTIERREZ ANTONIO J,D107,HJ,,264.58,68063.88
6170,10/30/2020,10/30/2020,103120,82L-IMPORT PAYROLL-MASON ANGELA,D107,HJ,,134.48,67929.4
6170,10/30/2020,10/30/2020,103120,82L-IMPORT PAYROLL-PARHAM-GANTT DENISE M,D112,HJ,,167.62,67761.78
6170,10/30/2020,10/30/2020,103120,82L-IMPORT PAYROLL-PEINADO ELIZABETH R,D111,HJ,,23.89,67737.89
6170,10/30/2020,10/30/2020,103120,82L-IMPORT PAYROLL-POLANCO ODALIS,D103,HJ,,23.89,67714
6170,10/30/2020,10/30/2020,103120,82L-IMPORT PAYROLL-QUINTAS JASHIVE,D105,HJ,,136.92,67577.08
6170,10/30/2020,10/30/2020,103120,82L-IMPORT PAYROLL-RANDOLPH ALEXANDER,D111,HJ,,130.11,67446.97
6170,10/30/2020,10/30/2020,103120,82L-IMPORT PAYROLL-RUBI PERLA,D101,HJ,,30.7,67416.27
6170,10/30/2020,10/30/2020,103120,82L-IMPORT PAYROLL-WALLACE AMENA,D104,HJ,,23.89,67392.38
6170,10/30/2020,10/30/2020,103120,82L-IMPORT PAYROLL-WEINSTOCK EMILY,D101,HJ,,136.92,67255.46
6170,10/30/2020,10/30/2020,103120,82L-IMPORT PAYROLL-BARTOLD DEANNA MARIE,D108,HJ,,23.89,67231.57
6170,10/30/2020,10/30/2020,103120,82L-IMPORT PAYROLL-BELLOT GENESIS,D108,HJ,,136.92,67094.65
6170,10/30/2020,10/30/2020,103120,82L-IMPORT PAYROLL-BURRELL RUSSELL,D108,HJ,,65,67029.65
6170,10/30/2020,10/30/2020,103120,82L-IMPORT PAYROLL-FEIGHERY JOHN,D108,HJ,,23.89,67005.76
6170,10/30/2020,10/30/2020,103120,82L-IMPORT PAYROLL-GREENE BROOKE,D108,HJ,,65,66940.76
6170,10/30/2020,10/30/2020,103120,82L-IMPORT PAYROLL-GRIFFIN ANDREW,D108,HJ,,136.92,66803.84
6170,10/30/2020,10/30/2020,103120,82L-IMPORT PAYROLL-GROSS EMILY,D108,HJ,,136.92,66666.92
6170,10/30/2020,10/30/2020,103120,82L-IMPORT PAYROLL-HALLINAN GABRIEL,D108,HJ,,30.7,66636.22
6170,10/30/2020,10/30/2020,103120,82L-IMPORT PAYROLL-HAMERSLY WILLIAM,D108,HJ,,130.11,66506.11
6170,10/30/2020,10/30/2020,103120,82L-IMPORT PAYROLL-JACKSON TASNIM F,D108,HJ,,136.92,66369.19
6170,10/30/2020,10/30/2020,103120,82L-IMPORT PAYROLL-LI BELLA,D108,HJ,,23.89,66345.3
6170,10/30/2020,10/30/2020,103120,82L-IMPORT PAYROLL-OPUH NDIDI,D108,HJ,,390.22,65955.08
6170,10/30/2020,10/30/2020,103120,82L-IMPORT PAYROLL-SCHWETTMANN CLAIRE,D108,HJ,,65,65890.08
6170,10/30/2020,10/30/2020,103120,82L-IMPORT PAYROLL-SOBELMAN JUSTIN,D108,HJ,,65,65825.08
6170,10/30/2020,10/30/2020,103120,82L-IMPORT PAYROLL-TERRENCE-SMITH ZIHIR,D108,HJ,,65,65760.08
6170,10/30/2020,10/30/2020,103120,82L-IMPORT PAYROLL-COVENEY ALLISON,D108,HJ,,136.92,65623.16
6170,10/30/2020,10/30/2020,103120,82L-IMPORT PAYROLL-JACKSON CLAICE M,D108,HJ,,30.7,65592.46
6170,10/30/2020,10/30/2020,103120,82L-IMPORT PAYROLL-JANG DANIEL,D108,HJ,,130.11,65462.35
6170,10/30/2020,10/30/2020,103120,82L-IMPORT PAYROLL-LENEGHAN MARYELLEN,D108,HJ,,23.89,65438.46
6170,11/2/2020,11/2/2020,BCBS,November BCBS Payment for October Americorp Portion-BCBS - November Payment,D108,HJ,3245.54,,68684
6170,11/2/2020,11/2/2020,BCBS,November BCBS Payment for October Americorp Portion-BCBS - November Payment,D108,HJ,1163.79,,69847.79
6170,11/2/2020,11/2/2020,BCBS,November BCBS Payment for October Americorp Portion-BCBS - November Payment,D108,HJ,520.43,,70368.22
6170,11/5/2020,11/5/2020,BCBS,November BCBS Payments-BCBS - November Invoices,D108,HJ,9575.57,,79943.79
6170,11/5/2020,11/5/2020,BCBS,November BCBS Payments-BCBS - November Invoices,D108,HJ,5157.04,,85100.83
6170,11/5/2020,11/5/2020,BCBS,November BCBS Payments-BCBS - November Invoices,D107,HJ,15371.53,,100472.36
6170,11/5/2020,11/5/2020,BCBS,November BCBS Payments-BCBS - November Invoices,D108,HJ,12870.63,,113342.99
6170,11/5/2020,11/5/2020,BCBS,November BCBS Payments-BCBS - November Invoices,D108,HJ,1400.5,,114743.49
6170,11/9/2020,11/9/2020,20201109,Julia Martin insurance repayment-Julia Martin insurance repayment,D108,HJ,,527.54,114215.95
6170,11/13/2020,11/13/2020,111320,82L-IMPORT PAYROLL-BARTHELEMY RACHALIE,D108,HJ,,65,114150.95
6170,11/13/2020,11/13/2020,111320,82L-IMPORT PAYROLL-BASHAM WILLIAM EDWARD,D108,HJ,,65,114085.95
6170,11/13/2020,11/13/2020,111320,82L-IMPORT PAYROLL-BROWN ISAAC,D108,HJ,,65,114020.95
6170,11/13/2020,11/13/2020,111320,82L-IMPORT PAYROLL-KHAN HUDA,D108,HJ,,65,113955.95
6170,11/13/2020,11/13/2020,111320,82L-IMPORT PAYROLL-KNOWLIN ZYLIA,D108,HJ,,136.92,113819.03
6170,11/13/2020,11/13/2020,111320,82L-IMPORT PAYROLL-KOPSHEVER MELISSA,D108,HJ,,240.7,113578.33
6170,11/13/2020,11/13/2020,111320,82L-IMPORT PAYROLL-LI SEN YUAN,D108,HJ,,65,113513.33
6170,11/13/2020,11/13/2020,111320,82L-IMPORT PAYROLL-LIPSCOMB STEPHEN,D108,HJ,,136.92,113376.41
6170,11/13/2020,11/13/2020,111320,82L-IMPORT PAYROLL-MEJIA ROSO CARLOS,D108,HJ,,65,113311.41
6170,11/13/2020,11/13/2020,111320,82L-IMPORT PAYROLL-SCOTT KIRK DONOVAN,D108,HJ,,65,113246.41
6170,11/13/2020,11/13/2020,111320,82L-IMPORT PAYROLL-SILVER KELLY,D108,HJ,,136.92,113109.49
6170,11/13/2020,11/13/2020,111320,82L-IMPORT PAYROLL-STEIN KYLE,D108,HJ,,136.92,112972.57
6170,11/13/2020,11/13/2020,111320,82L-IMPORT PAYROLL-VALCIN SABRINA JEMIMAH,D108,HJ,,65,112907.57
6170,11/13/2020,11/13/2020,111320,82L-IMPORT PAYROLL-APULI LINDSAY,D108,HJ,,130.11,112777.46
6170,11/13/2020,11/13/2020,111320,82L-IMPORT PAYROLL-AUSTIN PERCY ANTONIO,D108,HJ,,130.11,112647.35
6170,11/13/2020,11/13/2020,111320,82L-IMPORT PAYROLL-CAIN CORY,D108,HJ,,136.92,112510.43
6170,11/13/2020,11/13/2020,111320,82L-IMPORT PAYROLL-DADA ARIKPO E,D108,HJ,,390.22,112120.21
6170,11/13/2020,11/13/2020,111320,82L-IMPORT PAYROLL-GUTHRIE LESLIE,D108,HJ,,136.92,111983.29
6170,11/13/2020,11/13/2020,111320,82L-IMPORT PAYROLL-HOLMES JOREL ALEXANDER,D108,HJ,,136.92,111846.37
6170,11/13/2020,11/13/2020,111320,82L-IMPORT PAYROLL-JORDAN TIFFANY T,D108,HJ,,240.7,111605.67
6170,11/13/2020,11/13/2020,111320,82L-IMPORT PAYROLL-ONICA ANTHONY J,D108,HJ,,136.92,111468.75
6170,11/13/2020,11/13/2020,111320,82L-IMPORT PAYROLL-PRAHIN NICOLE M,D108,HJ,,130.11,111338.64
6170,11/13/2020,11/13/2020,111320,82L-IMPORT PAYROLL-SALIM YASSER,D108,HJ,,136.92,111201.72
6170,11/13/2020,11/13/2020,111320,82L-IMPORT PAYROLL-SEJOUR MAHALIAH,D108,HJ,,136.92,111064.8
6170,11/13/2020,11/13/2020,111320,82L-IMPORT PAYROLL-SKALSKI CHRISTOPHER,D108,HJ,,130.11,110934.69
6170,11/13/2020,11/13/2020,111320,82L-IMPORT PAYROLL-TUMENJARGAL ENKHJIN,D108,HJ,,130.11,110804.58
6170,11/13/2020,11/13/2020,111320,82L-IMPORT PAYROLL-VILLEGAS EVELYN,D108,HJ,,390.22,110414.36
6170,11/13/2020,11/13/2020,111320,82L-IMPORT PAYROLL-WOLF ANNA A,D108,HJ,,130.11,110284.25
6170,11/13/2020,11/13/2020,111320,82L-IMPORT PAYROLL-ACEVEDO MONIVETT,D107,HJ,,240.7,110043.55
6170,11/13/2020,11/13/2020,111320,82L-IMPORT PAYROLL-AKLESTAD ISABEL,D111,HJ,,130.11,109913.44
6170,11/13/2020,11/13/2020,111320,82L-IMPORT PAYROLL-BIBB TIFFANI,D104,HJ,,370.8,109542.64
6170,11/13/2020,11/13/2020,111320,82L-IMPORT PAYROLL-COOK CATHRYN ANNA,D105,HJ,,136.92,109405.72
6170,11/13/2020,11/13/2020,111320,82L-IMPORT PAYROLL-COOPER ASHLEE R,D101,HJ,,136.92,109268.8
6170,11/13/2020,11/13/2020,111320,82L-IMPORT PAYROLL-DETONE KYRA MAYA,D102,HJ,,130.11,109138.69
6170,11/13/2020,11/13/2020,111320,82L-IMPORT PAYROLL-DUPUIS CHRISTOPHER M,D107,HJ,,136.92,109001.77
6170,11/13/2020,11/13/2020,111320,82L-IMPORT PAYROLL-FISCHABER THOMAS,D109,HJ,,390.22,108611.55
6170,11/13/2020,11/13/2020,111320,82L-IMPORT PAYROLL-GUADARRAMA-ALVAREZ URIEL A,D105,HJ,,130.11,108481.44
6170,11/13/2020,11/13/2020,111320,82L-IMPORT PAYROLL-GUTIERREZ ANTONIO J,D107,HJ,,370.8,108110.64
6170,11/13/2020,11/13/2020,111320,82L-IMPORT PAYROLL-HOLT ADAM,D109,HJ,,136.92,107973.72
6170,11/13/2020,11/13/2020,111320,82L-IMPORT PAYROLL-MARKS KRISTA,D109,HJ,,136.92,107836.8
6170,11/13/2020,11/13/2020,111320,82L-IMPORT PAYROLL-MASON ANGELA,D107,HJ,,240.7,107596.1
6170,11/13/2020,11/13/2020,111320,82L-IMPORT PAYROLL-MELVIN DARNELL,D109,HJ,,130.11,107465.99
6170,11/13/2020,11/13/2020,111320,82L-IMPORT PAYROLL-MESSING JENNIFER,D104,HJ,,130.11,107335.88
6170,11/13/2020,11/13/2020,111320,82L-IMPORT PAYROLL-PARHAM-GANTT DENISE M,D112,HJ,,273.84,107062.04
6170,11/13/2020,11/13/2020,111320,82L-IMPORT PAYROLL-PEINADO ELIZABETH R,D111,HJ,,130.11,106931.93
6170,11/13/2020,11/13/2020,111320,82L-IMPORT PAYROLL-POLANCO ODALIS,D103,HJ,,130.11,106801.82
6170,11/13/2020,11/13/2020,111320,82L-IMPORT PAYROLL-QUINTAS JASHIVE,D105,HJ,,136.92,106664.9
6170,11/13/2020,11/13/2020,111320,82L-IMPORT PAYROLL-RANDOLPH ALEXANDER,D111,HJ,,130.11,106534.79
6170,11/13/2020,11/13/2020,111320,82L-IMPORT PAYROLL-RUBI PERLA,D101,HJ,,136.92,106397.87
6170,11/13/2020,11/13/2020,111320,82L-IMPORT PAYROLL-SAFRAN ALAN P,D107,HJ,,390.22,106007.65
6170,11/13/2020,11/13/2020,111320,82L-IMPORT PAYROLL-WALLACE AMENA,D104,HJ,,130.11,105877.54
6170,11/13/2020,11/13/2020,111320,82L-IMPORT PAYROLL-WARD JEFFREY,D109,HJ,,390.22,105487.32
6170,11/13/2020,11/13/2020,111320,82L-IMPORT PAYROLL-WEINSTOCK EMILY,D101,HJ,,136.92,105350.4
6170,11/13/2020,11/13/2020,111320,82L-IMPORT PAYROLL-BARTOLD DEANNA MARIE,D108,HJ,,130.11,105220.29
6170,11/13/2020,11/13/2020,111320,82L-IMPORT PAYROLL-BELLOT GENESIS,D108,HJ,,136.92,105083.37
6170,11/13/2020,11/13/2020,111320,82L-IMPORT PAYROLL-BURRELL RUSSELL,D108,HJ,,65,105018.37
6170,11/13/2020,11/13/2020,111320,82L-IMPORT PAYROLL-FEIGHERY JOHN,D108,HJ,,130.11,104888.26
6170,11/13/2020,11/13/2020,111320,82L-IMPORT PAYROLL-GREENE BROOKE,D108,HJ,,65,104823.26
6170,11/13/2020,11/13/2020,111320,82L-IMPORT PAYROLL-GRIFFIN ANDREW,D108,HJ,,136.92,104686.34
6170,11/13/2020,11/13/2020,111320,82L-IMPORT PAYROLL-GROSS EMILY,D108,HJ,,136.92,104549.42
6170,11/13/2020,11/13/2020,111320,82L-IMPORT PAYROLL-HALLINAN GABRIEL,D108,HJ,,136.92,104412.5
6170,11/13/2020,11/13/2020,111320,82L-IMPORT PAYROLL-HAMERSLY WILLIAM,D108,HJ,,130.11,104282.39
6170,11/13/2020,11/13/2020,111320,82L-IMPORT PAYROLL-JACKSON TASNIM F,D108,HJ,,136.92,104145.47
6170,11/13/2020,11/13/2020,111320,82L-IMPORT PAYROLL-LI BELLA,D108,HJ,,130.11,104015.36
6170,11/13/2020,11/13/2020,111320,82L-IMPORT PAYROLL-OPUH NDIDI,D108,HJ,,390.22,103625.14
6170,11/13/2020,11/13/2020,111320,82L-IMPORT PAYROLL-SCHWETTMANN CLAIRE,D108,HJ,,65,103560.14
6170,11/13/2020,11/13/2020,111320,82L-IMPORT PAYROLL-SOBELMAN JUSTIN,D108,HJ,,65,103495.14
6170,11/13/2020,11/13/2020,111320,82L-IMPORT PAYROLL-TERRENCE-SMITH ZIHIR,D108,HJ,,65,103430.14
6170,11/13/2020,11/13/2020,111320,82L-IMPORT PAYROLL-COVENEY ALLISON,D108,HJ,,136.92,103293.22
6170,11/13/2020,11/13/2020,111320,82L-IMPORT PAYROLL-JACKSON CLAICE M,D108,HJ,,136.92,103156.3
6170,11/13/2020,11/13/2020,111320,82L-IMPORT PAYROLL-JANG DANIEL,D108,HJ,,130.11,103026.19
6170,11/13/2020,11/13/2020,111320,82L-IMPORT PAYROLL-LENEGHAN MARYELLEN,D108,HJ,,130.11,102896.08
6170,11/30/2020,11/30/2020,1,To reallocate Benefits to CPS-To reallocate PR 1115 & 1130 Benefits to CPS,D104,HJ,,1262.04,101634.04
6170,11/30/2020,11/30/2020,1,To reallocate Benefits to CPS-To reallocate PR 1115 & 1130 Benefits to CPS,D104,HJ,1262.04,,102896.08
6170,11/30/2020,11/30/2020,113020,82L-IMPORT PAYROLL-BARTHELEMY RACHALIE,D108,HJ,,65,102831.08
6170,11/30/2020,11/30/2020,113020,82L-IMPORT PAYROLL-BASHAM WILLIAM EDWARD,D108,HJ,,65,102766.08
6170,11/30/2020,11/30/2020,113020,82L-IMPORT PAYROLL-BROWN ISAAC,D108,HJ,,65,102701.08
6170,11/30/2020,11/30/2020,113020,82L-IMPORT PAYROLL-KHAN HUDA,D108,HJ,,65,102636.08
6170,11/30/2020,11/30/2020,113020,82L-IMPORT PAYROLL-KNOWLIN ZYLIA,D108,HJ,,136.92,102499.16
6170,11/30/2020,11/30/2020,113020,82L-IMPORT PAYROLL-KOPSHEVER MELISSA,D108,HJ,,240.7,102258.46
6170,11/30/2020,11/30/2020,113020,82L-IMPORT PAYROLL-LI SEN YUAN,D108,HJ,,65,102193.46
6170,11/30/2020,11/30/2020,113020,82L-IMPORT PAYROLL-LIPSCOMB STEPHEN,D108,HJ,,136.92,102056.54
6170,11/30/2020,11/30/2020,113020,82L-IMPORT PAYROLL-MEJIA ROSO CARLOS,D108,HJ,,65,101991.54
6170,11/30/2020,11/30/2020,113020,82L-IMPORT PAYROLL-SCOTT KIRK DONOVAN,D108,HJ,,65,101926.54
6170,11/30/2020,11/30/2020,113020,82L-IMPORT PAYROLL-SILVER KELLY,D108,HJ,,136.92,101789.62
6170,11/30/2020,11/30/2020,113020,82L-IMPORT PAYROLL-STEIN KYLE,D108,HJ,,136.92,101652.7
6170,11/30/2020,11/30/2020,113020,82L-IMPORT PAYROLL-VALCIN SABRINA JEMIMAH,D108,HJ,,65,101587.7
6170,11/30/2020,11/30/2020,113020,82L-IMPORT PAYROLL-APULI LINDSAY,D108,HJ,,130.11,101457.59
6170,11/30/2020,11/30/2020,113020,82L-IMPORT PAYROLL-AUSTIN PERCY ANTONIO,D108,HJ,,130.11,101327.48
6170,11/30/2020,11/30/2020,113020,82L-IMPORT PAYROLL-CAIN CORY,D108,HJ,,136.92,101190.56
6170,11/30/2020,11/30/2020,113020,82L-IMPORT PAYROLL-DADA ARIKPO E,D108,HJ,,390.22,100800.34
6170,11/30/2020,11/30/2020,113020,82L-IMPORT PAYROLL-GUTHRIE LESLIE,D108,HJ,,136.92,100663.42
6170,11/30/2020,11/30/2020,113020,82L-IMPORT PAYROLL-HOLMES JOREL ALEXANDER,D108,HJ,,136.92,100526.5
6170,11/30/2020,11/30/2020,113020,82L-IMPORT PAYROLL-JORDAN TIFFANY T,D108,HJ,,240.7,100285.8
6170,11/30/2020,11/30/2020,113020,82L-IMPORT PAYROLL-ONICA ANTHONY J,D108,HJ,,136.92,100148.88
6170,11/30/2020,11/30/2020,113020,82L-IMPORT PAYROLL-PRAHIN NICOLE M,D108,HJ,,130.11,100018.77
6170,11/30/2020,11/30/2020,113020,82L-IMPORT PAYROLL-SALIM YASSER,D108,HJ,,136.92,99881.85
6170,11/30/2020,11/30/2020,113020,82L-IMPORT PAYROLL-SEJOUR MAHALIAH,D108,HJ,,136.92,99744.93
6170,11/30/2020,11/30/2020,113020,82L-IMPORT PAYROLL-SKALSKI CHRISTOPHER,D108,HJ,,130.11,99614.82
6170,11/30/2020,11/30/2020,113020,82L-IMPORT PAYROLL-TUMENJARGAL ENKHJIN,D108,HJ,,130.11,99484.71
6170,11/30/2020,11/30/2020,113020,82L-IMPORT PAYROLL-VILLEGAS EVELYN,D108,HJ,,390.22,99094.49
6170,11/30/2020,11/30/2020,113020,82L-IMPORT PAYROLL-WOLF ANNA A,D108,HJ,,130.11,98964.38
6170,11/30/2020,11/30/2020,113020,82L-IMPORT PAYROLL-ACEVEDO MONIVETT,D107,HJ,,240.7,98723.68
6170,11/30/2020,11/30/2020,113020,82L-IMPORT PAYROLL-AKLESTAD ISABEL,D111,HJ,,130.11,98593.57
6170,11/30/2020,11/30/2020,113020,82L-IMPORT PAYROLL-BIBB TIFFANI,D104,HJ,,370.8,98222.77
6170,11/30/2020,11/30/2020,113020,82L-IMPORT PAYROLL-COOK CATHRYN ANNA,D105,HJ,,136.92,98085.85
6170,11/30/2020,11/30/2020,113020,82L-IMPORT PAYROLL-COOPER ASHLEE R,D101,HJ,,136.92,97948.93
6170,11/30/2020,11/30/2020,113020,82L-IMPORT PAYROLL-DETONE KYRA MAYA,D102,HJ,,130.11,97818.82
6170,11/30/2020,11/30/2020,113020,82L-IMPORT PAYROLL-DUPUIS CHRISTOPHER M,D107,HJ,,136.92,97681.9
6170,11/30/2020,11/30/2020,113020,82L-IMPORT PAYROLL-FISCHABER THOMAS,D109,HJ,,390.22,97291.68
6170,11/30/2020,11/30/2020,113020,82L-IMPORT PAYROLL-GUADARRAMA-ALVAREZ URIEL A,D105,HJ,,130.11,97161.57
6170,11/30/2020,11/30/2020,113020,82L-IMPORT PAYROLL-GUTIERREZ ANTONIO J,D107,HJ,,370.8,96790.77
6170,11/30/2020,11/30/2020,113020,82L-IMPORT PAYROLL-HOLT ADAM,D109,HJ,,136.92,96653.85
6170,11/30/2020,11/30/2020,113020,82L-IMPORT PAYROLL-MARKS KRISTA,D109,HJ,,136.92,96516.93
6170,11/30/2020,11/30/2020,113020,82L-IMPORT PAYROLL-MELVIN DARNELL KEVIN,D109,HJ,,130.11,96386.82
6170,11/30/2020,11/30/2020,113020,82L-IMPORT PAYROLL-MESSING JENNIFER,D104,HJ,,130.11,96256.71
6170,11/30/2020,11/30/2020,113020,82L-IMPORT PAYROLL-MILNE ROGER,D109,HJ,,136.92,96119.79
6170,11/30/2020,11/30/2020,113020,82L-IMPORT PAYROLL-PARHAM-GANTT DENISE M,D112,HJ,,273.84,95845.95
6170,11/30/2020,11/30/2020,113020,82L-IMPORT PAYROLL-PEINADO ELIZABETH R,D111,HJ,,130.11,95715.84
6170,11/30/2020,11/30/2020,113020,82L-IMPORT PAYROLL-PERNIA JEFFREY,D109,HJ,,130.11,95585.73
6170,11/30/2020,11/30/2020,113020,82L-IMPORT PAYROLL-POLANCO ODALIS,D103,HJ,,130.11,95455.62
6170,11/30/2020,11/30/2020,113020,82L-IMPORT PAYROLL-QUINTAS JASHIVE,D105,HJ,,136.92,95318.7
6170,11/30/2020,11/30/2020,113020,82L-IMPORT PAYROLL-RANDOLPH ALEXANDER,D111,HJ,,130.11,95188.59
6170,11/30/2020,11/30/2020,113020,82L-IMPORT PAYROLL-RUBI PERLA,D101,HJ,,136.92,95051.67
6170,11/30/2020,11/30/2020,113020,82L-IMPORT PAYROLL-SAFRAN ALAN P,D107,HJ,,390.22,94661.45
6170,11/30/2020,11/30/2020,113020,82L-IMPORT PAYROLL-WALLACE AMENA,D104,HJ,,130.11,94531.34
6170,11/30/2020,11/30/2020,113020,82L-IMPORT PAYROLL-WARD JEFFREY,D109,HJ,,390.22,94141.12
6170,11/30/2020,11/30/2020,113020,82L-IMPORT PAYROLL-WEINSTOCK EMILY,D101,HJ,,136.92,94004.2
6170,11/30/2020,11/30/2020,113020,82L-IMPORT PAYROLL-BARTOLD DEANNA MARIE,D108,HJ,,130.11,93874.09
6170,11/30/2020,11/30/2020,113020,82L-IMPORT PAYROLL-BELLOT GENESIS,D108,HJ,,136.92,93737.17
6170,11/30/2020,11/30/2020,113020,82L-IMPORT PAYROLL-BURRELL RUSSELL,D108,HJ,,65,93672.17
6170,11/30/2020,11/30/2020,113020,82L-IMPORT PAYROLL-FEIGHERY JOHN,D108,HJ,,130.11,93542.06
6170,11/30/2020,11/30/2020,113020,82L-IMPORT PAYROLL-GREENE BROOKE,D108,HJ,,65,93477.06
6170,11/30/2020,11/30/2020,113020,82L-IMPORT PAYROLL-GRIFFIN ANDREW,D108,HJ,,136.92,93340.14
6170,11/30/2020,11/30/2020,113020,82L-IMPORT PAYROLL-GROSS EMILY,D108,HJ,,136.92,93203.22
6170,11/30/2020,11/30/2020,113020,82L-IMPORT PAYROLL-HALLINAN GABRIEL,D108,HJ,,136.92,93066.3
6170,11/30/2020,11/30/2020,113020,82L-IMPORT PAYROLL-HAMERSLY WILLIAM,D108,HJ,,130.11,92936.19
6170,11/30/2020,11/30/2020,113020,82L-IMPORT PAYROLL-JACKSON TASNIM F,D108,HJ,,136.92,92799.27
6170,11/30/2020,11/30/2020,113020,82L-IMPORT PAYROLL-LI BELLA,D108,HJ,,130.11,92669.16
6170,11/30/2020,11/30/2020,113020,82L-IMPORT PAYROLL-OPUH NDIDI,D108,HJ,,390.22,92278.94
6170,11/30/2020,11/30/2020,113020,82L-IMPORT PAYROLL-SCHWETTMANN CLAIRE,D108,HJ,,65,92213.94
6170,11/30/2020,11/30/2020,113020,82L-IMPORT PAYROLL-SOBELMAN JUSTIN,D108,HJ,,65,92148.94
6170,11/30/2020,11/30/2020,113020,82L-IMPORT PAYROLL-TERRENCE-SMITH ZIHIR,D108,HJ,,65,92083.94
6170,11/30/2020,11/30/2020,113020,82L-IMPORT PAYROLL-COVENEY ALLISON,D108,HJ,,136.92,91947.02
6170,11/30/2020,11/30/2020,113020,82L-IMPORT PAYROLL-JACKSON CLAICE M,D108,HJ,,136.92,91810.1
6170,11/30/2020,11/30/2020,113020,82L-IMPORT PAYROLL-JANG DANIEL,D108,HJ,,130.11,91679.99
6170,11/30/2020,11/30/2020,113020,82L-IMPORT PAYROLL-LENEGHAN MARYELLEN,D108,HJ,,130.11,91549.88
6170,12/1/2020,12/1/2020,BCBS,December BCBS Payment-BCBS - December BCBS,D108,HJ,7771.29,,99321.17
6170,12/1/2020,12/1/2020,BCBS,December BCBS Payment-BCBS - December BCBS,D108,HJ,8545.47,,107866.64
6170,12/1/2020,12/1/2020,BCBS,December BCBS Payment-BCBS - December BCBS,D107,HJ,14989.69,,122856.33
6170,12/1/2020,12/1/2020,BCBS,December BCBS Payment-BCBS - December BCBS,D108,HJ,7608.99,,130465.32
6170,12/1/2020,12/1/2020,BCBS,December BCBS Payment-BCBS - December BCBS,D108,HJ,2844.67,,133309.99
6170,12/8/2020,12/8/2020,20201208,Julia Martin insurance repayment-Julia Martin insurance repayment,D108,HJ,,527.54,132782.45
6170,12/15/2020,12/15/2020,121520,82L-IMPORT PAYROLL-BARTHELEMY RACHALIE,D108,HJ,,65,132717.45
6170,12/15/2020,12/15/2020,121520,82L-IMPORT PAYROLL-BASHAM WILLIAM EDWARD,D108,HJ,,65,132652.45
6170,12/15/2020,12/15/2020,121520,82L-IMPORT PAYROLL-BROWN ISAAC,D108,HJ,,65,132587.45
6170,12/15/2020,12/15/2020,121520,82L-IMPORT PAYROLL-KHAN HUDA,D108,HJ,,65,132522.45
6170,12/15/2020,12/15/2020,121520,82L-IMPORT PAYROLL-KNOWLIN ZYLIA,D108,HJ,,136.92,132385.53
6170,12/15/2020,12/15/2020,121520,82L-IMPORT PAYROLL-KOPSHEVER MELISSA,D108,HJ,,240.7,132144.83
6170,12/15/2020,12/15/2020,121520,82L-IMPORT PAYROLL-LI SEN YUAN,D108,HJ,,65,132079.83
6170,12/15/2020,12/15/2020,121520,82L-IMPORT PAYROLL-LIPSCOMB STEPHEN,D108,HJ,,136.92,131942.91
6170,12/15/2020,12/15/2020,121520,82L-IMPORT PAYROLL-MEJIA ROSO CARLOS,D108,HJ,,65,131877.91
6170,12/15/2020,12/15/2020,121520,82L-IMPORT PAYROLL-SCOTT KIRK DONOVAN,D108,HJ,,65,131812.91
6170,12/15/2020,12/15/2020,121520,82L-IMPORT PAYROLL-SILVER KELLY,D108,HJ,,136.92,131675.99
6170,12/15/2020,12/15/2020,121520,82L-IMPORT PAYROLL-STEIN KYLE,D108,HJ,,136.92,131539.07
6170,12/15/2020,12/15/2020,121520,82L-IMPORT PAYROLL-VALCIN SABRINA JEMIMAH,D108,HJ,,65,131474.07
6170,12/15/2020,12/15/2020,121520,82L-IMPORT PAYROLL-APULI LINDSAY,D108,HJ,,130.11,131343.96
6170,12/15/2020,12/15/2020,121520,82L-IMPORT PAYROLL-AUSTIN PERCY ANTONIO,D108,HJ,,130.11,131213.85
6170,12/15/2020,12/15/2020,121520,82L-IMPORT PAYROLL-CAIN CORY,D108,HJ,,136.92,131076.93
6170,12/15/2020,12/15/2020,121520,82L-IMPORT PAYROLL-DADA ARIKPO E,D108,HJ,,390.22,130686.71
6170,12/15/2020,12/15/2020,121520,82L-IMPORT PAYROLL-GUTHRIE LESLIE,D108,HJ,,136.92,130549.79
6170,12/15/2020,12/15/2020,121520,82L-IMPORT PAYROLL-HOLMES JOREL ALEXANDER,D108,HJ,,136.92,130412.87
6170,12/15/2020,12/15/2020,121520,82L-IMPORT PAYROLL-JORDAN TIFFANY T,D108,HJ,,240.7,130172.17
6170,12/15/2020,12/15/2020,121520,82L-IMPORT PAYROLL-ONICA ANTHONY J,D108,HJ,,136.92,130035.25
6170,12/15/2020,12/15/2020,121520,82L-IMPORT PAYROLL-PRAHIN NICOLE M,D108,HJ,,130.11,129905.14
6170,12/15/2020,12/15/2020,121520,82L-IMPORT PAYROLL-SALIM YASSER,D108,HJ,,136.92,129768.22
6170,12/15/2020,12/15/2020,121520,82L-IMPORT PAYROLL-SEJOUR MAHALIAH,D108,HJ,,136.92,129631.3
6170,12/15/2020,12/15/2020,121520,82L-IMPORT PAYROLL-SKALSKI CHRISTOPHER,D108,HJ,,130.11,129501.19
6170,12/15/2020,12/15/2020,121520,82L-IMPORT PAYROLL-TUMENJARGAL ENKHJIN,D108,HJ,,130.11,129371.08
6170,12/15/2020,12/15/2020,121520,82L-IMPORT PAYROLL-VILLEGAS EVELYN,D108,HJ,,390.22,128980.86
6170,12/15/2020,12/15/2020,121520,82L-IMPORT PAYROLL-WOLF ANNA A,D108,HJ,,130.11,128850.75
6170,12/15/2020,12/15/2020,121520,82L-IMPORT PAYROLL-ACEVEDO MONIVETT,D107,HJ,,240.7,128610.05
6170,12/15/2020,12/15/2020,121520,82L-IMPORT PAYROLL-AKLESTAD ISABEL,D111,HJ,,130.11,128479.94
6170,12/15/2020,12/15/2020,121520,82L-IMPORT PAYROLL-BIBB TIFFANI,D104,HJ,,370.8,128109.14
6170,12/15/2020,12/15/2020,121520,82L-IMPORT PAYROLL-COOK CATHRYN ANNA,D105,HJ,,136.92,127972.22
6170,12/15/2020,12/15/2020,121520,82L-IMPORT PAYROLL-COOPER ASHLEE R,D101,HJ,,136.92,127835.3
6170,12/15/2020,12/15/2020,121520,82L-IMPORT PAYROLL-DETONE KYRA MAYA,D102,HJ,,130.11,127705.19
6170,12/15/2020,12/15/2020,121520,82L-IMPORT PAYROLL-DUPUIS CHRISTOPHER M,D107,HJ,,136.92,127568.27
6170,12/15/2020,12/15/2020,121520,82L-IMPORT PAYROLL-FISCHABER THOMAS,D109,HJ,,390.22,127178.05
6170,12/15/2020,12/15/2020,121520,82L-IMPORT PAYROLL-GUADARRAMA-ALVAREZ URIEL A,D105,HJ,,130.11,127047.94
6170,12/15/2020,12/15/2020,121520,82L-IMPORT PAYROLL-GUTIERREZ ANTONIO J,D107,HJ,,370.8,126677.14
6170,12/15/2020,12/15/2020,121520,82L-IMPORT PAYROLL-HOLT ADAM,D109,HJ,,136.92,126540.22
6170,12/15/2020,12/15/2020,121520,82L-IMPORT PAYROLL-MARKS KRISTA,D109,HJ,,136.92,126403.3
6170,12/15/2020,12/15/2020,121520,82L-IMPORT PAYROLL-MELVIN DARNELL KEVIN,D109,HJ,,130.11,126273.19
6170,12/15/2020,12/15/2020,121520,82L-IMPORT PAYROLL-MESSING JENNIFER,D109,HJ,,130.11,126143.08
6170,12/15/2020,12/15/2020,121520,82L-IMPORT PAYROLL-MILNE ROGER,D109,HJ,,136.92,126006.16
6170,12/15/2020,12/15/2020,121520,82L-IMPORT PAYROLL-PARHAM-GANTT DENISE M,D112,HJ,,273.84,125732.32
6170,12/15/2020,12/15/2020,121520,82L-IMPORT PAYROLL-PEINADO ELIZABETH R,D111,HJ,,130.11,125602.21
6170,12/15/2020,12/15/2020,121520,82L-IMPORT PAYROLL-PERNIA JEFFREY,D109,HJ,,130.11,125472.1
6170,12/15/2020,12/15/2020,121520,82L-IMPORT PAYROLL-POLANCO ODALIS,D103,HJ,,130.11,125341.99
6170,12/15/2020,12/15/2020,121520,82L-IMPORT PAYROLL-QUINTAS JASHIVE,D105,HJ,,136.92,125205.07
6170,12/15/2020,12/15/2020,121520,82L-IMPORT PAYROLL-RANDOLPH ALEXANDER,D111,HJ,,130.11,125074.96
6170,12/15/2020,12/15/2020,121520,82L-IMPORT PAYROLL-RUBI PERLA,D101,HJ,,136.92,124938.04
6170,12/15/2020,12/15/2020,121520,82L-IMPORT PAYROLL-SAFRAN ALAN P,D107,HJ,,390.22,124547.82
6170,12/15/2020,12/15/2020,121520,82L-IMPORT PAYROLL-WALLACE AMENA,D104,HJ,,130.11,124417.71
6170,12/15/2020,12/15/2020,121520,82L-IMPORT PAYROLL-WARD JEFFREY,D109,HJ,,390.22,124027.49
6170,12/15/2020,12/15/2020,121520,82L-IMPORT PAYROLL-WEINSTOCK EMILY,D101,HJ,,136.92,123890.57
6170,12/15/2020,12/15/2020,121520,82L-IMPORT PAYROLL-BARTOLD DEANNA MARIE,D108,HJ,,130.11,123760.46
6170,12/15/2020,12/15/2020,121520,82L-IMPORT PAYROLL-BELLOT GENESIS,D108,HJ,,136.92,123623.54
6170,12/15/2020,12/15/2020,121520,82L-IMPORT PAYROLL-BURRELL RUSSELL,D108,HJ,,65,123558.54
6170,12/15/2020,12/15/2020,121520,82L-IMPORT PAYROLL-FEIGHERY JOHN,D108,HJ,,130.11,123428.43
6170,12/15/2020,12/15/2020,121520,82L-IMPORT PAYROLL-GREENE BROOKE,D108,HJ,,65,123363.43
6170,12/15/2020,12/15/2020,121520,82L-IMPORT PAYROLL-GRIFFIN ANDREW,D108,HJ,,136.92,123226.51
6170,12/15/2020,12/15/2020,121520,82L-IMPORT PAYROLL-GROSS EMILY,D108,HJ,,136.92,123089.59
6170,12/15/2020,12/15/2020,121520,82L-IMPORT PAYROLL-HALLINAN GABRIEL,D108,HJ,,136.92,122952.67
6170,12/15/2020,12/15/2020,121520,82L-IMPORT PAYROLL-HAMERSLY WILLIAM,D108,HJ,,130.11,122822.56
6170,12/15/2020,12/15/2020,121520,82L-IMPORT PAYROLL-JACKSON TASNIM F,D108,HJ,,136.92,122685.64
6170,12/15/2020,12/15/2020,121520,82L-IMPORT PAYROLL-LI BELLA,D108,HJ,,130.11,122555.53
6170,12/15/2020,12/15/2020,121520,82L-IMPORT PAYROLL-OPUH NDIDI,D108,HJ,,390.22,122165.31
6170,12/15/2020,12/15/2020,121520,82L-IMPORT PAYROLL-SCHWETTMANN CLAIRE,D108,HJ,,65,122100.31
6170,12/15/2020,12/15/2020,121520,82L-IMPORT PAYROLL-SOBELMAN JUSTIN,D108,HJ,,65,122035.31
6170,12/15/2020,12/15/2020,121520,82L-IMPORT PAYROLL-TERRENCE-SMITH ZIHIR,D108,HJ,,65,121970.31
6170,12/15/2020,12/15/2020,121520,82L-IMPORT PAYROLL-COVENEY ALLISON,D108,HJ,,136.92,121833.39
6170,12/15/2020,12/15/2020,121520,82L-IMPORT PAYROLL-JACKSON CLAICE M,D108,HJ,,136.92,121696.47
6170,12/15/2020,12/15/2020,121520,82L-IMPORT PAYROLL-JANG DANIEL,D108,HJ,,130.11,121566.36
6170,12/15/2020,12/15/2020,121520,82L-IMPORT PAYROLL-LENEGHAN MARYELLEN,D108,HJ,,130.11,121436.25
6170,12/31/2020,12/31/2020,123120,82L-IMPORT PAYROLL-BARTHELEMY RACHALIE,D108,HJ,,65,121371.25
6170,12/31/2020,12/31/2020,123120,82L-IMPORT PAYROLL-BASHAM WILLIAM EDWARD,D108,HJ,,65,121306.25
6170,12/31/2020,12/31/2020,123120,82L-IMPORT PAYROLL-BROWN ISAAC,D108,HJ,,65,121241.25
6170,12/31/2020,12/31/2020,123120,82L-IMPORT PAYROLL-KHAN HUDA,D108,HJ,,65,121176.25
6170,12/31/2020,12/31/2020,123120,82L-IMPORT PAYROLL-KNOWLIN ZYLIA,D108,HJ,,136.92,121039.33
6170,12/31/2020,12/31/2020,123120,82L-IMPORT PAYROLL-KOPSHEVER MELISSA,D108,HJ,,240.7,120798.63
6170,12/31/2020,12/31/2020,123120,82L-IMPORT PAYROLL-LI SEN YUAN,D108,HJ,,65,120733.63
6170,12/31/2020,12/31/2020,123120,82L-IMPORT PAYROLL-LIPSCOMB STEPHEN,D108,HJ,,136.92,120596.71
6170,12/31/2020,12/31/2020,123120,82L-IMPORT PAYROLL-MEJIA ROSO CARLOS,D108,HJ,,65,120531.71
6170,12/31/2020,12/31/2020,123120,82L-IMPORT PAYROLL-SCOTT KIRK DONOVAN,D108,HJ,,65,120466.71
6170,12/31/2020,12/31/2020,123120,82L-IMPORT PAYROLL-SILVER KELLY,D108,HJ,,136.92,120329.79
6170,12/31/2020,12/31/2020,123120,82L-IMPORT PAYROLL-STEIN KYLE,D108,HJ,,136.92,120192.87
6170,12/31/2020,12/31/2020,123120,82L-IMPORT PAYROLL-VALCIN SABRINA JEMIMAH,D108,HJ,,65,120127.87
6170,12/31/2020,12/31/2020,123120,82L-IMPORT PAYROLL-APULI LINDSAY,D108,HJ,,130.11,119997.76
6170,12/31/2020,12/31/2020,123120,82L-IMPORT PAYROLL-AUSTIN PERCY ANTONIO,D108,HJ,,130.11,119867.65
6170,12/31/2020,12/31/2020,123120,82L-IMPORT PAYROLL-CAIN CORY,D108,HJ,,136.92,119730.73
6170,12/31/2020,12/31/2020,123120,82L-IMPORT PAYROLL-DADA ARIKPO E,D108,HJ,,390.22,119340.51
6170,12/31/2020,12/31/2020,123120,82L-IMPORT PAYROLL-GUTHRIE LESLIE,D108,HJ,,136.92,119203.59
6170,12/31/2020,12/31/2020,123120,82L-IMPORT PAYROLL-HOLMES JOREL ALEXANDER,D108,HJ,,136.92,119066.67
6170,12/31/2020,12/31/2020,123120,82L-IMPORT PAYROLL-JORDAN TIFFANY T,D108,HJ,,240.7,118825.97
6170,12/31/2020,12/31/2020,123120,82L-IMPORT PAYROLL-ONICA ANTHONY J,D108,HJ,,136.92,118689.05
6170,12/31/2020,12/31/2020,123120,82L-IMPORT PAYROLL-PRAHIN NICOLE M,D108,HJ,,130.11,118558.94
6170,12/31/2020,12/31/2020,123120,82L-IMPORT PAYROLL-SALIM YASSER,D108,HJ,,136.92,118422.02
6170,12/31/2020,12/31/2020,123120,82L-IMPORT PAYROLL-SEJOUR MAHALIAH,D108,HJ,,136.92,118285.1
6170,12/31/2020,12/31/2020,123120,82L-IMPORT PAYROLL-SKALSKI CHRISTOPHER,D108,HJ,,130.11,118154.99
6170,12/31/2020,12/31/2020,123120,82L-IMPORT PAYROLL-TUMENJARGAL ENKHJIN,D108,HJ,,130.11,118024.88
6170,12/31/2020,12/31/2020,123120,82L-IMPORT PAYROLL-VILLEGAS EVELYN,D108,HJ,,390.22,117634.66
6170,12/31/2020,12/31/2020,123120,82L-IMPORT PAYROLL-WOLF ANNA A,D108,HJ,,130.11,117504.55
6170,12/31/2020,12/31/2020,123120,82L-IMPORT PAYROLL-ACEVEDO MONIVETT,D107,HJ,,240.7,117263.85
6170,12/31/2020,12/31/2020,123120,82L-IMPORT PAYROLL-AKLESTAD ISABEL,D111,HJ,,130.11,117133.74
6170,12/31/2020,12/31/2020,123120,82L-IMPORT PAYROLL-BIBB TIFFANI,D104,HJ,,370.8,116762.94
6170,12/31/2020,12/31/2020,123120,82L-IMPORT PAYROLL-COOK CATHRYN ANNA,D105,HJ,,136.92,116626.02
6170,12/31/2020,12/31/2020,123120,82L-IMPORT PAYROLL-COOPER ASHLEE R,D101,HJ,,136.92,116489.1
6170,12/31/2020,12/31/2020,123120,82L-IMPORT PAYROLL-DETONE KYRA MAYA,D102,HJ,,130.11,116358.99
6170,12/31/2020,12/31/2020,123120,82L-IMPORT PAYROLL-DUPUIS CHRISTOPHER M,D107,HJ,,136.92,116222.07
6170,12/31/2020,12/31/2020,123120,82L-IMPORT PAYROLL-FISCHABER THOMAS,D109,HJ,,390.22,115831.85
6170,12/31/2020,12/31/2020,123120,82L-IMPORT PAYROLL-GUADARRAMA-ALVAREZ URIEL A,D105,HJ,,130.11,115701.74
6170,12/31/2020,12/31/2020,123120,82L-IMPORT PAYROLL-GUTIERREZ ANTONIO J,D107,HJ,,370.8,115330.94
6170,12/31/2020,12/31/2020,123120,82L-IMPORT PAYROLL-HOLT ADAM,D109,HJ,,136.92,115194.02
6170,12/31/2020,12/31/2020,123120,82L-IMPORT PAYROLL-MARKS KRISTA,D109,HJ,,136.92,115057.1
6170,12/31/2020,12/31/2020,123120,82L-IMPORT PAYROLL-MELVIN DARNELL KEVIN,D109,HJ,,130.11,114926.99
6170,12/31/2020,12/31/2020,123120,82L-IMPORT PAYROLL-MESSING JENNIFER,D109,HJ,,130.11,114796.88
6170,12/31/2020,12/31/2020,123120,82L-IMPORT PAYROLL-MILNE ROGER,D109,HJ,,136.92,114659.96
6170,12/31/2020,12/31/2020,123120,82L-IMPORT PAYROLL-PARHAM-GANTT DENISE M,D112,HJ,,273.84,114386.12
6170,12/31/2020,12/31/2020,123120,82L-IMPORT PAYROLL-PEINADO ELIZABETH R,D111,HJ,,130.11,114256.01
6170,12/31/2020,12/31/2020,123120,82L-IMPORT PAYROLL-PERNIA JEFFREY,D109,HJ,,130.11,114125.9
6170,12/31/2020,12/31/2020,123120,82L-IMPORT PAYROLL-POLANCO ODALIS,D103,HJ,,130.11,113995.79
6170,12/31/2020,12/31/2020,123120,82L-IMPORT PAYROLL-QUINTAS JASHIVE,D105,HJ,,136.92,113858.87
6170,12/31/2020,12/31/2020,123120,82L-IMPORT PAYROLL-RANDOLPH ALEXANDER,D111,HJ,,130.11,113728.76
6170,12/31/2020,12/31/2020,123120,82L-IMPORT PAYROLL-RUBI PERLA,D101,HJ,,136.92,113591.84
6170,12/31/2020,12/31/2020,123120,82L-IMPORT PAYROLL-SAFRAN ALAN P,D107,HJ,,390.22,113201.62
6170,12/31/2020,12/31/2020,123120,82L-IMPORT PAYROLL-WALLACE AMENA,D104,HJ,,130.11,113071.51
6170,12/31/2020,12/31/2020,123120,82L-IMPORT PAYROLL-WARD JEFFREY,D109,HJ,,390.22,112681.29
6170,12/31/2020,12/31/2020,123120,82L-IMPORT PAYROLL-WEINSTOCK EMILY,D101,HJ,,136.92,112544.37
6170,12/31/2020,12/31/2020,123120,82L-IMPORT PAYROLL-BARTOLD DEANNA MARIE,D108,HJ,,130.11,112414.26
6170,12/31/2020,12/31/2020,123120,82L-IMPORT PAYROLL-BELLOT GENESIS,D108,HJ,,136.92,112277.34
6170,12/31/2020,12/31/2020,123120,82L-IMPORT PAYROLL-BURRELL RUSSELL,D108,HJ,,65,112212.34
6170,12/31/2020,12/31/2020,123120,82L-IMPORT PAYROLL-FEIGHERY JOHN,D108,HJ,,130.11,112082.23
6170,12/31/2020,12/31/2020,123120,82L-IMPORT PAYROLL-GREENE BROOKE,D108,HJ,,65,112017.23
6170,12/31/2020,12/31/2020,123120,82L-IMPORT PAYROLL-GRIFFIN ANDREW,D108,HJ,,136.92,111880.31
6170,12/31/2020,12/31/2020,123120,82L-IMPORT PAYROLL-GROSS EMILY,D108,HJ,,136.92,111743.39
6170,12/31/2020,12/31/2020,123120,82L-IMPORT PAYROLL-HALLINAN GABRIEL,D108,HJ,,136.92,111606.47
6170,12/31/2020,12/31/2020,123120,82L-IMPORT PAYROLL-HAMERSLY WILLIAM,D108,HJ,,130.11,111476.36
6170,12/31/2020,12/31/2020,123120,82L-IMPORT PAYROLL-JACKSON TASNIM F,D108,HJ,,136.92,111339.44
6170,12/31/2020,12/31/2020,123120,82L-IMPORT PAYROLL-LI BELLA,D108,HJ,,130.11,111209.33
6170,12/31/2020,12/31/2020,123120,82L-IMPORT PAYROLL-OPUH NDIDI,D108,HJ,,390.22,110819.11
6170,12/31/2020,12/31/2020,123120,82L-IMPORT PAYROLL-SCHWETTMANN CLAIRE,D108,HJ,,65,110754.11
6170,12/31/2020,12/31/2020,123120,82L-IMPORT PAYROLL-SOBELMAN JUSTIN,D108,HJ,,65,110689.11
6170,12/31/2020,12/31/2020,123120,82L-IMPORT PAYROLL-TERRENCE-SMITH ZIHIR,D108,HJ,,65,110624.11
6170,12/31/2020,12/31/2020,123120,82L-IMPORT PAYROLL-COVENEY ALLISON,D108,HJ,,136.92,110487.19
6170,12/31/2020,12/31/2020,123120,82L-IMPORT PAYROLL-JACKSON CLAICE M,D108,HJ,,136.92,110350.27
6170,12/31/2020,12/31/2020,123120,82L-IMPORT PAYROLL-JANG DANIEL,D108,HJ,,130.11,110220.16
6170,12/31/2020,12/31/2020,123120,82L-IMPORT PAYROLL-LENEGHAN MARYELLEN,D108,HJ,,130.11,110090.05
6170,1/4/2021,1/4/2021,BCBS,January 2021 BCBS Payment-BCBS - January 2021 BCBS,D108,HJ,8793.45,,118883.5
6170,1/4/2021,1/4/2021,BCBS,January 2021 BCBS Payment-BCBS - January 2021 BCBS,D108,HJ,8545.47,,127428.97
6170,1/4/2021,1/4/2021,BCBS,January 2021 BCBS Payment-BCBS - January 2021 BCBS,D107,HJ,23879.63,,151308.6
6170,1/4/2021,1/4/2021,BCBS,January 2021 BCBS Payment-BCBS - January 2021 BCBS,D108,HJ,7608.99,,158917.59
6170,1/4/2021,1/4/2021,BCBS,January 2021 BCBS Payment-BCBS - January 2021 BCBS,D108,HJ,433.3,,159350.89
6170,1/7/2021,1/7/2021,20210107,Julia Martin insurance repayment January 2021-Julia Martin insurance repayment January 2021,D108,HJ,,527.54,158823.35
6170,1/15/2021,1/15/2021,11521,82L-IMPORT PAYROLL-BARTHELEMY RACHALIE,D108,HJ,,65,158758.35
6170,1/15/2021,1/15/2021,11521,82L-IMPORT PAYROLL-BROWN ISAAC,D108,HJ,,65,158693.35
6170,1/15/2021,1/15/2021,11521,82L-IMPORT PAYROLL-KHAN HUDA,D108,HJ,,65,158628.35
6170,1/15/2021,1/15/2021,11521,82L-IMPORT PAYROLL-KNOWLIN ZYLIA,D108,HJ,,136.92,158491.43
6170,1/15/2021,1/15/2021,11521,82L-IMPORT PAYROLL-LI SEN YUAN,D108,HJ,,65,158426.43
6170,1/15/2021,1/15/2021,11521,82L-IMPORT PAYROLL-LIPSCOMB STEPHEN,D108,HJ,,136.92,158289.51
6170,1/15/2021,1/15/2021,11521,82L-IMPORT PAYROLL-MEJIA ROSO CARLOS,D108,HJ,,65,158224.51
6170,1/15/2021,1/15/2021,11521,82L-IMPORT PAYROLL-SCOTT KIRK DONOVAN,D108,HJ,,65,158159.51
6170,1/15/2021,1/15/2021,11521,82L-IMPORT PAYROLL-SILVER KELLY,D108,HJ,,136.92,158022.59
6170,1/15/2021,1/15/2021,11521,82L-IMPORT PAYROLL-STEIN KYLE,D108,HJ,,136.92,157885.67
6170,1/15/2021,1/15/2021,11521,82L-IMPORT PAYROLL-VALCIN SABRINA JEMIMAH,D108,HJ,,65,157820.67
6170,1/15/2021,1/15/2021,11521,82L-IMPORT PAYROLL-APULI LINDSAY,D108,HJ,,130.11,157690.56
6170,1/15/2021,1/15/2021,11521,82L-IMPORT PAYROLL-AUSTIN PERCY ANTONIO,D108,HJ,,130.11,157560.45
6170,1/15/2021,1/15/2021,11521,82L-IMPORT PAYROLL-CAIN CORY,D108,HJ,,136.92,157423.53
6170,1/15/2021,1/15/2021,11521,82L-IMPORT PAYROLL-DADA ARIKPO E,D108,HJ,,390.22,157033.31
6170,1/15/2021,1/15/2021,11521,82L-IMPORT PAYROLL-GUTHRIE LESLIE,D108,HJ,,136.92,156896.39
6170,1/15/2021,1/15/2021,11521,82L-IMPORT PAYROLL-HOLMES JOREL ALEXANDER,D108,HJ,,136.92,156759.47
6170,1/15/2021,1/15/2021,11521,82L-IMPORT PAYROLL-JORDAN TIFFANY T,D108,HJ,,240.7,156518.77
6170,1/15/2021,1/15/2021,11521,82L-IMPORT PAYROLL-ONICA ANTHONY J,D108,HJ,,136.92,156381.85
6170,1/15/2021,1/15/2021,11521,82L-IMPORT PAYROLL-PRAHIN NICOLE M,D108,HJ,,130.11,156251.74
6170,1/15/2021,1/15/2021,11521,82L-IMPORT PAYROLL-SALIM YASSER,D108,HJ,,136.92,156114.82
6170,1/15/2021,1/15/2021,11521,82L-IMPORT PAYROLL-SEJOUR MAHALIAH,D108,HJ,,136.92,155977.9
6170,1/15/2021,1/15/2021,11521,82L-IMPORT PAYROLL-SKALSKI CHRISTOPHER,D108,HJ,,130.11,155847.79
6170,1/15/2021,1/15/2021,11521,82L-IMPORT PAYROLL-TUMENJARGAL ENKHJIN,D108,HJ,,130.11,155717.68
6170,1/15/2021,1/15/2021,11521,82L-IMPORT PAYROLL-VILLEGAS EVELYN,D108,HJ,,390.22,155327.46
6170,1/15/2021,1/15/2021,11521,82L-IMPORT PAYROLL-WOLF ANNA A,D108,HJ,,130.11,155197.35
6170,1/15/2021,1/15/2021,11521,82L-IMPORT PAYROLL-ACEVEDO MONIVETT,D107,HJ,,240.7,154956.65
6170,1/15/2021,1/15/2021,11521,82L-IMPORT PAYROLL-AKLESTAD ISABEL,D111,HJ,,130.11,154826.54
6170,1/15/2021,1/15/2021,11521,82L-IMPORT PAYROLL-BIBB TIFFANI,D104,HJ,,370.8,154455.74
6170,1/15/2021,1/15/2021,11521,82L-IMPORT PAYROLL-COOK CATHRYN ANNA,D105,HJ,,136.92,154318.82
6170,1/15/2021,1/15/2021,11521,82L-IMPORT PAYROLL-COOPER ASHLEE R,D101,HJ,,136.92,154181.9
6170,1/15/2021,1/15/2021,11521,82L-IMPORT PAYROLL-DETONE KYRA MAYA,D102,HJ,,130.11,154051.79
6170,1/15/2021,1/15/2021,11521,82L-IMPORT PAYROLL-DUPUIS CHRISTOPHER M,D107,HJ,,136.92,153914.87
6170,1/15/2021,1/15/2021,11521,82L-IMPORT PAYROLL-FEENEY CLAIRE,D104,HJ,,136.92,153777.95
6170,1/15/2021,1/15/2021,11521,82L-IMPORT PAYROLL-FISCHABER THOMAS,D109,HJ,,390.22,153387.73
6170,1/15/2021,1/15/2021,11521,82L-IMPORT PAYROLL-GUADARRAMA-ALVAREZ URIEL A,D105,HJ,,130.11,153257.62
6170,1/15/2021,1/15/2021,11521,82L-IMPORT PAYROLL-GUTIERREZ ANTONIO J,D107,HJ,,370.8,152886.82
6170,1/15/2021,1/15/2021,11521,82L-IMPORT PAYROLL-HERNANDEZ ANNA,D101,HJ,,130.11,152756.71
6170,1/15/2021,1/15/2021,11521,82L-IMPORT PAYROLL-HOLT ADAM,D109,HJ,,136.92,152619.79
6170,1/15/2021,1/15/2021,11521,82L-IMPORT PAYROLL-MARKS KRISTA,D109,HJ,,136.92,152482.87
6170,1/15/2021,1/15/2021,11521,82L-IMPORT PAYROLL-MELVIN DARNELL KEVIN,D109,HJ,,130.11,152352.76
6170,1/15/2021,1/15/2021,11521,82L-IMPORT PAYROLL-MESSING JENNIFER,D104,HJ,,130.11,152222.65
6170,1/15/2021,1/15/2021,11521,82L-IMPORT PAYROLL-MILNE ROGER,D109,HJ,,136.92,152085.73
6170,1/15/2021,1/15/2021,11521,82L-IMPORT PAYROLL-PARHAM-GANTT DENISE M,D112,HJ,,273.84,151811.89
6170,1/15/2021,1/15/2021,11521,82L-IMPORT PAYROLL-PEINADO ELIZABETH R,D111,HJ,,130.11,151681.78
6170,1/15/2021,1/15/2021,11521,82L-IMPORT PAYROLL-PERNIA JEFFREY,D109,HJ,,130.11,151551.67
6170,1/15/2021,1/15/2021,11521,82L-IMPORT PAYROLL-POLANCO ODALIS,D103,HJ,,130.11,151421.56
6170,1/15/2021,1/15/2021,11521,82L-IMPORT PAYROLL-QUINTAS JASHIVE,D105,HJ,,136.92,151284.64
6170,1/15/2021,1/15/2021,11521,82L-IMPORT PAYROLL-RANDOLPH ALEXANDER,D111,HJ,,130.11,151154.53
6170,1/15/2021,1/15/2021,11521,82L-IMPORT PAYROLL-RUBI PERLA,D101,HJ,,136.92,151017.61
6170,1/15/2021,1/15/2021,11521,82L-IMPORT PAYROLL-SAFRAN ALAN P,D107,HJ,,390.22,150627.39
6170,1/15/2021,1/15/2021,11521,82L-IMPORT PAYROLL-WALLACE AMENA,D104,HJ,,130.11,150497.28
6170,1/15/2021,1/15/2021,11521,82L-IMPORT PAYROLL-WARD JEFFREY,D109,HJ,,390.22,150107.06
6170,1/15/2021,1/15/2021,11521,82L-IMPORT PAYROLL-WEINSTOCK EMILY,D101,HJ,,136.92,149970.14
6170,1/15/2021,1/15/2021,11521,82L-IMPORT PAYROLL-BARTOLD DEANNA MARIE,D108,HJ,,130.11,149840.03
6170,1/15/2021,1/15/2021,11521,82L-IMPORT PAYROLL-BELLOT GENESIS,D108,HJ,,136.92,149703.11
6170,1/15/2021,1/15/2021,11521,82L-IMPORT PAYROLL-BURRELL RUSSELL,D108,HJ,,65,149638.11
6170,1/15/2021,1/15/2021,11521,82L-IMPORT PAYROLL-FEIGHERY JOHN,D108,HJ,,130.11,149508
6170,1/15/2021,1/15/2021,11521,82L-IMPORT PAYROLL-GREENE BROOKE,D108,HJ,,65,149443
6170,1/15/2021,1/15/2021,11521,82L-IMPORT PAYROLL-GRIFFIN ANDREW,D108,HJ,,136.92,149306.08
6170,1/15/2021,1/15/2021,11521,82L-IMPORT PAYROLL-GROSS EMILY,D108,HJ,,136.92,149169.16
6170,1/15/2021,1/15/2021,11521,82L-IMPORT PAYROLL-HALLINAN GABRIEL,D108,HJ,,136.92,149032.24
6170,1/15/2021,1/15/2021,11521,82L-IMPORT PAYROLL-HAMERSLY WILLIAM,D108,HJ,,130.11,148902.13
6170,1/15/2021,1/15/2021,11521,82L-IMPORT PAYROLL-JACKSON TASNIM F,D108,HJ,,136.92,148765.21
6170,1/15/2021,1/15/2021,11521,82L-IMPORT PAYROLL-LI BELLA,D108,HJ,,130.11,148635.1
6170,1/15/2021,1/15/2021,11521,82L-IMPORT PAYROLL-OPUH NDIDI,D108,HJ,,390.22,148244.88
6170,1/15/2021,1/15/2021,11521,82L-IMPORT PAYROLL-SCHWETTMANN CLAIRE,D108,HJ,,65,148179.88
6170,1/15/2021,1/15/2021,11521,82L-IMPORT PAYROLL-SOBELMAN JUSTIN,D108,HJ,,65,148114.88
6170,1/15/2021,1/15/2021,11521,82L-IMPORT PAYROLL-TERRENCE-SMITH ZIHIR,D108,HJ,,65,148049.88
6170,1/15/2021,1/15/2021,11521,82L-IMPORT PAYROLL-COVENEY ALLISON,D108,HJ,,136.92,147912.96
6170,1/15/2021,1/15/2021,11521,82L-IMPORT PAYROLL-JACKSON CLAICE M,D108,HJ,,136.92,147776.04
6170,1/15/2021,1/15/2021,11521,82L-IMPORT PAYROLL-JANG DANIEL,D108,HJ,,130.11,147645.93
6170,1/15/2021,1/15/2021,11521,82L-IMPORT PAYROLL-LENEGHAN MARYELLEN,D108,HJ,,130.11,147515.82
6170,1/29/2021,1/29/2021,12921,82L-IMPORT PAYROLL-BARTHELEMY RACHALIE,D108,HJ,,65,147450.82
6170,1/29/2021,1/29/2021,12921,82L-IMPORT PAYROLL-BROWN ISAAC,D108,HJ,,65,147385.82
6170,1/29/2021,1/29/2021,12921,82L-IMPORT PAYROLL-KHAN HUDA,D108,HJ,,65,147320.82
6170,1/29/2021,1/29/2021,12921,82L-IMPORT PAYROLL-KNOWLIN ZYLIA,D108,HJ,,253.3,147067.52
6170,1/29/2021,1/29/2021,12921,82L-IMPORT PAYROLL-LI SEN YUAN,D108,HJ,,65,147002.52
6170,1/29/2021,1/29/2021,12921,82L-IMPORT PAYROLL-LIPSCOMB STEPHEN,D108,HJ,,136.92,146865.6
6170,1/29/2021,1/29/2021,12921,82L-IMPORT PAYROLL-MEJIA ROSO CARLOS,D108,HJ,,65,146800.6
6170,1/29/2021,1/29/2021,12921,82L-IMPORT PAYROLL-SCOTT KIRK DONOVAN,D108,HJ,,65,146735.6
6170,1/29/2021,1/29/2021,12921,82L-IMPORT PAYROLL-SILVER KELLY,D108,HJ,,136.92,146598.68
6170,1/29/2021,1/29/2021,12921,82L-IMPORT PAYROLL-STEIN KYLE,D108,HJ,,136.92,146461.76
6170,1/29/2021,1/29/2021,12921,82L-IMPORT PAYROLL-VALCIN SABRINA JEMIMAH,D108,HJ,,65,146396.76
6170,1/29/2021,1/29/2021,12921,82L-IMPORT PAYROLL-APULI LINDSAY,D108,HJ,,130.11,146266.65
6170,1/29/2021,1/29/2021,12921,82L-IMPORT PAYROLL-AUSTIN PERCY ANTONIO,D108,HJ,,130.11,146136.54
6170,1/29/2021,1/29/2021,12921,82L-IMPORT PAYROLL-CAIN CORY,D108,HJ,,136.92,145999.62
6170,1/29/2021,1/29/2021,12921,82L-IMPORT PAYROLL-DADA ARIKPO E,D108,HJ,,390.22,145609.4
6170,1/29/2021,1/29/2021,12921,82L-IMPORT PAYROLL-GUTHRIE LESLIE,D108,HJ,,136.92,145472.48
6170,1/29/2021,1/29/2021,12921,82L-IMPORT PAYROLL-HOLMES JOREL ALEXANDER,D108,HJ,,136.92,145335.56
6170,1/29/2021,1/29/2021,12921,82L-IMPORT PAYROLL-JORDAN TIFFANY T,D108,HJ,,240.7,145094.86
6170,1/29/2021,1/29/2021,12921,82L-IMPORT PAYROLL-ONICA ANTHONY J,D108,HJ,,136.92,144957.94
6170,1/29/2021,1/29/2021,12921,82L-IMPORT PAYROLL-PRAHIN NICOLE M,D108,HJ,,130.11,144827.83
6170,1/29/2021,1/29/2021,12921,82L-IMPORT PAYROLL-SALIM YASSER,D108,HJ,,136.92,144690.91
6170,1/29/2021,1/29/2021,12921,82L-IMPORT PAYROLL-SEJOUR MAHALIAH,D108,HJ,,136.92,144553.99
6170,1/29/2021,1/29/2021,12921,82L-IMPORT PAYROLL-SKALSKI CHRISTOPHER,D108,HJ,,130.11,144423.88
6170,1/29/2021,1/29/2021,12921,82L-IMPORT PAYROLL-TUMENJARGAL ENKHJIN,D108,HJ,,130.11,144293.77
6170,1/29/2021,1/29/2021,12921,82L-IMPORT PAYROLL-VILLEGAS EVELYN,D108,HJ,,390.22,143903.55
6170,1/29/2021,1/29/2021,12921,82L-IMPORT PAYROLL-WOLF ANNA A,D108,HJ,,130.11,143773.44
6170,1/29/2021,1/29/2021,12921,82L-IMPORT PAYROLL-ACEVEDO MONIVETT,D107,HJ,,240.7,143532.74
6170,1/29/2021,1/29/2021,12921,82L-IMPORT PAYROLL-AKLESTAD ISABEL,D111,HJ,,130.11,143402.63
6170,1/29/2021,1/29/2021,12921,82L-IMPORT PAYROLL-BIBB TIFFANI,D104,HJ,,370.8,143031.83
6170,1/29/2021,1/29/2021,12921,82L-IMPORT PAYROLL-COOK CATHRYN ANNA,D105,HJ,,136.92,142894.91
6170,1/29/2021,1/29/2021,12921,82L-IMPORT PAYROLL-COOPER ASHLEE R,D101,HJ,,136.92,142757.99
6170,1/29/2021,1/29/2021,12921,82L-IMPORT PAYROLL-DETONE KYRA MAYA,D102,HJ,,130.11,142627.88
6170,1/29/2021,1/29/2021,12921,82L-IMPORT PAYROLL-DUPUIS CHRISTOPHER M,D107,HJ,,136.92,142490.96
6170,1/29/2021,1/29/2021,12921,82L-IMPORT PAYROLL-FEENEY CLAIRE,D104,HJ,,136.92,142354.04
6170,1/29/2021,1/29/2021,12921,82L-IMPORT PAYROLL-FISCHABER THOMAS,D109,HJ,,390.22,141963.82
6170,1/29/2021,1/29/2021,12921,82L-IMPORT PAYROLL-GUADARRAMA-ALVAREZ URIEL A,D105,HJ,,130.11,141833.71
6170,1/29/2021,1/29/2021,12921,82L-IMPORT PAYROLL-GUTIERREZ ANTONIO J,D107,HJ,,370.8,141462.91
6170,1/29/2021,1/29/2021,12921,82L-IMPORT PAYROLL-HERNANDEZ ANNA,D101,HJ,,130.11,141332.8
6170,1/29/2021,1/29/2021,12921,82L-IMPORT PAYROLL-HOLT ADAM,D109,HJ,,136.92,141195.88
6170,1/29/2021,1/29/2021,12921,82L-IMPORT PAYROLL-MARKS KRISTA,D109,HJ,,136.92,141058.96
6170,1/29/2021,1/29/2021,12921,82L-IMPORT PAYROLL-MELVIN DARNELL KEVIN,D109,HJ,,130.11,140928.85
6170,1/29/2021,1/29/2021,12921,82L-IMPORT PAYROLL-MESSING JENNIFER,D104,HJ,,130.11,140798.74
6170,1/29/2021,1/29/2021,12921,82L-IMPORT PAYROLL-MILNE ROGER,D109,HJ,,136.92,140661.82
6170,1/29/2021,1/29/2021,12921,82L-IMPORT PAYROLL-O'DONNELL STEPHEN,D104,HJ,,136.92,140524.9
6170,1/29/2021,1/29/2021,12921,82L-IMPORT PAYROLL-PARHAM-GANTT DENISE M,D112,HJ,,273.84,140251.06
6170,1/29/2021,1/29/2021,12921,82L-IMPORT PAYROLL-PEINADO ELIZABETH R,D111,HJ,,130.11,140120.95
6170,1/29/2021,1/29/2021,12921,82L-IMPORT PAYROLL-PERNIA JEFFREY,D109,HJ,,130.11,139990.84
6170,1/29/2021,1/29/2021,12921,82L-IMPORT PAYROLL-POLANCO ODALIS,D103,HJ,,130.11,139860.73
6170,1/29/2021,1/29/2021,12921,82L-IMPORT PAYROLL-QUINTAS JASHIVE,D105,HJ,,136.92,139723.81
6170,1/29/2021,1/29/2021,12921,82L-IMPORT PAYROLL-RANDOLPH ALEXANDER,D111,HJ,,130.11,139593.7
6170,1/29/2021,1/29/2021,12921,82L-IMPORT PAYROLL-RUBI PERLA,D101,HJ,,136.92,139456.78
6170,1/29/2021,1/29/2021,12921,82L-IMPORT PAYROLL-SAFRAN ALAN P,D107,HJ,,390.22,139066.56
6170,1/29/2021,1/29/2021,12921,82L-IMPORT PAYROLL-WALLACE AMENA,D104,HJ,,130.11,138936.45
6170,1/29/2021,1/29/2021,12921,82L-IMPORT PAYROLL-WARD JEFFREY,D109,HJ,,390.22,138546.23
6170,1/29/2021,1/29/2021,12921,82L-IMPORT PAYROLL-WEINSTOCK EMILY,D101,HJ,,136.92,138409.31
6170,1/29/2021,1/29/2021,12921,82L-IMPORT PAYROLL-BARTOLD DEANNA MARIE,D108,HJ,,130.11,138279.2
6170,1/29/2021,1/29/2021,12921,82L-IMPORT PAYROLL-BELLOT GENESIS,D108,HJ,,136.92,138142.28
6170,1/29/2021,1/29/2021,12921,82L-IMPORT PAYROLL-BURRELL RUSSELL,D108,HJ,,65,138077.28
6170,1/29/2021,1/29/2021,12921,82L-IMPORT PAYROLL-FEIGHERY JOHN,D108,HJ,,130.11,137947.17
6170,1/29/2021,1/29/2021,12921,82L-IMPORT PAYROLL-GREENE BROOKE,D108,HJ,,65,137882.17
6170,1/29/2021,1/29/2021,12921,82L-IMPORT PAYROLL-GRIFFIN ANDREW,D108,HJ,,136.92,137745.25
6170,1/29/2021,1/29/2021,12921,82L-IMPORT PAYROLL-GROSS EMILY,D108,HJ,,136.92,137608.33
6170,1/29/2021,1/29/2021,12921,82L-IMPORT PAYROLL-HALLINAN GABRIEL,D108,HJ,,136.92,137471.41
6170,1/29/2021,1/29/2021,12921,82L-IMPORT PAYROLL-HAMERSLY WILLIAM,D108,HJ,,130.11,137341.3
6170,1/29/2021,1/29/2021,12921,82L-IMPORT PAYROLL-JACKSON TASNIM F,D108,HJ,,136.92,137204.38
6170,1/29/2021,1/29/2021,12921,82L-IMPORT PAYROLL-LI BELLA,D108,HJ,,130.11,137074.27
6170,1/29/2021,1/29/2021,12921,82L-IMPORT PAYROLL-OPUH NDIDI,D108,HJ,,390.22,136684.05
6170,1/29/2021,1/29/2021,12921,82L-IMPORT PAYROLL-SCHWETTMANN CLAIRE,D108,HJ,,65,136619.05
6170,1/29/2021,1/29/2021,12921,82L-IMPORT PAYROLL-SOBELMAN JUSTIN,D108,HJ,,65,136554.05
6170,1/29/2021,1/29/2021,12921,82L-IMPORT PAYROLL-TERRENCE-SMITH ZIHIR,D108,HJ,,65,136489.05
6170,1/29/2021,1/29/2021,12921,82L-IMPORT PAYROLL-COVENEY ALLISON,D108,HJ,,136.92,136352.13
6170,1/29/2021,1/29/2021,12921,82L-IMPORT PAYROLL-JACKSON CLAICE M,D108,HJ,,136.92,136215.21
6170,1/29/2021,1/29/2021,12921,82L-IMPORT PAYROLL-JANG DANIEL,D108,HJ,,130.11,136085.1
6170,1/29/2021,1/29/2021,12921,82L-IMPORT PAYROLL-LENEGHAN MARYELLEN,D108,HJ,,130.11,135954.99
6170,2/1/2021,2/1/2021,BCBS,BCBS February Payment-BCBS - February 2021 BCBS,D108,HJ,5737.47,,141692.46
6170,2/1/2021,2/1/2021,BCBS,BCBS February Payment-BCBS - February 2021 BCBS,D108,HJ,8545.47,,150237.93
6170,2/1/2021,2/1/2021,BCBS,BCBS February Payment-BCBS - February 2021 BCBS,D107,HJ,15379.07,,165617
6170,2/1/2021,2/1/2021,BCBS,BCBS February Payment-BCBS - February 2021 BCBS,D108,HJ,7608.99,,173225.99
6170,2/1/2021,2/1/2021,BCBS,BCBS February Payment-BCBS - February 2021 BCBS,D108,HJ,2324.24,,175550.23
6170,2/12/2021,2/12/2021,21221,82L-IMPORT PAYROLL-BARTHELEMY RACHALIE,D108,HJ,,65,175485.23
6170,2/12/2021,2/12/2021,21221,82L-IMPORT PAYROLL-BROWN ISAAC,D108,HJ,,65,175420.23
6170,2/12/2021,2/12/2021,21221,82L-IMPORT PAYROLL-GARCIA SANTIAGO,D108,HJ,,136.92,175283.31
6170,2/12/2021,2/12/2021,21221,82L-IMPORT PAYROLL-KHAN HUDA,D108,HJ,,65,175218.31
6170,2/12/2021,2/12/2021,21221,82L-IMPORT PAYROLL-KNOWLIN ZYLIA,D108,HJ,,253.3,174965.01
6170,2/12/2021,2/12/2021,21221,82L-IMPORT PAYROLL-LI SEN YUAN,D108,HJ,,65,174900.01
6170,2/12/2021,2/12/2021,21221,82L-IMPORT PAYROLL-LIPSCOMB STEPHEN,D108,HJ,,136.92,174763.09
6170,2/12/2021,2/12/2021,21221,82L-IMPORT PAYROLL-MEJIA ROSO CARLOS,D108,HJ,,65,174698.09
6170,2/12/2021,2/12/2021,21221,82L-IMPORT PAYROLL-SCOTT KIRK DONOVAN,D108,HJ,,65,174633.09
6170,2/12/2021,2/12/2021,21221,82L-IMPORT PAYROLL-SILVER KELLY,D108,HJ,,136.92,174496.17
6170,2/12/2021,2/12/2021,21221,82L-IMPORT PAYROLL-STEIN KYLE,D108,HJ,,136.92,174359.25
6170,2/12/2021,2/12/2021,21221,82L-IMPORT PAYROLL-VALCIN SABRINA JEMIMAH,D108,HJ,,65,174294.25
6170,2/12/2021,2/12/2021,21221,82L-IMPORT PAYROLL-APULI LINDSAY,D108,HJ,,130.11,174164.14
6170,2/12/2021,2/12/2021,21221,82L-IMPORT PAYROLL-AUSTIN PERCY ANTONIO,D108,HJ,,130.11,174034.03
6170,2/12/2021,2/12/2021,21221,82L-IMPORT PAYROLL-CAIN CORY,D108,HJ,,136.92,173897.11
6170,2/12/2021,2/12/2021,21221,82L-IMPORT PAYROLL-DADA ARIKPO E,D108,HJ,,390.22,173506.89
6170,2/12/2021,2/12/2021,21221,82L-IMPORT PAYROLL-GUTHRIE LESLIE,D108,HJ,,136.92,173369.97
6170,2/12/2021,2/12/2021,21221,82L-IMPORT PAYROLL-HOLMES JOREL ALEXANDER,D108,HJ,,136.92,173233.05
6170,2/12/2021,2/12/2021,21221,82L-IMPORT PAYROLL-JORDAN TIFFANY T,D108,HJ,,240.7,172992.35
6170,2/12/2021,2/12/2021,21221,82L-IMPORT PAYROLL-ONICA ANTHONY J,D108,HJ,,136.92,172855.43
6170,2/12/2021,2/12/2021,21221,82L-IMPORT PAYROLL-PRAHIN NICOLE M,D108,HJ,,130.11,172725.32
6170,2/12/2021,2/12/2021,21221,82L-IMPORT PAYROLL-SALIM YASSER,D108,HJ,,136.92,172588.4
6170,2/12/2021,2/12/2021,21221,82L-IMPORT PAYROLL-SEJOUR MAHALIAH,D108,HJ,,136.92,172451.48
6170,2/12/2021,2/12/2021,21221,82L-IMPORT PAYROLL-SKALSKI CHRISTOPHER,D108,HJ,,130.11,172321.37
6170,2/12/2021,2/12/2021,21221,82L-IMPORT PAYROLL-TUMENJARGAL ENKHJIN,D108,HJ,,130.11,172191.26
6170,2/12/2021,2/12/2021,21221,82L-IMPORT PAYROLL-VILLEGAS EVELYN,D108,HJ,,390.22,171801.04
6170,2/12/2021,2/12/2021,21221,82L-IMPORT PAYROLL-WOLF ANNA A,D108,HJ,,130.11,171670.93
6170,2/12/2021,2/12/2021,21221,82L-IMPORT PAYROLL-ACEVEDO MONIVETT,D107,HJ,,240.7,171430.23
6170,2/12/2021,2/12/2021,21221,82L-IMPORT PAYROLL-AKLESTAD ISABEL,D111,HJ,,130.11,171300.12
6170,2/12/2021,2/12/2021,21221,82L-IMPORT PAYROLL-BIBB TIFFANI,D104,HJ,,370.8,170929.32
6170,2/12/2021,2/12/2021,21221,82L-IMPORT PAYROLL-COOK CATHRYN ANNA,D105,HJ,,136.92,170792.4
6170,2/12/2021,2/12/2021,21221,82L-IMPORT PAYROLL-COOPER ASHLEE R,D101,HJ,,136.92,170655.48
6170,2/12/2021,2/12/2021,21221,82L-IMPORT PAYROLL-CORTEZ MIRANDA A,D111,HJ,,136.92,170518.56
6170,2/12/2021,2/12/2021,21221,82L-IMPORT PAYROLL-DETONE KYRA MAYA,D102,HJ,,130.11,170388.45
6170,2/12/2021,2/12/2021,21221,82L-IMPORT PAYROLL-DUPUIS CHRISTOPHER M,D107,HJ,,136.92,170251.53
6170,2/12/2021,2/12/2021,21221,82L-IMPORT PAYROLL-FEENEY CLAIRE,D104,HJ,,136.92,170114.61
6170,2/12/2021,2/12/2021,21221,82L-IMPORT PAYROLL-FISCHABER THOMAS,D109,HJ,,390.22,169724.39
6170,2/12/2021,2/12/2021,21221,82L-IMPORT PAYROLL-GUADARRAMA-ALVAREZ URIEL A,D105,HJ,,130.11,169594.28
6170,2/12/2021,2/12/2021,21221,82L-IMPORT PAYROLL-GUTIERREZ ANTONIO J,D107,HJ,,370.8,169223.48
6170,2/12/2021,2/12/2021,21221,82L-IMPORT PAYROLL-HERNANDEZ ANNA,D101,HJ,,130.11,169093.37
6170,2/12/2021,2/12/2021,21221,82L-IMPORT PAYROLL-HOLT ADAM,D109,HJ,,136.92,168956.45
6170,2/12/2021,2/12/2021,21221,82L-IMPORT PAYROLL-IWASAKI MIKA,D101,HJ,,130.11,168826.34
6170,2/12/2021,2/12/2021,21221,82L-IMPORT PAYROLL-MARKS KRISTA,D109,HJ,,136.92,168689.42
6170,2/12/2021,2/12/2021,21221,82L-IMPORT PAYROLL-MELVIN DARNELL KEVIN,D109,HJ,,130.11,168559.31
6170,2/12/2021,2/12/2021,21221,82L-IMPORT PAYROLL-MESSING JENNIFER,D104,HJ,,130.11,168429.2
6170,2/12/2021,2/12/2021,21221,82L-IMPORT PAYROLL-MILNE ROGER,D109,HJ,,136.92,168292.28
6170,2/12/2021,2/12/2021,21221,82L-IMPORT PAYROLL-O'DONNELL STEPHEN,D104,HJ,,136.92,168155.36
6170,2/12/2021,2/12/2021,21221,82L-IMPORT PAYROLL-PARHAM-GANTT DENISE M,D112,HJ,,273.84,167881.52
6170,2/12/2021,2/12/2021,21221,82L-IMPORT PAYROLL-PEINADO ELIZABETH R,D111,HJ,,130.11,167751.41
6170,2/12/2021,2/12/2021,21221,82L-IMPORT PAYROLL-PERNIA JEFFREY,D109,HJ,,130.11,167621.3
6170,2/12/2021,2/12/2021,21221,82L-IMPORT PAYROLL-POLANCO ODALIS,D103,HJ,,130.11,167491.19
6170,2/12/2021,2/12/2021,21221,82L-IMPORT PAYROLL-QUINTAS JASHIVE,D105,HJ,,136.92,167354.27
6170,2/12/2021,2/12/2021,21221,82L-IMPORT PAYROLL-RANDOLPH ALEXANDER,D111,HJ,,130.11,167224.16
6170,2/12/2021,2/12/2021,21221,82L-IMPORT PAYROLL-RUBI PERLA,D101,HJ,,136.92,167087.24
6170,2/12/2021,2/12/2021,21221,82L-IMPORT PAYROLL-SAFRAN ALAN P,D107,HJ,,390.22,166697.02
6170,2/12/2021,2/12/2021,21221,82L-IMPORT PAYROLL-WALLACE AMENA,D104,HJ,,130.11,166566.91
6170,2/12/2021,2/12/2021,21221,82L-IMPORT PAYROLL-WARD JEFFREY,D109,HJ,,390.22,166176.69
6170,2/12/2021,2/12/2021,21221,82L-IMPORT PAYROLL-WEINSTOCK EMILY,D101,HJ,,136.92,166039.77
6170,2/12/2021,2/12/2021,21221,82L-IMPORT PAYROLL-BARTOLD DEANNA MARIE,D108,HJ,,130.11,165909.66
6170,2/12/2021,2/12/2021,21221,82L-IMPORT PAYROLL-BELLOT GENESIS,D108,HJ,,136.92,165772.74
6170,2/12/2021,2/12/2021,21221,82L-IMPORT PAYROLL-BURRELL RUSSELL,D108,HJ,,65,165707.74
6170,2/12/2021,2/12/2021,21221,82L-IMPORT PAYROLL-FEIGHERY JOHN,D108,HJ,,130.11,165577.63
6170,2/12/2021,2/12/2021,21221,82L-IMPORT PAYROLL-GREENE BROOKE,D108,HJ,,65,165512.63
6170,2/12/2021,2/12/2021,21221,82L-IMPORT PAYROLL-GRIFFIN ANDREW,D108,HJ,,136.92,165375.71
6170,2/12/2021,2/12/2021,21221,82L-IMPORT PAYROLL-GROSS EMILY,D108,HJ,,136.92,165238.79
6170,2/12/2021,2/12/2021,21221,82L-IMPORT PAYROLL-HALLINAN GABRIEL,D108,HJ,,136.92,165101.87
6170,2/12/2021,2/12/2021,21221,82L-IMPORT PAYROLL-HAMERSLY WILLIAM,D108,HJ,,130.11,164971.76
6170,2/12/2021,2/12/2021,21221,82L-IMPORT PAYROLL-JACKSON TASNIM F,D108,HJ,,136.92,164834.84
6170,2/12/2021,2/12/2021,21221,82L-IMPORT PAYROLL-LI BELLA,D108,HJ,,130.11,164704.73
6170,2/12/2021,2/12/2021,21221,82L-IMPORT PAYROLL-OPUH NDIDI,D108,HJ,,390.22,164314.51
6170,2/12/2021,2/12/2021,21221,82L-IMPORT PAYROLL-SCHWETTMANN CLAIRE,D108,HJ,,65,164249.51
6170,2/12/2021,2/12/2021,21221,82L-IMPORT PAYROLL-SOBELMAN JUSTIN,D108,HJ,,65,164184.51
6170,2/12/2021,2/12/2021,21221,82L-IMPORT PAYROLL-TERRENCE-SMITH ZIHIR,D108,HJ,,65,164119.51
6170,2/12/2021,2/12/2021,21221,82L-IMPORT PAYROLL-COVENEY ALLISON,D108,HJ,,136.92,163982.59
6170,2/12/2021,2/12/2021,21221,82L-IMPORT PAYROLL-JACKSON CLAICE M,D108,HJ,,136.92,163845.67
6170,2/12/2021,2/12/2021,21221,82L-IMPORT PAYROLL-JANG DANIEL,D108,HJ,,130.11,163715.56
6170,2/12/2021,2/12/2021,21221,82L-IMPORT PAYROLL-LENEGHAN MARYELLEN,D108,HJ,,130.11,163585.45
6170,2/26/2021,2/26/2021,22621,82L-IMPORT PAYROLL-BARTHELEMY RACHALIE,D108,HJ,,65,163520.45
6170,2/26/2021,2/26/2021,22621,82L-IMPORT PAYROLL-BROWN ISAAC,D108,HJ,,65,163455.45
6170,2/26/2021,2/26/2021,22621,82L-IMPORT PAYROLL-GARCIA SANTIAGO,D108,HJ,,136.92,163318.53
6170,2/26/2021,2/26/2021,22621,82L-IMPORT PAYROLL-KHAN HUDA,D108,HJ,,65,163253.53
6170,2/26/2021,2/26/2021,22621,82L-IMPORT PAYROLL-KNOWLIN ZYLIA,D108,HJ,,253.3,163000.23
6170,2/26/2021,2/26/2021,22621,82L-IMPORT PAYROLL-LI SEN YUAN,D108,HJ,,65,162935.23
6170,2/26/2021,2/26/2021,22621,82L-IMPORT PAYROLL-LIPSCOMB STEPHEN,D108,HJ,,136.92,162798.31
6170,2/26/2021,2/26/2021,22621,82L-IMPORT PAYROLL-MEJIA ROSO CARLOS,D108,HJ,,65,162733.31
6170,2/26/2021,2/26/2021,22621,82L-IMPORT PAYROLL-SCOTT KIRK DONOVAN,D108,HJ,,65,162668.31
6170,2/26/2021,2/26/2021,22621,82L-IMPORT PAYROLL-SILVER KELLY,D108,HJ,,136.92,162531.39
6170,2/26/2021,2/26/2021,22621,82L-IMPORT PAYROLL-STEIN KYLE,D108,HJ,,136.92,162394.47
6170,2/26/2021,2/26/2021,22621,82L-IMPORT PAYROLL-VALCIN SABRINA JEMIMAH,D108,HJ,,65,162329.47
6170,2/26/2021,2/26/2021,22621,82L-IMPORT PAYROLL-APULI LINDSAY,D108,HJ,,130.11,162199.36
6170,2/26/2021,2/26/2021,22621,82L-IMPORT PAYROLL-AUSTIN PERCY,D108,HJ,,130.11,162069.25
6170,2/26/2021,2/26/2021,22621,82L-IMPORT PAYROLL-CAIN CORY,D108,HJ,,136.92,161932.33
6170,2/26/2021,2/26/2021,22621,82L-IMPORT PAYROLL-DADA ARIKPO E,D108,HJ,,390.22,161542.11
6170,2/26/2021,2/26/2021,22621,82L-IMPORT PAYROLL-GUTHRIE LESLIE,D108,HJ,,136.92,161405.19
6170,2/26/2021,2/26/2021,22621,82L-IMPORT PAYROLL-HOLMES JOREL ALEXANDER,D108,HJ,,136.92,161268.27
6170,2/26/2021,2/26/2021,22621,82L-IMPORT PAYROLL-JORDAN TIFFANY T,D108,HJ,,240.7,161027.57
6170,2/26/2021,2/26/2021,22621,82L-IMPORT PAYROLL-ONICA ANTHONY J,D108,HJ,,136.92,160890.65
6170,2/26/2021,2/26/2021,22621,82L-IMPORT PAYROLL-PRAHIN NICOLE M,D108,HJ,,130.11,160760.54
6170,2/26/2021,2/26/2021,22621,82L-IMPORT PAYROLL-SALIM YASSER,D108,HJ,,136.92,160623.62
6170,2/26/2021,2/26/2021,22621,82L-IMPORT PAYROLL-SEJOUR MAHALIAH,D108,HJ,,136.92,160486.7
6170,2/26/2021,2/26/2021,22621,82L-IMPORT PAYROLL-SKALSKI CHRISTOPHER,D108,HJ,,130.11,160356.59
6170,2/26/2021,2/26/2021,22621,82L-IMPORT PAYROLL-TUMENJARGAL ENKHJIN,D108,HJ,,130.11,160226.48
6170,2/26/2021,2/26/2021,22621,82L-IMPORT PAYROLL-VILLEGAS EVELYN,D108,HJ,,390.22,159836.26
6170,2/26/2021,2/26/2021,22621,82L-IMPORT PAYROLL-WOLF ANNA A,D108,HJ,,130.11,159706.15
6170,2/26/2021,2/26/2021,22621,82L-IMPORT PAYROLL-ACEVEDO MONIVETT,D107,HJ,,240.7,159465.45
6170,2/26/2021,2/26/2021,22621,82L-IMPORT PAYROLL-AKLESTAD ISABEL,D111,HJ,,130.11,159335.34
6170,2/26/2021,2/26/2021,22621,82L-IMPORT PAYROLL-BIBB TIFFANI,D104,HJ,,370.8,158964.54
6170,2/26/2021,2/26/2021,22621,82L-IMPORT PAYROLL-CALVO FERNANDA,D104,HJ,,136.92,158827.62
6170,2/26/2021,2/26/2021,22621,82L-IMPORT PAYROLL-COOK CATHRYN ANNA,D105,HJ,,136.92,158690.7
6170,2/26/2021,2/26/2021,22621,82L-IMPORT PAYROLL-COOPER ASHLEE R,D101,HJ,,136.92,158553.78
6170,2/26/2021,2/26/2021,22621,82L-IMPORT PAYROLL-CORTEZ MIRANDA A,D111,HJ,,136.92,158416.86
6170,2/26/2021,2/26/2021,22621,82L-IMPORT PAYROLL-DETONE KYRA MAYA,D102,HJ,,130.11,158286.75
6170,2/26/2021,2/26/2021,22621,82L-IMPORT PAYROLL-DUPUIS CHRISTOPHER M,D107,HJ,,136.92,158149.83
6170,2/26/2021,2/26/2021,22621,82L-IMPORT PAYROLL-FEENEY CLAIRE,D104,HJ,,136.92,158012.91
6170,2/26/2021,2/26/2021,22621,82L-IMPORT PAYROLL-FISCHABER THOMAS,D109,HJ,,390.22,157622.69
6170,2/26/2021,2/26/2021,22621,82L-IMPORT PAYROLL-GUADARRAMA-ALVAREZ URIEL A,D105,HJ,,130.11,157492.58
6170,2/26/2021,2/26/2021,22621,82L-IMPORT PAYROLL-GUTIERREZ ANTONIO J,D107,HJ,,370.8,157121.78
6170,2/26/2021,2/26/2021,22621,82L-IMPORT PAYROLL-HERNANDEZ ANNA,D101,HJ,,130.11,156991.67
6170,2/26/2021,2/26/2021,22621,82L-IMPORT PAYROLL-HOLT ADAM,D109,HJ,,136.92,156854.75
6170,2/26/2021,2/26/2021,22621,82L-IMPORT PAYROLL-IWASAKI MIKA,D101,HJ,,130.11,156724.64
6170,2/26/2021,2/26/2021,22621,82L-IMPORT PAYROLL-MARKS KRISTA,D109,HJ,,136.92,156587.72
6170,2/26/2021,2/26/2021,22621,82L-IMPORT PAYROLL-MELVIN DARNELL KEVIN,D109,HJ,,130.11,156457.61
6170,2/26/2021,2/26/2021,22621,82L-IMPORT PAYROLL-MESSING JENNIFER,D104,HJ,,130.11,156327.5
6170,2/26/2021,2/26/2021,22621,82L-IMPORT PAYROLL-MILNE ROGER,D109,HJ,,136.92,156190.58
6170,2/26/2021,2/26/2021,22621,82L-IMPORT PAYROLL-O'DONNELL STEPHEN,D104,HJ,,136.92,156053.66
6170,2/26/2021,2/26/2021,22621,82L-IMPORT PAYROLL-PARHAM-GANTT DENISE M,D112,HJ,,273.84,155779.82
6170,2/26/2021,2/26/2021,22621,82L-IMPORT PAYROLL-PEINADO ELIZABETH R,D111,HJ,,130.11,155649.71
6170,2/26/2021,2/26/2021,22621,82L-IMPORT PAYROLL-PERNIA JEFFREY,D109,HJ,,130.11,155519.6
6170,2/26/2021,2/26/2021,22621,82L-IMPORT PAYROLL-POLANCO ODALIS,D103,HJ,,130.11,155389.49
6170,2/26/2021,2/26/2021,22621,82L-IMPORT PAYROLL-QUINTAS JASHIVE,D105,HJ,,136.92,155252.57
6170,2/26/2021,2/26/2021,22621,82L-IMPORT PAYROLL-RANDOLPH ALEXANDER,D111,HJ,,130.11,155122.46
6170,2/26/2021,2/26/2021,22621,82L-IMPORT PAYROLL-RUBI PERLA,D101,HJ,,136.92,154985.54
6170,2/26/2021,2/26/2021,22621,82L-IMPORT PAYROLL-SAFRAN ALAN P,D107,HJ,,390.22,154595.32
6170,2/26/2021,2/26/2021,22621,82L-IMPORT PAYROLL-WALLACE AMENA,D104,HJ,,130.11,154465.21
6170,2/26/2021,2/26/2021,22621,82L-IMPORT PAYROLL-WARD JEFFREY,D109,HJ,,390.22,154074.99
6170,2/26/2021,2/26/2021,22621,82L-IMPORT PAYROLL-WEINSTOCK EMILY,D101,HJ,,136.92,153938.07
6170,2/26/2021,2/26/2021,22621,82L-IMPORT PAYROLL-BARTOLD DEANNA MARIE,D108,HJ,,130.11,153807.96
6170,2/26/2021,2/26/2021,22621,82L-IMPORT PAYROLL-BELLOT GENESIS,D108,HJ,,136.92,153671.04
6170,2/26/2021,2/26/2021,22621,82L-IMPORT PAYROLL-BURRELL RUSSELL,D108,HJ,,65,153606.04
6170,2/26/2021,2/26/2021,22621,82L-IMPORT PAYROLL-FEIGHERY JOHN,D108,HJ,,130.11,153475.93
6170,2/26/2021,2/26/2021,22621,82L-IMPORT PAYROLL-GREENE BROOKE,D108,HJ,,65,153410.93
6170,2/26/2021,2/26/2021,22621,82L-IMPORT PAYROLL-GRIFFIN ANDREW,D108,HJ,,136.92,153274.01
6170,2/26/2021,2/26/2021,22621,82L-IMPORT PAYROLL-GROSS EMILY,D108,HJ,,136.92,153137.09
6170,2/26/2021,2/26/2021,22621,82L-IMPORT PAYROLL-HALLINAN GABRIEL,D108,HJ,,136.92,153000.17
6170,2/26/2021,2/26/2021,22621,82L-IMPORT PAYROLL-HAMERSLY WILLIAM,D108,HJ,,130.11,152870.06
6170,2/26/2021,2/26/2021,22621,82L-IMPORT PAYROLL-JACKSON TASNIM F,D108,HJ,,136.92,152733.14
6170,2/26/2021,2/26/2021,22621,82L-IMPORT PAYROLL-LI BELLA,D108,HJ,,130.11,152603.03
6170,2/26/2021,2/26/2021,22621,82L-IMPORT PAYROLL-OPUH NDIDI,D108,HJ,,390.22,152212.81
6170,2/26/2021,2/26/2021,22621,82L-IMPORT PAYROLL-SCHWETTMANN CLAIRE,D108,HJ,,65,152147.81
6170,2/26/2021,2/26/2021,22621,82L-IMPORT PAYROLL-SOBELMAN JUSTIN,D108,HJ,,65,152082.81
6170,2/26/2021,2/26/2021,22621,82L-IMPORT PAYROLL-TERRENCE-SMITH ZIHIR,D108,HJ,,65,152017.81
6170,2/26/2021,2/26/2021,22621,82L-IMPORT PAYROLL-COVENEY ALLISON,D108,HJ,,136.92,151880.89
6170,2/26/2021,2/26/2021,22621,82L-IMPORT PAYROLL-JACKSON CLAICE M,D108,HJ,,136.92,151743.97
6170,2/26/2021,2/26/2021,22621,82L-IMPORT PAYROLL-JANG DANIEL,D108,HJ,,130.11,151613.86
6170,2/26/2021,2/26/2021,22621,82L-IMPORT PAYROLL-LENEGHAN MARYELLEN,D108,HJ,,130.11,151483.75
6170,3/3/2021,3/3/2021,BCBS,March 2021 BCBS payment,D108,HJ,8911.07,,160394.82
6170,3/3/2021,3/3/2021,BCBS,March 2021 BCBS payment,D108,HJ,8545.47,,168940.29
6170,3/3/2021,3/3/2021,BCBS,March 2021 BCBS payment,D107,HJ,17257.15,,186197.44
6170,3/3/2021,3/3/2021,BCBS,March 2021 BCBS payment,D108,HJ,7608.99,,193806.43
6170,3/3/2021,3/3/2021,BCBS,March 2021 BCBS payment,D108,HJ,2324.24,,196130.67
6170,3/15/2021,3/15/2021,31521,82L-IMPORT PAYROLL,D108,HJ,,65,196065.67
6170,3/15/2021,3/15/2021,31521,82L-IMPORT PAYROLL,D108,HJ,,65,196000.67
6170,3/15/2021,3/15/2021,31521,82L-IMPORT PAYROLL,D108,HJ,,65,195935.67
6170,3/15/2021,3/15/2021,31521,82L-IMPORT PAYROLL,D108,HJ,,65,195870.67
6170,3/15/2021,3/15/2021,31521,82L-IMPORT PAYROLL,D108,HJ,,65,195805.67
6170,3/15/2021,3/15/2021,31521,82L-IMPORT PAYROLL,D108,HJ,,65,195740.67
6170,3/15/2021,3/15/2021,31521,82L-IMPORT PAYROLL,D108,HJ,,65,195675.67
6170,3/15/2021,3/15/2021,31521,82L-IMPORT PAYROLL,D108,HJ,,65,195610.67
6170,3/15/2021,3/15/2021,31521,82L-IMPORT PAYROLL,D108,HJ,,136.92,195473.75
6170,3/15/2021,3/15/2021,31521,82L-IMPORT PAYROLL,D108,HJ,,136.92,195336.83
6170,3/15/2021,3/15/2021,31521,82L-IMPORT PAYROLL,D108,HJ,,136.92,195199.91
6170,3/15/2021,3/15/2021,31521,82L-IMPORT PAYROLL,D108,HJ,,136.92,195062.99
6170,3/15/2021,3/15/2021,31521,82L-IMPORT PAYROLL,D108,HJ,,136.92,194926.07
6170,3/15/2021,3/15/2021,31521,82L-IMPORT PAYROLL,D108,HJ,,253.3,194672.77
6170,3/15/2021,3/15/2021,31521,82L-IMPORT PAYROLL,D108,HJ,,130.11,194542.66
6170,3/15/2021,3/15/2021,31521,82L-IMPORT PAYROLL,D108,HJ,,130.11,194412.55
6170,3/15/2021,3/15/2021,31521,82L-IMPORT PAYROLL,D108,HJ,,130.11,194282.44
6170,3/15/2021,3/15/2021,31521,82L-IMPORT PAYROLL,D108,HJ,,130.11,194152.33
6170,3/15/2021,3/15/2021,31521,82L-IMPORT PAYROLL,D108,HJ,,130.11,194022.22
6170,3/15/2021,3/15/2021,31521,82L-IMPORT PAYROLL,D108,HJ,,130.11,193892.11
6170,3/15/2021,3/15/2021,31521,82L-IMPORT PAYROLL,D108,HJ,,136.92,193755.19
6170,3/15/2021,3/15/2021,31521,82L-IMPORT PAYROLL,D108,HJ,,136.92,193618.27
6170,3/15/2021,3/15/2021,31521,82L-IMPORT PAYROLL,D108,HJ,,136.92,193481.35
6170,3/15/2021,3/15/2021,31521,82L-IMPORT PAYROLL,D108,HJ,,136.92,193344.43
6170,3/15/2021,3/15/2021,31521,82L-IMPORT PAYROLL,D108,HJ,,136.92,193207.51
6170,3/15/2021,3/15/2021,31521,82L-IMPORT PAYROLL,D108,HJ,,136.92,193070.59
6170,3/15/2021,3/15/2021,31521,82L-IMPORT PAYROLL,D108,HJ,,240.7,192829.89
6170,3/15/2021,3/15/2021,31521,82L-IMPORT PAYROLL,D108,HJ,,390.22,192439.67
6170,3/15/2021,3/15/2021,31521,82L-IMPORT PAYROLL,D108,HJ,,390.22,192049.45
6170,3/15/2021,3/15/2021,31521,82L-IMPORT PAYROLL,D101,HJ,,130.11,191919.34
6170,3/15/2021,3/15/2021,31521,82L-IMPORT PAYROLL,D101,HJ,,130.11,191789.23
6170,3/15/2021,3/15/2021,31521,82L-IMPORT PAYROLL,D101,HJ,,136.92,191652.31
6170,3/15/2021,3/15/2021,31521,82L-IMPORT PAYROLL,D101,HJ,,136.92,191515.39
6170,3/15/2021,3/15/2021,31521,82L-IMPORT PAYROLL,D101,HJ,,136.92,191378.47
6170,3/15/2021,3/15/2021,31521,82L-IMPORT PAYROLL,D102,HJ,,130.11,191248.36
6170,3/15/2021,3/15/2021,31521,82L-IMPORT PAYROLL,D103,HJ,,130.11,191118.25
6170,3/15/2021,3/15/2021,31521,82L-IMPORT PAYROLL,D104,HJ,,130.11,190988.14
6170,3/15/2021,3/15/2021,31521,82L-IMPORT PAYROLL,D104,HJ,,130.11,190858.03
6170,3/15/2021,3/15/2021,31521,82L-IMPORT PAYROLL,D104,HJ,,136.92,190721.11
6170,3/15/2021,3/15/2021,31521,82L-IMPORT PAYROLL,D104,HJ,,136.92,190584.19
6170,3/15/2021,3/15/2021,31521,82L-IMPORT PAYROLL,D104,HJ,,136.92,190447.27
6170,3/15/2021,3/15/2021,31521,82L-IMPORT PAYROLL,D104,HJ,,370.8,190076.47
6170,3/15/2021,3/15/2021,31521,82L-IMPORT PAYROLL,D105,HJ,,130.11,189946.36
6170,3/15/2021,3/15/2021,31521,82L-IMPORT PAYROLL,D105,HJ,,136.92,189809.44
6170,3/15/2021,3/15/2021,31521,82L-IMPORT PAYROLL,D105,HJ,,136.92,189672.52
6170,3/15/2021,3/15/2021,31521,82L-IMPORT PAYROLL,D107,HJ,,136.92,189535.6
6170,3/15/2021,3/15/2021,31521,82L-IMPORT PAYROLL,D107,HJ,,240.7,189294.9
6170,3/15/2021,3/15/2021,31521,82L-IMPORT PAYROLL,D107,HJ,,370.8,188924.1
6170,3/15/2021,3/15/2021,31521,82L-IMPORT PAYROLL,D107,HJ,,390.22,188533.88
6170,3/15/2021,3/15/2021,31521,82L-IMPORT PAYROLL,D109,HJ,,130.11,188403.77
6170,3/15/2021,3/15/2021,31521,82L-IMPORT PAYROLL,D109,HJ,,130.11,188273.66
6170,3/15/2021,3/15/2021,31521,82L-IMPORT PAYROLL,D109,HJ,,136.92,188136.74
6170,3/15/2021,3/15/2021,31521,82L-IMPORT PAYROLL,D109,HJ,,136.92,187999.82
6170,3/15/2021,3/15/2021,31521,82L-IMPORT PAYROLL,D109,HJ,,136.92,187862.9
6170,3/15/2021,3/15/2021,31521,82L-IMPORT PAYROLL,D109,HJ,,390.22,187472.68
6170,3/15/2021,3/15/2021,31521,82L-IMPORT PAYROLL,D109,HJ,,390.22,187082.46
6170,3/15/2021,3/15/2021,31521,82L-IMPORT PAYROLL,D111,HJ,,130.11,186952.35
6170,3/15/2021,3/15/2021,31521,82L-IMPORT PAYROLL,D111,HJ,,130.11,186822.24
6170,3/15/2021,3/15/2021,31521,82L-IMPORT PAYROLL,D111,HJ,,130.11,186692.13
6170,3/15/2021,3/15/2021,31521,82L-IMPORT PAYROLL,D111,HJ,,136.92,186555.21
6170,3/15/2021,3/15/2021,31521,82L-IMPORT PAYROLL,D112,HJ,,273.84,186281.37
6170,3/15/2021,3/15/2021,31521,82L-IMPORT PAYROLL,D108,HJ,,65,186216.37
6170,3/15/2021,3/15/2021,31521,82L-IMPORT PAYROLL,D108,HJ,,65,186151.37
6170,3/15/2021,3/15/2021,31521,82L-IMPORT PAYROLL,D108,HJ,,65,186086.37
6170,3/15/2021,3/15/2021,31521,82L-IMPORT PAYROLL,D108,HJ,,65,186021.37
6170,3/15/2021,3/15/2021,31521,82L-IMPORT PAYROLL,D108,HJ,,65,185956.37
6170,3/15/2021,3/15/2021,31521,82L-IMPORT PAYROLL,D108,HJ,,130.11,185826.26
6170,3/15/2021,3/15/2021,31521,82L-IMPORT PAYROLL,D108,HJ,,130.11,185696.15
6170,3/15/2021,3/15/2021,31521,82L-IMPORT PAYROLL,D108,HJ,,130.11,185566.04
6170,3/15/2021,3/15/2021,31521,82L-IMPORT PAYROLL,D108,HJ,,130.11,185435.93
6170,3/15/2021,3/15/2021,31521,82L-IMPORT PAYROLL,D108,HJ,,136.92,185299.01
6170,3/15/2021,3/15/2021,31521,82L-IMPORT PAYROLL,D108,HJ,,136.92,185162.09
6170,3/15/2021,3/15/2021,31521,82L-IMPORT PAYROLL,D108,HJ,,136.92,185025.17
6170,3/15/2021,3/15/2021,31521,82L-IMPORT PAYROLL,D108,HJ,,136.92,184888.25
6170,3/15/2021,3/15/2021,31521,82L-IMPORT PAYROLL,D108,HJ,,136.92,184751.33
6170,3/15/2021,3/15/2021,31521,82L-IMPORT PAYROLL,D108,HJ,,390.22,184361.11
6170,3/15/2021,3/15/2021,31521,82L-IMPORT PAYROLL,D108,HJ,,130.11,184231
6170,3/15/2021,3/15/2021,31521,82L-IMPORT PAYROLL,D108,HJ,,130.11,184100.89
6170,3/15/2021,3/15/2021,31521,82L-IMPORT PAYROLL,D108,HJ,,136.92,183963.97
6170,3/15/2021,3/15/2021,31521,82L-IMPORT PAYROLL,D108,HJ,,136.92,183827.05
6170,3/31/2021,3/31/2021,33121,82L-IMPORT PAYROLL,D108,HJ,,65,183762.05
6170,3/31/2021,3/31/2021,33121,82L-IMPORT PAYROLL,D108,HJ,,65,183697.05
6170,3/31/2021,3/31/2021,33121,82L-IMPORT PAYROLL,D108,HJ,,65,183632.05
6170,3/31/2021,3/31/2021,33121,82L-IMPORT PAYROLL,D108,HJ,,65,183567.05
6170,3/31/2021,3/31/2021,33121,82L-IMPORT PAYROLL,D108,HJ,,65,183502.05
6170,3/31/2021,3/31/2021,33121,82L-IMPORT PAYROLL,D108,HJ,,65,183437.05
6170,3/31/2021,3/31/2021,33121,82L-IMPORT PAYROLL,D108,HJ,,65,183372.05
6170,3/31/2021,3/31/2021,33121,82L-IMPORT PAYROLL,D108,HJ,,136.92,183235.13
6170,3/31/2021,3/31/2021,33121,82L-IMPORT PAYROLL,D108,HJ,,136.92,183098.21
6170,3/31/2021,3/31/2021,33121,82L-IMPORT PAYROLL,D108,HJ,,136.92,182961.29
6170,3/31/2021,3/31/2021,33121,82L-IMPORT PAYROLL,D108,HJ,,136.92,182824.37
6170,3/31/2021,3/31/2021,33121,82L-IMPORT PAYROLL,D108,HJ,,136.92,182687.45
6170,3/31/2021,3/31/2021,33121,82L-IMPORT PAYROLL,D108,HJ,,253.3,182434.15
6170,3/31/2021,3/31/2021,33121,82L-IMPORT PAYROLL,D108,HJ,,130.11,182304.04
6170,3/31/2021,3/31/2021,33121,82L-IMPORT PAYROLL,D108,HJ,,130.11,182173.93
6170,3/31/2021,3/31/2021,33121,82L-IMPORT PAYROLL,D108,HJ,,130.11,182043.82
6170,3/31/2021,3/31/2021,33121,82L-IMPORT PAYROLL,D108,HJ,,130.11,181913.71
6170,3/31/2021,3/31/2021,33121,82L-IMPORT PAYROLL,D108,HJ,,130.11,181783.6
6170,3/31/2021,3/31/2021,33121,82L-IMPORT PAYROLL,D108,HJ,,130.11,181653.49
6170,3/31/2021,3/31/2021,33121,82L-IMPORT PAYROLL,D108,HJ,,136.92,181516.57
6170,3/31/2021,3/31/2021,33121,82L-IMPORT PAYROLL,D108,HJ,,136.92,181379.65
6170,3/31/2021,3/31/2021,33121,82L-IMPORT PAYROLL,D108,HJ,,136.92,181242.73
6170,3/31/2021,3/31/2021,33121,82L-IMPORT PAYROLL,D108,HJ,,136.92,181105.81
6170,3/31/2021,3/31/2021,33121,82L-IMPORT PAYROLL,D108,HJ,,136.92,180968.89
6170,3/31/2021,3/31/2021,33121,82L-IMPORT PAYROLL,D108,HJ,,136.92,180831.97
6170,3/31/2021,3/31/2021,33121,82L-IMPORT PAYROLL,D108,HJ,,240.7,180591.27
6170,3/31/2021,3/31/2021,33121,82L-IMPORT PAYROLL,D108,HJ,,390.22,180201.05
6170,3/31/2021,3/31/2021,33121,82L-IMPORT PAYROLL,D108,HJ,,390.22,179810.83
6170,3/31/2021,3/31/2021,33121,82L-IMPORT PAYROLL,D101,HJ,,130.11,179680.72
6170,3/31/2021,3/31/2021,33121,82L-IMPORT PAYROLL,D101,HJ,,130.11,179550.61
6170,3/31/2021,3/31/2021,33121,82L-IMPORT PAYROLL,D101,HJ,,136.92,179413.69
6170,3/31/2021,3/31/2021,33121,82L-IMPORT PAYROLL,D101,HJ,,136.92,179276.77
6170,3/31/2021,3/31/2021,33121,82L-IMPORT PAYROLL,D101,HJ,,136.92,179139.85
6170,3/31/2021,3/31/2021,33121,82L-IMPORT PAYROLL,D102,HJ,,130.11,179009.74
6170,3/31/2021,3/31/2021,33121,82L-IMPORT PAYROLL,D103,HJ,,130.11,178879.63
6170,3/31/2021,3/31/2021,33121,82L-IMPORT PAYROLL,D104,HJ,,130.11,178749.52
6170,3/31/2021,3/31/2021,33121,82L-IMPORT PAYROLL,D104,HJ,,130.11,178619.41
6170,3/31/2021,3/31/2021,33121,82L-IMPORT PAYROLL,D104,HJ,,136.92,178482.49
6170,3/31/2021,3/31/2021,33121,82L-IMPORT PAYROLL,D104,HJ,,136.92,178345.57
6170,3/31/2021,3/31/2021,33121,82L-IMPORT PAYROLL,D104,HJ,,136.92,178208.65
6170,3/31/2021,3/31/2021,33121,82L-IMPORT PAYROLL,D104,HJ,,370.8,177837.85
6170,3/31/2021,3/31/2021,33121,82L-IMPORT PAYROLL,D105,HJ,,130.11,177707.74
6170,3/31/2021,3/31/2021,33121,82L-IMPORT PAYROLL,D105,HJ,,136.92,177570.82
6170,3/31/2021,3/31/2021,33121,82L-IMPORT PAYROLL,D105,HJ,,136.92,177433.9
6170,3/31/2021,3/31/2021,33121,82L-IMPORT PAYROLL,D107,HJ,,136.92,177296.98
6170,3/31/2021,3/31/2021,33121,82L-IMPORT PAYROLL,D107,HJ,,240.7,177056.28
6170,3/31/2021,3/31/2021,33121,82L-IMPORT PAYROLL,D107,HJ,,370.8,176685.48
6170,3/31/2021,3/31/2021,33121,82L-IMPORT PAYROLL,D107,HJ,,390.22,176295.26
6170,3/31/2021,3/31/2021,33121,82L-IMPORT PAYROLL,D109,HJ,,130.11,176165.15
6170,3/31/2021,3/31/2021,33121,82L-IMPORT PAYROLL,D109,HJ,,130.11,176035.04
6170,3/31/2021,3/31/2021,33121,82L-IMPORT PAYROLL,D109,HJ,,136.92,175898.12
6170,3/31/2021,3/31/2021,33121,82L-IMPORT PAYROLL,D109,HJ,,136.92,175761.2
6170,3/31/2021,3/31/2021,33121,82L-IMPORT PAYROLL,D109,HJ,,136.92,175624.28
6170,3/31/2021,3/31/2021,33121,82L-IMPORT PAYROLL,D109,HJ,,390.22,175234.06
6170,3/31/2021,3/31/2021,33121,82L-IMPORT PAYROLL,D109,HJ,,390.22,174843.84
6170,3/31/2021,3/31/2021,33121,82L-IMPORT PAYROLL,D111,HJ,,130.11,174713.73
6170,3/31/2021,3/31/2021,33121,82L-IMPORT PAYROLL,D111,HJ,,130.11,174583.62
6170,3/31/2021,3/31/2021,33121,82L-IMPORT PAYROLL,D111,HJ,,130.11,174453.51
6170,3/31/2021,3/31/2021,33121,82L-IMPORT PAYROLL,D111,HJ,,136.92,174316.59
6170,3/31/2021,3/31/2021,33121,82L-IMPORT PAYROLL,D112,HJ,,273.84,174042.75
6170,3/31/2021,3/31/2021,33121,82L-IMPORT PAYROLL,D108,HJ,,65,173977.75
6170,3/31/2021,3/31/2021,33121,82L-IMPORT PAYROLL,D108,HJ,,65,173912.75
6170,3/31/2021,3/31/2021,33121,82L-IMPORT PAYROLL,D108,HJ,,65,173847.75
6170,3/31/2021,3/31/2021,33121,82L-IMPORT PAYROLL,D108,HJ,,65,173782.75
6170,3/31/2021,3/31/2021,33121,82L-IMPORT PAYROLL,D108,HJ,,65,173717.75
6170,3/31/2021,3/31/2021,33121,82L-IMPORT PAYROLL,D108,HJ,,130.11,173587.64
6170,3/31/2021,3/31/2021,33121,82L-IMPORT PAYROLL,D108,HJ,,130.11,173457.53
6170,3/31/2021,3/31/2021,33121,82L-IMPORT PAYROLL,D108,HJ,,130.11,173327.42
6170,3/31/2021,3/31/2021,33121,82L-IMPORT PAYROLL,D108,HJ,,130.11,173197.31
6170,3/31/2021,3/31/2021,33121,82L-IMPORT PAYROLL,D108,HJ,,136.92,173060.39
6170,3/31/2021,3/31/2021,33121,82L-IMPORT PAYROLL,D108,HJ,,136.92,172923.47
6170,3/31/2021,3/31/2021,33121,82L-IMPORT PAYROLL,D108,HJ,,136.92,172786.55
6170,3/31/2021,3/31/2021,33121,82L-IMPORT PAYROLL,D108,HJ,,136.92,172649.63
6170,3/31/2021,3/31/2021,33121,82L-IMPORT PAYROLL,D108,HJ,,136.92,172512.71
6170,3/31/2021,3/31/2021,33121,82L-IMPORT PAYROLL,D108,HJ,,390.22,172122.49
6170,3/31/2021,3/31/2021,33121,82L-IMPORT PAYROLL,D108,HJ,,130.11,171992.38
6170,3/31/2021,3/31/2021,33121,82L-IMPORT PAYROLL,D108,HJ,,130.11,171862.27
6170,3/31/2021,3/31/2021,33121,82L-IMPORT PAYROLL,D108,HJ,,136.92,171725.35
6170,3/31/2021,3/31/2021,33121,82L-IMPORT PAYROLL,D108,HJ,,136.92,171588.43
6170,4/2/2021,4/2/2021,BCBS,April 2021 BCBS Payment,D108,HJ,7234.03,,178822.46
6170,4/2/2021,4/2/2021,BCBS,April 2021 BCBS Payment,D108,HJ,8545.47,,187367.93
6170,4/2/2021,4/2/2021,BCBS,April 2021 BCBS Payment,D107,HJ,24783.69,,212151.62
6170,4/2/2021,4/2/2021,BCBS,April 2021 BCBS Payment,D108,HJ,7061.29,,219212.91
6170,4/2/2021,4/2/2021,BCBS,April 2021 BCBS Payment,D108,HJ,1068.13,,220281.04
6170,4/15/2021,4/15/2021,41521,82L-IMPORT PAYROLL,D108,HJ,,65,220216.04
6170,4/15/2021,4/15/2021,41521,82L-IMPORT PAYROLL,D108,HJ,,65,220151.04
6170,4/15/2021,4/15/2021,41521,82L-IMPORT PAYROLL,D108,HJ,,65,220086.04
6170,4/15/2021,4/15/2021,41521,82L-IMPORT PAYROLL,D108,HJ,,65,220021.04
6170,4/15/2021,4/15/2021,41521,82L-IMPORT PAYROLL,D108,HJ,,65,219956.04
6170,4/15/2021,4/15/2021,41521,82L-IMPORT PAYROLL,D108,HJ,,65,219891.04
6170,4/15/2021,4/15/2021,41521,82L-IMPORT PAYROLL,D108,HJ,,65,219826.04
6170,4/15/2021,4/15/2021,41521,82L-IMPORT PAYROLL,D108,HJ,,136.92,219689.12
6170,4/15/2021,4/15/2021,41521,82L-IMPORT PAYROLL,D108,HJ,,136.92,219552.2
6170,4/15/2021,4/15/2021,41521,82L-IMPORT PAYROLL,D108,HJ,,136.92,219415.28
6170,4/15/2021,4/15/2021,41521,82L-IMPORT PAYROLL,D108,HJ,,136.92,219278.36
6170,4/15/2021,4/15/2021,41521,82L-IMPORT PAYROLL,D108,HJ,,136.92,219141.44
6170,4/15/2021,4/15/2021,41521,82L-IMPORT PAYROLL,D108,HJ,,253.3,218888.14
6170,4/15/2021,4/15/2021,41521,82L-IMPORT PAYROLL,D108,HJ,,130.11,218758.03
6170,4/15/2021,4/15/2021,41521,82L-IMPORT PAYROLL,D108,HJ,,130.11,218627.92
6170,4/15/2021,4/15/2021,41521,82L-IMPORT PAYROLL,D108,HJ,,130.11,218497.81
6170,4/15/2021,4/15/2021,41521,82L-IMPORT PAYROLL,D108,HJ,,130.11,218367.7
6170,4/15/2021,4/15/2021,41521,82L-IMPORT PAYROLL,D108,HJ,,130.11,218237.59
6170,4/15/2021,4/15/2021,41521,82L-IMPORT PAYROLL,D108,HJ,,130.11,218107.48
6170,4/15/2021,4/15/2021,41521,82L-IMPORT PAYROLL,D108,HJ,,136.92,217970.56
6170,4/15/2021,4/15/2021,41521,82L-IMPORT PAYROLL,D108,HJ,,136.92,217833.64
6170,4/15/2021,4/15/2021,41521,82L-IMPORT PAYROLL,D108,HJ,,136.92,217696.72
6170,4/15/2021,4/15/2021,41521,82L-IMPORT PAYROLL,D108,HJ,,136.92,217559.8
6170,4/15/2021,4/15/2021,41521,82L-IMPORT PAYROLL,D108,HJ,,136.92,217422.88
6170,4/15/2021,4/15/2021,41521,82L-IMPORT PAYROLL,D108,HJ,,136.92,217285.96
6170,4/15/2021,4/15/2021,41521,82L-IMPORT PAYROLL,D108,HJ,,240.7,217045.26
6170,4/15/2021,4/15/2021,41521,82L-IMPORT PAYROLL,D108,HJ,,390.22,216655.04
6170,4/15/2021,4/15/2021,41521,82L-IMPORT PAYROLL,D108,HJ,,390.22,216264.82
6170,4/15/2021,4/15/2021,41521,82L-IMPORT PAYROLL,D101,HJ,,130.11,216134.71
6170,4/15/2021,4/15/2021,41521,82L-IMPORT PAYROLL,D101,HJ,,130.11,216004.6
6170,4/15/2021,4/15/2021,41521,82L-IMPORT PAYROLL,D101,HJ,,136.92,215867.68
6170,4/15/2021,4/15/2021,41521,82L-IMPORT PAYROLL,D101,HJ,,136.92,215730.76
6170,4/15/2021,4/15/2021,41521,82L-IMPORT PAYROLL,D101,HJ,,136.92,215593.84
6170,4/15/2021,4/15/2021,41521,82L-IMPORT PAYROLL,D102,HJ,,130.11,215463.73
6170,4/15/2021,4/15/2021,41521,82L-IMPORT PAYROLL,D103,HJ,,130.11,215333.62
6170,4/15/2021,4/15/2021,41521,82L-IMPORT PAYROLL,D104,HJ,,130.11,215203.51
6170,4/15/2021,4/15/2021,41521,82L-IMPORT PAYROLL,D104,HJ,,130.11,215073.4
6170,4/15/2021,4/15/2021,41521,82L-IMPORT PAYROLL,D104,HJ,,136.92,214936.48
6170,4/15/2021,4/15/2021,41521,82L-IMPORT PAYROLL,D104,HJ,,136.92,214799.56
6170,4/15/2021,4/15/2021,41521,82L-IMPORT PAYROLL,D104,HJ,,136.92,214662.64
6170,4/15/2021,4/15/2021,41521,82L-IMPORT PAYROLL,D104,HJ,,240.7,214421.94
6170,4/15/2021,4/15/2021,41521,82L-IMPORT PAYROLL,D104,HJ,,370.8,214051.14
6170,4/15/2021,4/15/2021,41521,82L-IMPORT PAYROLL,D104,HJ,,370.8,213680.34
6170,4/15/2021,4/15/2021,41521,82L-IMPORT PAYROLL,D105,HJ,,130.11,213550.23
6170,4/15/2021,4/15/2021,41521,82L-IMPORT PAYROLL,D105,HJ,,136.92,213413.31
6170,4/15/2021,4/15/2021,41521,82L-IMPORT PAYROLL,D105,HJ,,136.92,213276.39
6170,4/15/2021,4/15/2021,41521,82L-IMPORT PAYROLL,D107,HJ,,136.92,213139.47
6170,4/15/2021,4/15/2021,41521,82L-IMPORT PAYROLL,D107,HJ,,240.7,212898.77
6170,4/15/2021,4/15/2021,41521,82L-IMPORT PAYROLL,D107,HJ,,370.8,212527.97
6170,4/15/2021,4/15/2021,41521,82L-IMPORT PAYROLL,D107,HJ,,390.22,212137.75
6170,4/15/2021,4/15/2021,41521,82L-IMPORT PAYROLL,D109,HJ,,130.11,212007.64
6170,4/15/2021,4/15/2021,41521,82L-IMPORT PAYROLL,D109,HJ,,130.11,211877.53
6170,4/15/2021,4/15/2021,41521,82L-IMPORT PAYROLL,D109,HJ,,136.92,211740.61
6170,4/15/2021,4/15/2021,41521,82L-IMPORT PAYROLL,D109,HJ,,136.92,211603.69
6170,4/15/2021,4/15/2021,41521,82L-IMPORT PAYROLL,D109,HJ,,136.92,211466.77
6170,4/15/2021,4/15/2021,41521,82L-IMPORT PAYROLL,D109,HJ,,390.22,211076.55
6170,4/15/2021,4/15/2021,41521,82L-IMPORT PAYROLL,D109,HJ,,390.22,210686.33
6170,4/15/2021,4/15/2021,41521,82L-IMPORT PAYROLL,D111,HJ,,130.11,210556.22
6170,4/15/2021,4/15/2021,41521,82L-IMPORT PAYROLL,D111,HJ,,130.11,210426.11
6170,4/15/2021,4/15/2021,41521,82L-IMPORT PAYROLL,D111,HJ,,130.11,210296
6170,4/15/2021,4/15/2021,41521,82L-IMPORT PAYROLL,D111,HJ,,136.92,210159.08
6170,4/15/2021,4/15/2021,41521,82L-IMPORT PAYROLL,D112,HJ,,273.84,209885.24
6170,4/15/2021,4/15/2021,41521,82L-IMPORT PAYROLL,D108,HJ,,65,209820.24
6170,4/15/2021,4/15/2021,41521,82L-IMPORT PAYROLL,D108,HJ,,65,209755.24
6170,4/15/2021,4/15/2021,41521,82L-IMPORT PAYROLL,D108,HJ,,65,209690.24
6170,4/15/2021,4/15/2021,41521,82L-IMPORT PAYROLL,D108,HJ,,65,209625.24
6170,4/15/2021,4/15/2021,41521,82L-IMPORT PAYROLL,D108,HJ,,65,209560.24
6170,4/15/2021,4/15/2021,41521,82L-IMPORT PAYROLL,D108,HJ,,130.11,209430.13
6170,4/15/2021,4/15/2021,41521,82L-IMPORT PAYROLL,D108,HJ,,130.11,209300.02
6170,4/15/2021,4/15/2021,41521,82L-IMPORT PAYROLL,D108,HJ,,130.11,209169.91
6170,4/15/2021,4/15/2021,41521,82L-IMPORT PAYROLL,D108,HJ,,130.11,209039.8
6170,4/15/2021,4/15/2021,41521,82L-IMPORT PAYROLL,D108,HJ,,136.92,208902.88
6170,4/15/2021,4/15/2021,41521,82L-IMPORT PAYROLL,D108,HJ,,136.92,208765.96
6170,4/15/2021,4/15/2021,41521,82L-IMPORT PAYROLL,D108,HJ,,136.92,208629.04
6170,4/15/2021,4/15/2021,41521,82L-IMPORT PAYROLL,D108,HJ,,136.92,208492.12
6170,4/15/2021,4/15/2021,41521,82L-IMPORT PAYROLL,D108,HJ,,136.92,208355.2
6170,4/15/2021,4/15/2021,41521,82L-IMPORT PAYROLL,D108,HJ,,390.22,207964.98
6170,4/15/2021,4/15/2021,41521,82L-IMPORT PAYROLL,D108,HJ,,130.11,207834.87
6170,4/15/2021,4/15/2021,41521,82L-IMPORT PAYROLL,D108,HJ,,130.11,207704.76
6170,4/15/2021,4/15/2021,41521,82L-IMPORT PAYROLL,D108,HJ,,136.92,207567.84
6170,4/15/2021,4/15/2021,41521,82L-IMPORT PAYROLL,D108,HJ,,136.92,207430.92
6170,4/30/2021,4/30/2021,1,ADJ to Reclass funding source,D109,HJ,,924.28,206506.64
6170,4/30/2021,4/30/2021,1,ADJ to Reclass funding source,D109,HJ,924.28,,207430.92
6170,4/30/2021,4/30/2021,1,ADJ to Reclass funding source,D109,HJ,,4785.34,202645.58
6170,4/30/2021,4/30/2021,1,ADJ to Reclass funding source,D109,HJ,4785.34,,207430.92
6170,4/30/2021,4/30/2021,43021,82L-IMPORT PAYROLL,D108,HJ,,65,207365.92
6170,4/30/2021,4/30/2021,43021,82L-IMPORT PAYROLL,D108,HJ,,65,207300.92
6170,4/30/2021,4/30/2021,43021,82L-IMPORT PAYROLL,D108,HJ,,65,207235.92
6170,4/30/2021,4/30/2021,43021,82L-IMPORT PAYROLL,D108,HJ,,65,207170.92
6170,4/30/2021,4/30/2021,43021,82L-IMPORT PAYROLL,D108,HJ,,65,207105.92
6170,4/30/2021,4/30/2021,43021,82L-IMPORT PAYROLL,D108,HJ,,65,207040.92
6170,4/30/2021,4/30/2021,43021,82L-IMPORT PAYROLL,D108,HJ,,65,206975.92
6170,4/30/2021,4/30/2021,43021,82L-IMPORT PAYROLL,D108,HJ,,136.92,206839
6170,4/30/2021,4/30/2021,43021,82L-IMPORT PAYROLL,D108,HJ,,136.92,206702.08
6170,4/30/2021,4/30/2021,43021,82L-IMPORT PAYROLL,D108,HJ,,136.92,206565.16
6170,4/30/2021,4/30/2021,43021,82L-IMPORT PAYROLL,D108,HJ,,136.92,206428.24
6170,4/30/2021,4/30/2021,43021,82L-IMPORT PAYROLL,D108,HJ,,136.92,206291.32
6170,4/30/2021,4/30/2021,43021,82L-IMPORT PAYROLL,D108,HJ,,253.3,206038.02
6170,4/30/2021,4/30/2021,43021,82L-IMPORT PAYROLL,D108,HJ,,130.11,205907.91
6170,4/30/2021,4/30/2021,43021,82L-IMPORT PAYROLL,D108,HJ,,130.11,205777.8
6170,4/30/2021,4/30/2021,43021,82L-IMPORT PAYROLL,D108,HJ,,130.11,205647.69
6170,4/30/2021,4/30/2021,43021,82L-IMPORT PAYROLL,D108,HJ,,130.11,205517.58
6170,4/30/2021,4/30/2021,43021,82L-IMPORT PAYROLL,D108,HJ,,130.11,205387.47
6170,4/30/2021,4/30/2021,43021,82L-IMPORT PAYROLL,D108,HJ,,136.92,205250.55
6170,4/30/2021,4/30/2021,43021,82L-IMPORT PAYROLL,D108,HJ,,136.92,205113.63
6170,4/30/2021,4/30/2021,43021,82L-IMPORT PAYROLL,D108,HJ,,136.92,204976.71
6170,4/30/2021,4/30/2021,43021,82L-IMPORT PAYROLL,D108,HJ,,136.92,204839.79
6170,4/30/2021,4/30/2021,43021,82L-IMPORT PAYROLL,D108,HJ,,136.92,204702.87
6170,4/30/2021,4/30/2021,43021,82L-IMPORT PAYROLL,D108,HJ,,136.92,204565.95
6170,4/30/2021,4/30/2021,43021,82L-IMPORT PAYROLL,D108,HJ,,240.7,204325.25
6170,4/30/2021,4/30/2021,43021,82L-IMPORT PAYROLL,D108,HJ,,390.22,203935.03
6170,4/30/2021,4/30/2021,43021,82L-IMPORT PAYROLL,D108,HJ,,390.22,203544.81
6170,4/30/2021,4/30/2021,43021,82L-IMPORT PAYROLL,D101,HJ,,130.11,203414.7
6170,4/30/2021,4/30/2021,43021,82L-IMPORT PAYROLL,D101,HJ,,130.11,203284.59
6170,4/30/2021,4/30/2021,43021,82L-IMPORT PAYROLL,D101,HJ,,136.92,203147.67
6170,4/30/2021,4/30/2021,43021,82L-IMPORT PAYROLL,D101,HJ,,136.92,203010.75
6170,4/30/2021,4/30/2021,43021,82L-IMPORT PAYROLL,D101,HJ,,136.92,202873.83
6170,4/30/2021,4/30/2021,43021,82L-IMPORT PAYROLL,D102,HJ,,130.11,202743.72
6170,4/30/2021,4/30/2021,43021,82L-IMPORT PAYROLL,D103,HJ,,130.11,202613.61
6170,4/30/2021,4/30/2021,43021,82L-IMPORT PAYROLL,D103,HJ,,136.92,202476.69
6170,4/30/2021,4/30/2021,43021,82L-IMPORT PAYROLL,D104,HJ,,130.11,202346.58
6170,4/30/2021,4/30/2021,43021,82L-IMPORT PAYROLL,D104,HJ,,136.92,202209.66
6170,4/30/2021,4/30/2021,43021,82L-IMPORT PAYROLL,D104,HJ,,136.92,202072.74
6170,4/30/2021,4/30/2021,43021,82L-IMPORT PAYROLL,D104,HJ,,136.92,201935.82
6170,4/30/2021,4/30/2021,43021,82L-IMPORT PAYROLL,D104,HJ,,240.7,201695.12
6170,4/30/2021,4/30/2021,43021,82L-IMPORT PAYROLL,D104,HJ,,370.8,201324.32
6170,4/30/2021,4/30/2021,43021,82L-IMPORT PAYROLL,D104,HJ,,370.8,200953.52
6170,4/30/2021,4/30/2021,43021,82L-IMPORT PAYROLL,D105,HJ,,130.11,200823.41
6170,4/30/2021,4/30/2021,43021,82L-IMPORT PAYROLL,D105,HJ,,136.92,200686.49
6170,4/30/2021,4/30/2021,43021,82L-IMPORT PAYROLL,D105,HJ,,136.92,200549.57
6170,4/30/2021,4/30/2021,43021,82L-IMPORT PAYROLL,D107,HJ,,136.92,200412.65
6170,4/30/2021,4/30/2021,43021,82L-IMPORT PAYROLL,D107,HJ,,240.7,200171.95
6170,4/30/2021,4/30/2021,43021,82L-IMPORT PAYROLL,D107,HJ,,370.8,199801.15
6170,4/30/2021,4/30/2021,43021,82L-IMPORT PAYROLL,D107,HJ,,390.22,199410.93
6170,4/30/2021,4/30/2021,43021,82L-IMPORT PAYROLL,D109,HJ,,130.11,199280.82
6170,4/30/2021,4/30/2021,43021,82L-IMPORT PAYROLL,D109,HJ,,130.11,199150.71
6170,4/30/2021,4/30/2021,43021,82L-IMPORT PAYROLL,D109,HJ,,136.92,199013.79
6170,4/30/2021,4/30/2021,43021,82L-IMPORT PAYROLL,D109,HJ,,136.92,198876.87
6170,4/30/2021,4/30/2021,43021,82L-IMPORT PAYROLL,D109,HJ,,136.92,198739.95
6170,4/30/2021,4/30/2021,43021,82L-IMPORT PAYROLL,D109,HJ,,390.22,198349.73
6170,4/30/2021,4/30/2021,43021,82L-IMPORT PAYROLL,D109,HJ,,390.22,197959.51
6170,4/30/2021,4/30/2021,43021,82L-IMPORT PAYROLL,D111,HJ,,130.11,197829.4
6170,4/30/2021,4/30/2021,43021,82L-IMPORT PAYROLL,D111,HJ,,130.11,197699.29
6170,4/30/2021,4/30/2021,43021,82L-IMPORT PAYROLL,D111,HJ,,130.11,197569.18
6170,4/30/2021,4/30/2021,43021,82L-IMPORT PAYROLL,D111,HJ,,136.92,197432.26
6170,4/30/2021,4/30/2021,43021,82L-IMPORT PAYROLL,D112,HJ,,273.84,197158.42
6170,4/30/2021,4/30/2021,43021,82L-IMPORT PAYROLL,D108,HJ,,65,197093.42
6170,4/30/2021,4/30/2021,43021,82L-IMPORT PAYROLL,D108,HJ,,65,197028.42
6170,4/30/2021,4/30/2021,43021,82L-IMPORT PAYROLL,D108,HJ,,65,196963.42
6170,4/30/2021,4/30/2021,43021,82L-IMPORT PAYROLL,D108,HJ,,65,196898.42
6170,4/30/2021,4/30/2021,43021,82L-IMPORT PAYROLL,D108,HJ,,65,196833.42
6170,4/30/2021,4/30/2021,43021,82L-IMPORT PAYROLL,D108,HJ,,130.11,196703.31
6170,4/30/2021,4/30/2021,43021,82L-IMPORT PAYROLL,D108,HJ,,130.11,196573.2
6170,4/30/2021,4/30/2021,43021,82L-IMPORT PAYROLL,D108,HJ,,130.11,196443.09
6170,4/30/2021,4/30/2021,43021,82L-IMPORT PAYROLL,D108,HJ,,130.11,196312.98
6170,4/30/2021,4/30/2021,43021,82L-IMPORT PAYROLL,D108,HJ,,136.92,196176.06
6170,4/30/2021,4/30/2021,43021,82L-IMPORT PAYROLL,D108,HJ,,136.92,196039.14
6170,4/30/2021,4/30/2021,43021,82L-IMPORT PAYROLL,D108,HJ,,136.92,195902.22
6170,4/30/2021,4/30/2021,43021,82L-IMPORT PAYROLL,D108,HJ,,136.92,195765.3
6170,4/30/2021,4/30/2021,43021,82L-IMPORT PAYROLL,D108,HJ,,136.92,195628.38
6170,4/30/2021,4/30/2021,43021,82L-IMPORT PAYROLL,D108,HJ,,136.92,195491.46
6170,4/30/2021,4/30/2021,43021,82L-IMPORT PAYROLL,D108,HJ,,390.22,195101.24
6170,4/30/2021,4/30/2021,43021,82L-IMPORT PAYROLL,D108,HJ,,130.11,194971.13
6170,4/30/2021,4/30/2021,43021,82L-IMPORT PAYROLL,D108,HJ,,130.11,194841.02
6170,4/30/2021,4/30/2021,43021,82L-IMPORT PAYROLL,D108,HJ,,136.92,194704.1
6170,4/30/2021,4/30/2021,43021,82L-IMPORT PAYROLL,D108,HJ,,136.92,194567.18
6170,5/3/2021,5/3/2021,BCBS,BCBS MAy 2021 Payment,D108,HJ,9544.69,,204111.87
6170,5/3/2021,5/3/2021,BCBS,BCBS MAy 2021 Payment,D108,HJ,8545.47,,212657.34
6170,5/3/2021,5/3/2021,BCBS,BCBS MAy 2021 Payment,D101,HJ,2163.53,,214820.87
6170,5/3/2021,5/3/2021,BCBS,BCBS MAy 2021 Payment,D102,HJ,520.43,,215341.3
6170,5/3/2021,5/3/2021,BCBS,BCBS MAy 2021 Payment,D103,HJ,520.43,,215861.73
6170,5/3/2021,5/3/2021,BCBS,BCBS MAy 2021 Payment,D104,HJ,10576.87,,226438.6
6170,5/3/2021,5/3/2021,BCBS,BCBS MAy 2021 Payment,D105,HJ,1722.97,,228161.57
6170,5/3/2021,5/3/2021,BCBS,BCBS MAy 2021 Payment,D107,HJ,3071.38,,231232.95
6170,5/3/2021,5/3/2021,BCBS,BCBS MAy 2021 Payment,D109,HJ,4565.28,,235798.23
6170,5/3/2021,5/3/2021,BCBS,BCBS MAy 2021 Payment,D111,HJ,2108.99,,237907.22
6170,5/3/2021,5/3/2021,BCBS,BCBS MAy 2021 Payment,D112,HJ,1209.49,,239116.71
6170,5/3/2021,5/3/2021,BCBS,BCBS MAy 2021 Payment,D108,HJ,7608.99,,246725.7
6170,5/3/2021,5/3/2021,BCBS,BCBS MAy 2021 Payment,D108,HJ,2324.24,,249049.94
6170,5/14/2021,5/14/2021,51421,82L-IMPORT PAYROLL,D108,HJ,,65,248984.94
6170,5/14/2021,5/14/2021,51421,82L-IMPORT PAYROLL,D108,HJ,,65,248919.94
6170,5/14/2021,5/14/2021,51421,82L-IMPORT PAYROLL,D108,HJ,,65,248854.94
6170,5/14/2021,5/14/2021,51421,82L-IMPORT PAYROLL,D108,HJ,,65,248789.94
6170,5/14/2021,5/14/2021,51421,82L-IMPORT PAYROLL,D108,HJ,,65,248724.94
6170,5/14/2021,5/14/2021,51421,82L-IMPORT PAYROLL,D108,HJ,,65,248659.94
6170,5/14/2021,5/14/2021,51421,82L-IMPORT PAYROLL,D108,HJ,,65,248594.94
6170,5/14/2021,5/14/2021,51421,82L-IMPORT PAYROLL,D108,HJ,,136.92,248458.02
6170,5/14/2021,5/14/2021,51421,82L-IMPORT PAYROLL,D108,HJ,,136.92,248321.1
6170,5/14/2021,5/14/2021,51421,82L-IMPORT PAYROLL,D108,HJ,,136.92,248184.18
6170,5/14/2021,5/14/2021,51421,82L-IMPORT PAYROLL,D108,HJ,,136.92,248047.26
6170,5/14/2021,5/14/2021,51421,82L-IMPORT PAYROLL,D108,HJ,,136.92,247910.34
6170,5/14/2021,5/14/2021,51421,82L-IMPORT PAYROLL,D108,HJ,,253.3,247657.04
6170,5/14/2021,5/14/2021,51421,82L-IMPORT PAYROLL,D108,HJ,,130.11,247526.93
6170,5/14/2021,5/14/2021,51421,82L-IMPORT PAYROLL,D108,HJ,,130.11,247396.82
6170,5/14/2021,5/14/2021,51421,82L-IMPORT PAYROLL,D108,HJ,,130.11,247266.71
6170,5/14/2021,5/14/2021,51421,82L-IMPORT PAYROLL,D108,HJ,,130.11,247136.6
6170,5/14/2021,5/14/2021,51421,82L-IMPORT PAYROLL,D108,HJ,,130.11,247006.49
6170,5/14/2021,5/14/2021,51421,82L-IMPORT PAYROLL,D108,HJ,,136.92,246869.57
6170,5/14/2021,5/14/2021,51421,82L-IMPORT PAYROLL,D108,HJ,,136.92,246732.65
6170,5/14/2021,5/14/2021,51421,82L-IMPORT PAYROLL,D108,HJ,,136.92,246595.73
6170,5/14/2021,5/14/2021,51421,82L-IMPORT PAYROLL,D108,HJ,,136.92,246458.81
6170,5/14/2021,5/14/2021,51421,82L-IMPORT PAYROLL,D108,HJ,,136.92,246321.89
6170,5/14/2021,5/14/2021,51421,82L-IMPORT PAYROLL,D108,HJ,,136.92,246184.97
6170,5/14/2021,5/14/2021,51421,82L-IMPORT PAYROLL,D108,HJ,,240.7,245944.27
6170,5/14/2021,5/14/2021,51421,82L-IMPORT PAYROLL,D108,HJ,,390.22,245554.05
6170,5/14/2021,5/14/2021,51421,82L-IMPORT PAYROLL,D108,HJ,,390.22,245163.83
6170,5/14/2021,5/14/2021,51421,82L-IMPORT PAYROLL,D101,HJ,,130.11,245033.72
6170,5/14/2021,5/14/2021,51421,82L-IMPORT PAYROLL,D101,HJ,,130.11,244903.61
6170,5/14/2021,5/14/2021,51421,82L-IMPORT PAYROLL,D101,HJ,,136.92,244766.69
6170,5/14/2021,5/14/2021,51421,82L-IMPORT PAYROLL,D101,HJ,,136.92,244629.77
6170,5/14/2021,5/14/2021,51421,82L-IMPORT PAYROLL,D101,HJ,,136.92,244492.85
6170,5/14/2021,5/14/2021,51421,82L-IMPORT PAYROLL,D102,HJ,,130.11,244362.74
6170,5/14/2021,5/14/2021,51421,82L-IMPORT PAYROLL,D103,HJ,,130.11,244232.63
6170,5/14/2021,5/14/2021,51421,82L-IMPORT PAYROLL,D103,HJ,,136.92,244095.71
6170,5/14/2021,5/14/2021,51421,82L-IMPORT PAYROLL,D104,HJ,,130.11,243965.6
6170,5/14/2021,5/14/2021,51421,82L-IMPORT PAYROLL,D104,HJ,,136.92,243828.68
6170,5/14/2021,5/14/2021,51421,82L-IMPORT PAYROLL,D104,HJ,,136.92,243691.76
6170,5/14/2021,5/14/2021,51421,82L-IMPORT PAYROLL,D104,HJ,,136.92,243554.84
6170,5/14/2021,5/14/2021,51421,82L-IMPORT PAYROLL,D104,HJ,,240.7,243314.14
6170,5/14/2021,5/14/2021,51421,82L-IMPORT PAYROLL,D104,HJ,,370.8,242943.34
6170,5/14/2021,5/14/2021,51421,82L-IMPORT PAYROLL,D104,HJ,,370.8,242572.54
6170,5/14/2021,5/14/2021,51421,82L-IMPORT PAYROLL,D105,HJ,,130.11,242442.43
6170,5/14/2021,5/14/2021,51421,82L-IMPORT PAYROLL,D105,HJ,,136.92,242305.51
6170,5/14/2021,5/14/2021,51421,82L-IMPORT PAYROLL,D105,HJ,,136.92,242168.59
6170,5/14/2021,5/14/2021,51421,82L-IMPORT PAYROLL,D107,HJ,,136.92,242031.67
6170,5/14/2021,5/14/2021,51421,82L-IMPORT PAYROLL,D107,HJ,,240.7,241790.97
6170,5/14/2021,5/14/2021,51421,82L-IMPORT PAYROLL,D107,HJ,,370.8,241420.17
6170,5/14/2021,5/14/2021,51421,82L-IMPORT PAYROLL,D107,HJ,,390.22,241029.95
6170,5/14/2021,5/14/2021,51421,82L-IMPORT PAYROLL,D109,HJ,,130.11,240899.84
6170,5/14/2021,5/14/2021,51421,82L-IMPORT PAYROLL,D109,HJ,,130.11,240769.73
6170,5/14/2021,5/14/2021,51421,82L-IMPORT PAYROLL,D109,HJ,,136.92,240632.81
6170,5/14/2021,5/14/2021,51421,82L-IMPORT PAYROLL,D109,HJ,,136.92,240495.89
6170,5/14/2021,5/14/2021,51421,82L-IMPORT PAYROLL,D109,HJ,,136.92,240358.97
6170,5/14/2021,5/14/2021,51421,82L-IMPORT PAYROLL,D109,HJ,,390.22,239968.75
6170,5/14/2021,5/14/2021,51421,82L-IMPORT PAYROLL,D109,HJ,,390.22,239578.53
6170,5/14/2021,5/14/2021,51421,82L-IMPORT PAYROLL,D111,HJ,,130.11,239448.42
6170,5/14/2021,5/14/2021,51421,82L-IMPORT PAYROLL,D111,HJ,,130.11,239318.31
6170,5/14/2021,5/14/2021,51421,82L-IMPORT PAYROLL,D111,HJ,,130.11,239188.2
6170,5/14/2021,5/14/2021,51421,82L-IMPORT PAYROLL,D111,HJ,,130.11,239058.09
6170,5/14/2021,5/14/2021,51421,82L-IMPORT PAYROLL,D111,HJ,,136.92,238921.17
6170,5/14/2021,5/14/2021,51421,82L-IMPORT PAYROLL,D112,HJ,,273.84,238647.33
6170,5/14/2021,5/14/2021,51421,82L-IMPORT PAYROLL,D108,HJ,,65,238582.33
6170,5/14/2021,5/14/2021,51421,82L-IMPORT PAYROLL,D108,HJ,,65,238517.33
6170,5/14/2021,5/14/2021,51421,82L-IMPORT PAYROLL,D108,HJ,,65,238452.33
6170,5/14/2021,5/14/2021,51421,82L-IMPORT PAYROLL,D108,HJ,,65,238387.33
6170,5/14/2021,5/14/2021,51421,82L-IMPORT PAYROLL,D108,HJ,,65,238322.33
6170,5/14/2021,5/14/2021,51421,82L-IMPORT PAYROLL,D108,HJ,,130.11,238192.22
6170,5/14/2021,5/14/2021,51421,82L-IMPORT PAYROLL,D108,HJ,,130.11,238062.11
6170,5/14/2021,5/14/2021,51421,82L-IMPORT PAYROLL,D108,HJ,,130.11,237932
6170,5/14/2021,5/14/2021,51421,82L-IMPORT PAYROLL,D108,HJ,,130.11,237801.89
6170,5/14/2021,5/14/2021,51421,82L-IMPORT PAYROLL,D108,HJ,,136.92,237664.97
6170,5/14/2021,5/14/2021,51421,82L-IMPORT PAYROLL,D108,HJ,,136.92,237528.05
6170,5/14/2021,5/14/2021,51421,82L-IMPORT PAYROLL,D108,HJ,,136.92,237391.13
6170,5/14/2021,5/14/2021,51421,82L-IMPORT PAYROLL,D108,HJ,,136.92,237254.21
6170,5/14/2021,5/14/2021,51421,82L-IMPORT PAYROLL,D108,HJ,,136.92,237117.29
6170,5/14/2021,5/14/2021,51421,82L-IMPORT PAYROLL,D108,HJ,,136.92,236980.37
6170,5/14/2021,5/14/2021,51421,82L-IMPORT PAYROLL,D108,HJ,,390.22,236590.15
6170,5/14/2021,5/14/2021,51421,82L-IMPORT PAYROLL,D108,HJ,,130.11,236460.04
6170,5/14/2021,5/14/2021,51421,82L-IMPORT PAYROLL,D108,HJ,,130.11,236329.93
6170,5/14/2021,5/14/2021,51421,82L-IMPORT PAYROLL,D108,HJ,,136.92,236193.01
6170,5/14/2021,5/14/2021,51421,82L-IMPORT PAYROLL,D108,HJ,,136.92,236056.09
6170,5/28/2021,5/28/2021,1,HRK BCBS refund,D108,HJ,,218.36,235837.73
6170,5/28/2021,5/28/2021,1,HRK BCBS refund,D108,HJ,,639.24,235198.49
6170,5/28/2021,5/28/2021,1,HRK BCBS refund,D108,HJ,,1098.64,234099.85
6170,5/28/2021,5/28/2021,52821,82L-IMPORT PAYROLL,D108,HJ,,65,234034.85
6170,5/28/2021,5/28/2021,52821,82L-IMPORT PAYROLL,D108,HJ,,65,233969.85
6170,5/28/2021,5/28/2021,52821,82L-IMPORT PAYROLL,D108,HJ,,65,233904.85
6170,5/28/2021,5/28/2021,52821,82L-IMPORT PAYROLL,D108,HJ,,65,233839.85
6170,5/28/2021,5/28/2021,52821,82L-IMPORT PAYROLL,D108,HJ,,65,233774.85
6170,5/28/2021,5/28/2021,52821,82L-IMPORT PAYROLL,D108,HJ,,65,233709.85
6170,5/28/2021,5/28/2021,52821,82L-IMPORT PAYROLL,D108,HJ,,65,233644.85
6170,5/28/2021,5/28/2021,52821,82L-IMPORT PAYROLL,D108,HJ,,136.92,233507.93
6170,5/28/2021,5/28/2021,52821,82L-IMPORT PAYROLL,D108,HJ,,136.92,233371.01
6170,5/28/2021,5/28/2021,52821,82L-IMPORT PAYROLL,D108,HJ,,136.92,233234.09
6170,5/28/2021,5/28/2021,52821,82L-IMPORT PAYROLL,D108,HJ,,136.92,233097.17
6170,5/28/2021,5/28/2021,52821,82L-IMPORT PAYROLL,D108,HJ,,136.92,232960.25
6170,5/28/2021,5/28/2021,52821,82L-IMPORT PAYROLL,D108,HJ,,253.3,232706.95
6170,5/28/2021,5/28/2021,52821,82L-IMPORT PAYROLL,D108,HJ,,130.11,232576.84
6170,5/28/2021,5/28/2021,52821,82L-IMPORT PAYROLL,D108,HJ,,130.11,232446.73
6170,5/28/2021,5/28/2021,52821,82L-IMPORT PAYROLL,D108,HJ,,130.11,232316.62
6170,5/28/2021,5/28/2021,52821,82L-IMPORT PAYROLL,D108,HJ,,130.11,232186.51
6170,5/28/2021,5/28/2021,52821,82L-IMPORT PAYROLL,D108,HJ,,130.11,232056.4
6170,5/28/2021,5/28/2021,52821,82L-IMPORT PAYROLL,D108,HJ,,136.92,231919.48
6170,5/28/2021,5/28/2021,52821,82L-IMPORT PAYROLL,D108,HJ,,136.92,231782.56
6170,5/28/2021,5/28/2021,52821,82L-IMPORT PAYROLL,D108,HJ,,136.92,231645.64
6170,5/28/2021,5/28/2021,52821,82L-IMPORT PAYROLL,D108,HJ,,136.92,231508.72
6170,5/28/2021,5/28/2021,52821,82L-IMPORT PAYROLL,D108,HJ,,136.92,231371.8
6170,5/28/2021,5/28/2021,52821,82L-IMPORT PAYROLL,D108,HJ,,136.92,231234.88
6170,5/28/2021,5/28/2021,52821,82L-IMPORT PAYROLL,D108,HJ,,240.7,230994.18
6170,5/28/2021,5/28/2021,52821,82L-IMPORT PAYROLL,D108,HJ,,273.84,230720.34
6170,5/28/2021,5/28/2021,52821,82L-IMPORT PAYROLL,D108,HJ,,390.22,230330.12
6170,5/28/2021,5/28/2021,52821,82L-IMPORT PAYROLL,D108,HJ,,390.22,229939.9
6170,5/28/2021,5/28/2021,52821,82L-IMPORT PAYROLL,D101,HJ,,130.11,229809.79
6170,5/28/2021,5/28/2021,52821,82L-IMPORT PAYROLL,D101,HJ,,130.11,229679.68
6170,5/28/2021,5/28/2021,52821,82L-IMPORT PAYROLL,D101,HJ,,136.92,229542.76
6170,5/28/2021,5/28/2021,52821,82L-IMPORT PAYROLL,D101,HJ,,136.92,229405.84
6170,5/28/2021,5/28/2021,52821,82L-IMPORT PAYROLL,D101,HJ,,136.92,229268.92
6170,5/28/2021,5/28/2021,52821,82L-IMPORT PAYROLL,D102,HJ,,130.11,229138.81
6170,5/28/2021,5/28/2021,52821,82L-IMPORT PAYROLL,D103,HJ,,130.11,229008.7
6170,5/28/2021,5/28/2021,52821,82L-IMPORT PAYROLL,D103,HJ,,136.92,228871.78
6170,5/28/2021,5/28/2021,52821,82L-IMPORT PAYROLL,D104,HJ,,130.11,228741.67
6170,5/28/2021,5/28/2021,52821,82L-IMPORT PAYROLL,D104,HJ,,136.92,228604.75
6170,5/28/2021,5/28/2021,52821,82L-IMPORT PAYROLL,D104,HJ,,136.92,228467.83
6170,5/28/2021,5/28/2021,52821,82L-IMPORT PAYROLL,D104,HJ,,136.92,228330.91
6170,5/28/2021,5/28/2021,52821,82L-IMPORT PAYROLL,D104,HJ,,240.7,228090.21
6170,5/28/2021,5/28/2021,52821,82L-IMPORT PAYROLL,D104,HJ,,370.8,227719.41
6170,5/28/2021,5/28/2021,52821,82L-IMPORT PAYROLL,D104,HJ,,370.8,227348.61
6170,5/28/2021,5/28/2021,52821,82L-IMPORT PAYROLL,D105,HJ,,130.11,227218.5
6170,5/28/2021,5/28/2021,52821,82L-IMPORT PAYROLL,D105,HJ,,136.92,227081.58
6170,5/28/2021,5/28/2021,52821,82L-IMPORT PAYROLL,D105,HJ,,136.92,226944.66
6170,5/28/2021,5/28/2021,52821,82L-IMPORT PAYROLL,D107,HJ,,136.92,226807.74
6170,5/28/2021,5/28/2021,52821,82L-IMPORT PAYROLL,D107,HJ,,240.7,226567.04
6170,5/28/2021,5/28/2021,52821,82L-IMPORT PAYROLL,D107,HJ,,370.8,226196.24
6170,5/28/2021,5/28/2021,52821,82L-IMPORT PAYROLL,D107,HJ,,370.8,225825.44
6170,5/28/2021,5/28/2021,52821,82L-IMPORT PAYROLL,D107,HJ,,390.22,225435.22
6170,5/28/2021,5/28/2021,52821,82L-IMPORT PAYROLL,D109,HJ,,130.11,225305.11
6170,5/28/2021,5/28/2021,52821,82L-IMPORT PAYROLL,D109,HJ,,130.11,225175
6170,5/28/2021,5/28/2021,52821,82L-IMPORT PAYROLL,D109,HJ,,136.92,225038.08
6170,5/28/2021,5/28/2021,52821,82L-IMPORT PAYROLL,D109,HJ,,136.92,224901.16
6170,5/28/2021,5/28/2021,52821,82L-IMPORT PAYROLL,D109,HJ,,136.92,224764.24
6170,5/28/2021,5/28/2021,52821,82L-IMPORT PAYROLL,D109,HJ,,390.22,224374.02
6170,5/28/2021,5/28/2021,52821,82L-IMPORT PAYROLL,D109,HJ,,390.22,223983.8
6170,5/28/2021,5/28/2021,52821,82L-IMPORT PAYROLL,D111,HJ,,130.11,223853.69
6170,5/28/2021,5/28/2021,52821,82L-IMPORT PAYROLL,D111,HJ,,130.11,223723.58
6170,5/28/2021,5/28/2021,52821,82L-IMPORT PAYROLL,D111,HJ,,130.11,223593.47
6170,5/28/2021,5/28/2021,52821,82L-IMPORT PAYROLL,D111,HJ,,130.11,223463.36
6170,5/28/2021,5/28/2021,52821,82L-IMPORT PAYROLL,D111,HJ,,136.92,223326.44
6170,5/28/2021,5/28/2021,52821,82L-IMPORT PAYROLL,D112,HJ,,273.84,223052.6
6170,5/28/2021,5/28/2021,52821,82L-IMPORT PAYROLL,D108,HJ,,65,222987.6
6170,5/28/2021,5/28/2021,52821,82L-IMPORT PAYROLL,D108,HJ,,65,222922.6
6170,5/28/2021,5/28/2021,52821,82L-IMPORT PAYROLL,D108,HJ,,65,222857.6
6170,5/28/2021,5/28/2021,52821,82L-IMPORT PAYROLL,D108,HJ,,65,222792.6
6170,5/28/2021,5/28/2021,52821,82L-IMPORT PAYROLL,D108,HJ,,65,222727.6
6170,5/28/2021,5/28/2021,52821,82L-IMPORT PAYROLL,D108,HJ,,130.11,222597.49
6170,5/28/2021,5/28/2021,52821,82L-IMPORT PAYROLL,D108,HJ,,130.11,222467.38
6170,5/28/2021,5/28/2021,52821,82L-IMPORT PAYROLL,D108,HJ,,130.11,222337.27
6170,5/28/2021,5/28/2021,52821,82L-IMPORT PAYROLL,D108,HJ,,130.11,222207.16
6170,5/28/2021,5/28/2021,52821,82L-IMPORT PAYROLL,D108,HJ,,136.92,222070.24
6170,5/28/2021,5/28/2021,52821,82L-IMPORT PAYROLL,D108,HJ,,136.92,221933.32
6170,5/28/2021,5/28/2021,52821,82L-IMPORT PAYROLL,D108,HJ,,136.92,221796.4
6170,5/28/2021,5/28/2021,52821,82L-IMPORT PAYROLL,D108,HJ,,136.92,221659.48
6170,5/28/2021,5/28/2021,52821,82L-IMPORT PAYROLL,D108,HJ,,136.92,221522.56
6170,5/28/2021,5/28/2021,52821,82L-IMPORT PAYROLL,D108,HJ,,136.92,221385.64
6170,5/28/2021,5/28/2021,52821,82L-IMPORT PAYROLL,D108,HJ,,390.22,220995.42
6170,5/28/2021,5/28/2021,52821,82L-IMPORT PAYROLL,D108,HJ,,130.11,220865.31
6170,5/28/2021,5/28/2021,52821,82L-IMPORT PAYROLL,D108,HJ,,130.11,220735.2
6170,5/28/2021,5/28/2021,52821,82L-IMPORT PAYROLL,D108,HJ,,136.92,220598.28
6170,5/28/2021,5/28/2021,52821,82L-IMPORT PAYROLL,D108,HJ,,136.92,220461.36
6170,6/1/2021,6/1/2021,1,ADJ to reclass Benefit expenses,D101,HJ,17891.6,,238352.96
6170,6/1/2021,6/1/2021,1,ADJ to reclass Benefit expenses,D103,HJ,11089.6,,249442.56
6170,6/1/2021,6/1/2021,1,ADJ to reclass Benefit expenses,D104,HJ,29062.45,,278505.01
6170,6/1/2021,6/1/2021,1,ADJ to reclass Benefit expenses,D105,HJ,16409.73,,294914.74
6170,6/1/2021,6/1/2021,1,ADJ to reclass Benefit expenses,D107,HJ,,132685.76,162228.98
6170,6/1/2021,6/1/2021,1,ADJ to reclass Benefit expenses,D109,HJ,29931.26,,192160.24
6170,6/1/2021,6/1/2021,1,ADJ to reclass Benefit expenses,D111,HJ,18727.12,,210887.36
6170,6/1/2021,6/1/2021,1,ADJ to reclass Benefit expenses,D112,HJ,9574,,220461.36
6170,6/1/2021,6/1/2021,1,To reclassify Expenses bet departments,D107,HJ,,989.14,219472.22
6170,6/1/2021,6/1/2021,1,To reclassify Expenses bet departments,D107,HJ,989.14,,220461.36
6170,6/1/2021,6/1/2021,BCBS,BCBS June 2021 Payment,D108,HJ,7887.89,,228349.25
6170,6/1/2021,6/1/2021,BCBS,BCBS June 2021 Payment,D108,HJ,7048.97,,235398.22
6170,6/1/2021,6/1/2021,BCBS,BCBS June 2021 Payment,D101,HJ,2163.53,,237561.75
6170,6/1/2021,6/1/2021,BCBS,BCBS June 2021 Payment,D102,HJ,520.43,,238082.18
6170,6/1/2021,6/1/2021,BCBS,BCBS June 2021 Payment,D103,HJ,1707.07,,239789.25
6170,6/1/2021,6/1/2021,BCBS,BCBS June 2021 Payment,D104,HJ,5416.17,,245205.42
6170,6/1/2021,6/1/2021,BCBS,BCBS June 2021 Payment,D105,HJ,1615.83,,246821.25
6170,6/1/2021,6/1/2021,BCBS,BCBS June 2021 Payment,D107,HJ,3071.38,,249892.63
6170,6/1/2021,6/1/2021,BCBS,BCBS June 2021 Payment,D109,HJ,4244.86,,254137.49
6170,6/1/2021,6/1/2021,BCBS,BCBS June 2021 Payment,D111,HJ,2108.99,,256246.48
6170,6/1/2021,6/1/2021,BCBS,BCBS June 2021 Payment,D112,HJ,1095.34,,257341.82
6170,6/1/2021,6/1/2021,BCBS,BCBS June 2021 Payment,D108,HJ,9037.81,,266379.63
6170,6/1/2021,6/1/2021,BCBS,BCBS June 2021 Payment,D108,HJ,2163.53,,268543.16
6170,6/15/2021,6/15/2021,61521,82L-IMPORT PAYROLL,D108,HJ,,65,268478.16
6170,6/15/2021,6/15/2021,61521,82L-IMPORT PAYROLL,D108,HJ,,65,268413.16
6170,6/15/2021,6/15/2021,61521,82L-IMPORT PAYROLL,D108,HJ,,65,268348.16
6170,6/15/2021,6/15/2021,61521,82L-IMPORT PAYROLL,D108,HJ,,65,268283.16
6170,6/15/2021,6/15/2021,61521,82L-IMPORT PAYROLL,D108,HJ,,65,268218.16
6170,6/15/2021,6/15/2021,61521,82L-IMPORT PAYROLL,D108,HJ,,65,268153.16
6170,6/15/2021,6/15/2021,61521,82L-IMPORT PAYROLL,D108,HJ,,65,268088.16
6170,6/15/2021,6/15/2021,61521,82L-IMPORT PAYROLL,D108,HJ,,136.92,267951.24
6170,6/15/2021,6/15/2021,61521,82L-IMPORT PAYROLL,D108,HJ,,136.92,267814.32
6170,6/15/2021,6/15/2021,61521,82L-IMPORT PAYROLL,D108,HJ,,136.92,267677.4
6170,6/15/2021,6/15/2021,61521,82L-IMPORT PAYROLL,D108,HJ,,136.92,267540.48
6170,6/15/2021,6/15/2021,61521,82L-IMPORT PAYROLL,D108,HJ,,136.92,267403.56
6170,6/15/2021,6/15/2021,61521,82L-IMPORT PAYROLL,D108,HJ,,253.3,267150.26
6170,6/15/2021,6/15/2021,61521,82L-IMPORT PAYROLL,D108,HJ,,130.11,267020.15
6170,6/15/2021,6/15/2021,61521,82L-IMPORT PAYROLL,D108,HJ,,130.11,266890.04
6170,6/15/2021,6/15/2021,61521,82L-IMPORT PAYROLL,D108,HJ,,130.11,266759.93
6170,6/15/2021,6/15/2021,61521,82L-IMPORT PAYROLL,D108,HJ,,130.11,266629.82
6170,6/15/2021,6/15/2021,61521,82L-IMPORT PAYROLL,D108,HJ,,130.11,266499.71
6170,6/15/2021,6/15/2021,61521,82L-IMPORT PAYROLL,D108,HJ,,130.11,266369.6
6170,6/15/2021,6/15/2021,61521,82L-IMPORT PAYROLL,D108,HJ,,136.92,266232.68
6170,6/15/2021,6/15/2021,61521,82L-IMPORT PAYROLL,D108,HJ,,136.92,266095.76
6170,6/15/2021,6/15/2021,61521,82L-IMPORT PAYROLL,D108,HJ,,136.92,265958.84
6170,6/15/2021,6/15/2021,61521,82L-IMPORT PAYROLL,D108,HJ,,136.92,265821.92
6170,6/15/2021,6/15/2021,61521,82L-IMPORT PAYROLL,D108,HJ,,136.92,265685
6170,6/15/2021,6/15/2021,61521,82L-IMPORT PAYROLL,D108,HJ,,136.92,265548.08
6170,6/15/2021,6/15/2021,61521,82L-IMPORT PAYROLL,D108,HJ,,240.7,265307.38
6170,6/15/2021,6/15/2021,61521,82L-IMPORT PAYROLL,D108,HJ,,260.21,265047.17
6170,6/15/2021,6/15/2021,61521,82L-IMPORT PAYROLL,D108,HJ,,390.22,264656.95
6170,6/15/2021,6/15/2021,61521,82L-IMPORT PAYROLL,D108,HJ,,390.22,264266.73
6170,6/15/2021,6/15/2021,61521,82L-IMPORT PAYROLL,D101,HJ,,130.11,264136.62
6170,6/15/2021,6/15/2021,61521,82L-IMPORT PAYROLL,D101,HJ,,130.11,264006.51
6170,6/15/2021,6/15/2021,61521,82L-IMPORT PAYROLL,D101,HJ,,136.92,263869.59
6170,6/15/2021,6/15/2021,61521,82L-IMPORT PAYROLL,D101,HJ,,136.92,263732.67
6170,6/15/2021,6/15/2021,61521,82L-IMPORT PAYROLL,D101,HJ,,136.92,263595.75
6170,6/15/2021,6/15/2021,61521,82L-IMPORT PAYROLL,D102,HJ,,130.11,263465.64
6170,6/15/2021,6/15/2021,61521,82L-IMPORT PAYROLL,D103,HJ,,130.11,263335.53
6170,6/15/2021,6/15/2021,61521,82L-IMPORT PAYROLL,D103,HJ,,136.92,263198.61
6170,6/15/2021,6/15/2021,61521,82L-IMPORT PAYROLL,D104,HJ,,130.11,263068.5
6170,6/15/2021,6/15/2021,61521,82L-IMPORT PAYROLL,D104,HJ,,136.92,262931.58
6170,6/15/2021,6/15/2021,61521,82L-IMPORT PAYROLL,D104,HJ,,136.92,262794.66
6170,6/15/2021,6/15/2021,61521,82L-IMPORT PAYROLL,D104,HJ,,136.92,262657.74
6170,6/15/2021,6/15/2021,61521,82L-IMPORT PAYROLL,D104,HJ,,240.7,262417.04
6170,6/15/2021,6/15/2021,61521,82L-IMPORT PAYROLL,D104,HJ,,370.8,262046.24
6170,6/15/2021,6/15/2021,61521,82L-IMPORT PAYROLL,D104,HJ,,370.8,261675.44
6170,6/15/2021,6/15/2021,61521,82L-IMPORT PAYROLL,D105,HJ,,130.11,261545.33
6170,6/15/2021,6/15/2021,61521,82L-IMPORT PAYROLL,D105,HJ,,136.92,261408.41
6170,6/15/2021,6/15/2021,61521,82L-IMPORT PAYROLL,D105,HJ,,136.92,261271.49
6170,6/15/2021,6/15/2021,61521,82L-IMPORT PAYROLL,D107,HJ,,136.92,261134.57
6170,6/15/2021,6/15/2021,61521,82L-IMPORT PAYROLL,D107,HJ,,240.7,260893.87
6170,6/15/2021,6/15/2021,61521,82L-IMPORT PAYROLL,D107,HJ,,273.84,260620.03
6170,6/15/2021,6/15/2021,61521,82L-IMPORT PAYROLL,D107,HJ,,370.8,260249.23
6170,6/15/2021,6/15/2021,61521,82L-IMPORT PAYROLL,D107,HJ,,370.8,259878.43
6170,6/15/2021,6/15/2021,61521,82L-IMPORT PAYROLL,D107,HJ,,390.22,259488.21
6170,6/15/2021,6/15/2021,61521,82L-IMPORT PAYROLL,D109,HJ,,130.11,259358.1
6170,6/15/2021,6/15/2021,61521,82L-IMPORT PAYROLL,D109,HJ,,130.11,259227.99
6170,6/15/2021,6/15/2021,61521,82L-IMPORT PAYROLL,D109,HJ,,136.92,259091.07
6170,6/15/2021,6/15/2021,61521,82L-IMPORT PAYROLL,D109,HJ,,136.92,258954.15
6170,6/15/2021,6/15/2021,61521,82L-IMPORT PAYROLL,D109,HJ,,136.92,258817.23
6170,6/15/2021,6/15/2021,61521,82L-IMPORT PAYROLL,D109,HJ,,390.22,258427.01
6170,6/15/2021,6/15/2021,61521,82L-IMPORT PAYROLL,D109,HJ,,390.22,258036.79
6170,6/15/2021,6/15/2021,61521,82L-IMPORT PAYROLL,D111,HJ,,130.11,257906.68
6170,6/15/2021,6/15/2021,61521,82L-IMPORT PAYROLL,D111,HJ,,130.11,257776.57
6170,6/15/2021,6/15/2021,61521,82L-IMPORT PAYROLL,D111,HJ,,130.11,257646.46
6170,6/15/2021,6/15/2021,61521,82L-IMPORT PAYROLL,D111,HJ,,130.11,257516.35
6170,6/15/2021,6/15/2021,61521,82L-IMPORT PAYROLL,D111,HJ,,136.92,257379.43
6170,6/15/2021,6/15/2021,61521,82L-IMPORT PAYROLL,D112,HJ,,273.84,257105.59
6170,6/15/2021,6/15/2021,61521,82L-IMPORT PAYROLL,D108,HJ,,65,257040.59
6170,6/15/2021,6/15/2021,61521,82L-IMPORT PAYROLL,D108,HJ,,65,256975.59
6170,6/15/2021,6/15/2021,61521,82L-IMPORT PAYROLL,D108,HJ,,65,256910.59
6170,6/15/2021,6/15/2021,61521,82L-IMPORT PAYROLL,D108,HJ,,65,256845.59
6170,6/15/2021,6/15/2021,61521,82L-IMPORT PAYROLL,D108,HJ,,65,256780.59
6170,6/15/2021,6/15/2021,61521,82L-IMPORT PAYROLL,D108,HJ,,130.11,256650.48
6170,6/15/2021,6/15/2021,61521,82L-IMPORT PAYROLL,D108,HJ,,130.11,256520.37
6170,6/15/2021,6/15/2021,61521,82L-IMPORT PAYROLL,D108,HJ,,130.11,256390.26
6170,6/15/2021,6/15/2021,61521,82L-IMPORT PAYROLL,D108,HJ,,130.11,256260.15
6170,6/15/2021,6/15/2021,61521,82L-IMPORT PAYROLL,D108,HJ,,136.92,256123.23
6170,6/15/2021,6/15/2021,61521,82L-IMPORT PAYROLL,D108,HJ,,136.92,255986.31
6170,6/15/2021,6/15/2021,61521,82L-IMPORT PAYROLL,D108,HJ,,136.92,255849.39
6170,6/15/2021,6/15/2021,61521,82L-IMPORT PAYROLL,D108,HJ,,136.92,255712.47
6170,6/15/2021,6/15/2021,61521,82L-IMPORT PAYROLL,D108,HJ,,136.92,255575.55
6170,6/15/2021,6/15/2021,61521,82L-IMPORT PAYROLL,D108,HJ,,136.92,255438.63
6170,6/15/2021,6/15/2021,61521,82L-IMPORT PAYROLL,D108,HJ,,390.22,255048.41
6170,6/15/2021,6/15/2021,61521,82L-IMPORT PAYROLL,D108,HJ,,130.11,254918.3
6170,6/15/2021,6/15/2021,61521,82L-IMPORT PAYROLL,D108,HJ,,130.11,254788.19
6170,6/15/2021,6/15/2021,61521,82L-IMPORT PAYROLL,D108,HJ,,136.92,254651.27
6170,6/15/2021,6/15/2021,61521,82L-IMPORT PAYROLL,D108,HJ,,136.92,254514.35
6170,6/30/2021,6/30/2021,63021,82L-IMPORT PAYROLL,D108,HJ,,65,254449.35
6170,6/30/2021,6/30/2021,63021,82L-IMPORT PAYROLL,D108,HJ,,136.92,254312.43
6170,6/30/2021,6/30/2021,63021,82L-IMPORT PAYROLL,D108,HJ,,136.92,254175.51
6170,6/30/2021,6/30/2021,63021,82L-IMPORT PAYROLL,D108,HJ,,136.92,254038.59
6170,6/30/2021,6/30/2021,63021,82L-IMPORT PAYROLL,D108,HJ,,136.92,253901.67
6170,6/30/2021,6/30/2021,63021,82L-IMPORT PAYROLL,D108,HJ,,253.3,253648.37
6170,6/30/2021,6/30/2021,63021,82L-IMPORT PAYROLL,D108,HJ,,130.11,253518.26
6170,6/30/2021,6/30/2021,63021,82L-IMPORT PAYROLL,D108,HJ,,130.11,253388.15
6170,6/30/2021,6/30/2021,63021,82L-IMPORT PAYROLL,D108,HJ,,130.11,253258.04
6170,6/30/2021,6/30/2021,63021,82L-IMPORT PAYROLL,D108,HJ,,130.11,253127.93
6170,6/30/2021,6/30/2021,63021,82L-IMPORT PAYROLL,D108,HJ,,130.11,252997.82
6170,6/30/2021,6/30/2021,63021,82L-IMPORT PAYROLL,D108,HJ,,130.11,252867.71
6170,6/30/2021,6/30/2021,63021,82L-IMPORT PAYROLL,D108,HJ,,136.92,252730.79
6170,6/30/2021,6/30/2021,63021,82L-IMPORT PAYROLL,D108,HJ,,136.92,252593.87
6170,6/30/2021,6/30/2021,63021,82L-IMPORT PAYROLL,D108,HJ,,136.92,252456.95
6170,6/30/2021,6/30/2021,63021,82L-IMPORT PAYROLL,D108,HJ,,136.92,252320.03
6170,6/30/2021,6/30/2021,63021,82L-IMPORT PAYROLL,D108,HJ,,136.92,252183.11
6170,6/30/2021,6/30/2021,63021,82L-IMPORT PAYROLL,D108,HJ,,136.92,252046.19
6170,6/30/2021,6/30/2021,63021,82L-IMPORT PAYROLL,D108,HJ,,240.7,251805.49
6170,6/30/2021,6/30/2021,63021,82L-IMPORT PAYROLL,D108,HJ,260.21,,252065.7
6170,6/30/2021,6/30/2021,63021,82L-IMPORT PAYROLL,D108,HJ,,390.22,251675.48
6170,6/30/2021,6/30/2021,63021,82L-IMPORT PAYROLL,D108,HJ,,390.22,251285.26
6170,6/30/2021,6/30/2021,63021,82L-IMPORT PAYROLL,D101,HJ,,130.11,251155.15
6170,6/30/2021,6/30/2021,63021,82L-IMPORT PAYROLL,D101,HJ,,130.11,251025.04
6170,6/30/2021,6/30/2021,63021,82L-IMPORT PAYROLL,D101,HJ,,136.92,250888.12
6170,6/30/2021,6/30/2021,63021,82L-IMPORT PAYROLL,D101,HJ,,136.92,250751.2
6170,6/30/2021,6/30/2021,63021,82L-IMPORT PAYROLL,D101,HJ,,136.92,250614.28
6170,6/30/2021,6/30/2021,63021,82L-IMPORT PAYROLL,D102,HJ,,130.11,250484.17
6170,6/30/2021,6/30/2021,63021,82L-IMPORT PAYROLL,D103,HJ,,130.11,250354.06
6170,6/30/2021,6/30/2021,63021,82L-IMPORT PAYROLL,D103,HJ,,136.92,250217.14
6170,6/30/2021,6/30/2021,63021,82L-IMPORT PAYROLL,D104,HJ,,130.11,250087.03
6170,6/30/2021,6/30/2021,63021,82L-IMPORT PAYROLL,D104,HJ,,136.92,249950.11
6170,6/30/2021,6/30/2021,63021,82L-IMPORT PAYROLL,D104,HJ,,136.92,249813.19
6170,6/30/2021,6/30/2021,63021,82L-IMPORT PAYROLL,D104,HJ,,136.92,249676.27
6170,6/30/2021,6/30/2021,63021,82L-IMPORT PAYROLL,D104,HJ,,240.7,249435.57
6170,6/30/2021,6/30/2021,63021,82L-IMPORT PAYROLL,D104,HJ,,370.8,249064.77
6170,6/30/2021,6/30/2021,63021,82L-IMPORT PAYROLL,D104,HJ,,370.8,248693.97
6170,6/30/2021,6/30/2021,63021,82L-IMPORT PAYROLL,D105,HJ,,130.11,248563.86
6170,6/30/2021,6/30/2021,63021,82L-IMPORT PAYROLL,D105,HJ,,136.92,248426.94
6170,6/30/2021,6/30/2021,63021,82L-IMPORT PAYROLL,D105,HJ,,136.92,248290.02
6170,6/30/2021,6/30/2021,63021,82L-IMPORT PAYROLL,D107,HJ,,136.92,248153.1
6170,6/30/2021,6/30/2021,63021,82L-IMPORT PAYROLL,D107,HJ,,240.7,247912.4
6170,6/30/2021,6/30/2021,63021,82L-IMPORT PAYROLL,D107,HJ,,273.84,247638.56
6170,6/30/2021,6/30/2021,63021,82L-IMPORT PAYROLL,D107,HJ,,370.8,247267.76
6170,6/30/2021,6/30/2021,63021,82L-IMPORT PAYROLL,D107,HJ,,370.8,246896.96
6170,6/30/2021,6/30/2021,63021,82L-IMPORT PAYROLL,D107,HJ,,390.22,246506.74
6170,6/30/2021,6/30/2021,63021,82L-IMPORT PAYROLL,D109,HJ,,130.11,246376.63
6170,6/30/2021,6/30/2021,63021,82L-IMPORT PAYROLL,D109,HJ,,130.11,246246.52
6170,6/30/2021,6/30/2021,63021,82L-IMPORT PAYROLL,D109,HJ,,136.92,246109.6
6170,6/30/2021,6/30/2021,63021,82L-IMPORT PAYROLL,D109,HJ,,136.92,245972.68
6170,6/30/2021,6/30/2021,63021,82L-IMPORT PAYROLL,D109,HJ,,136.92,245835.76
6170,6/30/2021,6/30/2021,63021,82L-IMPORT PAYROLL,D109,HJ,,390.22,245445.54
6170,6/30/2021,6/30/2021,63021,82L-IMPORT PAYROLL,D109,HJ,,390.22,245055.32
6170,6/30/2021,6/30/2021,63021,82L-IMPORT PAYROLL,D111,HJ,,130.11,244925.21
6170,6/30/2021,6/30/2021,63021,82L-IMPORT PAYROLL,D111,HJ,,130.11,244795.1
6170,6/30/2021,6/30/2021,63021,82L-IMPORT PAYROLL,D111,HJ,,130.11,244664.99
6170,6/30/2021,6/30/2021,63021,82L-IMPORT PAYROLL,D111,HJ,,130.11,244534.88
6170,6/30/2021,6/30/2021,63021,82L-IMPORT PAYROLL,D111,HJ,,136.92,244397.96
6170,6/30/2021,6/30/2021,63021,82L-IMPORT PAYROLL,D112,HJ,,273.84,244124.12
6170,6/30/2021,6/30/2021,63021,82L-IMPORT PAYROLL,D108,HJ,,65,244059.12
6170,6/30/2021,6/30/2021,63021,82L-IMPORT PAYROLL,D108,HJ,,65,243994.12
6170,6/30/2021,6/30/2021,63021,82L-IMPORT PAYROLL,D108,HJ,,65,243929.12
6170,6/30/2021,6/30/2021,63021,82L-IMPORT PAYROLL,D108,HJ,,65,243864.12
6170,6/30/2021,6/30/2021,63021,82L-IMPORT PAYROLL,D108,HJ,,65,243799.12
6170,6/30/2021,6/30/2021,63021,82L-IMPORT PAYROLL,D108,HJ,,130.11,243669.01
6170,6/30/2021,6/30/2021,63021,82L-IMPORT PAYROLL,D108,HJ,,130.11,243538.9
6170,6/30/2021,6/30/2021,63021,82L-IMPORT PAYROLL,D108,HJ,,130.11,243408.79
6170,6/30/2021,6/30/2021,63021,82L-IMPORT PAYROLL,D108,HJ,,130.11,243278.68
6170,6/30/2021,6/30/2021,63021,82L-IMPORT PAYROLL,D108,HJ,,136.92,243141.76
6170,6/30/2021,6/30/2021,63021,82L-IMPORT PAYROLL,D108,HJ,,136.92,243004.84
6170,6/30/2021,6/30/2021,63021,82L-IMPORT PAYROLL,D108,HJ,,136.92,242867.92
6170,6/30/2021,6/30/2021,63021,82L-IMPORT PAYROLL,D108,HJ,,136.92,242731
6170,6/30/2021,6/30/2021,63021,82L-IMPORT PAYROLL,D108,HJ,,136.92,242594.08
6170,6/30/2021,6/30/2021,63021,82L-IMPORT PAYROLL,D108,HJ,,136.92,242457.16
6170,6/30/2021,6/30/2021,63021,82L-IMPORT PAYROLL,D108,HJ,,390.22,242066.94
6170,6/30/2021,6/30/2021,63021,82L-IMPORT PAYROLL,D108,HJ,,130.11,241936.83
6170,6/30/2021,6/30/2021,63021,82L-IMPORT PAYROLL,D108,HJ,,130.11,241806.72
6170,6/30/2021,6/30/2021,63021,82L-IMPORT PAYROLL,D108,HJ,,136.92,241669.8
6170,6/30/2021,6/30/2021,63021,82L-IMPORT PAYROLL,D108,HJ,,136.92,241532.88
6170, Totals for 6170 - Staff Health Insurance,,,,,,679927.9,438395.02,241532.88
6175,6175 - Staff Dental and Vision Insurance (Balance forward As of 07/01/2020) ,,,,,,,,0
6175,7/1/2020,7/1/2020,BCBS -July,BCBS- July - BCBS Health Insurance-July -BCBS Health Insurance,D108,HJ,955.49,,955.49
6175,7/1/2020,7/1/2020,BCBS -July,BCBS- July - BCBS Health Insurance-July -BCBS Health Insurance,D107,HJ,191.32,,1146.81
6175,7/1/2020,7/1/2020,BCBS -July,BCBS- July - BCBS Health Insurance-July -BCBS Health Insurance,D107,HJ,721.04,,1867.85
6175,7/1/2020,7/1/2020,BCBS -July,BCBS- July - BCBS Health Insurance-July -BCBS Health Insurance,D108,HJ,239.15,,2107
6175,7/1/2020,7/1/2020,BCBS -July,BCBS- July - BCBS Health Insurance-July -BCBS Health Insurance,D108,HJ,143.49,,2250.49
6175,7/2/2020,7/2/2020,1.94E+12,Blue 20/20 Vision Insurance -July Invoice-Blue 20/20 Vision Insurance -July Invoice,D107,HJ,296.94,,2547.43
6175,7/15/2020,7/15/2020,71520,82L-PRPD-071520 -Import Payroll (GENERL)-AKLESTAD ISABEL,D108,HJ,,1.78,2545.65
6175,7/15/2020,7/15/2020,71520,82L-PRPD-071520 -Import Payroll (GENERL)-AKLESTAD ISABEL,D108,HJ,,11.96,2533.69
6175,7/15/2020,7/15/2020,71520,82L-PRPD-071520 -Import Payroll (GENERL)-AUSTIN PERCY,D108,HJ,,1.78,2531.91
6175,7/15/2020,7/15/2020,71520,82L-PRPD-071520 -Import Payroll (GENERL)-AUSTIN PERCY,D108,HJ,,14.83,2517.08
6175,7/15/2020,7/15/2020,71520,82L-PRPD-071520 -Import Payroll (GENERL)-BARTOLD DEANNA MARIE,D108,HJ,,1.78,2515.3
6175,7/15/2020,7/15/2020,71520,82L-PRPD-071520 -Import Payroll (GENERL)-BARTOLD DEANNA MARIE,D108,HJ,,11.96,2503.34
6175,7/15/2020,7/15/2020,71520,82L-PRPD-071520 -Import Payroll (GENERL)-BAUSH DANIEL,D108,HJ,,1.78,2501.56
6175,7/15/2020,7/15/2020,71520,82L-PRPD-071520 -Import Payroll (GENERL)-BAUSH DANIEL,D108,HJ,,11.96,2489.6
6175,7/15/2020,7/15/2020,71520,82L-PRPD-071520 -Import Payroll (GENERL)-CHAPMAN CLAUDY EARL,D108,HJ,,1.78,2487.82
6175,7/15/2020,7/15/2020,71520,82L-PRPD-071520 -Import Payroll (GENERL)-COOPER ASHLEE R,D108,HJ,,1.78,2486.04
6175,7/15/2020,7/15/2020,71520,82L-PRPD-071520 -Import Payroll (GENERL)-COOPER ASHLEE R,D108,HJ,,11.96,2474.08
6175,7/15/2020,7/15/2020,71520,82L-PRPD-071520 -Import Payroll (GENERL)-COVENEY ALLISON,D108,HJ,,1.78,2472.3
6175,7/15/2020,7/15/2020,71520,82L-PRPD-071520 -Import Payroll (GENERL)-COVENEY ALLISON,D108,HJ,,14.83,2457.47
6175,7/15/2020,7/15/2020,71520,82L-PRPD-071520 -Import Payroll (GENERL)-DADA ARIKPO E,D108,HJ,,5.23,2452.24
6175,7/15/2020,7/15/2020,71520,82L-PRPD-071520 -Import Payroll (GENERL)-DADA ARIKPO E,D108,HJ,,35.65,2416.59
6175,7/15/2020,7/15/2020,71520,82L-PRPD-071520 -Import Payroll (GENERL)-FEIGHERY JOHN,D108,HJ,,11.96,2404.63
6175,7/15/2020,7/15/2020,71520,82L-PRPD-071520 -Import Payroll (GENERL)-GRAVES KAMIESHIA,D108,HJ,,3.38,2401.25
6175,7/15/2020,7/15/2020,71520,82L-PRPD-071520 -Import Payroll (GENERL)-GRAVES KAMIESHIA,D108,HJ,,25.48,2375.77
6175,7/15/2020,7/15/2020,71520,82L-PRPD-071520 -Import Payroll (GENERL)-GRAVES KIRA B,D108,HJ,,1.78,2373.99
6175,7/15/2020,7/15/2020,71520,82L-PRPD-071520 -Import Payroll (GENERL)-GRAVES KIRA B,D108,HJ,,11.96,2362.03
6175,7/15/2020,7/15/2020,71520,82L-PRPD-071520 -Import Payroll (GENERL)-GUADARRAMA-ALVAREZ URIEL A,D108,HJ,,1.78,2360.25
6175,7/15/2020,7/15/2020,71520,82L-PRPD-071520 -Import Payroll (GENERL)-GUADARRAMA-ALVAREZ URIEL A,D108,HJ,,11.96,2348.29
6175,7/15/2020,7/15/2020,71520,82L-PRPD-071520 -Import Payroll (GENERL)-GUTHRIE LESLIE,D108,HJ,,1.78,2346.51
6175,7/15/2020,7/15/2020,71520,82L-PRPD-071520 -Import Payroll (GENERL)-GUTHRIE LESLIE,D108,HJ,,14.83,2331.68
6175,7/15/2020,7/15/2020,71520,82L-PRPD-071520 -Import Payroll (GENERL)-HALLINAN GABRIEL B,D108,HJ,,1.78,2329.9
6175,7/15/2020,7/15/2020,71520,82L-PRPD-071520 -Import Payroll (GENERL)-HALLINAN GABRIEL B,D108,HJ,,11.96,2317.94
6175,7/15/2020,7/15/2020,71520,82L-PRPD-071520 -Import Payroll (GENERL)-HOLMES JOREL ALEXANDER,D108,HJ,,1.78,2316.16
6175,7/15/2020,7/15/2020,71520,82L-PRPD-071520 -Import Payroll (GENERL)-HOLMES JOREL ALEXANDER,D108,HJ,,11.96,2304.2
6175,7/15/2020,7/15/2020,71520,82L-PRPD-071520 -Import Payroll (GENERL)-HOSSAIN MYESHA R,D108,HJ,,1.78,2302.42
6175,7/15/2020,7/15/2020,71520,82L-PRPD-071520 -Import Payroll (GENERL)-HOSSAIN MYESHA R,D108,HJ,,14.83,2287.59
6175,7/15/2020,7/15/2020,71520,82L-PRPD-071520 -Import Payroll (GENERL)-JACKSON CLAICE M,D108,HJ,,1.78,2285.81
6175,7/15/2020,7/15/2020,71520,82L-PRPD-071520 -Import Payroll (GENERL)-JACKSON CLAICE M,D108,HJ,,11.96,2273.85
6175,7/15/2020,7/15/2020,71520,82L-PRPD-071520 -Import Payroll (GENERL)-JACKSON TASNIM F,D108,HJ,,1.78,2272.07
6175,7/15/2020,7/15/2020,71520,82L-PRPD-071520 -Import Payroll (GENERL)-JACKSON TASNIM F,D108,HJ,,14.83,2257.24
6175,7/15/2020,7/15/2020,71520,82L-PRPD-071520 -Import Payroll (GENERL)-JANG DANIEL,D108,HJ,,1.78,2255.46
6175,7/15/2020,7/15/2020,71520,82L-PRPD-071520 -Import Payroll (GENERL)-JANG DANIEL,D108,HJ,,14.83,2240.63
6175,7/15/2020,7/15/2020,71520,82L-PRPD-071520 -Import Payroll (GENERL)-JORDAN TIFFANY T,D108,HJ,,5.23,2235.4
6175,7/15/2020,7/15/2020,71520,82L-PRPD-071520 -Import Payroll (GENERL)-JORDAN TIFFANY T,D108,HJ,,35.65,2199.75
6175,7/15/2020,7/15/2020,71520,82L-PRPD-071520 -Import Payroll (GENERL)-KAMYA MIRIAM L,D108,HJ,,1.78,2197.97
6175,7/15/2020,7/15/2020,71520,82L-PRPD-071520 -Import Payroll (GENERL)-KAMYA MIRIAM L,D108,HJ,,11.96,2186.01
6175,7/15/2020,7/15/2020,71520,82L-PRPD-071520 -Import Payroll (GENERL)-LACEY DEQUITA,D108,HJ,,1.78,2184.23
6175,7/15/2020,7/15/2020,71520,82L-PRPD-071520 -Import Payroll (GENERL)-LACEY DEQUITA,D108,HJ,,14.83,2169.4
6175,7/15/2020,7/15/2020,71520,82L-PRPD-071520 -Import Payroll (GENERL)-LANIGAN LISA A,D108,HJ,,3.56,2165.84
6175,7/15/2020,7/15/2020,71520,82L-PRPD-071520 -Import Payroll (GENERL)-LENEGHAN MARYELLEN B,D108,HJ,,1.78,2164.06
6175,7/15/2020,7/15/2020,71520,82L-PRPD-071520 -Import Payroll (GENERL)-LENEGHAN MARYELLEN B,D108,HJ,,11.96,2152.1
6175,7/15/2020,7/15/2020,71520,82L-PRPD-071520 -Import Payroll (GENERL)-LI BELLA,D108,HJ,,1.78,2150.32
6175,7/15/2020,7/15/2020,71520,82L-PRPD-071520 -Import Payroll (GENERL)-LI BELLA,D108,HJ,,11.96,2138.36
6175,7/15/2020,7/15/2020,71520,82L-PRPD-071520 -Import Payroll (GENERL)-LIPORACE HERNAN LUIS,D108,HJ,,11.96,2126.4
6175,7/15/2020,7/15/2020,71520,82L-PRPD-071520 -Import Payroll (GENERL)-MOSELEY ARIELLE,D108,HJ,,1.78,2124.62
6175,7/15/2020,7/15/2020,71520,82L-PRPD-071520 -Import Payroll (GENERL)-MOSELEY ARIELLE,D108,HJ,,11.96,2112.66
6175,7/15/2020,7/15/2020,71520,82L-PRPD-071520 -Import Payroll (GENERL)-ONICA ANTHONY J,D108,HJ,,1.78,2110.88
6175,7/15/2020,7/15/2020,71520,82L-PRPD-071520 -Import Payroll (GENERL)-ONICA ANTHONY J,D108,HJ,,11.96,2098.92
6175,7/15/2020,7/15/2020,71520,82L-PRPD-071520 -Import Payroll (GENERL)-PARHAM-GANTT DENISE M,D108,HJ,,3.56,2095.36
6175,7/15/2020,7/15/2020,71520,82L-PRPD-071520 -Import Payroll (GENERL)-PARHAM-GANTT DENISE M,D108,HJ,,31.6,2063.76
6175,7/15/2020,7/15/2020,71520,82L-PRPD-071520 -Import Payroll (GENERL)-PEINADO ELIZABETH R,D108,HJ,,1.78,2061.98
6175,7/15/2020,7/15/2020,71520,82L-PRPD-071520 -Import Payroll (GENERL)-PEINADO ELIZABETH R,D108,HJ,,11.96,2050.02
6175,7/15/2020,7/15/2020,71520,82L-PRPD-071520 -Import Payroll (GENERL)-PRAHIN NICOLE M,D108,HJ,,1.78,2048.24
6175,7/15/2020,7/15/2020,71520,82L-PRPD-071520 -Import Payroll (GENERL)-PRAHIN NICOLE M,D108,HJ,,11.96,2036.28
6175,7/15/2020,7/15/2020,71520,82L-PRPD-071520 -Import Payroll (GENERL)-RANDOLPH ALEXANDER,D108,HJ,,1.78,2034.5
6175,7/15/2020,7/15/2020,71520,82L-PRPD-071520 -Import Payroll (GENERL)-RANDOLPH ALEXANDER,D108,HJ,,11.96,2022.54
6175,7/15/2020,7/15/2020,71520,82L-PRPD-071520 -Import Payroll (GENERL)-SALIM YASSER,D108,HJ,,11.96,2010.58
6175,7/15/2020,7/15/2020,71520,82L-PRPD-071520 -Import Payroll (GENERL)-SEJOUR MAHALIAH,D108,HJ,,1.78,2008.8
6175,7/15/2020,7/15/2020,71520,82L-PRPD-071520 -Import Payroll (GENERL)-SEJOUR MAHALIAH,D108,HJ,,11.96,1996.84
6175,7/15/2020,7/15/2020,71520,82L-PRPD-071520 -Import Payroll (GENERL)-SMITH AKILAH,D108,HJ,,11.96,1984.88
6175,7/15/2020,7/15/2020,71520,82L-PRPD-071520 -Import Payroll (GENERL)-TENESACA VERONICA A,D108,HJ,,11.96,1972.92
6175,7/15/2020,7/15/2020,71520,82L-PRPD-071520 -Import Payroll (GENERL)-TUMENJARGAL ENKHJIN,D108,HJ,,1.78,1971.14
6175,7/15/2020,7/15/2020,71520,82L-PRPD-071520 -Import Payroll (GENERL)-TUMENJARGAL ENKHJIN,D108,HJ,,11.96,1959.18
6175,7/15/2020,7/15/2020,71520,82L-PRPD-071520 -Import Payroll (GENERL)-VILLEGAS EVELYN,D108,HJ,,5.23,1953.95
6175,7/15/2020,7/15/2020,71520,82L-PRPD-071520 -Import Payroll (GENERL)-VILLEGAS EVELYN,D108,HJ,,35.65,1918.3
6175,7/15/2020,7/15/2020,71520,82L-PRPD-071520 -Import Payroll (GENERL)-WALLACE AMENA T,D108,HJ,,11.96,1906.34
6175,7/15/2020,7/15/2020,71520,82L-PRPD-071520 -Import Payroll (GENERL)-WOLF ANNA A,D108,HJ,,1.78,1904.56
6175,7/15/2020,7/15/2020,71520,To reverse 82L payroll 0715 JE-21-0008-Reverse payroll entry 07152020 IMPORT PAYROLL,D108,HJ,1.78,,1906.34
6175,7/15/2020,7/15/2020,71520,To reverse 82L payroll 0715 JE-21-0008-Reverse payroll entry 07152020 IMPORT PAYROLL,D108,HJ,1.78,,1908.12
6175,7/15/2020,7/15/2020,71520,To reverse 82L payroll 0715 JE-21-0008-Reverse payroll entry 07152020 IMPORT PAYROLL,D108,HJ,1.78,,1909.9
6175,7/15/2020,7/15/2020,71520,To reverse 82L payroll 0715 JE-21-0008-Reverse payroll entry 07152020 IMPORT PAYROLL,D108,HJ,1.78,,1911.68
6175,7/15/2020,7/15/2020,71520,To reverse 82L payroll 0715 JE-21-0008-Reverse payroll entry 07152020 IMPORT PAYROLL,D108,HJ,1.78,,1913.46
6175,7/15/2020,7/15/2020,71520,To reverse 82L payroll 0715 JE-21-0008-Reverse payroll entry 07152020 IMPORT PAYROLL,D108,HJ,1.78,,1915.24
6175,7/15/2020,7/15/2020,71520,To reverse 82L payroll 0715 JE-21-0008-Reverse payroll entry 07152020 IMPORT PAYROLL,D108,HJ,1.78,,1917.02
6175,7/15/2020,7/15/2020,71520,To reverse 82L payroll 0715 JE-21-0008-Reverse payroll entry 07152020 IMPORT PAYROLL,D108,HJ,1.78,,1918.8
6175,7/15/2020,7/15/2020,71520,To reverse 82L payroll 0715 JE-21-0008-Reverse payroll entry 07152020 IMPORT PAYROLL,D108,HJ,1.78,,1920.58
6175,7/15/2020,7/15/2020,71520,To reverse 82L payroll 0715 JE-21-0008-Reverse payroll entry 07152020 IMPORT PAYROLL,D108,HJ,1.78,,1922.36
6175,7/15/2020,7/15/2020,71520,To reverse 82L payroll 0715 JE-21-0008-Reverse payroll entry 07152020 IMPORT PAYROLL,D108,HJ,1.78,,1924.14
6175,7/15/2020,7/15/2020,71520,To reverse 82L payroll 0715 JE-21-0008-Reverse payroll entry 07152020 IMPORT PAYROLL,D108,HJ,1.78,,1925.92
6175,7/15/2020,7/15/2020,71520,To reverse 82L payroll 0715 JE-21-0008-Reverse payroll entry 07152020 IMPORT PAYROLL,D108,HJ,1.78,,1927.7
6175,7/15/2020,7/15/2020,71520,To reverse 82L payroll 0715 JE-21-0008-Reverse payroll entry 07152020 IMPORT PAYROLL,D108,HJ,1.78,,1929.48
6175,7/15/2020,7/15/2020,71520,To reverse 82L payroll 0715 JE-21-0008-Reverse payroll entry 07152020 IMPORT PAYROLL,D108,HJ,1.78,,1931.26
6175,7/15/2020,7/15/2020,71520,To reverse 82L payroll 0715 JE-21-0008-Reverse payroll entry 07152020 IMPORT PAYROLL,D108,HJ,1.78,,1933.04
6175,7/15/2020,7/15/2020,71520,To reverse 82L payroll 0715 JE-21-0008-Reverse payroll entry 07152020 IMPORT PAYROLL,D108,HJ,1.78,,1934.82
6175,7/15/2020,7/15/2020,71520,To reverse 82L payroll 0715 JE-21-0008-Reverse payroll entry 07152020 IMPORT PAYROLL,D108,HJ,1.78,,1936.6
6175,7/15/2020,7/15/2020,71520,To reverse 82L payroll 0715 JE-21-0008-Reverse payroll entry 07152020 IMPORT PAYROLL,D108,HJ,1.78,,1938.38
6175,7/15/2020,7/15/2020,71520,To reverse 82L payroll 0715 JE-21-0008-Reverse payroll entry 07152020 IMPORT PAYROLL,D108,HJ,1.78,,1940.16
6175,7/15/2020,7/15/2020,71520,To reverse 82L payroll 0715 JE-21-0008-Reverse payroll entry 07152020 IMPORT PAYROLL,D108,HJ,1.78,,1941.94
6175,7/15/2020,7/15/2020,71520,To reverse 82L payroll 0715 JE-21-0008-Reverse payroll entry 07152020 IMPORT PAYROLL,D108,HJ,1.78,,1943.72
6175,7/15/2020,7/15/2020,71520,To reverse 82L payroll 0715 JE-21-0008-Reverse payroll entry 07152020 IMPORT PAYROLL,D108,HJ,1.78,,1945.5
6175,7/15/2020,7/15/2020,71520,To reverse 82L payroll 0715 JE-21-0008-Reverse payroll entry 07152020 IMPORT PAYROLL,D108,HJ,1.78,,1947.28
6175,7/15/2020,7/15/2020,71520,To reverse 82L payroll 0715 JE-21-0008-Reverse payroll entry 07152020 IMPORT PAYROLL,D108,HJ,1.78,,1949.06
6175,7/15/2020,7/15/2020,71520,To reverse 82L payroll 0715 JE-21-0008-Reverse payroll entry 07152020 IMPORT PAYROLL,D108,HJ,1.78,,1950.84
6175,7/15/2020,7/15/2020,71520,To reverse 82L payroll 0715 JE-21-0008-Reverse payroll entry 07152020 IMPORT PAYROLL,D108,HJ,1.78,,1952.62
6175,7/15/2020,7/15/2020,71520,To reverse 82L payroll 0715 JE-21-0008-Reverse payroll entry 07152020 IMPORT PAYROLL,D108,HJ,1.78,,1954.4
6175,7/15/2020,7/15/2020,71520,To reverse 82L payroll 0715 JE-21-0008-Reverse payroll entry 07152020 IMPORT PAYROLL,D108,HJ,3.38,,1957.78
6175,7/15/2020,7/15/2020,71520,To reverse 82L payroll 0715 JE-21-0008-Reverse payroll entry 07152020 IMPORT PAYROLL,D108,HJ,3.56,,1961.34
6175,7/15/2020,7/15/2020,71520,To reverse 82L payroll 0715 JE-21-0008-Reverse payroll entry 07152020 IMPORT PAYROLL,D108,HJ,3.56,,1964.9
6175,7/15/2020,7/15/2020,71520,To reverse 82L payroll 0715 JE-21-0008-Reverse payroll entry 07152020 IMPORT PAYROLL,D108,HJ,5.23,,1970.13
6175,7/15/2020,7/15/2020,71520,To reverse 82L payroll 0715 JE-21-0008-Reverse payroll entry 07152020 IMPORT PAYROLL,D108,HJ,5.23,,1975.36
6175,7/15/2020,7/15/2020,71520,To reverse 82L payroll 0715 JE-21-0008-Reverse payroll entry 07152020 IMPORT PAYROLL,D108,HJ,5.23,,1980.59
6175,7/15/2020,7/15/2020,71520,To reverse 82L payroll 0715 JE-21-0008-Reverse payroll entry 07152020 IMPORT PAYROLL,D108,HJ,11.96,,1992.55
6175,7/15/2020,7/15/2020,71520,To reverse 82L payroll 0715 JE-21-0008-Reverse payroll entry 07152020 IMPORT PAYROLL,D108,HJ,11.96,,2004.51
6175,7/15/2020,7/15/2020,71520,To reverse 82L payroll 0715 JE-21-0008-Reverse payroll entry 07152020 IMPORT PAYROLL,D108,HJ,11.96,,2016.47
6175,7/15/2020,7/15/2020,71520,To reverse 82L payroll 0715 JE-21-0008-Reverse payroll entry 07152020 IMPORT PAYROLL,D108,HJ,11.96,,2028.43
6175,7/15/2020,7/15/2020,71520,To reverse 82L payroll 0715 JE-21-0008-Reverse payroll entry 07152020 IMPORT PAYROLL,D108,HJ,11.96,,2040.39
6175,7/15/2020,7/15/2020,71520,To reverse 82L payroll 0715 JE-21-0008-Reverse payroll entry 07152020 IMPORT PAYROLL,D108,HJ,11.96,,2052.35
6175,7/15/2020,7/15/2020,71520,To reverse 82L payroll 0715 JE-21-0008-Reverse payroll entry 07152020 IMPORT PAYROLL,D108,HJ,11.96,,2064.31
6175,7/15/2020,7/15/2020,71520,To reverse 82L payroll 0715 JE-21-0008-Reverse payroll entry 07152020 IMPORT PAYROLL,D108,HJ,11.96,,2076.27
6175,7/15/2020,7/15/2020,71520,To reverse 82L payroll 0715 JE-21-0008-Reverse payroll entry 07152020 IMPORT PAYROLL,D108,HJ,11.96,,2088.23
6175,7/15/2020,7/15/2020,71520,To reverse 82L payroll 0715 JE-21-0008-Reverse payroll entry 07152020 IMPORT PAYROLL,D108,HJ,11.96,,2100.19
6175,7/15/2020,7/15/2020,71520,To reverse 82L payroll 0715 JE-21-0008-Reverse payroll entry 07152020 IMPORT PAYROLL,D108,HJ,11.96,,2112.15
6175,7/15/2020,7/15/2020,71520,To reverse 82L payroll 0715 JE-21-0008-Reverse payroll entry 07152020 IMPORT PAYROLL,D108,HJ,11.96,,2124.11
6175,7/15/2020,7/15/2020,71520,To reverse 82L payroll 0715 JE-21-0008-Reverse payroll entry 07152020 IMPORT PAYROLL,D108,HJ,11.96,,2136.07
6175,7/15/2020,7/15/2020,71520,To reverse 82L payroll 0715 JE-21-0008-Reverse payroll entry 07152020 IMPORT PAYROLL,D108,HJ,11.96,,2148.03
6175,7/15/2020,7/15/2020,71520,To reverse 82L payroll 0715 JE-21-0008-Reverse payroll entry 07152020 IMPORT PAYROLL,D108,HJ,11.96,,2159.99
6175,7/15/2020,7/15/2020,71520,To reverse 82L payroll 0715 JE-21-0008-Reverse payroll entry 07152020 IMPORT PAYROLL,D108,HJ,11.96,,2171.95
6175,7/15/2020,7/15/2020,71520,To reverse 82L payroll 0715 JE-21-0008-Reverse payroll entry 07152020 IMPORT PAYROLL,D108,HJ,11.96,,2183.91
6175,7/15/2020,7/15/2020,71520,To reverse 82L payroll 0715 JE-21-0008-Reverse payroll entry 07152020 IMPORT PAYROLL,D108,HJ,11.96,,2195.87
6175,7/15/2020,7/15/2020,71520,To reverse 82L payroll 0715 JE-21-0008-Reverse payroll entry 07152020 IMPORT PAYROLL,D108,HJ,11.96,,2207.83
6175,7/15/2020,7/15/2020,71520,To reverse 82L payroll 0715 JE-21-0008-Reverse payroll entry 07152020 IMPORT PAYROLL,D108,HJ,11.96,,2219.79
6175,7/15/2020,7/15/2020,71520,To reverse 82L payroll 0715 JE-21-0008-Reverse payroll entry 07152020 IMPORT PAYROLL,D108,HJ,11.96,,2231.75
6175,7/15/2020,7/15/2020,71520,To reverse 82L payroll 0715 JE-21-0008-Reverse payroll entry 07152020 IMPORT PAYROLL,D108,HJ,11.96,,2243.71
6175,7/15/2020,7/15/2020,71520,To reverse 82L payroll 0715 JE-21-0008-Reverse payroll entry 07152020 IMPORT PAYROLL,D108,HJ,11.96,,2255.67
6175,7/15/2020,7/15/2020,71520,To reverse 82L payroll 0715 JE-21-0008-Reverse payroll entry 07152020 IMPORT PAYROLL,D108,HJ,11.96,,2267.63
6175,7/15/2020,7/15/2020,71520,To reverse 82L payroll 0715 JE-21-0008-Reverse payroll entry 07152020 IMPORT PAYROLL,D108,HJ,11.96,,2279.59
6175,7/15/2020,7/15/2020,71520,To reverse 82L payroll 0715 JE-21-0008-Reverse payroll entry 07152020 IMPORT PAYROLL,D108,HJ,14.83,,2294.42
6175,7/15/2020,7/15/2020,71520,To reverse 82L payroll 0715 JE-21-0008-Reverse payroll entry 07152020 IMPORT PAYROLL,D108,HJ,14.83,,2309.25
6175,7/15/2020,7/15/2020,71520,To reverse 82L payroll 0715 JE-21-0008-Reverse payroll entry 07152020 IMPORT PAYROLL,D108,HJ,14.83,,2324.08
6175,7/15/2020,7/15/2020,71520,To reverse 82L payroll 0715 JE-21-0008-Reverse payroll entry 07152020 IMPORT PAYROLL,D108,HJ,14.83,,2338.91
6175,7/15/2020,7/15/2020,71520,To reverse 82L payroll 0715 JE-21-0008-Reverse payroll entry 07152020 IMPORT PAYROLL,D108,HJ,14.83,,2353.74
6175,7/15/2020,7/15/2020,71520,To reverse 82L payroll 0715 JE-21-0008-Reverse payroll entry 07152020 IMPORT PAYROLL,D108,HJ,14.83,,2368.57
6175,7/15/2020,7/15/2020,71520,To reverse 82L payroll 0715 JE-21-0008-Reverse payroll entry 07152020 IMPORT PAYROLL,D108,HJ,14.83,,2383.4
6175,7/15/2020,7/15/2020,71520,To reverse 82L payroll 0715 JE-21-0008-Reverse payroll entry 07152020 IMPORT PAYROLL,D108,HJ,25.48,,2408.88
6175,7/15/2020,7/15/2020,71520,To reverse 82L payroll 0715 JE-21-0008-Reverse payroll entry 07152020 IMPORT PAYROLL,D108,HJ,31.6,,2440.48
6175,7/15/2020,7/15/2020,71520,To reverse 82L payroll 0715 JE-21-0008-Reverse payroll entry 07152020 IMPORT PAYROLL,D108,HJ,35.65,,2476.13
6175,7/15/2020,7/15/2020,71520,To reverse 82L payroll 0715 JE-21-0008-Reverse payroll entry 07152020 IMPORT PAYROLL,D108,HJ,35.65,,2511.78
6175,7/15/2020,7/15/2020,71520,To reverse 82L payroll 0715 JE-21-0008-Reverse payroll entry 07152020 IMPORT PAYROLL,D108,HJ,35.65,,2547.43
6175,7/15/2020,7/15/2020,71520,82L-IMPORT PAYROLL-AUSTIN PERCY,D108,HJ,,1.78,2545.65
6175,7/15/2020,7/15/2020,71520,82L-IMPORT PAYROLL-AUSTIN PERCY,D108,HJ,,14.83,2530.82
6175,7/15/2020,7/15/2020,71520,82L-IMPORT PAYROLL-BAUSH DANIEL,D108,HJ,,1.78,2529.04
6175,7/15/2020,7/15/2020,71520,82L-IMPORT PAYROLL-BAUSH DANIEL,D108,HJ,,11.96,2517.08
6175,7/15/2020,7/15/2020,71520,82L-IMPORT PAYROLL-CHAPMAN CLAUDY EARL,D108,HJ,,1.78,2515.3
6175,7/15/2020,7/15/2020,71520,82L-IMPORT PAYROLL-DADA ARIKPO E,D108,HJ,,5.23,2510.07
6175,7/15/2020,7/15/2020,71520,82L-IMPORT PAYROLL-DADA ARIKPO E,D108,HJ,,35.65,2474.42
6175,7/15/2020,7/15/2020,71520,82L-IMPORT PAYROLL-GUTHRIE LESLIE,D108,HJ,,1.78,2472.64
6175,7/15/2020,7/15/2020,71520,82L-IMPORT PAYROLL-GUTHRIE LESLIE,D108,HJ,,14.83,2457.81
6175,7/15/2020,7/15/2020,71520,82L-IMPORT PAYROLL-HOLMES JOREL ALEXANDER,D108,HJ,,1.78,2456.03
6175,7/15/2020,7/15/2020,71520,82L-IMPORT PAYROLL-HOLMES JOREL ALEXANDER,D108,HJ,,11.96,2444.07
6175,7/15/2020,7/15/2020,71520,82L-IMPORT PAYROLL-JORDAN TIFFANY T,D108,HJ,,5.23,2438.84
6175,7/15/2020,7/15/2020,71520,82L-IMPORT PAYROLL-JORDAN TIFFANY T,D108,HJ,,35.65,2403.19
6175,7/15/2020,7/15/2020,71520,82L-IMPORT PAYROLL-KAMYA MIRIAM L,D108,HJ,,1.78,2401.41
6175,7/15/2020,7/15/2020,71520,82L-IMPORT PAYROLL-KAMYA MIRIAM L,D108,HJ,,11.96,2389.45
6175,7/15/2020,7/15/2020,71520,82L-IMPORT PAYROLL-LANIGAN LISA A,D108,HJ,,3.56,2385.89
6175,7/15/2020,7/15/2020,71520,82L-IMPORT PAYROLL-ONICA ANTHONY J,D108,HJ,,1.78,2384.11
6175,7/15/2020,7/15/2020,71520,82L-IMPORT PAYROLL-ONICA ANTHONY J,D108,HJ,,11.96,2372.15
6175,7/15/2020,7/15/2020,71520,82L-IMPORT PAYROLL-PRAHIN NICOLE M,D108,HJ,,1.78,2370.37
6175,7/15/2020,7/15/2020,71520,82L-IMPORT PAYROLL-PRAHIN NICOLE M,D108,HJ,,11.96,2358.41
6175,7/15/2020,7/15/2020,71520,82L-IMPORT PAYROLL-SALIM YASSER,D108,HJ,,11.96,2346.45
6175,7/15/2020,7/15/2020,71520,82L-IMPORT PAYROLL-SEJOUR MAHALIAH,D108,HJ,,1.78,2344.67
6175,7/15/2020,7/15/2020,71520,82L-IMPORT PAYROLL-SEJOUR MAHALIAH,D108,HJ,,11.96,2332.71
6175,7/15/2020,7/15/2020,71520,82L-IMPORT PAYROLL-SMITH AKILAH,D108,HJ,,11.96,2320.75
6175,7/15/2020,7/15/2020,71520,82L-IMPORT PAYROLL-TENESACA VERONICA A,D108,HJ,,11.96,2308.79
6175,7/15/2020,7/15/2020,71520,82L-IMPORT PAYROLL-TUMENJARGAL ENKHJIN,D108,HJ,,1.78,2307.01
6175,7/15/2020,7/15/2020,71520,82L-IMPORT PAYROLL-TUMENJARGAL ENKHJIN,D108,HJ,,11.96,2295.05
6175,7/15/2020,7/15/2020,71520,82L-IMPORT PAYROLL-VILLEGAS EVELYN,D108,HJ,,5.23,2289.82
6175,7/15/2020,7/15/2020,71520,82L-IMPORT PAYROLL-VILLEGAS EVELYN,D108,HJ,,35.65,2254.17
6175,7/15/2020,7/15/2020,71520,82L-IMPORT PAYROLL-WOLF ANNA A,D108,HJ,,1.78,2252.39
6175,7/15/2020,7/15/2020,71520,82L-PRPD-071520 -Import Payroll (PPP)-ACEVEDO MONIVETT,D103,HJ,,25.48,2226.91
6175,7/15/2020,7/15/2020,71520,82L-PRPD-071520 -Import Payroll (PPP)-COOK CATHRYN ANNA,D105,HJ,,1.78,2225.13
6175,7/15/2020,7/15/2020,71520,82L-PRPD-071520 -Import Payroll (PPP)-COOK CATHRYN ANNA,D105,HJ,,14.83,2210.3
6175,7/15/2020,7/15/2020,71520,82L-PRPD-071520 -Import Payroll (PPP)-DETONE KYRA MAYA,D102,HJ,,1.78,2208.52
6175,7/15/2020,7/15/2020,71520,82L-PRPD-071520 -Import Payroll (PPP)-DETONE KYRA MAYA,D102,HJ,,11.96,2196.56
6175,7/15/2020,7/15/2020,71520,82L-PRPD-071520 -Import Payroll (PPP)-DUPUIS CHRISTOPHER M,D108,HJ,,1.78,2194.78
6175,7/15/2020,7/15/2020,71520,82L-PRPD-071520 -Import Payroll (PPP)-DUPUIS CHRISTOPHER M,D108,HJ,,11.96,2182.82
6175,7/15/2020,7/15/2020,71520,82L-PRPD-071520 -Import Payroll (PPP)-GUTIERREZ ANTONIO J,D102,HJ,,35.65,2147.17
6175,7/15/2020,7/15/2020,71520,82L-PRPD-071520 -Import Payroll (PPP)-MASON ANGELA,D111,HJ,,5.23,2141.94
6175,7/15/2020,7/15/2020,71520,82L-PRPD-071520 -Import Payroll (PPP)-MASON ANGELA,D111,HJ,,35.65,2106.29
6175,7/15/2020,7/15/2020,71520,82L-PRPD-071520 -Import Payroll (PPP)-POLANCO ODALIS,D103,HJ,,1.78,2104.51
6175,7/15/2020,7/15/2020,71520,82L-PRPD-071520 -Import Payroll (PPP)-POLANCO ODALIS,D103,HJ,,11.96,2092.55
6175,7/15/2020,7/15/2020,71520,82L-PRPD-071520 -Import Payroll (PPP)-SAFRAN ALAN P,D102,HJ,,3.56,2088.99
6175,7/15/2020,7/15/2020,71520,82L-PRPD-071520 -Import Payroll (PPP)-SAFRAN ALAN P,D102,HJ,,35.65,2053.34
6175,7/15/2020,7/15/2020,71520,82L-IMPORT PAYROLL-AKLESTAD ISABEL,D111,HJ,,1.78,2051.56
6175,7/15/2020,7/15/2020,71520,82L-IMPORT PAYROLL-AKLESTAD ISABEL,D111,HJ,,11.96,2039.6
6175,7/15/2020,7/15/2020,71520,82L-IMPORT PAYROLL-COOPER ASHLEE R,D101,HJ,,1.78,2037.82
6175,7/15/2020,7/15/2020,71520,82L-IMPORT PAYROLL-COOPER ASHLEE R,D101,HJ,,11.96,2025.86
6175,7/15/2020,7/15/2020,71520,82L-IMPORT PAYROLL-GRAVES KAMIESHIA,D101,HJ,,3.38,2022.48
6175,7/15/2020,7/15/2020,71520,82L-IMPORT PAYROLL-GRAVES KAMIESHIA,D101,HJ,,25.48,1997
6175,7/15/2020,7/15/2020,71520,82L-IMPORT PAYROLL-GUADARRAMA-ALVAREZ URIEL A,D105,HJ,,1.78,1995.22
6175,7/15/2020,7/15/2020,71520,82L-IMPORT PAYROLL-GUADARRAMA-ALVAREZ URIEL A,D105,HJ,,11.96,1983.26
6175,7/15/2020,7/15/2020,71520,82L-IMPORT PAYROLL-LACEY DEQUITA,D107,HJ,,1.78,1981.48
6175,7/15/2020,7/15/2020,71520,82L-IMPORT PAYROLL-LACEY DEQUITA,D107,HJ,,14.83,1966.65
6175,7/15/2020,7/15/2020,71520,82L-IMPORT PAYROLL-LIPORACE HERNAN LUIS,D103,HJ,,11.96,1954.69
6175,7/15/2020,7/15/2020,71520,82L-IMPORT PAYROLL-PARHAM-GANTT DENISE M,D112,HJ,,3.56,1951.13
6175,7/15/2020,7/15/2020,71520,82L-IMPORT PAYROLL-PARHAM-GANTT DENISE M,D112,HJ,,31.6,1919.53
6175,7/15/2020,7/15/2020,71520,82L-IMPORT PAYROLL-PEINADO ELIZABETH R,D111,HJ,,1.78,1917.75
6175,7/15/2020,7/15/2020,71520,82L-IMPORT PAYROLL-PEINADO ELIZABETH R,D111,HJ,,11.96,1905.79
6175,7/15/2020,7/15/2020,71520,82L-IMPORT PAYROLL-RANDOLPH ALEXANDER,D111,HJ,,1.78,1904.01
6175,7/15/2020,7/15/2020,71520,82L-IMPORT PAYROLL-RANDOLPH ALEXANDER,D111,HJ,,11.96,1892.05
6175,7/15/2020,7/15/2020,71520,82L-IMPORT PAYROLL-WALLACE AMENA T,D104,HJ,,11.96,1880.09
6175,7/15/2020,7/15/2020,71520,82L-IMPORT PAYROLL-BARTOLD DEANNA MARIE,D108,HJ,,1.78,1878.31
6175,7/15/2020,7/15/2020,71520,82L-IMPORT PAYROLL-BARTOLD DEANNA MARIE,D108,HJ,,11.96,1866.35
6175,7/15/2020,7/15/2020,71520,82L-IMPORT PAYROLL-FEIGHERY JOHN,D108,HJ,,11.96,1854.39
6175,7/15/2020,7/15/2020,71520,82L-IMPORT PAYROLL-HALLINAN GABRIEL B,D108,HJ,,1.78,1852.61
6175,7/15/2020,7/15/2020,71520,82L-IMPORT PAYROLL-HALLINAN GABRIEL B,D108,HJ,,11.96,1840.65
6175,7/15/2020,7/15/2020,71520,82L-IMPORT PAYROLL-HOSSAIN MYESHA R,D108,HJ,,1.78,1838.87
6175,7/15/2020,7/15/2020,71520,82L-IMPORT PAYROLL-HOSSAIN MYESHA R,D108,HJ,,14.83,1824.04
6175,7/15/2020,7/15/2020,71520,82L-IMPORT PAYROLL-JACKSON TASNIM F,D108,HJ,,1.78,1822.26
6175,7/15/2020,7/15/2020,71520,82L-IMPORT PAYROLL-JACKSON TASNIM F,D108,HJ,,14.83,1807.43
6175,7/15/2020,7/15/2020,71520,82L-IMPORT PAYROLL-LI BELLA,D108,HJ,,1.78,1805.65
6175,7/15/2020,7/15/2020,71520,82L-IMPORT PAYROLL-LI BELLA,D108,HJ,,11.96,1793.69
6175,7/15/2020,7/15/2020,71520,82L-IMPORT PAYROLL-MOSELEY ARIELLE,D108,HJ,,1.78,1791.91
6175,7/15/2020,7/15/2020,71520,82L-IMPORT PAYROLL-MOSELEY ARIELLE,D108,HJ,,11.96,1779.95
6175,7/15/2020,7/15/2020,71520,82L-IMPORT PAYROLL-COVENEY ALLISON,D108,HJ,,1.78,1778.17
6175,7/15/2020,7/15/2020,71520,82L-IMPORT PAYROLL-COVENEY ALLISON,D108,HJ,,14.83,1763.34
6175,7/15/2020,7/15/2020,71520,82L-IMPORT PAYROLL-GRAVES KIRA B,D101,HJ,,1.78,1761.56
6175,7/15/2020,7/15/2020,71520,82L-IMPORT PAYROLL-GRAVES KIRA B,D101,HJ,,11.96,1749.6
6175,7/15/2020,7/15/2020,71520,82L-IMPORT PAYROLL-JACKSON CLAICE M,D108,HJ,,1.78,1747.82
6175,7/15/2020,7/15/2020,71520,82L-IMPORT PAYROLL-JACKSON CLAICE M,D108,HJ,,11.96,1735.86
6175,7/15/2020,7/15/2020,71520,82L-IMPORT PAYROLL-JANG DANIEL,D108,HJ,,1.78,1734.08
6175,7/15/2020,7/15/2020,71520,82L-IMPORT PAYROLL-JANG DANIEL,D108,HJ,,14.83,1719.25
6175,7/15/2020,7/15/2020,71520,82L-IMPORT PAYROLL-LENEGHAN MARYELLEN B,D108,HJ,,1.78,1717.47
6175,7/15/2020,7/15/2020,71520,82L-IMPORT PAYROLL-LENEGHAN MARYELLEN B,D108,HJ,,11.96,1705.51
6175,7/31/2020,7/31/2020,73120,82L-IMPORT PAYROLL-LIPSCOMB STEPHEN,D108,HJ,,1.78,1703.73
6175,7/31/2020,7/31/2020,73120,82L-IMPORT PAYROLL-LIPSCOMB STEPHEN,D108,HJ,,11.96,1691.77
6175,7/31/2020,7/31/2020,73120,82L-IMPORT PAYROLL-SILVER KELLY,D108,HJ,,1.78,1689.99
6175,7/31/2020,7/31/2020,73120,82L-IMPORT PAYROLL-SILVER KELLY,D108,HJ,,14.83,1675.16
6175,7/31/2020,7/31/2020,73120,82L-PRPD-073120 -Import Payroll-ACEVEDO MONIVETT,D108,HJ,,25.48,1649.68
6175,7/31/2020,7/31/2020,73120,82L-PRPD-073120 -Import Payroll-AKLESTAD ISABEL,D108,HJ,,1.78,1647.9
6175,7/31/2020,7/31/2020,73120,82L-PRPD-073120 -Import Payroll-AKLESTAD ISABEL,D108,HJ,,11.96,1635.94
6175,7/31/2020,7/31/2020,73120,82L-PRPD-073120 -Import Payroll-AUSTIN PERCY,D108,HJ,,1.78,1634.16
6175,7/31/2020,7/31/2020,73120,82L-PRPD-073120 -Import Payroll-AUSTIN PERCY,D108,HJ,,14.83,1619.33
6175,7/31/2020,7/31/2020,73120,82L-PRPD-073120 -Import Payroll-BARTOLD DEANNA MARIE,D108,HJ,,1.78,1617.55
6175,7/31/2020,7/31/2020,73120,82L-PRPD-073120 -Import Payroll-BARTOLD DEANNA MARIE,D108,HJ,,11.96,1605.59
6175,7/31/2020,7/31/2020,73120,82L-PRPD-073120 -Import Payroll-BAUSH DANIEL,D108,HJ,,1.78,1603.81
6175,7/31/2020,7/31/2020,73120,82L-PRPD-073120 -Import Payroll-BAUSH DANIEL,D108,HJ,,11.96,1591.85
6175,7/31/2020,7/31/2020,73120,82L-PRPD-073120 -Import Payroll-BELLOT GENESIS,D108,HJ,,1.78,1590.07
6175,7/31/2020,7/31/2020,73120,82L-PRPD-073120 -Import Payroll-BELLOT GENESIS,D108,HJ,,14.83,1575.24
6175,7/31/2020,7/31/2020,73120,82L-PRPD-073120 -Import Payroll-CHAPMAN CLAUDY EARL,D108,HJ,,1.78,1573.46
6175,7/31/2020,7/31/2020,73120,82L-PRPD-073120 -Import Payroll-CHAPMAN CLAUDY EARL,D108,HJ,,11.96,1561.5
6175,7/31/2020,7/31/2020,73120,82L-PRPD-073120 -Import Payroll-COOK CATHRYN ANNA,D108,HJ,,1.78,1559.72
6175,7/31/2020,7/31/2020,73120,82L-PRPD-073120 -Import Payroll-COOK CATHRYN ANNA,D108,HJ,,14.83,1544.89
6175,7/31/2020,7/31/2020,73120,82L-PRPD-073120 -Import Payroll-COOPER ASHLEE R,D108,HJ,,1.78,1543.11
6175,7/31/2020,7/31/2020,73120,82L-PRPD-073120 -Import Payroll-COOPER ASHLEE R,D108,HJ,,11.96,1531.15
6175,7/31/2020,7/31/2020,73120,82L-PRPD-073120 -Import Payroll-COVENEY ALLISON,D108,HJ,,1.78,1529.37
6175,7/31/2020,7/31/2020,73120,82L-PRPD-073120 -Import Payroll-COVENEY ALLISON,D108,HJ,,14.83,1514.54
6175,7/31/2020,7/31/2020,73120,82L-PRPD-073120 -Import Payroll-DADA ARIKPO E,D108,HJ,,5.23,1509.31
6175,7/31/2020,7/31/2020,73120,82L-PRPD-073120 -Import Payroll-DADA ARIKPO E,D108,HJ,,35.65,1473.66
6175,7/31/2020,7/31/2020,73120,82L-PRPD-073120 -Import Payroll-DETONE KYRA MAYA,D108,HJ,,1.78,1471.88
6175,7/31/2020,7/31/2020,73120,82L-PRPD-073120 -Import Payroll-DETONE KYRA MAYA,D108,HJ,,11.96,1459.92
6175,7/31/2020,7/31/2020,73120,82L-PRPD-073120 -Import Payroll-DUPUIS CHRISTOPHER M,D108,HJ,,1.78,1458.14
6175,7/31/2020,7/31/2020,73120,82L-PRPD-073120 -Import Payroll-DUPUIS CHRISTOPHER M,D108,HJ,,11.96,1446.18
6175,7/31/2020,7/31/2020,73120,82L-PRPD-073120 -Import Payroll-DZIEDZIC JULIE K,D108,HJ,,3.38,1442.8
6175,7/31/2020,7/31/2020,73120,82L-PRPD-073120 -Import Payroll-DZIEDZIC JULIE K,D108,HJ,,25.48,1417.32
6175,7/31/2020,7/31/2020,73120,82L-PRPD-073120 -Import Payroll-FEIGHERY JOHN,D108,HJ,,11.96,1405.36
6175,7/31/2020,7/31/2020,73120,82L-PRPD-073120 -Import Payroll-GRAVES KAMIESHIA,D108,HJ,,3.38,1401.98
6175,7/31/2020,7/31/2020,73120,82L-PRPD-073120 -Import Payroll-GRAVES KAMIESHIA,D108,HJ,,25.48,1376.5
6175,7/31/2020,7/31/2020,73120,82L-PRPD-073120 -Import Payroll-GRIFFIN ANDREW,D108,HJ,,1.78,1374.72
6175,7/31/2020,7/31/2020,73120,82L-PRPD-073120 -Import Payroll-GRIFFIN ANDREW,D108,HJ,,11.96,1362.76
6175,7/31/2020,7/31/2020,73120,82L-PRPD-073120 -Import Payroll-GUADARRAMA-ALVAREZ URIEL A,D108,HJ,,1.78,1360.98
6175,7/31/2020,7/31/2020,73120,82L-PRPD-073120 -Import Payroll-GUADARRAMA-ALVAREZ URIEL A,D108,HJ,,11.96,1349.02
6175,7/31/2020,7/31/2020,73120,82L-PRPD-073120 -Import Payroll-GUTHRIE LESLIE,D108,HJ,,1.78,1347.24
6175,7/31/2020,7/31/2020,73120,82L-PRPD-073120 -Import Payroll-GUTHRIE LESLIE,D108,HJ,,14.83,1332.41
6175,7/31/2020,7/31/2020,73120,82L-PRPD-073120 -Import Payroll-GUTIERREZ ANTONIO J,D108,HJ,,35.65,1296.76
6175,7/31/2020,7/31/2020,73120,82L-PRPD-073120 -Import Payroll-HALLINAN GABRIEL B,D108,HJ,,1.78,1294.98
6175,7/31/2020,7/31/2020,73120,82L-PRPD-073120 -Import Payroll-HALLINAN GABRIEL B,D108,HJ,,11.96,1283.02
6175,7/31/2020,7/31/2020,73120,82L-PRPD-073120 -Import Payroll-HOLMES JOREL ALEXANDER,D108,HJ,,1.78,1281.24
6175,7/31/2020,7/31/2020,73120,82L-PRPD-073120 -Import Payroll-HOLMES JOREL ALEXANDER,D108,HJ,,11.96,1269.28
6175,7/31/2020,7/31/2020,73120,82L-PRPD-073120 -Import Payroll-HOSSAIN MYESHA R,D108,HJ,,1.78,1267.5
6175,7/31/2020,7/31/2020,73120,82L-PRPD-073120 -Import Payroll-HOSSAIN MYESHA R,D108,HJ,,14.83,1252.67
6175,7/31/2020,7/31/2020,73120,82L-PRPD-073120 -Import Payroll-JACKSON CLAICE M,D108,HJ,,1.78,1250.89
6175,7/31/2020,7/31/2020,73120,82L-PRPD-073120 -Import Payroll-JACKSON CLAICE M,D108,HJ,,11.96,1238.93
6175,7/31/2020,7/31/2020,73120,82L-PRPD-073120 -Import Payroll-JACKSON TASNIM F,D108,HJ,,1.78,1237.15
6175,7/31/2020,7/31/2020,73120,82L-PRPD-073120 -Import Payroll-JACKSON TASNIM F,D108,HJ,,14.83,1222.32
6175,7/31/2020,7/31/2020,73120,82L-PRPD-073120 -Import Payroll-JANG DANIEL,D108,HJ,,1.78,1220.54
6175,7/31/2020,7/31/2020,73120,82L-PRPD-073120 -Import Payroll-JANG DANIEL,D108,HJ,,14.83,1205.71
6175,7/31/2020,7/31/2020,73120,82L-PRPD-073120 -Import Payroll-JORDAN TIFFANY T,D108,HJ,,5.23,1200.48
6175,7/31/2020,7/31/2020,73120,82L-PRPD-073120 -Import Payroll-JORDAN TIFFANY T,D108,HJ,,35.65,1164.83
6175,7/31/2020,7/31/2020,73120,82L-PRPD-073120 -Import Payroll-LACEY DEQUITA,D108,HJ,,1.78,1163.05
6175,7/31/2020,7/31/2020,73120,82L-PRPD-073120 -Import Payroll-LACEY DEQUITA,D108,HJ,,14.83,1148.22
6175,7/31/2020,7/31/2020,73120,82L-PRPD-073120 -Import Payroll-LANIGAN LISA A,D108,HJ,,3.56,1144.66
6175,7/31/2020,7/31/2020,73120,82L-PRPD-073120 -Import Payroll-LENEGHAN MARYELLEN B,D108,HJ,,1.78,1142.88
6175,7/31/2020,7/31/2020,73120,82L-PRPD-073120 -Import Payroll-LENEGHAN MARYELLEN B,D108,HJ,,11.96,1130.92
6175,7/31/2020,7/31/2020,73120,82L-PRPD-073120 -Import Payroll-LI BELLA,D108,HJ,,1.78,1129.14
6175,7/31/2020,7/31/2020,73120,82L-PRPD-073120 -Import Payroll-LI BELLA,D108,HJ,,11.96,1117.18
6175,7/31/2020,7/31/2020,73120,82L-PRPD-073120 -Import Payroll-LIPORACE HERNAN LUIS,D108,HJ,,11.96,1105.22
6175,7/31/2020,7/31/2020,73120,82L-PRPD-073120 -Import Payroll-LIPSCOMB STEPHEN,D108,HJ,,1.78,1103.44
6175,7/31/2020,7/31/2020,73120,82L-PRPD-073120 -Import Payroll-LIPSCOMB STEPHEN,D108,HJ,,11.96,1091.48
6175,7/31/2020,7/31/2020,73120,82L-PRPD-073120 -Import Payroll-MASON ANGELA,D108,HJ,,5.23,1086.25
6175,7/31/2020,7/31/2020,73120,82L-PRPD-073120 -Import Payroll-MASON ANGELA,D108,HJ,,35.65,1050.6
6175,7/31/2020,7/31/2020,73120,82L-PRPD-073120 -Import Payroll-MOSELEY ARIELLE,D108,HJ,,1.78,1048.82
6175,7/31/2020,7/31/2020,73120,82L-PRPD-073120 -Import Payroll-MOSELEY ARIELLE,D108,HJ,,11.96,1036.86
6175,7/31/2020,7/31/2020,73120,82L-PRPD-073120 -Import Payroll-ONICA ANTHONY J,D108,HJ,,1.78,1035.08
6175,7/31/2020,7/31/2020,73120,82L-PRPD-073120 -Import Payroll-ONICA ANTHONY J,D108,HJ,,11.96,1023.12
6175,7/31/2020,7/31/2020,73120,82L-PRPD-073120 -Import Payroll-PARHAM-GANTT DENISE M,D108,HJ,,3.56,1019.56
6175,7/31/2020,7/31/2020,73120,82L-PRPD-073120 -Import Payroll-PARHAM-GANTT DENISE M,D108,HJ,,31.6,987.96
6175,7/31/2020,7/31/2020,73120,82L-PRPD-073120 -Import Payroll-PEINADO ELIZABETH R,D108,HJ,,1.78,986.18
6175,7/31/2020,7/31/2020,73120,82L-PRPD-073120 -Import Payroll-PEINADO ELIZABETH R,D108,HJ,,11.96,974.22
6175,7/31/2020,7/31/2020,73120,82L-PRPD-073120 -Import Payroll-POLANCO ODALIS,D108,HJ,,1.78,972.44
6175,7/31/2020,7/31/2020,73120,82L-PRPD-073120 -Import Payroll-POLANCO ODALIS,D108,HJ,,11.96,960.48
6175,7/31/2020,7/31/2020,73120,82L-PRPD-073120 -Import Payroll-PRAHIN NICOLE M,D108,HJ,,1.78,958.7
6175,7/31/2020,7/31/2020,73120,82L-PRPD-073120 -Import Payroll-PRAHIN NICOLE M,D108,HJ,,11.96,946.74
6175,7/31/2020,7/31/2020,73120,82L-PRPD-073120 -Import Payroll-RANDOLPH ALEXANDER,D108,HJ,,1.78,944.96
6175,7/31/2020,7/31/2020,73120,82L-PRPD-073120 -Import Payroll-RANDOLPH ALEXANDER,D108,HJ,,11.96,933
6175,7/31/2020,7/31/2020,73120,82L-PRPD-073120 -Import Payroll-SAFRAN ALAN P,D108,HJ,,3.56,929.44
6175,7/31/2020,7/31/2020,73120,82L-PRPD-073120 -Import Payroll-SAFRAN ALAN P,D108,HJ,,35.65,893.79
6175,7/31/2020,7/31/2020,73120,82L-PRPD-073120 -Import Payroll-SALIM YASSER,D108,HJ,,11.96,881.83
6175,7/31/2020,7/31/2020,73120,82L-PRPD-073120 -Import Payroll-SEJOUR MAHALIAH,D108,HJ,,1.78,880.05
6175,7/31/2020,7/31/2020,73120,82L-PRPD-073120 -Import Payroll-SEJOUR MAHALIAH,D108,HJ,,11.96,868.09
6175,7/31/2020,7/31/2020,73120,82L-PRPD-073120 -Import Payroll-SILVER KELLY,D108,HJ,,1.78,866.31
6175,7/31/2020,7/31/2020,73120,82L-PRPD-073120 -Import Payroll-SILVER KELLY,D108,HJ,,14.83,851.48
6175,7/31/2020,7/31/2020,73120,82L-PRPD-073120 -Import Payroll-SMITH AKILAH,D108,HJ,,11.96,839.52
6175,7/31/2020,7/31/2020,73120,82L-PRPD-073120 -Import Payroll-TAM CW RYAN,D108,HJ,,1.78,837.74
6175,7/31/2020,7/31/2020,73120,82L-PRPD-073120 -Import Payroll-TENESACA VERONICA A,D108,HJ,,11.96,825.78
6175,7/31/2020,7/31/2020,73120,82L-PRPD-073120 -Import Payroll-TUMENJARGAL ENKHJIN,D108,HJ,,1.78,824
6175,7/31/2020,7/31/2020,73120,82L-PRPD-073120 -Import Payroll-TUMENJARGAL ENKHJIN,D108,HJ,,11.96,812.04
6175,7/31/2020,7/31/2020,73120,82L-PRPD-073120 -Import Payroll-VILLEGAS EVELYN,D108,HJ,,5.23,806.81
6175,7/31/2020,7/31/2020,73120,82L-PRPD-073120 -Import Payroll-VILLEGAS EVELYN,D108,HJ,,35.65,771.16
6175,7/31/2020,7/31/2020,73120,82L-PRPD-073120 -Import Payroll-WALLACE AMENA T,D108,HJ,,11.96,759.2
6175,7/31/2020,7/31/2020,73120,82L-PRPD-073120 -Import Payroll-WOLF ANNA A,D108,HJ,,1.78,757.42
6175,7/31/2020,7/31/2020,73120,To reverse 82L payroll 73120-To reverse 82L payroll of 73120 JE-21-0003,D108,HJ,1.78,,759.2
6175,7/31/2020,7/31/2020,73120,To reverse 82L payroll 73120-To reverse 82L payroll of 73120 JE-21-0003,D108,HJ,1.78,,760.98
6175,7/31/2020,7/31/2020,73120,To reverse 82L payroll 73120-To reverse 82L payroll of 73120 JE-21-0003,D108,HJ,1.78,,762.76
6175,7/31/2020,7/31/2020,73120,To reverse 82L payroll 73120-To reverse 82L payroll of 73120 JE-21-0003,D108,HJ,1.78,,764.54
6175,7/31/2020,7/31/2020,73120,To reverse 82L payroll 73120-To reverse 82L payroll of 73120 JE-21-0003,D108,HJ,1.78,,766.32
6175,7/31/2020,7/31/2020,73120,To reverse 82L payroll 73120-To reverse 82L payroll of 73120 JE-21-0003,D108,HJ,1.78,,768.1
6175,7/31/2020,7/31/2020,73120,To reverse 82L payroll 73120-To reverse 82L payroll of 73120 JE-21-0003,D108,HJ,1.78,,769.88
6175,7/31/2020,7/31/2020,73120,To reverse 82L payroll 73120-To reverse 82L payroll of 73120 JE-21-0003,D108,HJ,1.78,,771.66
6175,7/31/2020,7/31/2020,73120,To reverse 82L payroll 73120-To reverse 82L payroll of 73120 JE-21-0003,D108,HJ,1.78,,773.44
6175,7/31/2020,7/31/2020,73120,To reverse 82L payroll 73120-To reverse 82L payroll of 73120 JE-21-0003,D108,HJ,1.78,,775.22
6175,7/31/2020,7/31/2020,73120,To reverse 82L payroll 73120-To reverse 82L payroll of 73120 JE-21-0003,D108,HJ,1.78,,777
6175,7/31/2020,7/31/2020,73120,To reverse 82L payroll 73120-To reverse 82L payroll of 73120 JE-21-0003,D108,HJ,1.78,,778.78
6175,7/31/2020,7/31/2020,73120,To reverse 82L payroll 73120-To reverse 82L payroll of 73120 JE-21-0003,D108,HJ,1.78,,780.56
6175,7/31/2020,7/31/2020,73120,To reverse 82L payroll 73120-To reverse 82L payroll of 73120 JE-21-0003,D108,HJ,1.78,,782.34
6175,7/31/2020,7/31/2020,73120,To reverse 82L payroll 73120-To reverse 82L payroll of 73120 JE-21-0003,D108,HJ,1.78,,784.12
6175,7/31/2020,7/31/2020,73120,To reverse 82L payroll 73120-To reverse 82L payroll of 73120 JE-21-0003,D108,HJ,1.78,,785.9
6175,7/31/2020,7/31/2020,73120,To reverse 82L payroll 73120-To reverse 82L payroll of 73120 JE-21-0003,D108,HJ,1.78,,787.68
6175,7/31/2020,7/31/2020,73120,To reverse 82L payroll 73120-To reverse 82L payroll of 73120 JE-21-0003,D108,HJ,1.78,,789.46
6175,7/31/2020,7/31/2020,73120,To reverse 82L payroll 73120-To reverse 82L payroll of 73120 JE-21-0003,D108,HJ,1.78,,791.24
6175,7/31/2020,7/31/2020,73120,To reverse 82L payroll 73120-To reverse 82L payroll of 73120 JE-21-0003,D108,HJ,1.78,,793.02
6175,7/31/2020,7/31/2020,73120,To reverse 82L payroll 73120-To reverse 82L payroll of 73120 JE-21-0003,D108,HJ,1.78,,794.8
6175,7/31/2020,7/31/2020,73120,To reverse 82L payroll 73120-To reverse 82L payroll of 73120 JE-21-0003,D108,HJ,1.78,,796.58
6175,7/31/2020,7/31/2020,73120,To reverse 82L payroll 73120-To reverse 82L payroll of 73120 JE-21-0003,D108,HJ,1.78,,798.36
6175,7/31/2020,7/31/2020,73120,To reverse 82L payroll 73120-To reverse 82L payroll of 73120 JE-21-0003,D108,HJ,1.78,,800.14
6175,7/31/2020,7/31/2020,73120,To reverse 82L payroll 73120-To reverse 82L payroll of 73120 JE-21-0003,D108,HJ,1.78,,801.92
6175,7/31/2020,7/31/2020,73120,To reverse 82L payroll 73120-To reverse 82L payroll of 73120 JE-21-0003,D108,HJ,1.78,,803.7
6175,7/31/2020,7/31/2020,73120,To reverse 82L payroll 73120-To reverse 82L payroll of 73120 JE-21-0003,D108,HJ,1.78,,805.48
6175,7/31/2020,7/31/2020,73120,To reverse 82L payroll 73120-To reverse 82L payroll of 73120 JE-21-0003,D108,HJ,1.78,,807.26
6175,7/31/2020,7/31/2020,73120,To reverse 82L payroll 73120-To reverse 82L payroll of 73120 JE-21-0003,D108,HJ,1.78,,809.04
6175,7/31/2020,7/31/2020,73120,To reverse 82L payroll 73120-To reverse 82L payroll of 73120 JE-21-0003,D108,HJ,1.78,,810.82
6175,7/31/2020,7/31/2020,73120,To reverse 82L payroll 73120-To reverse 82L payroll of 73120 JE-21-0003,D108,HJ,1.78,,812.6
6175,7/31/2020,7/31/2020,73120,To reverse 82L payroll 73120-To reverse 82L payroll of 73120 JE-21-0003,D108,HJ,1.78,,814.38
6175,7/31/2020,7/31/2020,73120,To reverse 82L payroll 73120-To reverse 82L payroll of 73120 JE-21-0003,D108,HJ,1.78,,816.16
6175,7/31/2020,7/31/2020,73120,To reverse 82L payroll 73120-To reverse 82L payroll of 73120 JE-21-0003,D108,HJ,1.78,,817.94
6175,7/31/2020,7/31/2020,73120,To reverse 82L payroll 73120-To reverse 82L payroll of 73120 JE-21-0003,D108,HJ,1.78,,819.72
6175,7/31/2020,7/31/2020,73120,To reverse 82L payroll 73120-To reverse 82L payroll of 73120 JE-21-0003,D108,HJ,3.38,,823.1
6175,7/31/2020,7/31/2020,73120,To reverse 82L payroll 73120-To reverse 82L payroll of 73120 JE-21-0003,D108,HJ,3.38,,826.48
6175,7/31/2020,7/31/2020,73120,To reverse 82L payroll 73120-To reverse 82L payroll of 73120 JE-21-0003,D108,HJ,3.56,,830.04
6175,7/31/2020,7/31/2020,73120,To reverse 82L payroll 73120-To reverse 82L payroll of 73120 JE-21-0003,D108,HJ,3.56,,833.6
6175,7/31/2020,7/31/2020,73120,To reverse 82L payroll 73120-To reverse 82L payroll of 73120 JE-21-0003,D108,HJ,3.56,,837.16
6175,7/31/2020,7/31/2020,73120,To reverse 82L payroll 73120-To reverse 82L payroll of 73120 JE-21-0003,D108,HJ,5.23,,842.39
6175,7/31/2020,7/31/2020,73120,To reverse 82L payroll 73120-To reverse 82L payroll of 73120 JE-21-0003,D108,HJ,5.23,,847.62
6175,7/31/2020,7/31/2020,73120,To reverse 82L payroll 73120-To reverse 82L payroll of 73120 JE-21-0003,D108,HJ,5.23,,852.85
6175,7/31/2020,7/31/2020,73120,To reverse 82L payroll 73120-To reverse 82L payroll of 73120 JE-21-0003,D108,HJ,5.23,,858.08
6175,7/31/2020,7/31/2020,73120,To reverse 82L payroll 73120-To reverse 82L payroll of 73120 JE-21-0003,D108,HJ,11.96,,870.04
6175,7/31/2020,7/31/2020,73120,To reverse 82L payroll 73120-To reverse 82L payroll of 73120 JE-21-0003,D108,HJ,11.96,,882
6175,7/31/2020,7/31/2020,73120,To reverse 82L payroll 73120-To reverse 82L payroll of 73120 JE-21-0003,D108,HJ,11.96,,893.96
6175,7/31/2020,7/31/2020,73120,To reverse 82L payroll 73120-To reverse 82L payroll of 73120 JE-21-0003,D108,HJ,11.96,,905.92
6175,7/31/2020,7/31/2020,73120,To reverse 82L payroll 73120-To reverse 82L payroll of 73120 JE-21-0003,D108,HJ,11.96,,917.88
6175,7/31/2020,7/31/2020,73120,To reverse 82L payroll 73120-To reverse 82L payroll of 73120 JE-21-0003,D108,HJ,11.96,,929.84
6175,7/31/2020,7/31/2020,73120,To reverse 82L payroll 73120-To reverse 82L payroll of 73120 JE-21-0003,D108,HJ,11.96,,941.8
6175,7/31/2020,7/31/2020,73120,To reverse 82L payroll 73120-To reverse 82L payroll of 73120 JE-21-0003,D108,HJ,11.96,,953.76
6175,7/31/2020,7/31/2020,73120,To reverse 82L payroll 73120-To reverse 82L payroll of 73120 JE-21-0003,D108,HJ,11.96,,965.72
6175,7/31/2020,7/31/2020,73120,To reverse 82L payroll 73120-To reverse 82L payroll of 73120 JE-21-0003,D108,HJ,11.96,,977.68
6175,7/31/2020,7/31/2020,73120,To reverse 82L payroll 73120-To reverse 82L payroll of 73120 JE-21-0003,D108,HJ,11.96,,989.64
6175,7/31/2020,7/31/2020,73120,To reverse 82L payroll 73120-To reverse 82L payroll of 73120 JE-21-0003,D108,HJ,11.96,,1001.6
6175,7/31/2020,7/31/2020,73120,To reverse 82L payroll 73120-To reverse 82L payroll of 73120 JE-21-0003,D108,HJ,11.96,,1013.56
6175,7/31/2020,7/31/2020,73120,To reverse 82L payroll 73120-To reverse 82L payroll of 73120 JE-21-0003,D108,HJ,11.96,,1025.52
6175,7/31/2020,7/31/2020,73120,To reverse 82L payroll 73120-To reverse 82L payroll of 73120 JE-21-0003,D108,HJ,11.96,,1037.48
6175,7/31/2020,7/31/2020,73120,To reverse 82L payroll 73120-To reverse 82L payroll of 73120 JE-21-0003,D108,HJ,11.96,,1049.44
6175,7/31/2020,7/31/2020,73120,To reverse 82L payroll 73120-To reverse 82L payroll of 73120 JE-21-0003,D108,HJ,11.96,,1061.4
6175,7/31/2020,7/31/2020,73120,To reverse 82L payroll 73120-To reverse 82L payroll of 73120 JE-21-0003,D108,HJ,11.96,,1073.36
6175,7/31/2020,7/31/2020,73120,To reverse 82L payroll 73120-To reverse 82L payroll of 73120 JE-21-0003,D108,HJ,11.96,,1085.32
6175,7/31/2020,7/31/2020,73120,To reverse 82L payroll 73120-To reverse 82L payroll of 73120 JE-21-0003,D108,HJ,11.96,,1097.28
6175,7/31/2020,7/31/2020,73120,To reverse 82L payroll 73120-To reverse 82L payroll of 73120 JE-21-0003,D108,HJ,11.96,,1109.24
6175,7/31/2020,7/31/2020,73120,To reverse 82L payroll 73120-To reverse 82L payroll of 73120 JE-21-0003,D108,HJ,11.96,,1121.2
6175,7/31/2020,7/31/2020,73120,To reverse 82L payroll 73120-To reverse 82L payroll of 73120 JE-21-0003,D108,HJ,11.96,,1133.16
6175,7/31/2020,7/31/2020,73120,To reverse 82L payroll 73120-To reverse 82L payroll of 73120 JE-21-0003,D108,HJ,11.96,,1145.12
6175,7/31/2020,7/31/2020,73120,To reverse 82L payroll 73120-To reverse 82L payroll of 73120 JE-21-0003,D108,HJ,11.96,,1157.08
6175,7/31/2020,7/31/2020,73120,To reverse 82L payroll 73120-To reverse 82L payroll of 73120 JE-21-0003,D108,HJ,11.96,,1169.04
6175,7/31/2020,7/31/2020,73120,To reverse 82L payroll 73120-To reverse 82L payroll of 73120 JE-21-0003,D108,HJ,11.96,,1181
6175,7/31/2020,7/31/2020,73120,To reverse 82L payroll 73120-To reverse 82L payroll of 73120 JE-21-0003,D108,HJ,11.96,,1192.96
6175,7/31/2020,7/31/2020,73120,To reverse 82L payroll 73120-To reverse 82L payroll of 73120 JE-21-0003,D108,HJ,11.96,,1204.92
6175,7/31/2020,7/31/2020,73120,To reverse 82L payroll 73120-To reverse 82L payroll of 73120 JE-21-0003,D108,HJ,14.83,,1219.75
6175,7/31/2020,7/31/2020,73120,To reverse 82L payroll 73120-To reverse 82L payroll of 73120 JE-21-0003,D108,HJ,14.83,,1234.58
6175,7/31/2020,7/31/2020,73120,To reverse 82L payroll 73120-To reverse 82L payroll of 73120 JE-21-0003,D108,HJ,14.83,,1249.41
6175,7/31/2020,7/31/2020,73120,To reverse 82L payroll 73120-To reverse 82L payroll of 73120 JE-21-0003,D108,HJ,14.83,,1264.24
6175,7/31/2020,7/31/2020,73120,To reverse 82L payroll 73120-To reverse 82L payroll of 73120 JE-21-0003,D108,HJ,14.83,,1279.07
6175,7/31/2020,7/31/2020,73120,To reverse 82L payroll 73120-To reverse 82L payroll of 73120 JE-21-0003,D108,HJ,14.83,,1293.9
6175,7/31/2020,7/31/2020,73120,To reverse 82L payroll 73120-To reverse 82L payroll of 73120 JE-21-0003,D108,HJ,14.83,,1308.73
6175,7/31/2020,7/31/2020,73120,To reverse 82L payroll 73120-To reverse 82L payroll of 73120 JE-21-0003,D108,HJ,14.83,,1323.56
6175,7/31/2020,7/31/2020,73120,To reverse 82L payroll 73120-To reverse 82L payroll of 73120 JE-21-0003,D108,HJ,14.83,,1338.39
6175,7/31/2020,7/31/2020,73120,To reverse 82L payroll 73120-To reverse 82L payroll of 73120 JE-21-0003,D108,HJ,14.83,,1353.22
6175,7/31/2020,7/31/2020,73120,To reverse 82L payroll 73120-To reverse 82L payroll of 73120 JE-21-0003,D108,HJ,25.48,,1378.7
6175,7/31/2020,7/31/2020,73120,To reverse 82L payroll 73120-To reverse 82L payroll of 73120 JE-21-0003,D108,HJ,25.48,,1404.18
6175,7/31/2020,7/31/2020,73120,To reverse 82L payroll 73120-To reverse 82L payroll of 73120 JE-21-0003,D108,HJ,25.48,,1429.66
6175,7/31/2020,7/31/2020,73120,To reverse 82L payroll 73120-To reverse 82L payroll of 73120 JE-21-0003,D108,HJ,31.6,,1461.26
6175,7/31/2020,7/31/2020,73120,To reverse 82L payroll 73120-To reverse 82L payroll of 73120 JE-21-0003,D108,HJ,35.65,,1496.91
6175,7/31/2020,7/31/2020,73120,To reverse 82L payroll 73120-To reverse 82L payroll of 73120 JE-21-0003,D108,HJ,35.65,,1532.56
6175,7/31/2020,7/31/2020,73120,To reverse 82L payroll 73120-To reverse 82L payroll of 73120 JE-21-0003,D108,HJ,35.65,,1568.21
6175,7/31/2020,7/31/2020,73120,To reverse 82L payroll 73120-To reverse 82L payroll of 73120 JE-21-0003,D108,HJ,35.65,,1603.86
6175,7/31/2020,7/31/2020,73120,To reverse 82L payroll 73120-To reverse 82L payroll of 73120 JE-21-0003,D108,HJ,35.65,,1639.51
6175,7/31/2020,7/31/2020,73120,To reverse 82L payroll 73120-To reverse 82L payroll of 73120 JE-21-0003,D108,HJ,35.65,,1675.16
6175,7/31/2020,7/31/2020,73120,82L-IMPORT PAYROLL-AUSTIN PERCY,D108,HJ,,1.78,1673.38
6175,7/31/2020,7/31/2020,73120,82L-IMPORT PAYROLL-AUSTIN PERCY,D108,HJ,,14.83,1658.55
6175,7/31/2020,7/31/2020,73120,82L-IMPORT PAYROLL-BAUSH DANIEL,D108,HJ,,1.78,1656.77
6175,7/31/2020,7/31/2020,73120,82L-IMPORT PAYROLL-BAUSH DANIEL,D108,HJ,,11.96,1644.81
6175,7/31/2020,7/31/2020,73120,82L-IMPORT PAYROLL-CHAPMAN CLAUDY EARL,D108,HJ,,1.78,1643.03
6175,7/31/2020,7/31/2020,73120,82L-IMPORT PAYROLL-CHAPMAN CLAUDY EARL,D108,HJ,,11.96,1631.07
6175,7/31/2020,7/31/2020,73120,82L-IMPORT PAYROLL-DADA ARIKPO E,D108,HJ,,5.23,1625.84
6175,7/31/2020,7/31/2020,73120,82L-IMPORT PAYROLL-DADA ARIKPO E,D108,HJ,,35.65,1590.19
6175,7/31/2020,7/31/2020,73120,82L-IMPORT PAYROLL-GUTHRIE LESLIE,D108,HJ,,1.78,1588.41
6175,7/31/2020,7/31/2020,73120,82L-IMPORT PAYROLL-GUTHRIE LESLIE,D108,HJ,,14.83,1573.58
6175,7/31/2020,7/31/2020,73120,82L-IMPORT PAYROLL-HOLMES JOREL ALEXANDER,D108,HJ,,1.78,1571.8
6175,7/31/2020,7/31/2020,73120,82L-IMPORT PAYROLL-HOLMES JOREL ALEXANDER,D108,HJ,,11.96,1559.84
6175,7/31/2020,7/31/2020,73120,82L-IMPORT PAYROLL-JORDAN TIFFANY T,D108,HJ,,5.23,1554.61
6175,7/31/2020,7/31/2020,73120,82L-IMPORT PAYROLL-JORDAN TIFFANY T,D108,HJ,,35.65,1518.96
6175,7/31/2020,7/31/2020,73120,82L-IMPORT PAYROLL-LANIGAN LISA A,D108,HJ,,3.56,1515.4
6175,7/31/2020,7/31/2020,73120,82L-IMPORT PAYROLL-ONICA ANTHONY J,D108,HJ,,1.78,1513.62
6175,7/31/2020,7/31/2020,73120,82L-IMPORT PAYROLL-ONICA ANTHONY J,D108,HJ,,11.96,1501.66
6175,7/31/2020,7/31/2020,73120,82L-IMPORT PAYROLL-PRAHIN NICOLE M,D108,HJ,,1.78,1499.88
6175,7/31/2020,7/31/2020,73120,82L-IMPORT PAYROLL-PRAHIN NICOLE M,D108,HJ,,11.96,1487.92
6175,7/31/2020,7/31/2020,73120,82L-IMPORT PAYROLL-SALIM YASSER,D108,HJ,,11.96,1475.96
6175,7/31/2020,7/31/2020,73120,82L-IMPORT PAYROLL-SEJOUR MAHALIAH,D108,HJ,,1.78,1474.18
6175,7/31/2020,7/31/2020,73120,82L-IMPORT PAYROLL-SEJOUR MAHALIAH,D108,HJ,,11.96,1462.22
6175,7/31/2020,7/31/2020,73120,82L-IMPORT PAYROLL-SMITH AKILAH,D108,HJ,,11.96,1450.26
6175,7/31/2020,7/31/2020,73120,82L-IMPORT PAYROLL-TAM CW RYAN,D108,HJ,,1.78,1448.48
6175,7/31/2020,7/31/2020,73120,82L-IMPORT PAYROLL-TENESACA VERONICA A,D108,HJ,,11.96,1436.52
6175,7/31/2020,7/31/2020,73120,82L-IMPORT PAYROLL-TUMENJARGAL ENKHJIN,D108,HJ,,1.78,1434.74
6175,7/31/2020,7/31/2020,73120,82L-IMPORT PAYROLL-TUMENJARGAL ENKHJIN,D108,HJ,,11.96,1422.78
6175,7/31/2020,7/31/2020,73120,82L-IMPORT PAYROLL-VILLEGAS EVELYN,D108,HJ,,5.23,1417.55
6175,7/31/2020,7/31/2020,73120,82L-IMPORT PAYROLL-VILLEGAS EVELYN,D108,HJ,,35.65,1381.9
6175,7/31/2020,7/31/2020,73120,82L-IMPORT PAYROLL-WOLF ANNA A,D108,HJ,,1.78,1380.12
6175,7/31/2020,7/31/2020,73120,82L-IMPORT PAYROLL-ACEVEDO MONIVETT,D107,HJ,,25.48,1354.64
6175,7/31/2020,7/31/2020,73120,82L-IMPORT PAYROLL-AKLESTAD ISABEL,D111,HJ,,1.78,1352.86
6175,7/31/2020,7/31/2020,73120,82L-IMPORT PAYROLL-AKLESTAD ISABEL,D111,HJ,,11.96,1340.9
6175,7/31/2020,7/31/2020,73120,82L-IMPORT PAYROLL-COOK CATHRYN ANNA,D105,HJ,,1.78,1339.12
6175,7/31/2020,7/31/2020,73120,82L-IMPORT PAYROLL-COOK CATHRYN ANNA,D105,HJ,,14.83,1324.29
6175,7/31/2020,7/31/2020,73120,82L-IMPORT PAYROLL-COOPER ASHLEE R,D101,HJ,,1.78,1322.51
6175,7/31/2020,7/31/2020,73120,82L-IMPORT PAYROLL-COOPER ASHLEE R,D101,HJ,,11.96,1310.55
6175,7/31/2020,7/31/2020,73120,82L-IMPORT PAYROLL-DETONE KYRA MAYA,D102,HJ,,1.78,1308.77
6175,7/31/2020,7/31/2020,73120,82L-IMPORT PAYROLL-DETONE KYRA MAYA,D102,HJ,,11.96,1296.81
6175,7/31/2020,7/31/2020,73120,82L-IMPORT PAYROLL-DUPUIS CHRISTOPHER M,D107,HJ,,1.78,1295.03
6175,7/31/2020,7/31/2020,73120,82L-IMPORT PAYROLL-DUPUIS CHRISTOPHER M,D107,HJ,,11.96,1283.07
6175,7/31/2020,7/31/2020,73120,82L-IMPORT PAYROLL-DZIEDZIC JULIE K,D101,HJ,,3.38,1279.69
6175,7/31/2020,7/31/2020,73120,82L-IMPORT PAYROLL-DZIEDZIC JULIE K,D101,HJ,,25.48,1254.21
6175,7/31/2020,7/31/2020,73120,82L-IMPORT PAYROLL-GRAVES KAMIESHIA,D101,HJ,,3.38,1250.83
6175,7/31/2020,7/31/2020,73120,82L-IMPORT PAYROLL-GRAVES KAMIESHIA,D101,HJ,,25.48,1225.35
6175,7/31/2020,7/31/2020,73120,82L-IMPORT PAYROLL-GUADARRAMA-ALVAREZ URIEL A,D105,HJ,,1.78,1223.57
6175,7/31/2020,7/31/2020,73120,82L-IMPORT PAYROLL-GUADARRAMA-ALVAREZ URIEL A,D105,HJ,,11.96,1211.61
6175,7/31/2020,7/31/2020,73120,82L-IMPORT PAYROLL-GUTIERREZ ANTONIO J,D107,HJ,,35.65,1175.96
6175,7/31/2020,7/31/2020,73120,82L-IMPORT PAYROLL-LACEY DEQUITA,D107,HJ,,1.78,1174.18
6175,7/31/2020,7/31/2020,73120,82L-IMPORT PAYROLL-LACEY DEQUITA,D107,HJ,,14.83,1159.35
6175,7/31/2020,7/31/2020,73120,82L-IMPORT PAYROLL-LIPORACE HERNAN LUIS,D103,HJ,,11.96,1147.39
6175,7/31/2020,7/31/2020,73120,82L-IMPORT PAYROLL-MASON ANGELA,D107,HJ,,5.23,1142.16
6175,7/31/2020,7/31/2020,73120,82L-IMPORT PAYROLL-MASON ANGELA,D107,HJ,,35.65,1106.51
6175,7/31/2020,7/31/2020,73120,82L-IMPORT PAYROLL-PARHAM-GANTT DENISE M,D112,HJ,,3.56,1102.95
6175,7/31/2020,7/31/2020,73120,82L-IMPORT PAYROLL-PARHAM-GANTT DENISE M,D112,HJ,,31.6,1071.35
6175,7/31/2020,7/31/2020,73120,82L-IMPORT PAYROLL-PEINADO ELIZABETH R,D111,HJ,,1.78,1069.57
6175,7/31/2020,7/31/2020,73120,82L-IMPORT PAYROLL-PEINADO ELIZABETH R,D111,HJ,,11.96,1057.61
6175,7/31/2020,7/31/2020,73120,82L-IMPORT PAYROLL-POLANCO ODALIS,D103,HJ,,1.78,1055.83
6175,7/31/2020,7/31/2020,73120,82L-IMPORT PAYROLL-POLANCO ODALIS,D103,HJ,,11.96,1043.87
6175,7/31/2020,7/31/2020,73120,82L-IMPORT PAYROLL-RANDOLPH ALEXANDER,D111,HJ,,1.78,1042.09
6175,7/31/2020,7/31/2020,73120,82L-IMPORT PAYROLL-RANDOLPH ALEXANDER,D111,HJ,,11.96,1030.13
6175,7/31/2020,7/31/2020,73120,82L-IMPORT PAYROLL-SAFRAN ALAN P,D107,HJ,,3.56,1026.57
6175,7/31/2020,7/31/2020,73120,82L-IMPORT PAYROLL-SAFRAN ALAN P,D107,HJ,,35.65,990.92
6175,7/31/2020,7/31/2020,73120,82L-IMPORT PAYROLL-WALLACE AMENA T,D104,HJ,,11.96,978.96
6175,7/31/2020,7/31/2020,73120,82L-IMPORT PAYROLL-BARTOLD DEANNA MARIE,D108,HJ,,1.78,977.18
6175,7/31/2020,7/31/2020,73120,82L-IMPORT PAYROLL-BARTOLD DEANNA MARIE,D108,HJ,,11.96,965.22
6175,7/31/2020,7/31/2020,73120,82L-IMPORT PAYROLL-BELLOT GENESIS,D108,HJ,,1.78,963.44
6175,7/31/2020,7/31/2020,73120,82L-IMPORT PAYROLL-BELLOT GENESIS,D108,HJ,,14.83,948.61
6175,7/31/2020,7/31/2020,73120,82L-IMPORT PAYROLL-FEIGHERY JOHN,D108,HJ,,11.96,936.65
6175,7/31/2020,7/31/2020,73120,82L-IMPORT PAYROLL-GRIFFIN ANDREW,D108,HJ,,1.78,934.87
6175,7/31/2020,7/31/2020,73120,82L-IMPORT PAYROLL-GRIFFIN ANDREW,D108,HJ,,11.96,922.91
6175,7/31/2020,7/31/2020,73120,82L-IMPORT PAYROLL-HALLINAN GABRIEL B,D108,HJ,,1.78,921.13
6175,7/31/2020,7/31/2020,73120,82L-IMPORT PAYROLL-HALLINAN GABRIEL B,D108,HJ,,11.96,909.17
6175,7/31/2020,7/31/2020,73120,82L-IMPORT PAYROLL-HOSSAIN MYESHA R,D108,HJ,,1.78,907.39
6175,7/31/2020,7/31/2020,73120,82L-IMPORT PAYROLL-HOSSAIN MYESHA R,D108,HJ,,14.83,892.56
6175,7/31/2020,7/31/2020,73120,82L-IMPORT PAYROLL-JACKSON TASNIM F,D108,HJ,,1.78,890.78
6175,7/31/2020,7/31/2020,73120,82L-IMPORT PAYROLL-JACKSON TASNIM F,D108,HJ,,14.83,875.95
6175,7/31/2020,7/31/2020,73120,82L-IMPORT PAYROLL-LI BELLA,D108,HJ,,1.78,874.17
6175,7/31/2020,7/31/2020,73120,82L-IMPORT PAYROLL-LI BELLA,D108,HJ,,11.96,862.21
6175,7/31/2020,7/31/2020,73120,82L-IMPORT PAYROLL-MOSELEY ARIELLE,D108,HJ,,1.78,860.43
6175,7/31/2020,7/31/2020,73120,82L-IMPORT PAYROLL-MOSELEY ARIELLE,D108,HJ,,11.96,848.47
6175,7/31/2020,7/31/2020,73120,82L-IMPORT PAYROLL-COVENEY ALLISON,D108,HJ,,1.78,846.69
6175,7/31/2020,7/31/2020,73120,82L-IMPORT PAYROLL-COVENEY ALLISON,D108,HJ,,14.83,831.86
6175,7/31/2020,7/31/2020,73120,82L-IMPORT PAYROLL-JACKSON CLAICE M,D108,HJ,,1.78,830.08
6175,7/31/2020,7/31/2020,73120,82L-IMPORT PAYROLL-JACKSON CLAICE M,D108,HJ,,11.96,818.12
6175,7/31/2020,7/31/2020,73120,82L-IMPORT PAYROLL-JANG DANIEL,D108,HJ,,1.78,816.34
6175,7/31/2020,7/31/2020,73120,82L-IMPORT PAYROLL-JANG DANIEL,D108,HJ,,14.83,801.51
6175,7/31/2020,7/31/2020,73120,82L-IMPORT PAYROLL-LENEGHAN MARYELLEN B,D108,HJ,,1.78,799.73
6175,7/31/2020,7/31/2020,73120,82L-IMPORT PAYROLL-LENEGHAN MARYELLEN B,D108,HJ,,11.96,787.77
6175,8/3/2020,8/3/2020,BCBS -August,BCBS - August Health Insurance-August -BCBS Health Insurance,D108,HJ,1139.62,,1927.39
6175,8/3/2020,8/3/2020,BCBS -August,BCBS - August Health Insurance-August -BCBS Health Insurance,D107,HJ,1030.98,,2958.37
6175,8/3/2020,8/3/2020,BCBS -August,BCBS - August Health Insurance-August -BCBS Health Insurance,D108,HJ,441.95,,3400.32
6175,8/3/2020,8/3/2020,BCBS -August,BCBS - August Health Insurance-August -BCBS Health Insurance,D108,HJ,191.32,,3591.64
6175,8/14/2020,8/14/2020,81420,82L-IMPORT PAYROLL-ALVAREZ-MORINE LISIS,D108,HJ,,1.78,3589.86
6175,8/14/2020,8/14/2020,81420,82L-IMPORT PAYROLL-ALVAREZ-MORINE LISIS,D108,HJ,,14.83,3575.03
6175,8/14/2020,8/14/2020,81420,82L-IMPORT PAYROLL-BARTHELEMY RACHALIE,D108,HJ,,1.78,3573.25
6175,8/14/2020,8/14/2020,81420,82L-IMPORT PAYROLL-BARTHELEMY RACHALIE,D108,HJ,,14.83,3558.42
6175,8/14/2020,8/14/2020,81420,82L-IMPORT PAYROLL-BREEDLOVE JOHNDEE L,D108,HJ,,14.83,3543.59
6175,8/14/2020,8/14/2020,81420,82L-IMPORT PAYROLL-LI SEN YUAN,D108,HJ,,1.78,3541.81
6175,8/14/2020,8/14/2020,81420,82L-IMPORT PAYROLL-LI SEN YUAN,D108,HJ,,11.96,3529.85
6175,8/14/2020,8/14/2020,81420,82L-IMPORT PAYROLL-LIPSCOMB STEPHEN,D108,HJ,,1.78,3528.07
6175,8/14/2020,8/14/2020,81420,82L-IMPORT PAYROLL-LIPSCOMB STEPHEN,D108,HJ,,11.96,3516.11
6175,8/14/2020,8/14/2020,81420,82L-IMPORT PAYROLL-MEJIA CARLOS MANUEL,D108,HJ,,1.78,3514.33
6175,8/14/2020,8/14/2020,81420,82L-IMPORT PAYROLL-MEJIA CARLOS MANUEL,D108,HJ,,14.83,3499.5
6175,8/14/2020,8/14/2020,81420,82L-IMPORT PAYROLL-SCOTT KIRK DONOVAN,D108,HJ,,1.78,3497.72
6175,8/14/2020,8/14/2020,81420,82L-IMPORT PAYROLL-SCOTT KIRK DONOVAN,D108,HJ,,11.96,3485.76
6175,8/14/2020,8/14/2020,81420,82L-IMPORT PAYROLL-SILVER KELLY,D108,HJ,,1.78,3483.98
6175,8/14/2020,8/14/2020,81420,82L-IMPORT PAYROLL-SILVER KELLY,D108,HJ,,14.83,3469.15
6175,8/14/2020,8/14/2020,81420,82L-IMPORT PAYROLL-STROUD DAVID,D108,HJ,,1.78,3467.37
6175,8/14/2020,8/14/2020,81420,82L-IMPORT PAYROLL-STROUD DAVID,D108,HJ,,14.83,3452.54
6175,8/14/2020,8/14/2020,81420,82L-IMPORT PAYROLL-WILLIAMS MACK ANTHONY,D108,HJ,,11.96,3440.58
6175,8/14/2020,8/14/2020,81420,82L-IMPORT PAYROLL-AUSTIN PERCY,D108,HJ,,1.78,3438.8
6175,8/14/2020,8/14/2020,81420,82L-IMPORT PAYROLL-AUSTIN PERCY,D108,HJ,,14.83,3423.97
6175,8/14/2020,8/14/2020,81420,82L-IMPORT PAYROLL-BAUSH DANIEL,D108,HJ,,1.78,3422.19
6175,8/14/2020,8/14/2020,81420,82L-IMPORT PAYROLL-BAUSH DANIEL,D108,HJ,,11.96,3410.23
6175,8/14/2020,8/14/2020,81420,82L-IMPORT PAYROLL-CHAPMAN CLAUDY EARL,D108,HJ,,1.78,3408.45
6175,8/14/2020,8/14/2020,81420,82L-IMPORT PAYROLL-CHAPMAN CLAUDY EARL,D108,HJ,,11.96,3396.49
6175,8/14/2020,8/14/2020,81420,82L-IMPORT PAYROLL-DADA ARIKPO E,D108,HJ,,5.23,3391.26
6175,8/14/2020,8/14/2020,81420,82L-IMPORT PAYROLL-DADA ARIKPO E,D108,HJ,,35.65,3355.61
6175,8/14/2020,8/14/2020,81420,82L-IMPORT PAYROLL-GUTHRIE LESLIE,D108,HJ,,1.78,3353.83
6175,8/14/2020,8/14/2020,81420,82L-IMPORT PAYROLL-GUTHRIE LESLIE,D108,HJ,,14.83,3339
6175,8/14/2020,8/14/2020,81420,82L-IMPORT PAYROLL-HOLMES JOREL ALEXANDER,D108,HJ,,1.78,3337.22
6175,8/14/2020,8/14/2020,81420,82L-IMPORT PAYROLL-HOLMES JOREL ALEXANDER,D108,HJ,,11.96,3325.26
6175,8/14/2020,8/14/2020,81420,82L-IMPORT PAYROLL-JORDAN TIFFANY T,D108,HJ,,5.23,3320.03
6175,8/14/2020,8/14/2020,81420,82L-IMPORT PAYROLL-JORDAN TIFFANY T,D108,HJ,,35.65,3284.38
6175,8/14/2020,8/14/2020,81420,82L-IMPORT PAYROLL-LANIGAN LISA A,D108,HJ,,3.56,3280.82
6175,8/14/2020,8/14/2020,81420,82L-IMPORT PAYROLL-ONICA ANTHONY J,D108,HJ,,1.78,3279.04
6175,8/14/2020,8/14/2020,81420,82L-IMPORT PAYROLL-ONICA ANTHONY J,D108,HJ,,11.96,3267.08
6175,8/14/2020,8/14/2020,81420,82L-IMPORT PAYROLL-PRAHIN NICOLE M,D108,HJ,,1.78,3265.3
6175,8/14/2020,8/14/2020,81420,82L-IMPORT PAYROLL-PRAHIN NICOLE M,D108,HJ,,11.96,3253.34
6175,8/14/2020,8/14/2020,81420,82L-IMPORT PAYROLL-SALIM YASSER,D108,HJ,,11.96,3241.38
6175,8/14/2020,8/14/2020,81420,82L-IMPORT PAYROLL-SEJOUR MAHALIAH,D108,HJ,,1.78,3239.6
6175,8/14/2020,8/14/2020,81420,82L-IMPORT PAYROLL-SEJOUR MAHALIAH,D108,HJ,,11.96,3227.64
6175,8/14/2020,8/14/2020,81420,82L-IMPORT PAYROLL-TUMENJARGAL ENKHJIN,D108,HJ,,1.78,3225.86
6175,8/14/2020,8/14/2020,81420,82L-IMPORT PAYROLL-TUMENJARGAL ENKHJIN,D108,HJ,,11.96,3213.9
6175,8/14/2020,8/14/2020,81420,82L-IMPORT PAYROLL-VILLEGAS EVELYN,D108,HJ,,5.23,3208.67
6175,8/14/2020,8/14/2020,81420,82L-IMPORT PAYROLL-VILLEGAS EVELYN,D108,HJ,,35.65,3173.02
6175,8/14/2020,8/14/2020,81420,82L-IMPORT PAYROLL-WOLF ANNA A,D108,HJ,,1.78,3171.24
6175,8/14/2020,8/14/2020,81420,82L-IMPORT PAYROLL-ACEVEDO MONIVETT,D107,HJ,,25.48,3145.76
6175,8/14/2020,8/14/2020,81420,82L-IMPORT PAYROLL-AKLESTAD ISABEL,D111,HJ,,1.78,3143.98
6175,8/14/2020,8/14/2020,81420,82L-IMPORT PAYROLL-AKLESTAD ISABEL,D111,HJ,,11.96,3132.02
6175,8/14/2020,8/14/2020,81420,82L-IMPORT PAYROLL-COOK CATHRYN ANNA,D105,HJ,,1.78,3130.24
6175,8/14/2020,8/14/2020,81420,82L-IMPORT PAYROLL-COOK CATHRYN ANNA,D105,HJ,,14.83,3115.41
6175,8/14/2020,8/14/2020,81420,82L-IMPORT PAYROLL-COOPER ASHLEE R,D101,HJ,,1.78,3113.63
6175,8/14/2020,8/14/2020,81420,82L-IMPORT PAYROLL-COOPER ASHLEE R,D101,HJ,,11.96,3101.67
6175,8/14/2020,8/14/2020,81420,82L-IMPORT PAYROLL-DETONE KYRA MAYA,D102,HJ,,1.78,3099.89
6175,8/14/2020,8/14/2020,81420,82L-IMPORT PAYROLL-DETONE KYRA MAYA,D102,HJ,,11.96,3087.93
6175,8/14/2020,8/14/2020,81420,82L-IMPORT PAYROLL-DUPUIS CHRISTOPHER M,D107,HJ,,1.78,3086.15
6175,8/14/2020,8/14/2020,81420,82L-IMPORT PAYROLL-DUPUIS CHRISTOPHER M,D107,HJ,,11.96,3074.19
6175,8/14/2020,8/14/2020,81420,82L-IMPORT PAYROLL-DZIEDZIC JULIE K,D101,HJ,,3.38,3070.81
6175,8/14/2020,8/14/2020,81420,82L-IMPORT PAYROLL-DZIEDZIC JULIE K,D101,HJ,,25.48,3045.33
6175,8/14/2020,8/14/2020,81420,82L-IMPORT PAYROLL-GRAVES KAMIESHIA,D101,HJ,,3.38,3041.95
6175,8/14/2020,8/14/2020,81420,82L-IMPORT PAYROLL-GRAVES KAMIESHIA,D101,HJ,,25.48,3016.47
6175,8/14/2020,8/14/2020,81420,82L-IMPORT PAYROLL-GUADARRAMA-ALVAREZ URIEL A,D105,HJ,,1.78,3014.69
6175,8/14/2020,8/14/2020,81420,82L-IMPORT PAYROLL-GUADARRAMA-ALVAREZ URIEL A,D105,HJ,,11.96,3002.73
6175,8/14/2020,8/14/2020,81420,82L-IMPORT PAYROLL-GUTIERREZ ANTONIO J,D107,HJ,,35.65,2967.08
6175,8/14/2020,8/14/2020,81420,82L-IMPORT PAYROLL-LACEY DEQUITA,D107,HJ,,1.78,2965.3
6175,8/14/2020,8/14/2020,81420,82L-IMPORT PAYROLL-LACEY DEQUITA,D107,HJ,,14.83,2950.47
6175,8/14/2020,8/14/2020,81420,82L-IMPORT PAYROLL-LIPORACE HERNAN LUIS,D103,HJ,,11.96,2938.51
6175,8/14/2020,8/14/2020,81420,82L-IMPORT PAYROLL-MASON ANGELA,D107,HJ,,5.23,2933.28
6175,8/14/2020,8/14/2020,81420,82L-IMPORT PAYROLL-MASON ANGELA,D107,HJ,,35.65,2897.63
6175,8/14/2020,8/14/2020,81420,82L-IMPORT PAYROLL-PARHAM-GANTT DENISE M,D112,HJ,,3.56,2894.07
6175,8/14/2020,8/14/2020,81420,82L-IMPORT PAYROLL-PARHAM-GANTT DENISE M,D112,HJ,,31.6,2862.47
6175,8/14/2020,8/14/2020,81420,82L-IMPORT PAYROLL-PEINADO ELIZABETH R,D111,HJ,,1.78,2860.69
6175,8/14/2020,8/14/2020,81420,82L-IMPORT PAYROLL-PEINADO ELIZABETH R,D111,HJ,,11.96,2848.73
6175,8/14/2020,8/14/2020,81420,82L-IMPORT PAYROLL-POLANCO ODALIS,D103,HJ,,1.78,2846.95
6175,8/14/2020,8/14/2020,81420,82L-IMPORT PAYROLL-POLANCO ODALIS,D103,HJ,,11.96,2834.99
6175,8/14/2020,8/14/2020,81420,82L-IMPORT PAYROLL-RANDOLPH ALEXANDER,D111,HJ,,1.78,2833.21
6175,8/14/2020,8/14/2020,81420,82L-IMPORT PAYROLL-RANDOLPH ALEXANDER,D111,HJ,,11.96,2821.25
6175,8/14/2020,8/14/2020,81420,82L-IMPORT PAYROLL-SAFRAN ALAN P,D107,HJ,,3.56,2817.69
6175,8/14/2020,8/14/2020,81420,82L-IMPORT PAYROLL-SAFRAN ALAN P,D107,HJ,,35.65,2782.04
6175,8/14/2020,8/14/2020,81420,82L-IMPORT PAYROLL-WALLACE AMENA T,D104,HJ,,11.96,2770.08
6175,8/14/2020,8/14/2020,81420,82L-IMPORT PAYROLL-WEINSTOCK EMILY,D101,HJ,,1.78,2768.3
6175,8/14/2020,8/14/2020,81420,82L-IMPORT PAYROLL-WEINSTOCK EMILY,D101,HJ,,11.96,2756.34
6175,8/14/2020,8/14/2020,81420,82L-IMPORT PAYROLL-BARTOLD DEANNA MARIE,D108,HJ,,1.78,2754.56
6175,8/14/2020,8/14/2020,81420,82L-IMPORT PAYROLL-BARTOLD DEANNA MARIE,D108,HJ,,11.96,2742.6
6175,8/14/2020,8/14/2020,81420,82L-IMPORT PAYROLL-BELLOT GENESIS,D108,HJ,,1.78,2740.82
6175,8/14/2020,8/14/2020,81420,82L-IMPORT PAYROLL-BELLOT GENESIS,D108,HJ,,14.83,2725.99
6175,8/14/2020,8/14/2020,81420,82L-IMPORT PAYROLL-FEIGHERY JOHN,D108,HJ,,11.96,2714.03
6175,8/14/2020,8/14/2020,81420,82L-IMPORT PAYROLL-GRIFFIN ANDREW,D108,HJ,,1.78,2712.25
6175,8/14/2020,8/14/2020,81420,82L-IMPORT PAYROLL-GRIFFIN ANDREW,D108,HJ,,11.96,2700.29
6175,8/14/2020,8/14/2020,81420,82L-IMPORT PAYROLL-HALLINAN GABRIEL B,D108,HJ,,1.78,2698.51
6175,8/14/2020,8/14/2020,81420,82L-IMPORT PAYROLL-HALLINAN GABRIEL B,D108,HJ,,11.96,2686.55
6175,8/14/2020,8/14/2020,81420,82L-IMPORT PAYROLL-HOSSAIN MYESHA R,D108,HJ,,1.78,2684.77
6175,8/14/2020,8/14/2020,81420,82L-IMPORT PAYROLL-HOSSAIN MYESHA R,D108,HJ,,14.83,2669.94
6175,8/14/2020,8/14/2020,81420,82L-IMPORT PAYROLL-JACKSON TASNIM F,D108,HJ,,1.78,2668.16
6175,8/14/2020,8/14/2020,81420,82L-IMPORT PAYROLL-JACKSON TASNIM F,D108,HJ,,14.83,2653.33
6175,8/14/2020,8/14/2020,81420,82L-IMPORT PAYROLL-LI BELLA,D108,HJ,,1.78,2651.55
6175,8/14/2020,8/14/2020,81420,82L-IMPORT PAYROLL-LI BELLA,D108,HJ,,11.96,2639.59
6175,8/14/2020,8/14/2020,81420,82L-IMPORT PAYROLL-MOSELEY ARIELLE,D108,HJ,,1.78,2637.81
6175,8/14/2020,8/14/2020,81420,82L-IMPORT PAYROLL-MOSELEY ARIELLE,D108,HJ,,11.96,2625.85
6175,8/14/2020,8/14/2020,81420,82L-IMPORT PAYROLL-COVENEY ALLISON,D108,HJ,,1.78,2624.07
6175,8/14/2020,8/14/2020,81420,82L-IMPORT PAYROLL-COVENEY ALLISON,D108,HJ,,14.83,2609.24
6175,8/14/2020,8/14/2020,81420,82L-IMPORT PAYROLL-JACKSON CLAICE M,D108,HJ,,1.78,2607.46
6175,8/14/2020,8/14/2020,81420,82L-IMPORT PAYROLL-JACKSON CLAICE M,D108,HJ,,11.96,2595.5
6175,8/14/2020,8/14/2020,81420,82L-IMPORT PAYROLL-JANG DANIEL,D108,HJ,,1.78,2593.72
6175,8/14/2020,8/14/2020,81420,82L-IMPORT PAYROLL-JANG DANIEL,D108,HJ,,14.83,2578.89
6175,8/14/2020,8/14/2020,81420,82L-IMPORT PAYROLL-LENEGHAN MARYELLEN B,D108,HJ,,1.78,2577.11
6175,8/14/2020,8/14/2020,81420,82L-IMPORT PAYROLL-LENEGHAN MARYELLEN B,D108,HJ,,11.96,2565.15
6175,8/14/2020,8/14/2020,82L-PRPD-081520,82L-PRPD-081520 -IMPORT PAYROLL-AUSTIN PERCY,D108,HJ,,1.78,2563.37
6175,8/14/2020,8/14/2020,82L-PRPD-081520,82L-PRPD-081520 -IMPORT PAYROLL-AUSTIN PERCY,D108,HJ,,14.83,2548.54
6175,8/14/2020,8/14/2020,82L-PRPD-081520,82L-PRPD-081520 -IMPORT PAYROLL-BAUSH DANIEL,D108,HJ,,1.78,2546.76
6175,8/14/2020,8/14/2020,82L-PRPD-081520,82L-PRPD-081520 -IMPORT PAYROLL-BAUSH DANIEL,D108,HJ,,11.96,2534.8
6175,8/14/2020,8/14/2020,82L-PRPD-081520,82L-PRPD-081520 -IMPORT PAYROLL-CHAPMAN CLAUDY EARL,D108,HJ,,1.78,2533.02
6175,8/14/2020,8/14/2020,82L-PRPD-081520,82L-PRPD-081520 -IMPORT PAYROLL-CHAPMAN CLAUDY EARL,D108,HJ,,11.96,2521.06
6175,8/14/2020,8/14/2020,82L-PRPD-081520,82L-PRPD-081520 -IMPORT PAYROLL-DADA ARIKPO E,D108,HJ,,5.23,2515.83
6175,8/14/2020,8/14/2020,82L-PRPD-081520,82L-PRPD-081520 -IMPORT PAYROLL-DADA ARIKPO E,D108,HJ,,35.65,2480.18
6175,8/14/2020,8/14/2020,82L-PRPD-081520,82L-PRPD-081520 -IMPORT PAYROLL-GUTHRIE LESLIE,D108,HJ,,1.78,2478.4
6175,8/14/2020,8/14/2020,82L-PRPD-081520,82L-PRPD-081520 -IMPORT PAYROLL-GUTHRIE LESLIE,D108,HJ,,14.83,2463.57
6175,8/14/2020,8/14/2020,82L-PRPD-081520,82L-PRPD-081520 -IMPORT PAYROLL-HOLMES JOREL ALEXANDER,D108,HJ,,1.78,2461.79
6175,8/14/2020,8/14/2020,82L-PRPD-081520,82L-PRPD-081520 -IMPORT PAYROLL-HOLMES JOREL ALEXANDER,D108,HJ,,11.96,2449.83
6175,8/14/2020,8/14/2020,82L-PRPD-081520,82L-PRPD-081520 -IMPORT PAYROLL-JORDAN TIFFANY T,D108,HJ,,5.23,2444.6
6175,8/14/2020,8/14/2020,82L-PRPD-081520,82L-PRPD-081520 -IMPORT PAYROLL-JORDAN TIFFANY T,D108,HJ,,35.65,2408.95
6175,8/14/2020,8/14/2020,82L-PRPD-081520,82L-PRPD-081520 -IMPORT PAYROLL-LANIGAN LISA A,D108,HJ,,3.56,2405.39
6175,8/14/2020,8/14/2020,82L-PRPD-081520,82L-PRPD-081520 -IMPORT PAYROLL-ONICA ANTHONY J,D108,HJ,,1.78,2403.61
6175,8/14/2020,8/14/2020,82L-PRPD-081520,82L-PRPD-081520 -IMPORT PAYROLL-ONICA ANTHONY J,D108,HJ,,11.96,2391.65
6175,8/14/2020,8/14/2020,82L-PRPD-081520,82L-PRPD-081520 -IMPORT PAYROLL-PRAHIN NICOLE M,D108,HJ,,1.78,2389.87
6175,8/14/2020,8/14/2020,82L-PRPD-081520,82L-PRPD-081520 -IMPORT PAYROLL-PRAHIN NICOLE M,D108,HJ,,11.96,2377.91
6175,8/14/2020,8/14/2020,82L-PRPD-081520,82L-PRPD-081520 -IMPORT PAYROLL-SALIM YASSER,D108,HJ,,11.96,2365.95
6175,8/14/2020,8/14/2020,82L-PRPD-081520,82L-PRPD-081520 -IMPORT PAYROLL-SEJOUR MAHALIAH,D108,HJ,,1.78,2364.17
6175,8/14/2020,8/14/2020,82L-PRPD-081520,82L-PRPD-081520 -IMPORT PAYROLL-SEJOUR MAHALIAH,D108,HJ,,11.96,2352.21
6175,8/14/2020,8/14/2020,82L-PRPD-081520,82L-PRPD-081520 -IMPORT PAYROLL-TUMENJARGAL ENKHJIN,D108,HJ,,1.78,2350.43
6175,8/14/2020,8/14/2020,82L-PRPD-081520,82L-PRPD-081520 -IMPORT PAYROLL-TUMENJARGAL ENKHJIN,D108,HJ,,11.96,2338.47
6175,8/14/2020,8/14/2020,82L-PRPD-081520,82L-PRPD-081520 -IMPORT PAYROLL-VILLEGAS EVELYN,D108,HJ,,5.23,2333.24
6175,8/14/2020,8/14/2020,82L-PRPD-081520,82L-PRPD-081520 -IMPORT PAYROLL-VILLEGAS EVELYN,D108,HJ,,35.65,2297.59
6175,8/14/2020,8/14/2020,82L-PRPD-081520,82L-PRPD-081520 -IMPORT PAYROLL-WALLACE AMENA T,D108,HJ,,11.96,2285.63
6175,8/14/2020,8/14/2020,82L-PRPD-081520,82L-PRPD-081520 -IMPORT PAYROLL-WOLF ANNA A,D108,HJ,,1.78,2283.85
6175,8/14/2020,8/14/2020,82L-PRPD-081520,82L-PRPD-081520 -IMPORT PAYROLL-ACEVEDO MONIVETT,D103,HJ,,25.48,2258.37
6175,8/14/2020,8/14/2020,82L-PRPD-081520,82L-PRPD-081520 -IMPORT PAYROLL-AKLESTAD ISABEL,D107,HJ,,1.78,2256.59
6175,8/14/2020,8/14/2020,82L-PRPD-081520,82L-PRPD-081520 -IMPORT PAYROLL-AKLESTAD ISABEL,D107,HJ,,11.96,2244.63
6175,8/14/2020,8/14/2020,82L-PRPD-081520,82L-PRPD-081520 -IMPORT PAYROLL-ALVAREZ-MORINE LISIS,D107,HJ,,1.78,2242.85
6175,8/14/2020,8/14/2020,82L-PRPD-081520,82L-PRPD-081520 -IMPORT PAYROLL-ALVAREZ-MORINE LISIS,D107,HJ,,14.83,2228.02
6175,8/14/2020,8/14/2020,82L-PRPD-081520,82L-PRPD-081520 -IMPORT PAYROLL-BARTHELEMY RACHALIE,D107,HJ,,1.78,2226.24
6175,8/14/2020,8/14/2020,82L-PRPD-081520,82L-PRPD-081520 -IMPORT PAYROLL-BARTHELEMY RACHALIE,D107,HJ,,14.83,2211.41
6175,8/14/2020,8/14/2020,82L-PRPD-081520,82L-PRPD-081520 -IMPORT PAYROLL-BREEDLOVE JOHNDEE L,D107,HJ,,14.83,2196.58
6175,8/14/2020,8/14/2020,82L-PRPD-081520,82L-PRPD-081520 -IMPORT PAYROLL-COOK CATHRYN ANNA,D107,HJ,,1.78,2194.8
6175,8/14/2020,8/14/2020,82L-PRPD-081520,82L-PRPD-081520 -IMPORT PAYROLL-COOK CATHRYN ANNA,D107,HJ,,14.83,2179.97
6175,8/14/2020,8/14/2020,82L-PRPD-081520,82L-PRPD-081520 -IMPORT PAYROLL-COOPER ASHLEE R,D107,HJ,,1.78,2178.19
6175,8/14/2020,8/14/2020,82L-PRPD-081520,82L-PRPD-081520 -IMPORT PAYROLL-COOPER ASHLEE R,D107,HJ,,11.96,2166.23
6175,8/14/2020,8/14/2020,82L-PRPD-081520,82L-PRPD-081520 -IMPORT PAYROLL-DETONE KYRA MAYA,D102,HJ,,1.78,2164.45
6175,8/14/2020,8/14/2020,82L-PRPD-081520,82L-PRPD-081520 -IMPORT PAYROLL-DETONE KYRA MAYA,D102,HJ,,11.96,2152.49
6175,8/14/2020,8/14/2020,82L-PRPD-081520,82L-PRPD-081520 -IMPORT PAYROLL-DUPUIS CHRISTOPHER M,D107,HJ,,1.78,2150.71
6175,8/14/2020,8/14/2020,82L-PRPD-081520,82L-PRPD-081520 -IMPORT PAYROLL-DUPUIS CHRISTOPHER M,D107,HJ,,11.96,2138.75
6175,8/14/2020,8/14/2020,82L-PRPD-081520,82L-PRPD-081520 -IMPORT PAYROLL-DZIEDZIC JULIE K,D107,HJ,,3.38,2135.37
6175,8/14/2020,8/14/2020,82L-PRPD-081520,82L-PRPD-081520 -IMPORT PAYROLL-DZIEDZIC JULIE K,D107,HJ,,25.48,2109.89
6175,8/14/2020,8/14/2020,82L-PRPD-081520,82L-PRPD-081520 -IMPORT PAYROLL-GRAVES KAMIESHIA,D107,HJ,,3.38,2106.51
6175,8/14/2020,8/14/2020,82L-PRPD-081520,82L-PRPD-081520 -IMPORT PAYROLL-GRAVES KAMIESHIA,D107,HJ,,25.48,2081.03
6175,8/14/2020,8/14/2020,82L-PRPD-081520,82L-PRPD-081520 -IMPORT PAYROLL-GUADARRAMA-ALVAREZ URIEL A,D107,HJ,,1.78,2079.25
6175,8/14/2020,8/14/2020,82L-PRPD-081520,82L-PRPD-081520 -IMPORT PAYROLL-GUADARRAMA-ALVAREZ URIEL A,D107,HJ,,11.96,2067.29
6175,8/14/2020,8/14/2020,82L-PRPD-081520,82L-PRPD-081520 -IMPORT PAYROLL-GUTIERREZ ANTONIO J,D102,HJ,,35.65,2031.64
6175,8/14/2020,8/14/2020,82L-PRPD-081520,82L-PRPD-081520 -IMPORT PAYROLL-LACEY DEQUITA,D108,HJ,,1.78,2029.86
6175,8/14/2020,8/14/2020,82L-PRPD-081520,82L-PRPD-081520 -IMPORT PAYROLL-LACEY DEQUITA,D108,HJ,,14.83,2015.03
6175,8/14/2020,8/14/2020,82L-PRPD-081520,82L-PRPD-081520 -IMPORT PAYROLL-LI SEN YUAN,D107,HJ,,1.78,2013.25
6175,8/14/2020,8/14/2020,82L-PRPD-081520,82L-PRPD-081520 -IMPORT PAYROLL-LI SEN YUAN,D107,HJ,,11.96,2001.29
6175,8/14/2020,8/14/2020,82L-PRPD-081520,82L-PRPD-081520 -IMPORT PAYROLL-LIPORACE HERNAN LUIS,D103,HJ,,11.96,1989.33
6175,8/14/2020,8/14/2020,82L-PRPD-081520,82L-PRPD-081520 -IMPORT PAYROLL-LIPSCOMB STEPHEN,D107,HJ,,1.78,1987.55
6175,8/14/2020,8/14/2020,82L-PRPD-081520,82L-PRPD-081520 -IMPORT PAYROLL-LIPSCOMB STEPHEN,D107,HJ,,11.96,1975.59
6175,8/14/2020,8/14/2020,82L-PRPD-081520,82L-PRPD-081520 -IMPORT PAYROLL-MASON ANGELA,D107,HJ,,5.23,1970.36
6175,8/14/2020,8/14/2020,82L-PRPD-081520,82L-PRPD-081520 -IMPORT PAYROLL-MASON ANGELA,D107,HJ,,35.65,1934.71
6175,8/14/2020,8/14/2020,82L-PRPD-081520,82L-PRPD-081520 -IMPORT PAYROLL-MEJIA CARLOS MANUEL,D107,HJ,,1.78,1932.93
6175,8/14/2020,8/14/2020,82L-PRPD-081520,82L-PRPD-081520 -IMPORT PAYROLL-MEJIA CARLOS MANUEL,D107,HJ,,14.83,1918.1
6175,8/14/2020,8/14/2020,82L-PRPD-081520,82L-PRPD-081520 -IMPORT PAYROLL-PARHAM-GANTT DENISE M,D108,HJ,,3.56,1914.54
6175,8/14/2020,8/14/2020,82L-PRPD-081520,82L-PRPD-081520 -IMPORT PAYROLL-PARHAM-GANTT DENISE M,D108,HJ,,31.6,1882.94
6175,8/14/2020,8/14/2020,82L-PRPD-081520,82L-PRPD-081520 -IMPORT PAYROLL-PEINADO ELIZABETH R,D107,HJ,,1.78,1881.16
6175,8/14/2020,8/14/2020,82L-PRPD-081520,82L-PRPD-081520 -IMPORT PAYROLL-PEINADO ELIZABETH R,D107,HJ,,11.96,1869.2
6175,8/14/2020,8/14/2020,82L-PRPD-081520,82L-PRPD-081520 -IMPORT PAYROLL-POLANCO ODALIS,D103,HJ,,1.78,1867.42
6175,8/14/2020,8/14/2020,82L-PRPD-081520,82L-PRPD-081520 -IMPORT PAYROLL-POLANCO ODALIS,D103,HJ,,11.96,1855.46
6175,8/14/2020,8/14/2020,82L-PRPD-081520,82L-PRPD-081520 -IMPORT PAYROLL-RANDOLPH ALEXANDER,D107,HJ,,1.78,1853.68
6175,8/14/2020,8/14/2020,82L-PRPD-081520,82L-PRPD-081520 -IMPORT PAYROLL-RANDOLPH ALEXANDER,D107,HJ,,11.96,1841.72
6175,8/14/2020,8/14/2020,82L-PRPD-081520,82L-PRPD-081520 -IMPORT PAYROLL-SAFRAN ALAN P,D102,HJ,,3.56,1838.16
6175,8/14/2020,8/14/2020,82L-PRPD-081520,82L-PRPD-081520 -IMPORT PAYROLL-SAFRAN ALAN P,D102,HJ,,35.65,1802.51
6175,8/14/2020,8/14/2020,82L-PRPD-081520,82L-PRPD-081520 -IMPORT PAYROLL-SCOTT KIRK DONOVAN,D107,HJ,,1.78,1800.73
6175,8/14/2020,8/14/2020,82L-PRPD-081520,82L-PRPD-081520 -IMPORT PAYROLL-SCOTT KIRK DONOVAN,D107,HJ,,11.96,1788.77
6175,8/14/2020,8/14/2020,82L-PRPD-081520,82L-PRPD-081520 -IMPORT PAYROLL-SILVER KELLY,D107,HJ,,1.78,1786.99
6175,8/14/2020,8/14/2020,82L-PRPD-081520,82L-PRPD-081520 -IMPORT PAYROLL-SILVER KELLY,D107,HJ,,14.83,1772.16
6175,8/14/2020,8/14/2020,82L-PRPD-081520,82L-PRPD-081520 -IMPORT PAYROLL-STROUD DAVID,D107,HJ,,1.78,1770.38
6175,8/14/2020,8/14/2020,82L-PRPD-081520,82L-PRPD-081520 -IMPORT PAYROLL-STROUD DAVID,D107,HJ,,14.83,1755.55
6175,8/14/2020,8/14/2020,82L-PRPD-081520,82L-PRPD-081520 -IMPORT PAYROLL-WEINSTOCK EMILY,D107,HJ,,1.78,1753.77
6175,8/14/2020,8/14/2020,82L-PRPD-081520,82L-PRPD-081520 -IMPORT PAYROLL-WEINSTOCK EMILY,D107,HJ,,11.96,1741.81
6175,8/14/2020,8/14/2020,82L-PRPD-081520,82L-PRPD-081520 -IMPORT PAYROLL-WILLIAMS MACK ANTHONY,D107,HJ,,11.96,1729.85
6175,8/14/2020,8/14/2020,82L-PRPD-081520,82L-PRPD-081520 -IMPORT PAYROLL-BARTOLD DEANNA MARIE,D108,HJ,,1.78,1728.07
6175,8/14/2020,8/14/2020,82L-PRPD-081520,82L-PRPD-081520 -IMPORT PAYROLL-BARTOLD DEANNA MARIE,D108,HJ,,11.96,1716.11
6175,8/14/2020,8/14/2020,82L-PRPD-081520,82L-PRPD-081520 -IMPORT PAYROLL-BELLOT GENESIS,D108,HJ,,1.78,1714.33
6175,8/14/2020,8/14/2020,82L-PRPD-081520,82L-PRPD-081520 -IMPORT PAYROLL-BELLOT GENESIS,D108,HJ,,14.83,1699.5
6175,8/14/2020,8/14/2020,82L-PRPD-081520,82L-PRPD-081520 -IMPORT PAYROLL-FEIGHERY JOHN,D108,HJ,,11.96,1687.54
6175,8/14/2020,8/14/2020,82L-PRPD-081520,82L-PRPD-081520 -IMPORT PAYROLL-GRIFFIN ANDREW,D108,HJ,,1.78,1685.76
6175,8/14/2020,8/14/2020,82L-PRPD-081520,82L-PRPD-081520 -IMPORT PAYROLL-GRIFFIN ANDREW,D108,HJ,,11.96,1673.8
6175,8/14/2020,8/14/2020,82L-PRPD-081520,82L-PRPD-081520 -IMPORT PAYROLL-HALLINAN GABRIEL B,D108,HJ,,1.78,1672.02
6175,8/14/2020,8/14/2020,82L-PRPD-081520,82L-PRPD-081520 -IMPORT PAYROLL-HALLINAN GABRIEL B,D108,HJ,,11.96,1660.06
6175,8/14/2020,8/14/2020,82L-PRPD-081520,82L-PRPD-081520 -IMPORT PAYROLL-HOSSAIN MYESHA R,D108,HJ,,1.78,1658.28
6175,8/14/2020,8/14/2020,82L-PRPD-081520,82L-PRPD-081520 -IMPORT PAYROLL-HOSSAIN MYESHA R,D108,HJ,,14.83,1643.45
6175,8/14/2020,8/14/2020,82L-PRPD-081520,82L-PRPD-081520 -IMPORT PAYROLL-JACKSON TASNIM F,D108,HJ,,1.78,1641.67
6175,8/14/2020,8/14/2020,82L-PRPD-081520,82L-PRPD-081520 -IMPORT PAYROLL-JACKSON TASNIM F,D108,HJ,,14.83,1626.84
6175,8/14/2020,8/14/2020,82L-PRPD-081520,82L-PRPD-081520 -IMPORT PAYROLL-LI BELLA,D108,HJ,,1.78,1625.06
6175,8/14/2020,8/14/2020,82L-PRPD-081520,82L-PRPD-081520 -IMPORT PAYROLL-LI BELLA,D108,HJ,,11.96,1613.1
6175,8/14/2020,8/14/2020,82L-PRPD-081520,82L-PRPD-081520 -IMPORT PAYROLL-MOSELEY ARIELLE,D108,HJ,,1.78,1611.32
6175,8/14/2020,8/14/2020,82L-PRPD-081520,82L-PRPD-081520 -IMPORT PAYROLL-MOSELEY ARIELLE,D108,HJ,,11.96,1599.36
6175,8/14/2020,8/14/2020,82L-PRPD-081520,82L-PRPD-081520 -IMPORT PAYROLL-COVENEY ALLISON,D108,HJ,,1.78,1597.58
6175,8/14/2020,8/14/2020,82L-PRPD-081520,82L-PRPD-081520 -IMPORT PAYROLL-COVENEY ALLISON,D108,HJ,,14.83,1582.75
6175,8/14/2020,8/14/2020,82L-PRPD-081520,82L-PRPD-081520 -IMPORT PAYROLL-JACKSON CLAICE M,D108,HJ,,1.78,1580.97
6175,8/14/2020,8/14/2020,82L-PRPD-081520,82L-PRPD-081520 -IMPORT PAYROLL-JACKSON CLAICE M,D108,HJ,,11.96,1569.01
6175,8/14/2020,8/14/2020,82L-PRPD-081520,82L-PRPD-081520 -IMPORT PAYROLL-JANG DANIEL,D108,HJ,,1.78,1567.23
6175,8/14/2020,8/14/2020,82L-PRPD-081520,82L-PRPD-081520 -IMPORT PAYROLL-JANG DANIEL,D108,HJ,,14.83,1552.4
6175,8/14/2020,8/14/2020,82L-PRPD-081520,82L-PRPD-081520 -IMPORT PAYROLL-LENEGHAN MARYELLEN B,D108,HJ,,1.78,1550.62
6175,8/14/2020,8/14/2020,82L-PRPD-081520,82L-PRPD-081520 -IMPORT PAYROLL-LENEGHAN MARYELLEN B,D108,HJ,,11.96,1538.66
6175,8/15/2020,8/15/2020,82L-PRPD-081520,To reverse 82L payroll 0815 JE-21-0020-To reverse 82L Payroll of 8152020,D108,HJ,1.78,,1540.44
6175,8/15/2020,8/15/2020,82L-PRPD-081520,To reverse 82L payroll 0815 JE-21-0020-To reverse 82L Payroll of 8152020,D108,HJ,1.78,,1542.22
6175,8/15/2020,8/15/2020,82L-PRPD-081520,To reverse 82L payroll 0815 JE-21-0020-To reverse 82L Payroll of 8152020,D108,HJ,1.78,,1544
6175,8/15/2020,8/15/2020,82L-PRPD-081520,To reverse 82L payroll 0815 JE-21-0020-To reverse 82L Payroll of 8152020,D108,HJ,1.78,,1545.78
6175,8/15/2020,8/15/2020,82L-PRPD-081520,To reverse 82L payroll 0815 JE-21-0020-To reverse 82L Payroll of 8152020,D108,HJ,1.78,,1547.56
6175,8/15/2020,8/15/2020,82L-PRPD-081520,To reverse 82L payroll 0815 JE-21-0020-To reverse 82L Payroll of 8152020,D108,HJ,1.78,,1549.34
6175,8/15/2020,8/15/2020,82L-PRPD-081520,To reverse 82L payroll 0815 JE-21-0020-To reverse 82L Payroll of 8152020,D108,HJ,1.78,,1551.12
6175,8/15/2020,8/15/2020,82L-PRPD-081520,To reverse 82L payroll 0815 JE-21-0020-To reverse 82L Payroll of 8152020,D108,HJ,1.78,,1552.9
6175,8/15/2020,8/15/2020,82L-PRPD-081520,To reverse 82L payroll 0815 JE-21-0020-To reverse 82L Payroll of 8152020,D108,HJ,1.78,,1554.68
6175,8/15/2020,8/15/2020,82L-PRPD-081520,To reverse 82L payroll 0815 JE-21-0020-To reverse 82L Payroll of 8152020,D108,HJ,1.78,,1556.46
6175,8/15/2020,8/15/2020,82L-PRPD-081520,To reverse 82L payroll 0815 JE-21-0020-To reverse 82L Payroll of 8152020,D108,HJ,3.56,,1560.02
6175,8/15/2020,8/15/2020,82L-PRPD-081520,To reverse 82L payroll 0815 JE-21-0020-To reverse 82L Payroll of 8152020,D108,HJ,5.23,,1565.25
6175,8/15/2020,8/15/2020,82L-PRPD-081520,To reverse 82L payroll 0815 JE-21-0020-To reverse 82L Payroll of 8152020,D108,HJ,5.23,,1570.48
6175,8/15/2020,8/15/2020,82L-PRPD-081520,To reverse 82L payroll 0815 JE-21-0020-To reverse 82L Payroll of 8152020,D108,HJ,5.23,,1575.71
6175,8/15/2020,8/15/2020,82L-PRPD-081520,To reverse 82L payroll 0815 JE-21-0020-To reverse 82L Payroll of 8152020,D108,HJ,11.96,,1587.67
6175,8/15/2020,8/15/2020,82L-PRPD-081520,To reverse 82L payroll 0815 JE-21-0020-To reverse 82L Payroll of 8152020,D108,HJ,11.96,,1599.63
6175,8/15/2020,8/15/2020,82L-PRPD-081520,To reverse 82L payroll 0815 JE-21-0020-To reverse 82L Payroll of 8152020,D108,HJ,11.96,,1611.59
6175,8/15/2020,8/15/2020,82L-PRPD-081520,To reverse 82L payroll 0815 JE-21-0020-To reverse 82L Payroll of 8152020,D108,HJ,11.96,,1623.55
6175,8/15/2020,8/15/2020,82L-PRPD-081520,To reverse 82L payroll 0815 JE-21-0020-To reverse 82L Payroll of 8152020,D108,HJ,11.96,,1635.51
6175,8/15/2020,8/15/2020,82L-PRPD-081520,To reverse 82L payroll 0815 JE-21-0020-To reverse 82L Payroll of 8152020,D108,HJ,11.96,,1647.47
6175,8/15/2020,8/15/2020,82L-PRPD-081520,To reverse 82L payroll 0815 JE-21-0020-To reverse 82L Payroll of 8152020,D108,HJ,11.96,,1659.43
6175,8/15/2020,8/15/2020,82L-PRPD-081520,To reverse 82L payroll 0815 JE-21-0020-To reverse 82L Payroll of 8152020,D108,HJ,11.96,,1671.39
6175,8/15/2020,8/15/2020,82L-PRPD-081520,To reverse 82L payroll 0815 JE-21-0020-To reverse 82L Payroll of 8152020,D108,HJ,11.96,,1683.35
6175,8/15/2020,8/15/2020,82L-PRPD-081520,To reverse 82L payroll 0815 JE-21-0020-To reverse 82L Payroll of 8152020,D108,HJ,14.83,,1698.18
6175,8/15/2020,8/15/2020,82L-PRPD-081520,To reverse 82L payroll 0815 JE-21-0020-To reverse 82L Payroll of 8152020,D108,HJ,14.83,,1713.01
6175,8/15/2020,8/15/2020,82L-PRPD-081520,To reverse 82L payroll 0815 JE-21-0020-To reverse 82L Payroll of 8152020,D108,HJ,35.65,,1748.66
6175,8/15/2020,8/15/2020,82L-PRPD-081520,To reverse 82L payroll 0815 JE-21-0020-To reverse 82L Payroll of 8152020,D108,HJ,35.65,,1784.31
6175,8/15/2020,8/15/2020,82L-PRPD-081520,To reverse 82L payroll 0815 JE-21-0020-To reverse 82L Payroll of 8152020,D108,HJ,35.65,,1819.96
6175,8/15/2020,8/15/2020,82L-PRPD-081520,To reverse 82L payroll 0815 JE-21-0020-To reverse 82L Payroll of 8152020,D102,HJ,1.78,,1821.74
6175,8/15/2020,8/15/2020,82L-PRPD-081520,To reverse 82L payroll 0815 JE-21-0020-To reverse 82L Payroll of 8152020,D102,HJ,3.56,,1825.3
6175,8/15/2020,8/15/2020,82L-PRPD-081520,To reverse 82L payroll 0815 JE-21-0020-To reverse 82L Payroll of 8152020,D102,HJ,11.96,,1837.26
6175,8/15/2020,8/15/2020,82L-PRPD-081520,To reverse 82L payroll 0815 JE-21-0020-To reverse 82L Payroll of 8152020,D102,HJ,35.65,,1872.91
6175,8/15/2020,8/15/2020,82L-PRPD-081520,To reverse 82L payroll 0815 JE-21-0020-To reverse 82L Payroll of 8152020,D102,HJ,35.65,,1908.56
6175,8/15/2020,8/15/2020,82L-PRPD-081520,To reverse 82L payroll 0815 JE-21-0020-To reverse 82L Payroll of 8152020,D103,HJ,1.78,,1910.34
6175,8/15/2020,8/15/2020,82L-PRPD-081520,To reverse 82L payroll 0815 JE-21-0020-To reverse 82L Payroll of 8152020,D103,HJ,11.96,,1922.3
6175,8/15/2020,8/15/2020,82L-PRPD-081520,To reverse 82L payroll 0815 JE-21-0020-To reverse 82L Payroll of 8152020,D103,HJ,11.96,,1934.26
6175,8/15/2020,8/15/2020,82L-PRPD-081520,To reverse 82L payroll 0815 JE-21-0020-To reverse 82L Payroll of 8152020,D103,HJ,25.48,,1959.74
6175,8/15/2020,8/15/2020,82L-PRPD-081520,To reverse 82L payroll 0815 JE-21-0020-To reverse 82L Payroll of 8152020,D107,HJ,1.78,,1961.52
6175,8/15/2020,8/15/2020,82L-PRPD-081520,To reverse 82L payroll 0815 JE-21-0020-To reverse 82L Payroll of 8152020,D107,HJ,1.78,,1963.3
6175,8/15/2020,8/15/2020,82L-PRPD-081520,To reverse 82L payroll 0815 JE-21-0020-To reverse 82L Payroll of 8152020,D107,HJ,1.78,,1965.08
6175,8/15/2020,8/15/2020,82L-PRPD-081520,To reverse 82L payroll 0815 JE-21-0020-To reverse 82L Payroll of 8152020,D107,HJ,1.78,,1966.86
6175,8/15/2020,8/15/2020,82L-PRPD-081520,To reverse 82L payroll 0815 JE-21-0020-To reverse 82L Payroll of 8152020,D107,HJ,1.78,,1968.64
6175,8/15/2020,8/15/2020,82L-PRPD-081520,To reverse 82L payroll 0815 JE-21-0020-To reverse 82L Payroll of 8152020,D107,HJ,1.78,,1970.42
6175,8/15/2020,8/15/2020,82L-PRPD-081520,To reverse 82L payroll 0815 JE-21-0020-To reverse 82L Payroll of 8152020,D107,HJ,1.78,,1972.2
6175,8/15/2020,8/15/2020,82L-PRPD-081520,To reverse 82L payroll 0815 JE-21-0020-To reverse 82L Payroll of 8152020,D107,HJ,1.78,,1973.98
6175,8/15/2020,8/15/2020,82L-PRPD-081520,To reverse 82L payroll 0815 JE-21-0020-To reverse 82L Payroll of 8152020,D107,HJ,1.78,,1975.76
6175,8/15/2020,8/15/2020,82L-PRPD-081520,To reverse 82L payroll 0815 JE-21-0020-To reverse 82L Payroll of 8152020,D107,HJ,1.78,,1977.54
6175,8/15/2020,8/15/2020,82L-PRPD-081520,To reverse 82L payroll 0815 JE-21-0020-To reverse 82L Payroll of 8152020,D107,HJ,1.78,,1979.32
6175,8/15/2020,8/15/2020,82L-PRPD-081520,To reverse 82L payroll 0815 JE-21-0020-To reverse 82L Payroll of 8152020,D107,HJ,1.78,,1981.1
6175,8/15/2020,8/15/2020,82L-PRPD-081520,To reverse 82L payroll 0815 JE-21-0020-To reverse 82L Payroll of 8152020,D107,HJ,1.78,,1982.88
6175,8/15/2020,8/15/2020,82L-PRPD-081520,To reverse 82L payroll 0815 JE-21-0020-To reverse 82L Payroll of 8152020,D107,HJ,1.78,,1984.66
6175,8/15/2020,8/15/2020,82L-PRPD-081520,To reverse 82L payroll 0815 JE-21-0020-To reverse 82L Payroll of 8152020,D107,HJ,1.78,,1986.44
6175,8/15/2020,8/15/2020,82L-PRPD-081520,To reverse 82L payroll 0815 JE-21-0020-To reverse 82L Payroll of 8152020,D107,HJ,1.78,,1988.22
6175,8/15/2020,8/15/2020,82L-PRPD-081520,To reverse 82L payroll 0815 JE-21-0020-To reverse 82L Payroll of 8152020,D107,HJ,3.38,,1991.6
6175,8/15/2020,8/15/2020,82L-PRPD-081520,To reverse 82L payroll 0815 JE-21-0020-To reverse 82L Payroll of 8152020,D107,HJ,3.38,,1994.98
6175,8/15/2020,8/15/2020,82L-PRPD-081520,To reverse 82L payroll 0815 JE-21-0020-To reverse 82L Payroll of 8152020,D107,HJ,5.23,,2000.21
6175,8/15/2020,8/15/2020,82L-PRPD-081520,To reverse 82L payroll 0815 JE-21-0020-To reverse 82L Payroll of 8152020,D107,HJ,11.96,,2012.17
6175,8/15/2020,8/15/2020,82L-PRPD-081520,To reverse 82L payroll 0815 JE-21-0020-To reverse 82L Payroll of 8152020,D107,HJ,11.96,,2024.13
6175,8/15/2020,8/15/2020,82L-PRPD-081520,To reverse 82L payroll 0815 JE-21-0020-To reverse 82L Payroll of 8152020,D107,HJ,11.96,,2036.09
6175,8/15/2020,8/15/2020,82L-PRPD-081520,To reverse 82L payroll 0815 JE-21-0020-To reverse 82L Payroll of 8152020,D107,HJ,11.96,,2048.05
6175,8/15/2020,8/15/2020,82L-PRPD-081520,To reverse 82L payroll 0815 JE-21-0020-To reverse 82L Payroll of 8152020,D107,HJ,11.96,,2060.01
6175,8/15/2020,8/15/2020,82L-PRPD-081520,To reverse 82L payroll 0815 JE-21-0020-To reverse 82L Payroll of 8152020,D107,HJ,11.96,,2071.97
6175,8/15/2020,8/15/2020,82L-PRPD-081520,To reverse 82L payroll 0815 JE-21-0020-To reverse 82L Payroll of 8152020,D107,HJ,11.96,,2083.93
6175,8/15/2020,8/15/2020,82L-PRPD-081520,To reverse 82L payroll 0815 JE-21-0020-To reverse 82L Payroll of 8152020,D107,HJ,11.96,,2095.89
6175,8/15/2020,8/15/2020,82L-PRPD-081520,To reverse 82L payroll 0815 JE-21-0020-To reverse 82L Payroll of 8152020,D107,HJ,11.96,,2107.85
6175,8/15/2020,8/15/2020,82L-PRPD-081520,To reverse 82L payroll 0815 JE-21-0020-To reverse 82L Payroll of 8152020,D107,HJ,11.96,,2119.81
6175,8/15/2020,8/15/2020,82L-PRPD-081520,To reverse 82L payroll 0815 JE-21-0020-To reverse 82L Payroll of 8152020,D107,HJ,11.96,,2131.77
6175,8/15/2020,8/15/2020,82L-PRPD-081520,To reverse 82L payroll 0815 JE-21-0020-To reverse 82L Payroll of 8152020,D107,HJ,14.83,,2146.6
6175,8/15/2020,8/15/2020,82L-PRPD-081520,To reverse 82L payroll 0815 JE-21-0020-To reverse 82L Payroll of 8152020,D107,HJ,14.83,,2161.43
6175,8/15/2020,8/15/2020,82L-PRPD-081520,To reverse 82L payroll 0815 JE-21-0020-To reverse 82L Payroll of 8152020,D107,HJ,14.83,,2176.26
6175,8/15/2020,8/15/2020,82L-PRPD-081520,To reverse 82L payroll 0815 JE-21-0020-To reverse 82L Payroll of 8152020,D107,HJ,14.83,,2191.09
6175,8/15/2020,8/15/2020,82L-PRPD-081520,To reverse 82L payroll 0815 JE-21-0020-To reverse 82L Payroll of 8152020,D107,HJ,14.83,,2205.92
6175,8/15/2020,8/15/2020,82L-PRPD-081520,To reverse 82L payroll 0815 JE-21-0020-To reverse 82L Payroll of 8152020,D107,HJ,14.83,,2220.75
6175,8/15/2020,8/15/2020,82L-PRPD-081520,To reverse 82L payroll 0815 JE-21-0020-To reverse 82L Payroll of 8152020,D107,HJ,14.83,,2235.58
6175,8/15/2020,8/15/2020,82L-PRPD-081520,To reverse 82L payroll 0815 JE-21-0020-To reverse 82L Payroll of 8152020,D107,HJ,25.48,,2261.06
6175,8/15/2020,8/15/2020,82L-PRPD-081520,To reverse 82L payroll 0815 JE-21-0020-To reverse 82L Payroll of 8152020,D107,HJ,25.48,,2286.54
6175,8/15/2020,8/15/2020,82L-PRPD-081520,To reverse 82L payroll 0815 JE-21-0020-To reverse 82L Payroll of 8152020,D107,HJ,35.65,,2322.19
6175,8/15/2020,8/15/2020,82L-PRPD-081520,To reverse 82L payroll 0815 JE-21-0020-To reverse 82L Payroll of 8152020,D108,HJ,1.78,,2323.97
6175,8/15/2020,8/15/2020,82L-PRPD-081520,To reverse 82L payroll 0815 JE-21-0020-To reverse 82L Payroll of 8152020,D108,HJ,3.56,,2327.53
6175,8/15/2020,8/15/2020,82L-PRPD-081520,To reverse 82L payroll 0815 JE-21-0020-To reverse 82L Payroll of 8152020,D108,HJ,14.83,,2342.36
6175,8/15/2020,8/15/2020,82L-PRPD-081520,To reverse 82L payroll 0815 JE-21-0020-To reverse 82L Payroll of 8152020,D108,HJ,31.6,,2373.96
6175,8/15/2020,8/15/2020,82L-PRPD-081520,To reverse 82L payroll 0815 JE-21-0020-To reverse 82L Payroll of 8152020,D108,HJ,1.78,,2375.74
6175,8/15/2020,8/15/2020,82L-PRPD-081520,To reverse 82L payroll 0815 JE-21-0020-To reverse 82L Payroll of 8152020,D108,HJ,1.78,,2377.52
6175,8/15/2020,8/15/2020,82L-PRPD-081520,To reverse 82L payroll 0815 JE-21-0020-To reverse 82L Payroll of 8152020,D108,HJ,1.78,,2379.3
6175,8/15/2020,8/15/2020,82L-PRPD-081520,To reverse 82L payroll 0815 JE-21-0020-To reverse 82L Payroll of 8152020,D108,HJ,1.78,,2381.08
6175,8/15/2020,8/15/2020,82L-PRPD-081520,To reverse 82L payroll 0815 JE-21-0020-To reverse 82L Payroll of 8152020,D108,HJ,1.78,,2382.86
6175,8/15/2020,8/15/2020,82L-PRPD-081520,To reverse 82L payroll 0815 JE-21-0020-To reverse 82L Payroll of 8152020,D108,HJ,1.78,,2384.64
6175,8/15/2020,8/15/2020,82L-PRPD-081520,To reverse 82L payroll 0815 JE-21-0020-To reverse 82L Payroll of 8152020,D108,HJ,1.78,,2386.42
6175,8/15/2020,8/15/2020,82L-PRPD-081520,To reverse 82L payroll 0815 JE-21-0020-To reverse 82L Payroll of 8152020,D108,HJ,1.78,,2388.2
6175,8/15/2020,8/15/2020,82L-PRPD-081520,To reverse 82L payroll 0815 JE-21-0020-To reverse 82L Payroll of 8152020,D108,HJ,11.96,,2400.16
6175,8/15/2020,8/15/2020,82L-PRPD-081520,To reverse 82L payroll 0815 JE-21-0020-To reverse 82L Payroll of 8152020,D108,HJ,11.96,,2412.12
6175,8/15/2020,8/15/2020,82L-PRPD-081520,To reverse 82L payroll 0815 JE-21-0020-To reverse 82L Payroll of 8152020,D108,HJ,11.96,,2424.08
6175,8/15/2020,8/15/2020,82L-PRPD-081520,To reverse 82L payroll 0815 JE-21-0020-To reverse 82L Payroll of 8152020,D108,HJ,11.96,,2436.04
6175,8/15/2020,8/15/2020,82L-PRPD-081520,To reverse 82L payroll 0815 JE-21-0020-To reverse 82L Payroll of 8152020,D108,HJ,11.96,,2448
6175,8/15/2020,8/15/2020,82L-PRPD-081520,To reverse 82L payroll 0815 JE-21-0020-To reverse 82L Payroll of 8152020,D108,HJ,11.96,,2459.96
6175,8/15/2020,8/15/2020,82L-PRPD-081520,To reverse 82L payroll 0815 JE-21-0020-To reverse 82L Payroll of 8152020,D108,HJ,14.83,,2474.79
6175,8/15/2020,8/15/2020,82L-PRPD-081520,To reverse 82L payroll 0815 JE-21-0020-To reverse 82L Payroll of 8152020,D108,HJ,14.83,,2489.62
6175,8/15/2020,8/15/2020,82L-PRPD-081520,To reverse 82L payroll 0815 JE-21-0020-To reverse 82L Payroll of 8152020,D108,HJ,14.83,,2504.45
6175,8/15/2020,8/15/2020,82L-PRPD-081520,To reverse 82L payroll 0815 JE-21-0020-To reverse 82L Payroll of 8152020,D108,HJ,1.78,,2506.23
6175,8/15/2020,8/15/2020,82L-PRPD-081520,To reverse 82L payroll 0815 JE-21-0020-To reverse 82L Payroll of 8152020,D108,HJ,1.78,,2508.01
6175,8/15/2020,8/15/2020,82L-PRPD-081520,To reverse 82L payroll 0815 JE-21-0020-To reverse 82L Payroll of 8152020,D108,HJ,1.78,,2509.79
6175,8/15/2020,8/15/2020,82L-PRPD-081520,To reverse 82L payroll 0815 JE-21-0020-To reverse 82L Payroll of 8152020,D108,HJ,1.78,,2511.57
6175,8/15/2020,8/15/2020,82L-PRPD-081520,To reverse 82L payroll 0815 JE-21-0020-To reverse 82L Payroll of 8152020,D108,HJ,11.96,,2523.53
6175,8/15/2020,8/15/2020,82L-PRPD-081520,To reverse 82L payroll 0815 JE-21-0020-To reverse 82L Payroll of 8152020,D108,HJ,11.96,,2535.49
6175,8/15/2020,8/15/2020,82L-PRPD-081520,To reverse 82L payroll 0815 JE-21-0020-To reverse 82L Payroll of 8152020,D108,HJ,14.83,,2550.32
6175,8/15/2020,8/15/2020,82L-PRPD-081520,To reverse 82L payroll 0815 JE-21-0020-To reverse 82L Payroll of 8152020,D108,HJ,14.83,,2565.15
6175,8/17/2020,8/17/2020,1.94E+12,Blue 20/20 Vision Insurance -August Invoice-Blue 20/20 Vision Insurance -August Invoice (Dup?),D108,HJ,20.55,,2585.7
6175,8/17/2020,8/17/2020,1.94E+12,Blue 20/20 Vision Insurance -August Invoice-Blue 20/20 Vision Insurance -August Invoice (Dup?),D108,HJ,73.59,,2659.29
6175,8/17/2020,8/17/2020,1.94E+12,Blue 20/20 Vision Insurance -August Invoice-Blue 20/20 Vision Insurance -August Invoice (Dup?),D108,HJ,20.55,,2679.84
6175,8/17/2020,8/17/2020,1.94E+12,Blue 20/20 Vision Insurance -August Invoice-Blue 20/20 Vision Insurance -August Invoice (Dup?),D108,HJ,13.29,,2693.13
6175,8/31/2020,8/31/2020,83120,82L-IMPORT PAYROLL-ALVAREZ-MORINE LISIS,D108,HJ,,1.78,2691.35
6175,8/31/2020,8/31/2020,83120,82L-IMPORT PAYROLL-ALVAREZ-MORINE LISIS,D108,HJ,,14.83,2676.52
6175,8/31/2020,8/31/2020,83120,82L-IMPORT PAYROLL-BARTHELEMY RACHALIE,D108,HJ,,1.78,2674.74
6175,8/31/2020,8/31/2020,83120,82L-IMPORT PAYROLL-BARTHELEMY RACHALIE,D108,HJ,,14.83,2659.91
6175,8/31/2020,8/31/2020,83120,82L-IMPORT PAYROLL-BASHAM WILLIAM EDWARD,D108,HJ,,1.78,2658.13
6175,8/31/2020,8/31/2020,83120,82L-IMPORT PAYROLL-BREEDLOVE JOHNDEE L,D108,HJ,,14.83,2643.3
6175,8/31/2020,8/31/2020,83120,82L-IMPORT PAYROLL-BROWN ISAAC,D108,HJ,,1.78,2641.52
6175,8/31/2020,8/31/2020,83120,82L-IMPORT PAYROLL-BROWN ISAAC,D108,HJ,,14.83,2626.69
6175,8/31/2020,8/31/2020,83120,82L-IMPORT PAYROLL-KOPSHEVER MELISSA,D108,HJ,,3.38,2623.31
6175,8/31/2020,8/31/2020,83120,82L-IMPORT PAYROLL-KOPSHEVER MELISSA,D108,HJ,,31.6,2591.71
6175,8/31/2020,8/31/2020,83120,82L-IMPORT PAYROLL-LI SEN YUAN,D108,HJ,,1.78,2589.93
6175,8/31/2020,8/31/2020,83120,82L-IMPORT PAYROLL-LI SEN YUAN,D108,HJ,,11.96,2577.97
6175,8/31/2020,8/31/2020,83120,82L-IMPORT PAYROLL-LIPSCOMB STEPHEN,D108,HJ,,1.78,2576.19
6175,8/31/2020,8/31/2020,83120,82L-IMPORT PAYROLL-LIPSCOMB STEPHEN,D108,HJ,,11.96,2564.23
6175,8/31/2020,8/31/2020,83120,82L-IMPORT PAYROLL-MEJIA CARLOS MANUEL,D108,HJ,,1.78,2562.45
6175,8/31/2020,8/31/2020,83120,82L-IMPORT PAYROLL-MEJIA CARLOS MANUEL,D108,HJ,,14.83,2547.62
6175,8/31/2020,8/31/2020,83120,82L-IMPORT PAYROLL-SCOTT KIRK DONOVAN,D108,HJ,,1.78,2545.84
6175,8/31/2020,8/31/2020,83120,82L-IMPORT PAYROLL-SCOTT KIRK DONOVAN,D108,HJ,,11.96,2533.88
6175,8/31/2020,8/31/2020,83120,82L-IMPORT PAYROLL-SILVER KELLY,D108,HJ,,1.78,2532.1
6175,8/31/2020,8/31/2020,83120,82L-IMPORT PAYROLL-SILVER KELLY,D108,HJ,,14.83,2517.27
6175,8/31/2020,8/31/2020,83120,82L-IMPORT PAYROLL-STROUD DAVID,D108,HJ,,1.78,2515.49
6175,8/31/2020,8/31/2020,83120,82L-IMPORT PAYROLL-STROUD DAVID,D108,HJ,,14.83,2500.66
6175,8/31/2020,8/31/2020,83120,82L-IMPORT PAYROLL-WILLIAMS MACK ANTHONY,D108,HJ,,11.96,2488.7
6175,8/31/2020,8/31/2020,83120,82L-IMPORT PAYROLL-AUSTIN PERCY,D108,HJ,,1.78,2486.92
6175,8/31/2020,8/31/2020,83120,82L-IMPORT PAYROLL-AUSTIN PERCY,D108,HJ,,14.83,2472.09
6175,8/31/2020,8/31/2020,83120,82L-IMPORT PAYROLL-BAUSH DANIEL,D108,HJ,,1.78,2470.31
6175,8/31/2020,8/31/2020,83120,82L-IMPORT PAYROLL-BAUSH DANIEL,D108,HJ,,11.96,2458.35
6175,8/31/2020,8/31/2020,83120,82L-IMPORT PAYROLL-CHAPMAN CLAUDY EARL,D108,HJ,,1.78,2456.57
6175,8/31/2020,8/31/2020,83120,82L-IMPORT PAYROLL-CHAPMAN CLAUDY EARL,D108,HJ,,11.96,2444.61
6175,8/31/2020,8/31/2020,83120,82L-IMPORT PAYROLL-DADA ARIKPO E,D108,HJ,,5.23,2439.38
6175,8/31/2020,8/31/2020,83120,82L-IMPORT PAYROLL-DADA ARIKPO E,D108,HJ,,35.65,2403.73
6175,8/31/2020,8/31/2020,83120,82L-IMPORT PAYROLL-GUTHRIE LESLIE,D108,HJ,,1.78,2401.95
6175,8/31/2020,8/31/2020,83120,82L-IMPORT PAYROLL-GUTHRIE LESLIE,D108,HJ,,14.83,2387.12
6175,8/31/2020,8/31/2020,83120,82L-IMPORT PAYROLL-HOLMES JOREL ALEXANDER,D108,HJ,,1.78,2385.34
6175,8/31/2020,8/31/2020,83120,82L-IMPORT PAYROLL-HOLMES JOREL ALEXANDER,D108,HJ,,11.96,2373.38
6175,8/31/2020,8/31/2020,83120,82L-IMPORT PAYROLL-JORDAN TIFFANY T,D108,HJ,,5.23,2368.15
6175,8/31/2020,8/31/2020,83120,82L-IMPORT PAYROLL-JORDAN TIFFANY T,D108,HJ,,35.65,2332.5
6175,8/31/2020,8/31/2020,83120,82L-IMPORT PAYROLL-LANIGAN LISA A,D108,HJ,,3.56,2328.94
6175,8/31/2020,8/31/2020,83120,82L-IMPORT PAYROLL-ONICA ANTHONY J,D108,HJ,,1.78,2327.16
6175,8/31/2020,8/31/2020,83120,82L-IMPORT PAYROLL-ONICA ANTHONY J,D108,HJ,,11.96,2315.2
6175,8/31/2020,8/31/2020,83120,82L-IMPORT PAYROLL-PRAHIN NICOLE M,D108,HJ,,1.78,2313.42
6175,8/31/2020,8/31/2020,83120,82L-IMPORT PAYROLL-PRAHIN NICOLE M,D108,HJ,,11.96,2301.46
6175,8/31/2020,8/31/2020,83120,82L-IMPORT PAYROLL-SALIM YASSER,D108,HJ,,11.96,2289.5
6175,8/31/2020,8/31/2020,83120,82L-IMPORT PAYROLL-SEJOUR MAHALIAH,D108,HJ,,1.78,2287.72
6175,8/31/2020,8/31/2020,83120,82L-IMPORT PAYROLL-SEJOUR MAHALIAH,D108,HJ,,11.96,2275.76
6175,8/31/2020,8/31/2020,83120,82L-IMPORT PAYROLL-TUMENJARGAL ENKHJIN,D108,HJ,,1.78,2273.98
6175,8/31/2020,8/31/2020,83120,82L-IMPORT PAYROLL-TUMENJARGAL ENKHJIN,D108,HJ,,11.96,2262.02
6175,8/31/2020,8/31/2020,83120,82L-IMPORT PAYROLL-VILLEGAS EVELYN,D108,HJ,,5.23,2256.79
6175,8/31/2020,8/31/2020,83120,82L-IMPORT PAYROLL-VILLEGAS EVELYN,D108,HJ,,35.65,2221.14
6175,8/31/2020,8/31/2020,83120,82L-IMPORT PAYROLL-WOLF ANNA A,D108,HJ,,1.78,2219.36
6175,8/31/2020,8/31/2020,83120,82L-IMPORT PAYROLL-ACEVEDO MONIVETT,D107,HJ,,25.48,2193.88
6175,8/31/2020,8/31/2020,83120,82L-IMPORT PAYROLL-AKLESTAD ISABEL,D111,HJ,,1.78,2192.1
6175,8/31/2020,8/31/2020,83120,82L-IMPORT PAYROLL-AKLESTAD ISABEL,D111,HJ,,11.96,2180.14
6175,8/31/2020,8/31/2020,83120,82L-IMPORT PAYROLL-COOK CATHRYN ANNA,D105,HJ,,1.78,2178.36
6175,8/31/2020,8/31/2020,83120,82L-IMPORT PAYROLL-COOK CATHRYN ANNA,D105,HJ,,14.83,2163.53
6175,8/31/2020,8/31/2020,83120,82L-IMPORT PAYROLL-COOPER ASHLEE R,D101,HJ,,1.78,2161.75
6175,8/31/2020,8/31/2020,83120,82L-IMPORT PAYROLL-COOPER ASHLEE R,D101,HJ,,11.96,2149.79
6175,8/31/2020,8/31/2020,83120,82L-IMPORT PAYROLL-DETONE KYRA MAYA,D102,HJ,,1.78,2148.01
6175,8/31/2020,8/31/2020,83120,82L-IMPORT PAYROLL-DETONE KYRA MAYA,D102,HJ,,11.96,2136.05
6175,8/31/2020,8/31/2020,83120,82L-IMPORT PAYROLL-DUPUIS CHRISTOPHER M,D107,HJ,,1.78,2134.27
6175,8/31/2020,8/31/2020,83120,82L-IMPORT PAYROLL-DUPUIS CHRISTOPHER M,D107,HJ,,11.96,2122.31
6175,8/31/2020,8/31/2020,83120,82L-IMPORT PAYROLL-DZIEDZIC JULIE K,D101,HJ,,3.38,2118.93
6175,8/31/2020,8/31/2020,83120,82L-IMPORT PAYROLL-DZIEDZIC JULIE K,D101,HJ,,25.48,2093.45
6175,8/31/2020,8/31/2020,83120,82L-IMPORT PAYROLL-GRAVES KAMIESHIA,D101,HJ,,3.38,2090.07
6175,8/31/2020,8/31/2020,83120,82L-IMPORT PAYROLL-GRAVES KAMIESHIA,D101,HJ,,25.48,2064.59
6175,8/31/2020,8/31/2020,83120,82L-IMPORT PAYROLL-GUADARRAMA-ALVAREZ URIEL A,D105,HJ,,1.78,2062.81
6175,8/31/2020,8/31/2020,83120,82L-IMPORT PAYROLL-GUADARRAMA-ALVAREZ URIEL A,D105,HJ,,11.96,2050.85
6175,8/31/2020,8/31/2020,83120,82L-IMPORT PAYROLL-GUTIERREZ ANTONIO J,D107,HJ,,35.65,2015.2
6175,8/31/2020,8/31/2020,83120,82L-IMPORT PAYROLL-LACEY DEQUITA,D107,HJ,,1.78,2013.42
6175,8/31/2020,8/31/2020,83120,82L-IMPORT PAYROLL-LACEY DEQUITA,D107,HJ,,14.83,1998.59
6175,8/31/2020,8/31/2020,83120,82L-IMPORT PAYROLL-LIPORACE HERNAN LUIS,D103,HJ,,11.96,1986.63
6175,8/31/2020,8/31/2020,83120,82L-IMPORT PAYROLL-MASON ANGELA,D107,HJ,,5.23,1981.4
6175,8/31/2020,8/31/2020,83120,82L-IMPORT PAYROLL-MASON ANGELA,D107,HJ,,35.65,1945.75
6175,8/31/2020,8/31/2020,83120,82L-IMPORT PAYROLL-PARHAM-GANTT DENISE M,D112,HJ,,3.56,1942.19
6175,8/31/2020,8/31/2020,83120,82L-IMPORT PAYROLL-PARHAM-GANTT DENISE M,D112,HJ,,31.6,1910.59
6175,8/31/2020,8/31/2020,83120,82L-IMPORT PAYROLL-PEINADO ELIZABETH R,D111,HJ,,1.78,1908.81
6175,8/31/2020,8/31/2020,83120,82L-IMPORT PAYROLL-PEINADO ELIZABETH R,D111,HJ,,11.96,1896.85
6175,8/31/2020,8/31/2020,83120,82L-IMPORT PAYROLL-POLANCO ODALIS,D103,HJ,,1.78,1895.07
6175,8/31/2020,8/31/2020,83120,82L-IMPORT PAYROLL-POLANCO ODALIS,D103,HJ,,11.96,1883.11
6175,8/31/2020,8/31/2020,83120,82L-IMPORT PAYROLL-QUINTAS JASHIVE,D105,HJ,,1.78,1881.33
6175,8/31/2020,8/31/2020,83120,82L-IMPORT PAYROLL-QUINTAS JASHIVE,D105,HJ,,14.83,1866.5
6175,8/31/2020,8/31/2020,83120,82L-IMPORT PAYROLL-RANDOLPH ALEXANDER,D111,HJ,,1.78,1864.72
6175,8/31/2020,8/31/2020,83120,82L-IMPORT PAYROLL-RANDOLPH ALEXANDER,D111,HJ,,11.96,1852.76
6175,8/31/2020,8/31/2020,83120,82L-IMPORT PAYROLL-SAFRAN ALAN P,D107,HJ,,3.56,1849.2
6175,8/31/2020,8/31/2020,83120,82L-IMPORT PAYROLL-SAFRAN ALAN P,D107,HJ,,35.65,1813.55
6175,8/31/2020,8/31/2020,83120,82L-IMPORT PAYROLL-WALLACE AMENA,D104,HJ,,11.96,1801.59
6175,8/31/2020,8/31/2020,83120,82L-IMPORT PAYROLL-WEINSTOCK EMILY,D101,HJ,,1.78,1799.81
6175,8/31/2020,8/31/2020,83120,82L-IMPORT PAYROLL-WEINSTOCK EMILY,D101,HJ,,11.96,1787.85
6175,8/31/2020,8/31/2020,83120,82L-IMPORT PAYROLL-BARTOLD DEANNA MARIE,D108,HJ,,1.78,1786.07
6175,8/31/2020,8/31/2020,83120,82L-IMPORT PAYROLL-BARTOLD DEANNA MARIE,D108,HJ,,11.96,1774.11
6175,8/31/2020,8/31/2020,83120,82L-IMPORT PAYROLL-BELLOT GENESIS,D108,HJ,,1.78,1772.33
6175,8/31/2020,8/31/2020,83120,82L-IMPORT PAYROLL-BELLOT GENESIS,D108,HJ,,14.83,1757.5
6175,8/31/2020,8/31/2020,83120,82L-IMPORT PAYROLL-FEIGHERY JOHN,D108,HJ,,11.96,1745.54
6175,8/31/2020,8/31/2020,83120,82L-IMPORT PAYROLL-GRIFFIN ANDREW,D108,HJ,,1.78,1743.76
6175,8/31/2020,8/31/2020,83120,82L-IMPORT PAYROLL-GRIFFIN ANDREW,D108,HJ,,11.96,1731.8
6175,8/31/2020,8/31/2020,83120,82L-IMPORT PAYROLL-GROSS EMILY,D108,HJ,,1.78,1730.02
6175,8/31/2020,8/31/2020,83120,82L-IMPORT PAYROLL-GROSS EMILY,D108,HJ,,14.83,1715.19
6175,8/31/2020,8/31/2020,83120,82L-IMPORT PAYROLL-HALLINAN GABRIEL B,D108,HJ,,1.78,1713.41
6175,8/31/2020,8/31/2020,83120,82L-IMPORT PAYROLL-HALLINAN GABRIEL B,D108,HJ,,11.96,1701.45
6175,8/31/2020,8/31/2020,83120,82L-IMPORT PAYROLL-HAMERSLY WILLIAM,D108,HJ,,1.78,1699.67
6175,8/31/2020,8/31/2020,83120,82L-IMPORT PAYROLL-HAMERSLY WILLIAM,D108,HJ,,11.96,1687.71
6175,8/31/2020,8/31/2020,83120,82L-IMPORT PAYROLL-HOSSAIN MYESHA R,D108,HJ,,1.78,1685.93
6175,8/31/2020,8/31/2020,83120,82L-IMPORT PAYROLL-HOSSAIN MYESHA R,D108,HJ,,14.83,1671.1
6175,8/31/2020,8/31/2020,83120,82L-IMPORT PAYROLL-JACKSON TASNIM F,D108,HJ,,1.78,1669.32
6175,8/31/2020,8/31/2020,83120,82L-IMPORT PAYROLL-JACKSON TASNIM F,D108,HJ,,14.83,1654.49
6175,8/31/2020,8/31/2020,83120,82L-IMPORT PAYROLL-LI BELLA,D108,HJ,,1.78,1652.71
6175,8/31/2020,8/31/2020,83120,82L-IMPORT PAYROLL-LI BELLA,D108,HJ,,11.96,1640.75
6175,8/31/2020,8/31/2020,83120,82L-IMPORT PAYROLL-SOBELMAN JUSTIN,D108,HJ,,1.78,1638.97
6175,8/31/2020,8/31/2020,83120,82L-IMPORT PAYROLL-SOBELMAN JUSTIN,D108,HJ,,11.96,1627.01
6175,8/31/2020,8/31/2020,83120,82L-IMPORT PAYROLL-TERRENCE-SMITH ZI,D108,HJ,,1.78,1625.23
6175,8/31/2020,8/31/2020,83120,82L-IMPORT PAYROLL-TERRENCE-SMITH ZI,D108,HJ,,14.83,1610.4
6175,8/31/2020,8/31/2020,83120,82L-IMPORT PAYROLL-COVENEY ALLISON,D108,HJ,,1.78,1608.62
6175,8/31/2020,8/31/2020,83120,82L-IMPORT PAYROLL-COVENEY ALLISON,D108,HJ,,14.83,1593.79
6175,8/31/2020,8/31/2020,83120,82L-IMPORT PAYROLL-JACKSON CLAICE M,D108,HJ,,1.78,1592.01
6175,8/31/2020,8/31/2020,83120,82L-IMPORT PAYROLL-JACKSON CLAICE M,D108,HJ,,11.96,1580.05
6175,8/31/2020,8/31/2020,83120,82L-IMPORT PAYROLL-JANG DANIEL,D108,HJ,,1.78,1578.27
6175,8/31/2020,8/31/2020,83120,82L-IMPORT PAYROLL-JANG DANIEL,D108,HJ,,14.83,1563.44
6175,8/31/2020,8/31/2020,83120,82L-IMPORT PAYROLL-LENEGHAN MARYELLEN,D108,HJ,,1.78,1561.66
6175,8/31/2020,8/31/2020,83120,82L-IMPORT PAYROLL-LENEGHAN MARYELLEN,D108,HJ,,11.96,1549.7
6175,8/31/2020,8/31/2020,82L-PRPD-083120,82L-PRPD-083120 -IMPORT PAYROLL-AUSTIN PERCY,D108,HJ,,1.78,1547.92
6175,8/31/2020,8/31/2020,82L-PRPD-083120,82L-PRPD-083120 -IMPORT PAYROLL-AUSTIN PERCY,D108,HJ,,14.83,1533.09
6175,8/31/2020,8/31/2020,82L-PRPD-083120,82L-PRPD-083120 -IMPORT PAYROLL-BAUSH DANIEL,D108,HJ,,1.78,1531.31
6175,8/31/2020,8/31/2020,82L-PRPD-083120,82L-PRPD-083120 -IMPORT PAYROLL-BAUSH DANIEL,D108,HJ,,11.96,1519.35
6175,8/31/2020,8/31/2020,82L-PRPD-083120,82L-PRPD-083120 -IMPORT PAYROLL-CHAPMAN CLAUDY EARL,D108,HJ,,1.78,1517.57
6175,8/31/2020,8/31/2020,82L-PRPD-083120,82L-PRPD-083120 -IMPORT PAYROLL-CHAPMAN CLAUDY EARL,D108,HJ,,11.96,1505.61
6175,8/31/2020,8/31/2020,82L-PRPD-083120,82L-PRPD-083120 -IMPORT PAYROLL-DADA ARIKPO E,D108,HJ,,5.23,1500.38
6175,8/31/2020,8/31/2020,82L-PRPD-083120,82L-PRPD-083120 -IMPORT PAYROLL-DADA ARIKPO E,D108,HJ,,35.65,1464.73
6175,8/31/2020,8/31/2020,82L-PRPD-083120,82L-PRPD-083120 -IMPORT PAYROLL-GUTHRIE LESLIE,D108,HJ,,1.78,1462.95
6175,8/31/2020,8/31/2020,82L-PRPD-083120,82L-PRPD-083120 -IMPORT PAYROLL-GUTHRIE LESLIE,D108,HJ,,14.83,1448.12
6175,8/31/2020,8/31/2020,82L-PRPD-083120,82L-PRPD-083120 -IMPORT PAYROLL-HOLMES JOREL ALEXANDER,D108,HJ,,1.78,1446.34
6175,8/31/2020,8/31/2020,82L-PRPD-083120,82L-PRPD-083120 -IMPORT PAYROLL-HOLMES JOREL ALEXANDER,D108,HJ,,11.96,1434.38
6175,8/31/2020,8/31/2020,82L-PRPD-083120,82L-PRPD-083120 -IMPORT PAYROLL-JORDAN TIFFANY T,D108,HJ,,5.23,1429.15
6175,8/31/2020,8/31/2020,82L-PRPD-083120,82L-PRPD-083120 -IMPORT PAYROLL-JORDAN TIFFANY T,D108,HJ,,35.65,1393.5
6175,8/31/2020,8/31/2020,82L-PRPD-083120,82L-PRPD-083120 -IMPORT PAYROLL-LANIGAN LISA A,D108,HJ,,3.56,1389.94
6175,8/31/2020,8/31/2020,82L-PRPD-083120,82L-PRPD-083120 -IMPORT PAYROLL-ONICA ANTHONY J,D108,HJ,,1.78,1388.16
6175,8/31/2020,8/31/2020,82L-PRPD-083120,82L-PRPD-083120 -IMPORT PAYROLL-ONICA ANTHONY J,D108,HJ,,11.96,1376.2
6175,8/31/2020,8/31/2020,82L-PRPD-083120,82L-PRPD-083120 -IMPORT PAYROLL-PRAHIN NICOLE M,D108,HJ,,1.78,1374.42
6175,8/31/2020,8/31/2020,82L-PRPD-083120,82L-PRPD-083120 -IMPORT PAYROLL-PRAHIN NICOLE M,D108,HJ,,11.96,1362.46
6175,8/31/2020,8/31/2020,82L-PRPD-083120,82L-PRPD-083120 -IMPORT PAYROLL-SALIM YASSER,D108,HJ,,11.96,1350.5
6175,8/31/2020,8/31/2020,82L-PRPD-083120,82L-PRPD-083120 -IMPORT PAYROLL-SEJOUR MAHALIAH,D108,HJ,,1.78,1348.72
6175,8/31/2020,8/31/2020,82L-PRPD-083120,82L-PRPD-083120 -IMPORT PAYROLL-SEJOUR MAHALIAH,D108,HJ,,11.96,1336.76
6175,8/31/2020,8/31/2020,82L-PRPD-083120,82L-PRPD-083120 -IMPORT PAYROLL-TUMENJARGAL ENKHJIN,D108,HJ,,1.78,1334.98
6175,8/31/2020,8/31/2020,82L-PRPD-083120,82L-PRPD-083120 -IMPORT PAYROLL-TUMENJARGAL ENKHJIN,D108,HJ,,11.96,1323.02
6175,8/31/2020,8/31/2020,82L-PRPD-083120,82L-PRPD-083120 -IMPORT PAYROLL-VILLEGAS EVELYN,D108,HJ,,5.23,1317.79
6175,8/31/2020,8/31/2020,82L-PRPD-083120,82L-PRPD-083120 -IMPORT PAYROLL-VILLEGAS EVELYN,D108,HJ,,35.65,1282.14
6175,8/31/2020,8/31/2020,82L-PRPD-083120,82L-PRPD-083120 -IMPORT PAYROLL-WALLACE AMENA T,D108,HJ,,11.96,1270.18
6175,8/31/2020,8/31/2020,82L-PRPD-083120,82L-PRPD-083120 -IMPORT PAYROLL-WOLF ANNA A,D108,HJ,,1.78,1268.4
6175,8/31/2020,8/31/2020,82L-PRPD-083120,Reverse 82L payroll of 83120 JE-21-0021-IMPORT PAYROLL,D108,HJ,1.78,,1270.18
6175,8/31/2020,8/31/2020,82L-PRPD-083120,Reverse 82L payroll of 83120 JE-21-0021-IMPORT PAYROLL,D108,HJ,1.78,,1271.96
6175,8/31/2020,8/31/2020,82L-PRPD-083120,Reverse 82L payroll of 83120 JE-21-0021-IMPORT PAYROLL,D108,HJ,1.78,,1273.74
6175,8/31/2020,8/31/2020,82L-PRPD-083120,Reverse 82L payroll of 83120 JE-21-0021-IMPORT PAYROLL,D108,HJ,1.78,,1275.52
6175,8/31/2020,8/31/2020,82L-PRPD-083120,Reverse 82L payroll of 83120 JE-21-0021-IMPORT PAYROLL,D108,HJ,1.78,,1277.3
6175,8/31/2020,8/31/2020,82L-PRPD-083120,Reverse 82L payroll of 83120 JE-21-0021-IMPORT PAYROLL,D108,HJ,1.78,,1279.08
6175,8/31/2020,8/31/2020,82L-PRPD-083120,Reverse 82L payroll of 83120 JE-21-0021-IMPORT PAYROLL,D108,HJ,1.78,,1280.86
6175,8/31/2020,8/31/2020,82L-PRPD-083120,Reverse 82L payroll of 83120 JE-21-0021-IMPORT PAYROLL,D108,HJ,1.78,,1282.64
6175,8/31/2020,8/31/2020,82L-PRPD-083120,Reverse 82L payroll of 83120 JE-21-0021-IMPORT PAYROLL,D108,HJ,1.78,,1284.42
6175,8/31/2020,8/31/2020,82L-PRPD-083120,Reverse 82L payroll of 83120 JE-21-0021-IMPORT PAYROLL,D108,HJ,1.78,,1286.2
6175,8/31/2020,8/31/2020,82L-PRPD-083120,Reverse 82L payroll of 83120 JE-21-0021-IMPORT PAYROLL,D108,HJ,3.56,,1289.76
6175,8/31/2020,8/31/2020,82L-PRPD-083120,Reverse 82L payroll of 83120 JE-21-0021-IMPORT PAYROLL,D108,HJ,5.23,,1294.99
6175,8/31/2020,8/31/2020,82L-PRPD-083120,Reverse 82L payroll of 83120 JE-21-0021-IMPORT PAYROLL,D108,HJ,5.23,,1300.22
6175,8/31/2020,8/31/2020,82L-PRPD-083120,Reverse 82L payroll of 83120 JE-21-0021-IMPORT PAYROLL,D108,HJ,5.23,,1305.45
6175,8/31/2020,8/31/2020,82L-PRPD-083120,Reverse 82L payroll of 83120 JE-21-0021-IMPORT PAYROLL,D108,HJ,11.96,,1317.41
6175,8/31/2020,8/31/2020,82L-PRPD-083120,Reverse 82L payroll of 83120 JE-21-0021-IMPORT PAYROLL,D108,HJ,11.96,,1329.37
6175,8/31/2020,8/31/2020,82L-PRPD-083120,Reverse 82L payroll of 83120 JE-21-0021-IMPORT PAYROLL,D108,HJ,11.96,,1341.33
6175,8/31/2020,8/31/2020,82L-PRPD-083120,Reverse 82L payroll of 83120 JE-21-0021-IMPORT PAYROLL,D108,HJ,11.96,,1353.29
6175,8/31/2020,8/31/2020,82L-PRPD-083120,Reverse 82L payroll of 83120 JE-21-0021-IMPORT PAYROLL,D108,HJ,11.96,,1365.25
6175,8/31/2020,8/31/2020,82L-PRPD-083120,Reverse 82L payroll of 83120 JE-21-0021-IMPORT PAYROLL,D108,HJ,11.96,,1377.21
6175,8/31/2020,8/31/2020,82L-PRPD-083120,Reverse 82L payroll of 83120 JE-21-0021-IMPORT PAYROLL,D108,HJ,11.96,,1389.17
6175,8/31/2020,8/31/2020,82L-PRPD-083120,Reverse 82L payroll of 83120 JE-21-0021-IMPORT PAYROLL,D108,HJ,11.96,,1401.13
6175,8/31/2020,8/31/2020,82L-PRPD-083120,Reverse 82L payroll of 83120 JE-21-0021-IMPORT PAYROLL,D108,HJ,11.96,,1413.09
6175,8/31/2020,8/31/2020,82L-PRPD-083120,Reverse 82L payroll of 83120 JE-21-0021-IMPORT PAYROLL,D108,HJ,14.83,,1427.92
6175,8/31/2020,8/31/2020,82L-PRPD-083120,Reverse 82L payroll of 83120 JE-21-0021-IMPORT PAYROLL,D108,HJ,14.83,,1442.75
6175,8/31/2020,8/31/2020,82L-PRPD-083120,Reverse 82L payroll of 83120 JE-21-0021-IMPORT PAYROLL,D108,HJ,35.65,,1478.4
6175,8/31/2020,8/31/2020,82L-PRPD-083120,Reverse 82L payroll of 83120 JE-21-0021-IMPORT PAYROLL,D108,HJ,35.65,,1514.05
6175,8/31/2020,8/31/2020,82L-PRPD-083120,Reverse 82L payroll of 83120 JE-21-0021-IMPORT PAYROLL,D108,HJ,35.65,,1549.7
6175,8/31/2020,8/31/2020,82L-PRPD-083120,82L-PRPD-083120 -IMPORT PAYROLL-ACEVEDO MONIVETT,D103,HJ,,25.48,1524.22
6175,8/31/2020,8/31/2020,82L-PRPD-083120,82L-PRPD-083120 -IMPORT PAYROLL-AKLESTAD ISABEL,D107,HJ,,1.78,1522.44
6175,8/31/2020,8/31/2020,82L-PRPD-083120,82L-PRPD-083120 -IMPORT PAYROLL-AKLESTAD ISABEL,D107,HJ,,11.96,1510.48
6175,8/31/2020,8/31/2020,82L-PRPD-083120,82L-PRPD-083120 -IMPORT PAYROLL-ALVAREZ-MORINE LISIS,D107,HJ,,1.78,1508.7
6175,8/31/2020,8/31/2020,82L-PRPD-083120,82L-PRPD-083120 -IMPORT PAYROLL-ALVAREZ-MORINE LISIS,D107,HJ,,14.83,1493.87
6175,8/31/2020,8/31/2020,82L-PRPD-083120,82L-PRPD-083120 -IMPORT PAYROLL-BARTHELEMY RACHALIE,D107,HJ,,1.78,1492.09
6175,8/31/2020,8/31/2020,82L-PRPD-083120,82L-PRPD-083120 -IMPORT PAYROLL-BARTHELEMY RACHALIE,D107,HJ,,14.83,1477.26
6175,8/31/2020,8/31/2020,82L-PRPD-083120,82L-PRPD-083120 -IMPORT PAYROLL-BREEDLOVE JOHNDEE L,D107,HJ,,14.83,1462.43
6175,8/31/2020,8/31/2020,82L-PRPD-083120,82L-PRPD-083120 -IMPORT PAYROLL-COOK CATHRYN ANNA,D107,HJ,,1.78,1460.65
6175,8/31/2020,8/31/2020,82L-PRPD-083120,82L-PRPD-083120 -IMPORT PAYROLL-COOK CATHRYN ANNA,D107,HJ,,14.83,1445.82
6175,8/31/2020,8/31/2020,82L-PRPD-083120,82L-PRPD-083120 -IMPORT PAYROLL-COOPER ASHLEE R,D107,HJ,,1.78,1444.04
6175,8/31/2020,8/31/2020,82L-PRPD-083120,82L-PRPD-083120 -IMPORT PAYROLL-COOPER ASHLEE R,D107,HJ,,11.96,1432.08
6175,8/31/2020,8/31/2020,82L-PRPD-083120,82L-PRPD-083120 -IMPORT PAYROLL-DETONE KYRA MAYA,D102,HJ,,1.78,1430.3
6175,8/31/2020,8/31/2020,82L-PRPD-083120,82L-PRPD-083120 -IMPORT PAYROLL-DETONE KYRA MAYA,D102,HJ,,11.96,1418.34
6175,8/31/2020,8/31/2020,82L-PRPD-083120,82L-PRPD-083120 -IMPORT PAYROLL-DUPUIS CHRISTOPHER M,D107,HJ,,1.78,1416.56
6175,8/31/2020,8/31/2020,82L-PRPD-083120,82L-PRPD-083120 -IMPORT PAYROLL-DUPUIS CHRISTOPHER M,D107,HJ,,11.96,1404.6
6175,8/31/2020,8/31/2020,82L-PRPD-083120,82L-PRPD-083120 -IMPORT PAYROLL-DZIEDZIC JULIE K,D107,HJ,,3.38,1401.22
6175,8/31/2020,8/31/2020,82L-PRPD-083120,82L-PRPD-083120 -IMPORT PAYROLL-DZIEDZIC JULIE K,D107,HJ,,25.48,1375.74
6175,8/31/2020,8/31/2020,82L-PRPD-083120,82L-PRPD-083120 -IMPORT PAYROLL-GRAVES KAMIESHIA,D107,HJ,,3.38,1372.36
6175,8/31/2020,8/31/2020,82L-PRPD-083120,82L-PRPD-083120 -IMPORT PAYROLL-GRAVES KAMIESHIA,D107,HJ,,25.48,1346.88
6175,8/31/2020,8/31/2020,82L-PRPD-083120,82L-PRPD-083120 -IMPORT PAYROLL-GUADARRAMA-ALVAREZ URIEL A,D107,HJ,,1.78,1345.1
6175,8/31/2020,8/31/2020,82L-PRPD-083120,82L-PRPD-083120 -IMPORT PAYROLL-GUADARRAMA-ALVAREZ URIEL A,D107,HJ,,11.96,1333.14
6175,8/31/2020,8/31/2020,82L-PRPD-083120,82L-PRPD-083120 -IMPORT PAYROLL-GUTIERREZ ANTONIO J,D102,HJ,,35.65,1297.49
6175,8/31/2020,8/31/2020,82L-PRPD-083120,82L-PRPD-083120 -IMPORT PAYROLL-LACEY DEQUITA,D108,HJ,,1.78,1295.71
6175,8/31/2020,8/31/2020,82L-PRPD-083120,82L-PRPD-083120 -IMPORT PAYROLL-LACEY DEQUITA,D108,HJ,,14.83,1280.88
6175,8/31/2020,8/31/2020,82L-PRPD-083120,82L-PRPD-083120 -IMPORT PAYROLL-LI SEN YUAN,D107,HJ,,1.78,1279.1
6175,8/31/2020,8/31/2020,82L-PRPD-083120,82L-PRPD-083120 -IMPORT PAYROLL-LI SEN YUAN,D107,HJ,,11.96,1267.14
6175,8/31/2020,8/31/2020,82L-PRPD-083120,82L-PRPD-083120 -IMPORT PAYROLL-LIPORACE HERNAN LUIS,D103,HJ,,11.96,1255.18
6175,8/31/2020,8/31/2020,82L-PRPD-083120,82L-PRPD-083120 -IMPORT PAYROLL-LIPSCOMB STEPHEN,D107,HJ,,1.78,1253.4
6175,8/31/2020,8/31/2020,82L-PRPD-083120,82L-PRPD-083120 -IMPORT PAYROLL-LIPSCOMB STEPHEN,D107,HJ,,11.96,1241.44
6175,8/31/2020,8/31/2020,82L-PRPD-083120,82L-PRPD-083120 -IMPORT PAYROLL-MASON ANGELA,D107,HJ,,5.23,1236.21
6175,8/31/2020,8/31/2020,82L-PRPD-083120,82L-PRPD-083120 -IMPORT PAYROLL-MASON ANGELA,D107,HJ,,35.65,1200.56
6175,8/31/2020,8/31/2020,82L-PRPD-083120,82L-PRPD-083120 -IMPORT PAYROLL-MEJIA CARLOS MANUEL,D107,HJ,,1.78,1198.78
6175,8/31/2020,8/31/2020,82L-PRPD-083120,82L-PRPD-083120 -IMPORT PAYROLL-MEJIA CARLOS MANUEL,D107,HJ,,14.83,1183.95
6175,8/31/2020,8/31/2020,82L-PRPD-083120,82L-PRPD-083120 -IMPORT PAYROLL-PARHAM-GANTT DENISE M,D108,HJ,,3.56,1180.39
6175,8/31/2020,8/31/2020,82L-PRPD-083120,82L-PRPD-083120 -IMPORT PAYROLL-PARHAM-GANTT DENISE M,D108,HJ,,31.6,1148.79
6175,8/31/2020,8/31/2020,82L-PRPD-083120,82L-PRPD-083120 -IMPORT PAYROLL-PEINADO ELIZABETH R,D107,HJ,,1.78,1147.01
6175,8/31/2020,8/31/2020,82L-PRPD-083120,82L-PRPD-083120 -IMPORT PAYROLL-PEINADO ELIZABETH R,D107,HJ,,11.96,1135.05
6175,8/31/2020,8/31/2020,82L-PRPD-083120,82L-PRPD-083120 -IMPORT PAYROLL-POLANCO ODALIS,D103,HJ,,1.78,1133.27
6175,8/31/2020,8/31/2020,82L-PRPD-083120,82L-PRPD-083120 -IMPORT PAYROLL-POLANCO ODALIS,D103,HJ,,11.96,1121.31
6175,8/31/2020,8/31/2020,82L-PRPD-083120,82L-PRPD-083120 -IMPORT PAYROLL-RANDOLPH ALEXANDER,D107,HJ,,1.78,1119.53
6175,8/31/2020,8/31/2020,82L-PRPD-083120,82L-PRPD-083120 -IMPORT PAYROLL-RANDOLPH ALEXANDER,D107,HJ,,11.96,1107.57
6175,8/31/2020,8/31/2020,82L-PRPD-083120,82L-PRPD-083120 -IMPORT PAYROLL-SAFRAN ALAN P,D102,HJ,,3.56,1104.01
6175,8/31/2020,8/31/2020,82L-PRPD-083120,82L-PRPD-083120 -IMPORT PAYROLL-SAFRAN ALAN P,D102,HJ,,35.65,1068.36
6175,8/31/2020,8/31/2020,82L-PRPD-083120,82L-PRPD-083120 -IMPORT PAYROLL-SCOTT KIRK DONOVAN,D107,HJ,,1.78,1066.58
6175,8/31/2020,8/31/2020,82L-PRPD-083120,82L-PRPD-083120 -IMPORT PAYROLL-SCOTT KIRK DONOVAN,D107,HJ,,11.96,1054.62
6175,8/31/2020,8/31/2020,82L-PRPD-083120,82L-PRPD-083120 -IMPORT PAYROLL-SILVER KELLY,D107,HJ,,1.78,1052.84
6175,8/31/2020,8/31/2020,82L-PRPD-083120,82L-PRPD-083120 -IMPORT PAYROLL-SILVER KELLY,D107,HJ,,14.83,1038.01
6175,8/31/2020,8/31/2020,82L-PRPD-083120,82L-PRPD-083120 -IMPORT PAYROLL-STROUD DAVID,D107,HJ,,1.78,1036.23
6175,8/31/2020,8/31/2020,82L-PRPD-083120,82L-PRPD-083120 -IMPORT PAYROLL-STROUD DAVID,D107,HJ,,14.83,1021.4
6175,8/31/2020,8/31/2020,82L-PRPD-083120,82L-PRPD-083120 -IMPORT PAYROLL-WEINSTOCK EMILY,D107,HJ,,1.78,1019.62
6175,8/31/2020,8/31/2020,82L-PRPD-083120,82L-PRPD-083120 -IMPORT PAYROLL-WEINSTOCK EMILY,D107,HJ,,11.96,1007.66
6175,8/31/2020,8/31/2020,82L-PRPD-083120,82L-PRPD-083120 -IMPORT PAYROLL-WILLIAMS MACK ANTHONY,D107,HJ,,11.96,995.7
6175,8/31/2020,8/31/2020,82L-PRPD-083120,Reverse 82L payroll of 83120 JE-21-0021-IMPORT PAYROLL,D102,HJ,1.78,,997.48
6175,8/31/2020,8/31/2020,82L-PRPD-083120,Reverse 82L payroll of 83120 JE-21-0021-IMPORT PAYROLL,D102,HJ,3.56,,1001.04
6175,8/31/2020,8/31/2020,82L-PRPD-083120,Reverse 82L payroll of 83120 JE-21-0021-IMPORT PAYROLL,D102,HJ,11.96,,1013
6175,8/31/2020,8/31/2020,82L-PRPD-083120,Reverse 82L payroll of 83120 JE-21-0021-IMPORT PAYROLL,D102,HJ,35.65,,1048.65
6175,8/31/2020,8/31/2020,82L-PRPD-083120,Reverse 82L payroll of 83120 JE-21-0021-IMPORT PAYROLL,D102,HJ,35.65,,1084.3
6175,8/31/2020,8/31/2020,82L-PRPD-083120,Reverse 82L payroll of 83120 JE-21-0021-IMPORT PAYROLL,D103,HJ,1.78,,1086.08
6175,8/31/2020,8/31/2020,82L-PRPD-083120,Reverse 82L payroll of 83120 JE-21-0021-IMPORT PAYROLL,D103,HJ,11.96,,1098.04
6175,8/31/2020,8/31/2020,82L-PRPD-083120,Reverse 82L payroll of 83120 JE-21-0021-IMPORT PAYROLL,D103,HJ,11.96,,1110
6175,8/31/2020,8/31/2020,82L-PRPD-083120,Reverse 82L payroll of 83120 JE-21-0021-IMPORT PAYROLL,D103,HJ,25.48,,1135.48
6175,8/31/2020,8/31/2020,82L-PRPD-083120,Reverse 82L payroll of 83120 JE-21-0021-IMPORT PAYROLL,D107,HJ,1.78,,1137.26
6175,8/31/2020,8/31/2020,82L-PRPD-083120,Reverse 82L payroll of 83120 JE-21-0021-IMPORT PAYROLL,D107,HJ,1.78,,1139.04
6175,8/31/2020,8/31/2020,82L-PRPD-083120,Reverse 82L payroll of 83120 JE-21-0021-IMPORT PAYROLL,D107,HJ,1.78,,1140.82
6175,8/31/2020,8/31/2020,82L-PRPD-083120,Reverse 82L payroll of 83120 JE-21-0021-IMPORT PAYROLL,D107,HJ,1.78,,1142.6
6175,8/31/2020,8/31/2020,82L-PRPD-083120,Reverse 82L payroll of 83120 JE-21-0021-IMPORT PAYROLL,D107,HJ,1.78,,1144.38
6175,8/31/2020,8/31/2020,82L-PRPD-083120,Reverse 82L payroll of 83120 JE-21-0021-IMPORT PAYROLL,D107,HJ,1.78,,1146.16
6175,8/31/2020,8/31/2020,82L-PRPD-083120,Reverse 82L payroll of 83120 JE-21-0021-IMPORT PAYROLL,D107,HJ,1.78,,1147.94
6175,8/31/2020,8/31/2020,82L-PRPD-083120,Reverse 82L payroll of 83120 JE-21-0021-IMPORT PAYROLL,D107,HJ,1.78,,1149.72
6175,8/31/2020,8/31/2020,82L-PRPD-083120,Reverse 82L payroll of 83120 JE-21-0021-IMPORT PAYROLL,D107,HJ,1.78,,1151.5
6175,8/31/2020,8/31/2020,82L-PRPD-083120,Reverse 82L payroll of 83120 JE-21-0021-IMPORT PAYROLL,D107,HJ,1.78,,1153.28
6175,8/31/2020,8/31/2020,82L-PRPD-083120,Reverse 82L payroll of 83120 JE-21-0021-IMPORT PAYROLL,D107,HJ,1.78,,1155.06
6175,8/31/2020,8/31/2020,82L-PRPD-083120,Reverse 82L payroll of 83120 JE-21-0021-IMPORT PAYROLL,D107,HJ,1.78,,1156.84
6175,8/31/2020,8/31/2020,82L-PRPD-083120,Reverse 82L payroll of 83120 JE-21-0021-IMPORT PAYROLL,D107,HJ,1.78,,1158.62
6175,8/31/2020,8/31/2020,82L-PRPD-083120,Reverse 82L payroll of 83120 JE-21-0021-IMPORT PAYROLL,D107,HJ,1.78,,1160.4
6175,8/31/2020,8/31/2020,82L-PRPD-083120,Reverse 82L payroll of 83120 JE-21-0021-IMPORT PAYROLL,D107,HJ,1.78,,1162.18
6175,8/31/2020,8/31/2020,82L-PRPD-083120,Reverse 82L payroll of 83120 JE-21-0021-IMPORT PAYROLL,D107,HJ,1.78,,1163.96
6175,8/31/2020,8/31/2020,82L-PRPD-083120,Reverse 82L payroll of 83120 JE-21-0021-IMPORT PAYROLL,D107,HJ,3.38,,1167.34
6175,8/31/2020,8/31/2020,82L-PRPD-083120,Reverse 82L payroll of 83120 JE-21-0021-IMPORT PAYROLL,D107,HJ,3.38,,1170.72
6175,8/31/2020,8/31/2020,82L-PRPD-083120,Reverse 82L payroll of 83120 JE-21-0021-IMPORT PAYROLL,D107,HJ,5.23,,1175.95
6175,8/31/2020,8/31/2020,82L-PRPD-083120,Reverse 82L payroll of 83120 JE-21-0021-IMPORT PAYROLL,D107,HJ,11.96,,1187.91
6175,8/31/2020,8/31/2020,82L-PRPD-083120,Reverse 82L payroll of 83120 JE-21-0021-IMPORT PAYROLL,D107,HJ,11.96,,1199.87
6175,8/31/2020,8/31/2020,82L-PRPD-083120,Reverse 82L payroll of 83120 JE-21-0021-IMPORT PAYROLL,D107,HJ,11.96,,1211.83
6175,8/31/2020,8/31/2020,82L-PRPD-083120,Reverse 82L payroll of 83120 JE-21-0021-IMPORT PAYROLL,D107,HJ,11.96,,1223.79
6175,8/31/2020,8/31/2020,82L-PRPD-083120,Reverse 82L payroll of 83120 JE-21-0021-IMPORT PAYROLL,D107,HJ,11.96,,1235.75
6175,8/31/2020,8/31/2020,82L-PRPD-083120,Reverse 82L payroll of 83120 JE-21-0021-IMPORT PAYROLL,D107,HJ,11.96,,1247.71
6175,8/31/2020,8/31/2020,82L-PRPD-083120,Reverse 82L payroll of 83120 JE-21-0021-IMPORT PAYROLL,D107,HJ,11.96,,1259.67
6175,8/31/2020,8/31/2020,82L-PRPD-083120,Reverse 82L payroll of 83120 JE-21-0021-IMPORT PAYROLL,D107,HJ,11.96,,1271.63
6175,8/31/2020,8/31/2020,82L-PRPD-083120,Reverse 82L payroll of 83120 JE-21-0021-IMPORT PAYROLL,D107,HJ,11.96,,1283.59
6175,8/31/2020,8/31/2020,82L-PRPD-083120,Reverse 82L payroll of 83120 JE-21-0021-IMPORT PAYROLL,D107,HJ,11.96,,1295.55
6175,8/31/2020,8/31/2020,82L-PRPD-083120,Reverse 82L payroll of 83120 JE-21-0021-IMPORT PAYROLL,D107,HJ,11.96,,1307.51
6175,8/31/2020,8/31/2020,82L-PRPD-083120,Reverse 82L payroll of 83120 JE-21-0021-IMPORT PAYROLL,D107,HJ,14.83,,1322.34
6175,8/31/2020,8/31/2020,82L-PRPD-083120,Reverse 82L payroll of 83120 JE-21-0021-IMPORT PAYROLL,D107,HJ,14.83,,1337.17
6175,8/31/2020,8/31/2020,82L-PRPD-083120,Reverse 82L payroll of 83120 JE-21-0021-IMPORT PAYROLL,D107,HJ,14.83,,1352
6175,8/31/2020,8/31/2020,82L-PRPD-083120,Reverse 82L payroll of 83120 JE-21-0021-IMPORT PAYROLL,D107,HJ,14.83,,1366.83
6175,8/31/2020,8/31/2020,82L-PRPD-083120,Reverse 82L payroll of 83120 JE-21-0021-IMPORT PAYROLL,D107,HJ,14.83,,1381.66
6175,8/31/2020,8/31/2020,82L-PRPD-083120,Reverse 82L payroll of 83120 JE-21-0021-IMPORT PAYROLL,D107,HJ,14.83,,1396.49
6175,8/31/2020,8/31/2020,82L-PRPD-083120,Reverse 82L payroll of 83120 JE-21-0021-IMPORT PAYROLL,D107,HJ,14.83,,1411.32
6175,8/31/2020,8/31/2020,82L-PRPD-083120,Reverse 82L payroll of 83120 JE-21-0021-IMPORT PAYROLL,D107,HJ,25.48,,1436.8
6175,8/31/2020,8/31/2020,82L-PRPD-083120,Reverse 82L payroll of 83120 JE-21-0021-IMPORT PAYROLL,D107,HJ,25.48,,1462.28
6175,8/31/2020,8/31/2020,82L-PRPD-083120,Reverse 82L payroll of 83120 JE-21-0021-IMPORT PAYROLL,D107,HJ,35.65,,1497.93
6175,8/31/2020,8/31/2020,82L-PRPD-083120,Reverse 82L payroll of 83120 JE-21-0021-IMPORT PAYROLL,D108,HJ,1.78,,1499.71
6175,8/31/2020,8/31/2020,82L-PRPD-083120,Reverse 82L payroll of 83120 JE-21-0021-IMPORT PAYROLL,D108,HJ,3.56,,1503.27
6175,8/31/2020,8/31/2020,82L-PRPD-083120,Reverse 82L payroll of 83120 JE-21-0021-IMPORT PAYROLL,D108,HJ,14.83,,1518.1
6175,8/31/2020,8/31/2020,82L-PRPD-083120,Reverse 82L payroll of 83120 JE-21-0021-IMPORT PAYROLL,D108,HJ,31.6,,1549.7
6175,8/31/2020,8/31/2020,82L-PRPD-083120,82L-PRPD-083120 -IMPORT PAYROLL-BARTOLD DEANNA MARIE,D108,HJ,,1.78,1547.92
6175,8/31/2020,8/31/2020,82L-PRPD-083120,82L-PRPD-083120 -IMPORT PAYROLL-BARTOLD DEANNA MARIE,D108,HJ,,11.96,1535.96
6175,8/31/2020,8/31/2020,82L-PRPD-083120,82L-PRPD-083120 -IMPORT PAYROLL-BELLOT GENESIS,D108,HJ,,1.78,1534.18
6175,8/31/2020,8/31/2020,82L-PRPD-083120,82L-PRPD-083120 -IMPORT PAYROLL-BELLOT GENESIS,D108,HJ,,14.83,1519.35
6175,8/31/2020,8/31/2020,82L-PRPD-083120,82L-PRPD-083120 -IMPORT PAYROLL-FEIGHERY JOHN,D108,HJ,,11.96,1507.39
6175,8/31/2020,8/31/2020,82L-PRPD-083120,82L-PRPD-083120 -IMPORT PAYROLL-GRIFFIN ANDREW,D108,HJ,,1.78,1505.61
6175,8/31/2020,8/31/2020,82L-PRPD-083120,82L-PRPD-083120 -IMPORT PAYROLL-GRIFFIN ANDREW,D108,HJ,,11.96,1493.65
6175,8/31/2020,8/31/2020,82L-PRPD-083120,82L-PRPD-083120 -IMPORT PAYROLL-HALLINAN GABRIEL B,D108,HJ,,1.78,1491.87
6175,8/31/2020,8/31/2020,82L-PRPD-083120,82L-PRPD-083120 -IMPORT PAYROLL-HALLINAN GABRIEL B,D108,HJ,,11.96,1479.91
6175,8/31/2020,8/31/2020,82L-PRPD-083120,82L-PRPD-083120 -IMPORT PAYROLL-HOSSAIN MYESHA R,D108,HJ,,1.78,1478.13
6175,8/31/2020,8/31/2020,82L-PRPD-083120,82L-PRPD-083120 -IMPORT PAYROLL-HOSSAIN MYESHA R,D108,HJ,,14.83,1463.3
6175,8/31/2020,8/31/2020,82L-PRPD-083120,82L-PRPD-083120 -IMPORT PAYROLL-JACKSON TASNIM F,D108,HJ,,1.78,1461.52
6175,8/31/2020,8/31/2020,82L-PRPD-083120,82L-PRPD-083120 -IMPORT PAYROLL-JACKSON TASNIM F,D108,HJ,,14.83,1446.69
6175,8/31/2020,8/31/2020,82L-PRPD-083120,82L-PRPD-083120 -IMPORT PAYROLL-LI BELLA,D108,HJ,,1.78,1444.91
6175,8/31/2020,8/31/2020,82L-PRPD-083120,82L-PRPD-083120 -IMPORT PAYROLL-LI BELLA,D108,HJ,,11.96,1432.95
6175,8/31/2020,8/31/2020,82L-PRPD-083120,82L-PRPD-083120 -IMPORT PAYROLL-MOSELEY ARIELLE,D108,HJ,,1.78,1431.17
6175,8/31/2020,8/31/2020,82L-PRPD-083120,82L-PRPD-083120 -IMPORT PAYROLL-MOSELEY ARIELLE,D108,HJ,,11.96,1419.21
6175,8/31/2020,8/31/2020,82L-PRPD-083120,Reverse 82L payroll of 83120 JE-21-0021-IMPORT PAYROLL,D108,HJ,1.78,,1420.99
6175,8/31/2020,8/31/2020,82L-PRPD-083120,Reverse 82L payroll of 83120 JE-21-0021-IMPORT PAYROLL,D108,HJ,1.78,,1422.77
6175,8/31/2020,8/31/2020,82L-PRPD-083120,Reverse 82L payroll of 83120 JE-21-0021-IMPORT PAYROLL,D108,HJ,1.78,,1424.55
6175,8/31/2020,8/31/2020,82L-PRPD-083120,Reverse 82L payroll of 83120 JE-21-0021-IMPORT PAYROLL,D108,HJ,1.78,,1426.33
6175,8/31/2020,8/31/2020,82L-PRPD-083120,Reverse 82L payroll of 83120 JE-21-0021-IMPORT PAYROLL,D108,HJ,1.78,,1428.11
6175,8/31/2020,8/31/2020,82L-PRPD-083120,Reverse 82L payroll of 83120 JE-21-0021-IMPORT PAYROLL,D108,HJ,1.78,,1429.89
6175,8/31/2020,8/31/2020,82L-PRPD-083120,Reverse 82L payroll of 83120 JE-21-0021-IMPORT PAYROLL,D108,HJ,1.78,,1431.67
6175,8/31/2020,8/31/2020,82L-PRPD-083120,Reverse 82L payroll of 83120 JE-21-0021-IMPORT PAYROLL,D108,HJ,1.78,,1433.45
6175,8/31/2020,8/31/2020,82L-PRPD-083120,Reverse 82L payroll of 83120 JE-21-0021-IMPORT PAYROLL,D108,HJ,11.96,,1445.41
6175,8/31/2020,8/31/2020,82L-PRPD-083120,Reverse 82L payroll of 83120 JE-21-0021-IMPORT PAYROLL,D108,HJ,11.96,,1457.37
6175,8/31/2020,8/31/2020,82L-PRPD-083120,Reverse 82L payroll of 83120 JE-21-0021-IMPORT PAYROLL,D108,HJ,11.96,,1469.33
6175,8/31/2020,8/31/2020,82L-PRPD-083120,Reverse 82L payroll of 83120 JE-21-0021-IMPORT PAYROLL,D108,HJ,11.96,,1481.29
6175,8/31/2020,8/31/2020,82L-PRPD-083120,Reverse 82L payroll of 83120 JE-21-0021-IMPORT PAYROLL,D108,HJ,11.96,,1493.25
6175,8/31/2020,8/31/2020,82L-PRPD-083120,Reverse 82L payroll of 83120 JE-21-0021-IMPORT PAYROLL,D108,HJ,11.96,,1505.21
6175,8/31/2020,8/31/2020,82L-PRPD-083120,Reverse 82L payroll of 83120 JE-21-0021-IMPORT PAYROLL,D108,HJ,14.83,,1520.04
6175,8/31/2020,8/31/2020,82L-PRPD-083120,Reverse 82L payroll of 83120 JE-21-0021-IMPORT PAYROLL,D108,HJ,14.83,,1534.87
6175,8/31/2020,8/31/2020,82L-PRPD-083120,Reverse 82L payroll of 83120 JE-21-0021-IMPORT PAYROLL,D108,HJ,14.83,,1549.7
6175,8/31/2020,8/31/2020,82L-PRPD-083120,82L-PRPD-083120 -IMPORT PAYROLL-COVENEY ALLISON,D108,HJ,,1.78,1547.92
6175,8/31/2020,8/31/2020,82L-PRPD-083120,82L-PRPD-083120 -IMPORT PAYROLL-COVENEY ALLISON,D108,HJ,,14.83,1533.09
6175,8/31/2020,8/31/2020,82L-PRPD-083120,82L-PRPD-083120 -IMPORT PAYROLL-JACKSON CLAICE M,D108,HJ,,1.78,1531.31
6175,8/31/2020,8/31/2020,82L-PRPD-083120,82L-PRPD-083120 -IMPORT PAYROLL-JACKSON CLAICE M,D108,HJ,,11.96,1519.35
6175,8/31/2020,8/31/2020,82L-PRPD-083120,82L-PRPD-083120 -IMPORT PAYROLL-JANG DANIEL,D108,HJ,,1.78,1517.57
6175,8/31/2020,8/31/2020,82L-PRPD-083120,82L-PRPD-083120 -IMPORT PAYROLL-JANG DANIEL,D108,HJ,,14.83,1502.74
6175,8/31/2020,8/31/2020,82L-PRPD-083120,82L-PRPD-083120 -IMPORT PAYROLL-LENEGHAN MARYELLEN B,D108,HJ,,1.78,1500.96
6175,8/31/2020,8/31/2020,82L-PRPD-083120,82L-PRPD-083120 -IMPORT PAYROLL-LENEGHAN MARYELLEN B,D108,HJ,,11.96,1489
6175,8/31/2020,8/31/2020,82L-PRPD-083120,Reverse 82L payroll of 83120 JE-21-0021-IMPORT PAYROLL,D108,HJ,1.78,,1490.78
6175,8/31/2020,8/31/2020,82L-PRPD-083120,Reverse 82L payroll of 83120 JE-21-0021-IMPORT PAYROLL,D108,HJ,1.78,,1492.56
6175,8/31/2020,8/31/2020,82L-PRPD-083120,Reverse 82L payroll of 83120 JE-21-0021-IMPORT PAYROLL,D108,HJ,1.78,,1494.34
6175,8/31/2020,8/31/2020,82L-PRPD-083120,Reverse 82L payroll of 83120 JE-21-0021-IMPORT PAYROLL,D108,HJ,1.78,,1496.12
6175,8/31/2020,8/31/2020,82L-PRPD-083120,Reverse 82L payroll of 83120 JE-21-0021-IMPORT PAYROLL,D108,HJ,11.96,,1508.08
6175,8/31/2020,8/31/2020,82L-PRPD-083120,Reverse 82L payroll of 83120 JE-21-0021-IMPORT PAYROLL,D108,HJ,11.96,,1520.04
6175,8/31/2020,8/31/2020,82L-PRPD-083120,Reverse 82L payroll of 83120 JE-21-0021-IMPORT PAYROLL,D108,HJ,14.83,,1534.87
6175,8/31/2020,8/31/2020,82L-PRPD-083120,Reverse 82L payroll of 83120 JE-21-0021-IMPORT PAYROLL,D108,HJ,14.83,,1549.7
6175,9/1/2020,9/1/2020,BCBS,BCBS - September 82L Invoices-BCBS - September 82L Invoices,D108,HJ,330.83,,1880.53
6175,9/1/2020,9/1/2020,BCBS,BCBS - September 82L Invoices-BCBS - September 82L Invoices,D108,HJ,1473.68,,3354.21
6175,9/1/2020,9/1/2020,BCBS,BCBS - September 82L Invoices-BCBS - September 82L Invoices,D107,HJ,1253.75,,4607.96
6175,9/1/2020,9/1/2020,BCBS,BCBS - September 82L Invoices-BCBS - September 82L Invoices,D108,HJ,306.35,,4914.31
6175,9/1/2020,9/1/2020,BCBS,BCBS - September 82L Invoices-BCBS - September 82L Invoices,D108,HJ,798.11,,5712.42
6175,9/2/2020,9/2/2020,JE-21-0031,Blue 20/20 Vision Insurance - September Inv-Blue 20/20 Vision Insurance -September Invoice,D108,HJ,35.55,,5747.97
6175,9/2/2020,9/2/2020,JE-21-0031,Blue 20/20 Vision Insurance - September Inv-Blue 20/20 Vision Insurance -September Invoice,D108,HJ,28.44,,5776.41
6175,9/2/2020,9/2/2020,JE-21-0031,Blue 20/20 Vision Insurance - September Inv-Blue 20/20 Vision Insurance -September Invoice,D107,HJ,28.44,,5804.85
6175,9/2/2020,9/2/2020,JE-21-0031,Blue 20/20 Vision Insurance - September Inv-Blue 20/20 Vision Insurance -September Invoice,D108,HJ,35.55,,5840.4
6175,9/2/2020,9/2/2020,JE-21-0031,Blue 20/20 Vision Insurance - September Inv-Blue 20/20 Vision Insurance -September Invoice,D108,HJ,69.68,,5910.08
6175,9/10/2020,9/10/2020,BCBS,BCBS - September LUX Invoices-BCBS - September LUX Invoices,D108,HJ,485.94,,6396.02
6175,9/15/2020,9/15/2020,91520,82L-IMPORT PAYROLL-ALVAREZ-MORINE LISIS,D108,HJ,,1.78,6394.24
6175,9/15/2020,9/15/2020,91520,82L-IMPORT PAYROLL-ALVAREZ-MORINE LISIS,D108,HJ,,14.83,6379.41
6175,9/15/2020,9/15/2020,91520,82L-IMPORT PAYROLL-BARTHELEMY RACHALIE,D108,HJ,,1.78,6377.63
6175,9/15/2020,9/15/2020,91520,82L-IMPORT PAYROLL-BARTHELEMY RACHALIE,D108,HJ,,14.83,6362.8
6175,9/15/2020,9/15/2020,91520,82L-IMPORT PAYROLL-BASHAM WILLIAM EDWARD,D108,HJ,,1.78,6361.02
6175,9/15/2020,9/15/2020,91520,82L-IMPORT PAYROLL-BOHLSEN GRACE,D108,HJ,,1.78,6359.24
6175,9/15/2020,9/15/2020,91520,82L-IMPORT PAYROLL-BROWN ISAAC,D108,HJ,,1.78,6357.46
6175,9/15/2020,9/15/2020,91520,82L-IMPORT PAYROLL-BROWN ISAAC,D108,HJ,,14.83,6342.63
6175,9/15/2020,9/15/2020,91520,82L-IMPORT PAYROLL-IKUNIKA FUNMILAYO,D108,HJ,,3.38,6339.25
6175,9/15/2020,9/15/2020,91520,82L-IMPORT PAYROLL-IKUNIKA FUNMILAYO,D108,HJ,,25.48,6313.77
6175,9/15/2020,9/15/2020,91520,82L-IMPORT PAYROLL-KOPSHEVER MELISSA,D108,HJ,,3.38,6310.39
6175,9/15/2020,9/15/2020,91520,82L-IMPORT PAYROLL-KOPSHEVER MELISSA,D108,HJ,,31.6,6278.79
6175,9/15/2020,9/15/2020,91520,82L-IMPORT PAYROLL-LI SEN,D108,HJ,,1.78,6277.01
6175,9/15/2020,9/15/2020,91520,82L-IMPORT PAYROLL-LI SEN,D108,HJ,,11.96,6265.05
6175,9/15/2020,9/15/2020,91520,82L-IMPORT PAYROLL-LIPSCOMB STEPHEN,D108,HJ,,1.78,6263.27
6175,9/15/2020,9/15/2020,91520,82L-IMPORT PAYROLL-LIPSCOMB STEPHEN,D108,HJ,,11.96,6251.31
6175,9/15/2020,9/15/2020,91520,82L-IMPORT PAYROLL-MEJIA CARLOS MANUEL,D108,HJ,,1.78,6249.53
6175,9/15/2020,9/15/2020,91520,82L-IMPORT PAYROLL-MEJIA CARLOS MANUEL,D108,HJ,,14.83,6234.7
6175,9/15/2020,9/15/2020,91520,82L-IMPORT PAYROLL-SCOTT KIRK,D108,HJ,,1.78,6232.92
6175,9/15/2020,9/15/2020,91520,82L-IMPORT PAYROLL-SCOTT KIRK,D108,HJ,,11.96,6220.96
6175,9/15/2020,9/15/2020,91520,82L-IMPORT PAYROLL-SILVER KELLY,D108,HJ,,1.78,6219.18
6175,9/15/2020,9/15/2020,91520,82L-IMPORT PAYROLL-SILVER KELLY,D108,HJ,,14.83,6204.35
6175,9/15/2020,9/15/2020,91520,82L-IMPORT PAYROLL-STEIN KYLE,D108,HJ,,1.78,6202.57
6175,9/15/2020,9/15/2020,91520,82L-IMPORT PAYROLL-STEIN KYLE,D108,HJ,,11.96,6190.61
6175,9/15/2020,9/15/2020,91520,82L-IMPORT PAYROLL-STROUD DAVID,D108,HJ,,1.78,6188.83
6175,9/15/2020,9/15/2020,91520,82L-IMPORT PAYROLL-STROUD DAVID,D108,HJ,,14.83,6174
6175,9/15/2020,9/15/2020,91520,82L-IMPORT PAYROLL-WILLIAMS MACK,D108,HJ,,11.96,6162.04
6175,9/15/2020,9/15/2020,91520,82L-IMPORT PAYROLL-AUSTIN PERCY,D108,HJ,,1.78,6160.26
6175,9/15/2020,9/15/2020,91520,82L-IMPORT PAYROLL-AUSTIN PERCY,D108,HJ,,14.83,6145.43
6175,9/15/2020,9/15/2020,91520,82L-IMPORT PAYROLL-CHAPMAN CLAUDY EARL,D108,HJ,,1.78,6143.65
6175,9/15/2020,9/15/2020,91520,82L-IMPORT PAYROLL-CHAPMAN CLAUDY EARL,D108,HJ,,11.96,6131.69
6175,9/15/2020,9/15/2020,91520,82L-IMPORT PAYROLL-DADA ARIKPO,D108,HJ,,5.23,6126.46
6175,9/15/2020,9/15/2020,91520,82L-IMPORT PAYROLL-DADA ARIKPO,D108,HJ,,35.65,6090.81
6175,9/15/2020,9/15/2020,91520,82L-IMPORT PAYROLL-GUTHRIE LESLIE,D108,HJ,,1.78,6089.03
6175,9/15/2020,9/15/2020,91520,82L-IMPORT PAYROLL-GUTHRIE LESLIE,D108,HJ,,14.83,6074.2
6175,9/15/2020,9/15/2020,91520,82L-IMPORT PAYROLL-HOLMES JOREL ALEXANDER,D108,HJ,,1.78,6072.42
6175,9/15/2020,9/15/2020,91520,82L-IMPORT PAYROLL-HOLMES JOREL ALEXANDER,D108,HJ,,11.96,6060.46
6175,9/15/2020,9/15/2020,91520,82L-IMPORT PAYROLL-JORDAN TIFFANY T,D108,HJ,,5.23,6055.23
6175,9/15/2020,9/15/2020,91520,82L-IMPORT PAYROLL-JORDAN TIFFANY T,D108,HJ,,35.65,6019.58
6175,9/15/2020,9/15/2020,91520,82L-IMPORT PAYROLL-LANIGAN LISA A,D108,HJ,,3.56,6016.02
6175,9/15/2020,9/15/2020,91520,82L-IMPORT PAYROLL-ONICA ANTHONY J,D108,HJ,,1.78,6014.24
6175,9/15/2020,9/15/2020,91520,82L-IMPORT PAYROLL-ONICA ANTHONY J,D108,HJ,,11.96,6002.28
6175,9/15/2020,9/15/2020,91520,82L-IMPORT PAYROLL-PRAHIN NICOLE M,D108,HJ,,1.78,6000.5
6175,9/15/2020,9/15/2020,91520,82L-IMPORT PAYROLL-PRAHIN NICOLE M,D108,HJ,,11.96,5988.54
6175,9/15/2020,9/15/2020,91520,82L-IMPORT PAYROLL-SALIM YASSER,D108,HJ,,11.96,5976.58
6175,9/15/2020,9/15/2020,91520,82L-IMPORT PAYROLL-SEJOUR MAHALIAH,D108,HJ,,1.78,5974.8
6175,9/15/2020,9/15/2020,91520,82L-IMPORT PAYROLL-SEJOUR MAHALIAH,D108,HJ,,11.96,5962.84
6175,9/15/2020,9/15/2020,91520,82L-IMPORT PAYROLL-TUMENJARGAL ENKHJIN,D108,HJ,,1.78,5961.06
6175,9/15/2020,9/15/2020,91520,82L-IMPORT PAYROLL-TUMENJARGAL ENKHJIN,D108,HJ,,11.96,5949.1
6175,9/15/2020,9/15/2020,91520,82L-IMPORT PAYROLL-VILLEGAS EVELYN,D108,HJ,,5.23,5943.87
6175,9/15/2020,9/15/2020,91520,82L-IMPORT PAYROLL-VILLEGAS EVELYN,D108,HJ,,35.65,5908.22
6175,9/15/2020,9/15/2020,91520,82L-IMPORT PAYROLL-WOLF ANNA A,D108,HJ,,1.78,5906.44
6175,9/15/2020,9/15/2020,91520,82L-IMPORT PAYROLL-ACEVEDO MONIVETT,D107,HJ,,25.48,5880.96
6175,9/15/2020,9/15/2020,91520,82L-IMPORT PAYROLL-AKLESTAD ISABEL,D111,HJ,,1.78,5879.18
6175,9/15/2020,9/15/2020,91520,82L-IMPORT PAYROLL-AKLESTAD ISABEL,D111,HJ,,11.96,5867.22
6175,9/15/2020,9/15/2020,91520,82L-IMPORT PAYROLL-BIBB TIFFANI,D104,HJ,,1.78,5865.44
6175,9/15/2020,9/15/2020,91520,82L-IMPORT PAYROLL-BIBB TIFFANI,D104,HJ,,44.2,5821.24
6175,9/15/2020,9/15/2020,91520,82L-IMPORT PAYROLL-COOK CATHRYN ANNA,D105,HJ,,1.78,5819.46
6175,9/15/2020,9/15/2020,91520,82L-IMPORT PAYROLL-COOK CATHRYN ANNA,D105,HJ,,14.83,5804.63
6175,9/15/2020,9/15/2020,91520,82L-IMPORT PAYROLL-COOPER ASHLEE R,D101,HJ,,1.78,5802.85
6175,9/15/2020,9/15/2020,91520,82L-IMPORT PAYROLL-COOPER ASHLEE R,D101,HJ,,11.96,5790.89
6175,9/15/2020,9/15/2020,91520,82L-IMPORT PAYROLL-DETONE KYRA MAYA,D102,HJ,,1.78,5789.11
6175,9/15/2020,9/15/2020,91520,82L-IMPORT PAYROLL-DETONE KYRA MAYA,D102,HJ,,11.96,5777.15
6175,9/15/2020,9/15/2020,91520,82L-IMPORT PAYROLL-DUPUIS CHRISTOPHER M,D107,HJ,,1.78,5775.37
6175,9/15/2020,9/15/2020,91520,82L-IMPORT PAYROLL-DUPUIS CHRISTOPHER M,D107,HJ,,11.96,5763.41
6175,9/15/2020,9/15/2020,91520,82L-IMPORT PAYROLL-DZIEDZIC JULIE K,D101,HJ,,3.38,5760.03
6175,9/15/2020,9/15/2020,91520,82L-IMPORT PAYROLL-DZIEDZIC JULIE K,D101,HJ,,25.48,5734.55
6175,9/15/2020,9/15/2020,91520,82L-IMPORT PAYROLL-GUADARRAMA-ALVAREZ URIEL A,D105,HJ,,1.78,5732.77
6175,9/15/2020,9/15/2020,91520,82L-IMPORT PAYROLL-GUADARRAMA-ALVAREZ URIEL A,D105,HJ,,11.96,5720.81
6175,9/15/2020,9/15/2020,91520,82L-IMPORT PAYROLL-GUTIERREZ ANTONIO J,D107,HJ,,35.65,5685.16
6175,9/15/2020,9/15/2020,91520,82L-IMPORT PAYROLL-LACEY DEQUITA,D104,HJ,,1.78,5683.38
6175,9/15/2020,9/15/2020,91520,82L-IMPORT PAYROLL-LACEY DEQUITA,D104,HJ,,14.83,5668.55
6175,9/15/2020,9/15/2020,91520,82L-IMPORT PAYROLL-LIPORACE HERNAN LUIS,D103,HJ,,11.96,5656.59
6175,9/15/2020,9/15/2020,91520,82L-IMPORT PAYROLL-MASON ANGELA,D107,HJ,,5.23,5651.36
6175,9/15/2020,9/15/2020,91520,82L-IMPORT PAYROLL-MASON ANGELA,D107,HJ,,35.65,5615.71
6175,9/15/2020,9/15/2020,91520,82L-IMPORT PAYROLL-PARHAM-GANTT DENISE M,D112,HJ,,3.56,5612.15
6175,9/15/2020,9/15/2020,91520,82L-IMPORT PAYROLL-PARHAM-GANTT DENISE M,D112,HJ,,31.6,5580.55
6175,9/15/2020,9/15/2020,91520,82L-IMPORT PAYROLL-PEINADO ELIZABETH R,D111,HJ,,1.78,5578.77
6175,9/15/2020,9/15/2020,91520,82L-IMPORT PAYROLL-PEINADO ELIZABETH R,D111,HJ,,11.96,5566.81
6175,9/15/2020,9/15/2020,91520,82L-IMPORT PAYROLL-POLANCO ODALIS,D103,HJ,,1.78,5565.03
6175,9/15/2020,9/15/2020,91520,82L-IMPORT PAYROLL-POLANCO ODALIS,D103,HJ,,11.96,5553.07
6175,9/15/2020,9/15/2020,91520,82L-IMPORT PAYROLL-QUINTAS JASHIVE,D105,HJ,,1.78,5551.29
6175,9/15/2020,9/15/2020,91520,82L-IMPORT PAYROLL-QUINTAS JASHIVE,D105,HJ,,14.83,5536.46
6175,9/15/2020,9/15/2020,91520,82L-IMPORT PAYROLL-RANDOLPH ALEXANDER,D111,HJ,,1.78,5534.68
6175,9/15/2020,9/15/2020,91520,82L-IMPORT PAYROLL-RANDOLPH ALEXANDER,D111,HJ,,11.96,5522.72
6175,9/15/2020,9/15/2020,91520,82L-IMPORT PAYROLL-RUBI PERLA,D101,HJ,,14.83,5507.89
6175,9/15/2020,9/15/2020,91520,82L-IMPORT PAYROLL-SAFRAN ALAN P,D107,HJ,,3.56,5504.33
6175,9/15/2020,9/15/2020,91520,82L-IMPORT PAYROLL-SAFRAN ALAN P,D107,HJ,,35.65,5468.68
6175,9/15/2020,9/15/2020,91520,82L-IMPORT PAYROLL-WALLACE AMENA,D104,HJ,,11.96,5456.72
6175,9/15/2020,9/15/2020,91520,82L-IMPORT PAYROLL-WEINSTOCK EMILY,D101,HJ,,1.78,5454.94
6175,9/15/2020,9/15/2020,91520,82L-IMPORT PAYROLL-WEINSTOCK EMILY,D101,HJ,,11.96,5442.98
6175,9/15/2020,9/15/2020,91520,82L-IMPORT PAYROLL-BARTOLD DEANNA MARIE,D108,HJ,,1.78,5441.2
6175,9/15/2020,9/15/2020,91520,82L-IMPORT PAYROLL-BARTOLD DEANNA MARIE,D108,HJ,,11.96,5429.24
6175,9/15/2020,9/15/2020,91520,82L-IMPORT PAYROLL-BELLOT GENESIS,D108,HJ,,1.78,5427.46
6175,9/15/2020,9/15/2020,91520,82L-IMPORT PAYROLL-BELLOT GENESIS,D108,HJ,,14.83,5412.63
6175,9/15/2020,9/15/2020,91520,82L-IMPORT PAYROLL-FEIGHERY JOHN,D108,HJ,,11.96,5400.67
6175,9/15/2020,9/15/2020,91520,82L-IMPORT PAYROLL-GRIFFIN ANDREW,D108,HJ,,1.78,5398.89
6175,9/15/2020,9/15/2020,91520,82L-IMPORT PAYROLL-GRIFFIN ANDREW,D108,HJ,,11.96,5386.93
6175,9/15/2020,9/15/2020,91520,82L-IMPORT PAYROLL-GROSS EMILY,D108,HJ,,1.78,5385.15
6175,9/15/2020,9/15/2020,91520,82L-IMPORT PAYROLL-GROSS EMILY,D108,HJ,,14.83,5370.32
6175,9/15/2020,9/15/2020,91520,82L-IMPORT PAYROLL-HALLINAN GABRIEL B,D108,HJ,,1.78,5368.54
6175,9/15/2020,9/15/2020,91520,82L-IMPORT PAYROLL-HALLINAN GABRIEL B,D108,HJ,,11.96,5356.58
6175,9/15/2020,9/15/2020,91520,82L-IMPORT PAYROLL-HAMERSLY WILLIAM,D108,HJ,,1.78,5354.8
6175,9/15/2020,9/15/2020,91520,82L-IMPORT PAYROLL-HAMERSLY WILLIAM,D108,HJ,,11.96,5342.84
6175,9/15/2020,9/15/2020,91520,82L-IMPORT PAYROLL-HOSSAIN MYESHA R,D108,HJ,,1.78,5341.06
6175,9/15/2020,9/15/2020,91520,82L-IMPORT PAYROLL-HOSSAIN MYESHA R,D108,HJ,,14.83,5326.23
6175,9/15/2020,9/15/2020,91520,82L-IMPORT PAYROLL-JACKSON TASNIM,D108,HJ,,1.78,5324.45
6175,9/15/2020,9/15/2020,91520,82L-IMPORT PAYROLL-JACKSON TASNIM,D108,HJ,,14.83,5309.62
6175,9/15/2020,9/15/2020,91520,82L-IMPORT PAYROLL-LEARY AUBREY,D108,HJ,,1.78,5307.84
6175,9/15/2020,9/15/2020,91520,82L-IMPORT PAYROLL-LI BELLA,D108,HJ,,1.78,5306.06
6175,9/15/2020,9/15/2020,91520,82L-IMPORT PAYROLL-LI BELLA,D108,HJ,,11.96,5294.1
6175,9/15/2020,9/15/2020,91520,82L-IMPORT PAYROLL-OPUH NDIDI,D108,HJ,,1.78,5292.32
6175,9/15/2020,9/15/2020,91520,82L-IMPORT PAYROLL-OPUH NDIDI,D108,HJ,,35.65,5256.67
6175,9/15/2020,9/15/2020,91520,82L-IMPORT PAYROLL-SOBELMAN JUSTIN,D108,HJ,,1.78,5254.89
6175,9/15/2020,9/15/2020,91520,82L-IMPORT PAYROLL-SOBELMAN JUSTIN,D108,HJ,,11.96,5242.93
6175,9/15/2020,9/15/2020,91520,82L-IMPORT PAYROLL-TERRENCE-SMITH ZIHIR UNIQUE,D108,HJ,,1.78,5241.15
6175,9/15/2020,9/15/2020,91520,82L-IMPORT PAYROLL-TERRENCE-SMITH ZIHIR UNIQUE,D108,HJ,,14.83,5226.32
6175,9/15/2020,9/15/2020,91520,82L-IMPORT PAYROLL-WILLIAMS- MASSEY BRIANNA M,D108,HJ,,11.96,5214.36
6175,9/15/2020,9/15/2020,91520,82L-IMPORT PAYROLL-COVENEY ALLISON,D108,HJ,,1.78,5212.58
6175,9/15/2020,9/15/2020,91520,82L-IMPORT PAYROLL-COVENEY ALLISON,D108,HJ,,14.83,5197.75
6175,9/15/2020,9/15/2020,91520,82L-IMPORT PAYROLL-JACKSON CLAICE,D108,HJ,,1.78,5195.97
6175,9/15/2020,9/15/2020,91520,82L-IMPORT PAYROLL-JACKSON CLAICE,D108,HJ,,11.96,5184.01
6175,9/15/2020,9/15/2020,91520,82L-IMPORT PAYROLL-JANG DANIEL,D108,HJ,,1.78,5182.23
6175,9/15/2020,9/15/2020,91520,82L-IMPORT PAYROLL-JANG DANIEL,D108,HJ,,14.83,5167.4
6175,9/15/2020,9/15/2020,91520,82L-IMPORT PAYROLL-LENEGHAN MARYELLEN,D108,HJ,,1.78,5165.62
6175,9/15/2020,9/15/2020,91520,82L-IMPORT PAYROLL-LENEGHAN MARYELLEN,D108,HJ,,11.96,5153.66
6175,9/30/2020,9/30/2020,93020,82L-IMPORT PAYROLL-ALVAREZ-MORINE LISIS,D108,HJ,,1.78,5151.88
6175,9/30/2020,9/30/2020,93020,82L-IMPORT PAYROLL-ALVAREZ-MORINE LISIS,D108,HJ,,14.83,5137.05
6175,9/30/2020,9/30/2020,93020,82L-IMPORT PAYROLL-BARTHELEMY RACHALIE,D108,HJ,,1.78,5135.27
6175,9/30/2020,9/30/2020,93020,82L-IMPORT PAYROLL-BARTHELEMY RACHALIE,D108,HJ,,14.83,5120.44
6175,9/30/2020,9/30/2020,93020,82L-IMPORT PAYROLL-BASHAM WILLIAM EDWARD,D108,HJ,,1.78,5118.66
6175,9/30/2020,9/30/2020,93020,82L-IMPORT PAYROLL-BOHLSEN GRACE,D108,HJ,,1.78,5116.88
6175,9/30/2020,9/30/2020,93020,82L-IMPORT PAYROLL-BROWN ISAAC,D108,HJ,,1.78,5115.1
6175,9/30/2020,9/30/2020,93020,82L-IMPORT PAYROLL-BROWN ISAAC,D108,HJ,,14.83,5100.27
6175,9/30/2020,9/30/2020,93020,82L-IMPORT PAYROLL-KNOWLIN ZYLIA,D108,HJ,,1.78,5098.49
6175,9/30/2020,9/30/2020,93020,82L-IMPORT PAYROLL-KNOWLIN ZYLIA,D108,HJ,,14.83,5083.66
6175,9/30/2020,9/30/2020,93020,82L-IMPORT PAYROLL-KOPSHEVER MELISSA,D108,HJ,,3.38,5080.28
6175,9/30/2020,9/30/2020,93020,82L-IMPORT PAYROLL-KOPSHEVER MELISSA,D108,HJ,,31.6,5048.68
6175,9/30/2020,9/30/2020,93020,82L-IMPORT PAYROLL-LI SEN,D108,HJ,,1.78,5046.9
6175,9/30/2020,9/30/2020,93020,82L-IMPORT PAYROLL-LI SEN,D108,HJ,,11.96,5034.94
6175,9/30/2020,9/30/2020,93020,82L-IMPORT PAYROLL-LIPSCOMB STEPHEN,D108,HJ,,1.78,5033.16
6175,9/30/2020,9/30/2020,93020,82L-IMPORT PAYROLL-LIPSCOMB STEPHEN,D108,HJ,,11.96,5021.2
6175,9/30/2020,9/30/2020,93020,82L-IMPORT PAYROLL-MEJIA CARLOS MANUEL,D108,HJ,,1.78,5019.42
6175,9/30/2020,9/30/2020,93020,82L-IMPORT PAYROLL-MEJIA CARLOS MANUEL,D108,HJ,,14.83,5004.59
6175,9/30/2020,9/30/2020,93020,82L-IMPORT PAYROLL-SCOTT KIRK,D108,HJ,,1.78,5002.81
6175,9/30/2020,9/30/2020,93020,82L-IMPORT PAYROLL-SCOTT KIRK,D108,HJ,,11.96,4990.85
6175,9/30/2020,9/30/2020,93020,82L-IMPORT PAYROLL-SILVER KELLY,D108,HJ,,1.78,4989.07
6175,9/30/2020,9/30/2020,93020,82L-IMPORT PAYROLL-SILVER KELLY,D108,HJ,,14.83,4974.24
6175,9/30/2020,9/30/2020,93020,82L-IMPORT PAYROLL-STEIN KYLE,D108,HJ,,1.78,4972.46
6175,9/30/2020,9/30/2020,93020,82L-IMPORT PAYROLL-STEIN KYLE,D108,HJ,,11.96,4960.5
6175,9/30/2020,9/30/2020,93020,82L-IMPORT PAYROLL-STROUD DAVID,D108,HJ,,1.78,4958.72
6175,9/30/2020,9/30/2020,93020,82L-IMPORT PAYROLL-STROUD DAVID,D108,HJ,,14.83,4943.89
6175,9/30/2020,9/30/2020,93020,82L-IMPORT PAYROLL-WILLIAMS MACK,D108,HJ,,11.96,4931.93
6175,9/30/2020,9/30/2020,93020,82L-IMPORT PAYROLL-AUSTIN PERCY,D108,HJ,,1.78,4930.15
6175,9/30/2020,9/30/2020,93020,82L-IMPORT PAYROLL-AUSTIN PERCY,D108,HJ,,14.83,4915.32
6175,9/30/2020,9/30/2020,93020,82L-IMPORT PAYROLL-BUHMANN JAY,D108,HJ,,1.78,4913.54
6175,9/30/2020,9/30/2020,93020,82L-IMPORT PAYROLL-CHAPMAN CLAUDY EARL,D108,HJ,,1.78,4911.76
6175,9/30/2020,9/30/2020,93020,82L-IMPORT PAYROLL-CHAPMAN CLAUDY EARL,D108,HJ,,11.96,4899.8
6175,9/30/2020,9/30/2020,93020,82L-IMPORT PAYROLL-DADA ARIKPO,D108,HJ,,5.23,4894.57
6175,9/30/2020,9/30/2020,93020,82L-IMPORT PAYROLL-DADA ARIKPO,D108,HJ,,35.65,4858.92
6175,9/30/2020,9/30/2020,93020,82L-IMPORT PAYROLL-GUTHRIE LESLIE,D108,HJ,,1.78,4857.14
6175,9/30/2020,9/30/2020,93020,82L-IMPORT PAYROLL-GUTHRIE LESLIE,D108,HJ,,14.83,4842.31
6175,9/30/2020,9/30/2020,93020,82L-IMPORT PAYROLL-HOLMES JOREL ALEXANDER,D108,HJ,,1.78,4840.53
6175,9/30/2020,9/30/2020,93020,82L-IMPORT PAYROLL-HOLMES JOREL ALEXANDER,D108,HJ,,11.96,4828.57
6175,9/30/2020,9/30/2020,93020,82L-IMPORT PAYROLL-JORDAN TIFFANY T,D108,HJ,,5.23,4823.34
6175,9/30/2020,9/30/2020,93020,82L-IMPORT PAYROLL-JORDAN TIFFANY T,D108,HJ,,35.65,4787.69
6175,9/30/2020,9/30/2020,93020,82L-IMPORT PAYROLL-LANIGAN LISA A,D108,HJ,,3.56,4784.13
6175,9/30/2020,9/30/2020,93020,82L-IMPORT PAYROLL-ONICA ANTHONY J,D108,HJ,,1.78,4782.35
6175,9/30/2020,9/30/2020,93020,82L-IMPORT PAYROLL-ONICA ANTHONY J,D108,HJ,,11.96,4770.39
6175,9/30/2020,9/30/2020,93020,82L-IMPORT PAYROLL-PRAHIN NICOLE M,D108,HJ,,1.78,4768.61
6175,9/30/2020,9/30/2020,93020,82L-IMPORT PAYROLL-PRAHIN NICOLE M,D108,HJ,,11.96,4756.65
6175,9/30/2020,9/30/2020,93020,82L-IMPORT PAYROLL-SALIM YASSER,D108,HJ,,11.96,4744.69
6175,9/30/2020,9/30/2020,93020,82L-IMPORT PAYROLL-SEJOUR MAHALIAH,D108,HJ,,1.78,4742.91
6175,9/30/2020,9/30/2020,93020,82L-IMPORT PAYROLL-SEJOUR MAHALIAH,D108,HJ,,11.96,4730.95
6175,9/30/2020,9/30/2020,93020,82L-IMPORT PAYROLL-TUMENJARGAL ENKHJIN,D108,HJ,,1.78,4729.17
6175,9/30/2020,9/30/2020,93020,82L-IMPORT PAYROLL-TUMENJARGAL ENKHJIN,D108,HJ,,11.96,4717.21
6175,9/30/2020,9/30/2020,93020,82L-IMPORT PAYROLL-VILLEGAS EVELYN,D108,HJ,,5.23,4711.98
6175,9/30/2020,9/30/2020,93020,82L-IMPORT PAYROLL-VILLEGAS EVELYN,D108,HJ,,35.65,4676.33
6175,9/30/2020,9/30/2020,93020,82L-IMPORT PAYROLL-WOLF ANNA A,D108,HJ,,1.78,4674.55
6175,9/30/2020,9/30/2020,93020,82L-IMPORT PAYROLL-ACEVEDO MONIVETT,D107,HJ,,25.48,4649.07
6175,9/30/2020,9/30/2020,93020,82L-IMPORT PAYROLL-AKLESTAD ISABEL,D111,HJ,,1.78,4647.29
6175,9/30/2020,9/30/2020,93020,82L-IMPORT PAYROLL-AKLESTAD ISABEL,D111,HJ,,11.96,4635.33
6175,9/30/2020,9/30/2020,93020,82L-IMPORT PAYROLL-BIBB TIFFANI,D104,HJ,,1.78,4633.55
6175,9/30/2020,9/30/2020,93020,82L-IMPORT PAYROLL-BIBB TIFFANI,D104,HJ,,44.2,4589.35
6175,9/30/2020,9/30/2020,93020,82L-IMPORT PAYROLL-COOK CATHRYN ANNA,D105,HJ,,1.78,4587.57
6175,9/30/2020,9/30/2020,93020,82L-IMPORT PAYROLL-COOK CATHRYN ANNA,D105,HJ,,14.83,4572.74
6175,9/30/2020,9/30/2020,93020,82L-IMPORT PAYROLL-COOPER ASHLEE R,D101,HJ,,1.78,4570.96
6175,9/30/2020,9/30/2020,93020,82L-IMPORT PAYROLL-COOPER ASHLEE R,D101,HJ,,11.96,4559
6175,9/30/2020,9/30/2020,93020,82L-IMPORT PAYROLL-DETONE KYRA MAYA,D102,HJ,,1.78,4557.22
6175,9/30/2020,9/30/2020,93020,82L-IMPORT PAYROLL-DETONE KYRA MAYA,D102,HJ,,11.96,4545.26
6175,9/30/2020,9/30/2020,93020,82L-IMPORT PAYROLL-DUPUIS CHRISTOPHER M,D107,HJ,,1.78,4543.48
6175,9/30/2020,9/30/2020,93020,82L-IMPORT PAYROLL-DUPUIS CHRISTOPHER M,D107,HJ,,11.96,4531.52
6175,9/30/2020,9/30/2020,93020,82L-IMPORT PAYROLL-DZIEDZIC JULIE K,D101,HJ,,3.38,4528.14
6175,9/30/2020,9/30/2020,93020,82L-IMPORT PAYROLL-DZIEDZIC JULIE K,D101,HJ,,25.48,4502.66
6175,9/30/2020,9/30/2020,93020,82L-IMPORT PAYROLL-GUADARRAMA-ALVAREZ URIEL A,D105,HJ,,1.78,4500.88
6175,9/30/2020,9/30/2020,93020,82L-IMPORT PAYROLL-GUADARRAMA-ALVAREZ URIEL A,D105,HJ,,11.96,4488.92
6175,9/30/2020,9/30/2020,93020,82L-IMPORT PAYROLL-GUTIERREZ ANTONIO J,D107,HJ,,35.65,4453.27
6175,9/30/2020,9/30/2020,93020,82L-IMPORT PAYROLL-HERMAN ADAM,D102,HJ,,1.78,4451.49
6175,9/30/2020,9/30/2020,93020,82L-IMPORT PAYROLL-HERMAN ADAM,D102,HJ,,11.96,4439.53
6175,9/30/2020,9/30/2020,93020,82L-IMPORT PAYROLL-LACEY DEQUITA,D104,HJ,,0.47,4439.06
6175,9/30/2020,9/30/2020,93020,82L-IMPORT PAYROLL-LACEY DEQUITA,D104,HJ,,5.47,4433.59
6175,9/30/2020,9/30/2020,93020,82L-IMPORT PAYROLL-LIPORACE HERNAN LUIS,D103,HJ,,11.96,4421.63
6175,9/30/2020,9/30/2020,93020,82L-IMPORT PAYROLL-MASON ANGELA,D107,HJ,,5.23,4416.4
6175,9/30/2020,9/30/2020,93020,82L-IMPORT PAYROLL-MASON ANGELA,D107,HJ,,35.65,4380.75
6175,9/30/2020,9/30/2020,93020,82L-IMPORT PAYROLL-PARHAM-GANTT DENISE M,D112,HJ,,3.56,4377.19
6175,9/30/2020,9/30/2020,93020,82L-IMPORT PAYROLL-PARHAM-GANTT DENISE M,D112,HJ,,31.6,4345.59
6175,9/30/2020,9/30/2020,93020,82L-IMPORT PAYROLL-PEINADO ELIZABETH R,D111,HJ,,1.78,4343.81
6175,9/30/2020,9/30/2020,93020,82L-IMPORT PAYROLL-PEINADO ELIZABETH R,D111,HJ,,11.96,4331.85
6175,9/30/2020,9/30/2020,93020,82L-IMPORT PAYROLL-POLANCO ODALIS,D103,HJ,,1.78,4330.07
6175,9/30/2020,9/30/2020,93020,82L-IMPORT PAYROLL-POLANCO ODALIS,D103,HJ,,11.96,4318.11
6175,9/30/2020,9/30/2020,93020,82L-IMPORT PAYROLL-QUINTAS JASHIVE,D105,HJ,,1.78,4316.33
6175,9/30/2020,9/30/2020,93020,82L-IMPORT PAYROLL-QUINTAS JASHIVE,D105,HJ,,14.83,4301.5
6175,9/30/2020,9/30/2020,93020,82L-IMPORT PAYROLL-RANDOLPH ALEXANDER,D111,HJ,,1.78,4299.72
6175,9/30/2020,9/30/2020,93020,82L-IMPORT PAYROLL-RANDOLPH ALEXANDER,D111,HJ,,11.96,4287.76
6175,9/30/2020,9/30/2020,93020,82L-IMPORT PAYROLL-RUBI PERLA,D101,HJ,,14.83,4272.93
6175,9/30/2020,9/30/2020,93020,82L-IMPORT PAYROLL-SAFRAN ALAN P,D107,HJ,,3.56,4269.37
6175,9/30/2020,9/30/2020,93020,82L-IMPORT PAYROLL-SAFRAN ALAN P,D107,HJ,,35.65,4233.72
6175,9/30/2020,9/30/2020,93020,82L-IMPORT PAYROLL-WALLACE AMENA,D104,HJ,,11.96,4221.76
6175,9/30/2020,9/30/2020,93020,82L-IMPORT PAYROLL-WEINSTOCK EMILY,D101,HJ,,1.78,4219.98
6175,9/30/2020,9/30/2020,93020,82L-IMPORT PAYROLL-WEINSTOCK EMILY,D101,HJ,,11.96,4208.02
6175,9/30/2020,9/30/2020,93020,82L-IMPORT PAYROLL-BARTOLD DEANNA MARIE,D108,HJ,,1.78,4206.24
6175,9/30/2020,9/30/2020,93020,82L-IMPORT PAYROLL-BARTOLD DEANNA MARIE,D108,HJ,,11.96,4194.28
6175,9/30/2020,9/30/2020,93020,82L-IMPORT PAYROLL-BELLOT GENESIS,D108,HJ,,1.78,4192.5
6175,9/30/2020,9/30/2020,93020,82L-IMPORT PAYROLL-BELLOT GENESIS,D108,HJ,,14.83,4177.67
6175,9/30/2020,9/30/2020,93020,82L-IMPORT PAYROLL-BURRELL RUSSELL,D108,HJ,,1.78,4175.89
6175,9/30/2020,9/30/2020,93020,82L-IMPORT PAYROLL-BURRELL RUSSELL,D108,HJ,,11.96,4163.93
6175,9/30/2020,9/30/2020,93020,82L-IMPORT PAYROLL-FEIGHERY JOHN,D108,HJ,,11.96,4151.97
6175,9/30/2020,9/30/2020,93020,82L-IMPORT PAYROLL-GRIFFIN ANDREW,D108,HJ,,1.78,4150.19
6175,9/30/2020,9/30/2020,93020,82L-IMPORT PAYROLL-GRIFFIN ANDREW,D108,HJ,,11.96,4138.23
6175,9/30/2020,9/30/2020,93020,82L-IMPORT PAYROLL-GROSS EMILY,D108,HJ,,1.78,4136.45
6175,9/30/2020,9/30/2020,93020,82L-IMPORT PAYROLL-GROSS EMILY,D108,HJ,,14.83,4121.62
6175,9/30/2020,9/30/2020,93020,82L-IMPORT PAYROLL-HALLINAN GABRIEL B,D108,HJ,,1.78,4119.84
6175,9/30/2020,9/30/2020,93020,82L-IMPORT PAYROLL-HALLINAN GABRIEL B,D108,HJ,,11.96,4107.88
6175,9/30/2020,9/30/2020,93020,82L-IMPORT PAYROLL-HAMERSLY WILLIAM,D108,HJ,,1.78,4106.1
6175,9/30/2020,9/30/2020,93020,82L-IMPORT PAYROLL-HAMERSLY WILLIAM,D108,HJ,,11.96,4094.14
6175,9/30/2020,9/30/2020,93020,82L-IMPORT PAYROLL-HOSSAIN MYESHA R,D108,HJ,,1.78,4092.36
6175,9/30/2020,9/30/2020,93020,82L-IMPORT PAYROLL-HOSSAIN MYESHA R,D108,HJ,,14.83,4077.53
6175,9/30/2020,9/30/2020,93020,82L-IMPORT PAYROLL-JACKSON TASNIM,D108,HJ,,1.78,4075.75
6175,9/30/2020,9/30/2020,93020,82L-IMPORT PAYROLL-JACKSON TASNIM,D108,HJ,,14.83,4060.92
6175,9/30/2020,9/30/2020,93020,82L-IMPORT PAYROLL-LEARY AUBREY,D108,HJ,,1.78,4059.14
6175,9/30/2020,9/30/2020,93020,82L-IMPORT PAYROLL-LI BELLA,D108,HJ,,1.78,4057.36
6175,9/30/2020,9/30/2020,93020,82L-IMPORT PAYROLL-LI BELLA,D108,HJ,,11.96,4045.4
6175,9/30/2020,9/30/2020,93020,82L-IMPORT PAYROLL-OPUH NDIDI,D108,HJ,,1.78,4043.62
6175,9/30/2020,9/30/2020,93020,82L-IMPORT PAYROLL-OPUH NDIDI,D108,HJ,,35.65,4007.97
6175,9/30/2020,9/30/2020,93020,82L-IMPORT PAYROLL-SOBELMAN JUSTIN,D108,HJ,,1.78,4006.19
6175,9/30/2020,9/30/2020,93020,82L-IMPORT PAYROLL-SOBELMAN JUSTIN,D108,HJ,,11.96,3994.23
6175,9/30/2020,9/30/2020,93020,82L-IMPORT PAYROLL-TERRENCE-SMITH ZIHIR UNIQUE,D108,HJ,,1.78,3992.45
6175,9/30/2020,9/30/2020,93020,82L-IMPORT PAYROLL-TERRENCE-SMITH ZIHIR UNIQUE,D108,HJ,,14.83,3977.62
6175,9/30/2020,9/30/2020,93020,82L-IMPORT PAYROLL-WILLIAMS- MASSEY BRIANNA M,D108,HJ,,11.96,3965.66
6175,9/30/2020,9/30/2020,93020,82L-IMPORT PAYROLL-COVENEY ALLISON,D108,HJ,,1.78,3963.88
6175,9/30/2020,9/30/2020,93020,82L-IMPORT PAYROLL-COVENEY ALLISON,D108,HJ,,14.83,3949.05
6175,9/30/2020,9/30/2020,93020,82L-IMPORT PAYROLL-JACKSON CLAICE,D108,HJ,,1.78,3947.27
6175,9/30/2020,9/30/2020,93020,82L-IMPORT PAYROLL-JACKSON CLAICE,D108,HJ,,11.96,3935.31
6175,9/30/2020,9/30/2020,93020,82L-IMPORT PAYROLL-JANG DANIEL,D108,HJ,,1.78,3933.53
6175,9/30/2020,9/30/2020,93020,82L-IMPORT PAYROLL-JANG DANIEL,D108,HJ,,14.83,3918.7
6175,9/30/2020,9/30/2020,93020,82L-IMPORT PAYROLL-LENEGHAN MARYELLEN,D108,HJ,,1.78,3916.92
6175,9/30/2020,9/30/2020,93020,82L-IMPORT PAYROLL-LENEGHAN MARYELLEN,D108,HJ,,11.96,3904.96
6175,9/30/2020,9/30/2020,202009,Adj to reallocate Salaries FICA and benefits from GM3 - ACY2 to G-BL-To reallocate PR 0915 & 0930 Benefits to CPS,D104,HJ,,165.06,3739.9
6175,9/30/2020,9/30/2020,202009,Adj to reallocate Salaries FICA and benefits from GM3 - ACY2 to G-BL-To reallocate PR 0915 & 0930 Benefits to CPS,D104,HJ,165.06,,3904.96
6175,9/30/2020,9/30/2020,202009,Adj to reallocate Salaries FICA and benefits from GM3 - ACY2 to G-BL-To reallocate PR 0915 & 0930 Benefits to CPS A Wallace,D104,HJ,,23.92,3881.04
6175,9/30/2020,9/30/2020,202009,Adj to reallocate Salaries FICA and benefits from GM3 - ACY2 to G-BL-To reallocate PR 0915 & 0930 Benefits to CPS A Wallace,D104,HJ,23.92,,3904.96
6175,10/1/2020,10/1/2020,BCBS,October BCBS Payment-BCBS - October BCBS,D108,HJ,1717.96,,5622.92
6175,10/1/2020,10/1/2020,BCBS,October BCBS Payment-BCBS - October BCBS,D108,HJ,,788.11,4834.81
6175,10/1/2020,10/1/2020,BCBS,October BCBS Payment-BCBS - October BCBS,D107,HJ,1647.87,,6482.68
6175,10/1/2020,10/1/2020,BCBS,October BCBS Payment-BCBS - October BCBS,D108,HJ,242.58,,6725.26
6175,10/1/2020,10/1/2020,BCBS,October BCBS Payment-BCBS - October BCBS,D108,HJ,358.29,,7083.55
6175,10/2/2020,10/2/2020,JE-21-0072,BLue 20/020 Vision Insurance-Blue 20/20 Vision Insurance October Invoice,D108,HJ,168.51,,7252.06
6175,10/2/2020,10/2/2020,JE-21-0072,BLue 20/020 Vision Insurance-Blue 20/20 Vision Insurance October Invoice,D108,HJ,42.66,,7294.72
6175,10/2/2020,10/2/2020,JE-21-0072,BLue 20/020 Vision Insurance-Blue 20/20 Vision Insurance October Invoice,D107,HJ,14.22,,7308.94
6175,10/2/2020,10/2/2020,JE-21-0072,BLue 20/020 Vision Insurance-Blue 20/20 Vision Insurance October Invoice,D107,HJ,68.97,,7377.91
6175,10/2/2020,10/2/2020,JE-21-0072,BLue 20/020 Vision Insurance-Blue 20/20 Vision Insurance October Invoice,D108,HJ,92.43,,7470.34
6175,10/2/2020,10/2/2020,JE-21-0072,BLue 20/020 Vision Insurance-Blue 20/20 Vision Insurance October Invoice,D108,HJ,27.73,,7498.07
6175,10/15/2020,10/15/2020,101520,82L-IMPORT PAYROLL-BARTHELEMY RACHALIE,D108,HJ,,1.78,7496.29
6175,10/15/2020,10/15/2020,101520,82L-IMPORT PAYROLL-BARTHELEMY RACHALIE,D108,HJ,,14.83,7481.46
6175,10/15/2020,10/15/2020,101520,82L-IMPORT PAYROLL-BASHAM WILLIAM EDWARD,D108,HJ,,1.78,7479.68
6175,10/15/2020,10/15/2020,101520,82L-IMPORT PAYROLL-BOHLSEN GRACE,D108,HJ,,1.78,7477.9
6175,10/15/2020,10/15/2020,101520,82L-IMPORT PAYROLL-BROWN ISAAC,D108,HJ,,1.78,7476.12
6175,10/15/2020,10/15/2020,101520,82L-IMPORT PAYROLL-BROWN ISAAC,D108,HJ,,14.83,7461.29
6175,10/15/2020,10/15/2020,101520,82L-IMPORT PAYROLL-KNOWLIN ZYLIA,D108,HJ,,1.78,7459.51
6175,10/15/2020,10/15/2020,101520,82L-IMPORT PAYROLL-KNOWLIN ZYLIA,D108,HJ,,14.83,7444.68
6175,10/15/2020,10/15/2020,101520,82L-IMPORT PAYROLL-KOPSHEVER MELISSA,D108,HJ,,3.38,7441.3
6175,10/15/2020,10/15/2020,101520,82L-IMPORT PAYROLL-KOPSHEVER MELISSA,D108,HJ,,31.6,7409.7
6175,10/15/2020,10/15/2020,101520,82L-IMPORT PAYROLL-LI SEN,D108,HJ,,1.78,7407.92
6175,10/15/2020,10/15/2020,101520,82L-IMPORT PAYROLL-LI SEN,D108,HJ,,11.96,7395.96
6175,10/15/2020,10/15/2020,101520,82L-IMPORT PAYROLL-LIPSCOMB STEPHEN,D108,HJ,,1.78,7394.18
6175,10/15/2020,10/15/2020,101520,82L-IMPORT PAYROLL-LIPSCOMB STEPHEN,D108,HJ,,11.96,7382.22
6175,10/15/2020,10/15/2020,101520,82L-IMPORT PAYROLL-MEJIA CARLOS MANUEL,D108,HJ,,1.78,7380.44
6175,10/15/2020,10/15/2020,101520,82L-IMPORT PAYROLL-MEJIA CARLOS MANUEL,D108,HJ,,14.83,7365.61
6175,10/15/2020,10/15/2020,101520,82L-IMPORT PAYROLL-SCOTT KIRK,D108,HJ,,1.78,7363.83
6175,10/15/2020,10/15/2020,101520,82L-IMPORT PAYROLL-SCOTT KIRK,D108,HJ,,11.96,7351.87
6175,10/15/2020,10/15/2020,101520,82L-IMPORT PAYROLL-SILVER KELLY,D108,HJ,,1.78,7350.09
6175,10/15/2020,10/15/2020,101520,82L-IMPORT PAYROLL-SILVER KELLY,D108,HJ,,14.83,7335.26
6175,10/15/2020,10/15/2020,101520,82L-IMPORT PAYROLL-STEIN KYLE,D108,HJ,,1.78,7333.48
6175,10/15/2020,10/15/2020,101520,82L-IMPORT PAYROLL-STEIN KYLE,D108,HJ,,11.96,7321.52
6175,10/15/2020,10/15/2020,101520,82L-IMPORT PAYROLL-STROUD DAVID,D108,HJ,,1.78,7319.74
6175,10/15/2020,10/15/2020,101520,82L-IMPORT PAYROLL-STROUD DAVID,D108,HJ,,14.83,7304.91
6175,10/15/2020,10/15/2020,101520,82L-IMPORT PAYROLL-WILLIAMS MACK,D108,HJ,,11.96,7292.95
6175,10/15/2020,10/15/2020,101520,82L-IMPORT PAYROLL-APULI LINDSAY,D108,HJ,,1.78,7291.17
6175,10/15/2020,10/15/2020,101520,82L-IMPORT PAYROLL-APULI LINDSAY,D108,HJ,,11.96,7279.21
6175,10/15/2020,10/15/2020,101520,82L-IMPORT PAYROLL-AUSTIN PERCY,D108,HJ,,1.78,7277.43
6175,10/15/2020,10/15/2020,101520,82L-IMPORT PAYROLL-AUSTIN PERCY,D108,HJ,,14.83,7262.6
6175,10/15/2020,10/15/2020,101520,82L-IMPORT PAYROLL-BUHMANN JAY,D108,HJ,,1.78,7260.82
6175,10/15/2020,10/15/2020,101520,82L-IMPORT PAYROLL-CAIN CORY,D108,HJ,,1.78,7259.04
6175,10/15/2020,10/15/2020,101520,82L-IMPORT PAYROLL-CAIN CORY,D108,HJ,,14.83,7244.21
6175,10/15/2020,10/15/2020,101520,82L-IMPORT PAYROLL-CHAPMAN CLAUDY EARL,D108,HJ,,1.78,7242.43
6175,10/15/2020,10/15/2020,101520,82L-IMPORT PAYROLL-CHAPMAN CLAUDY EARL,D108,HJ,,11.96,7230.47
6175,10/15/2020,10/15/2020,101520,82L-IMPORT PAYROLL-DADA ARIKPO,D108,HJ,,5.23,7225.24
6175,10/15/2020,10/15/2020,101520,82L-IMPORT PAYROLL-DADA ARIKPO,D108,HJ,,35.65,7189.59
6175,10/15/2020,10/15/2020,101520,82L-IMPORT PAYROLL-GUTHRIE LESLIE,D108,HJ,,1.78,7187.81
6175,10/15/2020,10/15/2020,101520,82L-IMPORT PAYROLL-GUTHRIE LESLIE,D108,HJ,,14.83,7172.98
6175,10/15/2020,10/15/2020,101520,82L-IMPORT PAYROLL-HOLMES JOREL ALEXANDER,D108,HJ,,1.78,7171.2
6175,10/15/2020,10/15/2020,101520,82L-IMPORT PAYROLL-HOLMES JOREL ALEXANDER,D108,HJ,,11.96,7159.24
6175,10/15/2020,10/15/2020,101520,82L-IMPORT PAYROLL-JORDAN TIFFANY T,D108,HJ,,5.23,7154.01
6175,10/15/2020,10/15/2020,101520,82L-IMPORT PAYROLL-JORDAN TIFFANY T,D108,HJ,,35.65,7118.36
6175,10/15/2020,10/15/2020,101520,82L-IMPORT PAYROLL-LANIGAN LISA A,D108,HJ,,3.56,7114.8
6175,10/15/2020,10/15/2020,101520,82L-IMPORT PAYROLL-ONICA ANTHONY J,D108,HJ,,1.78,7113.02
6175,10/15/2020,10/15/2020,101520,82L-IMPORT PAYROLL-ONICA ANTHONY J,D108,HJ,,11.96,7101.06
6175,10/15/2020,10/15/2020,101520,82L-IMPORT PAYROLL-PRAHIN NICOLE M,D108,HJ,,1.78,7099.28
6175,10/15/2020,10/15/2020,101520,82L-IMPORT PAYROLL-PRAHIN NICOLE M,D108,HJ,,11.96,7087.32
6175,10/15/2020,10/15/2020,101520,82L-IMPORT PAYROLL-SALIM YASSER,D108,HJ,,11.96,7075.36
6175,10/15/2020,10/15/2020,101520,82L-IMPORT PAYROLL-SEJOUR MAHALIAH,D108,HJ,,1.78,7073.58
6175,10/15/2020,10/15/2020,101520,82L-IMPORT PAYROLL-SEJOUR MAHALIAH,D108,HJ,,11.96,7061.62
6175,10/15/2020,10/15/2020,101520,82L-IMPORT PAYROLL-TUMENJARGAL ENKHJIN,D108,HJ,,1.78,7059.84
6175,10/15/2020,10/15/2020,101520,82L-IMPORT PAYROLL-TUMENJARGAL ENKHJIN,D108,HJ,,11.96,7047.88
6175,10/15/2020,10/15/2020,101520,82L-IMPORT PAYROLL-VILLEGAS EVELYN,D108,HJ,,5.23,7042.65
6175,10/15/2020,10/15/2020,101520,82L-IMPORT PAYROLL-VILLEGAS EVELYN,D108,HJ,,35.65,7007
6175,10/15/2020,10/15/2020,101520,82L-IMPORT PAYROLL-WOLF ANNA A,D108,HJ,,1.78,7005.22
6175,10/15/2020,10/15/2020,101520,82L-IMPORT PAYROLL-ACEVEDO MONIVETT,D107,HJ,,25.48,6979.74
6175,10/15/2020,10/15/2020,101520,82L-IMPORT PAYROLL-AKLESTAD ISABEL,D111,HJ,,1.78,6977.96
6175,10/15/2020,10/15/2020,101520,82L-IMPORT PAYROLL-AKLESTAD ISABEL,D111,HJ,,11.96,6966
6175,10/15/2020,10/15/2020,101520,82L-IMPORT PAYROLL-BIBB TIFFANI,D104,HJ,,1.78,6964.22
6175,10/15/2020,10/15/2020,101520,82L-IMPORT PAYROLL-BIBB TIFFANI,D104,HJ,,44.2,6920.02
6175,10/15/2020,10/15/2020,101520,82L-IMPORT PAYROLL-COOK CATHRYN ANNA,D105,HJ,,1.78,6918.24
6175,10/15/2020,10/15/2020,101520,82L-IMPORT PAYROLL-COOK CATHRYN ANNA,D105,HJ,,14.83,6903.41
6175,10/15/2020,10/15/2020,101520,82L-IMPORT PAYROLL-COOPER ASHLEE R,D101,HJ,,1.78,6901.63
6175,10/15/2020,10/15/2020,101520,82L-IMPORT PAYROLL-COOPER ASHLEE R,D101,HJ,,11.96,6889.67
6175,10/15/2020,10/15/2020,101520,82L-IMPORT PAYROLL-DETONE KYRA MAYA,D102,HJ,,1.78,6887.89
6175,10/15/2020,10/15/2020,101520,82L-IMPORT PAYROLL-DETONE KYRA MAYA,D102,HJ,,11.96,6875.93
6175,10/15/2020,10/15/2020,101520,82L-IMPORT PAYROLL-DUPUIS CHRISTOPHER M,D107,HJ,,1.78,6874.15
6175,10/15/2020,10/15/2020,101520,82L-IMPORT PAYROLL-DUPUIS CHRISTOPHER M,D107,HJ,,11.96,6862.19
6175,10/15/2020,10/15/2020,101520,82L-IMPORT PAYROLL-DZIEDZIC JULIE K,D101,HJ,,3.38,6858.81
6175,10/15/2020,10/15/2020,101520,82L-IMPORT PAYROLL-DZIEDZIC JULIE K,D101,HJ,,25.48,6833.33
6175,10/15/2020,10/15/2020,101520,82L-IMPORT PAYROLL-GUADARRAMA-ALVAREZ URIEL A,D105,HJ,,1.78,6831.55
6175,10/15/2020,10/15/2020,101520,82L-IMPORT PAYROLL-GUADARRAMA-ALVAREZ URIEL A,D105,HJ,,11.96,6819.59
6175,10/15/2020,10/15/2020,101520,82L-IMPORT PAYROLL-GUTIERREZ ANTONIO J,D107,HJ,,35.65,6783.94
6175,10/15/2020,10/15/2020,101520,82L-IMPORT PAYROLL-HERMAN ADAM,D102,HJ,,1.78,6782.16
6175,10/15/2020,10/15/2020,101520,82L-IMPORT PAYROLL-HERMAN ADAM,D102,HJ,,11.96,6770.2
6175,10/15/2020,10/15/2020,101520,82L-IMPORT PAYROLL-LIPORACE HERNAN LUIS,D103,HJ,,11.96,6758.24
6175,10/15/2020,10/15/2020,101520,82L-IMPORT PAYROLL-MASON ANGELA,D107,HJ,,5.23,6753.01
6175,10/15/2020,10/15/2020,101520,82L-IMPORT PAYROLL-MASON ANGELA,D107,HJ,,35.65,6717.36
6175,10/15/2020,10/15/2020,101520,82L-IMPORT PAYROLL-PARHAM-GANTT DENISE M,D112,HJ,,3.56,6713.8
6175,10/15/2020,10/15/2020,101520,82L-IMPORT PAYROLL-PARHAM-GANTT DENISE M,D112,HJ,,31.6,6682.2
6175,10/15/2020,10/15/2020,101520,82L-IMPORT PAYROLL-PEINADO ELIZABETH R,D111,HJ,,1.78,6680.42
6175,10/15/2020,10/15/2020,101520,82L-IMPORT PAYROLL-PEINADO ELIZABETH R,D111,HJ,,11.96,6668.46
6175,10/15/2020,10/15/2020,101520,82L-IMPORT PAYROLL-POLANCO ODALIS,D103,HJ,,1.78,6666.68
6175,10/15/2020,10/15/2020,101520,82L-IMPORT PAYROLL-POLANCO ODALIS,D103,HJ,,11.96,6654.72
6175,10/15/2020,10/15/2020,101520,82L-IMPORT PAYROLL-QUINTAS JASHIVE,D105,HJ,,1.78,6652.94
6175,10/15/2020,10/15/2020,101520,82L-IMPORT PAYROLL-QUINTAS JASHIVE,D105,HJ,,14.83,6638.11
6175,10/15/2020,10/15/2020,101520,82L-IMPORT PAYROLL-RANDOLPH ALEXANDER,D111,HJ,,1.78,6636.33
6175,10/15/2020,10/15/2020,101520,82L-IMPORT PAYROLL-RANDOLPH ALEXANDER,D111,HJ,,11.96,6624.37
6175,10/15/2020,10/15/2020,101520,82L-IMPORT PAYROLL-RUBI PERLA,D101,HJ,,14.83,6609.54
6175,10/15/2020,10/15/2020,101520,82L-IMPORT PAYROLL-SAFRAN ALAN P,D107,HJ,,3.56,6605.98
6175,10/15/2020,10/15/2020,101520,82L-IMPORT PAYROLL-SAFRAN ALAN P,D107,HJ,,35.65,6570.33
6175,10/15/2020,10/15/2020,101520,82L-IMPORT PAYROLL-WALLACE AMENA,D104,HJ,,11.96,6558.37
6175,10/15/2020,10/15/2020,101520,82L-IMPORT PAYROLL-WEINSTOCK EMILY,D101,HJ,,1.78,6556.59
6175,10/15/2020,10/15/2020,101520,82L-IMPORT PAYROLL-WEINSTOCK EMILY,D101,HJ,,11.96,6544.63
6175,10/15/2020,10/15/2020,101520,82L-IMPORT PAYROLL-BARTOLD DEANNA MARIE,D108,HJ,,1.78,6542.85
6175,10/15/2020,10/15/2020,101520,82L-IMPORT PAYROLL-BARTOLD DEANNA MARIE,D108,HJ,,11.96,6530.89
6175,10/15/2020,10/15/2020,101520,82L-IMPORT PAYROLL-BELLOT GENESIS,D108,HJ,,1.78,6529.11
6175,10/15/2020,10/15/2020,101520,82L-IMPORT PAYROLL-BELLOT GENESIS,D108,HJ,,14.83,6514.28
6175,10/15/2020,10/15/2020,101520,82L-IMPORT PAYROLL-BURRELL RUSSELL,D108,HJ,,1.78,6512.5
6175,10/15/2020,10/15/2020,101520,82L-IMPORT PAYROLL-BURRELL RUSSELL,D108,HJ,,11.96,6500.54
6175,10/15/2020,10/15/2020,101520,82L-IMPORT PAYROLL-FEIGHERY JOHN,D108,HJ,,11.96,6488.58
6175,10/15/2020,10/15/2020,101520,82L-IMPORT PAYROLL-GRIFFIN ANDREW,D108,HJ,,1.78,6486.8
6175,10/15/2020,10/15/2020,101520,82L-IMPORT PAYROLL-GRIFFIN ANDREW,D108,HJ,,11.96,6474.84
6175,10/15/2020,10/15/2020,101520,82L-IMPORT PAYROLL-GROSS EMILY,D108,HJ,,1.78,6473.06
6175,10/15/2020,10/15/2020,101520,82L-IMPORT PAYROLL-GROSS EMILY,D108,HJ,,14.83,6458.23
6175,10/15/2020,10/15/2020,101520,82L-IMPORT PAYROLL-HALLINAN GABRIEL B,D108,HJ,,1.78,6456.45
6175,10/15/2020,10/15/2020,101520,82L-IMPORT PAYROLL-HALLINAN GABRIEL B,D108,HJ,,11.96,6444.49
6175,10/15/2020,10/15/2020,101520,82L-IMPORT PAYROLL-HAMERSLY WILLIAM,D108,HJ,,1.78,6442.71
6175,10/15/2020,10/15/2020,101520,82L-IMPORT PAYROLL-HAMERSLY WILLIAM,D108,HJ,,11.96,6430.75
6175,10/15/2020,10/15/2020,101520,82L-IMPORT PAYROLL-HOSSAIN MYESHA R,D108,HJ,,1.78,6428.97
6175,10/15/2020,10/15/2020,101520,82L-IMPORT PAYROLL-HOSSAIN MYESHA R,D108,HJ,,14.83,6414.14
6175,10/15/2020,10/15/2020,101520,82L-IMPORT PAYROLL-JACKSON TASNIM,D108,HJ,,1.78,6412.36
6175,10/15/2020,10/15/2020,101520,82L-IMPORT PAYROLL-JACKSON TASNIM,D108,HJ,,14.83,6397.53
6175,10/15/2020,10/15/2020,101520,82L-IMPORT PAYROLL-LEARY AUBREY,D108,HJ,,1.78,6395.75
6175,10/15/2020,10/15/2020,101520,82L-IMPORT PAYROLL-LI BELLA,D108,HJ,,1.78,6393.97
6175,10/15/2020,10/15/2020,101520,82L-IMPORT PAYROLL-LI BELLA,D108,HJ,,11.96,6382.01
6175,10/15/2020,10/15/2020,101520,82L-IMPORT PAYROLL-OPUH NDIDI,D108,HJ,,1.78,6380.23
6175,10/15/2020,10/15/2020,101520,82L-IMPORT PAYROLL-OPUH NDIDI,D108,HJ,,35.65,6344.58
6175,10/15/2020,10/15/2020,101520,82L-IMPORT PAYROLL-SOBELMAN JUSTIN,D108,HJ,,1.78,6342.8
6175,10/15/2020,10/15/2020,101520,82L-IMPORT PAYROLL-SOBELMAN JUSTIN,D108,HJ,,11.96,6330.84
6175,10/15/2020,10/15/2020,101520,82L-IMPORT PAYROLL-TERRENCE-SMITH ZIHIR UNIQUE,D108,HJ,,1.78,6329.06
6175,10/15/2020,10/15/2020,101520,82L-IMPORT PAYROLL-TERRENCE-SMITH ZIHIR UNIQUE,D108,HJ,,14.83,6314.23
6175,10/15/2020,10/15/2020,101520,82L-IMPORT PAYROLL-WILLIAMS- MASSEY BRIANNA M,D108,HJ,,11.96,6302.27
6175,10/15/2020,10/15/2020,101520,82L-IMPORT PAYROLL-COVENEY ALLISON,D108,HJ,,1.78,6300.49
6175,10/15/2020,10/15/2020,101520,82L-IMPORT PAYROLL-COVENEY ALLISON,D108,HJ,,14.83,6285.66
6175,10/15/2020,10/15/2020,101520,82L-IMPORT PAYROLL-JACKSON CLAICE,D108,HJ,,1.78,6283.88
6175,10/15/2020,10/15/2020,101520,82L-IMPORT PAYROLL-JACKSON CLAICE,D108,HJ,,11.96,6271.92
6175,10/15/2020,10/15/2020,101520,82L-IMPORT PAYROLL-JANG DANIEL,D108,HJ,,1.78,6270.14
6175,10/15/2020,10/15/2020,101520,82L-IMPORT PAYROLL-JANG DANIEL,D108,HJ,,14.83,6255.31
6175,10/15/2020,10/15/2020,101520,82L-IMPORT PAYROLL-LENEGHAN MARYELLEN,D108,HJ,,1.78,6253.53
6175,10/15/2020,10/15/2020,101520,82L-IMPORT PAYROLL-LENEGHAN MARYELLEN,D108,HJ,,11.96,6241.57
6175,10/30/2020,10/30/2020,103120,82L-IMPORT PAYROLL-BARTHELEMY RACHALIE,D108,HJ,,1.78,6239.79
6175,10/30/2020,10/30/2020,103120,82L-IMPORT PAYROLL-BARTHELEMY RACHALIE,D108,HJ,,14.83,6224.96
6175,10/30/2020,10/30/2020,103120,82L-IMPORT PAYROLL-BASHAM WILLIAM EDWARD,D108,HJ,,1.78,6223.18
6175,10/30/2020,10/30/2020,103120,82L-IMPORT PAYROLL-BOHLSEN GRACE ISABELLE,D108,HJ,,1.78,6221.4
6175,10/30/2020,10/30/2020,103120,82L-IMPORT PAYROLL-BROWN ISAAC,D108,HJ,,1.78,6219.62
6175,10/30/2020,10/30/2020,103120,82L-IMPORT PAYROLL-BROWN ISAAC,D108,HJ,,14.83,6204.79
6175,10/30/2020,10/30/2020,103120,82L-IMPORT PAYROLL-KNOWLIN ZYLIA,D108,HJ,,1.78,6203.01
6175,10/30/2020,10/30/2020,103120,82L-IMPORT PAYROLL-KNOWLIN ZYLIA,D108,HJ,,14.83,6188.18
6175,10/30/2020,10/30/2020,103120,82L-IMPORT PAYROLL-KOPSHEVER MELISSA,D108,HJ,,3.38,6184.8
6175,10/30/2020,10/30/2020,103120,82L-IMPORT PAYROLL-KOPSHEVER MELISSA,D108,HJ,,31.6,6153.2
6175,10/30/2020,10/30/2020,103120,82L-IMPORT PAYROLL-LI SEN YUAN,D108,HJ,,1.78,6151.42
6175,10/30/2020,10/30/2020,103120,82L-IMPORT PAYROLL-LI SEN YUAN,D108,HJ,,11.96,6139.46
6175,10/30/2020,10/30/2020,103120,82L-IMPORT PAYROLL-LIPSCOMB STEPHEN,D108,HJ,,1.78,6137.68
6175,10/30/2020,10/30/2020,103120,82L-IMPORT PAYROLL-LIPSCOMB STEPHEN,D108,HJ,,11.96,6125.72
6175,10/30/2020,10/30/2020,103120,82L-IMPORT PAYROLL-MEJIA ROSO CARLOS,D108,HJ,,1.78,6123.94
6175,10/30/2020,10/30/2020,103120,82L-IMPORT PAYROLL-MEJIA ROSO CARLOS,D108,HJ,,14.83,6109.11
6175,10/30/2020,10/30/2020,103120,82L-IMPORT PAYROLL-SCOTT KIRK DONOVAN,D108,HJ,,1.78,6107.33
6175,10/30/2020,10/30/2020,103120,82L-IMPORT PAYROLL-SCOTT KIRK DONOVAN,D108,HJ,,11.96,6095.37
6175,10/30/2020,10/30/2020,103120,82L-IMPORT PAYROLL-SILVER KELLY,D108,HJ,,1.78,6093.59
6175,10/30/2020,10/30/2020,103120,82L-IMPORT PAYROLL-SILVER KELLY,D108,HJ,,14.83,6078.76
6175,10/30/2020,10/30/2020,103120,82L-IMPORT PAYROLL-STEIN KYLE,D108,HJ,,1.78,6076.98
6175,10/30/2020,10/30/2020,103120,82L-IMPORT PAYROLL-STEIN KYLE,D108,HJ,,11.96,6065.02
6175,10/30/2020,10/30/2020,103120,82L-IMPORT PAYROLL-STROUD DAVID,D108,HJ,,1.78,6063.24
6175,10/30/2020,10/30/2020,103120,82L-IMPORT PAYROLL-STROUD DAVID,D108,HJ,,14.83,6048.41
6175,10/30/2020,10/30/2020,103120,82L-IMPORT PAYROLL-WILLIAMS MACK ANTHONY,D108,HJ,,11.96,6036.45
6175,10/30/2020,10/30/2020,103120,82L-IMPORT PAYROLL-APULI LINDSAY,D108,HJ,,1.78,6034.67
6175,10/30/2020,10/30/2020,103120,82L-IMPORT PAYROLL-APULI LINDSAY,D108,HJ,,11.96,6022.71
6175,10/30/2020,10/30/2020,103120,82L-IMPORT PAYROLL-AUSTIN PERCY ANTONIO,D108,HJ,,1.78,6020.93
6175,10/30/2020,10/30/2020,103120,82L-IMPORT PAYROLL-AUSTIN PERCY ANTONIO,D108,HJ,,14.83,6006.1
6175,10/30/2020,10/30/2020,103120,82L-IMPORT PAYROLL-BUHMANN JAY,D108,HJ,,1.78,6004.32
6175,10/30/2020,10/30/2020,103120,82L-IMPORT PAYROLL-CAIN CORY,D108,HJ,,1.78,6002.54
6175,10/30/2020,10/30/2020,103120,82L-IMPORT PAYROLL-CAIN CORY,D108,HJ,,14.83,5987.71
6175,10/30/2020,10/30/2020,103120,82L-IMPORT PAYROLL-CHAPMAN CLAUDY EARL,D108,HJ,,1.78,5985.93
6175,10/30/2020,10/30/2020,103120,82L-IMPORT PAYROLL-CHAPMAN CLAUDY EARL,D108,HJ,,11.96,5973.97
6175,10/30/2020,10/30/2020,103120,82L-IMPORT PAYROLL-DADA ARIKPO E,D108,HJ,,5.23,5968.74
6175,10/30/2020,10/30/2020,103120,82L-IMPORT PAYROLL-DADA ARIKPO E,D108,HJ,13.03,,5981.77
6175,10/30/2020,10/30/2020,103120,82L-IMPORT PAYROLL-GUTHRIE LESLIE,D108,HJ,,1.78,5979.99
6175,10/30/2020,10/30/2020,103120,82L-IMPORT PAYROLL-GUTHRIE LESLIE,D108,HJ,,14.83,5965.16
6175,10/30/2020,10/30/2020,103120,82L-IMPORT PAYROLL-HOLMES JOREL ALEXANDER,D108,HJ,,1.78,5963.38
6175,10/30/2020,10/30/2020,103120,82L-IMPORT PAYROLL-HOLMES JOREL ALEXANDER,D108,HJ,36.72,,6000.1
6175,10/30/2020,10/30/2020,103120,82L-IMPORT PAYROLL-JORDAN TIFFANY T,D108,HJ,,5.23,5994.87
6175,10/30/2020,10/30/2020,103120,82L-IMPORT PAYROLL-JORDAN TIFFANY T,D108,HJ,13.03,,6007.9
6175,10/30/2020,10/30/2020,103120,82L-IMPORT PAYROLL-LANIGAN LISA A,D108,HJ,,3.56,6004.34
6175,10/30/2020,10/30/2020,103120,82L-IMPORT PAYROLL-ONICA ANTHONY J,D108,HJ,,1.78,6002.56
6175,10/30/2020,10/30/2020,103120,82L-IMPORT PAYROLL-ONICA ANTHONY J,D108,HJ,36.72,,6039.28
6175,10/30/2020,10/30/2020,103120,82L-IMPORT PAYROLL-PRAHIN NICOLE M,D108,HJ,,1.78,6037.5
6175,10/30/2020,10/30/2020,103120,82L-IMPORT PAYROLL-PRAHIN NICOLE M,D108,HJ,36.72,,6074.22
6175,10/30/2020,10/30/2020,103120,82L-IMPORT PAYROLL-SALIM YASSER,D108,HJ,36.72,,6110.94
6175,10/30/2020,10/30/2020,103120,82L-IMPORT PAYROLL-SEJOUR MAHALIAH,D108,HJ,,1.78,6109.16
6175,10/30/2020,10/30/2020,103120,82L-IMPORT PAYROLL-SEJOUR MAHALIAH,D108,HJ,36.72,,6145.88
6175,10/30/2020,10/30/2020,103120,82L-IMPORT PAYROLL-TUMENJARGAL ENKHJIN,D108,HJ,,1.78,6144.1
6175,10/30/2020,10/30/2020,103120,82L-IMPORT PAYROLL-TUMENJARGAL ENKHJIN,D108,HJ,36.72,,6180.82
6175,10/30/2020,10/30/2020,103120,82L-IMPORT PAYROLL-VILLEGAS EVELYN,D108,HJ,,5.23,6175.59
6175,10/30/2020,10/30/2020,103120,82L-IMPORT PAYROLL-VILLEGAS EVELYN,D108,HJ,13.03,,6188.62
6175,10/30/2020,10/30/2020,103120,82L-IMPORT PAYROLL-WOLF ANNA A,D108,HJ,,1.78,6186.84
6175,10/30/2020,10/30/2020,103120,82L-IMPORT PAYROLL-ACEVEDO MONIVETT,D107,HJ,23.2,,6210.04
6175,10/30/2020,10/30/2020,103120,82L-IMPORT PAYROLL-AKLESTAD ISABEL,D111,HJ,,1.78,6208.26
6175,10/30/2020,10/30/2020,103120,82L-IMPORT PAYROLL-AKLESTAD ISABEL,D111,HJ,,11.96,6196.3
6175,10/30/2020,10/30/2020,103120,82L-IMPORT PAYROLL-BIBB TIFFANI,D104,HJ,,1.78,6194.52
6175,10/30/2020,10/30/2020,103120,82L-IMPORT PAYROLL-BIBB TIFFANI,D104,HJ,,44.2,6150.32
6175,10/30/2020,10/30/2020,103120,82L-IMPORT PAYROLL-COOK CATHRYN ANNA,D105,HJ,,1.78,6148.54
6175,10/30/2020,10/30/2020,103120,82L-IMPORT PAYROLL-COOK CATHRYN ANNA,D105,HJ,,14.83,6133.71
6175,10/30/2020,10/30/2020,103120,82L-IMPORT PAYROLL-COOPER ASHLEE R,D101,HJ,,1.78,6131.93
6175,10/30/2020,10/30/2020,103120,82L-IMPORT PAYROLL-COOPER ASHLEE R,D101,HJ,36.72,,6168.65
6175,10/30/2020,10/30/2020,103120,82L-IMPORT PAYROLL-DETONE KYRA MAYA,D102,HJ,,1.78,6166.87
6175,10/30/2020,10/30/2020,103120,82L-IMPORT PAYROLL-DETONE KYRA MAYA,D102,HJ,36.72,,6203.59
6175,10/30/2020,10/30/2020,103120,82L-IMPORT PAYROLL-DUPUIS CHRISTOPHER M,D107,HJ,,1.78,6201.81
6175,10/30/2020,10/30/2020,103120,82L-IMPORT PAYROLL-DUPUIS CHRISTOPHER M,D107,HJ,36.72,,6238.53
6175,10/30/2020,10/30/2020,103120,82L-IMPORT PAYROLL-DZIEDZIC JULIE K,D101,HJ,,3.38,6235.15
6175,10/30/2020,10/30/2020,103120,82L-IMPORT PAYROLL-DZIEDZIC JULIE K,D101,HJ,,25.48,6209.67
6175,10/30/2020,10/30/2020,103120,82L-IMPORT PAYROLL-GUADARRAMA-ALVAREZ URIEL A,D105,HJ,,1.78,6207.89
6175,10/30/2020,10/30/2020,103120,82L-IMPORT PAYROLL-GUADARRAMA-ALVAREZ URIEL A,D105,HJ,,11.96,6195.93
6175,10/30/2020,10/30/2020,103120,82L-IMPORT PAYROLL-GUTIERREZ ANTONIO J,D107,HJ,13.03,,6208.96
6175,10/30/2020,10/30/2020,103120,82L-IMPORT PAYROLL-HERMAN ADAM,D102,HJ,,1.78,6207.18
6175,10/30/2020,10/30/2020,103120,82L-IMPORT PAYROLL-HERMAN ADAM,D102,HJ,,11.96,6195.22
6175,10/30/2020,10/30/2020,103120,82L-IMPORT PAYROLL-LIPORACE HERNAN LUIS,D103,HJ,,11.96,6183.26
6175,10/30/2020,10/30/2020,103120,82L-IMPORT PAYROLL-MASON ANGELA,D107,HJ,,5.23,6178.03
6175,10/30/2020,10/30/2020,103120,82L-IMPORT PAYROLL-MASON ANGELA,D107,HJ,13.03,,6191.06
6175,10/30/2020,10/30/2020,103120,82L-IMPORT PAYROLL-PARHAM-GANTT DENISE M,D112,HJ,,3.56,6187.5
6175,10/30/2020,10/30/2020,103120,82L-IMPORT PAYROLL-PARHAM-GANTT DENISE M,D112,HJ,,31.6,6155.9
6175,10/30/2020,10/30/2020,103120,82L-IMPORT PAYROLL-PEINADO ELIZABETH R,D111,HJ,,1.78,6154.12
6175,10/30/2020,10/30/2020,103120,82L-IMPORT PAYROLL-PEINADO ELIZABETH R,D111,HJ,36.72,,6190.84
6175,10/30/2020,10/30/2020,103120,82L-IMPORT PAYROLL-POLANCO ODALIS,D103,HJ,,1.78,6189.06
6175,10/30/2020,10/30/2020,103120,82L-IMPORT PAYROLL-POLANCO ODALIS,D103,HJ,36.72,,6225.78
6175,10/30/2020,10/30/2020,103120,82L-IMPORT PAYROLL-QUINTAS JASHIVE,D105,HJ,,1.78,6224
6175,10/30/2020,10/30/2020,103120,82L-IMPORT PAYROLL-QUINTAS JASHIVE,D105,HJ,,14.83,6209.17
6175,10/30/2020,10/30/2020,103120,82L-IMPORT PAYROLL-RANDOLPH ALEXANDER,D111,HJ,,1.78,6207.39
6175,10/30/2020,10/30/2020,103120,82L-IMPORT PAYROLL-RANDOLPH ALEXANDER,D111,HJ,,11.96,6195.43
6175,10/30/2020,10/30/2020,103120,82L-IMPORT PAYROLL-RUBI PERLA,D101,HJ,,14.83,6180.6
6175,10/30/2020,10/30/2020,103120,82L-IMPORT PAYROLL-SAFRAN ALAN P,D107,HJ,,3.56,6177.04
6175,10/30/2020,10/30/2020,103120,82L-IMPORT PAYROLL-SAFRAN ALAN P,D107,HJ,13.03,,6190.07
6175,10/30/2020,10/30/2020,103120,82L-IMPORT PAYROLL-WALLACE AMENA,D104,HJ,36.72,,6226.79
6175,10/30/2020,10/30/2020,103120,82L-IMPORT PAYROLL-WEINSTOCK EMILY,D101,HJ,,1.78,6225.01
6175,10/30/2020,10/30/2020,103120,82L-IMPORT PAYROLL-WEINSTOCK EMILY,D101,HJ,,11.96,6213.05
6175,10/30/2020,10/30/2020,103120,82L-IMPORT PAYROLL-BARTOLD DEANNA MARIE,D108,HJ,,1.78,6211.27
6175,10/30/2020,10/30/2020,103120,82L-IMPORT PAYROLL-BARTOLD DEANNA MARIE,D108,HJ,36.72,,6247.99
6175,10/30/2020,10/30/2020,103120,82L-IMPORT PAYROLL-BELLOT GENESIS,D108,HJ,,1.78,6246.21
6175,10/30/2020,10/30/2020,103120,82L-IMPORT PAYROLL-BELLOT GENESIS,D108,HJ,,14.83,6231.38
6175,10/30/2020,10/30/2020,103120,82L-IMPORT PAYROLL-BURRELL RUSSELL,D108,HJ,,1.78,6229.6
6175,10/30/2020,10/30/2020,103120,82L-IMPORT PAYROLL-BURRELL RUSSELL,D108,HJ,,11.96,6217.64
6175,10/30/2020,10/30/2020,103120,82L-IMPORT PAYROLL-FEIGHERY JOHN,D108,HJ,36.72,,6254.36
6175,10/30/2020,10/30/2020,103120,82L-IMPORT PAYROLL-GRIFFIN ANDREW,D108,HJ,,1.78,6252.58
6175,10/30/2020,10/30/2020,103120,82L-IMPORT PAYROLL-GRIFFIN ANDREW,D108,HJ,,11.96,6240.62
6175,10/30/2020,10/30/2020,103120,82L-IMPORT PAYROLL-GROSS EMILY,D108,HJ,,1.78,6238.84
6175,10/30/2020,10/30/2020,103120,82L-IMPORT PAYROLL-GROSS EMILY,D108,HJ,,14.83,6224.01
6175,10/30/2020,10/30/2020,103120,82L-IMPORT PAYROLL-HALLINAN GABRIEL,D108,HJ,,1.78,6222.23
6175,10/30/2020,10/30/2020,103120,82L-IMPORT PAYROLL-HALLINAN GABRIEL,D108,HJ,36.72,,6258.95
6175,10/30/2020,10/30/2020,103120,82L-IMPORT PAYROLL-HAMERSLY WILLIAM,D108,HJ,,1.78,6257.17
6175,10/30/2020,10/30/2020,103120,82L-IMPORT PAYROLL-HAMERSLY WILLIAM,D108,HJ,,11.96,6245.21
6175,10/30/2020,10/30/2020,103120,82L-IMPORT PAYROLL-HOLDER LATIVA M,D108,HJ,48.68,,6293.89
6175,10/30/2020,10/30/2020,103120,82L-IMPORT PAYROLL-HOSSAIN MYESHA,D108,HJ,,1.78,6292.11
6175,10/30/2020,10/30/2020,103120,82L-IMPORT PAYROLL-HOSSAIN MYESHA,D108,HJ,,14.83,6277.28
6175,10/30/2020,10/30/2020,103120,82L-IMPORT PAYROLL-JACKSON TASNIM F,D108,HJ,,1.78,6275.5
6175,10/30/2020,10/30/2020,103120,82L-IMPORT PAYROLL-JACKSON TASNIM F,D108,HJ,,14.83,6260.67
6175,10/30/2020,10/30/2020,103120,82L-IMPORT PAYROLL-LEARY AUBREY,D108,HJ,,1.78,6258.89
6175,10/30/2020,10/30/2020,103120,82L-IMPORT PAYROLL-LI BELLA,D108,HJ,,1.78,6257.11
6175,10/30/2020,10/30/2020,103120,82L-IMPORT PAYROLL-LI BELLA,D108,HJ,36.72,,6293.83
6175,10/30/2020,10/30/2020,103120,82L-IMPORT PAYROLL-OPUH NDIDI,D108,HJ,,1.78,6292.05
6175,10/30/2020,10/30/2020,103120,82L-IMPORT PAYROLL-OPUH NDIDI,D108,HJ,,35.65,6256.4
6175,10/30/2020,10/30/2020,103120,82L-IMPORT PAYROLL-SOBELMAN JUSTIN,D108,HJ,,1.78,6254.62
6175,10/30/2020,10/30/2020,103120,82L-IMPORT PAYROLL-SOBELMAN JUSTIN,D108,HJ,,11.96,6242.66
6175,10/30/2020,10/30/2020,103120,82L-IMPORT PAYROLL-TERRENCE-SMITH ZIHIR,D108,HJ,,1.78,6240.88
6175,10/30/2020,10/30/2020,103120,82L-IMPORT PAYROLL-TERRENCE-SMITH ZIHIR,D108,HJ,,14.83,6226.05
6175,10/30/2020,10/30/2020,103120,82L-IMPORT PAYROLL-WILLIAMS-MASSEY BRIANNA,D108,HJ,,11.96,6214.09
6175,10/30/2020,10/30/2020,103120,82L-IMPORT PAYROLL-COVENEY ALLISON,D108,HJ,,1.78,6212.31
6175,10/30/2020,10/30/2020,103120,82L-IMPORT PAYROLL-COVENEY ALLISON,D108,HJ,,14.83,6197.48
6175,10/30/2020,10/30/2020,103120,82L-IMPORT PAYROLL-JACKSON CLAICE M,D108,HJ,,1.78,6195.7
6175,10/30/2020,10/30/2020,103120,82L-IMPORT PAYROLL-JACKSON CLAICE M,D108,HJ,36.72,,6232.42
6175,10/30/2020,10/30/2020,103120,82L-IMPORT PAYROLL-JANG DANIEL,D108,HJ,,1.78,6230.64
6175,10/30/2020,10/30/2020,103120,82L-IMPORT PAYROLL-JANG DANIEL,D108,HJ,,14.83,6215.81
6175,10/30/2020,10/30/2020,103120,82L-IMPORT PAYROLL-LENEGHAN MARYELLEN,D108,HJ,,1.78,6214.03
6175,10/30/2020,10/30/2020,103120,82L-IMPORT PAYROLL-LENEGHAN MARYELLEN,D108,HJ,,11.96,6202.07
6175,11/2/2020,11/2/2020,BCBS,November BCBS Payment for October Americorp Portion-BCBS - November Payment,D108,HJ,126.77,,6328.84
6175,11/2/2020,11/2/2020,BCBS,November BCBS Payment for October Americorp Portion-BCBS - November Payment,D108,HJ,114.15,,6442.99
6175,11/3/2020,11/3/2020,JE-21-0085,Blue 20/20 Vision Insurance November Inv 82L-Blue 20/20 Vision Insurance November Inv 82L,D108,HJ,105.94,,6548.93
6175,11/3/2020,11/3/2020,JE-21-0085,Blue 20/20 Vision Insurance November Inv 82L-Blue 20/20 Vision Insurance November Inv 82L,D108,HJ,71.1,,6620.03
6175,11/3/2020,11/3/2020,JE-21-0085,Blue 20/20 Vision Insurance November Inv 82L-Blue 20/20 Vision Insurance November Inv 82L,D107,HJ,21.33,,6641.36
6175,11/3/2020,11/3/2020,JE-21-0085,Blue 20/20 Vision Insurance November Inv 82L-Blue 20/20 Vision Insurance November Inv 82L,D107,HJ,27.73,,6669.09
6175,11/3/2020,11/3/2020,JE-21-0085,Blue 20/20 Vision Insurance November Inv 82L-Blue 20/20 Vision Insurance November Inv 82L,D108,HJ,35.55,,6704.64
6175,11/3/2020,11/3/2020,JE-21-0085,Blue 20/20 Vision Insurance November Inv 82L-Blue 20/20 Vision Insurance November Inv 82L,D108,HJ,7.82,,6712.46
6175,11/3/2020,11/3/2020,JE-21-0086,Blue 20/20 Vision Insurance November Inv LUX-Blue 20/20 Vision Insurance -November Inv LUX,D108,HJ,7.11,,6719.57
6175,11/3/2020,11/3/2020,JE-21-0086,Blue 20/20 Vision Insurance November Inv LUX-Blue 20/20 Vision Insurance -November Inv LUX,D108,HJ,,14.22,6705.35
6175,11/5/2020,11/5/2020,BCBS,November BCBS Payments-BCBS - November Invoices,D108,HJ,456.48,,7161.83
6175,11/5/2020,11/5/2020,BCBS,November BCBS Payments-BCBS - November Invoices,D108,HJ,402.28,,7564.11
6175,11/5/2020,11/5/2020,BCBS,November BCBS Payments-BCBS - November Invoices,D107,HJ,1024.1,,8588.21
6175,11/5/2020,11/5/2020,BCBS,November BCBS Payments-BCBS - November Invoices,D108,HJ,1335.35,,9923.56
6175,11/5/2020,11/5/2020,BCBS,November BCBS Payments-BCBS - November Invoices,D108,HJ,,57.22,9866.34
6175,11/13/2020,11/13/2020,111320,82L-IMPORT PAYROLL-BARTHELEMY RACHALIE,D108,HJ,,1.78,9864.56
6175,11/13/2020,11/13/2020,111320,82L-IMPORT PAYROLL-BARTHELEMY RACHALIE,D108,HJ,,14.83,9849.73
6175,11/13/2020,11/13/2020,111320,82L-IMPORT PAYROLL-BASHAM WILLIAM EDWARD,D108,HJ,,1.78,9847.95
6175,11/13/2020,11/13/2020,111320,82L-IMPORT PAYROLL-BOHLSEN GRACE ISABELLE,D108,HJ,,1.78,9846.17
6175,11/13/2020,11/13/2020,111320,82L-IMPORT PAYROLL-BROWN ISAAC,D108,HJ,,1.78,9844.39
6175,11/13/2020,11/13/2020,111320,82L-IMPORT PAYROLL-BROWN ISAAC,D108,HJ,,14.83,9829.56
6175,11/13/2020,11/13/2020,111320,82L-IMPORT PAYROLL-KNOWLIN ZYLIA,D108,HJ,,1.78,9827.78
6175,11/13/2020,11/13/2020,111320,82L-IMPORT PAYROLL-KNOWLIN ZYLIA,D108,HJ,,14.83,9812.95
6175,11/13/2020,11/13/2020,111320,82L-IMPORT PAYROLL-KOPSHEVER MELISSA,D108,HJ,,3.38,9809.57
6175,11/13/2020,11/13/2020,111320,82L-IMPORT PAYROLL-KOPSHEVER MELISSA,D108,HJ,,31.6,9777.97
6175,11/13/2020,11/13/2020,111320,82L-IMPORT PAYROLL-LI SEN YUAN,D108,HJ,,1.78,9776.19
6175,11/13/2020,11/13/2020,111320,82L-IMPORT PAYROLL-LI SEN YUAN,D108,HJ,,11.96,9764.23
6175,11/13/2020,11/13/2020,111320,82L-IMPORT PAYROLL-LIPSCOMB STEPHEN,D108,HJ,,1.78,9762.45
6175,11/13/2020,11/13/2020,111320,82L-IMPORT PAYROLL-LIPSCOMB STEPHEN,D108,HJ,,11.96,9750.49
6175,11/13/2020,11/13/2020,111320,82L-IMPORT PAYROLL-MEJIA ROSO CARLOS,D108,HJ,,1.78,9748.71
6175,11/13/2020,11/13/2020,111320,82L-IMPORT PAYROLL-MEJIA ROSO CARLOS,D108,HJ,,14.83,9733.88
6175,11/13/2020,11/13/2020,111320,82L-IMPORT PAYROLL-SCOTT KIRK DONOVAN,D108,HJ,,1.78,9732.1
6175,11/13/2020,11/13/2020,111320,82L-IMPORT PAYROLL-SCOTT KIRK DONOVAN,D108,HJ,,11.96,9720.14
6175,11/13/2020,11/13/2020,111320,82L-IMPORT PAYROLL-SILVER KELLY,D108,HJ,,1.78,9718.36
6175,11/13/2020,11/13/2020,111320,82L-IMPORT PAYROLL-SILVER KELLY,D108,HJ,,14.83,9703.53
6175,11/13/2020,11/13/2020,111320,82L-IMPORT PAYROLL-STEIN KYLE,D108,HJ,,1.78,9701.75
6175,11/13/2020,11/13/2020,111320,82L-IMPORT PAYROLL-STEIN KYLE,D108,HJ,,11.96,9689.79
6175,11/13/2020,11/13/2020,111320,82L-IMPORT PAYROLL-STROUD DAVID,D108,HJ,,1.78,9688.01
6175,11/13/2020,11/13/2020,111320,82L-IMPORT PAYROLL-STROUD DAVID,D108,HJ,,14.83,9673.18
6175,11/13/2020,11/13/2020,111320,82L-IMPORT PAYROLL-WILLIAMS MACK ANTHONY,D108,HJ,,11.96,9661.22
6175,11/13/2020,11/13/2020,111320,82L-IMPORT PAYROLL-APULI LINDSAY,D108,HJ,,1.78,9659.44
6175,11/13/2020,11/13/2020,111320,82L-IMPORT PAYROLL-APULI LINDSAY,D108,HJ,,11.96,9647.48
6175,11/13/2020,11/13/2020,111320,82L-IMPORT PAYROLL-AUSTIN PERCY ANTONIO,D108,HJ,,1.78,9645.7
6175,11/13/2020,11/13/2020,111320,82L-IMPORT PAYROLL-AUSTIN PERCY ANTONIO,D108,HJ,,14.83,9630.87
6175,11/13/2020,11/13/2020,111320,82L-IMPORT PAYROLL-BUHMANN JENNIFER,D108,HJ,,1.78,9629.09
6175,11/13/2020,11/13/2020,111320,82L-IMPORT PAYROLL-CAIN CORY,D108,HJ,,1.78,9627.31
6175,11/13/2020,11/13/2020,111320,82L-IMPORT PAYROLL-CAIN CORY,D108,HJ,,14.83,9612.48
6175,11/13/2020,11/13/2020,111320,82L-IMPORT PAYROLL-CHAPMAN CLAUDY EARL,D108,HJ,,1.78,9610.7
6175,11/13/2020,11/13/2020,111320,82L-IMPORT PAYROLL-CHAPMAN CLAUDY EARL,D108,HJ,,11.96,9598.74
6175,11/13/2020,11/13/2020,111320,82L-IMPORT PAYROLL-DADA ARIKPO E,D108,HJ,,5.23,9593.51
6175,11/13/2020,11/13/2020,111320,82L-IMPORT PAYROLL-DADA ARIKPO E,D108,HJ,,35.65,9557.86
6175,11/13/2020,11/13/2020,111320,82L-IMPORT PAYROLL-GUTHRIE LESLIE,D108,HJ,,1.78,9556.08
6175,11/13/2020,11/13/2020,111320,82L-IMPORT PAYROLL-GUTHRIE LESLIE,D108,HJ,,14.83,9541.25
6175,11/13/2020,11/13/2020,111320,82L-IMPORT PAYROLL-HOLMES JOREL ALEXANDER,D108,HJ,,1.78,9539.47
6175,11/13/2020,11/13/2020,111320,82L-IMPORT PAYROLL-HOLMES JOREL ALEXANDER,D108,HJ,,11.96,9527.51
6175,11/13/2020,11/13/2020,111320,82L-IMPORT PAYROLL-JORDAN TIFFANY T,D108,HJ,,5.23,9522.28
6175,11/13/2020,11/13/2020,111320,82L-IMPORT PAYROLL-JORDAN TIFFANY T,D108,HJ,,35.65,9486.63
6175,11/13/2020,11/13/2020,111320,82L-IMPORT PAYROLL-LANIGAN LISA A,D108,HJ,,3.56,9483.07
6175,11/13/2020,11/13/2020,111320,82L-IMPORT PAYROLL-ONICA ANTHONY J,D108,HJ,,1.78,9481.29
6175,11/13/2020,11/13/2020,111320,82L-IMPORT PAYROLL-ONICA ANTHONY J,D108,HJ,,11.96,9469.33
6175,11/13/2020,11/13/2020,111320,82L-IMPORT PAYROLL-PRAHIN NICOLE M,D108,HJ,,1.78,9467.55
6175,11/13/2020,11/13/2020,111320,82L-IMPORT PAYROLL-PRAHIN NICOLE M,D108,HJ,,11.96,9455.59
6175,11/13/2020,11/13/2020,111320,82L-IMPORT PAYROLL-SALIM YASSER,D108,HJ,,11.96,9443.63
6175,11/13/2020,11/13/2020,111320,82L-IMPORT PAYROLL-SEJOUR MAHALIAH,D108,HJ,,1.78,9441.85
6175,11/13/2020,11/13/2020,111320,82L-IMPORT PAYROLL-SEJOUR MAHALIAH,D108,HJ,,11.96,9429.89
6175,11/13/2020,11/13/2020,111320,82L-IMPORT PAYROLL-TUMENJARGAL ENKHJIN,D108,HJ,,1.78,9428.11
6175,11/13/2020,11/13/2020,111320,82L-IMPORT PAYROLL-TUMENJARGAL ENKHJIN,D108,HJ,,11.96,9416.15
6175,11/13/2020,11/13/2020,111320,82L-IMPORT PAYROLL-VILLEGAS EVELYN,D108,HJ,,5.23,9410.92
6175,11/13/2020,11/13/2020,111320,82L-IMPORT PAYROLL-VILLEGAS EVELYN,D108,HJ,,35.65,9375.27
6175,11/13/2020,11/13/2020,111320,82L-IMPORT PAYROLL-WOLF ANNA A,D108,HJ,,1.78,9373.49
6175,11/13/2020,11/13/2020,111320,82L-IMPORT PAYROLL-ACEVEDO MONIVETT,D107,HJ,,25.48,9348.01
6175,11/13/2020,11/13/2020,111320,82L-IMPORT PAYROLL-AKLESTAD ISABEL,D111,HJ,,1.78,9346.23
6175,11/13/2020,11/13/2020,111320,82L-IMPORT PAYROLL-AKLESTAD ISABEL,D111,HJ,,11.96,9334.27
6175,11/13/2020,11/13/2020,111320,82L-IMPORT PAYROLL-BIBB TIFFANI,D104,HJ,,1.78,9332.49
6175,11/13/2020,11/13/2020,111320,82L-IMPORT PAYROLL-BIBB TIFFANI,D104,HJ,,44.2,9288.29
6175,11/13/2020,11/13/2020,111320,82L-IMPORT PAYROLL-COOK CATHRYN ANNA,D105,HJ,,1.78,9286.51
6175,11/13/2020,11/13/2020,111320,82L-IMPORT PAYROLL-COOK CATHRYN ANNA,D105,HJ,,14.83,9271.68
6175,11/13/2020,11/13/2020,111320,82L-IMPORT PAYROLL-COOPER ASHLEE R,D101,HJ,,1.78,9269.9
6175,11/13/2020,11/13/2020,111320,82L-IMPORT PAYROLL-COOPER ASHLEE R,D101,HJ,,11.96,9257.94
6175,11/13/2020,11/13/2020,111320,82L-IMPORT PAYROLL-DETONE KYRA MAYA,D102,HJ,,1.78,9256.16
6175,11/13/2020,11/13/2020,111320,82L-IMPORT PAYROLL-DETONE KYRA MAYA,D102,HJ,,11.96,9244.2
6175,11/13/2020,11/13/2020,111320,82L-IMPORT PAYROLL-DUPUIS CHRISTOPHER M,D107,HJ,,1.78,9242.42
6175,11/13/2020,11/13/2020,111320,82L-IMPORT PAYROLL-DUPUIS CHRISTOPHER M,D107,HJ,,11.96,9230.46
6175,11/13/2020,11/13/2020,111320,82L-IMPORT PAYROLL-DZIEDZIC JULIE K,D101,HJ,,3.38,9227.08
6175,11/13/2020,11/13/2020,111320,82L-IMPORT PAYROLL-DZIEDZIC JULIE K,D101,HJ,,25.48,9201.6
6175,11/13/2020,11/13/2020,111320,82L-IMPORT PAYROLL-FISCHABER THOMAS,D109,HJ,,5.23,9196.37
6175,11/13/2020,11/13/2020,111320,82L-IMPORT PAYROLL-FISCHABER THOMAS,D109,HJ,,44.2,9152.17
6175,11/13/2020,11/13/2020,111320,82L-IMPORT PAYROLL-GUADARRAMA-ALVAREZ URIEL A,D105,HJ,,1.78,9150.39
6175,11/13/2020,11/13/2020,111320,82L-IMPORT PAYROLL-GUADARRAMA-ALVAREZ URIEL A,D105,HJ,,11.96,9138.43
6175,11/13/2020,11/13/2020,111320,82L-IMPORT PAYROLL-GUTIERREZ ANTONIO J,D107,HJ,,35.65,9102.78
6175,11/13/2020,11/13/2020,111320,82L-IMPORT PAYROLL-HERMAN ADAM,D102,HJ,,1.78,9101
6175,11/13/2020,11/13/2020,111320,82L-IMPORT PAYROLL-HERMAN ADAM,D102,HJ,,11.96,9089.04
6175,11/13/2020,11/13/2020,111320,82L-IMPORT PAYROLL-HOLT ADAM,D109,HJ,,1.78,9087.26
6175,11/13/2020,11/13/2020,111320,82L-IMPORT PAYROLL-HOLT ADAM,D109,HJ,,14.83,9072.43
6175,11/13/2020,11/13/2020,111320,82L-IMPORT PAYROLL-LIPORACE HERNAN LUIS,D103,HJ,,11.96,9060.47
6175,11/13/2020,11/13/2020,111320,82L-IMPORT PAYROLL-MARKS KRISTA,D109,HJ,,1.78,9058.69
6175,11/13/2020,11/13/2020,111320,82L-IMPORT PAYROLL-MARKS KRISTA,D109,HJ,,14.83,9043.86
6175,11/13/2020,11/13/2020,111320,82L-IMPORT PAYROLL-MASON ANGELA,D107,HJ,,5.23,9038.63
6175,11/13/2020,11/13/2020,111320,82L-IMPORT PAYROLL-MASON ANGELA,D107,HJ,,35.65,9002.98
6175,11/13/2020,11/13/2020,111320,82L-IMPORT PAYROLL-MELVIN DARNELL,D109,HJ,,1.78,9001.2
6175,11/13/2020,11/13/2020,111320,82L-IMPORT PAYROLL-MELVIN DARNELL,D109,HJ,,11.96,8989.24
6175,11/13/2020,11/13/2020,111320,82L-IMPORT PAYROLL-MESSING JENNIFER,D104,HJ,,1.78,8987.46
6175,11/13/2020,11/13/2020,111320,82L-IMPORT PAYROLL-MESSING JENNIFER,D104,HJ,,14.83,8972.63
6175,11/13/2020,11/13/2020,111320,82L-IMPORT PAYROLL-PARHAM-GANTT DENISE M,D112,HJ,,3.56,8969.07
6175,11/13/2020,11/13/2020,111320,82L-IMPORT PAYROLL-PARHAM-GANTT DENISE M,D112,HJ,,31.6,8937.47
6175,11/13/2020,11/13/2020,111320,82L-IMPORT PAYROLL-PEINADO ELIZABETH R,D111,HJ,,1.78,8935.69
6175,11/13/2020,11/13/2020,111320,82L-IMPORT PAYROLL-PEINADO ELIZABETH R,D111,HJ,,11.96,8923.73
6175,11/13/2020,11/13/2020,111320,82L-IMPORT PAYROLL-POLANCO ODALIS,D103,HJ,,1.78,8921.95
6175,11/13/2020,11/13/2020,111320,82L-IMPORT PAYROLL-POLANCO ODALIS,D103,HJ,,11.96,8909.99
6175,11/13/2020,11/13/2020,111320,82L-IMPORT PAYROLL-QUINTAS JASHIVE,D105,HJ,,1.78,8908.21
6175,11/13/2020,11/13/2020,111320,82L-IMPORT PAYROLL-QUINTAS JASHIVE,D105,HJ,,14.83,8893.38
6175,11/13/2020,11/13/2020,111320,82L-IMPORT PAYROLL-RANDOLPH ALEXANDER,D111,HJ,,1.78,8891.6
6175,11/13/2020,11/13/2020,111320,82L-IMPORT PAYROLL-RANDOLPH ALEXANDER,D111,HJ,,11.96,8879.64
6175,11/13/2020,11/13/2020,111320,82L-IMPORT PAYROLL-RUBI PERLA,D101,HJ,,14.83,8864.81
6175,11/13/2020,11/13/2020,111320,82L-IMPORT PAYROLL-SAFRAN ALAN P,D107,HJ,,5.23,8859.58
6175,11/13/2020,11/13/2020,111320,82L-IMPORT PAYROLL-SAFRAN ALAN P,D107,HJ,,35.65,8823.93
6175,11/13/2020,11/13/2020,111320,82L-IMPORT PAYROLL-WALLACE AMENA,D104,HJ,,11.96,8811.97
6175,11/13/2020,11/13/2020,111320,82L-IMPORT PAYROLL-WARD JEFFREY,D109,HJ,,5.23,8806.74
6175,11/13/2020,11/13/2020,111320,82L-IMPORT PAYROLL-WARD JEFFREY,D109,HJ,,44.2,8762.54
6175,11/13/2020,11/13/2020,111320,82L-IMPORT PAYROLL-WEINSTOCK EMILY,D101,HJ,,1.78,8760.76
6175,11/13/2020,11/13/2020,111320,82L-IMPORT PAYROLL-WEINSTOCK EMILY,D101,HJ,,11.96,8748.8
6175,11/13/2020,11/13/2020,111320,82L-IMPORT PAYROLL-BARTOLD DEANNA MARIE,D108,HJ,,1.78,8747.02
6175,11/13/2020,11/13/2020,111320,82L-IMPORT PAYROLL-BARTOLD DEANNA MARIE,D108,HJ,,11.96,8735.06
6175,11/13/2020,11/13/2020,111320,82L-IMPORT PAYROLL-BELLOT GENESIS,D108,HJ,,1.78,8733.28
6175,11/13/2020,11/13/2020,111320,82L-IMPORT PAYROLL-BELLOT GENESIS,D108,HJ,,14.83,8718.45
6175,11/13/2020,11/13/2020,111320,82L-IMPORT PAYROLL-BURRELL RUSSELL,D108,HJ,,1.78,8716.67
6175,11/13/2020,11/13/2020,111320,82L-IMPORT PAYROLL-BURRELL RUSSELL,D108,HJ,,11.96,8704.71
6175,11/13/2020,11/13/2020,111320,82L-IMPORT PAYROLL-FEIGHERY JOHN,D108,HJ,,11.96,8692.75
6175,11/13/2020,11/13/2020,111320,82L-IMPORT PAYROLL-GRIFFIN ANDREW,D108,HJ,,1.78,8690.97
6175,11/13/2020,11/13/2020,111320,82L-IMPORT PAYROLL-GRIFFIN ANDREW,D108,HJ,,11.96,8679.01
6175,11/13/2020,11/13/2020,111320,82L-IMPORT PAYROLL-GROSS EMILY,D108,HJ,,1.78,8677.23
6175,11/13/2020,11/13/2020,111320,82L-IMPORT PAYROLL-GROSS EMILY,D108,HJ,,14.83,8662.4
6175,11/13/2020,11/13/2020,111320,82L-IMPORT PAYROLL-HALLINAN GABRIEL,D108,HJ,,1.78,8660.62
6175,11/13/2020,11/13/2020,111320,82L-IMPORT PAYROLL-HALLINAN GABRIEL,D108,HJ,,11.96,8648.66
6175,11/13/2020,11/13/2020,111320,82L-IMPORT PAYROLL-HAMERSLY WILLIAM,D108,HJ,,1.78,8646.88
6175,11/13/2020,11/13/2020,111320,82L-IMPORT PAYROLL-HAMERSLY WILLIAM,D108,HJ,,11.96,8634.92
6175,11/13/2020,11/13/2020,111320,82L-IMPORT PAYROLL-HOSSAIN MYESHA,D108,HJ,,1.78,8633.14
6175,11/13/2020,11/13/2020,111320,82L-IMPORT PAYROLL-HOSSAIN MYESHA,D108,HJ,,14.83,8618.31
6175,11/13/2020,11/13/2020,111320,82L-IMPORT PAYROLL-JACKSON TASNIM F,D108,HJ,,1.78,8616.53
6175,11/13/2020,11/13/2020,111320,82L-IMPORT PAYROLL-JACKSON TASNIM F,D108,HJ,,14.83,8601.7
6175,11/13/2020,11/13/2020,111320,82L-IMPORT PAYROLL-LEARY AUBREY,D108,HJ,,1.78,8599.92
6175,11/13/2020,11/13/2020,111320,82L-IMPORT PAYROLL-LI BELLA,D108,HJ,,1.78,8598.14
6175,11/13/2020,11/13/2020,111320,82L-IMPORT PAYROLL-LI BELLA,D108,HJ,,11.96,8586.18
6175,11/13/2020,11/13/2020,111320,82L-IMPORT PAYROLL-OPUH NDIDI,D108,HJ,,1.78,8584.4
6175,11/13/2020,11/13/2020,111320,82L-IMPORT PAYROLL-OPUH NDIDI,D108,HJ,,35.65,8548.75
6175,11/13/2020,11/13/2020,111320,82L-IMPORT PAYROLL-SOBELMAN JUSTIN,D108,HJ,,1.78,8546.97
6175,11/13/2020,11/13/2020,111320,82L-IMPORT PAYROLL-SOBELMAN JUSTIN,D108,HJ,,11.96,8535.01
6175,11/13/2020,11/13/2020,111320,82L-IMPORT PAYROLL-TERRENCE-SMITH ZIHIR,D108,HJ,,1.78,8533.23
6175,11/13/2020,11/13/2020,111320,82L-IMPORT PAYROLL-TERRENCE-SMITH ZIHIR,D108,HJ,,14.83,8518.4
6175,11/13/2020,11/13/2020,111320,82L-IMPORT PAYROLL-WILLIAMS-MASSEY BRIANNA,D108,HJ,,11.96,8506.44
6175,11/13/2020,11/13/2020,111320,82L-IMPORT PAYROLL-COVENEY ALLISON,D108,HJ,,1.78,8504.66
6175,11/13/2020,11/13/2020,111320,82L-IMPORT PAYROLL-COVENEY ALLISON,D108,HJ,,14.83,8489.83
6175,11/13/2020,11/13/2020,111320,82L-IMPORT PAYROLL-JACKSON CLAICE M,D108,HJ,,1.78,8488.05
6175,11/13/2020,11/13/2020,111320,82L-IMPORT PAYROLL-JACKSON CLAICE M,D108,HJ,,11.96,8476.09
6175,11/13/2020,11/13/2020,111320,82L-IMPORT PAYROLL-JANG DANIEL,D108,HJ,,1.78,8474.31
6175,11/13/2020,11/13/2020,111320,82L-IMPORT PAYROLL-JANG DANIEL,D108,HJ,,14.83,8459.48
6175,11/13/2020,11/13/2020,111320,82L-IMPORT PAYROLL-LENEGHAN MARYELLEN,D108,HJ,,1.78,8457.7
6175,11/13/2020,11/13/2020,111320,82L-IMPORT PAYROLL-LENEGHAN MARYELLEN,D108,HJ,,11.96,8445.74
6175,11/30/2020,11/30/2020,1,To reallocate Benefits to CPS-To reallocate PR 1115 & 1130 Benefits to CPS,D104,HJ,,149.1,8296.64
6175,11/30/2020,11/30/2020,1,To reallocate Benefits to CPS-To reallocate PR 1115 & 1130 Benefits to CPS,D104,HJ,149.1,,8445.74
6175,11/30/2020,11/30/2020,113020,82L-IMPORT PAYROLL-BARTHELEMY RACHALIE,D108,HJ,,1.78,8443.96
6175,11/30/2020,11/30/2020,113020,82L-IMPORT PAYROLL-BARTHELEMY RACHALIE,D108,HJ,,14.83,8429.13
6175,11/30/2020,11/30/2020,113020,82L-IMPORT PAYROLL-BASHAM WILLIAM EDWARD,D108,HJ,,1.78,8427.35
6175,11/30/2020,11/30/2020,113020,82L-IMPORT PAYROLL-BOHLSEN GRACE ISABELLE,D108,HJ,,1.78,8425.57
6175,11/30/2020,11/30/2020,113020,82L-IMPORT PAYROLL-BROWN ISAAC,D108,HJ,,1.78,8423.79
6175,11/30/2020,11/30/2020,113020,82L-IMPORT PAYROLL-BROWN ISAAC,D108,HJ,,14.83,8408.96
6175,11/30/2020,11/30/2020,113020,82L-IMPORT PAYROLL-KNOWLIN ZYLIA,D108,HJ,,1.78,8407.18
6175,11/30/2020,11/30/2020,113020,82L-IMPORT PAYROLL-KNOWLIN ZYLIA,D108,HJ,,14.83,8392.35
6175,11/30/2020,11/30/2020,113020,82L-IMPORT PAYROLL-KOPSHEVER MELISSA,D108,HJ,,3.38,8388.97
6175,11/30/2020,11/30/2020,113020,82L-IMPORT PAYROLL-KOPSHEVER MELISSA,D108,HJ,,31.6,8357.37
6175,11/30/2020,11/30/2020,113020,82L-IMPORT PAYROLL-LI SEN YUAN,D108,HJ,,1.78,8355.59
6175,11/30/2020,11/30/2020,113020,82L-IMPORT PAYROLL-LI SEN YUAN,D108,HJ,,11.96,8343.63
6175,11/30/2020,11/30/2020,113020,82L-IMPORT PAYROLL-LIPSCOMB STEPHEN,D108,HJ,,1.78,8341.85
6175,11/30/2020,11/30/2020,113020,82L-IMPORT PAYROLL-LIPSCOMB STEPHEN,D108,HJ,,11.96,8329.89
6175,11/30/2020,11/30/2020,113020,82L-IMPORT PAYROLL-MEJIA ROSO CARLOS,D108,HJ,,1.78,8328.11
6175,11/30/2020,11/30/2020,113020,82L-IMPORT PAYROLL-MEJIA ROSO CARLOS,D108,HJ,,14.83,8313.28
6175,11/30/2020,11/30/2020,113020,82L-IMPORT PAYROLL-SCOTT KIRK DONOVAN,D108,HJ,,1.78,8311.5
6175,11/30/2020,11/30/2020,113020,82L-IMPORT PAYROLL-SCOTT KIRK DONOVAN,D108,HJ,,11.96,8299.54
6175,11/30/2020,11/30/2020,113020,82L-IMPORT PAYROLL-SILVER KELLY,D108,HJ,,1.78,8297.76
6175,11/30/2020,11/30/2020,113020,82L-IMPORT PAYROLL-SILVER KELLY,D108,HJ,,14.83,8282.93
6175,11/30/2020,11/30/2020,113020,82L-IMPORT PAYROLL-STEIN KYLE,D108,HJ,,1.78,8281.15
6175,11/30/2020,11/30/2020,113020,82L-IMPORT PAYROLL-STEIN KYLE,D108,HJ,,11.96,8269.19
6175,11/30/2020,11/30/2020,113020,82L-IMPORT PAYROLL-STROUD DAVID,D108,HJ,,1.78,8267.41
6175,11/30/2020,11/30/2020,113020,82L-IMPORT PAYROLL-STROUD DAVID,D108,HJ,,14.83,8252.58
6175,11/30/2020,11/30/2020,113020,82L-IMPORT PAYROLL-WILLIAMS MACK ANTHONY,D108,HJ,,11.96,8240.62
6175,11/30/2020,11/30/2020,113020,82L-IMPORT PAYROLL-APULI LINDSAY,D108,HJ,,1.78,8238.84
6175,11/30/2020,11/30/2020,113020,82L-IMPORT PAYROLL-APULI LINDSAY,D108,HJ,,11.96,8226.88
6175,11/30/2020,11/30/2020,113020,82L-IMPORT PAYROLL-AUSTIN PERCY ANTONIO,D108,HJ,,1.78,8225.1
6175,11/30/2020,11/30/2020,113020,82L-IMPORT PAYROLL-AUSTIN PERCY ANTONIO,D108,HJ,,14.83,8210.27
6175,11/30/2020,11/30/2020,113020,82L-IMPORT PAYROLL-BUHMANN JENNIFER,D108,HJ,,1.78,8208.49
6175,11/30/2020,11/30/2020,113020,82L-IMPORT PAYROLL-CAIN CORY,D108,HJ,,1.78,8206.71
6175,11/30/2020,11/30/2020,113020,82L-IMPORT PAYROLL-CAIN CORY,D108,HJ,,14.83,8191.88
6175,11/30/2020,11/30/2020,113020,82L-IMPORT PAYROLL-CHAPMAN CLAUDY EARL,D108,HJ,,1.78,8190.1
6175,11/30/2020,11/30/2020,113020,82L-IMPORT PAYROLL-CHAPMAN CLAUDY EARL,D108,HJ,,11.96,8178.14
6175,11/30/2020,11/30/2020,113020,82L-IMPORT PAYROLL-DADA ARIKPO E,D108,HJ,,5.23,8172.91
6175,11/30/2020,11/30/2020,113020,82L-IMPORT PAYROLL-DADA ARIKPO E,D108,HJ,,35.65,8137.26
6175,11/30/2020,11/30/2020,113020,82L-IMPORT PAYROLL-GUTHRIE LESLIE,D108,HJ,,1.78,8135.48
6175,11/30/2020,11/30/2020,113020,82L-IMPORT PAYROLL-GUTHRIE LESLIE,D108,HJ,,14.83,8120.65
6175,11/30/2020,11/30/2020,113020,82L-IMPORT PAYROLL-HOLMES JOREL ALEXANDER,D108,HJ,,1.78,8118.87
6175,11/30/2020,11/30/2020,113020,82L-IMPORT PAYROLL-HOLMES JOREL ALEXANDER,D108,HJ,,11.96,8106.91
6175,11/30/2020,11/30/2020,113020,82L-IMPORT PAYROLL-JORDAN TIFFANY T,D108,HJ,,5.23,8101.68
6175,11/30/2020,11/30/2020,113020,82L-IMPORT PAYROLL-JORDAN TIFFANY T,D108,HJ,,35.65,8066.03
6175,11/30/2020,11/30/2020,113020,82L-IMPORT PAYROLL-LANIGAN LISA A,D108,HJ,,3.56,8062.47
6175,11/30/2020,11/30/2020,113020,82L-IMPORT PAYROLL-ONICA ANTHONY J,D108,HJ,,1.78,8060.69
6175,11/30/2020,11/30/2020,113020,82L-IMPORT PAYROLL-ONICA ANTHONY J,D108,HJ,,11.96,8048.73
6175,11/30/2020,11/30/2020,113020,82L-IMPORT PAYROLL-PRAHIN NICOLE M,D108,HJ,,1.78,8046.95
6175,11/30/2020,11/30/2020,113020,82L-IMPORT PAYROLL-PRAHIN NICOLE M,D108,HJ,,11.96,8034.99
6175,11/30/2020,11/30/2020,113020,82L-IMPORT PAYROLL-SALIM YASSER,D108,HJ,,11.96,8023.03
6175,11/30/2020,11/30/2020,113020,82L-IMPORT PAYROLL-SEJOUR MAHALIAH,D108,HJ,,1.78,8021.25
6175,11/30/2020,11/30/2020,113020,82L-IMPORT PAYROLL-SEJOUR MAHALIAH,D108,HJ,,11.96,8009.29
6175,11/30/2020,11/30/2020,113020,82L-IMPORT PAYROLL-TUMENJARGAL ENKHJIN,D108,HJ,,1.78,8007.51
6175,11/30/2020,11/30/2020,113020,82L-IMPORT PAYROLL-TUMENJARGAL ENKHJIN,D108,HJ,,11.96,7995.55
6175,11/30/2020,11/30/2020,113020,82L-IMPORT PAYROLL-VILLEGAS EVELYN,D108,HJ,,5.23,7990.32
6175,11/30/2020,11/30/2020,113020,82L-IMPORT PAYROLL-VILLEGAS EVELYN,D108,HJ,,35.65,7954.67
6175,11/30/2020,11/30/2020,113020,82L-IMPORT PAYROLL-WOLF ANNA A,D108,HJ,,1.78,7952.89
6175,11/30/2020,11/30/2020,113020,82L-IMPORT PAYROLL-ACEVEDO MONIVETT,D107,HJ,,25.48,7927.41
6175,11/30/2020,11/30/2020,113020,82L-IMPORT PAYROLL-AKLESTAD ISABEL,D111,HJ,,1.78,7925.63
6175,11/30/2020,11/30/2020,113020,82L-IMPORT PAYROLL-AKLESTAD ISABEL,D111,HJ,,11.96,7913.67
6175,11/30/2020,11/30/2020,113020,82L-IMPORT PAYROLL-BIBB TIFFANI,D104,HJ,,1.78,7911.89
6175,11/30/2020,11/30/2020,113020,82L-IMPORT PAYROLL-BIBB TIFFANI,D104,HJ,,44.2,7867.69
6175,11/30/2020,11/30/2020,113020,82L-IMPORT PAYROLL-COOK CATHRYN ANNA,D105,HJ,,1.78,7865.91
6175,11/30/2020,11/30/2020,113020,82L-IMPORT PAYROLL-COOK CATHRYN ANNA,D105,HJ,,14.83,7851.08
6175,11/30/2020,11/30/2020,113020,82L-IMPORT PAYROLL-COOPER ASHLEE R,D101,HJ,,1.78,7849.3
6175,11/30/2020,11/30/2020,113020,82L-IMPORT PAYROLL-COOPER ASHLEE R,D101,HJ,,11.96,7837.34
6175,11/30/2020,11/30/2020,113020,82L-IMPORT PAYROLL-DETONE KYRA MAYA,D102,HJ,,1.78,7835.56
6175,11/30/2020,11/30/2020,113020,82L-IMPORT PAYROLL-DETONE KYRA MAYA,D102,HJ,,11.96,7823.6
6175,11/30/2020,11/30/2020,113020,82L-IMPORT PAYROLL-DUPUIS CHRISTOPHER M,D107,HJ,,1.78,7821.82
6175,11/30/2020,11/30/2020,113020,82L-IMPORT PAYROLL-DUPUIS CHRISTOPHER M,D107,HJ,,11.96,7809.86
6175,11/30/2020,11/30/2020,113020,82L-IMPORT PAYROLL-DZIEDZIC JULIE K,D101,HJ,,3.38,7806.48
6175,11/30/2020,11/30/2020,113020,82L-IMPORT PAYROLL-DZIEDZIC JULIE K,D101,HJ,,25.48,7781
6175,11/30/2020,11/30/2020,113020,82L-IMPORT PAYROLL-FISCHABER THOMAS,D109,HJ,,5.23,7775.77
6175,11/30/2020,11/30/2020,113020,82L-IMPORT PAYROLL-FISCHABER THOMAS,D109,HJ,,44.2,7731.57
6175,11/30/2020,11/30/2020,113020,82L-IMPORT PAYROLL-GUADARRAMA-ALVAREZ URIEL A,D105,HJ,,1.78,7729.79
6175,11/30/2020,11/30/2020,113020,82L-IMPORT PAYROLL-GUADARRAMA-ALVAREZ URIEL A,D105,HJ,,11.96,7717.83
6175,11/30/2020,11/30/2020,113020,82L-IMPORT PAYROLL-GUTIERREZ ANTONIO J,D107,HJ,,35.65,7682.18
6175,11/30/2020,11/30/2020,113020,82L-IMPORT PAYROLL-HERMAN ADAM,D102,HJ,,1.78,7680.4
6175,11/30/2020,11/30/2020,113020,82L-IMPORT PAYROLL-HERMAN ADAM,D102,HJ,,11.96,7668.44
6175,11/30/2020,11/30/2020,113020,82L-IMPORT PAYROLL-HOLT ADAM,D109,HJ,,1.78,7666.66
6175,11/30/2020,11/30/2020,113020,82L-IMPORT PAYROLL-HOLT ADAM,D109,HJ,,14.83,7651.83
6175,11/30/2020,11/30/2020,113020,82L-IMPORT PAYROLL-LIPORACE HERNAN LUIS,D103,HJ,,11.96,7639.87
6175,11/30/2020,11/30/2020,113020,82L-IMPORT PAYROLL-MARKS KRISTA,D109,HJ,,1.78,7638.09
6175,11/30/2020,11/30/2020,113020,82L-IMPORT PAYROLL-MARKS KRISTA,D109,HJ,,14.83,7623.26
6175,11/30/2020,11/30/2020,113020,82L-IMPORT PAYROLL-MELVIN DARNELL KEVIN,D109,HJ,,1.78,7621.48
6175,11/30/2020,11/30/2020,113020,82L-IMPORT PAYROLL-MELVIN DARNELL KEVIN,D109,HJ,,11.96,7609.52
6175,11/30/2020,11/30/2020,113020,82L-IMPORT PAYROLL-MESSING JENNIFER,D104,HJ,,1.78,7607.74
6175,11/30/2020,11/30/2020,113020,82L-IMPORT PAYROLL-MESSING JENNIFER,D104,HJ,,14.83,7592.91
6175,11/30/2020,11/30/2020,113020,82L-IMPORT PAYROLL-MILNE ROGER,D109,HJ,,1.78,7591.13
6175,11/30/2020,11/30/2020,113020,82L-IMPORT PAYROLL-MILNE ROGER,D109,HJ,,11.96,7579.17
6175,11/30/2020,11/30/2020,113020,82L-IMPORT PAYROLL-PARHAM-GANTT DENISE M,D112,HJ,,3.56,7575.61
6175,11/30/2020,11/30/2020,113020,82L-IMPORT PAYROLL-PARHAM-GANTT DENISE M,D112,HJ,,31.6,7544.01
6175,11/30/2020,11/30/2020,113020,82L-IMPORT PAYROLL-PEINADO ELIZABETH R,D111,HJ,,1.78,7542.23
6175,11/30/2020,11/30/2020,113020,82L-IMPORT PAYROLL-PEINADO ELIZABETH R,D111,HJ,,11.96,7530.27
6175,11/30/2020,11/30/2020,113020,82L-IMPORT PAYROLL-PERNIA JEFFREY,D109,HJ,,1.78,7528.49
6175,11/30/2020,11/30/2020,113020,82L-IMPORT PAYROLL-PERNIA JEFFREY,D109,HJ,,14.83,7513.66
6175,11/30/2020,11/30/2020,113020,82L-IMPORT PAYROLL-POLANCO ODALIS,D103,HJ,,1.78,7511.88
6175,11/30/2020,11/30/2020,113020,82L-IMPORT PAYROLL-POLANCO ODALIS,D103,HJ,,11.96,7499.92
6175,11/30/2020,11/30/2020,113020,82L-IMPORT PAYROLL-QUINTAS JASHIVE,D105,HJ,,1.78,7498.14
6175,11/30/2020,11/30/2020,113020,82L-IMPORT PAYROLL-QUINTAS JASHIVE,D105,HJ,,14.83,7483.31
6175,11/30/2020,11/30/2020,113020,82L-IMPORT PAYROLL-RANDOLPH ALEXANDER,D111,HJ,,1.78,7481.53
6175,11/30/2020,11/30/2020,113020,82L-IMPORT PAYROLL-RANDOLPH ALEXANDER,D111,HJ,,11.96,7469.57
6175,11/30/2020,11/30/2020,113020,82L-IMPORT PAYROLL-RUBI PERLA,D101,HJ,,14.83,7454.74
6175,11/30/2020,11/30/2020,113020,82L-IMPORT PAYROLL-SAFRAN ALAN P,D107,HJ,,5.23,7449.51
6175,11/30/2020,11/30/2020,113020,82L-IMPORT PAYROLL-SAFRAN ALAN P,D107,HJ,,35.65,7413.86
6175,11/30/2020,11/30/2020,113020,82L-IMPORT PAYROLL-WALLACE AMENA,D104,HJ,,11.96,7401.9
6175,11/30/2020,11/30/2020,113020,82L-IMPORT PAYROLL-WARD JEFFREY,D109,HJ,,5.23,7396.67
6175,11/30/2020,11/30/2020,113020,82L-IMPORT PAYROLL-WARD JEFFREY,D109,HJ,,44.2,7352.47
6175,11/30/2020,11/30/2020,113020,82L-IMPORT PAYROLL-WEINSTOCK EMILY,D101,HJ,,1.78,7350.69
6175,11/30/2020,11/30/2020,113020,82L-IMPORT PAYROLL-WEINSTOCK EMILY,D101,HJ,,11.96,7338.73
6175,11/30/2020,11/30/2020,113020,82L-IMPORT PAYROLL-BARTOLD DEANNA MARIE,D108,HJ,,1.78,7336.95
6175,11/30/2020,11/30/2020,113020,82L-IMPORT PAYROLL-BARTOLD DEANNA MARIE,D108,HJ,,11.96,7324.99
6175,11/30/2020,11/30/2020,113020,82L-IMPORT PAYROLL-BELLOT GENESIS,D108,HJ,,1.78,7323.21
6175,11/30/2020,11/30/2020,113020,82L-IMPORT PAYROLL-BELLOT GENESIS,D108,HJ,,14.83,7308.38
6175,11/30/2020,11/30/2020,113020,82L-IMPORT PAYROLL-BURRELL RUSSELL,D108,HJ,,1.78,7306.6
6175,11/30/2020,11/30/2020,113020,82L-IMPORT PAYROLL-BURRELL RUSSELL,D108,HJ,,11.96,7294.64
6175,11/30/2020,11/30/2020,113020,82L-IMPORT PAYROLL-FEIGHERY JOHN,D108,HJ,,11.96,7282.68
6175,11/30/2020,11/30/2020,113020,82L-IMPORT PAYROLL-GRIFFIN ANDREW,D108,HJ,,1.78,7280.9
6175,11/30/2020,11/30/2020,113020,82L-IMPORT PAYROLL-GRIFFIN ANDREW,D108,HJ,,11.96,7268.94
6175,11/30/2020,11/30/2020,113020,82L-IMPORT PAYROLL-GROSS EMILY,D108,HJ,,1.78,7267.16
6175,11/30/2020,11/30/2020,113020,82L-IMPORT PAYROLL-GROSS EMILY,D108,HJ,,14.83,7252.33
6175,11/30/2020,11/30/2020,113020,82L-IMPORT PAYROLL-HALLINAN GABRIEL,D108,HJ,,1.78,7250.55
6175,11/30/2020,11/30/2020,113020,82L-IMPORT PAYROLL-HALLINAN GABRIEL,D108,HJ,,11.96,7238.59
6175,11/30/2020,11/30/2020,113020,82L-IMPORT PAYROLL-HAMERSLY WILLIAM,D108,HJ,,1.78,7236.81
6175,11/30/2020,11/30/2020,113020,82L-IMPORT PAYROLL-HAMERSLY WILLIAM,D108,HJ,,11.96,7224.85
6175,11/30/2020,11/30/2020,113020,82L-IMPORT PAYROLL-HOSSAIN MYESHA,D108,HJ,,1.78,7223.07
6175,11/30/2020,11/30/2020,113020,82L-IMPORT PAYROLL-HOSSAIN MYESHA,D108,HJ,,14.83,7208.24
6175,11/30/2020,11/30/2020,113020,82L-IMPORT PAYROLL-JACKSON TASNIM F,D108,HJ,,1.78,7206.46
6175,11/30/2020,11/30/2020,113020,82L-IMPORT PAYROLL-JACKSON TASNIM F,D108,HJ,,14.83,7191.63
6175,11/30/2020,11/30/2020,113020,82L-IMPORT PAYROLL-LEARY AUBREY,D108,HJ,,1.78,7189.85
6175,11/30/2020,11/30/2020,113020,82L-IMPORT PAYROLL-LI BELLA,D108,HJ,,1.78,7188.07
6175,11/30/2020,11/30/2020,113020,82L-IMPORT PAYROLL-LI BELLA,D108,HJ,,11.96,7176.11
6175,11/30/2020,11/30/2020,113020,82L-IMPORT PAYROLL-OPUH NDIDI,D108,HJ,,1.78,7174.33
6175,11/30/2020,11/30/2020,113020,82L-IMPORT PAYROLL-OPUH NDIDI,D108,HJ,,35.65,7138.68
6175,11/30/2020,11/30/2020,113020,82L-IMPORT PAYROLL-SOBELMAN JUSTIN,D108,HJ,,1.78,7136.9
6175,11/30/2020,11/30/2020,113020,82L-IMPORT PAYROLL-SOBELMAN JUSTIN,D108,HJ,,11.96,7124.94
6175,11/30/2020,11/30/2020,113020,82L-IMPORT PAYROLL-TERRENCE-SMITH ZIHIR,D108,HJ,,1.78,7123.16
6175,11/30/2020,11/30/2020,113020,82L-IMPORT PAYROLL-TERRENCE-SMITH ZIHIR,D108,HJ,,14.83,7108.33
6175,11/30/2020,11/30/2020,113020,82L-IMPORT PAYROLL-WILLIAMS-MASSEY BRIANNA,D108,HJ,,11.96,7096.37
6175,11/30/2020,11/30/2020,113020,82L-IMPORT PAYROLL-COVENEY ALLISON,D108,HJ,,1.78,7094.59
6175,11/30/2020,11/30/2020,113020,82L-IMPORT PAYROLL-COVENEY ALLISON,D108,HJ,,14.83,7079.76
6175,11/30/2020,11/30/2020,113020,82L-IMPORT PAYROLL-JACKSON CLAICE M,D108,HJ,,1.78,7077.98
6175,11/30/2020,11/30/2020,113020,82L-IMPORT PAYROLL-JACKSON CLAICE M,D108,HJ,,11.96,7066.02
6175,11/30/2020,11/30/2020,113020,82L-IMPORT PAYROLL-JANG DANIEL,D108,HJ,,1.78,7064.24
6175,11/30/2020,11/30/2020,113020,82L-IMPORT PAYROLL-JANG DANIEL,D108,HJ,,14.83,7049.41
6175,11/30/2020,11/30/2020,113020,82L-IMPORT PAYROLL-LENEGHAN MARYELLEN,D108,HJ,,1.78,7047.63
6175,11/30/2020,11/30/2020,113020,82L-IMPORT PAYROLL-LENEGHAN MARYELLEN,D108,HJ,,11.96,7035.67
6175,12/1/2020,12/1/2020,BCBS,December BCBS Payment-BCBS - December BCBS,D108,HJ,855.24,,7890.91
6175,12/1/2020,12/1/2020,BCBS,December BCBS Payment-BCBS - December BCBS,D108,HJ,1263.37,,9154.28
6175,12/1/2020,12/1/2020,BCBS,December BCBS Payment-BCBS - December BCBS,D107,HJ,1063,,10217.28
6175,12/1/2020,12/1/2020,BCBS,December BCBS Payment-BCBS - December BCBS,D108,HJ,1159.82,,11377.1
6175,12/1/2020,12/1/2020,BCBS,December BCBS Payment-BCBS - December BCBS,D108,HJ,95.66,,11472.76
6175,12/3/2020,12/3/2020,JE-21-0110,Blue 20/20 Vision Insurance - December Inv Lux-Blue 20/20 Vision Insurance -December Inv LUX,D108,HJ,7.11,,11479.87
6175,12/3/2020,12/3/2020,JE-21-0111,Blue 20/20 Vision Insurance - December Inv 82L-Blue 20/20 Vision Insurance December Inv 82L,D108,HJ,127.27,,11607.14
6175,12/3/2020,12/3/2020,JE-21-0111,Blue 20/20 Vision Insurance - December Inv 82L-Blue 20/20 Vision Insurance December Inv 82L,D108,HJ,63.99,,11671.13
6175,12/3/2020,12/3/2020,JE-21-0111,Blue 20/20 Vision Insurance - December Inv 82L-Blue 20/20 Vision Insurance December Inv 82L,D107,HJ,56.04,,11727.17
6175,12/3/2020,12/3/2020,JE-21-0111,Blue 20/20 Vision Insurance - December Inv 82L-Blue 20/20 Vision Insurance December Inv 82L,D107,HJ,84.61,,11811.78
6175,12/3/2020,12/3/2020,JE-21-0111,Blue 20/20 Vision Insurance - December Inv 82L-Blue 20/20 Vision Insurance December Inv 82L,D108,HJ,127.98,,11939.76
6175,12/3/2020,12/3/2020,JE-21-0111,Blue 20/20 Vision Insurance - December Inv 82L-Blue 20/20 Vision Insurance December Inv 82L,D108,HJ,21.33,,11961.09
6175,12/15/2020,12/15/2020,121520,82L-IMPORT PAYROLL-BARTHELEMY RACHALIE,D108,HJ,,1.78,11959.31
6175,12/15/2020,12/15/2020,121520,82L-IMPORT PAYROLL-BARTHELEMY RACHALIE,D108,HJ,,14.83,11944.48
6175,12/15/2020,12/15/2020,121520,82L-IMPORT PAYROLL-BASHAM WILLIAM EDWARD,D108,HJ,,1.78,11942.7
6175,12/15/2020,12/15/2020,121520,82L-IMPORT PAYROLL-BOHLSEN GRACE ISABELLE,D108,HJ,,1.78,11940.92
6175,12/15/2020,12/15/2020,121520,82L-IMPORT PAYROLL-BROWN ISAAC,D108,HJ,,1.78,11939.14
6175,12/15/2020,12/15/2020,121520,82L-IMPORT PAYROLL-BROWN ISAAC,D108,HJ,,14.83,11924.31
6175,12/15/2020,12/15/2020,121520,82L-IMPORT PAYROLL-KNOWLIN ZYLIA,D108,HJ,,1.78,11922.53
6175,12/15/2020,12/15/2020,121520,82L-IMPORT PAYROLL-KNOWLIN ZYLIA,D108,HJ,,14.83,11907.7
6175,12/15/2020,12/15/2020,121520,82L-IMPORT PAYROLL-KOPSHEVER MELISSA,D108,HJ,,3.38,11904.32
6175,12/15/2020,12/15/2020,121520,82L-IMPORT PAYROLL-KOPSHEVER MELISSA,D108,HJ,,31.6,11872.72
6175,12/15/2020,12/15/2020,121520,82L-IMPORT PAYROLL-LI SEN YUAN,D108,HJ,,1.78,11870.94
6175,12/15/2020,12/15/2020,121520,82L-IMPORT PAYROLL-LI SEN YUAN,D108,HJ,,11.96,11858.98
6175,12/15/2020,12/15/2020,121520,82L-IMPORT PAYROLL-LIPSCOMB STEPHEN,D108,HJ,,1.78,11857.2
6175,12/15/2020,12/15/2020,121520,82L-IMPORT PAYROLL-LIPSCOMB STEPHEN,D108,HJ,,11.96,11845.24
6175,12/15/2020,12/15/2020,121520,82L-IMPORT PAYROLL-MEJIA ROSO CARLOS,D108,HJ,,1.78,11843.46
6175,12/15/2020,12/15/2020,121520,82L-IMPORT PAYROLL-MEJIA ROSO CARLOS,D108,HJ,,14.83,11828.63
6175,12/15/2020,12/15/2020,121520,82L-IMPORT PAYROLL-SCOTT KIRK DONOVAN,D108,HJ,,1.78,11826.85
6175,12/15/2020,12/15/2020,121520,82L-IMPORT PAYROLL-SCOTT KIRK DONOVAN,D108,HJ,,11.96,11814.89
6175,12/15/2020,12/15/2020,121520,82L-IMPORT PAYROLL-SILVER KELLY,D108,HJ,,1.78,11813.11
6175,12/15/2020,12/15/2020,121520,82L-IMPORT PAYROLL-SILVER KELLY,D108,HJ,,14.83,11798.28
6175,12/15/2020,12/15/2020,121520,82L-IMPORT PAYROLL-STEIN KYLE,D108,HJ,,1.78,11796.5
6175,12/15/2020,12/15/2020,121520,82L-IMPORT PAYROLL-STEIN KYLE,D108,HJ,,11.96,11784.54
6175,12/15/2020,12/15/2020,121520,82L-IMPORT PAYROLL-STROUD DAVID,D108,HJ,,1.78,11782.76
6175,12/15/2020,12/15/2020,121520,82L-IMPORT PAYROLL-STROUD DAVID,D108,HJ,,14.83,11767.93
6175,12/15/2020,12/15/2020,121520,82L-IMPORT PAYROLL-WILLIAMS MACK ANTHONY,D108,HJ,,11.96,11755.97
6175,12/15/2020,12/15/2020,121520,82L-IMPORT PAYROLL-APULI LINDSAY,D108,HJ,,1.78,11754.19
6175,12/15/2020,12/15/2020,121520,82L-IMPORT PAYROLL-APULI LINDSAY,D108,HJ,,11.96,11742.23
6175,12/15/2020,12/15/2020,121520,82L-IMPORT PAYROLL-AUSTIN PERCY ANTONIO,D108,HJ,,1.78,11740.45
6175,12/15/2020,12/15/2020,121520,82L-IMPORT PAYROLL-AUSTIN PERCY ANTONIO,D108,HJ,,14.83,11725.62
6175,12/15/2020,12/15/2020,121520,82L-IMPORT PAYROLL-BUHMANN JENNIFER,D108,HJ,,1.78,11723.84
6175,12/15/2020,12/15/2020,121520,82L-IMPORT PAYROLL-CAIN CORY,D108,HJ,,1.78,11722.06
6175,12/15/2020,12/15/2020,121520,82L-IMPORT PAYROLL-CAIN CORY,D108,HJ,,14.83,11707.23
6175,12/15/2020,12/15/2020,121520,82L-IMPORT PAYROLL-CHAPMAN CLAUDY EARL,D108,HJ,,1.78,11705.45
6175,12/15/2020,12/15/2020,121520,82L-IMPORT PAYROLL-CHAPMAN CLAUDY EARL,D108,HJ,,11.96,11693.49
6175,12/15/2020,12/15/2020,121520,82L-IMPORT PAYROLL-DADA ARIKPO E,D108,HJ,,5.23,11688.26
6175,12/15/2020,12/15/2020,121520,82L-IMPORT PAYROLL-DADA ARIKPO E,D108,HJ,,35.65,11652.61
6175,12/15/2020,12/15/2020,121520,82L-IMPORT PAYROLL-GUTHRIE LESLIE,D108,HJ,,1.78,11650.83
6175,12/15/2020,12/15/2020,121520,82L-IMPORT PAYROLL-GUTHRIE LESLIE,D108,HJ,,14.83,11636
6175,12/15/2020,12/15/2020,121520,82L-IMPORT PAYROLL-HOLMES JOREL ALEXANDER,D108,HJ,,1.78,11634.22
6175,12/15/2020,12/15/2020,121520,82L-IMPORT PAYROLL-HOLMES JOREL ALEXANDER,D108,HJ,,11.96,11622.26
6175,12/15/2020,12/15/2020,121520,82L-IMPORT PAYROLL-JORDAN TIFFANY T,D108,HJ,,5.23,11617.03
6175,12/15/2020,12/15/2020,121520,82L-IMPORT PAYROLL-JORDAN TIFFANY T,D108,HJ,,35.65,11581.38
6175,12/15/2020,12/15/2020,121520,82L-IMPORT PAYROLL-LANIGAN LISA A,D108,HJ,,3.56,11577.82
6175,12/15/2020,12/15/2020,121520,82L-IMPORT PAYROLL-ONICA ANTHONY J,D108,HJ,,1.78,11576.04
6175,12/15/2020,12/15/2020,121520,82L-IMPORT PAYROLL-ONICA ANTHONY J,D108,HJ,,11.96,11564.08
6175,12/15/2020,12/15/2020,121520,82L-IMPORT PAYROLL-PRAHIN NICOLE M,D108,HJ,,1.78,11562.3
6175,12/15/2020,12/15/2020,121520,82L-IMPORT PAYROLL-PRAHIN NICOLE M,D108,HJ,,11.96,11550.34
6175,12/15/2020,12/15/2020,121520,82L-IMPORT PAYROLL-SALIM YASSER,D108,HJ,,11.96,11538.38
6175,12/15/2020,12/15/2020,121520,82L-IMPORT PAYROLL-SEJOUR MAHALIAH,D108,HJ,,1.78,11536.6
6175,12/15/2020,12/15/2020,121520,82L-IMPORT PAYROLL-SEJOUR MAHALIAH,D108,HJ,,11.96,11524.64
6175,12/15/2020,12/15/2020,121520,82L-IMPORT PAYROLL-TUMENJARGAL ENKHJIN,D108,HJ,,1.78,11522.86
6175,12/15/2020,12/15/2020,121520,82L-IMPORT PAYROLL-TUMENJARGAL ENKHJIN,D108,HJ,,11.96,11510.9
6175,12/15/2020,12/15/2020,121520,82L-IMPORT PAYROLL-VILLEGAS EVELYN,D108,HJ,,5.23,11505.67
6175,12/15/2020,12/15/2020,121520,82L-IMPORT PAYROLL-VILLEGAS EVELYN,D108,HJ,,35.65,11470.02
6175,12/15/2020,12/15/2020,121520,82L-IMPORT PAYROLL-WOLF ANNA A,D108,HJ,,1.78,11468.24
6175,12/15/2020,12/15/2020,121520,82L-IMPORT PAYROLL-ACEVEDO MONIVETT,D107,HJ,,25.48,11442.76
6175,12/15/2020,12/15/2020,121520,82L-IMPORT PAYROLL-AKLESTAD ISABEL,D111,HJ,,1.78,11440.98
6175,12/15/2020,12/15/2020,121520,82L-IMPORT PAYROLL-AKLESTAD ISABEL,D111,HJ,,11.96,11429.02
6175,12/15/2020,12/15/2020,121520,82L-IMPORT PAYROLL-BIBB TIFFANI,D104,HJ,,1.78,11427.24
6175,12/15/2020,12/15/2020,121520,82L-IMPORT PAYROLL-BIBB TIFFANI,D104,HJ,,44.2,11383.04
6175,12/15/2020,12/15/2020,121520,82L-IMPORT PAYROLL-COOK CATHRYN ANNA,D105,HJ,,1.78,11381.26
6175,12/15/2020,12/15/2020,121520,82L-IMPORT PAYROLL-COOK CATHRYN ANNA,D105,HJ,,14.83,11366.43
6175,12/15/2020,12/15/2020,121520,82L-IMPORT PAYROLL-COOPER ASHLEE R,D101,HJ,,1.78,11364.65
6175,12/15/2020,12/15/2020,121520,82L-IMPORT PAYROLL-COOPER ASHLEE R,D101,HJ,,11.96,11352.69
6175,12/15/2020,12/15/2020,121520,82L-IMPORT PAYROLL-DETONE KYRA MAYA,D102,HJ,,1.78,11350.91
6175,12/15/2020,12/15/2020,121520,82L-IMPORT PAYROLL-DETONE KYRA MAYA,D102,HJ,,11.96,11338.95
6175,12/15/2020,12/15/2020,121520,82L-IMPORT PAYROLL-DUPUIS CHRISTOPHER M,D107,HJ,,1.78,11337.17
6175,12/15/2020,12/15/2020,121520,82L-IMPORT PAYROLL-DUPUIS CHRISTOPHER M,D107,HJ,,11.96,11325.21
6175,12/15/2020,12/15/2020,121520,82L-IMPORT PAYROLL-DZIEDZIC JULIE K,D101,HJ,,3.38,11321.83
6175,12/15/2020,12/15/2020,121520,82L-IMPORT PAYROLL-DZIEDZIC JULIE K,D101,HJ,,25.48,11296.35
6175,12/15/2020,12/15/2020,121520,82L-IMPORT PAYROLL-FISCHABER THOMAS,D109,HJ,,5.23,11291.12
6175,12/15/2020,12/15/2020,121520,82L-IMPORT PAYROLL-FISCHABER THOMAS,D109,HJ,,44.2,11246.92
6175,12/15/2020,12/15/2020,121520,82L-IMPORT PAYROLL-GUADARRAMA-ALVAREZ URIEL A,D105,HJ,,1.78,11245.14
6175,12/15/2020,12/15/2020,121520,82L-IMPORT PAYROLL-GUADARRAMA-ALVAREZ URIEL A,D105,HJ,,11.96,11233.18
6175,12/15/2020,12/15/2020,121520,82L-IMPORT PAYROLL-GUTIERREZ ANTONIO J,D107,HJ,,35.65,11197.53
6175,12/15/2020,12/15/2020,121520,82L-IMPORT PAYROLL-HERMAN ADAM,D102,HJ,,1.78,11195.75
6175,12/15/2020,12/15/2020,121520,82L-IMPORT PAYROLL-HERMAN ADAM,D102,HJ,,11.96,11183.79
6175,12/15/2020,12/15/2020,121520,82L-IMPORT PAYROLL-HOLT ADAM,D109,HJ,,1.78,11182.01
6175,12/15/2020,12/15/2020,121520,82L-IMPORT PAYROLL-HOLT ADAM,D109,HJ,,14.83,11167.18
6175,12/15/2020,12/15/2020,121520,82L-IMPORT PAYROLL-LIPORACE HERNAN LUIS,D103,HJ,,11.96,11155.22
6175,12/15/2020,12/15/2020,121520,82L-IMPORT PAYROLL-MARKS KRISTA,D109,HJ,,1.78,11153.44
6175,12/15/2020,12/15/2020,121520,82L-IMPORT PAYROLL-MARKS KRISTA,D109,HJ,,14.83,11138.61
6175,12/15/2020,12/15/2020,121520,82L-IMPORT PAYROLL-MELVIN DARNELL KEVIN,D109,HJ,,1.78,11136.83
6175,12/15/2020,12/15/2020,121520,82L-IMPORT PAYROLL-MELVIN DARNELL KEVIN,D109,HJ,,11.96,11124.87
6175,12/15/2020,12/15/2020,121520,82L-IMPORT PAYROLL-MESSING JENNIFER,D109,HJ,,1.78,11123.09
6175,12/15/2020,12/15/2020,121520,82L-IMPORT PAYROLL-MESSING JENNIFER,D109,HJ,,14.83,11108.26
6175,12/15/2020,12/15/2020,121520,82L-IMPORT PAYROLL-MILNE ROGER,D109,HJ,,1.78,11106.48
6175,12/15/2020,12/15/2020,121520,82L-IMPORT PAYROLL-MILNE ROGER,D109,HJ,,11.96,11094.52
6175,12/15/2020,12/15/2020,121520,82L-IMPORT PAYROLL-PARHAM-GANTT DENISE M,D112,HJ,,3.56,11090.96
6175,12/15/2020,12/15/2020,121520,82L-IMPORT PAYROLL-PARHAM-GANTT DENISE M,D112,HJ,,31.6,11059.36
6175,12/15/2020,12/15/2020,121520,82L-IMPORT PAYROLL-PEINADO ELIZABETH R,D111,HJ,,1.78,11057.58
6175,12/15/2020,12/15/2020,121520,82L-IMPORT PAYROLL-PEINADO ELIZABETH R,D111,HJ,,11.96,11045.62
6175,12/15/2020,12/15/2020,121520,82L-IMPORT PAYROLL-PERNIA JEFFREY,D109,HJ,,1.78,11043.84
6175,12/15/2020,12/15/2020,121520,82L-IMPORT PAYROLL-PERNIA JEFFREY,D109,HJ,,14.83,11029.01
6175,12/15/2020,12/15/2020,121520,82L-IMPORT PAYROLL-POLANCO ODALIS,D103,HJ,,1.78,11027.23
6175,12/15/2020,12/15/2020,121520,82L-IMPORT PAYROLL-POLANCO ODALIS,D103,HJ,,11.96,11015.27
6175,12/15/2020,12/15/2020,121520,82L-IMPORT PAYROLL-QUINTAS JASHIVE,D105,HJ,,1.78,11013.49
6175,12/15/2020,12/15/2020,121520,82L-IMPORT PAYROLL-QUINTAS JASHIVE,D105,HJ,,14.83,10998.66
6175,12/15/2020,12/15/2020,121520,82L-IMPORT PAYROLL-RANDOLPH ALEXANDER,D111,HJ,,1.78,10996.88
6175,12/15/2020,12/15/2020,121520,82L-IMPORT PAYROLL-RANDOLPH ALEXANDER,D111,HJ,,11.96,10984.92
6175,12/15/2020,12/15/2020,121520,82L-IMPORT PAYROLL-RUBI PERLA,D101,HJ,,14.83,10970.09
6175,12/15/2020,12/15/2020,121520,82L-IMPORT PAYROLL-SAFRAN ALAN P,D107,HJ,,5.23,10964.86
6175,12/15/2020,12/15/2020,121520,82L-IMPORT PAYROLL-SAFRAN ALAN P,D107,HJ,,35.65,10929.21
6175,12/15/2020,12/15/2020,121520,82L-IMPORT PAYROLL-WALLACE AMENA,D104,HJ,,11.96,10917.25
6175,12/15/2020,12/15/2020,121520,82L-IMPORT PAYROLL-WARD JEFFREY,D109,HJ,,5.23,10912.02
6175,12/15/2020,12/15/2020,121520,82L-IMPORT PAYROLL-WARD JEFFREY,D109,HJ,,44.2,10867.82
6175,12/15/2020,12/15/2020,121520,82L-IMPORT PAYROLL-WEINSTOCK EMILY,D101,HJ,,1.78,10866.04
6175,12/15/2020,12/15/2020,121520,82L-IMPORT PAYROLL-WEINSTOCK EMILY,D101,HJ,,11.96,10854.08
6175,12/15/2020,12/15/2020,121520,82L-IMPORT PAYROLL-BARTOLD DEANNA MARIE,D108,HJ,,1.78,10852.3
6175,12/15/2020,12/15/2020,121520,82L-IMPORT PAYROLL-BARTOLD DEANNA MARIE,D108,HJ,,11.96,10840.34
6175,12/15/2020,12/15/2020,121520,82L-IMPORT PAYROLL-BELLOT GENESIS,D108,HJ,,1.78,10838.56
6175,12/15/2020,12/15/2020,121520,82L-IMPORT PAYROLL-BELLOT GENESIS,D108,HJ,,14.83,10823.73
6175,12/15/2020,12/15/2020,121520,82L-IMPORT PAYROLL-BURRELL RUSSELL,D108,HJ,,1.78,10821.95
6175,12/15/2020,12/15/2020,121520,82L-IMPORT PAYROLL-BURRELL RUSSELL,D108,HJ,,11.96,10809.99
6175,12/15/2020,12/15/2020,121520,82L-IMPORT PAYROLL-FEIGHERY JOHN,D108,HJ,,11.96,10798.03
6175,12/15/2020,12/15/2020,121520,82L-IMPORT PAYROLL-GRIFFIN ANDREW,D108,HJ,,1.78,10796.25
6175,12/15/2020,12/15/2020,121520,82L-IMPORT PAYROLL-GRIFFIN ANDREW,D108,HJ,,11.96,10784.29
6175,12/15/2020,12/15/2020,121520,82L-IMPORT PAYROLL-GROSS EMILY,D108,HJ,,1.78,10782.51
6175,12/15/2020,12/15/2020,121520,82L-IMPORT PAYROLL-GROSS EMILY,D108,HJ,,14.83,10767.68
6175,12/15/2020,12/15/2020,121520,82L-IMPORT PAYROLL-HALLINAN GABRIEL,D108,HJ,,1.78,10765.9
6175,12/15/2020,12/15/2020,121520,82L-IMPORT PAYROLL-HALLINAN GABRIEL,D108,HJ,,11.96,10753.94
6175,12/15/2020,12/15/2020,121520,82L-IMPORT PAYROLL-HAMERSLY WILLIAM,D108,HJ,,1.78,10752.16
6175,12/15/2020,12/15/2020,121520,82L-IMPORT PAYROLL-HAMERSLY WILLIAM,D108,HJ,,11.96,10740.2
6175,12/15/2020,12/15/2020,121520,82L-IMPORT PAYROLL-HOSSAIN MYESHA,D108,HJ,,1.78,10738.42
6175,12/15/2020,12/15/2020,121520,82L-IMPORT PAYROLL-HOSSAIN MYESHA,D108,HJ,,14.83,10723.59
6175,12/15/2020,12/15/2020,121520,82L-IMPORT PAYROLL-JACKSON TASNIM F,D108,HJ,,1.78,10721.81
6175,12/15/2020,12/15/2020,121520,82L-IMPORT PAYROLL-JACKSON TASNIM F,D108,HJ,,14.83,10706.98
6175,12/15/2020,12/15/2020,121520,82L-IMPORT PAYROLL-LEARY AUBREY,D108,HJ,,1.78,10705.2
6175,12/15/2020,12/15/2020,121520,82L-IMPORT PAYROLL-LI BELLA,D108,HJ,,1.78,10703.42
6175,12/15/2020,12/15/2020,121520,82L-IMPORT PAYROLL-LI BELLA,D108,HJ,,11.96,10691.46
6175,12/15/2020,12/15/2020,121520,82L-IMPORT PAYROLL-OPUH NDIDI,D108,HJ,,1.78,10689.68
6175,12/15/2020,12/15/2020,121520,82L-IMPORT PAYROLL-OPUH NDIDI,D108,HJ,,35.65,10654.03
6175,12/15/2020,12/15/2020,121520,82L-IMPORT PAYROLL-SOBELMAN JUSTIN,D108,HJ,,1.78,10652.25
6175,12/15/2020,12/15/2020,121520,82L-IMPORT PAYROLL-SOBELMAN JUSTIN,D108,HJ,,11.96,10640.29
6175,12/15/2020,12/15/2020,121520,82L-IMPORT PAYROLL-TERRENCE-SMITH ZIHIR,D108,HJ,,1.78,10638.51
6175,12/15/2020,12/15/2020,121520,82L-IMPORT PAYROLL-TERRENCE-SMITH ZIHIR,D108,HJ,,14.83,10623.68
6175,12/15/2020,12/15/2020,121520,82L-IMPORT PAYROLL-WILLIAMS-MASSEY BRIANNA,D108,HJ,,11.96,10611.72
6175,12/15/2020,12/15/2020,121520,82L-IMPORT PAYROLL-COVENEY ALLISON,D108,HJ,,1.78,10609.94
6175,12/15/2020,12/15/2020,121520,82L-IMPORT PAYROLL-COVENEY ALLISON,D108,HJ,,14.83,10595.11
6175,12/15/2020,12/15/2020,121520,82L-IMPORT PAYROLL-JACKSON CLAICE M,D108,HJ,,1.78,10593.33
6175,12/15/2020,12/15/2020,121520,82L-IMPORT PAYROLL-JACKSON CLAICE M,D108,HJ,,11.96,10581.37
6175,12/15/2020,12/15/2020,121520,82L-IMPORT PAYROLL-JANG DANIEL,D108,HJ,,1.78,10579.59
6175,12/15/2020,12/15/2020,121520,82L-IMPORT PAYROLL-JANG DANIEL,D108,HJ,,14.83,10564.76
6175,12/15/2020,12/15/2020,121520,82L-IMPORT PAYROLL-LENEGHAN MARYELLEN,D108,HJ,,1.78,10562.98
6175,12/15/2020,12/15/2020,121520,82L-IMPORT PAYROLL-LENEGHAN MARYELLEN,D108,HJ,,11.96,10551.02
6175,12/31/2020,12/31/2020,123120,82L-IMPORT PAYROLL-BARTHELEMY RACHALIE,D108,HJ,,1.78,10549.24
6175,12/31/2020,12/31/2020,123120,82L-IMPORT PAYROLL-BARTHELEMY RACHALIE,D108,HJ,,14.83,10534.41
6175,12/31/2020,12/31/2020,123120,82L-IMPORT PAYROLL-BASHAM WILLIAM EDWARD,D108,HJ,,1.78,10532.63
6175,12/31/2020,12/31/2020,123120,82L-IMPORT PAYROLL-BOHLSEN GRACE ISABELLE,D108,HJ,,1.78,10530.85
6175,12/31/2020,12/31/2020,123120,82L-IMPORT PAYROLL-BROWN ISAAC,D108,HJ,,1.78,10529.07
6175,12/31/2020,12/31/2020,123120,82L-IMPORT PAYROLL-BROWN ISAAC,D108,HJ,,14.83,10514.24
6175,12/31/2020,12/31/2020,123120,82L-IMPORT PAYROLL-KNOWLIN ZYLIA,D108,HJ,,1.78,10512.46
6175,12/31/2020,12/31/2020,123120,82L-IMPORT PAYROLL-KNOWLIN ZYLIA,D108,HJ,,14.83,10497.63
6175,12/31/2020,12/31/2020,123120,82L-IMPORT PAYROLL-KOPSHEVER MELISSA,D108,HJ,,3.38,10494.25
6175,12/31/2020,12/31/2020,123120,82L-IMPORT PAYROLL-KOPSHEVER MELISSA,D108,HJ,,31.6,10462.65
6175,12/31/2020,12/31/2020,123120,82L-IMPORT PAYROLL-LI SEN YUAN,D108,HJ,,1.78,10460.87
6175,12/31/2020,12/31/2020,123120,82L-IMPORT PAYROLL-LI SEN YUAN,D108,HJ,,11.96,10448.91
6175,12/31/2020,12/31/2020,123120,82L-IMPORT PAYROLL-LIPSCOMB STEPHEN,D108,HJ,,1.78,10447.13
6175,12/31/2020,12/31/2020,123120,82L-IMPORT PAYROLL-LIPSCOMB STEPHEN,D108,HJ,,11.96,10435.17
6175,12/31/2020,12/31/2020,123120,82L-IMPORT PAYROLL-MEJIA ROSO CARLOS,D108,HJ,,1.78,10433.39
6175,12/31/2020,12/31/2020,123120,82L-IMPORT PAYROLL-MEJIA ROSO CARLOS,D108,HJ,,14.83,10418.56
6175,12/31/2020,12/31/2020,123120,82L-IMPORT PAYROLL-SCOTT KIRK DONOVAN,D108,HJ,,1.78,10416.78
6175,12/31/2020,12/31/2020,123120,82L-IMPORT PAYROLL-SCOTT KIRK DONOVAN,D108,HJ,,11.96,10404.82
6175,12/31/2020,12/31/2020,123120,82L-IMPORT PAYROLL-SILVER KELLY,D108,HJ,,1.78,10403.04
6175,12/31/2020,12/31/2020,123120,82L-IMPORT PAYROLL-SILVER KELLY,D108,HJ,,14.83,10388.21
6175,12/31/2020,12/31/2020,123120,82L-IMPORT PAYROLL-STEIN KYLE,D108,HJ,,1.78,10386.43
6175,12/31/2020,12/31/2020,123120,82L-IMPORT PAYROLL-STEIN KYLE,D108,HJ,,11.96,10374.47
6175,12/31/2020,12/31/2020,123120,82L-IMPORT PAYROLL-STROUD DAVID,D108,HJ,,1.78,10372.69
6175,12/31/2020,12/31/2020,123120,82L-IMPORT PAYROLL-STROUD DAVID,D108,HJ,,14.83,10357.86
6175,12/31/2020,12/31/2020,123120,82L-IMPORT PAYROLL-WILLIAMS MACK ANTHONY,D108,HJ,,11.96,10345.9
6175,12/31/2020,12/31/2020,123120,82L-IMPORT PAYROLL-APULI LINDSAY,D108,HJ,,1.78,10344.12
6175,12/31/2020,12/31/2020,123120,82L-IMPORT PAYROLL-APULI LINDSAY,D108,HJ,,11.96,10332.16
6175,12/31/2020,12/31/2020,123120,82L-IMPORT PAYROLL-AUSTIN PERCY ANTONIO,D108,HJ,,1.78,10330.38
6175,12/31/2020,12/31/2020,123120,82L-IMPORT PAYROLL-AUSTIN PERCY ANTONIO,D108,HJ,,14.83,10315.55
6175,12/31/2020,12/31/2020,123120,82L-IMPORT PAYROLL-BUHMANN JENNIFER,D108,HJ,,1.78,10313.77
6175,12/31/2020,12/31/2020,123120,82L-IMPORT PAYROLL-CAIN CORY,D108,HJ,,1.78,10311.99
6175,12/31/2020,12/31/2020,123120,82L-IMPORT PAYROLL-CAIN CORY,D108,HJ,,14.83,10297.16
6175,12/31/2020,12/31/2020,123120,82L-IMPORT PAYROLL-CHAPMAN CLAUDY EARL,D108,HJ,,1.78,10295.38
6175,12/31/2020,12/31/2020,123120,82L-IMPORT PAYROLL-CHAPMAN CLAUDY EARL,D108,HJ,,11.96,10283.42
6175,12/31/2020,12/31/2020,123120,82L-IMPORT PAYROLL-DADA ARIKPO E,D108,HJ,,5.23,10278.19
6175,12/31/2020,12/31/2020,123120,82L-IMPORT PAYROLL-DADA ARIKPO E,D108,HJ,,35.65,10242.54
6175,12/31/2020,12/31/2020,123120,82L-IMPORT PAYROLL-GUTHRIE LESLIE,D108,HJ,,1.78,10240.76
6175,12/31/2020,12/31/2020,123120,82L-IMPORT PAYROLL-GUTHRIE LESLIE,D108,HJ,,14.83,10225.93
6175,12/31/2020,12/31/2020,123120,82L-IMPORT PAYROLL-HOLMES JOREL ALEXANDER,D108,HJ,,1.78,10224.15
6175,12/31/2020,12/31/2020,123120,82L-IMPORT PAYROLL-HOLMES JOREL ALEXANDER,D108,HJ,,11.96,10212.19
6175,12/31/2020,12/31/2020,123120,82L-IMPORT PAYROLL-JORDAN TIFFANY T,D108,HJ,,5.23,10206.96
6175,12/31/2020,12/31/2020,123120,82L-IMPORT PAYROLL-JORDAN TIFFANY T,D108,HJ,,35.65,10171.31
6175,12/31/2020,12/31/2020,123120,82L-IMPORT PAYROLL-LANIGAN LISA A,D108,HJ,,3.56,10167.75
6175,12/31/2020,12/31/2020,123120,82L-IMPORT PAYROLL-ONICA ANTHONY J,D108,HJ,,1.78,10165.97
6175,12/31/2020,12/31/2020,123120,82L-IMPORT PAYROLL-ONICA ANTHONY J,D108,HJ,,11.96,10154.01
6175,12/31/2020,12/31/2020,123120,82L-IMPORT PAYROLL-PRAHIN NICOLE M,D108,HJ,,1.78,10152.23
6175,12/31/2020,12/31/2020,123120,82L-IMPORT PAYROLL-PRAHIN NICOLE M,D108,HJ,,11.96,10140.27
6175,12/31/2020,12/31/2020,123120,82L-IMPORT PAYROLL-SALIM YASSER,D108,HJ,,11.96,10128.31
6175,12/31/2020,12/31/2020,123120,82L-IMPORT PAYROLL-SEJOUR MAHALIAH,D108,HJ,,1.78,10126.53
6175,12/31/2020,12/31/2020,123120,82L-IMPORT PAYROLL-SEJOUR MAHALIAH,D108,HJ,,11.96,10114.57
6175,12/31/2020,12/31/2020,123120,82L-IMPORT PAYROLL-TUMENJARGAL ENKHJIN,D108,HJ,,1.78,10112.79
6175,12/31/2020,12/31/2020,123120,82L-IMPORT PAYROLL-TUMENJARGAL ENKHJIN,D108,HJ,,11.96,10100.83
6175,12/31/2020,12/31/2020,123120,82L-IMPORT PAYROLL-VILLEGAS EVELYN,D108,HJ,,5.23,10095.6
6175,12/31/2020,12/31/2020,123120,82L-IMPORT PAYROLL-VILLEGAS EVELYN,D108,HJ,,35.65,10059.95
6175,12/31/2020,12/31/2020,123120,82L-IMPORT PAYROLL-WOLF ANNA A,D108,HJ,,1.78,10058.17
6175,12/31/2020,12/31/2020,123120,82L-IMPORT PAYROLL-ACEVEDO MONIVETT,D107,HJ,,25.48,10032.69
6175,12/31/2020,12/31/2020,123120,82L-IMPORT PAYROLL-AKLESTAD ISABEL,D111,HJ,,1.78,10030.91
6175,12/31/2020,12/31/2020,123120,82L-IMPORT PAYROLL-AKLESTAD ISABEL,D111,HJ,,11.96,10018.95
6175,12/31/2020,12/31/2020,123120,82L-IMPORT PAYROLL-BIBB TIFFANI,D104,HJ,,1.78,10017.17
6175,12/31/2020,12/31/2020,123120,82L-IMPORT PAYROLL-BIBB TIFFANI,D104,HJ,,44.2,9972.97
6175,12/31/2020,12/31/2020,123120,82L-IMPORT PAYROLL-COOK CATHRYN ANNA,D105,HJ,,1.78,9971.19
6175,12/31/2020,12/31/2020,123120,82L-IMPORT PAYROLL-COOK CATHRYN ANNA,D105,HJ,,14.83,9956.36
6175,12/31/2020,12/31/2020,123120,82L-IMPORT PAYROLL-COOPER ASHLEE R,D101,HJ,,1.78,9954.58
6175,12/31/2020,12/31/2020,123120,82L-IMPORT PAYROLL-COOPER ASHLEE R,D101,HJ,,11.96,9942.62
6175,12/31/2020,12/31/2020,123120,82L-IMPORT PAYROLL-DETONE KYRA MAYA,D102,HJ,,1.78,9940.84
6175,12/31/2020,12/31/2020,123120,82L-IMPORT PAYROLL-DETONE KYRA MAYA,D102,HJ,,11.96,9928.88
6175,12/31/2020,12/31/2020,123120,82L-IMPORT PAYROLL-DUPUIS CHRISTOPHER M,D107,HJ,,1.78,9927.1
6175,12/31/2020,12/31/2020,123120,82L-IMPORT PAYROLL-DUPUIS CHRISTOPHER M,D107,HJ,,11.96,9915.14
6175,12/31/2020,12/31/2020,123120,82L-IMPORT PAYROLL-DZIEDZIC JULIE K,D101,HJ,,3.38,9911.76
6175,12/31/2020,12/31/2020,123120,82L-IMPORT PAYROLL-DZIEDZIC JULIE K,D101,HJ,,25.48,9886.28
6175,12/31/2020,12/31/2020,123120,82L-IMPORT PAYROLL-FISCHABER THOMAS,D109,HJ,,5.23,9881.05
6175,12/31/2020,12/31/2020,123120,82L-IMPORT PAYROLL-FISCHABER THOMAS,D109,HJ,,44.2,9836.85
6175,12/31/2020,12/31/2020,123120,82L-IMPORT PAYROLL-GUADARRAMA-ALVAREZ URIEL A,D105,HJ,,1.78,9835.07
6175,12/31/2020,12/31/2020,123120,82L-IMPORT PAYROLL-GUADARRAMA-ALVAREZ URIEL A,D105,HJ,,11.96,9823.11
6175,12/31/2020,12/31/2020,123120,82L-IMPORT PAYROLL-GUTIERREZ ANTONIO J,D107,HJ,,35.65,9787.46
6175,12/31/2020,12/31/2020,123120,82L-IMPORT PAYROLL-HERMAN ADAM,D102,HJ,,1.78,9785.68
6175,12/31/2020,12/31/2020,123120,82L-IMPORT PAYROLL-HERMAN ADAM,D102,HJ,,11.96,9773.72
6175,12/31/2020,12/31/2020,123120,82L-IMPORT PAYROLL-HOLT ADAM,D109,HJ,,1.78,9771.94
6175,12/31/2020,12/31/2020,123120,82L-IMPORT PAYROLL-HOLT ADAM,D109,HJ,,14.83,9757.11
6175,12/31/2020,12/31/2020,123120,82L-IMPORT PAYROLL-LIPORACE HERNAN LUIS,D103,HJ,,11.96,9745.15
6175,12/31/2020,12/31/2020,123120,82L-IMPORT PAYROLL-MARKS KRISTA,D109,HJ,,1.78,9743.37
6175,12/31/2020,12/31/2020,123120,82L-IMPORT PAYROLL-MARKS KRISTA,D109,HJ,,14.83,9728.54
6175,12/31/2020,12/31/2020,123120,82L-IMPORT PAYROLL-MELVIN DARNELL KEVIN,D109,HJ,,1.78,9726.76
6175,12/31/2020,12/31/2020,123120,82L-IMPORT PAYROLL-MELVIN DARNELL KEVIN,D109,HJ,,11.96,9714.8
6175,12/31/2020,12/31/2020,123120,82L-IMPORT PAYROLL-MESSING JENNIFER,D109,HJ,,1.78,9713.02
6175,12/31/2020,12/31/2020,123120,82L-IMPORT PAYROLL-MESSING JENNIFER,D109,HJ,,14.83,9698.19
6175,12/31/2020,12/31/2020,123120,82L-IMPORT PAYROLL-MILNE ROGER,D109,HJ,,1.78,9696.41
6175,12/31/2020,12/31/2020,123120,82L-IMPORT PAYROLL-MILNE ROGER,D109,HJ,,11.96,9684.45
6175,12/31/2020,12/31/2020,123120,82L-IMPORT PAYROLL-PARHAM-GANTT DENISE M,D112,HJ,,3.56,9680.89
6175,12/31/2020,12/31/2020,123120,82L-IMPORT PAYROLL-PARHAM-GANTT DENISE M,D112,HJ,,31.6,9649.29
6175,12/31/2020,12/31/2020,123120,82L-IMPORT PAYROLL-PEINADO ELIZABETH R,D111,HJ,,1.78,9647.51
6175,12/31/2020,12/31/2020,123120,82L-IMPORT PAYROLL-PEINADO ELIZABETH R,D111,HJ,,11.96,9635.55
6175,12/31/2020,12/31/2020,123120,82L-IMPORT PAYROLL-PERNIA JEFFREY,D109,HJ,,1.78,9633.77
6175,12/31/2020,12/31/2020,123120,82L-IMPORT PAYROLL-PERNIA JEFFREY,D109,HJ,,14.83,9618.94
6175,12/31/2020,12/31/2020,123120,82L-IMPORT PAYROLL-POLANCO ODALIS,D103,HJ,,1.78,9617.16
6175,12/31/2020,12/31/2020,123120,82L-IMPORT PAYROLL-POLANCO ODALIS,D103,HJ,,11.96,9605.2
6175,12/31/2020,12/31/2020,123120,82L-IMPORT PAYROLL-QUINTAS JASHIVE,D105,HJ,,1.78,9603.42
6175,12/31/2020,12/31/2020,123120,82L-IMPORT PAYROLL-QUINTAS JASHIVE,D105,HJ,,14.83,9588.59
6175,12/31/2020,12/31/2020,123120,82L-IMPORT PAYROLL-RANDOLPH ALEXANDER,D111,HJ,,1.78,9586.81
6175,12/31/2020,12/31/2020,123120,82L-IMPORT PAYROLL-RANDOLPH ALEXANDER,D111,HJ,,11.96,9574.85
6175,12/31/2020,12/31/2020,123120,82L-IMPORT PAYROLL-RUBI PERLA,D101,HJ,,14.83,9560.02
6175,12/31/2020,12/31/2020,123120,82L-IMPORT PAYROLL-SAFRAN ALAN P,D107,HJ,,5.23,9554.79
6175,12/31/2020,12/31/2020,123120,82L-IMPORT PAYROLL-SAFRAN ALAN P,D107,HJ,,35.65,9519.14
6175,12/31/2020,12/31/2020,123120,82L-IMPORT PAYROLL-WALLACE AMENA,D104,HJ,,11.96,9507.18
6175,12/31/2020,12/31/2020,123120,82L-IMPORT PAYROLL-WARD JEFFREY,D109,HJ,,5.23,9501.95
6175,12/31/2020,12/31/2020,123120,82L-IMPORT PAYROLL-WARD JEFFREY,D109,HJ,,44.2,9457.75
6175,12/31/2020,12/31/2020,123120,82L-IMPORT PAYROLL-WEINSTOCK EMILY,D101,HJ,,1.78,9455.97
6175,12/31/2020,12/31/2020,123120,82L-IMPORT PAYROLL-WEINSTOCK EMILY,D101,HJ,,11.96,9444.01
6175,12/31/2020,12/31/2020,123120,82L-IMPORT PAYROLL-BARTOLD DEANNA MARIE,D108,HJ,,1.78,9442.23
6175,12/31/2020,12/31/2020,123120,82L-IMPORT PAYROLL-BARTOLD DEANNA MARIE,D108,HJ,,11.96,9430.27
6175,12/31/2020,12/31/2020,123120,82L-IMPORT PAYROLL-BELLOT GENESIS,D108,HJ,,1.78,9428.49
6175,12/31/2020,12/31/2020,123120,82L-IMPORT PAYROLL-BELLOT GENESIS,D108,HJ,,14.83,9413.66
6175,12/31/2020,12/31/2020,123120,82L-IMPORT PAYROLL-BURRELL RUSSELL,D108,HJ,,1.78,9411.88
6175,12/31/2020,12/31/2020,123120,82L-IMPORT PAYROLL-BURRELL RUSSELL,D108,HJ,,11.96,9399.92
6175,12/31/2020,12/31/2020,123120,82L-IMPORT PAYROLL-FEIGHERY JOHN,D108,HJ,,11.96,9387.96
6175,12/31/2020,12/31/2020,123120,82L-IMPORT PAYROLL-GRIFFIN ANDREW,D108,HJ,,1.78,9386.18
6175,12/31/2020,12/31/2020,123120,82L-IMPORT PAYROLL-GRIFFIN ANDREW,D108,HJ,,11.96,9374.22
6175,12/31/2020,12/31/2020,123120,82L-IMPORT PAYROLL-GROSS EMILY,D108,HJ,,1.78,9372.44
6175,12/31/2020,12/31/2020,123120,82L-IMPORT PAYROLL-GROSS EMILY,D108,HJ,,14.83,9357.61
6175,12/31/2020,12/31/2020,123120,82L-IMPORT PAYROLL-HALLINAN GABRIEL,D108,HJ,,1.78,9355.83
6175,12/31/2020,12/31/2020,123120,82L-IMPORT PAYROLL-HALLINAN GABRIEL,D108,HJ,,11.96,9343.87
6175,12/31/2020,12/31/2020,123120,82L-IMPORT PAYROLL-HAMERSLY WILLIAM,D108,HJ,,1.78,9342.09
6175,12/31/2020,12/31/2020,123120,82L-IMPORT PAYROLL-HAMERSLY WILLIAM,D108,HJ,,11.96,9330.13
6175,12/31/2020,12/31/2020,123120,82L-IMPORT PAYROLL-HOSSAIN MYESHA,D108,HJ,,1.78,9328.35
6175,12/31/2020,12/31/2020,123120,82L-IMPORT PAYROLL-HOSSAIN MYESHA,D108,HJ,,14.83,9313.52
6175,12/31/2020,12/31/2020,123120,82L-IMPORT PAYROLL-JACKSON TASNIM F,D108,HJ,,1.78,9311.74
6175,12/31/2020,12/31/2020,123120,82L-IMPORT PAYROLL-JACKSON TASNIM F,D108,HJ,,14.83,9296.91
6175,12/31/2020,12/31/2020,123120,82L-IMPORT PAYROLL-LEARY AUBREY,D108,HJ,,1.78,9295.13
6175,12/31/2020,12/31/2020,123120,82L-IMPORT PAYROLL-LI BELLA,D108,HJ,,1.78,9293.35
6175,12/31/2020,12/31/2020,123120,82L-IMPORT PAYROLL-LI BELLA,D108,HJ,,11.96,9281.39
6175,12/31/2020,12/31/2020,123120,82L-IMPORT PAYROLL-OPUH NDIDI,D108,HJ,,1.78,9279.61
6175,12/31/2020,12/31/2020,123120,82L-IMPORT PAYROLL-OPUH NDIDI,D108,HJ,,35.65,9243.96
6175,12/31/2020,12/31/2020,123120,82L-IMPORT PAYROLL-SOBELMAN JUSTIN,D108,HJ,,1.78,9242.18
6175,12/31/2020,12/31/2020,123120,82L-IMPORT PAYROLL-SOBELMAN JUSTIN,D108,HJ,,11.96,9230.22
6175,12/31/2020,12/31/2020,123120,82L-IMPORT PAYROLL-TERRENCE-SMITH ZIHIR,D108,HJ,,1.78,9228.44
6175,12/31/2020,12/31/2020,123120,82L-IMPORT PAYROLL-TERRENCE-SMITH ZIHIR,D108,HJ,,14.83,9213.61
6175,12/31/2020,12/31/2020,123120,82L-IMPORT PAYROLL-WILLIAMS-MASSEY BRIANNA,D108,HJ,,11.96,9201.65
6175,12/31/2020,12/31/2020,123120,82L-IMPORT PAYROLL-COVENEY ALLISON,D108,HJ,,1.78,9199.87
6175,12/31/2020,12/31/2020,123120,82L-IMPORT PAYROLL-COVENEY ALLISON,D108,HJ,,14.83,9185.04
6175,12/31/2020,12/31/2020,123120,82L-IMPORT PAYROLL-JACKSON CLAICE M,D108,HJ,,1.78,9183.26
6175,12/31/2020,12/31/2020,123120,82L-IMPORT PAYROLL-JACKSON CLAICE M,D108,HJ,,11.96,9171.3
6175,12/31/2020,12/31/2020,123120,82L-IMPORT PAYROLL-JANG DANIEL,D108,HJ,,1.78,9169.52
6175,12/31/2020,12/31/2020,123120,82L-IMPORT PAYROLL-JANG DANIEL,D108,HJ,,14.83,9154.69
6175,12/31/2020,12/31/2020,123120,82L-IMPORT PAYROLL-LENEGHAN MARYELLEN,D108,HJ,,1.78,9152.91
6175,12/31/2020,12/31/2020,123120,82L-IMPORT PAYROLL-LENEGHAN MARYELLEN,D108,HJ,,11.96,9140.95
6175,1/4/2021,1/4/2021,BCBS,January 2021 BCBS Payment-BCBS - January 2021 BCBS,D108,HJ,855.24,,9996.19
6175,1/4/2021,1/4/2021,BCBS,January 2021 BCBS Payment-BCBS - January 2021 BCBS,D108,HJ,,1495.97,8500.22
6175,1/4/2021,1/4/2021,BCBS,January 2021 BCBS Payment-BCBS - January 2021 BCBS,D107,HJ,5409.12,,13909.34
6175,1/4/2021,1/4/2021,BCBS,January 2021 BCBS Payment-BCBS - January 2021 BCBS,D108,HJ,1159.82,,15069.16
6175,1/4/2021,1/4/2021,BCBS,January 2021 BCBS Payment-BCBS - January 2021 BCBS,D108,HJ,,125.96,14943.2
6175,1/5/2021,1/5/2021,JE-21-0146,Blue 20/20 Vision Insurance - January Inv LUX-Blue 20/20 Vision Insurance -January Inv LUX,D108,HJ,7.11,,14950.31
6175,1/5/2021,1/5/2021,JE-21-0147,Blue 20/20 Vision Insurance- January Inv 82L-Blue 20/20 Vision Insurance January Inv 82L,D108,HJ,105.94,,15056.25
6175,1/5/2021,1/5/2021,JE-21-0147,Blue 20/20 Vision Insurance- January Inv 82L-Blue 20/20 Vision Insurance January Inv 82L,D108,HJ,49.77,,15106.02
6175,1/5/2021,1/5/2021,JE-21-0147,Blue 20/20 Vision Insurance- January Inv 82L-Blue 20/20 Vision Insurance January Inv 82L,D107,HJ,56.04,,15162.06
6175,1/5/2021,1/5/2021,JE-21-0147,Blue 20/20 Vision Insurance- January Inv 82L-Blue 20/20 Vision Insurance January Inv 82L,D107,HJ,161.56,,15323.62
6175,1/5/2021,1/5/2021,JE-21-0147,Blue 20/20 Vision Insurance- January Inv 82L-Blue 20/20 Vision Insurance January Inv 82L,D108,HJ,85.32,,15408.94
6175,1/5/2021,1/5/2021,JE-21-0147,Blue 20/20 Vision Insurance- January Inv 82L-Blue 20/20 Vision Insurance January Inv 82L,D108,HJ,21.33,,15430.27
6175,1/15/2021,1/15/2021,11521,82L-IMPORT PAYROLL-BARTHELEMY RACHALIE,D108,HJ,,1.78,15428.49
6175,1/15/2021,1/15/2021,11521,82L-IMPORT PAYROLL-BARTHELEMY RACHALIE,D108,HJ,,14.83,15413.66
6175,1/15/2021,1/15/2021,11521,82L-IMPORT PAYROLL-BOHLSEN GRACE ISABELLE,D108,HJ,,1.78,15411.88
6175,1/15/2021,1/15/2021,11521,82L-IMPORT PAYROLL-BROWN ISAAC,D108,HJ,,1.78,15410.1
6175,1/15/2021,1/15/2021,11521,82L-IMPORT PAYROLL-BROWN ISAAC,D108,HJ,,14.83,15395.27
6175,1/15/2021,1/15/2021,11521,82L-IMPORT PAYROLL-KNOWLIN ZYLIA,D108,HJ,,1.78,15393.49
6175,1/15/2021,1/15/2021,11521,82L-IMPORT PAYROLL-KNOWLIN ZYLIA,D108,HJ,,14.83,15378.66
6175,1/15/2021,1/15/2021,11521,82L-IMPORT PAYROLL-KOPSHEVER MELISSA,D108,HJ,,3.38,15375.28
6175,1/15/2021,1/15/2021,11521,82L-IMPORT PAYROLL-LI SEN YUAN,D108,HJ,,1.78,15373.5
6175,1/15/2021,1/15/2021,11521,82L-IMPORT PAYROLL-LI SEN YUAN,D108,HJ,,11.96,15361.54
6175,1/15/2021,1/15/2021,11521,82L-IMPORT PAYROLL-LIPSCOMB STEPHEN,D108,HJ,,1.78,15359.76
6175,1/15/2021,1/15/2021,11521,82L-IMPORT PAYROLL-LIPSCOMB STEPHEN,D108,HJ,,11.96,15347.8
6175,1/15/2021,1/15/2021,11521,82L-IMPORT PAYROLL-MEJIA ROSO CARLOS,D108,HJ,,1.78,15346.02
6175,1/15/2021,1/15/2021,11521,82L-IMPORT PAYROLL-MEJIA ROSO CARLOS,D108,HJ,,14.83,15331.19
6175,1/15/2021,1/15/2021,11521,82L-IMPORT PAYROLL-SCOTT KIRK DONOVAN,D108,HJ,,1.78,15329.41
6175,1/15/2021,1/15/2021,11521,82L-IMPORT PAYROLL-SCOTT KIRK DONOVAN,D108,HJ,,11.96,15317.45
6175,1/15/2021,1/15/2021,11521,82L-IMPORT PAYROLL-SILVER KELLY,D108,HJ,,1.78,15315.67
6175,1/15/2021,1/15/2021,11521,82L-IMPORT PAYROLL-SILVER KELLY,D108,HJ,,14.83,15300.84
6175,1/15/2021,1/15/2021,11521,82L-IMPORT PAYROLL-STEIN KYLE,D108,HJ,,1.78,15299.06
6175,1/15/2021,1/15/2021,11521,82L-IMPORT PAYROLL-STEIN KYLE,D108,HJ,,11.96,15287.1
6175,1/15/2021,1/15/2021,11521,82L-IMPORT PAYROLL-STROUD DAVID,D108,HJ,,1.78,15285.32
6175,1/15/2021,1/15/2021,11521,82L-IMPORT PAYROLL-STROUD DAVID,D108,HJ,,14.83,15270.49
6175,1/15/2021,1/15/2021,11521,82L-IMPORT PAYROLL-WILLIAMS MACK ANTHONY,D108,HJ,,11.96,15258.53
6175,1/15/2021,1/15/2021,11521,82L-IMPORT PAYROLL-APULI LINDSAY,D108,HJ,,1.78,15256.75
6175,1/15/2021,1/15/2021,11521,82L-IMPORT PAYROLL-APULI LINDSAY,D108,HJ,,11.96,15244.79
6175,1/15/2021,1/15/2021,11521,82L-IMPORT PAYROLL-AUSTIN PERCY ANTONIO,D108,HJ,,1.78,15243.01
6175,1/15/2021,1/15/2021,11521,82L-IMPORT PAYROLL-AUSTIN PERCY ANTONIO,D108,HJ,,14.83,15228.18
6175,1/15/2021,1/15/2021,11521,82L-IMPORT PAYROLL-BUHMANN JENNIFER,D108,HJ,,1.78,15226.4
6175,1/15/2021,1/15/2021,11521,82L-IMPORT PAYROLL-CAIN CORY,D108,HJ,,1.78,15224.62
6175,1/15/2021,1/15/2021,11521,82L-IMPORT PAYROLL-CAIN CORY,D108,HJ,,14.83,15209.79
6175,1/15/2021,1/15/2021,11521,82L-IMPORT PAYROLL-CHAPMAN CLAUDY EARL,D108,HJ,,1.78,15208.01
6175,1/15/2021,1/15/2021,11521,82L-IMPORT PAYROLL-CHAPMAN CLAUDY EARL,D108,HJ,,11.96,15196.05
6175,1/15/2021,1/15/2021,11521,82L-IMPORT PAYROLL-DADA ARIKPO E,D108,HJ,,5.23,15190.82
6175,1/15/2021,1/15/2021,11521,82L-IMPORT PAYROLL-DADA ARIKPO E,D108,HJ,,35.65,15155.17
6175,1/15/2021,1/15/2021,11521,82L-IMPORT PAYROLL-GUTHRIE LESLIE,D108,HJ,,1.78,15153.39
6175,1/15/2021,1/15/2021,11521,82L-IMPORT PAYROLL-GUTHRIE LESLIE,D108,HJ,,14.83,15138.56
6175,1/15/2021,1/15/2021,11521,82L-IMPORT PAYROLL-HOLMES JOREL ALEXANDER,D108,HJ,,1.78,15136.78
6175,1/15/2021,1/15/2021,11521,82L-IMPORT PAYROLL-HOLMES JOREL ALEXANDER,D108,HJ,,11.96,15124.82
6175,1/15/2021,1/15/2021,11521,82L-IMPORT PAYROLL-JORDAN TIFFANY T,D108,HJ,,5.23,15119.59
6175,1/15/2021,1/15/2021,11521,82L-IMPORT PAYROLL-JORDAN TIFFANY T,D108,HJ,,35.65,15083.94
6175,1/15/2021,1/15/2021,11521,82L-IMPORT PAYROLL-LANIGAN LISA A,D108,HJ,,3.56,15080.38
6175,1/15/2021,1/15/2021,11521,82L-IMPORT PAYROLL-ONICA ANTHONY J,D108,HJ,,1.78,15078.6
6175,1/15/2021,1/15/2021,11521,82L-IMPORT PAYROLL-ONICA ANTHONY J,D108,HJ,,11.96,15066.64
6175,1/15/2021,1/15/2021,11521,82L-IMPORT PAYROLL-PRAHIN NICOLE M,D108,HJ,,1.78,15064.86
6175,1/15/2021,1/15/2021,11521,82L-IMPORT PAYROLL-PRAHIN NICOLE M,D108,HJ,,11.96,15052.9
6175,1/15/2021,1/15/2021,11521,82L-IMPORT PAYROLL-SALIM YASSER,D108,HJ,,11.96,15040.94
6175,1/15/2021,1/15/2021,11521,82L-IMPORT PAYROLL-SEJOUR MAHALIAH,D108,HJ,,1.78,15039.16
6175,1/15/2021,1/15/2021,11521,82L-IMPORT PAYROLL-SEJOUR MAHALIAH,D108,HJ,,11.96,15027.2
6175,1/15/2021,1/15/2021,11521,82L-IMPORT PAYROLL-TUMENJARGAL ENKHJIN,D108,HJ,,1.78,15025.42
6175,1/15/2021,1/15/2021,11521,82L-IMPORT PAYROLL-TUMENJARGAL ENKHJIN,D108,HJ,,11.96,15013.46
6175,1/15/2021,1/15/2021,11521,82L-IMPORT PAYROLL-VILLEGAS EVELYN,D108,HJ,,5.23,15008.23
6175,1/15/2021,1/15/2021,11521,82L-IMPORT PAYROLL-VILLEGAS EVELYN,D108,HJ,,35.65,14972.58
6175,1/15/2021,1/15/2021,11521,82L-IMPORT PAYROLL-WOLF ANNA A,D108,HJ,,1.78,14970.8
6175,1/15/2021,1/15/2021,11521,82L-IMPORT PAYROLL-ACEVEDO MONIVETT,D107,HJ,,25.48,14945.32
6175,1/15/2021,1/15/2021,11521,82L-IMPORT PAYROLL-AKLESTAD ISABEL,D111,HJ,,1.78,14943.54
6175,1/15/2021,1/15/2021,11521,82L-IMPORT PAYROLL-AKLESTAD ISABEL,D111,HJ,,11.96,14931.58
6175,1/15/2021,1/15/2021,11521,82L-IMPORT PAYROLL-BIBB TIFFANI,D104,HJ,,1.78,14929.8
6175,1/15/2021,1/15/2021,11521,82L-IMPORT PAYROLL-BIBB TIFFANI,D104,HJ,,44.2,14885.6
6175,1/15/2021,1/15/2021,11521,82L-IMPORT PAYROLL-COOK CATHRYN ANNA,D105,HJ,,1.78,14883.82
6175,1/15/2021,1/15/2021,11521,82L-IMPORT PAYROLL-COOK CATHRYN ANNA,D105,HJ,,14.83,14868.99
6175,1/15/2021,1/15/2021,11521,82L-IMPORT PAYROLL-COOPER ASHLEE R,D101,HJ,,1.78,14867.21
6175,1/15/2021,1/15/2021,11521,82L-IMPORT PAYROLL-COOPER ASHLEE R,D101,HJ,,11.96,14855.25
6175,1/15/2021,1/15/2021,11521,82L-IMPORT PAYROLL-DETONE KYRA MAYA,D102,HJ,,1.78,14853.47
6175,1/15/2021,1/15/2021,11521,82L-IMPORT PAYROLL-DETONE KYRA MAYA,D102,HJ,,11.96,14841.51
6175,1/15/2021,1/15/2021,11521,82L-IMPORT PAYROLL-DUPUIS CHRISTOPHER M,D107,HJ,,1.78,14839.73
6175,1/15/2021,1/15/2021,11521,82L-IMPORT PAYROLL-DUPUIS CHRISTOPHER M,D107,HJ,,11.96,14827.77
6175,1/15/2021,1/15/2021,11521,82L-IMPORT PAYROLL-DZIEDZIC JULIE K,D101,HJ,,3.38,14824.39
6175,1/15/2021,1/15/2021,11521,82L-IMPORT PAYROLL-DZIEDZIC JULIE K,D101,HJ,,25.48,14798.91
6175,1/15/2021,1/15/2021,11521,82L-IMPORT PAYROLL-FEENEY CLAIRE,D104,HJ,,1.78,14797.13
6175,1/15/2021,1/15/2021,11521,82L-IMPORT PAYROLL-FEENEY CLAIRE,D104,HJ,,11.96,14785.17
6175,1/15/2021,1/15/2021,11521,82L-IMPORT PAYROLL-FISCHABER THOMAS,D109,HJ,,5.23,14779.94
6175,1/15/2021,1/15/2021,11521,82L-IMPORT PAYROLL-FISCHABER THOMAS,D109,HJ,,44.2,14735.74
6175,1/15/2021,1/15/2021,11521,82L-IMPORT PAYROLL-GUADARRAMA-ALVAREZ URIEL A,D105,HJ,,1.78,14733.96
6175,1/15/2021,1/15/2021,11521,82L-IMPORT PAYROLL-GUADARRAMA-ALVAREZ URIEL A,D105,HJ,,11.96,14722
6175,1/15/2021,1/15/2021,11521,82L-IMPORT PAYROLL-GUTIERREZ ANTONIO J,D107,HJ,,35.65,14686.35
6175,1/15/2021,1/15/2021,11521,82L-IMPORT PAYROLL-HERMAN ADAM,D102,HJ,,1.78,14684.57
6175,1/15/2021,1/15/2021,11521,82L-IMPORT PAYROLL-HERMAN ADAM,D102,HJ,,11.96,14672.61
6175,1/15/2021,1/15/2021,11521,82L-IMPORT PAYROLL-HERNANDEZ ANNA,D101,HJ,,1.78,14670.83
6175,1/15/2021,1/15/2021,11521,82L-IMPORT PAYROLL-HERNANDEZ ANNA,D101,HJ,,11.96,14658.87
6175,1/15/2021,1/15/2021,11521,82L-IMPORT PAYROLL-HOLT ADAM,D109,HJ,,1.78,14657.09
6175,1/15/2021,1/15/2021,11521,82L-IMPORT PAYROLL-HOLT ADAM,D109,HJ,,14.83,14642.26
6175,1/15/2021,1/15/2021,11521,82L-IMPORT PAYROLL-LIPORACE HERNAN LUIS,D103,HJ,,11.96,14630.3
6175,1/15/2021,1/15/2021,11521,82L-IMPORT PAYROLL-MARKS KRISTA,D109,HJ,,1.78,14628.52
6175,1/15/2021,1/15/2021,11521,82L-IMPORT PAYROLL-MARKS KRISTA,D109,HJ,,14.83,14613.69
6175,1/15/2021,1/15/2021,11521,82L-IMPORT PAYROLL-MELVIN DARNELL KEVIN,D109,HJ,,1.78,14611.91
6175,1/15/2021,1/15/2021,11521,82L-IMPORT PAYROLL-MELVIN DARNELL KEVIN,D109,HJ,,11.96,14599.95
6175,1/15/2021,1/15/2021,11521,82L-IMPORT PAYROLL-MESSING JENNIFER,D104,HJ,,1.78,14598.17
6175,1/15/2021,1/15/2021,11521,82L-IMPORT PAYROLL-MESSING JENNIFER,D104,HJ,,14.83,14583.34
6175,1/15/2021,1/15/2021,11521,82L-IMPORT PAYROLL-MILNE ROGER,D109,HJ,,1.78,14581.56
6175,1/15/2021,1/15/2021,11521,82L-IMPORT PAYROLL-MILNE ROGER,D109,HJ,,11.96,14569.6
6175,1/15/2021,1/15/2021,11521,82L-IMPORT PAYROLL-PARHAM-GANTT DENISE M,D112,HJ,,3.56,14566.04
6175,1/15/2021,1/15/2021,11521,82L-IMPORT PAYROLL-PARHAM-GANTT DENISE M,D112,HJ,,31.6,14534.44
6175,1/15/2021,1/15/2021,11521,82L-IMPORT PAYROLL-PEINADO ELIZABETH R,D111,HJ,,1.78,14532.66
6175,1/15/2021,1/15/2021,11521,82L-IMPORT PAYROLL-PEINADO ELIZABETH R,D111,HJ,,11.96,14520.7
6175,1/15/2021,1/15/2021,11521,82L-IMPORT PAYROLL-PERNIA JEFFREY,D109,HJ,,1.78,14518.92
6175,1/15/2021,1/15/2021,11521,82L-IMPORT PAYROLL-PERNIA JEFFREY,D109,HJ,,14.83,14504.09
6175,1/15/2021,1/15/2021,11521,82L-IMPORT PAYROLL-POLANCO ODALIS,D103,HJ,,1.78,14502.31
6175,1/15/2021,1/15/2021,11521,82L-IMPORT PAYROLL-POLANCO ODALIS,D103,HJ,,11.96,14490.35
6175,1/15/2021,1/15/2021,11521,82L-IMPORT PAYROLL-QUINTAS JASHIVE,D105,HJ,,1.78,14488.57
6175,1/15/2021,1/15/2021,11521,82L-IMPORT PAYROLL-QUINTAS JASHIVE,D105,HJ,,14.83,14473.74
6175,1/15/2021,1/15/2021,11521,82L-IMPORT PAYROLL-RANDOLPH ALEXANDER,D111,HJ,,1.78,14471.96
6175,1/15/2021,1/15/2021,11521,82L-IMPORT PAYROLL-RANDOLPH ALEXANDER,D111,HJ,,11.96,14460
6175,1/15/2021,1/15/2021,11521,82L-IMPORT PAYROLL-RUBI PERLA,D101,HJ,,14.83,14445.17
6175,1/15/2021,1/15/2021,11521,82L-IMPORT PAYROLL-SAFRAN ALAN P,D107,HJ,,5.23,14439.94
6175,1/15/2021,1/15/2021,11521,82L-IMPORT PAYROLL-SAFRAN ALAN P,D107,HJ,,35.65,14404.29
6175,1/15/2021,1/15/2021,11521,82L-IMPORT PAYROLL-WALLACE AMENA,D104,HJ,,11.96,14392.33
6175,1/15/2021,1/15/2021,11521,82L-IMPORT PAYROLL-WARD JEFFREY,D109,HJ,,5.23,14387.1
6175,1/15/2021,1/15/2021,11521,82L-IMPORT PAYROLL-WARD JEFFREY,D109,HJ,,44.2,14342.9
6175,1/15/2021,1/15/2021,11521,82L-IMPORT PAYROLL-WEINSTOCK EMILY,D101,HJ,,1.78,14341.12
6175,1/15/2021,1/15/2021,11521,82L-IMPORT PAYROLL-WEINSTOCK EMILY,D101,HJ,,11.96,14329.16
6175,1/15/2021,1/15/2021,11521,82L-IMPORT PAYROLL-BARTOLD DEANNA MARIE,D108,HJ,,1.78,14327.38
6175,1/15/2021,1/15/2021,11521,82L-IMPORT PAYROLL-BARTOLD DEANNA MARIE,D108,HJ,,11.96,14315.42
6175,1/15/2021,1/15/2021,11521,82L-IMPORT PAYROLL-BELLOT GENESIS,D108,HJ,,1.78,14313.64
6175,1/15/2021,1/15/2021,11521,82L-IMPORT PAYROLL-BELLOT GENESIS,D108,HJ,,14.83,14298.81
6175,1/15/2021,1/15/2021,11521,82L-IMPORT PAYROLL-BURRELL RUSSELL,D108,HJ,,1.78,14297.03
6175,1/15/2021,1/15/2021,11521,82L-IMPORT PAYROLL-BURRELL RUSSELL,D108,HJ,,11.96,14285.07
6175,1/15/2021,1/15/2021,11521,82L-IMPORT PAYROLL-FEIGHERY JOHN,D108,HJ,,11.96,14273.11
6175,1/15/2021,1/15/2021,11521,82L-IMPORT PAYROLL-GRIFFIN ANDREW,D108,HJ,,1.78,14271.33
6175,1/15/2021,1/15/2021,11521,82L-IMPORT PAYROLL-GRIFFIN ANDREW,D108,HJ,,11.96,14259.37
6175,1/15/2021,1/15/2021,11521,82L-IMPORT PAYROLL-GROSS EMILY,D108,HJ,,1.78,14257.59
6175,1/15/2021,1/15/2021,11521,82L-IMPORT PAYROLL-GROSS EMILY,D108,HJ,,14.83,14242.76
6175,1/15/2021,1/15/2021,11521,82L-IMPORT PAYROLL-HALLINAN GABRIEL,D108,HJ,,1.78,14240.98
6175,1/15/2021,1/15/2021,11521,82L-IMPORT PAYROLL-HALLINAN GABRIEL,D108,HJ,,11.96,14229.02
6175,1/15/2021,1/15/2021,11521,82L-IMPORT PAYROLL-HAMERSLY WILLIAM,D108,HJ,,1.78,14227.24
6175,1/15/2021,1/15/2021,11521,82L-IMPORT PAYROLL-HAMERSLY WILLIAM,D108,HJ,,11.96,14215.28
6175,1/15/2021,1/15/2021,11521,82L-IMPORT PAYROLL-HOSSAIN MYESHA,D108,HJ,,1.78,14213.5
6175,1/15/2021,1/15/2021,11521,82L-IMPORT PAYROLL-HOSSAIN MYESHA,D108,HJ,,14.83,14198.67
6175,1/15/2021,1/15/2021,11521,82L-IMPORT PAYROLL-JACKSON TASNIM F,D108,HJ,,1.78,14196.89
6175,1/15/2021,1/15/2021,11521,82L-IMPORT PAYROLL-JACKSON TASNIM F,D108,HJ,,14.83,14182.06
6175,1/15/2021,1/15/2021,11521,82L-IMPORT PAYROLL-LEARY AUBREY,D108,HJ,,1.78,14180.28
6175,1/15/2021,1/15/2021,11521,82L-IMPORT PAYROLL-LI BELLA,D108,HJ,,1.78,14178.5
6175,1/15/2021,1/15/2021,11521,82L-IMPORT PAYROLL-LI BELLA,D108,HJ,,11.96,14166.54
6175,1/15/2021,1/15/2021,11521,82L-IMPORT PAYROLL-OPUH NDIDI,D108,HJ,,1.78,14164.76
6175,1/15/2021,1/15/2021,11521,82L-IMPORT PAYROLL-OPUH NDIDI,D108,HJ,,35.65,14129.11
6175,1/15/2021,1/15/2021,11521,82L-IMPORT PAYROLL-SOBELMAN JUSTIN,D108,HJ,,1.78,14127.33
6175,1/15/2021,1/15/2021,11521,82L-IMPORT PAYROLL-SOBELMAN JUSTIN,D108,HJ,,11.96,14115.37
6175,1/15/2021,1/15/2021,11521,82L-IMPORT PAYROLL-TERRENCE-SMITH ZIHIR,D108,HJ,,1.78,14113.59
6175,1/15/2021,1/15/2021,11521,82L-IMPORT PAYROLL-TERRENCE-SMITH ZIHIR,D108,HJ,,14.83,14098.76
6175,1/15/2021,1/15/2021,11521,82L-IMPORT PAYROLL-WILLIAMS-MASSEY BRIANNA,D108,HJ,,11.96,14086.8
6175,1/15/2021,1/15/2021,11521,82L-IMPORT PAYROLL-COVENEY ALLISON,D108,HJ,,1.78,14085.02
6175,1/15/2021,1/15/2021,11521,82L-IMPORT PAYROLL-COVENEY ALLISON,D108,HJ,,14.83,14070.19
6175,1/15/2021,1/15/2021,11521,82L-IMPORT PAYROLL-JACKSON CLAICE M,D108,HJ,,1.78,14068.41
6175,1/15/2021,1/15/2021,11521,82L-IMPORT PAYROLL-JACKSON CLAICE M,D108,HJ,,11.96,14056.45
6175,1/15/2021,1/15/2021,11521,82L-IMPORT PAYROLL-JANG DANIEL,D108,HJ,,1.78,14054.67
6175,1/15/2021,1/15/2021,11521,82L-IMPORT PAYROLL-JANG DANIEL,D108,HJ,,14.83,14039.84
6175,1/15/2021,1/15/2021,11521,82L-IMPORT PAYROLL-LENEGHAN MARYELLEN,D108,HJ,,1.78,14038.06
6175,1/15/2021,1/15/2021,11521,82L-IMPORT PAYROLL-LENEGHAN MARYELLEN,D108,HJ,,11.96,14026.1
6175,1/29/2021,1/29/2021,12921,82L-IMPORT PAYROLL-BARTHELEMY RACHALIE,D108,HJ,,1.78,14024.32
6175,1/29/2021,1/29/2021,12921,82L-IMPORT PAYROLL-BARTHELEMY RACHALIE,D108,HJ,,14.83,14009.49
6175,1/29/2021,1/29/2021,12921,82L-IMPORT PAYROLL-BOHLSEN GRACE ISABELLE,D108,HJ,,1.78,14007.71
6175,1/29/2021,1/29/2021,12921,82L-IMPORT PAYROLL-BROWN ISAAC,D108,HJ,,1.78,14005.93
6175,1/29/2021,1/29/2021,12921,82L-IMPORT PAYROLL-BROWN ISAAC,D108,HJ,,14.83,13991.1
6175,1/29/2021,1/29/2021,12921,82L-IMPORT PAYROLL-KNOWLIN ZYLIA,D108,HJ,,5.23,13985.87
6175,1/29/2021,1/29/2021,12921,82L-IMPORT PAYROLL-KNOWLIN ZYLIA,D108,HJ,,44.2,13941.67
6175,1/29/2021,1/29/2021,12921,82L-IMPORT PAYROLL-KOPSHEVER MELISSA,D108,HJ,,3.38,13938.29
6175,1/29/2021,1/29/2021,12921,82L-IMPORT PAYROLL-LI SEN YUAN,D108,HJ,,1.78,13936.51
6175,1/29/2021,1/29/2021,12921,82L-IMPORT PAYROLL-LI SEN YUAN,D108,HJ,,11.96,13924.55
6175,1/29/2021,1/29/2021,12921,82L-IMPORT PAYROLL-LIPSCOMB STEPHEN,D108,HJ,,1.78,13922.77
6175,1/29/2021,1/29/2021,12921,82L-IMPORT PAYROLL-LIPSCOMB STEPHEN,D108,HJ,,11.96,13910.81
6175,1/29/2021,1/29/2021,12921,82L-IMPORT PAYROLL-MEJIA ROSO CARLOS,D108,HJ,,1.78,13909.03
6175,1/29/2021,1/29/2021,12921,82L-IMPORT PAYROLL-MEJIA ROSO CARLOS,D108,HJ,,14.83,13894.2
6175,1/29/2021,1/29/2021,12921,82L-IMPORT PAYROLL-SCOTT KIRK DONOVAN,D108,HJ,,1.78,13892.42
6175,1/29/2021,1/29/2021,12921,82L-IMPORT PAYROLL-SCOTT KIRK DONOVAN,D108,HJ,,11.96,13880.46
6175,1/29/2021,1/29/2021,12921,82L-IMPORT PAYROLL-SILVER KELLY,D108,HJ,,1.78,13878.68
6175,1/29/2021,1/29/2021,12921,82L-IMPORT PAYROLL-SILVER KELLY,D108,HJ,,14.83,13863.85
6175,1/29/2021,1/29/2021,12921,82L-IMPORT PAYROLL-STEIN KYLE,D108,HJ,,1.78,13862.07
6175,1/29/2021,1/29/2021,12921,82L-IMPORT PAYROLL-STEIN KYLE,D108,HJ,,11.96,13850.11
6175,1/29/2021,1/29/2021,12921,82L-IMPORT PAYROLL-STROUD DAVID,D108,HJ,,1.78,13848.33
6175,1/29/2021,1/29/2021,12921,82L-IMPORT PAYROLL-STROUD DAVID,D108,HJ,,14.83,13833.5
6175,1/29/2021,1/29/2021,12921,82L-IMPORT PAYROLL-WILLIAMS MACK ANTHONY,D108,HJ,,11.96,13821.54
6175,1/29/2021,1/29/2021,12921,82L-IMPORT PAYROLL-APULI LINDSAY,D108,HJ,,1.78,13819.76
6175,1/29/2021,1/29/2021,12921,82L-IMPORT PAYROLL-APULI LINDSAY,D108,HJ,,11.96,13807.8
6175,1/29/2021,1/29/2021,12921,82L-IMPORT PAYROLL-AUSTIN PERCY ANTONIO,D108,HJ,,1.78,13806.02
6175,1/29/2021,1/29/2021,12921,82L-IMPORT PAYROLL-AUSTIN PERCY ANTONIO,D108,HJ,,14.83,13791.19
6175,1/29/2021,1/29/2021,12921,82L-IMPORT PAYROLL-BUHMANN JENNIFER,D108,HJ,,1.78,13789.41
6175,1/29/2021,1/29/2021,12921,82L-IMPORT PAYROLL-CAIN CORY,D108,HJ,,1.78,13787.63
6175,1/29/2021,1/29/2021,12921,82L-IMPORT PAYROLL-CAIN CORY,D108,HJ,,14.83,13772.8
6175,1/29/2021,1/29/2021,12921,82L-IMPORT PAYROLL-CHAPMAN CLAUDY EARL,D108,HJ,,1.78,13771.02
6175,1/29/2021,1/29/2021,12921,82L-IMPORT PAYROLL-CHAPMAN CLAUDY EARL,D108,HJ,,11.96,13759.06
6175,1/29/2021,1/29/2021,12921,82L-IMPORT PAYROLL-DADA ARIKPO E,D108,HJ,,5.23,13753.83
6175,1/29/2021,1/29/2021,12921,82L-IMPORT PAYROLL-DADA ARIKPO E,D108,HJ,,35.65,13718.18
6175,1/29/2021,1/29/2021,12921,82L-IMPORT PAYROLL-GUTHRIE LESLIE,D108,HJ,,1.78,13716.4
6175,1/29/2021,1/29/2021,12921,82L-IMPORT PAYROLL-GUTHRIE LESLIE,D108,HJ,,14.83,13701.57
6175,1/29/2021,1/29/2021,12921,82L-IMPORT PAYROLL-HOLMES JOREL ALEXANDER,D108,HJ,,1.78,13699.79
6175,1/29/2021,1/29/2021,12921,82L-IMPORT PAYROLL-HOLMES JOREL ALEXANDER,D108,HJ,,11.96,13687.83
6175,1/29/2021,1/29/2021,12921,82L-IMPORT PAYROLL-JORDAN TIFFANY T,D108,HJ,,5.23,13682.6
6175,1/29/2021,1/29/2021,12921,82L-IMPORT PAYROLL-JORDAN TIFFANY T,D108,HJ,,35.65,13646.95
6175,1/29/2021,1/29/2021,12921,82L-IMPORT PAYROLL-LANIGAN LISA A,D108,HJ,,3.56,13643.39
6175,1/29/2021,1/29/2021,12921,82L-IMPORT PAYROLL-ONICA ANTHONY J,D108,HJ,,1.78,13641.61
6175,1/29/2021,1/29/2021,12921,82L-IMPORT PAYROLL-ONICA ANTHONY J,D108,HJ,,11.96,13629.65
6175,1/29/2021,1/29/2021,12921,82L-IMPORT PAYROLL-PRAHIN NICOLE M,D108,HJ,,1.78,13627.87
6175,1/29/2021,1/29/2021,12921,82L-IMPORT PAYROLL-PRAHIN NICOLE M,D108,HJ,,11.96,13615.91
6175,1/29/2021,1/29/2021,12921,82L-IMPORT PAYROLL-SALIM YASSER,D108,HJ,,11.96,13603.95
6175,1/29/2021,1/29/2021,12921,82L-IMPORT PAYROLL-SEJOUR MAHALIAH,D108,HJ,,1.78,13602.17
6175,1/29/2021,1/29/2021,12921,82L-IMPORT PAYROLL-SEJOUR MAHALIAH,D108,HJ,,11.96,13590.21
6175,1/29/2021,1/29/2021,12921,82L-IMPORT PAYROLL-TUMENJARGAL ENKHJIN,D108,HJ,,1.78,13588.43
6175,1/29/2021,1/29/2021,12921,82L-IMPORT PAYROLL-TUMENJARGAL ENKHJIN,D108,HJ,,11.96,13576.47
6175,1/29/2021,1/29/2021,12921,82L-IMPORT PAYROLL-VILLEGAS EVELYN,D108,HJ,,5.23,13571.24
6175,1/29/2021,1/29/2021,12921,82L-IMPORT PAYROLL-VILLEGAS EVELYN,D108,HJ,,35.65,13535.59
6175,1/29/2021,1/29/2021,12921,82L-IMPORT PAYROLL-WOLF ANNA A,D108,HJ,,1.78,13533.81
6175,1/29/2021,1/29/2021,12921,82L-IMPORT PAYROLL-ACEVEDO MONIVETT,D107,HJ,,25.48,13508.33
6175,1/29/2021,1/29/2021,12921,82L-IMPORT PAYROLL-AKLESTAD ISABEL,D111,HJ,,1.78,13506.55
6175,1/29/2021,1/29/2021,12921,82L-IMPORT PAYROLL-AKLESTAD ISABEL,D111,HJ,,11.96,13494.59
6175,1/29/2021,1/29/2021,12921,82L-IMPORT PAYROLL-BIBB TIFFANI,D104,HJ,,1.78,13492.81
6175,1/29/2021,1/29/2021,12921,82L-IMPORT PAYROLL-BIBB TIFFANI,D104,HJ,,44.2,13448.61
6175,1/29/2021,1/29/2021,12921,82L-IMPORT PAYROLL-COOK CATHRYN ANNA,D105,HJ,,1.78,13446.83
6175,1/29/2021,1/29/2021,12921,82L-IMPORT PAYROLL-COOK CATHRYN ANNA,D105,HJ,,14.83,13432
6175,1/29/2021,1/29/2021,12921,82L-IMPORT PAYROLL-COOPER ASHLEE R,D101,HJ,,1.78,13430.22
6175,1/29/2021,1/29/2021,12921,82L-IMPORT PAYROLL-COOPER ASHLEE R,D101,HJ,,11.96,13418.26
6175,1/29/2021,1/29/2021,12921,82L-IMPORT PAYROLL-DETONE KYRA MAYA,D102,HJ,,1.78,13416.48
6175,1/29/2021,1/29/2021,12921,82L-IMPORT PAYROLL-DETONE KYRA MAYA,D102,HJ,,11.96,13404.52
6175,1/29/2021,1/29/2021,12921,82L-IMPORT PAYROLL-DUPUIS CHRISTOPHER M,D107,HJ,,1.78,13402.74
6175,1/29/2021,1/29/2021,12921,82L-IMPORT PAYROLL-DUPUIS CHRISTOPHER M,D107,HJ,,11.96,13390.78
6175,1/29/2021,1/29/2021,12921,82L-IMPORT PAYROLL-DZIEDZIC JULIE K,D101,HJ,,3.38,13387.4
6175,1/29/2021,1/29/2021,12921,82L-IMPORT PAYROLL-DZIEDZIC JULIE K,D101,HJ,,25.48,13361.92
6175,1/29/2021,1/29/2021,12921,82L-IMPORT PAYROLL-FEENEY CLAIRE,D104,HJ,,1.78,13360.14
6175,1/29/2021,1/29/2021,12921,82L-IMPORT PAYROLL-FEENEY CLAIRE,D104,HJ,,11.96,13348.18
6175,1/29/2021,1/29/2021,12921,82L-IMPORT PAYROLL-FISCHABER THOMAS,D109,HJ,,5.23,13342.95
6175,1/29/2021,1/29/2021,12921,82L-IMPORT PAYROLL-FISCHABER THOMAS,D109,HJ,,44.2,13298.75
6175,1/29/2021,1/29/2021,12921,82L-IMPORT PAYROLL-GUADARRAMA-ALVAREZ URIEL A,D105,HJ,,1.78,13296.97
6175,1/29/2021,1/29/2021,12921,82L-IMPORT PAYROLL-GUADARRAMA-ALVAREZ URIEL A,D105,HJ,,11.96,13285.01
6175,1/29/2021,1/29/2021,12921,82L-IMPORT PAYROLL-GUTIERREZ ANTONIO J,D107,HJ,,35.65,13249.36
6175,1/29/2021,1/29/2021,12921,82L-IMPORT PAYROLL-HERMAN ADAM,D102,HJ,,1.78,13247.58
6175,1/29/2021,1/29/2021,12921,82L-IMPORT PAYROLL-HERMAN ADAM,D102,HJ,,11.96,13235.62
6175,1/29/2021,1/29/2021,12921,82L-IMPORT PAYROLL-HERNANDEZ ANNA,D101,HJ,,1.78,13233.84
6175,1/29/2021,1/29/2021,12921,82L-IMPORT PAYROLL-HERNANDEZ ANNA,D101,HJ,,11.96,13221.88
6175,1/29/2021,1/29/2021,12921,82L-IMPORT PAYROLL-HOLT ADAM,D109,HJ,,1.78,13220.1
6175,1/29/2021,1/29/2021,12921,82L-IMPORT PAYROLL-HOLT ADAM,D109,HJ,,14.83,13205.27
6175,1/29/2021,1/29/2021,12921,82L-IMPORT PAYROLL-LIPORACE HERNAN LUIS,D103,HJ,,11.96,13193.31
6175,1/29/2021,1/29/2021,12921,82L-IMPORT PAYROLL-MARKS KRISTA,D109,HJ,,1.78,13191.53
6175,1/29/2021,1/29/2021,12921,82L-IMPORT PAYROLL-MARKS KRISTA,D109,HJ,,14.83,13176.7
6175,1/29/2021,1/29/2021,12921,82L-IMPORT PAYROLL-MELVIN DARNELL KEVIN,D109,HJ,,1.78,13174.92
6175,1/29/2021,1/29/2021,12921,82L-IMPORT PAYROLL-MELVIN DARNELL KEVIN,D109,HJ,,11.96,13162.96
6175,1/29/2021,1/29/2021,12921,82L-IMPORT PAYROLL-MESSING JENNIFER,D104,HJ,,1.78,13161.18
6175,1/29/2021,1/29/2021,12921,82L-IMPORT PAYROLL-MESSING JENNIFER,D104,HJ,,14.83,13146.35
6175,1/29/2021,1/29/2021,12921,82L-IMPORT PAYROLL-MILNE ROGER,D109,HJ,,1.78,13144.57
6175,1/29/2021,1/29/2021,12921,82L-IMPORT PAYROLL-MILNE ROGER,D109,HJ,,11.96,13132.61
6175,1/29/2021,1/29/2021,12921,82L-IMPORT PAYROLL-O'DONNELL STEPHEN,D104,HJ,,1.78,13130.83
6175,1/29/2021,1/29/2021,12921,82L-IMPORT PAYROLL-O'DONNELL STEPHEN,D104,HJ,,14.83,13116
6175,1/29/2021,1/29/2021,12921,82L-IMPORT PAYROLL-PARHAM-GANTT DENISE M,D112,HJ,,3.56,13112.44
6175,1/29/2021,1/29/2021,12921,82L-IMPORT PAYROLL-PARHAM-GANTT DENISE M,D112,HJ,,31.6,13080.84
6175,1/29/2021,1/29/2021,12921,82L-IMPORT PAYROLL-PEINADO ELIZABETH R,D111,HJ,,1.78,13079.06
6175,1/29/2021,1/29/2021,12921,82L-IMPORT PAYROLL-PEINADO ELIZABETH R,D111,HJ,,11.96,13067.1
6175,1/29/2021,1/29/2021,12921,82L-IMPORT PAYROLL-PERNIA JEFFREY,D109,HJ,,1.78,13065.32
6175,1/29/2021,1/29/2021,12921,82L-IMPORT PAYROLL-PERNIA JEFFREY,D109,HJ,,14.83,13050.49
6175,1/29/2021,1/29/2021,12921,82L-IMPORT PAYROLL-POLANCO ODALIS,D103,HJ,,1.78,13048.71
6175,1/29/2021,1/29/2021,12921,82L-IMPORT PAYROLL-POLANCO ODALIS,D103,HJ,,11.96,13036.75
6175,1/29/2021,1/29/2021,12921,82L-IMPORT PAYROLL-QUINTAS JASHIVE,D105,HJ,,1.78,13034.97
6175,1/29/2021,1/29/2021,12921,82L-IMPORT PAYROLL-QUINTAS JASHIVE,D105,HJ,,14.83,13020.14
6175,1/29/2021,1/29/2021,12921,82L-IMPORT PAYROLL-RANDOLPH ALEXANDER,D111,HJ,,1.78,13018.36
6175,1/29/2021,1/29/2021,12921,82L-IMPORT PAYROLL-RANDOLPH ALEXANDER,D111,HJ,,11.96,13006.4
6175,1/29/2021,1/29/2021,12921,82L-IMPORT PAYROLL-RUBI PERLA,D101,HJ,,14.83,12991.57
6175,1/29/2021,1/29/2021,12921,82L-IMPORT PAYROLL-SAFRAN ALAN P,D107,HJ,,5.23,12986.34
6175,1/29/2021,1/29/2021,12921,82L-IMPORT PAYROLL-SAFRAN ALAN P,D107,HJ,,35.65,12950.69
6175,1/29/2021,1/29/2021,12921,82L-IMPORT PAYROLL-WALLACE AMENA,D104,HJ,,11.96,12938.73
6175,1/29/2021,1/29/2021,12921,82L-IMPORT PAYROLL-WARD JEFFREY,D109,HJ,,5.23,12933.5
6175,1/29/2021,1/29/2021,12921,82L-IMPORT PAYROLL-WARD JEFFREY,D109,HJ,,44.2,12889.3
6175,1/29/2021,1/29/2021,12921,82L-IMPORT PAYROLL-WEINSTOCK EMILY,D101,HJ,,1.78,12887.52
6175,1/29/2021,1/29/2021,12921,82L-IMPORT PAYROLL-WEINSTOCK EMILY,D101,HJ,,11.96,12875.56
6175,1/29/2021,1/29/2021,12921,82L-IMPORT PAYROLL-BARTOLD DEANNA MARIE,D108,HJ,,1.78,12873.78
6175,1/29/2021,1/29/2021,12921,82L-IMPORT PAYROLL-BARTOLD DEANNA MARIE,D108,HJ,,11.96,12861.82
6175,1/29/2021,1/29/2021,12921,82L-IMPORT PAYROLL-BELLOT GENESIS,D108,HJ,,1.78,12860.04
6175,1/29/2021,1/29/2021,12921,82L-IMPORT PAYROLL-BELLOT GENESIS,D108,HJ,,14.83,12845.21
6175,1/29/2021,1/29/2021,12921,82L-IMPORT PAYROLL-BURRELL RUSSELL,D108,HJ,,1.78,12843.43
6175,1/29/2021,1/29/2021,12921,82L-IMPORT PAYROLL-BURRELL RUSSELL,D108,HJ,,11.96,12831.47
6175,1/29/2021,1/29/2021,12921,82L-IMPORT PAYROLL-FEIGHERY JOHN,D108,HJ,,11.96,12819.51
6175,1/29/2021,1/29/2021,12921,82L-IMPORT PAYROLL-GRIFFIN ANDREW,D108,HJ,,1.78,12817.73
6175,1/29/2021,1/29/2021,12921,82L-IMPORT PAYROLL-GRIFFIN ANDREW,D108,HJ,,11.96,12805.77
6175,1/29/2021,1/29/2021,12921,82L-IMPORT PAYROLL-GROSS EMILY,D108,HJ,,1.78,12803.99
6175,1/29/2021,1/29/2021,12921,82L-IMPORT PAYROLL-GROSS EMILY,D108,HJ,,14.83,12789.16
6175,1/29/2021,1/29/2021,12921,82L-IMPORT PAYROLL-HALLINAN GABRIEL,D108,HJ,,1.78,12787.38
6175,1/29/2021,1/29/2021,12921,82L-IMPORT PAYROLL-HALLINAN GABRIEL,D108,HJ,,11.96,12775.42
6175,1/29/2021,1/29/2021,12921,82L-IMPORT PAYROLL-HAMERSLY WILLIAM,D108,HJ,,1.78,12773.64
6175,1/29/2021,1/29/2021,12921,82L-IMPORT PAYROLL-HAMERSLY WILLIAM,D108,HJ,,11.96,12761.68
6175,1/29/2021,1/29/2021,12921,82L-IMPORT PAYROLL-HOSSAIN MYESHA,D108,HJ,,1.78,12759.9
6175,1/29/2021,1/29/2021,12921,82L-IMPORT PAYROLL-HOSSAIN MYESHA,D108,HJ,,14.83,12745.07
6175,1/29/2021,1/29/2021,12921,82L-IMPORT PAYROLL-JACKSON TASNIM F,D108,HJ,,1.78,12743.29
6175,1/29/2021,1/29/2021,12921,82L-IMPORT PAYROLL-JACKSON TASNIM F,D108,HJ,,14.83,12728.46
6175,1/29/2021,1/29/2021,12921,82L-IMPORT PAYROLL-LEARY AUBREY,D108,HJ,,1.78,12726.68
6175,1/29/2021,1/29/2021,12921,82L-IMPORT PAYROLL-LI BELLA,D108,HJ,,1.78,12724.9
6175,1/29/2021,1/29/2021,12921,82L-IMPORT PAYROLL-LI BELLA,D108,HJ,,11.96,12712.94
6175,1/29/2021,1/29/2021,12921,82L-IMPORT PAYROLL-OPUH NDIDI,D108,HJ,,1.78,12711.16
6175,1/29/2021,1/29/2021,12921,82L-IMPORT PAYROLL-OPUH NDIDI,D108,HJ,,35.65,12675.51
6175,1/29/2021,1/29/2021,12921,82L-IMPORT PAYROLL-SOBELMAN JUSTIN,D108,HJ,,1.78,12673.73
6175,1/29/2021,1/29/2021,12921,82L-IMPORT PAYROLL-SOBELMAN JUSTIN,D108,HJ,,11.96,12661.77
6175,1/29/2021,1/29/2021,12921,82L-IMPORT PAYROLL-TERRENCE-SMITH ZIHIR,D108,HJ,,1.78,12659.99
6175,1/29/2021,1/29/2021,12921,82L-IMPORT PAYROLL-TERRENCE-SMITH ZIHIR,D108,HJ,,14.83,12645.16
6175,1/29/2021,1/29/2021,12921,82L-IMPORT PAYROLL-WILLIAMS-MASSEY BRIANNA,D108,HJ,,11.96,12633.2
6175,1/29/2021,1/29/2021,12921,82L-IMPORT PAYROLL-COVENEY ALLISON,D108,HJ,,1.78,12631.42
6175,1/29/2021,1/29/2021,12921,82L-IMPORT PAYROLL-COVENEY ALLISON,D108,HJ,,14.83,12616.59
6175,1/29/2021,1/29/2021,12921,82L-IMPORT PAYROLL-JACKSON CLAICE M,D108,HJ,,1.78,12614.81
6175,1/29/2021,1/29/2021,12921,82L-IMPORT PAYROLL-JACKSON CLAICE M,D108,HJ,,11.96,12602.85
6175,1/29/2021,1/29/2021,12921,82L-IMPORT PAYROLL-JANG DANIEL,D108,HJ,,1.78,12601.07
6175,1/29/2021,1/29/2021,12921,82L-IMPORT PAYROLL-JANG DANIEL,D108,HJ,,14.83,12586.24
6175,1/29/2021,1/29/2021,12921,82L-IMPORT PAYROLL-LENEGHAN MARYELLEN,D108,HJ,,1.78,12584.46
6175,1/29/2021,1/29/2021,12921,82L-IMPORT PAYROLL-LENEGHAN MARYELLEN,D108,HJ,,11.96,12572.5
6175,2/1/2021,2/1/2021,BCBS,BCBS February Payment-BCBS - February 2021 BCBS,D108,HJ,855.24,,13427.74
6175,2/1/2021,2/1/2021,BCBS,BCBS February Payment-BCBS - February 2021 BCBS,D108,HJ,667.84,,14095.58
6175,2/1/2021,2/1/2021,BCBS,BCBS February Payment-BCBS - February 2021 BCBS,D107,HJ,3225.17,,17320.75
6175,2/1/2021,2/1/2021,BCBS,BCBS February Payment-BCBS - February 2021 BCBS,D108,HJ,1159.82,,18480.57
6175,2/1/2021,2/1/2021,BCBS,BCBS February Payment-BCBS - February 2021 BCBS,D108,HJ,47.83,,18528.4
6175,2/2/2021,2/2/2021,JE-21-0165,Blue 20/20 Vision Insurance February Inv 82L-Blue 20/20 Vision Insurance February Inv 82L,D108,HJ,98.83,,18627.23
6175,2/2/2021,2/2/2021,JE-21-0165,Blue 20/20 Vision Insurance February Inv 82L-Blue 20/20 Vision Insurance February Inv 82L,D108,HJ,49.77,,18677
6175,2/2/2021,2/2/2021,JE-21-0165,Blue 20/20 Vision Insurance February Inv 82L-Blue 20/20 Vision Insurance February Inv 82L,D107,HJ,35.13,,18712.13
6175,2/2/2021,2/2/2021,JE-21-0165,Blue 20/20 Vision Insurance February Inv 82L-Blue 20/20 Vision Insurance February Inv 82L,D107,HJ,98.42,,18810.55
6175,2/2/2021,2/2/2021,JE-21-0165,Blue 20/20 Vision Insurance February Inv 82L-Blue 20/20 Vision Insurance February Inv 82L,D108,HJ,71.1,,18881.65
6175,2/2/2021,2/2/2021,JE-21-0165,Blue 20/20 Vision Insurance February Inv 82L-Blue 20/20 Vision Insurance February Inv 82L,D108,HJ,21.33,,18902.98
6175,2/2/2021,2/2/2021,JE-21-0166,Blue 20/20 Vision Insurance - February Inv LUX-Blue 20/20 Vision Insurance -February Inv LUX,D108,HJ,7.11,,18910.09
6175,2/12/2021,2/12/2021,21221,82L-IMPORT PAYROLL-BARTHELEMY RACHALIE,D108,HJ,,1.78,18908.31
6175,2/12/2021,2/12/2021,21221,82L-IMPORT PAYROLL-BARTHELEMY RACHALIE,D108,HJ,,14.83,18893.48
6175,2/12/2021,2/12/2021,21221,82L-IMPORT PAYROLL-BOHLSEN GRACE ISABELLE,D108,HJ,,1.78,18891.7
6175,2/12/2021,2/12/2021,21221,82L-IMPORT PAYROLL-BRIANTE SAMUEL,D108,HJ,,14.83,18876.87
6175,2/12/2021,2/12/2021,21221,82L-IMPORT PAYROLL-BROWN ISAAC,D108,HJ,,1.78,18875.09
6175,2/12/2021,2/12/2021,21221,82L-IMPORT PAYROLL-BROWN ISAAC,D108,HJ,,14.83,18860.26
6175,2/12/2021,2/12/2021,21221,82L-IMPORT PAYROLL-GARCIA SANTIAGO,D108,HJ,,1.78,18858.48
6175,2/12/2021,2/12/2021,21221,82L-IMPORT PAYROLL-KNOWLIN ZYLIA,D108,HJ,,5.23,18853.25
6175,2/12/2021,2/12/2021,21221,82L-IMPORT PAYROLL-KNOWLIN ZYLIA,D108,HJ,,44.2,18809.05
6175,2/12/2021,2/12/2021,21221,82L-IMPORT PAYROLL-LI SEN YUAN,D108,HJ,,1.78,18807.27
6175,2/12/2021,2/12/2021,21221,82L-IMPORT PAYROLL-LI SEN YUAN,D108,HJ,,11.96,18795.31
6175,2/12/2021,2/12/2021,21221,82L-IMPORT PAYROLL-LIPSCOMB STEPHEN,D108,HJ,,1.78,18793.53
6175,2/12/2021,2/12/2021,21221,82L-IMPORT PAYROLL-LIPSCOMB STEPHEN,D108,HJ,,11.96,18781.57
6175,2/12/2021,2/12/2021,21221,82L-IMPORT PAYROLL-MEJIA ROSO CARLOS,D108,HJ,,1.78,18779.79
6175,2/12/2021,2/12/2021,21221,82L-IMPORT PAYROLL-MEJIA ROSO CARLOS,D108,HJ,,14.83,18764.96
6175,2/12/2021,2/12/2021,21221,82L-IMPORT PAYROLL-SCOTT KIRK DONOVAN,D108,HJ,,1.78,18763.18
6175,2/12/2021,2/12/2021,21221,82L-IMPORT PAYROLL-SCOTT KIRK DONOVAN,D108,HJ,,11.96,18751.22
6175,2/12/2021,2/12/2021,21221,82L-IMPORT PAYROLL-SILVER KELLY,D108,HJ,,1.78,18749.44
6175,2/12/2021,2/12/2021,21221,82L-IMPORT PAYROLL-SILVER KELLY,D108,HJ,,14.83,18734.61
6175,2/12/2021,2/12/2021,21221,82L-IMPORT PAYROLL-STEIN KYLE,D108,HJ,,1.78,18732.83
6175,2/12/2021,2/12/2021,21221,82L-IMPORT PAYROLL-STEIN KYLE,D108,HJ,,11.96,18720.87
6175,2/12/2021,2/12/2021,21221,82L-IMPORT PAYROLL-STROUD DAVID,D108,HJ,,1.78,18719.09
6175,2/12/2021,2/12/2021,21221,82L-IMPORT PAYROLL-STROUD DAVID,D108,HJ,,14.83,18704.26
6175,2/12/2021,2/12/2021,21221,82L-IMPORT PAYROLL-WILLIAMS MACK ANTHONY,D108,HJ,,11.96,18692.3
6175,2/12/2021,2/12/2021,21221,82L-IMPORT PAYROLL-APULI LINDSAY,D108,HJ,,1.78,18690.52
6175,2/12/2021,2/12/2021,21221,82L-IMPORT PAYROLL-APULI LINDSAY,D108,HJ,,11.96,18678.56
6175,2/12/2021,2/12/2021,21221,82L-IMPORT PAYROLL-AUSTIN PERCY ANTONIO,D108,HJ,,1.78,18676.78
6175,2/12/2021,2/12/2021,21221,82L-IMPORT PAYROLL-AUSTIN PERCY ANTONIO,D108,HJ,,14.83,18661.95
6175,2/12/2021,2/12/2021,21221,82L-IMPORT PAYROLL-BUHMANN JENNIFER,D108,HJ,,1.78,18660.17
6175,2/12/2021,2/12/2021,21221,82L-IMPORT PAYROLL-CAIN CORY,D108,HJ,,1.78,18658.39
6175,2/12/2021,2/12/2021,21221,82L-IMPORT PAYROLL-CAIN CORY,D108,HJ,,14.83,18643.56
6175,2/12/2021,2/12/2021,21221,82L-IMPORT PAYROLL-CHAPMAN CLAUDY EARL,D108,HJ,,1.78,18641.78
6175,2/12/2021,2/12/2021,21221,82L-IMPORT PAYROLL-CHAPMAN CLAUDY EARL,D108,HJ,,11.96,18629.82
6175,2/12/2021,2/12/2021,21221,82L-IMPORT PAYROLL-DADA ARIKPO E,D108,HJ,,5.23,18624.59
6175,2/12/2021,2/12/2021,21221,82L-IMPORT PAYROLL-DADA ARIKPO E,D108,HJ,,35.65,18588.94
6175,2/12/2021,2/12/2021,21221,82L-IMPORT PAYROLL-GUTHRIE LESLIE,D108,HJ,,1.78,18587.16
6175,2/12/2021,2/12/2021,21221,82L-IMPORT PAYROLL-GUTHRIE LESLIE,D108,HJ,,14.83,18572.33
6175,2/12/2021,2/12/2021,21221,82L-IMPORT PAYROLL-HOLMES JOREL ALEXANDER,D108,HJ,,1.78,18570.55
6175,2/12/2021,2/12/2021,21221,82L-IMPORT PAYROLL-HOLMES JOREL ALEXANDER,D108,HJ,,11.96,18558.59
6175,2/12/2021,2/12/2021,21221,82L-IMPORT PAYROLL-JORDAN TIFFANY T,D108,HJ,,5.23,18553.36
6175,2/12/2021,2/12/2021,21221,82L-IMPORT PAYROLL-JORDAN TIFFANY T,D108,HJ,,35.65,18517.71
6175,2/12/2021,2/12/2021,21221,82L-IMPORT PAYROLL-LANIGAN LISA A,D108,HJ,,3.56,18514.15
6175,2/12/2021,2/12/2021,21221,82L-IMPORT PAYROLL-ONICA ANTHONY J,D108,HJ,,1.78,18512.37
6175,2/12/2021,2/12/2021,21221,82L-IMPORT PAYROLL-ONICA ANTHONY J,D108,HJ,,11.96,18500.41
6175,2/12/2021,2/12/2021,21221,82L-IMPORT PAYROLL-PRAHIN NICOLE M,D108,HJ,,1.78,18498.63
6175,2/12/2021,2/12/2021,21221,82L-IMPORT PAYROLL-PRAHIN NICOLE M,D108,HJ,,11.96,18486.67
6175,2/12/2021,2/12/2021,21221,82L-IMPORT PAYROLL-SALIM YASSER,D108,HJ,,11.96,18474.71
6175,2/12/2021,2/12/2021,21221,82L-IMPORT PAYROLL-SEJOUR MAHALIAH,D108,HJ,,1.78,18472.93
6175,2/12/2021,2/12/2021,21221,82L-IMPORT PAYROLL-SEJOUR MAHALIAH,D108,HJ,,11.96,18460.97
6175,2/12/2021,2/12/2021,21221,82L-IMPORT PAYROLL-TUMENJARGAL ENKHJIN,D108,HJ,,1.78,18459.19
6175,2/12/2021,2/12/2021,21221,82L-IMPORT PAYROLL-TUMENJARGAL ENKHJIN,D108,HJ,,11.96,18447.23
6175,2/12/2021,2/12/2021,21221,82L-IMPORT PAYROLL-VILLEGAS EVELYN,D108,HJ,,5.23,18442
6175,2/12/2021,2/12/2021,21221,82L-IMPORT PAYROLL-VILLEGAS EVELYN,D108,HJ,,35.65,18406.35
6175,2/12/2021,2/12/2021,21221,82L-IMPORT PAYROLL-WOLF ANNA A,D108,HJ,,1.78,18404.57
6175,2/12/2021,2/12/2021,21221,82L-IMPORT PAYROLL-ACEVEDO MONIVETT,D107,HJ,,25.48,18379.09
6175,2/12/2021,2/12/2021,21221,82L-IMPORT PAYROLL-AKLESTAD ISABEL,D111,HJ,,1.78,18377.31
6175,2/12/2021,2/12/2021,21221,82L-IMPORT PAYROLL-AKLESTAD ISABEL,D111,HJ,,11.96,18365.35
6175,2/12/2021,2/12/2021,21221,82L-IMPORT PAYROLL-BIBB TIFFANI,D104,HJ,,1.78,18363.57
6175,2/12/2021,2/12/2021,21221,82L-IMPORT PAYROLL-BIBB TIFFANI,D104,HJ,,44.2,18319.37
6175,2/12/2021,2/12/2021,21221,82L-IMPORT PAYROLL-COOK CATHRYN ANNA,D105,HJ,,1.78,18317.59
6175,2/12/2021,2/12/2021,21221,82L-IMPORT PAYROLL-COOK CATHRYN ANNA,D105,HJ,,14.83,18302.76
6175,2/12/2021,2/12/2021,21221,82L-IMPORT PAYROLL-COOPER ASHLEE R,D101,HJ,,1.78,18300.98
6175,2/12/2021,2/12/2021,21221,82L-IMPORT PAYROLL-COOPER ASHLEE R,D101,HJ,,11.96,18289.02
6175,2/12/2021,2/12/2021,21221,82L-IMPORT PAYROLL-CORTEZ MIRANDA A,D111,HJ,,1.78,18287.24
6175,2/12/2021,2/12/2021,21221,82L-IMPORT PAYROLL-DETONE KYRA MAYA,D102,HJ,,1.78,18285.46
6175,2/12/2021,2/12/2021,21221,82L-IMPORT PAYROLL-DETONE KYRA MAYA,D102,HJ,,11.96,18273.5
6175,2/12/2021,2/12/2021,21221,82L-IMPORT PAYROLL-DUPUIS CHRISTOPHER M,D107,HJ,,1.78,18271.72
6175,2/12/2021,2/12/2021,21221,82L-IMPORT PAYROLL-DUPUIS CHRISTOPHER M,D107,HJ,,11.96,18259.76
6175,2/12/2021,2/12/2021,21221,82L-IMPORT PAYROLL-DZIEDZIC JULIE K,D101,HJ,,3.38,18256.38
6175,2/12/2021,2/12/2021,21221,82L-IMPORT PAYROLL-DZIEDZIC JULIE K,D101,HJ,,25.48,18230.9
6175,2/12/2021,2/12/2021,21221,82L-IMPORT PAYROLL-FEENEY CLAIRE,D104,HJ,,1.78,18229.12
6175,2/12/2021,2/12/2021,21221,82L-IMPORT PAYROLL-FEENEY CLAIRE,D104,HJ,,11.96,18217.16
6175,2/12/2021,2/12/2021,21221,82L-IMPORT PAYROLL-FISCHABER THOMAS,D109,HJ,,5.23,18211.93
6175,2/12/2021,2/12/2021,21221,82L-IMPORT PAYROLL-FISCHABER THOMAS,D109,HJ,,44.2,18167.73
6175,2/12/2021,2/12/2021,21221,82L-IMPORT PAYROLL-GUADARRAMA-ALVAREZ URIEL A,D105,HJ,,1.78,18165.95
6175,2/12/2021,2/12/2021,21221,82L-IMPORT PAYROLL-GUADARRAMA-ALVAREZ URIEL A,D105,HJ,,11.96,18153.99
6175,2/12/2021,2/12/2021,21221,82L-IMPORT PAYROLL-GUTIERREZ ANTONIO J,D107,HJ,,35.65,18118.34
6175,2/12/2021,2/12/2021,21221,82L-IMPORT PAYROLL-HERMAN ADAM,D102,HJ,,1.78,18116.56
6175,2/12/2021,2/12/2021,21221,82L-IMPORT PAYROLL-HERMAN ADAM,D102,HJ,,11.96,18104.6
6175,2/12/2021,2/12/2021,21221,82L-IMPORT PAYROLL-HERNANDEZ ANNA,D101,HJ,,1.78,18102.82
6175,2/12/2021,2/12/2021,21221,82L-IMPORT PAYROLL-HERNANDEZ ANNA,D101,HJ,,11.96,18090.86
6175,2/12/2021,2/12/2021,21221,82L-IMPORT PAYROLL-HOLT ADAM,D109,HJ,,1.78,18089.08
6175,2/12/2021,2/12/2021,21221,82L-IMPORT PAYROLL-HOLT ADAM,D109,HJ,,14.83,18074.25
6175,2/12/2021,2/12/2021,21221,82L-IMPORT PAYROLL-LIPORACE HERNAN LUIS,D103,HJ,,11.96,18062.29
6175,2/12/2021,2/12/2021,21221,82L-IMPORT PAYROLL-MARKS KRISTA,D109,HJ,,1.78,18060.51
6175,2/12/2021,2/12/2021,21221,82L-IMPORT PAYROLL-MARKS KRISTA,D109,HJ,,14.83,18045.68
6175,2/12/2021,2/12/2021,21221,82L-IMPORT PAYROLL-MELVIN DARNELL KEVIN,D109,HJ,,1.78,18043.9
6175,2/12/2021,2/12/2021,21221,82L-IMPORT PAYROLL-MELVIN DARNELL KEVIN,D109,HJ,,11.96,18031.94
6175,2/12/2021,2/12/2021,21221,82L-IMPORT PAYROLL-MESSING JENNIFER,D104,HJ,,1.78,18030.16
6175,2/12/2021,2/12/2021,21221,82L-IMPORT PAYROLL-MESSING JENNIFER,D104,HJ,,14.83,18015.33
6175,2/12/2021,2/12/2021,21221,82L-IMPORT PAYROLL-MILNE ROGER,D109,HJ,,1.78,18013.55
6175,2/12/2021,2/12/2021,21221,82L-IMPORT PAYROLL-MILNE ROGER,D109,HJ,,11.96,18001.59
6175,2/12/2021,2/12/2021,21221,82L-IMPORT PAYROLL-O'DONNELL STEPHEN,D104,HJ,,1.78,17999.81
6175,2/12/2021,2/12/2021,21221,82L-IMPORT PAYROLL-O'DONNELL STEPHEN,D104,HJ,,14.83,17984.98
6175,2/12/2021,2/12/2021,21221,82L-IMPORT PAYROLL-PARHAM-GANTT DENISE M,D112,HJ,,3.56,17981.42
6175,2/12/2021,2/12/2021,21221,82L-IMPORT PAYROLL-PARHAM-GANTT DENISE M,D112,HJ,,31.6,17949.82
6175,2/12/2021,2/12/2021,21221,82L-IMPORT PAYROLL-PEINADO ELIZABETH R,D111,HJ,,1.78,17948.04
6175,2/12/2021,2/12/2021,21221,82L-IMPORT PAYROLL-PEINADO ELIZABETH R,D111,HJ,,11.96,17936.08
6175,2/12/2021,2/12/2021,21221,82L-IMPORT PAYROLL-PERNIA JEFFREY,D109,HJ,,1.78,17934.3
6175,2/12/2021,2/12/2021,21221,82L-IMPORT PAYROLL-PERNIA JEFFREY,D109,HJ,,14.83,17919.47
6175,2/12/2021,2/12/2021,21221,82L-IMPORT PAYROLL-POLANCO ODALIS,D103,HJ,,1.78,17917.69
6175,2/12/2021,2/12/2021,21221,82L-IMPORT PAYROLL-POLANCO ODALIS,D103,HJ,,11.96,17905.73
6175,2/12/2021,2/12/2021,21221,82L-IMPORT PAYROLL-QUINTAS JASHIVE,D105,HJ,,1.78,17903.95
6175,2/12/2021,2/12/2021,21221,82L-IMPORT PAYROLL-QUINTAS JASHIVE,D105,HJ,,14.83,17889.12
6175,2/12/2021,2/12/2021,21221,82L-IMPORT PAYROLL-RANDOLPH ALEXANDER,D111,HJ,,1.78,17887.34
6175,2/12/2021,2/12/2021,21221,82L-IMPORT PAYROLL-RANDOLPH ALEXANDER,D111,HJ,,11.96,17875.38
6175,2/12/2021,2/12/2021,21221,82L-IMPORT PAYROLL-RUBI PERLA,D101,HJ,,14.83,17860.55
6175,2/12/2021,2/12/2021,21221,82L-IMPORT PAYROLL-SAFRAN ALAN P,D107,HJ,,5.23,17855.32
6175,2/12/2021,2/12/2021,21221,82L-IMPORT PAYROLL-SAFRAN ALAN P,D107,HJ,,35.65,17819.67
6175,2/12/2021,2/12/2021,21221,82L-IMPORT PAYROLL-WALLACE AMENA,D104,HJ,,11.96,17807.71
6175,2/12/2021,2/12/2021,21221,82L-IMPORT PAYROLL-WARD JEFFREY,D109,HJ,,5.23,17802.48
6175,2/12/2021,2/12/2021,21221,82L-IMPORT PAYROLL-WARD JEFFREY,D109,HJ,,44.2,17758.28
6175,2/12/2021,2/12/2021,21221,82L-IMPORT PAYROLL-WEINSTOCK EMILY,D101,HJ,,1.78,17756.5
6175,2/12/2021,2/12/2021,21221,82L-IMPORT PAYROLL-WEINSTOCK EMILY,D101,HJ,,11.96,17744.54
6175,2/12/2021,2/12/2021,21221,82L-IMPORT PAYROLL-BARTOLD DEANNA MARIE,D108,HJ,,1.78,17742.76
6175,2/12/2021,2/12/2021,21221,82L-IMPORT PAYROLL-BARTOLD DEANNA MARIE,D108,HJ,,11.96,17730.8
6175,2/12/2021,2/12/2021,21221,82L-IMPORT PAYROLL-BELLOT GENESIS,D108,HJ,,1.78,17729.02
6175,2/12/2021,2/12/2021,21221,82L-IMPORT PAYROLL-BELLOT GENESIS,D108,HJ,,14.83,17714.19
6175,2/12/2021,2/12/2021,21221,82L-IMPORT PAYROLL-BURRELL RUSSELL,D108,HJ,,1.78,17712.41
6175,2/12/2021,2/12/2021,21221,82L-IMPORT PAYROLL-BURRELL RUSSELL,D108,HJ,,11.96,17700.45
6175,2/12/2021,2/12/2021,21221,82L-IMPORT PAYROLL-FEIGHERY JOHN,D108,HJ,,11.96,17688.49
6175,2/12/2021,2/12/2021,21221,82L-IMPORT PAYROLL-GRIFFIN ANDREW,D108,HJ,,1.78,17686.71
6175,2/12/2021,2/12/2021,21221,82L-IMPORT PAYROLL-GRIFFIN ANDREW,D108,HJ,,11.96,17674.75
6175,2/12/2021,2/12/2021,21221,82L-IMPORT PAYROLL-GROSS EMILY,D108,HJ,,1.78,17672.97
6175,2/12/2021,2/12/2021,21221,82L-IMPORT PAYROLL-GROSS EMILY,D108,HJ,,14.83,17658.14
6175,2/12/2021,2/12/2021,21221,82L-IMPORT PAYROLL-HALLINAN GABRIEL,D108,HJ,,1.78,17656.36
6175,2/12/2021,2/12/2021,21221,82L-IMPORT PAYROLL-HALLINAN GABRIEL,D108,HJ,,11.96,17644.4
6175,2/12/2021,2/12/2021,21221,82L-IMPORT PAYROLL-HAMERSLY WILLIAM,D108,HJ,,1.78,17642.62
6175,2/12/2021,2/12/2021,21221,82L-IMPORT PAYROLL-HAMERSLY WILLIAM,D108,HJ,,11.96,17630.66
6175,2/12/2021,2/12/2021,21221,82L-IMPORT PAYROLL-HOSSAIN MYESHA,D108,HJ,,1.78,17628.88
6175,2/12/2021,2/12/2021,21221,82L-IMPORT PAYROLL-HOSSAIN MYESHA,D108,HJ,,14.83,17614.05
6175,2/12/2021,2/12/2021,21221,82L-IMPORT PAYROLL-JACKSON TASNIM F,D108,HJ,,1.78,17612.27
6175,2/12/2021,2/12/2021,21221,82L-IMPORT PAYROLL-JACKSON TASNIM F,D108,HJ,,14.83,17597.44
6175,2/12/2021,2/12/2021,21221,82L-IMPORT PAYROLL-LEARY AUBREY,D108,HJ,,1.78,17595.66
6175,2/12/2021,2/12/2021,21221,82L-IMPORT PAYROLL-LI BELLA,D108,HJ,,1.78,17593.88
6175,2/12/2021,2/12/2021,21221,82L-IMPORT PAYROLL-LI BELLA,D108,HJ,,11.96,17581.92
6175,2/12/2021,2/12/2021,21221,82L-IMPORT PAYROLL-OPUH NDIDI,D108,HJ,,1.78,17580.14
6175,2/12/2021,2/12/2021,21221,82L-IMPORT PAYROLL-OPUH NDIDI,D108,HJ,,35.65,17544.49
6175,2/12/2021,2/12/2021,21221,82L-IMPORT PAYROLL-SOBELMAN JUSTIN,D108,HJ,,1.78,17542.71
6175,2/12/2021,2/12/2021,21221,82L-IMPORT PAYROLL-SOBELMAN JUSTIN,D108,HJ,,11.96,17530.75
6175,2/12/2021,2/12/2021,21221,82L-IMPORT PAYROLL-TERRENCE-SMITH ZIHIR,D108,HJ,,1.78,17528.97
6175,2/12/2021,2/12/2021,21221,82L-IMPORT PAYROLL-TERRENCE-SMITH ZIHIR,D108,HJ,,14.83,17514.14
6175,2/12/2021,2/12/2021,21221,82L-IMPORT PAYROLL-WILLIAMS-MASSEY BRIANNA,D108,HJ,,11.96,17502.18
6175,2/12/2021,2/12/2021,21221,82L-IMPORT PAYROLL-COVENEY ALLISON,D108,HJ,,1.78,17500.4
6175,2/12/2021,2/12/2021,21221,82L-IMPORT PAYROLL-COVENEY ALLISON,D108,HJ,,14.83,17485.57
6175,2/12/2021,2/12/2021,21221,82L-IMPORT PAYROLL-JACKSON CLAICE M,D108,HJ,,1.78,17483.79
6175,2/12/2021,2/12/2021,21221,82L-IMPORT PAYROLL-JACKSON CLAICE M,D108,HJ,,11.96,17471.83
6175,2/12/2021,2/12/2021,21221,82L-IMPORT PAYROLL-JANG DANIEL,D108,HJ,,1.78,17470.05
6175,2/12/2021,2/12/2021,21221,82L-IMPORT PAYROLL-JANG DANIEL,D108,HJ,,14.83,17455.22
6175,2/12/2021,2/12/2021,21221,82L-IMPORT PAYROLL-LENEGHAN MARYELLEN,D108,HJ,,1.78,17453.44
6175,2/12/2021,2/12/2021,21221,82L-IMPORT PAYROLL-LENEGHAN MARYELLEN,D108,HJ,,11.96,17441.48
6175,2/26/2021,2/26/2021,22621,82L-IMPORT PAYROLL-BARTHELEMY RACHALIE,D108,HJ,,1.78,17439.7
6175,2/26/2021,2/26/2021,22621,82L-IMPORT PAYROLL-BARTHELEMY RACHALIE,D108,HJ,,14.83,17424.87
6175,2/26/2021,2/26/2021,22621,82L-IMPORT PAYROLL-BOHLSEN GRACE ISABELLE,D108,HJ,,1.78,17423.09
6175,2/26/2021,2/26/2021,22621,82L-IMPORT PAYROLL-BRIANTE SAMUEL,D108,HJ,,14.83,17408.26
6175,2/26/2021,2/26/2021,22621,82L-IMPORT PAYROLL-BROWN ISAAC,D108,HJ,,1.78,17406.48
6175,2/26/2021,2/26/2021,22621,82L-IMPORT PAYROLL-BROWN ISAAC,D108,HJ,,14.83,17391.65
6175,2/26/2021,2/26/2021,22621,82L-IMPORT PAYROLL-GARCIA SANTIAGO,D108,HJ,,1.78,17389.87
6175,2/26/2021,2/26/2021,22621,82L-IMPORT PAYROLL-KNOWLIN ZYLIA,D108,HJ,,5.23,17384.64
6175,2/26/2021,2/26/2021,22621,82L-IMPORT PAYROLL-KNOWLIN ZYLIA,D108,HJ,,44.2,17340.44
6175,2/26/2021,2/26/2021,22621,82L-IMPORT PAYROLL-LI SEN YUAN,D108,HJ,,1.78,17338.66
6175,2/26/2021,2/26/2021,22621,82L-IMPORT PAYROLL-LI SEN YUAN,D108,HJ,,11.96,17326.7
6175,2/26/2021,2/26/2021,22621,82L-IMPORT PAYROLL-LIPSCOMB STEPHEN,D108,HJ,,1.78,17324.92
6175,2/26/2021,2/26/2021,22621,82L-IMPORT PAYROLL-LIPSCOMB STEPHEN,D108,HJ,,11.96,17312.96
6175,2/26/2021,2/26/2021,22621,82L-IMPORT PAYROLL-MEJIA ROSO CARLOS,D108,HJ,,1.78,17311.18
6175,2/26/2021,2/26/2021,22621,82L-IMPORT PAYROLL-MEJIA ROSO CARLOS,D108,HJ,,14.83,17296.35
6175,2/26/2021,2/26/2021,22621,82L-IMPORT PAYROLL-SCOTT KIRK DONOVAN,D108,HJ,,1.78,17294.57
6175,2/26/2021,2/26/2021,22621,82L-IMPORT PAYROLL-SCOTT KIRK DONOVAN,D108,HJ,,11.96,17282.61
6175,2/26/2021,2/26/2021,22621,82L-IMPORT PAYROLL-SILVER KELLY,D108,HJ,,1.78,17280.83
6175,2/26/2021,2/26/2021,22621,82L-IMPORT PAYROLL-SILVER KELLY,D108,HJ,,14.83,17266
6175,2/26/2021,2/26/2021,22621,82L-IMPORT PAYROLL-STEIN KYLE,D108,HJ,,1.78,17264.22
6175,2/26/2021,2/26/2021,22621,82L-IMPORT PAYROLL-STEIN KYLE,D108,HJ,,11.96,17252.26
6175,2/26/2021,2/26/2021,22621,82L-IMPORT PAYROLL-STROUD DAVID,D108,HJ,,1.78,17250.48
6175,2/26/2021,2/26/2021,22621,82L-IMPORT PAYROLL-STROUD DAVID,D108,HJ,,14.83,17235.65
6175,2/26/2021,2/26/2021,22621,82L-IMPORT PAYROLL-WILLIAMS MACK ANTHONY,D108,HJ,,11.96,17223.69
6175,2/26/2021,2/26/2021,22621,82L-IMPORT PAYROLL-APULI LINDSAY,D108,HJ,,1.78,17221.91
6175,2/26/2021,2/26/2021,22621,82L-IMPORT PAYROLL-APULI LINDSAY,D108,HJ,,11.96,17209.95
6175,2/26/2021,2/26/2021,22621,82L-IMPORT PAYROLL-AUSTIN PERCY,D108,HJ,,1.78,17208.17
6175,2/26/2021,2/26/2021,22621,82L-IMPORT PAYROLL-AUSTIN PERCY,D108,HJ,,14.83,17193.34
6175,2/26/2021,2/26/2021,22621,82L-IMPORT PAYROLL-BUHMANN JENNIFER,D108,HJ,,1.78,17191.56
6175,2/26/2021,2/26/2021,22621,82L-IMPORT PAYROLL-CAIN CORY,D108,HJ,,1.78,17189.78
6175,2/26/2021,2/26/2021,22621,82L-IMPORT PAYROLL-CAIN CORY,D108,HJ,,14.83,17174.95
6175,2/26/2021,2/26/2021,22621,82L-IMPORT PAYROLL-CHAPMAN CLAUDY EARL,D108,HJ,,1.78,17173.17
6175,2/26/2021,2/26/2021,22621,82L-IMPORT PAYROLL-CHAPMAN CLAUDY EARL,D108,HJ,,11.96,17161.21
6175,2/26/2021,2/26/2021,22621,82L-IMPORT PAYROLL-DADA ARIKPO E,D108,HJ,,5.23,17155.98
6175,2/26/2021,2/26/2021,22621,82L-IMPORT PAYROLL-DADA ARIKPO E,D108,HJ,,35.65,17120.33
6175,2/26/2021,2/26/2021,22621,82L-IMPORT PAYROLL-GUTHRIE LESLIE,D108,HJ,,1.78,17118.55
6175,2/26/2021,2/26/2021,22621,82L-IMPORT PAYROLL-GUTHRIE LESLIE,D108,HJ,,14.83,17103.72
6175,2/26/2021,2/26/2021,22621,82L-IMPORT PAYROLL-HOLMES JOREL ALEXANDER,D108,HJ,,1.78,17101.94
6175,2/26/2021,2/26/2021,22621,82L-IMPORT PAYROLL-HOLMES JOREL ALEXANDER,D108,HJ,,11.96,17089.98
6175,2/26/2021,2/26/2021,22621,82L-IMPORT PAYROLL-JORDAN TIFFANY T,D108,HJ,,5.23,17084.75
6175,2/26/2021,2/26/2021,22621,82L-IMPORT PAYROLL-JORDAN TIFFANY T,D108,HJ,,35.65,17049.1
6175,2/26/2021,2/26/2021,22621,82L-IMPORT PAYROLL-LANIGAN LISA A,D108,HJ,,3.56,17045.54
6175,2/26/2021,2/26/2021,22621,82L-IMPORT PAYROLL-ONICA ANTHONY J,D108,HJ,,1.78,17043.76
6175,2/26/2021,2/26/2021,22621,82L-IMPORT PAYROLL-ONICA ANTHONY J,D108,HJ,,11.96,17031.8
6175,2/26/2021,2/26/2021,22621,82L-IMPORT PAYROLL-PRAHIN NICOLE M,D108,HJ,,1.78,17030.02
6175,2/26/2021,2/26/2021,22621,82L-IMPORT PAYROLL-PRAHIN NICOLE M,D108,HJ,,11.96,17018.06
6175,2/26/2021,2/26/2021,22621,82L-IMPORT PAYROLL-SALIM YASSER,D108,HJ,,11.96,17006.1
6175,2/26/2021,2/26/2021,22621,82L-IMPORT PAYROLL-SEJOUR MAHALIAH,D108,HJ,,1.78,17004.32
6175,2/26/2021,2/26/2021,22621,82L-IMPORT PAYROLL-SEJOUR MAHALIAH,D108,HJ,,11.96,16992.36
6175,2/26/2021,2/26/2021,22621,82L-IMPORT PAYROLL-TUMENJARGAL ENKHJIN,D108,HJ,,1.78,16990.58
6175,2/26/2021,2/26/2021,22621,82L-IMPORT PAYROLL-TUMENJARGAL ENKHJIN,D108,HJ,,11.96,16978.62
6175,2/26/2021,2/26/2021,22621,82L-IMPORT PAYROLL-VILLEGAS EVELYN,D108,HJ,,5.23,16973.39
6175,2/26/2021,2/26/2021,22621,82L-IMPORT PAYROLL-VILLEGAS EVELYN,D108,HJ,,35.65,16937.74
6175,2/26/2021,2/26/2021,22621,82L-IMPORT PAYROLL-WOLF ANNA A,D108,HJ,,1.78,16935.96
6175,2/26/2021,2/26/2021,22621,82L-IMPORT PAYROLL-ACEVEDO MONIVETT,D107,HJ,,25.48,16910.48
6175,2/26/2021,2/26/2021,22621,82L-IMPORT PAYROLL-AKLESTAD ISABEL,D111,HJ,,1.78,16908.7
6175,2/26/2021,2/26/2021,22621,82L-IMPORT PAYROLL-AKLESTAD ISABEL,D111,HJ,,11.96,16896.74
6175,2/26/2021,2/26/2021,22621,82L-IMPORT PAYROLL-BIBB TIFFANI,D104,HJ,,1.78,16894.96
6175,2/26/2021,2/26/2021,22621,82L-IMPORT PAYROLL-BIBB TIFFANI,D104,HJ,,44.2,16850.76
6175,2/26/2021,2/26/2021,22621,82L-IMPORT PAYROLL-CALVO FERNANDA,D104,HJ,,1.78,16848.98
6175,2/26/2021,2/26/2021,22621,82L-IMPORT PAYROLL-CALVO FERNANDA,D104,HJ,,14.83,16834.15
6175,2/26/2021,2/26/2021,22621,82L-IMPORT PAYROLL-COOK CATHRYN ANNA,D105,HJ,,1.78,16832.37
6175,2/26/2021,2/26/2021,22621,82L-IMPORT PAYROLL-COOK CATHRYN ANNA,D105,HJ,,14.83,16817.54
6175,2/26/2021,2/26/2021,22621,82L-IMPORT PAYROLL-COOPER ASHLEE R,D101,HJ,,1.78,16815.76
6175,2/26/2021,2/26/2021,22621,82L-IMPORT PAYROLL-COOPER ASHLEE R,D101,HJ,,11.96,16803.8
6175,2/26/2021,2/26/2021,22621,82L-IMPORT PAYROLL-CORTEZ MIRANDA A,D111,HJ,,1.78,16802.02
6175,2/26/2021,2/26/2021,22621,82L-IMPORT PAYROLL-DETONE KYRA MAYA,D102,HJ,,1.78,16800.24
6175,2/26/2021,2/26/2021,22621,82L-IMPORT PAYROLL-DETONE KYRA MAYA,D102,HJ,,11.96,16788.28
6175,2/26/2021,2/26/2021,22621,82L-IMPORT PAYROLL-DUPUIS CHRISTOPHER M,D107,HJ,,1.78,16786.5
6175,2/26/2021,2/26/2021,22621,82L-IMPORT PAYROLL-DUPUIS CHRISTOPHER M,D107,HJ,,11.96,16774.54
6175,2/26/2021,2/26/2021,22621,82L-IMPORT PAYROLL-DZIEDZIC JULIE K,D101,HJ,,3.38,16771.16
6175,2/26/2021,2/26/2021,22621,82L-IMPORT PAYROLL-DZIEDZIC JULIE K,D101,HJ,,25.48,16745.68
6175,2/26/2021,2/26/2021,22621,82L-IMPORT PAYROLL-FEENEY CLAIRE,D104,HJ,,1.78,16743.9
6175,2/26/2021,2/26/2021,22621,82L-IMPORT PAYROLL-FEENEY CLAIRE,D104,HJ,,11.96,16731.94
6175,2/26/2021,2/26/2021,22621,82L-IMPORT PAYROLL-FISCHABER THOMAS,D109,HJ,,5.23,16726.71
6175,2/26/2021,2/26/2021,22621,82L-IMPORT PAYROLL-FISCHABER THOMAS,D109,HJ,,44.2,16682.51
6175,2/26/2021,2/26/2021,22621,82L-IMPORT PAYROLL-GUADARRAMA-ALVAREZ URIEL A,D105,HJ,,1.78,16680.73
6175,2/26/2021,2/26/2021,22621,82L-IMPORT PAYROLL-GUADARRAMA-ALVAREZ URIEL A,D105,HJ,,11.96,16668.77
6175,2/26/2021,2/26/2021,22621,82L-IMPORT PAYROLL-GUTIERREZ ANTONIO J,D107,HJ,,35.65,16633.12
6175,2/26/2021,2/26/2021,22621,82L-IMPORT PAYROLL-HERMAN ADAM,D102,HJ,,1.78,16631.34
6175,2/26/2021,2/26/2021,22621,82L-IMPORT PAYROLL-HERMAN ADAM,D102,HJ,,11.96,16619.38
6175,2/26/2021,2/26/2021,22621,82L-IMPORT PAYROLL-HERNANDEZ ANNA,D101,HJ,,1.78,16617.6
6175,2/26/2021,2/26/2021,22621,82L-IMPORT PAYROLL-HERNANDEZ ANNA,D101,HJ,,11.96,16605.64
6175,2/26/2021,2/26/2021,22621,82L-IMPORT PAYROLL-HOLT ADAM,D109,HJ,,1.78,16603.86
6175,2/26/2021,2/26/2021,22621,82L-IMPORT PAYROLL-HOLT ADAM,D109,HJ,,14.83,16589.03
6175,2/26/2021,2/26/2021,22621,82L-IMPORT PAYROLL-LIPORACE HERNAN LUIS,D103,HJ,,11.96,16577.07
6175,2/26/2021,2/26/2021,22621,82L-IMPORT PAYROLL-MARKS KRISTA,D109,HJ,,1.78,16575.29
6175,2/26/2021,2/26/2021,22621,82L-IMPORT PAYROLL-MARKS KRISTA,D109,HJ,,14.83,16560.46
6175,2/26/2021,2/26/2021,22621,82L-IMPORT PAYROLL-MELVIN DARNELL KEVIN,D109,HJ,,1.78,16558.68
6175,2/26/2021,2/26/2021,22621,82L-IMPORT PAYROLL-MELVIN DARNELL KEVIN,D109,HJ,,11.96,16546.72
6175,2/26/2021,2/26/2021,22621,82L-IMPORT PAYROLL-MESSING JENNIFER,D104,HJ,,1.78,16544.94
6175,2/26/2021,2/26/2021,22621,82L-IMPORT PAYROLL-MESSING JENNIFER,D104,HJ,,14.83,16530.11
6175,2/26/2021,2/26/2021,22621,82L-IMPORT PAYROLL-MILNE ROGER,D109,HJ,,1.78,16528.33
6175,2/26/2021,2/26/2021,22621,82L-IMPORT PAYROLL-MILNE ROGER,D109,HJ,,11.96,16516.37
6175,2/26/2021,2/26/2021,22621,82L-IMPORT PAYROLL-O'DONNELL STEPHEN,D104,HJ,,1.78,16514.59
6175,2/26/2021,2/26/2021,22621,82L-IMPORT PAYROLL-O'DONNELL STEPHEN,D104,HJ,,14.83,16499.76
6175,2/26/2021,2/26/2021,22621,82L-IMPORT PAYROLL-PARHAM-GANTT DENISE M,D112,HJ,,3.56,16496.2
6175,2/26/2021,2/26/2021,22621,82L-IMPORT PAYROLL-PARHAM-GANTT DENISE M,D112,HJ,,31.6,16464.6
6175,2/26/2021,2/26/2021,22621,82L-IMPORT PAYROLL-PEINADO ELIZABETH R,D111,HJ,,1.78,16462.82
6175,2/26/2021,2/26/2021,22621,82L-IMPORT PAYROLL-PEINADO ELIZABETH R,D111,HJ,,11.96,16450.86
6175,2/26/2021,2/26/2021,22621,82L-IMPORT PAYROLL-PERNIA JEFFREY,D109,HJ,,1.78,16449.08
6175,2/26/2021,2/26/2021,22621,82L-IMPORT PAYROLL-PERNIA JEFFREY,D109,HJ,,14.83,16434.25
6175,2/26/2021,2/26/2021,22621,82L-IMPORT PAYROLL-POLANCO ODALIS,D103,HJ,,1.78,16432.47
6175,2/26/2021,2/26/2021,22621,82L-IMPORT PAYROLL-POLANCO ODALIS,D103,HJ,,11.96,16420.51
6175,2/26/2021,2/26/2021,22621,82L-IMPORT PAYROLL-QUINTAS JASHIVE,D105,HJ,,1.78,16418.73
6175,2/26/2021,2/26/2021,22621,82L-IMPORT PAYROLL-QUINTAS JASHIVE,D105,HJ,,14.83,16403.9
6175,2/26/2021,2/26/2021,22621,82L-IMPORT PAYROLL-RANDOLPH ALEXANDER,D111,HJ,,1.78,16402.12
6175,2/26/2021,2/26/2021,22621,82L-IMPORT PAYROLL-RANDOLPH ALEXANDER,D111,HJ,,11.96,16390.16
6175,2/26/2021,2/26/2021,22621,82L-IMPORT PAYROLL-RUBI PERLA,D101,HJ,,14.83,16375.33
6175,2/26/2021,2/26/2021,22621,82L-IMPORT PAYROLL-SAFRAN ALAN P,D107,HJ,,5.23,16370.1
6175,2/26/2021,2/26/2021,22621,82L-IMPORT PAYROLL-SAFRAN ALAN P,D107,HJ,,35.65,16334.45
6175,2/26/2021,2/26/2021,22621,82L-IMPORT PAYROLL-WALLACE AMENA,D104,HJ,,11.96,16322.49
6175,2/26/2021,2/26/2021,22621,82L-IMPORT PAYROLL-WARD JEFFREY,D109,HJ,,5.23,16317.26
6175,2/26/2021,2/26/2021,22621,82L-IMPORT PAYROLL-WARD JEFFREY,D109,HJ,,44.2,16273.06
6175,2/26/2021,2/26/2021,22621,82L-IMPORT PAYROLL-WEINSTOCK EMILY,D101,HJ,,1.78,16271.28
6175,2/26/2021,2/26/2021,22621,82L-IMPORT PAYROLL-WEINSTOCK EMILY,D101,HJ,,11.96,16259.32
6175,2/26/2021,2/26/2021,22621,82L-IMPORT PAYROLL-BARTOLD DEANNA MARIE,D108,HJ,,1.78,16257.54
6175,2/26/2021,2/26/2021,22621,82L-IMPORT PAYROLL-BARTOLD DEANNA MARIE,D108,HJ,,11.96,16245.58
6175,2/26/2021,2/26/2021,22621,82L-IMPORT PAYROLL-BELLOT GENESIS,D108,HJ,,1.78,16243.8
6175,2/26/2021,2/26/2021,22621,82L-IMPORT PAYROLL-BELLOT GENESIS,D108,HJ,,14.83,16228.97
6175,2/26/2021,2/26/2021,22621,82L-IMPORT PAYROLL-BURRELL RUSSELL,D108,HJ,,1.78,16227.19
6175,2/26/2021,2/26/2021,22621,82L-IMPORT PAYROLL-BURRELL RUSSELL,D108,HJ,,11.96,16215.23
6175,2/26/2021,2/26/2021,22621,82L-IMPORT PAYROLL-FEIGHERY JOHN,D108,HJ,,11.96,16203.27
6175,2/26/2021,2/26/2021,22621,82L-IMPORT PAYROLL-GRIFFIN ANDREW,D108,HJ,,1.78,16201.49
6175,2/26/2021,2/26/2021,22621,82L-IMPORT PAYROLL-GRIFFIN ANDREW,D108,HJ,,11.96,16189.53
6175,2/26/2021,2/26/2021,22621,82L-IMPORT PAYROLL-GROSS EMILY,D108,HJ,,1.78,16187.75
6175,2/26/2021,2/26/2021,22621,82L-IMPORT PAYROLL-GROSS EMILY,D108,HJ,,14.83,16172.92
6175,2/26/2021,2/26/2021,22621,82L-IMPORT PAYROLL-HALLINAN GABRIEL,D108,HJ,,1.78,16171.14
6175,2/26/2021,2/26/2021,22621,82L-IMPORT PAYROLL-HALLINAN GABRIEL,D108,HJ,,11.96,16159.18
6175,2/26/2021,2/26/2021,22621,82L-IMPORT PAYROLL-HAMERSLY WILLIAM,D108,HJ,,1.78,16157.4
6175,2/26/2021,2/26/2021,22621,82L-IMPORT PAYROLL-HAMERSLY WILLIAM,D108,HJ,,11.96,16145.44
6175,2/26/2021,2/26/2021,22621,82L-IMPORT PAYROLL-HOSSAIN MYESHA,D108,HJ,,1.78,16143.66
6175,2/26/2021,2/26/2021,22621,82L-IMPORT PAYROLL-HOSSAIN MYESHA,D108,HJ,,14.83,16128.83
6175,2/26/2021,2/26/2021,22621,82L-IMPORT PAYROLL-JACKSON TASNIM F,D108,HJ,,1.78,16127.05
6175,2/26/2021,2/26/2021,22621,82L-IMPORT PAYROLL-JACKSON TASNIM F,D108,HJ,,14.83,16112.22
6175,2/26/2021,2/26/2021,22621,82L-IMPORT PAYROLL-LEARY AUBREY,D108,HJ,,1.78,16110.44
6175,2/26/2021,2/26/2021,22621,82L-IMPORT PAYROLL-LI BELLA,D108,HJ,,1.78,16108.66
6175,2/26/2021,2/26/2021,22621,82L-IMPORT PAYROLL-LI BELLA,D108,HJ,,11.96,16096.7
6175,2/26/2021,2/26/2021,22621,82L-IMPORT PAYROLL-OPUH NDIDI,D108,HJ,,1.78,16094.92
6175,2/26/2021,2/26/2021,22621,82L-IMPORT PAYROLL-OPUH NDIDI,D108,HJ,,35.65,16059.27
6175,2/26/2021,2/26/2021,22621,82L-IMPORT PAYROLL-SOBELMAN JUSTIN,D108,HJ,,1.78,16057.49
6175,2/26/2021,2/26/2021,22621,82L-IMPORT PAYROLL-SOBELMAN JUSTIN,D108,HJ,,11.96,16045.53
6175,2/26/2021,2/26/2021,22621,82L-IMPORT PAYROLL-TERRENCE-SMITH ZIHIR,D108,HJ,,1.78,16043.75
6175,2/26/2021,2/26/2021,22621,82L-IMPORT PAYROLL-TERRENCE-SMITH ZIHIR,D108,HJ,,14.83,16028.92
6175,2/26/2021,2/26/2021,22621,82L-IMPORT PAYROLL-WILLIAMS-MASSEY BRIANNA,D108,HJ,,11.96,16016.96
6175,2/26/2021,2/26/2021,22621,82L-IMPORT PAYROLL-COVENEY ALLISON,D108,HJ,,1.78,16015.18
6175,2/26/2021,2/26/2021,22621,82L-IMPORT PAYROLL-COVENEY ALLISON,D108,HJ,,14.83,16000.35
6175,2/26/2021,2/26/2021,22621,82L-IMPORT PAYROLL-JACKSON CLAICE M,D108,HJ,,1.78,15998.57
6175,2/26/2021,2/26/2021,22621,82L-IMPORT PAYROLL-JACKSON CLAICE M,D108,HJ,,11.96,15986.61
6175,2/26/2021,2/26/2021,22621,82L-IMPORT PAYROLL-JANG DANIEL,D108,HJ,,1.78,15984.83
6175,2/26/2021,2/26/2021,22621,82L-IMPORT PAYROLL-JANG DANIEL,D108,HJ,,14.83,15970
6175,2/26/2021,2/26/2021,22621,82L-IMPORT PAYROLL-LENEGHAN MARYELLEN,D108,HJ,,1.78,15968.22
6175,2/26/2021,2/26/2021,22621,82L-IMPORT PAYROLL-LENEGHAN MARYELLEN,D108,HJ,,11.96,15956.26
6175,3/3/2021,3/3/2021,BCBS,March 2021 BCBS payment,D108,HJ,855.24,,16811.5
6175,3/3/2021,3/3/2021,BCBS,March 2021 BCBS payment,D108,HJ,667.84,,17479.34
6175,3/3/2021,3/3/2021,BCBS,March 2021 BCBS payment,D107,HJ,6028.84,,23508.18
6175,3/3/2021,3/3/2021,BCBS,March 2021 BCBS payment,D108,HJ,1159.82,,24668
6175,3/3/2021,3/3/2021,BCBS,March 2021 BCBS payment,D108,HJ,47.83,,24715.83
6175,3/3/2021,3/3/2021,JE-21-0185,Blue 20/20 Vision Insurance - February 82L,D108,HJ,113.21,,24829.04
6175,3/3/2021,3/3/2021,JE-21-0185,Blue 20/20 Vision Insurance - February 82L,D108,HJ,49.77,,24878.81
6175,3/3/2021,3/3/2021,JE-21-0185,Blue 20/20 Vision Insurance - February 82L,D107,HJ,41.95,,24920.76
6175,3/3/2021,3/3/2021,JE-21-0185,Blue 20/20 Vision Insurance - February 82L,D107,HJ,49.35,,24970.11
6175,3/3/2021,3/3/2021,JE-21-0185,Blue 20/20 Vision Insurance - February 82L,D108,HJ,71.1,,25041.21
6175,3/3/2021,3/3/2021,JE-21-0185,Blue 20/20 Vision Insurance - February 82L,D108,HJ,21.33,,25062.54
6175,3/3/2021,3/3/2021,JE-21-0186,Blue 20/20 Vision Ins - March Payment LUX,D108,HJ,7.11,,25069.65
6175,3/15/2021,3/15/2021,31521,82L-IMPORT PAYROLL,D108,HJ,,1.78,25067.87
6175,3/15/2021,3/15/2021,31521,82L-IMPORT PAYROLL,D108,HJ,,1.78,25066.09
6175,3/15/2021,3/15/2021,31521,82L-IMPORT PAYROLL,D108,HJ,,1.78,25064.31
6175,3/15/2021,3/15/2021,31521,82L-IMPORT PAYROLL,D108,HJ,,1.78,25062.53
6175,3/15/2021,3/15/2021,31521,82L-IMPORT PAYROLL,D108,HJ,,1.78,25060.75
6175,3/15/2021,3/15/2021,31521,82L-IMPORT PAYROLL,D108,HJ,,1.78,25058.97
6175,3/15/2021,3/15/2021,31521,82L-IMPORT PAYROLL,D108,HJ,,1.78,25057.19
6175,3/15/2021,3/15/2021,31521,82L-IMPORT PAYROLL,D108,HJ,,1.78,25055.41
6175,3/15/2021,3/15/2021,31521,82L-IMPORT PAYROLL,D108,HJ,,1.78,25053.63
6175,3/15/2021,3/15/2021,31521,82L-IMPORT PAYROLL,D108,HJ,,1.78,25051.85
6175,3/15/2021,3/15/2021,31521,82L-IMPORT PAYROLL,D108,HJ,,1.78,25050.07
6175,3/15/2021,3/15/2021,31521,82L-IMPORT PAYROLL,D108,HJ,,1.78,25048.29
6175,3/15/2021,3/15/2021,31521,82L-IMPORT PAYROLL,D108,HJ,,5.23,25043.06
6175,3/15/2021,3/15/2021,31521,82L-IMPORT PAYROLL,D108,HJ,,11.96,25031.1
6175,3/15/2021,3/15/2021,31521,82L-IMPORT PAYROLL,D108,HJ,,11.96,25019.14
6175,3/15/2021,3/15/2021,31521,82L-IMPORT PAYROLL,D108,HJ,,11.96,25007.18
6175,3/15/2021,3/15/2021,31521,82L-IMPORT PAYROLL,D108,HJ,,11.96,24995.22
6175,3/15/2021,3/15/2021,31521,82L-IMPORT PAYROLL,D108,HJ,,11.96,24983.26
6175,3/15/2021,3/15/2021,31521,82L-IMPORT PAYROLL,D108,HJ,,11.96,24971.3
6175,3/15/2021,3/15/2021,31521,82L-IMPORT PAYROLL,D108,HJ,,14.83,24956.47
6175,3/15/2021,3/15/2021,31521,82L-IMPORT PAYROLL,D108,HJ,,14.83,24941.64
6175,3/15/2021,3/15/2021,31521,82L-IMPORT PAYROLL,D108,HJ,,14.83,24926.81
6175,3/15/2021,3/15/2021,31521,82L-IMPORT PAYROLL,D108,HJ,,14.83,24911.98
6175,3/15/2021,3/15/2021,31521,82L-IMPORT PAYROLL,D108,HJ,,14.83,24897.15
6175,3/15/2021,3/15/2021,31521,82L-IMPORT PAYROLL,D108,HJ,,14.83,24882.32
6175,3/15/2021,3/15/2021,31521,82L-IMPORT PAYROLL,D108,HJ,,44.2,24838.12
6175,3/15/2021,3/15/2021,31521,82L-IMPORT PAYROLL,D108,HJ,,1.78,24836.34
6175,3/15/2021,3/15/2021,31521,82L-IMPORT PAYROLL,D108,HJ,,1.78,24834.56
6175,3/15/2021,3/15/2021,31521,82L-IMPORT PAYROLL,D108,HJ,,1.78,24832.78
6175,3/15/2021,3/15/2021,31521,82L-IMPORT PAYROLL,D108,HJ,,1.78,24831
6175,3/15/2021,3/15/2021,31521,82L-IMPORT PAYROLL,D108,HJ,,1.78,24829.22
6175,3/15/2021,3/15/2021,31521,82L-IMPORT PAYROLL,D108,HJ,,1.78,24827.44
6175,3/15/2021,3/15/2021,31521,82L-IMPORT PAYROLL,D108,HJ,,1.78,24825.66
6175,3/15/2021,3/15/2021,31521,82L-IMPORT PAYROLL,D108,HJ,,1.78,24823.88
6175,3/15/2021,3/15/2021,31521,82L-IMPORT PAYROLL,D108,HJ,,1.78,24822.1
6175,3/15/2021,3/15/2021,31521,82L-IMPORT PAYROLL,D108,HJ,,1.78,24820.32
6175,3/15/2021,3/15/2021,31521,82L-IMPORT PAYROLL,D108,HJ,,1.78,24818.54
6175,3/15/2021,3/15/2021,31521,82L-IMPORT PAYROLL,D108,HJ,,1.78,24816.76
6175,3/15/2021,3/15/2021,31521,82L-IMPORT PAYROLL,D108,HJ,,3.56,24813.2
6175,3/15/2021,3/15/2021,31521,82L-IMPORT PAYROLL,D108,HJ,,5.23,24807.97
6175,3/15/2021,3/15/2021,31521,82L-IMPORT PAYROLL,D108,HJ,,5.23,24802.74
6175,3/15/2021,3/15/2021,31521,82L-IMPORT PAYROLL,D108,HJ,,5.23,24797.51
6175,3/15/2021,3/15/2021,31521,82L-IMPORT PAYROLL,D108,HJ,,11.96,24785.55
6175,3/15/2021,3/15/2021,31521,82L-IMPORT PAYROLL,D108,HJ,,11.96,24773.59
6175,3/15/2021,3/15/2021,31521,82L-IMPORT PAYROLL,D108,HJ,,11.96,24761.63
6175,3/15/2021,3/15/2021,31521,82L-IMPORT PAYROLL,D108,HJ,,11.96,24749.67
6175,3/15/2021,3/15/2021,31521,82L-IMPORT PAYROLL,D108,HJ,,11.96,24737.71
6175,3/15/2021,3/15/2021,31521,82L-IMPORT PAYROLL,D108,HJ,,11.96,24725.75
6175,3/15/2021,3/15/2021,31521,82L-IMPORT PAYROLL,D108,HJ,,11.96,24713.79
6175,3/15/2021,3/15/2021,31521,82L-IMPORT PAYROLL,D108,HJ,,11.96,24701.83
6175,3/15/2021,3/15/2021,31521,82L-IMPORT PAYROLL,D108,HJ,,14.83,24687
6175,3/15/2021,3/15/2021,31521,82L-IMPORT PAYROLL,D108,HJ,,14.83,24672.17
6175,3/15/2021,3/15/2021,31521,82L-IMPORT PAYROLL,D108,HJ,,14.83,24657.34
6175,3/15/2021,3/15/2021,31521,82L-IMPORT PAYROLL,D108,HJ,,35.65,24621.69
6175,3/15/2021,3/15/2021,31521,82L-IMPORT PAYROLL,D108,HJ,,35.65,24586.04
6175,3/15/2021,3/15/2021,31521,82L-IMPORT PAYROLL,D108,HJ,,35.65,24550.39
6175,3/15/2021,3/15/2021,31521,82L-IMPORT PAYROLL,D101,HJ,,1.78,24548.61
6175,3/15/2021,3/15/2021,31521,82L-IMPORT PAYROLL,D101,HJ,,1.78,24546.83
6175,3/15/2021,3/15/2021,31521,82L-IMPORT PAYROLL,D101,HJ,,1.78,24545.05
6175,3/15/2021,3/15/2021,31521,82L-IMPORT PAYROLL,D101,HJ,,3.38,24541.67
6175,3/15/2021,3/15/2021,31521,82L-IMPORT PAYROLL,D101,HJ,,11.96,24529.71
6175,3/15/2021,3/15/2021,31521,82L-IMPORT PAYROLL,D101,HJ,,11.96,24517.75
6175,3/15/2021,3/15/2021,31521,82L-IMPORT PAYROLL,D101,HJ,,11.96,24505.79
6175,3/15/2021,3/15/2021,31521,82L-IMPORT PAYROLL,D101,HJ,,14.83,24490.96
6175,3/15/2021,3/15/2021,31521,82L-IMPORT PAYROLL,D101,HJ,,25.48,24465.48
6175,3/15/2021,3/15/2021,31521,82L-IMPORT PAYROLL,D102,HJ,,1.78,24463.7
6175,3/15/2021,3/15/2021,31521,82L-IMPORT PAYROLL,D102,HJ,,1.78,24461.92
6175,3/15/2021,3/15/2021,31521,82L-IMPORT PAYROLL,D102,HJ,,11.96,24449.96
6175,3/15/2021,3/15/2021,31521,82L-IMPORT PAYROLL,D102,HJ,,11.96,24438
6175,3/15/2021,3/15/2021,31521,82L-IMPORT PAYROLL,D103,HJ,,1.78,24436.22
6175,3/15/2021,3/15/2021,31521,82L-IMPORT PAYROLL,D103,HJ,,11.96,24424.26
6175,3/15/2021,3/15/2021,31521,82L-IMPORT PAYROLL,D103,HJ,,11.96,24412.3
6175,3/15/2021,3/15/2021,31521,82L-IMPORT PAYROLL,D104,HJ,,1.78,24410.52
6175,3/15/2021,3/15/2021,31521,82L-IMPORT PAYROLL,D104,HJ,,1.78,24408.74
6175,3/15/2021,3/15/2021,31521,82L-IMPORT PAYROLL,D104,HJ,,1.78,24406.96
6175,3/15/2021,3/15/2021,31521,82L-IMPORT PAYROLL,D104,HJ,,1.78,24405.18
6175,3/15/2021,3/15/2021,31521,82L-IMPORT PAYROLL,D104,HJ,,1.78,24403.4
6175,3/15/2021,3/15/2021,31521,82L-IMPORT PAYROLL,D104,HJ,,11.96,24391.44
6175,3/15/2021,3/15/2021,31521,82L-IMPORT PAYROLL,D104,HJ,,11.96,24379.48
6175,3/15/2021,3/15/2021,31521,82L-IMPORT PAYROLL,D104,HJ,,14.83,24364.65
6175,3/15/2021,3/15/2021,31521,82L-IMPORT PAYROLL,D104,HJ,,14.83,24349.82
6175,3/15/2021,3/15/2021,31521,82L-IMPORT PAYROLL,D104,HJ,,14.83,24334.99
6175,3/15/2021,3/15/2021,31521,82L-IMPORT PAYROLL,D104,HJ,,44.2,24290.79
6175,3/15/2021,3/15/2021,31521,82L-IMPORT PAYROLL,D105,HJ,,1.78,24289.01
6175,3/15/2021,3/15/2021,31521,82L-IMPORT PAYROLL,D105,HJ,,1.78,24287.23
6175,3/15/2021,3/15/2021,31521,82L-IMPORT PAYROLL,D105,HJ,,1.78,24285.45
6175,3/15/2021,3/15/2021,31521,82L-IMPORT PAYROLL,D105,HJ,,11.96,24273.49
6175,3/15/2021,3/15/2021,31521,82L-IMPORT PAYROLL,D105,HJ,,14.83,24258.66
6175,3/15/2021,3/15/2021,31521,82L-IMPORT PAYROLL,D105,HJ,,14.83,24243.83
6175,3/15/2021,3/15/2021,31521,82L-IMPORT PAYROLL,D107,HJ,,1.78,24242.05
6175,3/15/2021,3/15/2021,31521,82L-IMPORT PAYROLL,D107,HJ,,5.23,24236.82
6175,3/15/2021,3/15/2021,31521,82L-IMPORT PAYROLL,D107,HJ,,11.93,24224.89
6175,3/15/2021,3/15/2021,31521,82L-IMPORT PAYROLL,D107,HJ,,25.48,24199.41
6175,3/15/2021,3/15/2021,31521,82L-IMPORT PAYROLL,D107,HJ,,35.65,24163.76
6175,3/15/2021,3/15/2021,31521,82L-IMPORT PAYROLL,D107,HJ,,35.65,24128.11
6175,3/15/2021,3/15/2021,31521,82L-IMPORT PAYROLL,D109,HJ,,1.78,24126.33
6175,3/15/2021,3/15/2021,31521,82L-IMPORT PAYROLL,D109,HJ,,1.78,24124.55
6175,3/15/2021,3/15/2021,31521,82L-IMPORT PAYROLL,D109,HJ,,1.78,24122.77
6175,3/15/2021,3/15/2021,31521,82L-IMPORT PAYROLL,D109,HJ,,1.78,24120.99
6175,3/15/2021,3/15/2021,31521,82L-IMPORT PAYROLL,D109,HJ,,1.78,24119.21
6175,3/15/2021,3/15/2021,31521,82L-IMPORT PAYROLL,D109,HJ,,5.23,24113.98
6175,3/15/2021,3/15/2021,31521,82L-IMPORT PAYROLL,D109,HJ,,5.23,24108.75
6175,3/15/2021,3/15/2021,31521,82L-IMPORT PAYROLL,D109,HJ,,11.96,24096.79
6175,3/15/2021,3/15/2021,31521,82L-IMPORT PAYROLL,D109,HJ,,11.96,24084.83
6175,3/15/2021,3/15/2021,31521,82L-IMPORT PAYROLL,D109,HJ,,14.83,24070
6175,3/15/2021,3/15/2021,31521,82L-IMPORT PAYROLL,D109,HJ,,14.83,24055.17
6175,3/15/2021,3/15/2021,31521,82L-IMPORT PAYROLL,D109,HJ,,14.83,24040.34
6175,3/15/2021,3/15/2021,31521,82L-IMPORT PAYROLL,D109,HJ,,44.2,23996.14
6175,3/15/2021,3/15/2021,31521,82L-IMPORT PAYROLL,D109,HJ,,44.2,23951.94
6175,3/15/2021,3/15/2021,31521,82L-IMPORT PAYROLL,D111,HJ,,1.78,23950.16
6175,3/15/2021,3/15/2021,31521,82L-IMPORT PAYROLL,D111,HJ,,1.78,23948.38
6175,3/15/2021,3/15/2021,31521,82L-IMPORT PAYROLL,D111,HJ,,1.78,23946.6
6175,3/15/2021,3/15/2021,31521,82L-IMPORT PAYROLL,D111,HJ,,1.78,23944.82
6175,3/15/2021,3/15/2021,31521,82L-IMPORT PAYROLL,D111,HJ,,11.96,23932.86
6175,3/15/2021,3/15/2021,31521,82L-IMPORT PAYROLL,D111,HJ,,11.96,23920.9
6175,3/15/2021,3/15/2021,31521,82L-IMPORT PAYROLL,D111,HJ,,11.96,23908.94
6175,3/15/2021,3/15/2021,31521,82L-IMPORT PAYROLL,D112,HJ,,3.56,23905.38
6175,3/15/2021,3/15/2021,31521,82L-IMPORT PAYROLL,D112,HJ,,31.6,23873.78
6175,3/15/2021,3/15/2021,31521,82L-IMPORT PAYROLL,D108,HJ,,1.78,23872
6175,3/15/2021,3/15/2021,31521,82L-IMPORT PAYROLL,D108,HJ,,1.78,23870.22
6175,3/15/2021,3/15/2021,31521,82L-IMPORT PAYROLL,D108,HJ,,1.78,23868.44
6175,3/15/2021,3/15/2021,31521,82L-IMPORT PAYROLL,D108,HJ,,1.78,23866.66
6175,3/15/2021,3/15/2021,31521,82L-IMPORT PAYROLL,D108,HJ,,1.78,23864.88
6175,3/15/2021,3/15/2021,31521,82L-IMPORT PAYROLL,D108,HJ,,1.78,23863.1
6175,3/15/2021,3/15/2021,31521,82L-IMPORT PAYROLL,D108,HJ,,1.78,23861.32
6175,3/15/2021,3/15/2021,31521,82L-IMPORT PAYROLL,D108,HJ,,1.78,23859.54
6175,3/15/2021,3/15/2021,31521,82L-IMPORT PAYROLL,D108,HJ,,1.78,23857.76
6175,3/15/2021,3/15/2021,31521,82L-IMPORT PAYROLL,D108,HJ,,1.78,23855.98
6175,3/15/2021,3/15/2021,31521,82L-IMPORT PAYROLL,D108,HJ,,1.78,23854.2
6175,3/15/2021,3/15/2021,31521,82L-IMPORT PAYROLL,D108,HJ,,1.78,23852.42
6175,3/15/2021,3/15/2021,31521,82L-IMPORT PAYROLL,D108,HJ,,1.78,23850.64
6175,3/15/2021,3/15/2021,31521,82L-IMPORT PAYROLL,D108,HJ,,1.78,23848.86
6175,3/15/2021,3/15/2021,31521,82L-IMPORT PAYROLL,D108,HJ,,11.96,23836.9
6175,3/15/2021,3/15/2021,31521,82L-IMPORT PAYROLL,D108,HJ,,11.96,23824.94
6175,3/15/2021,3/15/2021,31521,82L-IMPORT PAYROLL,D108,HJ,,11.96,23812.98
6175,3/15/2021,3/15/2021,31521,82L-IMPORT PAYROLL,D108,HJ,,11.96,23801.02
6175,3/15/2021,3/15/2021,31521,82L-IMPORT PAYROLL,D108,HJ,,11.96,23789.06
6175,3/15/2021,3/15/2021,31521,82L-IMPORT PAYROLL,D108,HJ,,11.96,23777.1
6175,3/15/2021,3/15/2021,31521,82L-IMPORT PAYROLL,D108,HJ,,11.96,23765.14
6175,3/15/2021,3/15/2021,31521,82L-IMPORT PAYROLL,D108,HJ,,11.96,23753.18
6175,3/15/2021,3/15/2021,31521,82L-IMPORT PAYROLL,D108,HJ,,11.96,23741.22
6175,3/15/2021,3/15/2021,31521,82L-IMPORT PAYROLL,D108,HJ,,14.83,23726.39
6175,3/15/2021,3/15/2021,31521,82L-IMPORT PAYROLL,D108,HJ,,14.83,23711.56
6175,3/15/2021,3/15/2021,31521,82L-IMPORT PAYROLL,D108,HJ,,14.83,23696.73
6175,3/15/2021,3/15/2021,31521,82L-IMPORT PAYROLL,D108,HJ,,14.83,23681.9
6175,3/15/2021,3/15/2021,31521,82L-IMPORT PAYROLL,D108,HJ,,14.83,23667.07
6175,3/15/2021,3/15/2021,31521,82L-IMPORT PAYROLL,D108,HJ,,35.65,23631.42
6175,3/15/2021,3/15/2021,31521,82L-IMPORT PAYROLL,D108,HJ,,1.78,23629.64
6175,3/15/2021,3/15/2021,31521,82L-IMPORT PAYROLL,D108,HJ,,1.78,23627.86
6175,3/15/2021,3/15/2021,31521,82L-IMPORT PAYROLL,D108,HJ,,1.78,23626.08
6175,3/15/2021,3/15/2021,31521,82L-IMPORT PAYROLL,D108,HJ,,1.78,23624.3
6175,3/15/2021,3/15/2021,31521,82L-IMPORT PAYROLL,D108,HJ,,11.96,23612.34
6175,3/15/2021,3/15/2021,31521,82L-IMPORT PAYROLL,D108,HJ,,11.96,23600.38
6175,3/15/2021,3/15/2021,31521,82L-IMPORT PAYROLL,D108,HJ,,14.83,23585.55
6175,3/15/2021,3/15/2021,31521,82L-IMPORT PAYROLL,D108,HJ,,14.83,23570.72
6175,3/31/2021,3/31/2021,33121,82L-IMPORT PAYROLL,D108,HJ,,1.78,23568.94
6175,3/31/2021,3/31/2021,33121,82L-IMPORT PAYROLL,D108,HJ,,1.78,23567.16
6175,3/31/2021,3/31/2021,33121,82L-IMPORT PAYROLL,D108,HJ,,1.78,23565.38
6175,3/31/2021,3/31/2021,33121,82L-IMPORT PAYROLL,D108,HJ,,1.78,23563.6
6175,3/31/2021,3/31/2021,33121,82L-IMPORT PAYROLL,D108,HJ,,1.78,23561.82
6175,3/31/2021,3/31/2021,33121,82L-IMPORT PAYROLL,D108,HJ,,1.78,23560.04
6175,3/31/2021,3/31/2021,33121,82L-IMPORT PAYROLL,D108,HJ,,1.78,23558.26
6175,3/31/2021,3/31/2021,33121,82L-IMPORT PAYROLL,D108,HJ,,1.78,23556.48
6175,3/31/2021,3/31/2021,33121,82L-IMPORT PAYROLL,D108,HJ,,1.78,23554.7
6175,3/31/2021,3/31/2021,33121,82L-IMPORT PAYROLL,D108,HJ,,1.78,23552.92
6175,3/31/2021,3/31/2021,33121,82L-IMPORT PAYROLL,D108,HJ,,1.78,23551.14
6175,3/31/2021,3/31/2021,33121,82L-IMPORT PAYROLL,D108,HJ,,1.78,23549.36
6175,3/31/2021,3/31/2021,33121,82L-IMPORT PAYROLL,D108,HJ,,5.23,23544.13
6175,3/31/2021,3/31/2021,33121,82L-IMPORT PAYROLL,D108,HJ,,11.96,23532.17
6175,3/31/2021,3/31/2021,33121,82L-IMPORT PAYROLL,D108,HJ,,11.96,23520.21
6175,3/31/2021,3/31/2021,33121,82L-IMPORT PAYROLL,D108,HJ,,11.96,23508.25
6175,3/31/2021,3/31/2021,33121,82L-IMPORT PAYROLL,D108,HJ,,11.96,23496.29
6175,3/31/2021,3/31/2021,33121,82L-IMPORT PAYROLL,D108,HJ,,11.96,23484.33
6175,3/31/2021,3/31/2021,33121,82L-IMPORT PAYROLL,D108,HJ,,11.96,23472.37
6175,3/31/2021,3/31/2021,33121,82L-IMPORT PAYROLL,D108,HJ,,14.83,23457.54
6175,3/31/2021,3/31/2021,33121,82L-IMPORT PAYROLL,D108,HJ,,14.83,23442.71
6175,3/31/2021,3/31/2021,33121,82L-IMPORT PAYROLL,D108,HJ,,14.83,23427.88
6175,3/31/2021,3/31/2021,33121,82L-IMPORT PAYROLL,D108,HJ,,14.83,23413.05
6175,3/31/2021,3/31/2021,33121,82L-IMPORT PAYROLL,D108,HJ,,14.83,23398.22
6175,3/31/2021,3/31/2021,33121,82L-IMPORT PAYROLL,D108,HJ,,14.83,23383.39
6175,3/31/2021,3/31/2021,33121,82L-IMPORT PAYROLL,D108,HJ,,44.2,23339.19
6175,3/31/2021,3/31/2021,33121,82L-IMPORT PAYROLL,D108,HJ,,1.78,23337.41
6175,3/31/2021,3/31/2021,33121,82L-IMPORT PAYROLL,D108,HJ,,1.78,23335.63
6175,3/31/2021,3/31/2021,33121,82L-IMPORT PAYROLL,D108,HJ,,1.78,23333.85
6175,3/31/2021,3/31/2021,33121,82L-IMPORT PAYROLL,D108,HJ,,1.78,23332.07
6175,3/31/2021,3/31/2021,33121,82L-IMPORT PAYROLL,D108,HJ,,1.78,23330.29
6175,3/31/2021,3/31/2021,33121,82L-IMPORT PAYROLL,D108,HJ,,1.78,23328.51
6175,3/31/2021,3/31/2021,33121,82L-IMPORT PAYROLL,D108,HJ,,1.78,23326.73
6175,3/31/2021,3/31/2021,33121,82L-IMPORT PAYROLL,D108,HJ,,1.78,23324.95
6175,3/31/2021,3/31/2021,33121,82L-IMPORT PAYROLL,D108,HJ,,1.78,23323.17
6175,3/31/2021,3/31/2021,33121,82L-IMPORT PAYROLL,D108,HJ,,1.78,23321.39
6175,3/31/2021,3/31/2021,33121,82L-IMPORT PAYROLL,D108,HJ,,1.78,23319.61
6175,3/31/2021,3/31/2021,33121,82L-IMPORT PAYROLL,D108,HJ,,1.78,23317.83
6175,3/31/2021,3/31/2021,33121,82L-IMPORT PAYROLL,D108,HJ,,3.56,23314.27
6175,3/31/2021,3/31/2021,33121,82L-IMPORT PAYROLL,D108,HJ,,5.23,23309.04
6175,3/31/2021,3/31/2021,33121,82L-IMPORT PAYROLL,D108,HJ,,5.23,23303.81
6175,3/31/2021,3/31/2021,33121,82L-IMPORT PAYROLL,D108,HJ,,5.23,23298.58
6175,3/31/2021,3/31/2021,33121,82L-IMPORT PAYROLL,D108,HJ,,11.96,23286.62
6175,3/31/2021,3/31/2021,33121,82L-IMPORT PAYROLL,D108,HJ,,11.96,23274.66
6175,3/31/2021,3/31/2021,33121,82L-IMPORT PAYROLL,D108,HJ,,11.96,23262.7
6175,3/31/2021,3/31/2021,33121,82L-IMPORT PAYROLL,D108,HJ,,11.96,23250.74
6175,3/31/2021,3/31/2021,33121,82L-IMPORT PAYROLL,D108,HJ,,11.96,23238.78
6175,3/31/2021,3/31/2021,33121,82L-IMPORT PAYROLL,D108,HJ,,11.96,23226.82
6175,3/31/2021,3/31/2021,33121,82L-IMPORT PAYROLL,D108,HJ,,11.96,23214.86
6175,3/31/2021,3/31/2021,33121,82L-IMPORT PAYROLL,D108,HJ,,11.96,23202.9
6175,3/31/2021,3/31/2021,33121,82L-IMPORT PAYROLL,D108,HJ,,14.83,23188.07
6175,3/31/2021,3/31/2021,33121,82L-IMPORT PAYROLL,D108,HJ,,14.83,23173.24
6175,3/31/2021,3/31/2021,33121,82L-IMPORT PAYROLL,D108,HJ,,14.83,23158.41
6175,3/31/2021,3/31/2021,33121,82L-IMPORT PAYROLL,D108,HJ,,35.65,23122.76
6175,3/31/2021,3/31/2021,33121,82L-IMPORT PAYROLL,D108,HJ,,35.65,23087.11
6175,3/31/2021,3/31/2021,33121,82L-IMPORT PAYROLL,D108,HJ,,35.65,23051.46
6175,3/31/2021,3/31/2021,33121,82L-IMPORT PAYROLL,D101,HJ,,1.78,23049.68
6175,3/31/2021,3/31/2021,33121,82L-IMPORT PAYROLL,D101,HJ,,1.78,23047.9
6175,3/31/2021,3/31/2021,33121,82L-IMPORT PAYROLL,D101,HJ,,1.78,23046.12
6175,3/31/2021,3/31/2021,33121,82L-IMPORT PAYROLL,D101,HJ,,3.38,23042.74
6175,3/31/2021,3/31/2021,33121,82L-IMPORT PAYROLL,D101,HJ,,11.96,23030.78
6175,3/31/2021,3/31/2021,33121,82L-IMPORT PAYROLL,D101,HJ,,11.96,23018.82
6175,3/31/2021,3/31/2021,33121,82L-IMPORT PAYROLL,D101,HJ,,11.96,23006.86
6175,3/31/2021,3/31/2021,33121,82L-IMPORT PAYROLL,D101,HJ,,14.83,22992.03
6175,3/31/2021,3/31/2021,33121,82L-IMPORT PAYROLL,D101,HJ,,25.48,22966.55
6175,3/31/2021,3/31/2021,33121,82L-IMPORT PAYROLL,D102,HJ,,1.78,22964.77
6175,3/31/2021,3/31/2021,33121,82L-IMPORT PAYROLL,D102,HJ,,1.78,22962.99
6175,3/31/2021,3/31/2021,33121,82L-IMPORT PAYROLL,D102,HJ,,11.96,22951.03
6175,3/31/2021,3/31/2021,33121,82L-IMPORT PAYROLL,D102,HJ,,11.96,22939.07
6175,3/31/2021,3/31/2021,33121,82L-IMPORT PAYROLL,D103,HJ,,1.78,22937.29
6175,3/31/2021,3/31/2021,33121,82L-IMPORT PAYROLL,D103,HJ,,11.96,22925.33
6175,3/31/2021,3/31/2021,33121,82L-IMPORT PAYROLL,D103,HJ,,11.96,22913.37
6175,3/31/2021,3/31/2021,33121,82L-IMPORT PAYROLL,D104,HJ,,1.78,22911.59
6175,3/31/2021,3/31/2021,33121,82L-IMPORT PAYROLL,D104,HJ,,1.78,22909.81
6175,3/31/2021,3/31/2021,33121,82L-IMPORT PAYROLL,D104,HJ,,1.78,22908.03
6175,3/31/2021,3/31/2021,33121,82L-IMPORT PAYROLL,D104,HJ,,1.78,22906.25
6175,3/31/2021,3/31/2021,33121,82L-IMPORT PAYROLL,D104,HJ,,1.78,22904.47
6175,3/31/2021,3/31/2021,33121,82L-IMPORT PAYROLL,D104,HJ,,11.96,22892.51
6175,3/31/2021,3/31/2021,33121,82L-IMPORT PAYROLL,D104,HJ,,11.96,22880.55
6175,3/31/2021,3/31/2021,33121,82L-IMPORT PAYROLL,D104,HJ,,14.83,22865.72
6175,3/31/2021,3/31/2021,33121,82L-IMPORT PAYROLL,D104,HJ,,14.83,22850.89
6175,3/31/2021,3/31/2021,33121,82L-IMPORT PAYROLL,D104,HJ,,14.83,22836.06
6175,3/31/2021,3/31/2021,33121,82L-IMPORT PAYROLL,D104,HJ,,44.2,22791.86
6175,3/31/2021,3/31/2021,33121,82L-IMPORT PAYROLL,D105,HJ,,1.78,22790.08
6175,3/31/2021,3/31/2021,33121,82L-IMPORT PAYROLL,D105,HJ,,1.78,22788.3
6175,3/31/2021,3/31/2021,33121,82L-IMPORT PAYROLL,D105,HJ,,1.78,22786.52
6175,3/31/2021,3/31/2021,33121,82L-IMPORT PAYROLL,D105,HJ,,11.96,22774.56
6175,3/31/2021,3/31/2021,33121,82L-IMPORT PAYROLL,D105,HJ,,14.83,22759.73
6175,3/31/2021,3/31/2021,33121,82L-IMPORT PAYROLL,D105,HJ,,14.83,22744.9
6175,3/31/2021,3/31/2021,33121,82L-IMPORT PAYROLL,D107,HJ,,1.78,22743.12
6175,3/31/2021,3/31/2021,33121,82L-IMPORT PAYROLL,D107,HJ,,5.23,22737.89
6175,3/31/2021,3/31/2021,33121,82L-IMPORT PAYROLL,D107,HJ,,11.96,22725.93
6175,3/31/2021,3/31/2021,33121,82L-IMPORT PAYROLL,D107,HJ,,25.48,22700.45
6175,3/31/2021,3/31/2021,33121,82L-IMPORT PAYROLL,D107,HJ,,35.65,22664.8
6175,3/31/2021,3/31/2021,33121,82L-IMPORT PAYROLL,D107,HJ,,35.65,22629.15
6175,3/31/2021,3/31/2021,33121,82L-IMPORT PAYROLL,D109,HJ,,1.78,22627.37
6175,3/31/2021,3/31/2021,33121,82L-IMPORT PAYROLL,D109,HJ,,1.78,22625.59
6175,3/31/2021,3/31/2021,33121,82L-IMPORT PAYROLL,D109,HJ,,1.78,22623.81
6175,3/31/2021,3/31/2021,33121,82L-IMPORT PAYROLL,D109,HJ,,1.78,22622.03
6175,3/31/2021,3/31/2021,33121,82L-IMPORT PAYROLL,D109,HJ,,1.78,22620.25
6175,3/31/2021,3/31/2021,33121,82L-IMPORT PAYROLL,D109,HJ,,5.23,22615.02
6175,3/31/2021,3/31/2021,33121,82L-IMPORT PAYROLL,D109,HJ,,5.23,22609.79
6175,3/31/2021,3/31/2021,33121,82L-IMPORT PAYROLL,D109,HJ,,11.96,22597.83
6175,3/31/2021,3/31/2021,33121,82L-IMPORT PAYROLL,D109,HJ,,11.96,22585.87
6175,3/31/2021,3/31/2021,33121,82L-IMPORT PAYROLL,D109,HJ,,14.83,22571.04
6175,3/31/2021,3/31/2021,33121,82L-IMPORT PAYROLL,D109,HJ,,14.83,22556.21
6175,3/31/2021,3/31/2021,33121,82L-IMPORT PAYROLL,D109,HJ,,14.83,22541.38
6175,3/31/2021,3/31/2021,33121,82L-IMPORT PAYROLL,D109,HJ,,44.2,22497.18
6175,3/31/2021,3/31/2021,33121,82L-IMPORT PAYROLL,D109,HJ,,44.2,22452.98
6175,3/31/2021,3/31/2021,33121,82L-IMPORT PAYROLL,D111,HJ,,1.78,22451.2
6175,3/31/2021,3/31/2021,33121,82L-IMPORT PAYROLL,D111,HJ,,1.78,22449.42
6175,3/31/2021,3/31/2021,33121,82L-IMPORT PAYROLL,D111,HJ,,1.78,22447.64
6175,3/31/2021,3/31/2021,33121,82L-IMPORT PAYROLL,D111,HJ,,1.78,22445.86
6175,3/31/2021,3/31/2021,33121,82L-IMPORT PAYROLL,D111,HJ,,11.96,22433.9
6175,3/31/2021,3/31/2021,33121,82L-IMPORT PAYROLL,D111,HJ,,11.96,22421.94
6175,3/31/2021,3/31/2021,33121,82L-IMPORT PAYROLL,D111,HJ,,11.96,22409.98
6175,3/31/2021,3/31/2021,33121,82L-IMPORT PAYROLL,D112,HJ,,3.56,22406.42
6175,3/31/2021,3/31/2021,33121,82L-IMPORT PAYROLL,D112,HJ,,31.6,22374.82
6175,3/31/2021,3/31/2021,33121,82L-IMPORT PAYROLL,D108,HJ,,1.78,22373.04
6175,3/31/2021,3/31/2021,33121,82L-IMPORT PAYROLL,D108,HJ,,1.78,22371.26
6175,3/31/2021,3/31/2021,33121,82L-IMPORT PAYROLL,D108,HJ,,1.78,22369.48
6175,3/31/2021,3/31/2021,33121,82L-IMPORT PAYROLL,D108,HJ,,1.78,22367.7
6175,3/31/2021,3/31/2021,33121,82L-IMPORT PAYROLL,D108,HJ,,1.78,22365.92
6175,3/31/2021,3/31/2021,33121,82L-IMPORT PAYROLL,D108,HJ,,1.78,22364.14
6175,3/31/2021,3/31/2021,33121,82L-IMPORT PAYROLL,D108,HJ,,1.78,22362.36
6175,3/31/2021,3/31/2021,33121,82L-IMPORT PAYROLL,D108,HJ,,1.78,22360.58
6175,3/31/2021,3/31/2021,33121,82L-IMPORT PAYROLL,D108,HJ,,1.78,22358.8
6175,3/31/2021,3/31/2021,33121,82L-IMPORT PAYROLL,D108,HJ,,1.78,22357.02
6175,3/31/2021,3/31/2021,33121,82L-IMPORT PAYROLL,D108,HJ,,1.78,22355.24
6175,3/31/2021,3/31/2021,33121,82L-IMPORT PAYROLL,D108,HJ,,1.78,22353.46
6175,3/31/2021,3/31/2021,33121,82L-IMPORT PAYROLL,D108,HJ,,1.78,22351.68
6175,3/31/2021,3/31/2021,33121,82L-IMPORT PAYROLL,D108,HJ,,1.78,22349.9
6175,3/31/2021,3/31/2021,33121,82L-IMPORT PAYROLL,D108,HJ,,11.96,22337.94
6175,3/31/2021,3/31/2021,33121,82L-IMPORT PAYROLL,D108,HJ,,11.96,22325.98
6175,3/31/2021,3/31/2021,33121,82L-IMPORT PAYROLL,D108,HJ,,11.96,22314.02
6175,3/31/2021,3/31/2021,33121,82L-IMPORT PAYROLL,D108,HJ,,11.96,22302.06
6175,3/31/2021,3/31/2021,33121,82L-IMPORT PAYROLL,D108,HJ,,11.96,22290.1
6175,3/31/2021,3/31/2021,33121,82L-IMPORT PAYROLL,D108,HJ,,11.96,22278.14
6175,3/31/2021,3/31/2021,33121,82L-IMPORT PAYROLL,D108,HJ,,11.96,22266.18
6175,3/31/2021,3/31/2021,33121,82L-IMPORT PAYROLL,D108,HJ,,11.96,22254.22
6175,3/31/2021,3/31/2021,33121,82L-IMPORT PAYROLL,D108,HJ,,11.96,22242.26
6175,3/31/2021,3/31/2021,33121,82L-IMPORT PAYROLL,D108,HJ,,14.83,22227.43
6175,3/31/2021,3/31/2021,33121,82L-IMPORT PAYROLL,D108,HJ,,14.83,22212.6
6175,3/31/2021,3/31/2021,33121,82L-IMPORT PAYROLL,D108,HJ,,14.83,22197.77
6175,3/31/2021,3/31/2021,33121,82L-IMPORT PAYROLL,D108,HJ,,14.83,22182.94
6175,3/31/2021,3/31/2021,33121,82L-IMPORT PAYROLL,D108,HJ,,14.83,22168.11
6175,3/31/2021,3/31/2021,33121,82L-IMPORT PAYROLL,D108,HJ,,35.65,22132.46
6175,3/31/2021,3/31/2021,33121,82L-IMPORT PAYROLL,D108,HJ,,1.78,22130.68
6175,3/31/2021,3/31/2021,33121,82L-IMPORT PAYROLL,D108,HJ,,1.78,22128.9
6175,3/31/2021,3/31/2021,33121,82L-IMPORT PAYROLL,D108,HJ,,1.78,22127.12
6175,3/31/2021,3/31/2021,33121,82L-IMPORT PAYROLL,D108,HJ,,1.78,22125.34
6175,3/31/2021,3/31/2021,33121,82L-IMPORT PAYROLL,D108,HJ,,11.96,22113.38
6175,3/31/2021,3/31/2021,33121,82L-IMPORT PAYROLL,D108,HJ,,11.96,22101.42
6175,3/31/2021,3/31/2021,33121,82L-IMPORT PAYROLL,D108,HJ,,14.83,22086.59
6175,3/31/2021,3/31/2021,33121,82L-IMPORT PAYROLL,D108,HJ,,14.83,22071.76
6175,4/2/2021,4/2/2021,BCBS,April 2021 BCBS Payment,D108,HJ,855.24,,22927
6175,4/2/2021,4/2/2021,BCBS,April 2021 BCBS Payment,D108,HJ,1215.54,,24142.54
6175,4/2/2021,4/2/2021,BCBS,April 2021 BCBS Payment,D107,HJ,1016.06,,25158.6
6175,4/2/2021,4/2/2021,BCBS,April 2021 BCBS Payment,D108,HJ,657.56,,25816.16
6175,4/2/2021,4/2/2021,BCBS,April 2021 BCBS Payment,D108,HJ,47.83,,25863.99
6175,4/2/2021,4/2/2021,JE-21-0202,Blue 20/20 Vision Ins - April Inv LUX,D108,HJ,7.11,,25871.1
6175,4/2/2021,4/2/2021,JE-21-0203,Blue 20/20 April Inv Payment 82L,D108,HJ,156,,26027.1
6175,4/2/2021,4/2/2021,JE-21-0203,Blue 20/20 April Inv Payment 82L,D108,HJ,719.34,,26746.44
6175,4/2/2021,4/2/2021,JE-21-0203,Blue 20/20 April Inv Payment 82L,D107,HJ,56.46,,26802.9
6175,4/2/2021,4/2/2021,JE-21-0203,Blue 20/20 April Inv Payment 82L,D107,HJ,205.48,,27008.38
6175,4/2/2021,4/2/2021,JE-21-0203,Blue 20/20 April Inv Payment 82L,D107,HJ,440.4,,27448.78
6175,4/2/2021,4/2/2021,JE-21-0203,Blue 20/20 April Inv Payment 82L,D108,HJ,170.64,,27619.42
6175,4/2/2021,4/2/2021,JE-21-0203,Blue 20/20 April Inv Payment 82L,D108,HJ,71.1,,27690.52
6175,4/15/2021,4/15/2021,41521,82L-IMPORT PAYROLL,D108,HJ,,1.78,27688.74
6175,4/15/2021,4/15/2021,41521,82L-IMPORT PAYROLL,D108,HJ,,1.78,27686.96
6175,4/15/2021,4/15/2021,41521,82L-IMPORT PAYROLL,D108,HJ,,1.78,27685.18
6175,4/15/2021,4/15/2021,41521,82L-IMPORT PAYROLL,D108,HJ,,1.78,27683.4
6175,4/15/2021,4/15/2021,41521,82L-IMPORT PAYROLL,D108,HJ,,1.78,27681.62
6175,4/15/2021,4/15/2021,41521,82L-IMPORT PAYROLL,D108,HJ,,1.78,27679.84
6175,4/15/2021,4/15/2021,41521,82L-IMPORT PAYROLL,D108,HJ,,1.78,27678.06
6175,4/15/2021,4/15/2021,41521,82L-IMPORT PAYROLL,D108,HJ,,1.78,27676.28
6175,4/15/2021,4/15/2021,41521,82L-IMPORT PAYROLL,D108,HJ,,1.78,27674.5
6175,4/15/2021,4/15/2021,41521,82L-IMPORT PAYROLL,D108,HJ,,1.78,27672.72
6175,4/15/2021,4/15/2021,41521,82L-IMPORT PAYROLL,D108,HJ,,1.78,27670.94
6175,4/15/2021,4/15/2021,41521,82L-IMPORT PAYROLL,D108,HJ,,1.78,27669.16
6175,4/15/2021,4/15/2021,41521,82L-IMPORT PAYROLL,D108,HJ,,5.23,27663.93
6175,4/15/2021,4/15/2021,41521,82L-IMPORT PAYROLL,D108,HJ,,11.96,27651.97
6175,4/15/2021,4/15/2021,41521,82L-IMPORT PAYROLL,D108,HJ,,11.96,27640.01
6175,4/15/2021,4/15/2021,41521,82L-IMPORT PAYROLL,D108,HJ,,11.96,27628.05
6175,4/15/2021,4/15/2021,41521,82L-IMPORT PAYROLL,D108,HJ,,11.96,27616.09
6175,4/15/2021,4/15/2021,41521,82L-IMPORT PAYROLL,D108,HJ,,11.96,27604.13
6175,4/15/2021,4/15/2021,41521,82L-IMPORT PAYROLL,D108,HJ,,11.96,27592.17
6175,4/15/2021,4/15/2021,41521,82L-IMPORT PAYROLL,D108,HJ,,14.83,27577.34
6175,4/15/2021,4/15/2021,41521,82L-IMPORT PAYROLL,D108,HJ,,14.83,27562.51
6175,4/15/2021,4/15/2021,41521,82L-IMPORT PAYROLL,D108,HJ,,14.83,27547.68
6175,4/15/2021,4/15/2021,41521,82L-IMPORT PAYROLL,D108,HJ,,14.83,27532.85
6175,4/15/2021,4/15/2021,41521,82L-IMPORT PAYROLL,D108,HJ,,14.83,27518.02
6175,4/15/2021,4/15/2021,41521,82L-IMPORT PAYROLL,D108,HJ,,14.83,27503.19
6175,4/15/2021,4/15/2021,41521,82L-IMPORT PAYROLL,D108,HJ,,44.2,27458.99
6175,4/15/2021,4/15/2021,41521,82L-IMPORT PAYROLL,D108,HJ,,1.78,27457.21
6175,4/15/2021,4/15/2021,41521,82L-IMPORT PAYROLL,D108,HJ,,1.78,27455.43
6175,4/15/2021,4/15/2021,41521,82L-IMPORT PAYROLL,D108,HJ,,1.78,27453.65
6175,4/15/2021,4/15/2021,41521,82L-IMPORT PAYROLL,D108,HJ,,1.78,27451.87
6175,4/15/2021,4/15/2021,41521,82L-IMPORT PAYROLL,D108,HJ,,1.78,27450.09
6175,4/15/2021,4/15/2021,41521,82L-IMPORT PAYROLL,D108,HJ,,1.78,27448.31
6175,4/15/2021,4/15/2021,41521,82L-IMPORT PAYROLL,D108,HJ,,1.78,27446.53
6175,4/15/2021,4/15/2021,41521,82L-IMPORT PAYROLL,D108,HJ,,1.78,27444.75
6175,4/15/2021,4/15/2021,41521,82L-IMPORT PAYROLL,D108,HJ,,1.78,27442.97
6175,4/15/2021,4/15/2021,41521,82L-IMPORT PAYROLL,D108,HJ,,1.78,27441.19
6175,4/15/2021,4/15/2021,41521,82L-IMPORT PAYROLL,D108,HJ,,1.78,27439.41
6175,4/15/2021,4/15/2021,41521,82L-IMPORT PAYROLL,D108,HJ,,1.78,27437.63
6175,4/15/2021,4/15/2021,41521,82L-IMPORT PAYROLL,D108,HJ,,3.56,27434.07
6175,4/15/2021,4/15/2021,41521,82L-IMPORT PAYROLL,D108,HJ,,5.23,27428.84
6175,4/15/2021,4/15/2021,41521,82L-IMPORT PAYROLL,D108,HJ,,5.23,27423.61
6175,4/15/2021,4/15/2021,41521,82L-IMPORT PAYROLL,D108,HJ,,5.23,27418.38
6175,4/15/2021,4/15/2021,41521,82L-IMPORT PAYROLL,D108,HJ,,11.96,27406.42
6175,4/15/2021,4/15/2021,41521,82L-IMPORT PAYROLL,D108,HJ,,11.96,27394.46
6175,4/15/2021,4/15/2021,41521,82L-IMPORT PAYROLL,D108,HJ,,11.96,27382.5
6175,4/15/2021,4/15/2021,41521,82L-IMPORT PAYROLL,D108,HJ,,11.96,27370.54
6175,4/15/2021,4/15/2021,41521,82L-IMPORT PAYROLL,D108,HJ,,11.96,27358.58
6175,4/15/2021,4/15/2021,41521,82L-IMPORT PAYROLL,D108,HJ,,11.96,27346.62
6175,4/15/2021,4/15/2021,41521,82L-IMPORT PAYROLL,D108,HJ,,11.96,27334.66
6175,4/15/2021,4/15/2021,41521,82L-IMPORT PAYROLL,D108,HJ,,11.96,27322.7
6175,4/15/2021,4/15/2021,41521,82L-IMPORT PAYROLL,D108,HJ,,14.83,27307.87
6175,4/15/2021,4/15/2021,41521,82L-IMPORT PAYROLL,D108,HJ,,14.83,27293.04
6175,4/15/2021,4/15/2021,41521,82L-IMPORT PAYROLL,D108,HJ,,14.83,27278.21
6175,4/15/2021,4/15/2021,41521,82L-IMPORT PAYROLL,D108,HJ,,35.65,27242.56
6175,4/15/2021,4/15/2021,41521,82L-IMPORT PAYROLL,D108,HJ,,35.65,27206.91
6175,4/15/2021,4/15/2021,41521,82L-IMPORT PAYROLL,D108,HJ,,35.65,27171.26
6175,4/15/2021,4/15/2021,41521,82L-IMPORT PAYROLL,D101,HJ,,1.78,27169.48
6175,4/15/2021,4/15/2021,41521,82L-IMPORT PAYROLL,D101,HJ,,1.78,27167.7
6175,4/15/2021,4/15/2021,41521,82L-IMPORT PAYROLL,D101,HJ,,1.78,27165.92
6175,4/15/2021,4/15/2021,41521,82L-IMPORT PAYROLL,D101,HJ,,3.38,27162.54
6175,4/15/2021,4/15/2021,41521,82L-IMPORT PAYROLL,D101,HJ,,11.96,27150.58
6175,4/15/2021,4/15/2021,41521,82L-IMPORT PAYROLL,D101,HJ,,11.96,27138.62
6175,4/15/2021,4/15/2021,41521,82L-IMPORT PAYROLL,D101,HJ,,11.96,27126.66
6175,4/15/2021,4/15/2021,41521,82L-IMPORT PAYROLL,D101,HJ,,14.83,27111.83
6175,4/15/2021,4/15/2021,41521,82L-IMPORT PAYROLL,D101,HJ,,25.48,27086.35
6175,4/15/2021,4/15/2021,41521,82L-IMPORT PAYROLL,D102,HJ,,1.78,27084.57
6175,4/15/2021,4/15/2021,41521,82L-IMPORT PAYROLL,D102,HJ,,1.78,27082.79
6175,4/15/2021,4/15/2021,41521,82L-IMPORT PAYROLL,D102,HJ,,11.96,27070.83
6175,4/15/2021,4/15/2021,41521,82L-IMPORT PAYROLL,D102,HJ,,11.96,27058.87
6175,4/15/2021,4/15/2021,41521,82L-IMPORT PAYROLL,D103,HJ,,1.78,27057.09
6175,4/15/2021,4/15/2021,41521,82L-IMPORT PAYROLL,D103,HJ,,11.96,27045.13
6175,4/15/2021,4/15/2021,41521,82L-IMPORT PAYROLL,D103,HJ,,11.96,27033.17
6175,4/15/2021,4/15/2021,41521,82L-IMPORT PAYROLL,D104,HJ,,1.78,27031.39
6175,4/15/2021,4/15/2021,41521,82L-IMPORT PAYROLL,D104,HJ,,1.78,27029.61
6175,4/15/2021,4/15/2021,41521,82L-IMPORT PAYROLL,D104,HJ,,1.78,27027.83
6175,4/15/2021,4/15/2021,41521,82L-IMPORT PAYROLL,D104,HJ,,1.78,27026.05
6175,4/15/2021,4/15/2021,41521,82L-IMPORT PAYROLL,D104,HJ,,1.78,27024.27
6175,4/15/2021,4/15/2021,41521,82L-IMPORT PAYROLL,D104,HJ,,3.38,27020.89
6175,4/15/2021,4/15/2021,41521,82L-IMPORT PAYROLL,D104,HJ,,5.23,27015.66
6175,4/15/2021,4/15/2021,41521,82L-IMPORT PAYROLL,D104,HJ,,11.96,27003.7
6175,4/15/2021,4/15/2021,41521,82L-IMPORT PAYROLL,D104,HJ,,11.96,26991.74
6175,4/15/2021,4/15/2021,41521,82L-IMPORT PAYROLL,D104,HJ,,14.83,26976.91
6175,4/15/2021,4/15/2021,41521,82L-IMPORT PAYROLL,D104,HJ,,14.83,26962.08
6175,4/15/2021,4/15/2021,41521,82L-IMPORT PAYROLL,D104,HJ,,14.83,26947.25
6175,4/15/2021,4/15/2021,41521,82L-IMPORT PAYROLL,D104,HJ,,25.48,26921.77
6175,4/15/2021,4/15/2021,41521,82L-IMPORT PAYROLL,D104,HJ,,35.65,26886.12
6175,4/15/2021,4/15/2021,41521,82L-IMPORT PAYROLL,D104,HJ,,44.2,26841.92
6175,4/15/2021,4/15/2021,41521,82L-IMPORT PAYROLL,D105,HJ,,1.78,26840.14
6175,4/15/2021,4/15/2021,41521,82L-IMPORT PAYROLL,D105,HJ,,1.78,26838.36
6175,4/15/2021,4/15/2021,41521,82L-IMPORT PAYROLL,D105,HJ,,1.78,26836.58
6175,4/15/2021,4/15/2021,41521,82L-IMPORT PAYROLL,D105,HJ,,11.96,26824.62
6175,4/15/2021,4/15/2021,41521,82L-IMPORT PAYROLL,D105,HJ,,14.83,26809.79
6175,4/15/2021,4/15/2021,41521,82L-IMPORT PAYROLL,D105,HJ,,14.83,26794.96
6175,4/15/2021,4/15/2021,41521,82L-IMPORT PAYROLL,D107,HJ,,1.78,26793.18
6175,4/15/2021,4/15/2021,41521,82L-IMPORT PAYROLL,D107,HJ,,5.23,26787.95
6175,4/15/2021,4/15/2021,41521,82L-IMPORT PAYROLL,D107,HJ,,11.96,26775.99
6175,4/15/2021,4/15/2021,41521,82L-IMPORT PAYROLL,D107,HJ,,25.48,26750.51
6175,4/15/2021,4/15/2021,41521,82L-IMPORT PAYROLL,D107,HJ,,35.65,26714.86
6175,4/15/2021,4/15/2021,41521,82L-IMPORT PAYROLL,D107,HJ,,35.65,26679.21
6175,4/15/2021,4/15/2021,41521,82L-IMPORT PAYROLL,D109,HJ,,1.78,26677.43
6175,4/15/2021,4/15/2021,41521,82L-IMPORT PAYROLL,D109,HJ,,1.78,26675.65
6175,4/15/2021,4/15/2021,41521,82L-IMPORT PAYROLL,D109,HJ,,1.78,26673.87
6175,4/15/2021,4/15/2021,41521,82L-IMPORT PAYROLL,D109,HJ,,1.78,26672.09
6175,4/15/2021,4/15/2021,41521,82L-IMPORT PAYROLL,D109,HJ,,1.78,26670.31
6175,4/15/2021,4/15/2021,41521,82L-IMPORT PAYROLL,D109,HJ,,5.23,26665.08
6175,4/15/2021,4/15/2021,41521,82L-IMPORT PAYROLL,D109,HJ,,5.23,26659.85
6175,4/15/2021,4/15/2021,41521,82L-IMPORT PAYROLL,D109,HJ,,11.96,26647.89
6175,4/15/2021,4/15/2021,41521,82L-IMPORT PAYROLL,D109,HJ,,11.96,26635.93
6175,4/15/2021,4/15/2021,41521,82L-IMPORT PAYROLL,D109,HJ,,14.83,26621.1
6175,4/15/2021,4/15/2021,41521,82L-IMPORT PAYROLL,D109,HJ,,14.83,26606.27
6175,4/15/2021,4/15/2021,41521,82L-IMPORT PAYROLL,D109,HJ,,14.83,26591.44
6175,4/15/2021,4/15/2021,41521,82L-IMPORT PAYROLL,D109,HJ,,44.2,26547.24
6175,4/15/2021,4/15/2021,41521,82L-IMPORT PAYROLL,D109,HJ,,44.2,26503.04
6175,4/15/2021,4/15/2021,41521,82L-IMPORT PAYROLL,D111,HJ,,1.78,26501.26
6175,4/15/2021,4/15/2021,41521,82L-IMPORT PAYROLL,D111,HJ,,1.78,26499.48
6175,4/15/2021,4/15/2021,41521,82L-IMPORT PAYROLL,D111,HJ,,1.78,26497.7
6175,4/15/2021,4/15/2021,41521,82L-IMPORT PAYROLL,D111,HJ,,1.78,26495.92
6175,4/15/2021,4/15/2021,41521,82L-IMPORT PAYROLL,D111,HJ,,11.96,26483.96
6175,4/15/2021,4/15/2021,41521,82L-IMPORT PAYROLL,D111,HJ,,11.96,26472
6175,4/15/2021,4/15/2021,41521,82L-IMPORT PAYROLL,D111,HJ,,11.96,26460.04
6175,4/15/2021,4/15/2021,41521,82L-IMPORT PAYROLL,D112,HJ,,3.56,26456.48
6175,4/15/2021,4/15/2021,41521,82L-IMPORT PAYROLL,D112,HJ,,31.6,26424.88
6175,4/15/2021,4/15/2021,41521,82L-IMPORT PAYROLL,D108,HJ,,1.78,26423.1
6175,4/15/2021,4/15/2021,41521,82L-IMPORT PAYROLL,D108,HJ,,1.78,26421.32
6175,4/15/2021,4/15/2021,41521,82L-IMPORT PAYROLL,D108,HJ,,1.78,26419.54
6175,4/15/2021,4/15/2021,41521,82L-IMPORT PAYROLL,D108,HJ,,1.78,26417.76
6175,4/15/2021,4/15/2021,41521,82L-IMPORT PAYROLL,D108,HJ,,1.78,26415.98
6175,4/15/2021,4/15/2021,41521,82L-IMPORT PAYROLL,D108,HJ,,1.78,26414.2
6175,4/15/2021,4/15/2021,41521,82L-IMPORT PAYROLL,D108,HJ,,1.78,26412.42
6175,4/15/2021,4/15/2021,41521,82L-IMPORT PAYROLL,D108,HJ,,1.78,26410.64
6175,4/15/2021,4/15/2021,41521,82L-IMPORT PAYROLL,D108,HJ,,1.78,26408.86
6175,4/15/2021,4/15/2021,41521,82L-IMPORT PAYROLL,D108,HJ,,1.78,26407.08
6175,4/15/2021,4/15/2021,41521,82L-IMPORT PAYROLL,D108,HJ,,1.78,26405.3
6175,4/15/2021,4/15/2021,41521,82L-IMPORT PAYROLL,D108,HJ,,1.78,26403.52
6175,4/15/2021,4/15/2021,41521,82L-IMPORT PAYROLL,D108,HJ,,1.78,26401.74
6175,4/15/2021,4/15/2021,41521,82L-IMPORT PAYROLL,D108,HJ,,1.78,26399.96
6175,4/15/2021,4/15/2021,41521,82L-IMPORT PAYROLL,D108,HJ,,11.96,26388
6175,4/15/2021,4/15/2021,41521,82L-IMPORT PAYROLL,D108,HJ,,11.96,26376.04
6175,4/15/2021,4/15/2021,41521,82L-IMPORT PAYROLL,D108,HJ,,11.96,26364.08
6175,4/15/2021,4/15/2021,41521,82L-IMPORT PAYROLL,D108,HJ,,11.96,26352.12
6175,4/15/2021,4/15/2021,41521,82L-IMPORT PAYROLL,D108,HJ,,11.96,26340.16
6175,4/15/2021,4/15/2021,41521,82L-IMPORT PAYROLL,D108,HJ,,11.96,26328.2
6175,4/15/2021,4/15/2021,41521,82L-IMPORT PAYROLL,D108,HJ,,11.96,26316.24
6175,4/15/2021,4/15/2021,41521,82L-IMPORT PAYROLL,D108,HJ,,11.96,26304.28
6175,4/15/2021,4/15/2021,41521,82L-IMPORT PAYROLL,D108,HJ,,11.96,26292.32
6175,4/15/2021,4/15/2021,41521,82L-IMPORT PAYROLL,D108,HJ,,14.83,26277.49
6175,4/15/2021,4/15/2021,41521,82L-IMPORT PAYROLL,D108,HJ,,14.83,26262.66
6175,4/15/2021,4/15/2021,41521,82L-IMPORT PAYROLL,D108,HJ,,14.83,26247.83
6175,4/15/2021,4/15/2021,41521,82L-IMPORT PAYROLL,D108,HJ,,14.83,26233
6175,4/15/2021,4/15/2021,41521,82L-IMPORT PAYROLL,D108,HJ,,14.83,26218.17
6175,4/15/2021,4/15/2021,41521,82L-IMPORT PAYROLL,D108,HJ,,35.65,26182.52
6175,4/15/2021,4/15/2021,41521,82L-IMPORT PAYROLL,D108,HJ,,1.78,26180.74
6175,4/15/2021,4/15/2021,41521,82L-IMPORT PAYROLL,D108,HJ,,1.78,26178.96
6175,4/15/2021,4/15/2021,41521,82L-IMPORT PAYROLL,D108,HJ,,1.78,26177.18
6175,4/15/2021,4/15/2021,41521,82L-IMPORT PAYROLL,D108,HJ,,1.78,26175.4
6175,4/15/2021,4/15/2021,41521,82L-IMPORT PAYROLL,D108,HJ,,11.96,26163.44
6175,4/15/2021,4/15/2021,41521,82L-IMPORT PAYROLL,D108,HJ,,11.96,26151.48
6175,4/15/2021,4/15/2021,41521,82L-IMPORT PAYROLL,D108,HJ,,14.83,26136.65
6175,4/15/2021,4/15/2021,41521,82L-IMPORT PAYROLL,D108,HJ,,14.83,26121.82
6175,4/30/2021,4/30/2021,1,ADJ to Reclass funding source,D109,HJ,,110.13,26011.69
6175,4/30/2021,4/30/2021,1,ADJ to Reclass funding source,D109,HJ,110.13,,26121.82
6175,4/30/2021,4/30/2021,1,ADJ to Reclass funding source,D109,HJ,,572.2,25549.62
6175,4/30/2021,4/30/2021,1,ADJ to Reclass funding source,D109,HJ,572.2,,26121.82
6175,4/30/2021,4/30/2021,43021,82L-IMPORT PAYROLL,D108,HJ,,1.78,26120.04
6175,4/30/2021,4/30/2021,43021,82L-IMPORT PAYROLL,D108,HJ,,1.78,26118.26
6175,4/30/2021,4/30/2021,43021,82L-IMPORT PAYROLL,D108,HJ,,1.78,26116.48
6175,4/30/2021,4/30/2021,43021,82L-IMPORT PAYROLL,D108,HJ,,1.78,26114.7
6175,4/30/2021,4/30/2021,43021,82L-IMPORT PAYROLL,D108,HJ,,1.78,26112.92
6175,4/30/2021,4/30/2021,43021,82L-IMPORT PAYROLL,D108,HJ,,1.78,26111.14
6175,4/30/2021,4/30/2021,43021,82L-IMPORT PAYROLL,D108,HJ,,1.78,26109.36
6175,4/30/2021,4/30/2021,43021,82L-IMPORT PAYROLL,D108,HJ,,1.78,26107.58
6175,4/30/2021,4/30/2021,43021,82L-IMPORT PAYROLL,D108,HJ,,1.78,26105.8
6175,4/30/2021,4/30/2021,43021,82L-IMPORT PAYROLL,D108,HJ,,1.78,26104.02
6175,4/30/2021,4/30/2021,43021,82L-IMPORT PAYROLL,D108,HJ,,1.78,26102.24
6175,4/30/2021,4/30/2021,43021,82L-IMPORT PAYROLL,D108,HJ,,1.78,26100.46
6175,4/30/2021,4/30/2021,43021,82L-IMPORT PAYROLL,D108,HJ,,5.23,26095.23
6175,4/30/2021,4/30/2021,43021,82L-IMPORT PAYROLL,D108,HJ,,11.96,26083.27
6175,4/30/2021,4/30/2021,43021,82L-IMPORT PAYROLL,D108,HJ,,11.96,26071.31
6175,4/30/2021,4/30/2021,43021,82L-IMPORT PAYROLL,D108,HJ,,11.96,26059.35
6175,4/30/2021,4/30/2021,43021,82L-IMPORT PAYROLL,D108,HJ,,11.96,26047.39
6175,4/30/2021,4/30/2021,43021,82L-IMPORT PAYROLL,D108,HJ,,11.96,26035.43
6175,4/30/2021,4/30/2021,43021,82L-IMPORT PAYROLL,D108,HJ,,11.96,26023.47
6175,4/30/2021,4/30/2021,43021,82L-IMPORT PAYROLL,D108,HJ,,14.83,26008.64
6175,4/30/2021,4/30/2021,43021,82L-IMPORT PAYROLL,D108,HJ,,14.83,25993.81
6175,4/30/2021,4/30/2021,43021,82L-IMPORT PAYROLL,D108,HJ,,14.83,25978.98
6175,4/30/2021,4/30/2021,43021,82L-IMPORT PAYROLL,D108,HJ,,14.83,25964.15
6175,4/30/2021,4/30/2021,43021,82L-IMPORT PAYROLL,D108,HJ,,14.83,25949.32
6175,4/30/2021,4/30/2021,43021,82L-IMPORT PAYROLL,D108,HJ,,14.83,25934.49
6175,4/30/2021,4/30/2021,43021,82L-IMPORT PAYROLL,D108,HJ,,44.2,25890.29
6175,4/30/2021,4/30/2021,43021,82L-IMPORT PAYROLL,D108,HJ,,1.78,25888.51
6175,4/30/2021,4/30/2021,43021,82L-IMPORT PAYROLL,D108,HJ,,1.78,25886.73
6175,4/30/2021,4/30/2021,43021,82L-IMPORT PAYROLL,D108,HJ,,1.78,25884.95
6175,4/30/2021,4/30/2021,43021,82L-IMPORT PAYROLL,D108,HJ,,1.78,25883.17
6175,4/30/2021,4/30/2021,43021,82L-IMPORT PAYROLL,D108,HJ,,1.78,25881.39
6175,4/30/2021,4/30/2021,43021,82L-IMPORT PAYROLL,D108,HJ,,1.78,25879.61
6175,4/30/2021,4/30/2021,43021,82L-IMPORT PAYROLL,D108,HJ,,1.78,25877.83
6175,4/30/2021,4/30/2021,43021,82L-IMPORT PAYROLL,D108,HJ,,1.78,25876.05
6175,4/30/2021,4/30/2021,43021,82L-IMPORT PAYROLL,D108,HJ,,1.78,25874.27
6175,4/30/2021,4/30/2021,43021,82L-IMPORT PAYROLL,D108,HJ,,1.78,25872.49
6175,4/30/2021,4/30/2021,43021,82L-IMPORT PAYROLL,D108,HJ,,1.78,25870.71
6175,4/30/2021,4/30/2021,43021,82L-IMPORT PAYROLL,D108,HJ,,3.56,25867.15
6175,4/30/2021,4/30/2021,43021,82L-IMPORT PAYROLL,D108,HJ,,5.23,25861.92
6175,4/30/2021,4/30/2021,43021,82L-IMPORT PAYROLL,D108,HJ,,5.23,25856.69
6175,4/30/2021,4/30/2021,43021,82L-IMPORT PAYROLL,D108,HJ,,5.23,25851.46
6175,4/30/2021,4/30/2021,43021,82L-IMPORT PAYROLL,D108,HJ,,11.96,25839.5
6175,4/30/2021,4/30/2021,43021,82L-IMPORT PAYROLL,D108,HJ,,11.96,25827.54
6175,4/30/2021,4/30/2021,43021,82L-IMPORT PAYROLL,D108,HJ,,11.96,25815.58
6175,4/30/2021,4/30/2021,43021,82L-IMPORT PAYROLL,D108,HJ,,11.96,25803.62
6175,4/30/2021,4/30/2021,43021,82L-IMPORT PAYROLL,D108,HJ,,11.96,25791.66
6175,4/30/2021,4/30/2021,43021,82L-IMPORT PAYROLL,D108,HJ,,11.96,25779.7
6175,4/30/2021,4/30/2021,43021,82L-IMPORT PAYROLL,D108,HJ,,11.96,25767.74
6175,4/30/2021,4/30/2021,43021,82L-IMPORT PAYROLL,D108,HJ,,14.83,25752.91
6175,4/30/2021,4/30/2021,43021,82L-IMPORT PAYROLL,D108,HJ,,14.83,25738.08
6175,4/30/2021,4/30/2021,43021,82L-IMPORT PAYROLL,D108,HJ,,14.83,25723.25
6175,4/30/2021,4/30/2021,43021,82L-IMPORT PAYROLL,D108,HJ,,35.65,25687.6
6175,4/30/2021,4/30/2021,43021,82L-IMPORT PAYROLL,D108,HJ,,35.65,25651.95
6175,4/30/2021,4/30/2021,43021,82L-IMPORT PAYROLL,D108,HJ,,35.65,25616.3
6175,4/30/2021,4/30/2021,43021,82L-IMPORT PAYROLL,D101,HJ,,1.78,25614.52
6175,4/30/2021,4/30/2021,43021,82L-IMPORT PAYROLL,D101,HJ,,1.78,25612.74
6175,4/30/2021,4/30/2021,43021,82L-IMPORT PAYROLL,D101,HJ,,1.78,25610.96
6175,4/30/2021,4/30/2021,43021,82L-IMPORT PAYROLL,D101,HJ,,3.38,25607.58
6175,4/30/2021,4/30/2021,43021,82L-IMPORT PAYROLL,D101,HJ,,11.96,25595.62
6175,4/30/2021,4/30/2021,43021,82L-IMPORT PAYROLL,D101,HJ,,11.96,25583.66
6175,4/30/2021,4/30/2021,43021,82L-IMPORT PAYROLL,D101,HJ,,11.96,25571.7
6175,4/30/2021,4/30/2021,43021,82L-IMPORT PAYROLL,D101,HJ,,14.83,25556.87
6175,4/30/2021,4/30/2021,43021,82L-IMPORT PAYROLL,D101,HJ,,25.48,25531.39
6175,4/30/2021,4/30/2021,43021,82L-IMPORT PAYROLL,D102,HJ,,1.78,25529.61
6175,4/30/2021,4/30/2021,43021,82L-IMPORT PAYROLL,D102,HJ,,1.78,25527.83
6175,4/30/2021,4/30/2021,43021,82L-IMPORT PAYROLL,D102,HJ,,11.96,25515.87
6175,4/30/2021,4/30/2021,43021,82L-IMPORT PAYROLL,D102,HJ,,11.96,25503.91
6175,4/30/2021,4/30/2021,43021,82L-IMPORT PAYROLL,D103,HJ,,1.78,25502.13
6175,4/30/2021,4/30/2021,43021,82L-IMPORT PAYROLL,D103,HJ,,1.78,25500.35
6175,4/30/2021,4/30/2021,43021,82L-IMPORT PAYROLL,D103,HJ,,11.96,25488.39
6175,4/30/2021,4/30/2021,43021,82L-IMPORT PAYROLL,D103,HJ,,11.96,25476.43
6175,4/30/2021,4/30/2021,43021,82L-IMPORT PAYROLL,D103,HJ,,11.96,25464.47
6175,4/30/2021,4/30/2021,43021,82L-IMPORT PAYROLL,D104,HJ,,1.78,25462.69
6175,4/30/2021,4/30/2021,43021,82L-IMPORT PAYROLL,D104,HJ,,1.78,25460.91
6175,4/30/2021,4/30/2021,43021,82L-IMPORT PAYROLL,D104,HJ,,1.78,25459.13
6175,4/30/2021,4/30/2021,43021,82L-IMPORT PAYROLL,D104,HJ,,1.78,25457.35
6175,4/30/2021,4/30/2021,43021,82L-IMPORT PAYROLL,D104,HJ,,1.78,25455.57
6175,4/30/2021,4/30/2021,43021,82L-IMPORT PAYROLL,D104,HJ,,3.38,25452.19
6175,4/30/2021,4/30/2021,43021,82L-IMPORT PAYROLL,D104,HJ,,5.23,25446.96
6175,4/30/2021,4/30/2021,43021,82L-IMPORT PAYROLL,D104,HJ,,11.96,25435
6175,4/30/2021,4/30/2021,43021,82L-IMPORT PAYROLL,D104,HJ,,14.83,25420.17
6175,4/30/2021,4/30/2021,43021,82L-IMPORT PAYROLL,D104,HJ,,14.83,25405.34
6175,4/30/2021,4/30/2021,43021,82L-IMPORT PAYROLL,D104,HJ,,14.83,25390.51
6175,4/30/2021,4/30/2021,43021,82L-IMPORT PAYROLL,D104,HJ,,25.48,25365.03
6175,4/30/2021,4/30/2021,43021,82L-IMPORT PAYROLL,D104,HJ,,35.65,25329.38
6175,4/30/2021,4/30/2021,43021,82L-IMPORT PAYROLL,D104,HJ,,44.2,25285.18
6175,4/30/2021,4/30/2021,43021,82L-IMPORT PAYROLL,D105,HJ,,1.78,25283.4
6175,4/30/2021,4/30/2021,43021,82L-IMPORT PAYROLL,D105,HJ,,1.78,25281.62
6175,4/30/2021,4/30/2021,43021,82L-IMPORT PAYROLL,D105,HJ,,1.78,25279.84
6175,4/30/2021,4/30/2021,43021,82L-IMPORT PAYROLL,D105,HJ,,11.96,25267.88
6175,4/30/2021,4/30/2021,43021,82L-IMPORT PAYROLL,D105,HJ,,14.83,25253.05
6175,4/30/2021,4/30/2021,43021,82L-IMPORT PAYROLL,D105,HJ,,14.83,25238.22
6175,4/30/2021,4/30/2021,43021,82L-IMPORT PAYROLL,D107,HJ,,1.78,25236.44
6175,4/30/2021,4/30/2021,43021,82L-IMPORT PAYROLL,D107,HJ,,5.23,25231.21
6175,4/30/2021,4/30/2021,43021,82L-IMPORT PAYROLL,D107,HJ,,11.96,25219.25
6175,4/30/2021,4/30/2021,43021,82L-IMPORT PAYROLL,D107,HJ,,25.48,25193.77
6175,4/30/2021,4/30/2021,43021,82L-IMPORT PAYROLL,D107,HJ,,35.65,25158.12
6175,4/30/2021,4/30/2021,43021,82L-IMPORT PAYROLL,D107,HJ,,35.65,25122.47
6175,4/30/2021,4/30/2021,43021,82L-IMPORT PAYROLL,D109,HJ,,1.78,25120.69
6175,4/30/2021,4/30/2021,43021,82L-IMPORT PAYROLL,D109,HJ,,1.78,25118.91
6175,4/30/2021,4/30/2021,43021,82L-IMPORT PAYROLL,D109,HJ,,1.78,25117.13
6175,4/30/2021,4/30/2021,43021,82L-IMPORT PAYROLL,D109,HJ,,1.78,25115.35
6175,4/30/2021,4/30/2021,43021,82L-IMPORT PAYROLL,D109,HJ,,1.78,25113.57
6175,4/30/2021,4/30/2021,43021,82L-IMPORT PAYROLL,D109,HJ,,5.23,25108.34
6175,4/30/2021,4/30/2021,43021,82L-IMPORT PAYROLL,D109,HJ,,5.23,25103.11
6175,4/30/2021,4/30/2021,43021,82L-IMPORT PAYROLL,D109,HJ,,11.96,25091.15
6175,4/30/2021,4/30/2021,43021,82L-IMPORT PAYROLL,D109,HJ,,11.96,25079.19
6175,4/30/2021,4/30/2021,43021,82L-IMPORT PAYROLL,D109,HJ,,14.83,25064.36
6175,4/30/2021,4/30/2021,43021,82L-IMPORT PAYROLL,D109,HJ,,14.83,25049.53
6175,4/30/2021,4/30/2021,43021,82L-IMPORT PAYROLL,D109,HJ,,14.83,25034.7
6175,4/30/2021,4/30/2021,43021,82L-IMPORT PAYROLL,D109,HJ,,44.2,24990.5
6175,4/30/2021,4/30/2021,43021,82L-IMPORT PAYROLL,D109,HJ,,44.2,24946.3
6175,4/30/2021,4/30/2021,43021,82L-IMPORT PAYROLL,D111,HJ,,1.78,24944.52
6175,4/30/2021,4/30/2021,43021,82L-IMPORT PAYROLL,D111,HJ,,1.78,24942.74
6175,4/30/2021,4/30/2021,43021,82L-IMPORT PAYROLL,D111,HJ,,1.78,24940.96
6175,4/30/2021,4/30/2021,43021,82L-IMPORT PAYROLL,D111,HJ,,1.78,24939.18
6175,4/30/2021,4/30/2021,43021,82L-IMPORT PAYROLL,D111,HJ,,11.96,24927.22
6175,4/30/2021,4/30/2021,43021,82L-IMPORT PAYROLL,D111,HJ,,11.96,24915.26
6175,4/30/2021,4/30/2021,43021,82L-IMPORT PAYROLL,D111,HJ,,11.96,24903.3
6175,4/30/2021,4/30/2021,43021,82L-IMPORT PAYROLL,D112,HJ,,3.56,24899.74
6175,4/30/2021,4/30/2021,43021,82L-IMPORT PAYROLL,D112,HJ,,31.6,24868.14
6175,4/30/2021,4/30/2021,43021,82L-IMPORT PAYROLL,D108,HJ,,1.78,24866.36
6175,4/30/2021,4/30/2021,43021,82L-IMPORT PAYROLL,D108,HJ,,1.78,24864.58
6175,4/30/2021,4/30/2021,43021,82L-IMPORT PAYROLL,D108,HJ,,1.78,24862.8
6175,4/30/2021,4/30/2021,43021,82L-IMPORT PAYROLL,D108,HJ,,1.78,24861.02
6175,4/30/2021,4/30/2021,43021,82L-IMPORT PAYROLL,D108,HJ,,1.78,24859.24
6175,4/30/2021,4/30/2021,43021,82L-IMPORT PAYROLL,D108,HJ,,1.78,24857.46
6175,4/30/2021,4/30/2021,43021,82L-IMPORT PAYROLL,D108,HJ,,1.78,24855.68
6175,4/30/2021,4/30/2021,43021,82L-IMPORT PAYROLL,D108,HJ,,1.78,24853.9
6175,4/30/2021,4/30/2021,43021,82L-IMPORT PAYROLL,D108,HJ,,1.78,24852.12
6175,4/30/2021,4/30/2021,43021,82L-IMPORT PAYROLL,D108,HJ,,1.78,24850.34
6175,4/30/2021,4/30/2021,43021,82L-IMPORT PAYROLL,D108,HJ,,1.78,24848.56
6175,4/30/2021,4/30/2021,43021,82L-IMPORT PAYROLL,D108,HJ,,1.78,24846.78
6175,4/30/2021,4/30/2021,43021,82L-IMPORT PAYROLL,D108,HJ,,1.78,24845
6175,4/30/2021,4/30/2021,43021,82L-IMPORT PAYROLL,D108,HJ,,1.78,24843.22
6175,4/30/2021,4/30/2021,43021,82L-IMPORT PAYROLL,D108,HJ,,1.78,24841.44
6175,4/30/2021,4/30/2021,43021,82L-IMPORT PAYROLL,D108,HJ,,11.96,24829.48
6175,4/30/2021,4/30/2021,43021,82L-IMPORT PAYROLL,D108,HJ,,11.96,24817.52
6175,4/30/2021,4/30/2021,43021,82L-IMPORT PAYROLL,D108,HJ,,11.96,24805.56
6175,4/30/2021,4/30/2021,43021,82L-IMPORT PAYROLL,D108,HJ,,11.96,24793.6
6175,4/30/2021,4/30/2021,43021,82L-IMPORT PAYROLL,D108,HJ,,11.96,24781.64
6175,4/30/2021,4/30/2021,43021,82L-IMPORT PAYROLL,D108,HJ,,11.96,24769.68
6175,4/30/2021,4/30/2021,43021,82L-IMPORT PAYROLL,D108,HJ,,11.96,24757.72
6175,4/30/2021,4/30/2021,43021,82L-IMPORT PAYROLL,D108,HJ,,11.96,24745.76
6175,4/30/2021,4/30/2021,43021,82L-IMPORT PAYROLL,D108,HJ,,11.96,24733.8
6175,4/30/2021,4/30/2021,43021,82L-IMPORT PAYROLL,D108,HJ,,11.96,24721.84
6175,4/30/2021,4/30/2021,43021,82L-IMPORT PAYROLL,D108,HJ,,14.83,24707.01
6175,4/30/2021,4/30/2021,43021,82L-IMPORT PAYROLL,D108,HJ,,14.83,24692.18
6175,4/30/2021,4/30/2021,43021,82L-IMPORT PAYROLL,D108,HJ,,14.83,24677.35
6175,4/30/2021,4/30/2021,43021,82L-IMPORT PAYROLL,D108,HJ,,14.83,24662.52
6175,4/30/2021,4/30/2021,43021,82L-IMPORT PAYROLL,D108,HJ,,14.83,24647.69
6175,4/30/2021,4/30/2021,43021,82L-IMPORT PAYROLL,D108,HJ,,35.65,24612.04
6175,4/30/2021,4/30/2021,43021,82L-IMPORT PAYROLL,D108,HJ,,1.78,24610.26
6175,4/30/2021,4/30/2021,43021,82L-IMPORT PAYROLL,D108,HJ,,1.78,24608.48
6175,4/30/2021,4/30/2021,43021,82L-IMPORT PAYROLL,D108,HJ,,1.78,24606.7
6175,4/30/2021,4/30/2021,43021,82L-IMPORT PAYROLL,D108,HJ,,1.78,24604.92
6175,4/30/2021,4/30/2021,43021,82L-IMPORT PAYROLL,D108,HJ,,11.96,24592.96
6175,4/30/2021,4/30/2021,43021,82L-IMPORT PAYROLL,D108,HJ,,11.96,24581
6175,4/30/2021,4/30/2021,43021,82L-IMPORT PAYROLL,D108,HJ,,14.83,24566.17
6175,4/30/2021,4/30/2021,43021,82L-IMPORT PAYROLL,D108,HJ,,14.83,24551.34
6175,5/3/2021,5/3/2021,BCBS,BCBS MAy 2021 Payment,D108,HJ,1006.68,,25558.02
6175,5/3/2021,5/3/2021,BCBS,BCBS MAy 2021 Payment,D108,HJ,1215.54,,26773.56
6175,5/3/2021,5/3/2021,BCBS,BCBS MAy 2021 Payment,D101,HJ,251.15,,27024.71
6175,5/3/2021,5/3/2021,BCBS,BCBS MAy 2021 Payment,D102,HJ,95.66,,27120.37
6175,5/3/2021,5/3/2021,BCBS,BCBS MAy 2021 Payment,D103,HJ,95.66,,27216.03
6175,5/3/2021,5/3/2021,BCBS,BCBS MAy 2021 Payment,D104,HJ,827.97,,28044
6175,5/3/2021,5/3/2021,BCBS,BCBS MAy 2021 Payment,D105,HJ,47.83,,28091.83
6175,5/3/2021,5/3/2021,BCBS,BCBS MAy 2021 Payment,D107,HJ,292.35,,28384.18
6175,5/3/2021,5/3/2021,BCBS,BCBS MAy 2021 Payment,D109,HJ,95.66,,28479.84
6175,5/3/2021,5/3/2021,BCBS,BCBS MAy 2021 Payment,D111,HJ,143.49,,28623.33
6175,5/3/2021,5/3/2021,BCBS,BCBS MAy 2021 Payment,D108,HJ,1045.67,,29669
6175,5/3/2021,5/3/2021,BCBS,BCBS MAy 2021 Payment,D108,HJ,47.83,,29716.83
6175,5/4/2021,5/4/2021,1,Blue 20/20 Vision Insurance,D108,HJ,113.34,,29830.17
6175,5/4/2021,5/4/2021,1,blUE 20/20 Vision payment May,D108,HJ,7.11,,29837.28
6175,5/4/2021,5/4/2021,1,Blue 20/20 Vision Insurance,D108,HJ,141.36,,29978.64
6175,5/4/2021,5/4/2021,1,Blue 20/20 Vision Insurance,D101,HJ,27.73,,30006.37
6175,5/4/2021,5/4/2021,1,Blue 20/20 Vision Insurance,D102,HJ,14.22,,30020.59
6175,5/4/2021,5/4/2021,1,Blue 20/20 Vision Insurance,D103,HJ,7.11,,30027.7
6175,5/4/2021,5/4/2021,1,Blue 20/20 Vision Insurance,D104,HJ,105.81,,30133.51
6175,5/4/2021,5/4/2021,1,Blue 20/20 Vision Insurance,D105,HJ,21.33,,30154.84
6175,5/4/2021,5/4/2021,1,Blue 20/20 Vision Insurance,D107,HJ,28.02,,30182.86
6175,5/4/2021,5/4/2021,1,Blue 20/20 Vision Insurance,D109,HJ,56.46,,30239.32
6175,5/4/2021,5/4/2021,1,Blue 20/20 Vision Insurance,D111,HJ,28.44,,30267.76
6175,5/4/2021,5/4/2021,1,Blue 20/20 Vision Insurance,D112,HJ,14.22,,30281.98
6175,5/4/2021,5/4/2021,1,blUE 20/20 Vision payment May,D104,HJ,27.02,,30309
6175,5/4/2021,5/4/2021,1,Blue 20/20 Vision Insurance,D108,HJ,85.32,,30394.32
6175,5/4/2021,5/4/2021,1,Blue 20/20 Vision Insurance,D108,HJ,28.44,,30422.76
6175,5/14/2021,5/14/2021,51421,82L-IMPORT PAYROLL,D108,HJ,,1.78,30420.98
6175,5/14/2021,5/14/2021,51421,82L-IMPORT PAYROLL,D108,HJ,,1.78,30419.2
6175,5/14/2021,5/14/2021,51421,82L-IMPORT PAYROLL,D108,HJ,,1.78,30417.42
6175,5/14/2021,5/14/2021,51421,82L-IMPORT PAYROLL,D108,HJ,,1.78,30415.64
6175,5/14/2021,5/14/2021,51421,82L-IMPORT PAYROLL,D108,HJ,,1.78,30413.86
6175,5/14/2021,5/14/2021,51421,82L-IMPORT PAYROLL,D108,HJ,,1.78,30412.08
6175,5/14/2021,5/14/2021,51421,82L-IMPORT PAYROLL,D108,HJ,,1.78,30410.3
6175,5/14/2021,5/14/2021,51421,82L-IMPORT PAYROLL,D108,HJ,,1.78,30408.52
6175,5/14/2021,5/14/2021,51421,82L-IMPORT PAYROLL,D108,HJ,,1.78,30406.74
6175,5/14/2021,5/14/2021,51421,82L-IMPORT PAYROLL,D108,HJ,,1.78,30404.96
6175,5/14/2021,5/14/2021,51421,82L-IMPORT PAYROLL,D108,HJ,,1.78,30403.18
6175,5/14/2021,5/14/2021,51421,82L-IMPORT PAYROLL,D108,HJ,,1.78,30401.4
6175,5/14/2021,5/14/2021,51421,82L-IMPORT PAYROLL,D108,HJ,,5.23,30396.17
6175,5/14/2021,5/14/2021,51421,82L-IMPORT PAYROLL,D108,HJ,,11.96,30384.21
6175,5/14/2021,5/14/2021,51421,82L-IMPORT PAYROLL,D108,HJ,,11.96,30372.25
6175,5/14/2021,5/14/2021,51421,82L-IMPORT PAYROLL,D108,HJ,,11.96,30360.29
6175,5/14/2021,5/14/2021,51421,82L-IMPORT PAYROLL,D108,HJ,,11.96,30348.33
6175,5/14/2021,5/14/2021,51421,82L-IMPORT PAYROLL,D108,HJ,,11.96,30336.37
6175,5/14/2021,5/14/2021,51421,82L-IMPORT PAYROLL,D108,HJ,,11.96,30324.41
6175,5/14/2021,5/14/2021,51421,82L-IMPORT PAYROLL,D108,HJ,,14.83,30309.58
6175,5/14/2021,5/14/2021,51421,82L-IMPORT PAYROLL,D108,HJ,,14.83,30294.75
6175,5/14/2021,5/14/2021,51421,82L-IMPORT PAYROLL,D108,HJ,,14.83,30279.92
6175,5/14/2021,5/14/2021,51421,82L-IMPORT PAYROLL,D108,HJ,,14.83,30265.09
6175,5/14/2021,5/14/2021,51421,82L-IMPORT PAYROLL,D108,HJ,,14.83,30250.26
6175,5/14/2021,5/14/2021,51421,82L-IMPORT PAYROLL,D108,HJ,,44.2,30206.06
6175,5/14/2021,5/14/2021,51421,82L-IMPORT PAYROLL,D108,HJ,,1.78,30204.28
6175,5/14/2021,5/14/2021,51421,82L-IMPORT PAYROLL,D108,HJ,,1.78,30202.5
6175,5/14/2021,5/14/2021,51421,82L-IMPORT PAYROLL,D108,HJ,,1.78,30200.72
6175,5/14/2021,5/14/2021,51421,82L-IMPORT PAYROLL,D108,HJ,,1.78,30198.94
6175,5/14/2021,5/14/2021,51421,82L-IMPORT PAYROLL,D108,HJ,,1.78,30197.16
6175,5/14/2021,5/14/2021,51421,82L-IMPORT PAYROLL,D108,HJ,,1.78,30195.38
6175,5/14/2021,5/14/2021,51421,82L-IMPORT PAYROLL,D108,HJ,,1.78,30193.6
6175,5/14/2021,5/14/2021,51421,82L-IMPORT PAYROLL,D108,HJ,,1.78,30191.82
6175,5/14/2021,5/14/2021,51421,82L-IMPORT PAYROLL,D108,HJ,,1.78,30190.04
6175,5/14/2021,5/14/2021,51421,82L-IMPORT PAYROLL,D108,HJ,,1.78,30188.26
6175,5/14/2021,5/14/2021,51421,82L-IMPORT PAYROLL,D108,HJ,,1.78,30186.48
6175,5/14/2021,5/14/2021,51421,82L-IMPORT PAYROLL,D108,HJ,,3.56,30182.92
6175,5/14/2021,5/14/2021,51421,82L-IMPORT PAYROLL,D108,HJ,,5.23,30177.69
6175,5/14/2021,5/14/2021,51421,82L-IMPORT PAYROLL,D108,HJ,,5.23,30172.46
6175,5/14/2021,5/14/2021,51421,82L-IMPORT PAYROLL,D108,HJ,,5.23,30167.23
6175,5/14/2021,5/14/2021,51421,82L-IMPORT PAYROLL,D108,HJ,,11.96,30155.27
6175,5/14/2021,5/14/2021,51421,82L-IMPORT PAYROLL,D108,HJ,,11.96,30143.31
6175,5/14/2021,5/14/2021,51421,82L-IMPORT PAYROLL,D108,HJ,,11.96,30131.35
6175,5/14/2021,5/14/2021,51421,82L-IMPORT PAYROLL,D108,HJ,,11.96,30119.39
6175,5/14/2021,5/14/2021,51421,82L-IMPORT PAYROLL,D108,HJ,,11.96,30107.43
6175,5/14/2021,5/14/2021,51421,82L-IMPORT PAYROLL,D108,HJ,,11.96,30095.47
6175,5/14/2021,5/14/2021,51421,82L-IMPORT PAYROLL,D108,HJ,,11.96,30083.51
6175,5/14/2021,5/14/2021,51421,82L-IMPORT PAYROLL,D108,HJ,,14.83,30068.68
6175,5/14/2021,5/14/2021,51421,82L-IMPORT PAYROLL,D108,HJ,,14.83,30053.85
6175,5/14/2021,5/14/2021,51421,82L-IMPORT PAYROLL,D108,HJ,,14.83,30039.02
6175,5/14/2021,5/14/2021,51421,82L-IMPORT PAYROLL,D108,HJ,,35.65,30003.37
6175,5/14/2021,5/14/2021,51421,82L-IMPORT PAYROLL,D108,HJ,,35.65,29967.72
6175,5/14/2021,5/14/2021,51421,82L-IMPORT PAYROLL,D108,HJ,,35.65,29932.07
6175,5/14/2021,5/14/2021,51421,82L-IMPORT PAYROLL,D101,HJ,,1.78,29930.29
6175,5/14/2021,5/14/2021,51421,82L-IMPORT PAYROLL,D101,HJ,,1.78,29928.51
6175,5/14/2021,5/14/2021,51421,82L-IMPORT PAYROLL,D101,HJ,,1.78,29926.73
6175,5/14/2021,5/14/2021,51421,82L-IMPORT PAYROLL,D101,HJ,,3.38,29923.35
6175,5/14/2021,5/14/2021,51421,82L-IMPORT PAYROLL,D101,HJ,,11.96,29911.39
6175,5/14/2021,5/14/2021,51421,82L-IMPORT PAYROLL,D101,HJ,,11.96,29899.43
6175,5/14/2021,5/14/2021,51421,82L-IMPORT PAYROLL,D101,HJ,,11.96,29887.47
6175,5/14/2021,5/14/2021,51421,82L-IMPORT PAYROLL,D101,HJ,,14.83,29872.64
6175,5/14/2021,5/14/2021,51421,82L-IMPORT PAYROLL,D101,HJ,,25.48,29847.16
6175,5/14/2021,5/14/2021,51421,82L-IMPORT PAYROLL,D102,HJ,,1.78,29845.38
6175,5/14/2021,5/14/2021,51421,82L-IMPORT PAYROLL,D102,HJ,,1.78,29843.6
6175,5/14/2021,5/14/2021,51421,82L-IMPORT PAYROLL,D102,HJ,,11.96,29831.64
6175,5/14/2021,5/14/2021,51421,82L-IMPORT PAYROLL,D102,HJ,,11.96,29819.68
6175,5/14/2021,5/14/2021,51421,82L-IMPORT PAYROLL,D103,HJ,,1.78,29817.9
6175,5/14/2021,5/14/2021,51421,82L-IMPORT PAYROLL,D103,HJ,,1.78,29816.12
6175,5/14/2021,5/14/2021,51421,82L-IMPORT PAYROLL,D103,HJ,,11.96,29804.16
6175,5/14/2021,5/14/2021,51421,82L-IMPORT PAYROLL,D103,HJ,,11.96,29792.2
6175,5/14/2021,5/14/2021,51421,82L-IMPORT PAYROLL,D103,HJ,,11.96,29780.24
6175,5/14/2021,5/14/2021,51421,82L-IMPORT PAYROLL,D104,HJ,,1.78,29778.46
6175,5/14/2021,5/14/2021,51421,82L-IMPORT PAYROLL,D104,HJ,,1.78,29776.68
6175,5/14/2021,5/14/2021,51421,82L-IMPORT PAYROLL,D104,HJ,,1.78,29774.9
6175,5/14/2021,5/14/2021,51421,82L-IMPORT PAYROLL,D104,HJ,,1.78,29773.12
6175,5/14/2021,5/14/2021,51421,82L-IMPORT PAYROLL,D104,HJ,,1.78,29771.34
6175,5/14/2021,5/14/2021,51421,82L-IMPORT PAYROLL,D104,HJ,,3.38,29767.96
6175,5/14/2021,5/14/2021,51421,82L-IMPORT PAYROLL,D104,HJ,,5.23,29762.73
6175,5/14/2021,5/14/2021,51421,82L-IMPORT PAYROLL,D104,HJ,,11.96,29750.77
6175,5/14/2021,5/14/2021,51421,82L-IMPORT PAYROLL,D104,HJ,,14.83,29735.94
6175,5/14/2021,5/14/2021,51421,82L-IMPORT PAYROLL,D104,HJ,,14.83,29721.11
6175,5/14/2021,5/14/2021,51421,82L-IMPORT PAYROLL,D104,HJ,,14.83,29706.28
6175,5/14/2021,5/14/2021,51421,82L-IMPORT PAYROLL,D104,HJ,,25.48,29680.8
6175,5/14/2021,5/14/2021,51421,82L-IMPORT PAYROLL,D104,HJ,,35.65,29645.15
6175,5/14/2021,5/14/2021,51421,82L-IMPORT PAYROLL,D104,HJ,,44.2,29600.95
6175,5/14/2021,5/14/2021,51421,82L-IMPORT PAYROLL,D105,HJ,,1.78,29599.17
6175,5/14/2021,5/14/2021,51421,82L-IMPORT PAYROLL,D105,HJ,,1.78,29597.39
6175,5/14/2021,5/14/2021,51421,82L-IMPORT PAYROLL,D105,HJ,,1.78,29595.61
6175,5/14/2021,5/14/2021,51421,82L-IMPORT PAYROLL,D105,HJ,,11.96,29583.65
6175,5/14/2021,5/14/2021,51421,82L-IMPORT PAYROLL,D105,HJ,,14.83,29568.82
6175,5/14/2021,5/14/2021,51421,82L-IMPORT PAYROLL,D105,HJ,,14.83,29553.99
6175,5/14/2021,5/14/2021,51421,82L-IMPORT PAYROLL,D107,HJ,,1.78,29552.21
6175,5/14/2021,5/14/2021,51421,82L-IMPORT PAYROLL,D107,HJ,,5.23,29546.98
6175,5/14/2021,5/14/2021,51421,82L-IMPORT PAYROLL,D107,HJ,,11.96,29535.02
6175,5/14/2021,5/14/2021,51421,82L-IMPORT PAYROLL,D107,HJ,,25.48,29509.54
6175,5/14/2021,5/14/2021,51421,82L-IMPORT PAYROLL,D107,HJ,,35.65,29473.89
6175,5/14/2021,5/14/2021,51421,82L-IMPORT PAYROLL,D107,HJ,,35.65,29438.24
6175,5/14/2021,5/14/2021,51421,82L-IMPORT PAYROLL,D109,HJ,,1.78,29436.46
6175,5/14/2021,5/14/2021,51421,82L-IMPORT PAYROLL,D109,HJ,,1.78,29434.68
6175,5/14/2021,5/14/2021,51421,82L-IMPORT PAYROLL,D109,HJ,,1.78,29432.9
6175,5/14/2021,5/14/2021,51421,82L-IMPORT PAYROLL,D109,HJ,,1.78,29431.12
6175,5/14/2021,5/14/2021,51421,82L-IMPORT PAYROLL,D109,HJ,,1.78,29429.34
6175,5/14/2021,5/14/2021,51421,82L-IMPORT PAYROLL,D109,HJ,,5.23,29424.11
6175,5/14/2021,5/14/2021,51421,82L-IMPORT PAYROLL,D109,HJ,,5.23,29418.88
6175,5/14/2021,5/14/2021,51421,82L-IMPORT PAYROLL,D109,HJ,,11.96,29406.92
6175,5/14/2021,5/14/2021,51421,82L-IMPORT PAYROLL,D109,HJ,,11.96,29394.96
6175,5/14/2021,5/14/2021,51421,82L-IMPORT PAYROLL,D109,HJ,,14.83,29380.13
6175,5/14/2021,5/14/2021,51421,82L-IMPORT PAYROLL,D109,HJ,,14.83,29365.3
6175,5/14/2021,5/14/2021,51421,82L-IMPORT PAYROLL,D109,HJ,,14.83,29350.47
6175,5/14/2021,5/14/2021,51421,82L-IMPORT PAYROLL,D109,HJ,,44.2,29306.27
6175,5/14/2021,5/14/2021,51421,82L-IMPORT PAYROLL,D109,HJ,,44.2,29262.07
6175,5/14/2021,5/14/2021,51421,82L-IMPORT PAYROLL,D111,HJ,,1.78,29260.29
6175,5/14/2021,5/14/2021,51421,82L-IMPORT PAYROLL,D111,HJ,,1.78,29258.51
6175,5/14/2021,5/14/2021,51421,82L-IMPORT PAYROLL,D111,HJ,,1.78,29256.73
6175,5/14/2021,5/14/2021,51421,82L-IMPORT PAYROLL,D111,HJ,,1.78,29254.95
6175,5/14/2021,5/14/2021,51421,82L-IMPORT PAYROLL,D111,HJ,,1.78,29253.17
6175,5/14/2021,5/14/2021,51421,82L-IMPORT PAYROLL,D111,HJ,,11.96,29241.21
6175,5/14/2021,5/14/2021,51421,82L-IMPORT PAYROLL,D111,HJ,,11.96,29229.25
6175,5/14/2021,5/14/2021,51421,82L-IMPORT PAYROLL,D111,HJ,,11.96,29217.29
6175,5/14/2021,5/14/2021,51421,82L-IMPORT PAYROLL,D111,HJ,,11.96,29205.33
6175,5/14/2021,5/14/2021,51421,82L-IMPORT PAYROLL,D112,HJ,,3.56,29201.77
6175,5/14/2021,5/14/2021,51421,82L-IMPORT PAYROLL,D112,HJ,,31.6,29170.17
6175,5/14/2021,5/14/2021,51421,82L-IMPORT PAYROLL,D108,HJ,,1.78,29168.39
6175,5/14/2021,5/14/2021,51421,82L-IMPORT PAYROLL,D108,HJ,,1.78,29166.61
6175,5/14/2021,5/14/2021,51421,82L-IMPORT PAYROLL,D108,HJ,,1.78,29164.83
6175,5/14/2021,5/14/2021,51421,82L-IMPORT PAYROLL,D108,HJ,,1.78,29163.05
6175,5/14/2021,5/14/2021,51421,82L-IMPORT PAYROLL,D108,HJ,,1.78,29161.27
6175,5/14/2021,5/14/2021,51421,82L-IMPORT PAYROLL,D108,HJ,,1.78,29159.49
6175,5/14/2021,5/14/2021,51421,82L-IMPORT PAYROLL,D108,HJ,,1.78,29157.71
6175,5/14/2021,5/14/2021,51421,82L-IMPORT PAYROLL,D108,HJ,,1.78,29155.93
6175,5/14/2021,5/14/2021,51421,82L-IMPORT PAYROLL,D108,HJ,,1.78,29154.15
6175,5/14/2021,5/14/2021,51421,82L-IMPORT PAYROLL,D108,HJ,,1.78,29152.37
6175,5/14/2021,5/14/2021,51421,82L-IMPORT PAYROLL,D108,HJ,,1.78,29150.59
6175,5/14/2021,5/14/2021,51421,82L-IMPORT PAYROLL,D108,HJ,,1.78,29148.81
6175,5/14/2021,5/14/2021,51421,82L-IMPORT PAYROLL,D108,HJ,,1.78,29147.03
6175,5/14/2021,5/14/2021,51421,82L-IMPORT PAYROLL,D108,HJ,,1.78,29145.25
6175,5/14/2021,5/14/2021,51421,82L-IMPORT PAYROLL,D108,HJ,,1.78,29143.47
6175,5/14/2021,5/14/2021,51421,82L-IMPORT PAYROLL,D108,HJ,,11.96,29131.51
6175,5/14/2021,5/14/2021,51421,82L-IMPORT PAYROLL,D108,HJ,,11.96,29119.55
6175,5/14/2021,5/14/2021,51421,82L-IMPORT PAYROLL,D108,HJ,,11.96,29107.59
6175,5/14/2021,5/14/2021,51421,82L-IMPORT PAYROLL,D108,HJ,,11.96,29095.63
6175,5/14/2021,5/14/2021,51421,82L-IMPORT PAYROLL,D108,HJ,,11.96,29083.67
6175,5/14/2021,5/14/2021,51421,82L-IMPORT PAYROLL,D108,HJ,,11.96,29071.71
6175,5/14/2021,5/14/2021,51421,82L-IMPORT PAYROLL,D108,HJ,,11.96,29059.75
6175,5/14/2021,5/14/2021,51421,82L-IMPORT PAYROLL,D108,HJ,,11.96,29047.79
6175,5/14/2021,5/14/2021,51421,82L-IMPORT PAYROLL,D108,HJ,,11.96,29035.83
6175,5/14/2021,5/14/2021,51421,82L-IMPORT PAYROLL,D108,HJ,,11.96,29023.87
6175,5/14/2021,5/14/2021,51421,82L-IMPORT PAYROLL,D108,HJ,,14.83,29009.04
6175,5/14/2021,5/14/2021,51421,82L-IMPORT PAYROLL,D108,HJ,,14.83,28994.21
6175,5/14/2021,5/14/2021,51421,82L-IMPORT PAYROLL,D108,HJ,,14.83,28979.38
6175,5/14/2021,5/14/2021,51421,82L-IMPORT PAYROLL,D108,HJ,,14.83,28964.55
6175,5/14/2021,5/14/2021,51421,82L-IMPORT PAYROLL,D108,HJ,,14.83,28949.72
6175,5/14/2021,5/14/2021,51421,82L-IMPORT PAYROLL,D108,HJ,,35.65,28914.07
6175,5/14/2021,5/14/2021,51421,82L-IMPORT PAYROLL,D108,HJ,,1.78,28912.29
6175,5/14/2021,5/14/2021,51421,82L-IMPORT PAYROLL,D108,HJ,,1.78,28910.51
6175,5/14/2021,5/14/2021,51421,82L-IMPORT PAYROLL,D108,HJ,,1.78,28908.73
6175,5/14/2021,5/14/2021,51421,82L-IMPORT PAYROLL,D108,HJ,,1.78,28906.95
6175,5/14/2021,5/14/2021,51421,82L-IMPORT PAYROLL,D108,HJ,,11.96,28894.99
6175,5/14/2021,5/14/2021,51421,82L-IMPORT PAYROLL,D108,HJ,,11.96,28883.03
6175,5/14/2021,5/14/2021,51421,82L-IMPORT PAYROLL,D108,HJ,,14.83,28868.2
6175,5/14/2021,5/14/2021,51421,82L-IMPORT PAYROLL,D108,HJ,,14.83,28853.37
6175,5/28/2021,5/28/2021,52821,82L-IMPORT PAYROLL,D108,HJ,,1.78,28851.59
6175,5/28/2021,5/28/2021,52821,82L-IMPORT PAYROLL,D108,HJ,,1.78,28849.81
6175,5/28/2021,5/28/2021,52821,82L-IMPORT PAYROLL,D108,HJ,,1.78,28848.03
6175,5/28/2021,5/28/2021,52821,82L-IMPORT PAYROLL,D108,HJ,,1.78,28846.25
6175,5/28/2021,5/28/2021,52821,82L-IMPORT PAYROLL,D108,HJ,,1.78,28844.47
6175,5/28/2021,5/28/2021,52821,82L-IMPORT PAYROLL,D108,HJ,,1.78,28842.69
6175,5/28/2021,5/28/2021,52821,82L-IMPORT PAYROLL,D108,HJ,,1.78,28840.91
6175,5/28/2021,5/28/2021,52821,82L-IMPORT PAYROLL,D108,HJ,,1.78,28839.13
6175,5/28/2021,5/28/2021,52821,82L-IMPORT PAYROLL,D108,HJ,,1.78,28837.35
6175,5/28/2021,5/28/2021,52821,82L-IMPORT PAYROLL,D108,HJ,,1.78,28835.57
6175,5/28/2021,5/28/2021,52821,82L-IMPORT PAYROLL,D108,HJ,,1.78,28833.79
6175,5/28/2021,5/28/2021,52821,82L-IMPORT PAYROLL,D108,HJ,,1.78,28832.01
6175,5/28/2021,5/28/2021,52821,82L-IMPORT PAYROLL,D108,HJ,,5.23,28826.78
6175,5/28/2021,5/28/2021,52821,82L-IMPORT PAYROLL,D108,HJ,,11.96,28814.82
6175,5/28/2021,5/28/2021,52821,82L-IMPORT PAYROLL,D108,HJ,,11.96,28802.86
6175,5/28/2021,5/28/2021,52821,82L-IMPORT PAYROLL,D108,HJ,,11.96,28790.9
6175,5/28/2021,5/28/2021,52821,82L-IMPORT PAYROLL,D108,HJ,,11.96,28778.94
6175,5/28/2021,5/28/2021,52821,82L-IMPORT PAYROLL,D108,HJ,,11.96,28766.98
6175,5/28/2021,5/28/2021,52821,82L-IMPORT PAYROLL,D108,HJ,,11.96,28755.02
6175,5/28/2021,5/28/2021,52821,82L-IMPORT PAYROLL,D108,HJ,,14.83,28740.19
6175,5/28/2021,5/28/2021,52821,82L-IMPORT PAYROLL,D108,HJ,,14.83,28725.36
6175,5/28/2021,5/28/2021,52821,82L-IMPORT PAYROLL,D108,HJ,,14.83,28710.53
6175,5/28/2021,5/28/2021,52821,82L-IMPORT PAYROLL,D108,HJ,,14.83,28695.7
6175,5/28/2021,5/28/2021,52821,82L-IMPORT PAYROLL,D108,HJ,,14.83,28680.87
6175,5/28/2021,5/28/2021,52821,82L-IMPORT PAYROLL,D108,HJ,,44.2,28636.67
6175,5/28/2021,5/28/2021,52821,82L-IMPORT PAYROLL,D108,HJ,,1.78,28634.89
6175,5/28/2021,5/28/2021,52821,82L-IMPORT PAYROLL,D108,HJ,,1.78,28633.11
6175,5/28/2021,5/28/2021,52821,82L-IMPORT PAYROLL,D108,HJ,,1.78,28631.33
6175,5/28/2021,5/28/2021,52821,82L-IMPORT PAYROLL,D108,HJ,,1.78,28629.55
6175,5/28/2021,5/28/2021,52821,82L-IMPORT PAYROLL,D108,HJ,,1.78,28627.77
6175,5/28/2021,5/28/2021,52821,82L-IMPORT PAYROLL,D108,HJ,,1.78,28625.99
6175,5/28/2021,5/28/2021,52821,82L-IMPORT PAYROLL,D108,HJ,,1.78,28624.21
6175,5/28/2021,5/28/2021,52821,82L-IMPORT PAYROLL,D108,HJ,,1.78,28622.43
6175,5/28/2021,5/28/2021,52821,82L-IMPORT PAYROLL,D108,HJ,,1.78,28620.65
6175,5/28/2021,5/28/2021,52821,82L-IMPORT PAYROLL,D108,HJ,,1.78,28618.87
6175,5/28/2021,5/28/2021,52821,82L-IMPORT PAYROLL,D108,HJ,,1.78,28617.09
6175,5/28/2021,5/28/2021,52821,82L-IMPORT PAYROLL,D108,HJ,,3.56,28613.53
6175,5/28/2021,5/28/2021,52821,82L-IMPORT PAYROLL,D108,HJ,,3.56,28609.97
6175,5/28/2021,5/28/2021,52821,82L-IMPORT PAYROLL,D108,HJ,,5.23,28604.74
6175,5/28/2021,5/28/2021,52821,82L-IMPORT PAYROLL,D108,HJ,,5.23,28599.51
6175,5/28/2021,5/28/2021,52821,82L-IMPORT PAYROLL,D108,HJ,,5.23,28594.28
6175,5/28/2021,5/28/2021,52821,82L-IMPORT PAYROLL,D108,HJ,,11.96,28582.32
6175,5/28/2021,5/28/2021,52821,82L-IMPORT PAYROLL,D108,HJ,,11.96,28570.36
6175,5/28/2021,5/28/2021,52821,82L-IMPORT PAYROLL,D108,HJ,,11.96,28558.4
6175,5/28/2021,5/28/2021,52821,82L-IMPORT PAYROLL,D108,HJ,,11.96,28546.44
6175,5/28/2021,5/28/2021,52821,82L-IMPORT PAYROLL,D108,HJ,,11.96,28534.48
6175,5/28/2021,5/28/2021,52821,82L-IMPORT PAYROLL,D108,HJ,,11.96,28522.52
6175,5/28/2021,5/28/2021,52821,82L-IMPORT PAYROLL,D108,HJ,,11.96,28510.56
6175,5/28/2021,5/28/2021,52821,82L-IMPORT PAYROLL,D108,HJ,,14.83,28495.73
6175,5/28/2021,5/28/2021,52821,82L-IMPORT PAYROLL,D108,HJ,,14.83,28480.9
6175,5/28/2021,5/28/2021,52821,82L-IMPORT PAYROLL,D108,HJ,,14.83,28466.07
6175,5/28/2021,5/28/2021,52821,82L-IMPORT PAYROLL,D108,HJ,,31.6,28434.47
6175,5/28/2021,5/28/2021,52821,82L-IMPORT PAYROLL,D108,HJ,,35.65,28398.82
6175,5/28/2021,5/28/2021,52821,82L-IMPORT PAYROLL,D108,HJ,,35.65,28363.17
6175,5/28/2021,5/28/2021,52821,82L-IMPORT PAYROLL,D108,HJ,,35.65,28327.52
6175,5/28/2021,5/28/2021,52821,82L-IMPORT PAYROLL,D101,HJ,,1.78,28325.74
6175,5/28/2021,5/28/2021,52821,82L-IMPORT PAYROLL,D101,HJ,,1.78,28323.96
6175,5/28/2021,5/28/2021,52821,82L-IMPORT PAYROLL,D101,HJ,,1.78,28322.18
6175,5/28/2021,5/28/2021,52821,82L-IMPORT PAYROLL,D101,HJ,,3.38,28318.8
6175,5/28/2021,5/28/2021,52821,82L-IMPORT PAYROLL,D101,HJ,,11.96,28306.84
6175,5/28/2021,5/28/2021,52821,82L-IMPORT PAYROLL,D101,HJ,,11.96,28294.88
6175,5/28/2021,5/28/2021,52821,82L-IMPORT PAYROLL,D101,HJ,,11.96,28282.92
6175,5/28/2021,5/28/2021,52821,82L-IMPORT PAYROLL,D101,HJ,,14.83,28268.09
6175,5/28/2021,5/28/2021,52821,82L-IMPORT PAYROLL,D101,HJ,,25.48,28242.61
6175,5/28/2021,5/28/2021,52821,82L-IMPORT PAYROLL,D102,HJ,,1.78,28240.83
6175,5/28/2021,5/28/2021,52821,82L-IMPORT PAYROLL,D102,HJ,,1.78,28239.05
6175,5/28/2021,5/28/2021,52821,82L-IMPORT PAYROLL,D102,HJ,,11.96,28227.09
6175,5/28/2021,5/28/2021,52821,82L-IMPORT PAYROLL,D102,HJ,,11.96,28215.13
6175,5/28/2021,5/28/2021,52821,82L-IMPORT PAYROLL,D103,HJ,,1.78,28213.35
6175,5/28/2021,5/28/2021,52821,82L-IMPORT PAYROLL,D103,HJ,,1.78,28211.57
6175,5/28/2021,5/28/2021,52821,82L-IMPORT PAYROLL,D103,HJ,,11.96,28199.61
6175,5/28/2021,5/28/2021,52821,82L-IMPORT PAYROLL,D103,HJ,,11.96,28187.65
6175,5/28/2021,5/28/2021,52821,82L-IMPORT PAYROLL,D103,HJ,,11.96,28175.69
6175,5/28/2021,5/28/2021,52821,82L-IMPORT PAYROLL,D104,HJ,,1.78,28173.91
6175,5/28/2021,5/28/2021,52821,82L-IMPORT PAYROLL,D104,HJ,,1.78,28172.13
6175,5/28/2021,5/28/2021,52821,82L-IMPORT PAYROLL,D104,HJ,,1.78,28170.35
6175,5/28/2021,5/28/2021,52821,82L-IMPORT PAYROLL,D104,HJ,,1.78,28168.57
6175,5/28/2021,5/28/2021,52821,82L-IMPORT PAYROLL,D104,HJ,,1.78,28166.79
6175,5/28/2021,5/28/2021,52821,82L-IMPORT PAYROLL,D104,HJ,,3.38,28163.41
6175,5/28/2021,5/28/2021,52821,82L-IMPORT PAYROLL,D104,HJ,,5.23,28158.18
6175,5/28/2021,5/28/2021,52821,82L-IMPORT PAYROLL,D104,HJ,,11.96,28146.22
6175,5/28/2021,5/28/2021,52821,82L-IMPORT PAYROLL,D104,HJ,,14.83,28131.39
6175,5/28/2021,5/28/2021,52821,82L-IMPORT PAYROLL,D104,HJ,,14.83,28116.56
6175,5/28/2021,5/28/2021,52821,82L-IMPORT PAYROLL,D104,HJ,,14.83,28101.73
6175,5/28/2021,5/28/2021,52821,82L-IMPORT PAYROLL,D104,HJ,,25.48,28076.25
6175,5/28/2021,5/28/2021,52821,82L-IMPORT PAYROLL,D104,HJ,,35.65,28040.6
6175,5/28/2021,5/28/2021,52821,82L-IMPORT PAYROLL,D104,HJ,,44.2,27996.4
6175,5/28/2021,5/28/2021,52821,82L-IMPORT PAYROLL,D105,HJ,,1.78,27994.62
6175,5/28/2021,5/28/2021,52821,82L-IMPORT PAYROLL,D105,HJ,,1.78,27992.84
6175,5/28/2021,5/28/2021,52821,82L-IMPORT PAYROLL,D105,HJ,,1.78,27991.06
6175,5/28/2021,5/28/2021,52821,82L-IMPORT PAYROLL,D105,HJ,,11.96,27979.1
6175,5/28/2021,5/28/2021,52821,82L-IMPORT PAYROLL,D105,HJ,,14.83,27964.27
6175,5/28/2021,5/28/2021,52821,82L-IMPORT PAYROLL,D105,HJ,,14.83,27949.44
6175,5/28/2021,5/28/2021,52821,82L-IMPORT PAYROLL,D107,HJ,,1.78,27947.66
6175,5/28/2021,5/28/2021,52821,82L-IMPORT PAYROLL,D107,HJ,,5.23,27942.43
6175,5/28/2021,5/28/2021,52821,82L-IMPORT PAYROLL,D107,HJ,,11.96,27930.47
6175,5/28/2021,5/28/2021,52821,82L-IMPORT PAYROLL,D107,HJ,,25.48,27904.99
6175,5/28/2021,5/28/2021,52821,82L-IMPORT PAYROLL,D107,HJ,,35.65,27869.34
6175,5/28/2021,5/28/2021,52821,82L-IMPORT PAYROLL,D107,HJ,,35.65,27833.69
6175,5/28/2021,5/28/2021,52821,82L-IMPORT PAYROLL,D109,HJ,,1.78,27831.91
6175,5/28/2021,5/28/2021,52821,82L-IMPORT PAYROLL,D109,HJ,,1.78,27830.13
6175,5/28/2021,5/28/2021,52821,82L-IMPORT PAYROLL,D109,HJ,,1.78,27828.35
6175,5/28/2021,5/28/2021,52821,82L-IMPORT PAYROLL,D109,HJ,,1.78,27826.57
6175,5/28/2021,5/28/2021,52821,82L-IMPORT PAYROLL,D109,HJ,,1.78,27824.79
6175,5/28/2021,5/28/2021,52821,82L-IMPORT PAYROLL,D109,HJ,,5.23,27819.56
6175,5/28/2021,5/28/2021,52821,82L-IMPORT PAYROLL,D109,HJ,,5.23,27814.33
6175,5/28/2021,5/28/2021,52821,82L-IMPORT PAYROLL,D109,HJ,,11.96,27802.37
6175,5/28/2021,5/28/2021,52821,82L-IMPORT PAYROLL,D109,HJ,,11.96,27790.41
6175,5/28/2021,5/28/2021,52821,82L-IMPORT PAYROLL,D109,HJ,,14.83,27775.58
6175,5/28/2021,5/28/2021,52821,82L-IMPORT PAYROLL,D109,HJ,,14.83,27760.75
6175,5/28/2021,5/28/2021,52821,82L-IMPORT PAYROLL,D109,HJ,,14.83,27745.92
6175,5/28/2021,5/28/2021,52821,82L-IMPORT PAYROLL,D109,HJ,,44.2,27701.72
6175,5/28/2021,5/28/2021,52821,82L-IMPORT PAYROLL,D109,HJ,,44.2,27657.52
6175,5/28/2021,5/28/2021,52821,82L-IMPORT PAYROLL,D111,HJ,,1.78,27655.74
6175,5/28/2021,5/28/2021,52821,82L-IMPORT PAYROLL,D111,HJ,,1.78,27653.96
6175,5/28/2021,5/28/2021,52821,82L-IMPORT PAYROLL,D111,HJ,,1.78,27652.18
6175,5/28/2021,5/28/2021,52821,82L-IMPORT PAYROLL,D111,HJ,,1.78,27650.4
6175,5/28/2021,5/28/2021,52821,82L-IMPORT PAYROLL,D111,HJ,,1.78,27648.62
6175,5/28/2021,5/28/2021,52821,82L-IMPORT PAYROLL,D111,HJ,,11.96,27636.66
6175,5/28/2021,5/28/2021,52821,82L-IMPORT PAYROLL,D111,HJ,,11.96,27624.7
6175,5/28/2021,5/28/2021,52821,82L-IMPORT PAYROLL,D111,HJ,,11.96,27612.74
6175,5/28/2021,5/28/2021,52821,82L-IMPORT PAYROLL,D111,HJ,,11.96,27600.78
6175,5/28/2021,5/28/2021,52821,82L-IMPORT PAYROLL,D112,HJ,,3.56,27597.22
6175,5/28/2021,5/28/2021,52821,82L-IMPORT PAYROLL,D112,HJ,,31.6,27565.62
6175,5/28/2021,5/28/2021,52821,82L-IMPORT PAYROLL,D108,HJ,,1.78,27563.84
6175,5/28/2021,5/28/2021,52821,82L-IMPORT PAYROLL,D108,HJ,,1.78,27562.06
6175,5/28/2021,5/28/2021,52821,82L-IMPORT PAYROLL,D108,HJ,,1.78,27560.28
6175,5/28/2021,5/28/2021,52821,82L-IMPORT PAYROLL,D108,HJ,,1.78,27558.5
6175,5/28/2021,5/28/2021,52821,82L-IMPORT PAYROLL,D108,HJ,,1.78,27556.72
6175,5/28/2021,5/28/2021,52821,82L-IMPORT PAYROLL,D108,HJ,,1.78,27554.94
6175,5/28/2021,5/28/2021,52821,82L-IMPORT PAYROLL,D108,HJ,,1.78,27553.16
6175,5/28/2021,5/28/2021,52821,82L-IMPORT PAYROLL,D108,HJ,,1.78,27551.38
6175,5/28/2021,5/28/2021,52821,82L-IMPORT PAYROLL,D108,HJ,,1.78,27549.6
6175,5/28/2021,5/28/2021,52821,82L-IMPORT PAYROLL,D108,HJ,,1.78,27547.82
6175,5/28/2021,5/28/2021,52821,82L-IMPORT PAYROLL,D108,HJ,,1.78,27546.04
6175,5/28/2021,5/28/2021,52821,82L-IMPORT PAYROLL,D108,HJ,,1.78,27544.26
6175,5/28/2021,5/28/2021,52821,82L-IMPORT PAYROLL,D108,HJ,,1.78,27542.48
6175,5/28/2021,5/28/2021,52821,82L-IMPORT PAYROLL,D108,HJ,,1.78,27540.7
6175,5/28/2021,5/28/2021,52821,82L-IMPORT PAYROLL,D108,HJ,,1.78,27538.92
6175,5/28/2021,5/28/2021,52821,82L-IMPORT PAYROLL,D108,HJ,,11.96,27526.96
6175,5/28/2021,5/28/2021,52821,82L-IMPORT PAYROLL,D108,HJ,,11.96,27515
6175,5/28/2021,5/28/2021,52821,82L-IMPORT PAYROLL,D108,HJ,,11.96,27503.04
6175,5/28/2021,5/28/2021,52821,82L-IMPORT PAYROLL,D108,HJ,,11.96,27491.08
6175,5/28/2021,5/28/2021,52821,82L-IMPORT PAYROLL,D108,HJ,,11.96,27479.12
6175,5/28/2021,5/28/2021,52821,82L-IMPORT PAYROLL,D108,HJ,,11.96,27467.16
6175,5/28/2021,5/28/2021,52821,82L-IMPORT PAYROLL,D108,HJ,,11.96,27455.2
6175,5/28/2021,5/28/2021,52821,82L-IMPORT PAYROLL,D108,HJ,,11.96,27443.24
6175,5/28/2021,5/28/2021,52821,82L-IMPORT PAYROLL,D108,HJ,,11.96,27431.28
6175,5/28/2021,5/28/2021,52821,82L-IMPORT PAYROLL,D108,HJ,,11.96,27419.32
6175,5/28/2021,5/28/2021,52821,82L-IMPORT PAYROLL,D108,HJ,,14.83,27404.49
6175,5/28/2021,5/28/2021,52821,82L-IMPORT PAYROLL,D108,HJ,,14.83,27389.66
6175,5/28/2021,5/28/2021,52821,82L-IMPORT PAYROLL,D108,HJ,,14.83,27374.83
6175,5/28/2021,5/28/2021,52821,82L-IMPORT PAYROLL,D108,HJ,,14.83,27360
6175,5/28/2021,5/28/2021,52821,82L-IMPORT PAYROLL,D108,HJ,,14.83,27345.17
6175,5/28/2021,5/28/2021,52821,82L-IMPORT PAYROLL,D108,HJ,,35.65,27309.52
6175,5/28/2021,5/28/2021,52821,82L-IMPORT PAYROLL,D108,HJ,,1.78,27307.74
6175,5/28/2021,5/28/2021,52821,82L-IMPORT PAYROLL,D108,HJ,,1.78,27305.96
6175,5/28/2021,5/28/2021,52821,82L-IMPORT PAYROLL,D108,HJ,,1.78,27304.18
6175,5/28/2021,5/28/2021,52821,82L-IMPORT PAYROLL,D108,HJ,,1.78,27302.4
6175,5/28/2021,5/28/2021,52821,82L-IMPORT PAYROLL,D108,HJ,,11.96,27290.44
6175,5/28/2021,5/28/2021,52821,82L-IMPORT PAYROLL,D108,HJ,,11.96,27278.48
6175,5/28/2021,5/28/2021,52821,82L-IMPORT PAYROLL,D108,HJ,,14.83,27263.65
6175,5/28/2021,5/28/2021,52821,82L-IMPORT PAYROLL,D108,HJ,,14.83,27248.82
6175,6/1/2021,6/1/2021,1,To reclassify Expenses bet departments,D107,HJ,,61.24,27187.58
6175,6/1/2021,6/1/2021,1,To reclassify Expenses bet departments,D107,HJ,61.24,,27248.82
6175,6/1/2021,6/1/2021,BCBS,BCBS June 2021 Payment,D108,HJ,1384.2,,28633.02
6175,6/1/2021,6/1/2021,BCBS,BCBS June 2021 Payment,D108,HJ,1253.48,,29886.5
6175,6/1/2021,6/1/2021,BCBS,BCBS June 2021 Payment,D101,HJ,251.15,,30137.65
6175,6/1/2021,6/1/2021,BCBS,BCBS June 2021 Payment,D102,HJ,95.66,,30233.31
6175,6/1/2021,6/1/2021,BCBS,BCBS June 2021 Payment,D103,HJ,199.28,,30432.59
6175,6/1/2021,6/1/2021,BCBS,BCBS June 2021 Payment,D104,HJ,523.81,,30956.4
6175,6/1/2021,6/1/2021,BCBS,BCBS June 2021 Payment,D105,HJ,154.97,,31111.37
6175,6/1/2021,6/1/2021,BCBS,BCBS June 2021 Payment,D107,HJ,292.35,,31403.72
6175,6/1/2021,6/1/2021,BCBS,BCBS June 2021 Payment,D109,HJ,416.08,,31819.8
6175,6/1/2021,6/1/2021,BCBS,BCBS June 2021 Payment,D111,HJ,143.49,,31963.29
6175,6/1/2021,6/1/2021,BCBS,BCBS June 2021 Payment,D112,HJ,114.15,,32077.44
6175,6/1/2021,6/1/2021,BCBS,BCBS June 2021 Payment,D108,HJ,1403.44,,33480.88
6175,6/1/2021,6/1/2021,BCBS,BCBS June 2021 Payment,D108,HJ,208.54,,33689.42
6175,6/2/2021,6/2/2021,1,Blue 20/20 Vision Ins LUX,D108,HJ,7.11,,33696.53
6175,6/2/2021,6/2/2021,1,Blue 20/20 Vision Ins 82L June Payment,D108,HJ,113.34,,33809.87
6175,6/2/2021,6/2/2021,1,Blue 20/20 Vision Ins 82L June Payment,D108,HJ,127.14,,33937.01
6175,6/2/2021,6/2/2021,1,Blue 20/20 Vision Ins LUX,D104,HJ,13.51,,33950.52
6175,6/2/2021,6/2/2021,1,Blue 20/20 Vision Ins 82L June Payment,D101,HJ,27.73,,33978.25
6175,6/2/2021,6/2/2021,1,Blue 20/20 Vision Ins 82L June Payment,D102,HJ,14.22,,33992.47
6175,6/2/2021,6/2/2021,1,Blue 20/20 Vision Ins 82L June Payment,D103,HJ,21.33,,34013.8
6175,6/2/2021,6/2/2021,1,Blue 20/20 Vision Ins 82L June Payment,D104,HJ,56.46,,34070.26
6175,6/2/2021,6/2/2021,1,Blue 20/20 Vision Ins 82L June Payment,D105,HJ,21.33,,34091.59
6175,6/2/2021,6/2/2021,1,Blue 20/20 Vision Ins 82L June Payment,D107,HJ,28.02,,34119.61
6175,6/2/2021,6/2/2021,1,Blue 20/20 Vision Ins 82L June Payment,D109,HJ,56.46,,34176.07
6175,6/2/2021,6/2/2021,1,Blue 20/20 Vision Ins 82L June Payment,D111,HJ,35.55,,34211.62
6175,6/2/2021,6/2/2021,1,Blue 20/20 Vision Ins 82L June Payment,D112,HJ,14.22,,34225.84
6175,6/2/2021,6/2/2021,1,Blue 20/20 Vision Ins 82L June Payment,D108,HJ,106.65,,34332.49
6175,6/2/2021,6/2/2021,1,Blue 20/20 Vision Ins 82L June Payment,D108,HJ,28.44,,34360.93
6175,6/15/2021,6/15/2021,61521,82L-IMPORT PAYROLL,D108,HJ,,1.78,34359.15
6175,6/15/2021,6/15/2021,61521,82L-IMPORT PAYROLL,D108,HJ,,1.78,34357.37
6175,6/15/2021,6/15/2021,61521,82L-IMPORT PAYROLL,D108,HJ,,1.78,34355.59
6175,6/15/2021,6/15/2021,61521,82L-IMPORT PAYROLL,D108,HJ,,1.78,34353.81
6175,6/15/2021,6/15/2021,61521,82L-IMPORT PAYROLL,D108,HJ,,1.78,34352.03
6175,6/15/2021,6/15/2021,61521,82L-IMPORT PAYROLL,D108,HJ,,1.78,34350.25
6175,6/15/2021,6/15/2021,61521,82L-IMPORT PAYROLL,D108,HJ,,1.78,34348.47
6175,6/15/2021,6/15/2021,61521,82L-IMPORT PAYROLL,D108,HJ,,1.78,34346.69
6175,6/15/2021,6/15/2021,61521,82L-IMPORT PAYROLL,D108,HJ,,1.78,34344.91
6175,6/15/2021,6/15/2021,61521,82L-IMPORT PAYROLL,D108,HJ,,1.78,34343.13
6175,6/15/2021,6/15/2021,61521,82L-IMPORT PAYROLL,D108,HJ,,1.78,34341.35
6175,6/15/2021,6/15/2021,61521,82L-IMPORT PAYROLL,D108,HJ,,1.78,34339.57
6175,6/15/2021,6/15/2021,61521,82L-IMPORT PAYROLL,D108,HJ,,5.23,34334.34
6175,6/15/2021,6/15/2021,61521,82L-IMPORT PAYROLL,D108,HJ,,11.96,34322.38
6175,6/15/2021,6/15/2021,61521,82L-IMPORT PAYROLL,D108,HJ,,11.96,34310.42
6175,6/15/2021,6/15/2021,61521,82L-IMPORT PAYROLL,D108,HJ,,11.96,34298.46
6175,6/15/2021,6/15/2021,61521,82L-IMPORT PAYROLL,D108,HJ,,11.96,34286.5
6175,6/15/2021,6/15/2021,61521,82L-IMPORT PAYROLL,D108,HJ,,11.96,34274.54
6175,6/15/2021,6/15/2021,61521,82L-IMPORT PAYROLL,D108,HJ,,11.96,34262.58
6175,6/15/2021,6/15/2021,61521,82L-IMPORT PAYROLL,D108,HJ,,14.83,34247.75
6175,6/15/2021,6/15/2021,61521,82L-IMPORT PAYROLL,D108,HJ,,14.83,34232.92
6175,6/15/2021,6/15/2021,61521,82L-IMPORT PAYROLL,D108,HJ,,14.83,34218.09
6175,6/15/2021,6/15/2021,61521,82L-IMPORT PAYROLL,D108,HJ,,14.83,34203.26
6175,6/15/2021,6/15/2021,61521,82L-IMPORT PAYROLL,D108,HJ,,14.83,34188.43
6175,6/15/2021,6/15/2021,61521,82L-IMPORT PAYROLL,D108,HJ,,44.2,34144.23
6175,6/15/2021,6/15/2021,61521,82L-IMPORT PAYROLL,D108,HJ,,1.78,34142.45
6175,6/15/2021,6/15/2021,61521,82L-IMPORT PAYROLL,D108,HJ,,1.78,34140.67
6175,6/15/2021,6/15/2021,61521,82L-IMPORT PAYROLL,D108,HJ,,1.78,34138.89
6175,6/15/2021,6/15/2021,61521,82L-IMPORT PAYROLL,D108,HJ,,1.78,34137.11
6175,6/15/2021,6/15/2021,61521,82L-IMPORT PAYROLL,D108,HJ,,1.78,34135.33
6175,6/15/2021,6/15/2021,61521,82L-IMPORT PAYROLL,D108,HJ,,1.78,34133.55
6175,6/15/2021,6/15/2021,61521,82L-IMPORT PAYROLL,D108,HJ,,1.78,34131.77
6175,6/15/2021,6/15/2021,61521,82L-IMPORT PAYROLL,D108,HJ,,1.78,34129.99
6175,6/15/2021,6/15/2021,61521,82L-IMPORT PAYROLL,D108,HJ,,1.78,34128.21
6175,6/15/2021,6/15/2021,61521,82L-IMPORT PAYROLL,D108,HJ,,1.78,34126.43
6175,6/15/2021,6/15/2021,61521,82L-IMPORT PAYROLL,D108,HJ,,1.78,34124.65
6175,6/15/2021,6/15/2021,61521,82L-IMPORT PAYROLL,D108,HJ,,1.78,34122.87
6175,6/15/2021,6/15/2021,61521,82L-IMPORT PAYROLL,D108,HJ,,1.78,34121.09
6175,6/15/2021,6/15/2021,61521,82L-IMPORT PAYROLL,D108,HJ,,3.56,34117.53
6175,6/15/2021,6/15/2021,61521,82L-IMPORT PAYROLL,D108,HJ,,3.56,34113.97
6175,6/15/2021,6/15/2021,61521,82L-IMPORT PAYROLL,D108,HJ,,5.23,34108.74
6175,6/15/2021,6/15/2021,61521,82L-IMPORT PAYROLL,D108,HJ,,5.23,34103.51
6175,6/15/2021,6/15/2021,61521,82L-IMPORT PAYROLL,D108,HJ,,5.23,34098.28
6175,6/15/2021,6/15/2021,61521,82L-IMPORT PAYROLL,D108,HJ,,11.96,34086.32
6175,6/15/2021,6/15/2021,61521,82L-IMPORT PAYROLL,D108,HJ,,11.96,34074.36
6175,6/15/2021,6/15/2021,61521,82L-IMPORT PAYROLL,D108,HJ,,11.96,34062.4
6175,6/15/2021,6/15/2021,61521,82L-IMPORT PAYROLL,D108,HJ,,11.96,34050.44
6175,6/15/2021,6/15/2021,61521,82L-IMPORT PAYROLL,D108,HJ,,11.96,34038.48
6175,6/15/2021,6/15/2021,61521,82L-IMPORT PAYROLL,D108,HJ,,11.96,34026.52
6175,6/15/2021,6/15/2021,61521,82L-IMPORT PAYROLL,D108,HJ,,11.96,34014.56
6175,6/15/2021,6/15/2021,61521,82L-IMPORT PAYROLL,D108,HJ,,11.96,34002.6
6175,6/15/2021,6/15/2021,61521,82L-IMPORT PAYROLL,D108,HJ,,14.83,33987.77
6175,6/15/2021,6/15/2021,61521,82L-IMPORT PAYROLL,D108,HJ,,14.83,33972.94
6175,6/15/2021,6/15/2021,61521,82L-IMPORT PAYROLL,D108,HJ,,14.83,33958.11
6175,6/15/2021,6/15/2021,61521,82L-IMPORT PAYROLL,D108,HJ,,25.48,33932.63
6175,6/15/2021,6/15/2021,61521,82L-IMPORT PAYROLL,D108,HJ,,35.65,33896.98
6175,6/15/2021,6/15/2021,61521,82L-IMPORT PAYROLL,D108,HJ,,35.65,33861.33
6175,6/15/2021,6/15/2021,61521,82L-IMPORT PAYROLL,D108,HJ,,35.65,33825.68
6175,6/15/2021,6/15/2021,61521,82L-IMPORT PAYROLL,D101,HJ,,1.78,33823.9
6175,6/15/2021,6/15/2021,61521,82L-IMPORT PAYROLL,D101,HJ,,1.78,33822.12
6175,6/15/2021,6/15/2021,61521,82L-IMPORT PAYROLL,D101,HJ,,1.78,33820.34
6175,6/15/2021,6/15/2021,61521,82L-IMPORT PAYROLL,D101,HJ,,3.38,33816.96
6175,6/15/2021,6/15/2021,61521,82L-IMPORT PAYROLL,D101,HJ,,11.96,33805
6175,6/15/2021,6/15/2021,61521,82L-IMPORT PAYROLL,D101,HJ,,11.96,33793.04
6175,6/15/2021,6/15/2021,61521,82L-IMPORT PAYROLL,D101,HJ,,11.96,33781.08
6175,6/15/2021,6/15/2021,61521,82L-IMPORT PAYROLL,D101,HJ,,14.83,33766.25
6175,6/15/2021,6/15/2021,61521,82L-IMPORT PAYROLL,D101,HJ,,25.48,33740.77
6175,6/15/2021,6/15/2021,61521,82L-IMPORT PAYROLL,D102,HJ,,1.78,33738.99
6175,6/15/2021,6/15/2021,61521,82L-IMPORT PAYROLL,D102,HJ,,1.78,33737.21
6175,6/15/2021,6/15/2021,61521,82L-IMPORT PAYROLL,D102,HJ,,11.96,33725.25
6175,6/15/2021,6/15/2021,61521,82L-IMPORT PAYROLL,D102,HJ,,11.96,33713.29
6175,6/15/2021,6/15/2021,61521,82L-IMPORT PAYROLL,D103,HJ,,1.78,33711.51
6175,6/15/2021,6/15/2021,61521,82L-IMPORT PAYROLL,D103,HJ,,1.78,33709.73
6175,6/15/2021,6/15/2021,61521,82L-IMPORT PAYROLL,D103,HJ,,11.96,33697.77
6175,6/15/2021,6/15/2021,61521,82L-IMPORT PAYROLL,D103,HJ,,11.96,33685.81
6175,6/15/2021,6/15/2021,61521,82L-IMPORT PAYROLL,D103,HJ,,11.96,33673.85
6175,6/15/2021,6/15/2021,61521,82L-IMPORT PAYROLL,D104,HJ,,1.78,33672.07
6175,6/15/2021,6/15/2021,61521,82L-IMPORT PAYROLL,D104,HJ,,1.78,33670.29
6175,6/15/2021,6/15/2021,61521,82L-IMPORT PAYROLL,D104,HJ,,1.78,33668.51
6175,6/15/2021,6/15/2021,61521,82L-IMPORT PAYROLL,D104,HJ,,1.78,33666.73
6175,6/15/2021,6/15/2021,61521,82L-IMPORT PAYROLL,D104,HJ,,1.78,33664.95
6175,6/15/2021,6/15/2021,61521,82L-IMPORT PAYROLL,D104,HJ,,3.38,33661.57
6175,6/15/2021,6/15/2021,61521,82L-IMPORT PAYROLL,D104,HJ,,5.23,33656.34
6175,6/15/2021,6/15/2021,61521,82L-IMPORT PAYROLL,D104,HJ,,11.96,33644.38
6175,6/15/2021,6/15/2021,61521,82L-IMPORT PAYROLL,D104,HJ,,14.83,33629.55
6175,6/15/2021,6/15/2021,61521,82L-IMPORT PAYROLL,D104,HJ,,14.83,33614.72
6175,6/15/2021,6/15/2021,61521,82L-IMPORT PAYROLL,D104,HJ,,14.83,33599.89
6175,6/15/2021,6/15/2021,61521,82L-IMPORT PAYROLL,D104,HJ,,25.48,33574.41
6175,6/15/2021,6/15/2021,61521,82L-IMPORT PAYROLL,D104,HJ,,35.65,33538.76
6175,6/15/2021,6/15/2021,61521,82L-IMPORT PAYROLL,D104,HJ,,44.2,33494.56
6175,6/15/2021,6/15/2021,61521,82L-IMPORT PAYROLL,D105,HJ,,1.78,33492.78
6175,6/15/2021,6/15/2021,61521,82L-IMPORT PAYROLL,D105,HJ,,1.78,33491
6175,6/15/2021,6/15/2021,61521,82L-IMPORT PAYROLL,D105,HJ,,1.78,33489.22
6175,6/15/2021,6/15/2021,61521,82L-IMPORT PAYROLL,D105,HJ,,11.96,33477.26
6175,6/15/2021,6/15/2021,61521,82L-IMPORT PAYROLL,D105,HJ,,14.83,33462.43
6175,6/15/2021,6/15/2021,61521,82L-IMPORT PAYROLL,D105,HJ,,14.83,33447.6
6175,6/15/2021,6/15/2021,61521,82L-IMPORT PAYROLL,D107,HJ,,1.78,33445.82
6175,6/15/2021,6/15/2021,61521,82L-IMPORT PAYROLL,D107,HJ,,3.56,33442.26
6175,6/15/2021,6/15/2021,61521,82L-IMPORT PAYROLL,D107,HJ,,5.23,33437.03
6175,6/15/2021,6/15/2021,61521,82L-IMPORT PAYROLL,D107,HJ,,11.96,33425.07
6175,6/15/2021,6/15/2021,61521,82L-IMPORT PAYROLL,D107,HJ,,25.48,33399.59
6175,6/15/2021,6/15/2021,61521,82L-IMPORT PAYROLL,D107,HJ,,31.6,33367.99
6175,6/15/2021,6/15/2021,61521,82L-IMPORT PAYROLL,D107,HJ,,35.65,33332.34
6175,6/15/2021,6/15/2021,61521,82L-IMPORT PAYROLL,D107,HJ,,35.65,33296.69
6175,6/15/2021,6/15/2021,61521,82L-IMPORT PAYROLL,D109,HJ,,1.78,33294.91
6175,6/15/2021,6/15/2021,61521,82L-IMPORT PAYROLL,D109,HJ,,1.78,33293.13
6175,6/15/2021,6/15/2021,61521,82L-IMPORT PAYROLL,D109,HJ,,1.78,33291.35
6175,6/15/2021,6/15/2021,61521,82L-IMPORT PAYROLL,D109,HJ,,1.78,33289.57
6175,6/15/2021,6/15/2021,61521,82L-IMPORT PAYROLL,D109,HJ,,1.78,33287.79
6175,6/15/2021,6/15/2021,61521,82L-IMPORT PAYROLL,D109,HJ,,5.23,33282.56
6175,6/15/2021,6/15/2021,61521,82L-IMPORT PAYROLL,D109,HJ,,5.23,33277.33
6175,6/15/2021,6/15/2021,61521,82L-IMPORT PAYROLL,D109,HJ,,11.96,33265.37
6175,6/15/2021,6/15/2021,61521,82L-IMPORT PAYROLL,D109,HJ,,11.96,33253.41
6175,6/15/2021,6/15/2021,61521,82L-IMPORT PAYROLL,D109,HJ,,14.83,33238.58
6175,6/15/2021,6/15/2021,61521,82L-IMPORT PAYROLL,D109,HJ,,14.83,33223.75
6175,6/15/2021,6/15/2021,61521,82L-IMPORT PAYROLL,D109,HJ,,14.83,33208.92
6175,6/15/2021,6/15/2021,61521,82L-IMPORT PAYROLL,D109,HJ,,44.2,33164.72
6175,6/15/2021,6/15/2021,61521,82L-IMPORT PAYROLL,D109,HJ,,44.2,33120.52
6175,6/15/2021,6/15/2021,61521,82L-IMPORT PAYROLL,D111,HJ,,1.78,33118.74
6175,6/15/2021,6/15/2021,61521,82L-IMPORT PAYROLL,D111,HJ,,1.78,33116.96
6175,6/15/2021,6/15/2021,61521,82L-IMPORT PAYROLL,D111,HJ,,1.78,33115.18
6175,6/15/2021,6/15/2021,61521,82L-IMPORT PAYROLL,D111,HJ,,1.78,33113.4
6175,6/15/2021,6/15/2021,61521,82L-IMPORT PAYROLL,D111,HJ,,1.78,33111.62
6175,6/15/2021,6/15/2021,61521,82L-IMPORT PAYROLL,D111,HJ,,11.96,33099.66
6175,6/15/2021,6/15/2021,61521,82L-IMPORT PAYROLL,D111,HJ,,11.96,33087.7
6175,6/15/2021,6/15/2021,61521,82L-IMPORT PAYROLL,D111,HJ,,11.96,33075.74
6175,6/15/2021,6/15/2021,61521,82L-IMPORT PAYROLL,D111,HJ,,11.96,33063.78
6175,6/15/2021,6/15/2021,61521,82L-IMPORT PAYROLL,D112,HJ,,3.56,33060.22
6175,6/15/2021,6/15/2021,61521,82L-IMPORT PAYROLL,D112,HJ,,31.6,33028.62
6175,6/15/2021,6/15/2021,61521,82L-IMPORT PAYROLL,D108,HJ,,1.78,33026.84
6175,6/15/2021,6/15/2021,61521,82L-IMPORT PAYROLL,D108,HJ,,1.78,33025.06
6175,6/15/2021,6/15/2021,61521,82L-IMPORT PAYROLL,D108,HJ,,1.78,33023.28
6175,6/15/2021,6/15/2021,61521,82L-IMPORT PAYROLL,D108,HJ,,1.78,33021.5
6175,6/15/2021,6/15/2021,61521,82L-IMPORT PAYROLL,D108,HJ,,1.78,33019.72
6175,6/15/2021,6/15/2021,61521,82L-IMPORT PAYROLL,D108,HJ,,1.78,33017.94
6175,6/15/2021,6/15/2021,61521,82L-IMPORT PAYROLL,D108,HJ,,1.78,33016.16
6175,6/15/2021,6/15/2021,61521,82L-IMPORT PAYROLL,D108,HJ,,1.78,33014.38
6175,6/15/2021,6/15/2021,61521,82L-IMPORT PAYROLL,D108,HJ,,1.78,33012.6
6175,6/15/2021,6/15/2021,61521,82L-IMPORT PAYROLL,D108,HJ,,1.78,33010.82
6175,6/15/2021,6/15/2021,61521,82L-IMPORT PAYROLL,D108,HJ,,1.78,33009.04
6175,6/15/2021,6/15/2021,61521,82L-IMPORT PAYROLL,D108,HJ,,1.78,33007.26
6175,6/15/2021,6/15/2021,61521,82L-IMPORT PAYROLL,D108,HJ,,1.78,33005.48
6175,6/15/2021,6/15/2021,61521,82L-IMPORT PAYROLL,D108,HJ,,1.78,33003.7
6175,6/15/2021,6/15/2021,61521,82L-IMPORT PAYROLL,D108,HJ,,1.78,33001.92
6175,6/15/2021,6/15/2021,61521,82L-IMPORT PAYROLL,D108,HJ,,11.96,32989.96
6175,6/15/2021,6/15/2021,61521,82L-IMPORT PAYROLL,D108,HJ,,11.96,32978
6175,6/15/2021,6/15/2021,61521,82L-IMPORT PAYROLL,D108,HJ,,11.96,32966.04
6175,6/15/2021,6/15/2021,61521,82L-IMPORT PAYROLL,D108,HJ,,11.96,32954.08
6175,6/15/2021,6/15/2021,61521,82L-IMPORT PAYROLL,D108,HJ,,11.96,32942.12
6175,6/15/2021,6/15/2021,61521,82L-IMPORT PAYROLL,D108,HJ,,11.96,32930.16
6175,6/15/2021,6/15/2021,61521,82L-IMPORT PAYROLL,D108,HJ,,11.96,32918.2
6175,6/15/2021,6/15/2021,61521,82L-IMPORT PAYROLL,D108,HJ,,11.96,32906.24
6175,6/15/2021,6/15/2021,61521,82L-IMPORT PAYROLL,D108,HJ,,11.96,32894.28
6175,6/15/2021,6/15/2021,61521,82L-IMPORT PAYROLL,D108,HJ,,11.96,32882.32
6175,6/15/2021,6/15/2021,61521,82L-IMPORT PAYROLL,D108,HJ,,14.83,32867.49
6175,6/15/2021,6/15/2021,61521,82L-IMPORT PAYROLL,D108,HJ,,14.83,32852.66
6175,6/15/2021,6/15/2021,61521,82L-IMPORT PAYROLL,D108,HJ,,14.83,32837.83
6175,6/15/2021,6/15/2021,61521,82L-IMPORT PAYROLL,D108,HJ,,14.83,32823
6175,6/15/2021,6/15/2021,61521,82L-IMPORT PAYROLL,D108,HJ,,14.83,32808.17
6175,6/15/2021,6/15/2021,61521,82L-IMPORT PAYROLL,D108,HJ,,35.65,32772.52
6175,6/15/2021,6/15/2021,61521,82L-IMPORT PAYROLL,D108,HJ,,1.78,32770.74
6175,6/15/2021,6/15/2021,61521,82L-IMPORT PAYROLL,D108,HJ,,1.78,32768.96
6175,6/15/2021,6/15/2021,61521,82L-IMPORT PAYROLL,D108,HJ,,1.78,32767.18
6175,6/15/2021,6/15/2021,61521,82L-IMPORT PAYROLL,D108,HJ,,1.78,32765.4
6175,6/15/2021,6/15/2021,61521,82L-IMPORT PAYROLL,D108,HJ,,11.96,32753.44
6175,6/15/2021,6/15/2021,61521,82L-IMPORT PAYROLL,D108,HJ,,11.96,32741.48
6175,6/15/2021,6/15/2021,61521,82L-IMPORT PAYROLL,D108,HJ,,14.83,32726.65
6175,6/15/2021,6/15/2021,61521,82L-IMPORT PAYROLL,D108,HJ,,14.83,32711.82
6175,6/30/2021,6/30/2021,63021,82L-IMPORT PAYROLL,D108,HJ,,1.78,32710.04
6175,6/30/2021,6/30/2021,63021,82L-IMPORT PAYROLL,D108,HJ,,1.78,32708.26
6175,6/30/2021,6/30/2021,63021,82L-IMPORT PAYROLL,D108,HJ,,1.78,32706.48
6175,6/30/2021,6/30/2021,63021,82L-IMPORT PAYROLL,D108,HJ,,1.78,32704.7
6175,6/30/2021,6/30/2021,63021,82L-IMPORT PAYROLL,D108,HJ,,5.23,32699.47
6175,6/30/2021,6/30/2021,63021,82L-IMPORT PAYROLL,D108,HJ,,11.96,32687.51
6175,6/30/2021,6/30/2021,63021,82L-IMPORT PAYROLL,D108,HJ,,11.96,32675.55
6175,6/30/2021,6/30/2021,63021,82L-IMPORT PAYROLL,D108,HJ,,11.96,32663.59
6175,6/30/2021,6/30/2021,63021,82L-IMPORT PAYROLL,D108,HJ,,11.96,32651.63
6175,6/30/2021,6/30/2021,63021,82L-IMPORT PAYROLL,D108,HJ,,44.2,32607.43
6175,6/30/2021,6/30/2021,63021,82L-IMPORT PAYROLL,D108,HJ,,1.78,32605.65
6175,6/30/2021,6/30/2021,63021,82L-IMPORT PAYROLL,D108,HJ,,1.78,32603.87
6175,6/30/2021,6/30/2021,63021,82L-IMPORT PAYROLL,D108,HJ,,1.78,32602.09
6175,6/30/2021,6/30/2021,63021,82L-IMPORT PAYROLL,D108,HJ,,1.78,32600.31
6175,6/30/2021,6/30/2021,63021,82L-IMPORT PAYROLL,D108,HJ,,1.78,32598.53
6175,6/30/2021,6/30/2021,63021,82L-IMPORT PAYROLL,D108,HJ,,1.78,32596.75
6175,6/30/2021,6/30/2021,63021,82L-IMPORT PAYROLL,D108,HJ,,1.78,32594.97
6175,6/30/2021,6/30/2021,63021,82L-IMPORT PAYROLL,D108,HJ,,1.78,32593.19
6175,6/30/2021,6/30/2021,63021,82L-IMPORT PAYROLL,D108,HJ,,1.78,32591.41
6175,6/30/2021,6/30/2021,63021,82L-IMPORT PAYROLL,D108,HJ,,1.78,32589.63
6175,6/30/2021,6/30/2021,63021,82L-IMPORT PAYROLL,D108,HJ,,1.78,32587.85
6175,6/30/2021,6/30/2021,63021,82L-IMPORT PAYROLL,D108,HJ,,1.78,32586.07
6175,6/30/2021,6/30/2021,63021,82L-IMPORT PAYROLL,D108,HJ,,1.78,32584.29
6175,6/30/2021,6/30/2021,63021,82L-IMPORT PAYROLL,D108,HJ,,3.56,32580.73
6175,6/30/2021,6/30/2021,63021,82L-IMPORT PAYROLL,D108,HJ,,3.56,32577.17
6175,6/30/2021,6/30/2021,63021,82L-IMPORT PAYROLL,D108,HJ,,5.23,32571.94
6175,6/30/2021,6/30/2021,63021,82L-IMPORT PAYROLL,D108,HJ,,5.23,32566.71
6175,6/30/2021,6/30/2021,63021,82L-IMPORT PAYROLL,D108,HJ,,5.23,32561.48
6175,6/30/2021,6/30/2021,63021,82L-IMPORT PAYROLL,D108,HJ,,11.96,32549.52
6175,6/30/2021,6/30/2021,63021,82L-IMPORT PAYROLL,D108,HJ,,11.96,32537.56
6175,6/30/2021,6/30/2021,63021,82L-IMPORT PAYROLL,D108,HJ,,11.96,32525.6
6175,6/30/2021,6/30/2021,63021,82L-IMPORT PAYROLL,D108,HJ,,11.96,32513.64
6175,6/30/2021,6/30/2021,63021,82L-IMPORT PAYROLL,D108,HJ,,11.96,32501.68
6175,6/30/2021,6/30/2021,63021,82L-IMPORT PAYROLL,D108,HJ,,11.96,32489.72
6175,6/30/2021,6/30/2021,63021,82L-IMPORT PAYROLL,D108,HJ,,11.96,32477.76
6175,6/30/2021,6/30/2021,63021,82L-IMPORT PAYROLL,D108,HJ,,11.96,32465.8
6175,6/30/2021,6/30/2021,63021,82L-IMPORT PAYROLL,D108,HJ,,14.83,32450.97
6175,6/30/2021,6/30/2021,63021,82L-IMPORT PAYROLL,D108,HJ,,14.83,32436.14
6175,6/30/2021,6/30/2021,63021,82L-IMPORT PAYROLL,D108,HJ,,14.83,32421.31
6175,6/30/2021,6/30/2021,63021,82L-IMPORT PAYROLL,D108,HJ,25.48,,32446.79
6175,6/30/2021,6/30/2021,63021,82L-IMPORT PAYROLL,D108,HJ,,35.65,32411.14
6175,6/30/2021,6/30/2021,63021,82L-IMPORT PAYROLL,D108,HJ,,35.65,32375.49
6175,6/30/2021,6/30/2021,63021,82L-IMPORT PAYROLL,D108,HJ,,35.65,32339.84
6175,6/30/2021,6/30/2021,63021,82L-IMPORT PAYROLL,D101,HJ,,1.78,32338.06
6175,6/30/2021,6/30/2021,63021,82L-IMPORT PAYROLL,D101,HJ,,1.78,32336.28
6175,6/30/2021,6/30/2021,63021,82L-IMPORT PAYROLL,D101,HJ,,1.78,32334.5
6175,6/30/2021,6/30/2021,63021,82L-IMPORT PAYROLL,D101,HJ,,3.38,32331.12
6175,6/30/2021,6/30/2021,63021,82L-IMPORT PAYROLL,D101,HJ,,11.96,32319.16
6175,6/30/2021,6/30/2021,63021,82L-IMPORT PAYROLL,D101,HJ,,11.96,32307.2
6175,6/30/2021,6/30/2021,63021,82L-IMPORT PAYROLL,D101,HJ,,11.96,32295.24
6175,6/30/2021,6/30/2021,63021,82L-IMPORT PAYROLL,D101,HJ,,14.83,32280.41
6175,6/30/2021,6/30/2021,63021,82L-IMPORT PAYROLL,D101,HJ,,25.48,32254.93
6175,6/30/2021,6/30/2021,63021,82L-IMPORT PAYROLL,D102,HJ,,1.78,32253.15
6175,6/30/2021,6/30/2021,63021,82L-IMPORT PAYROLL,D102,HJ,,1.78,32251.37
6175,6/30/2021,6/30/2021,63021,82L-IMPORT PAYROLL,D102,HJ,,11.96,32239.41
6175,6/30/2021,6/30/2021,63021,82L-IMPORT PAYROLL,D102,HJ,,11.96,32227.45
6175,6/30/2021,6/30/2021,63021,82L-IMPORT PAYROLL,D103,HJ,,1.78,32225.67
6175,6/30/2021,6/30/2021,63021,82L-IMPORT PAYROLL,D103,HJ,,1.78,32223.89
6175,6/30/2021,6/30/2021,63021,82L-IMPORT PAYROLL,D103,HJ,,11.96,32211.93
6175,6/30/2021,6/30/2021,63021,82L-IMPORT PAYROLL,D103,HJ,,11.96,32199.97
6175,6/30/2021,6/30/2021,63021,82L-IMPORT PAYROLL,D103,HJ,,11.96,32188.01
6175,6/30/2021,6/30/2021,63021,82L-IMPORT PAYROLL,D104,HJ,,1.78,32186.23
6175,6/30/2021,6/30/2021,63021,82L-IMPORT PAYROLL,D104,HJ,,1.78,32184.45
6175,6/30/2021,6/30/2021,63021,82L-IMPORT PAYROLL,D104,HJ,,1.78,32182.67
6175,6/30/2021,6/30/2021,63021,82L-IMPORT PAYROLL,D104,HJ,,1.78,32180.89
6175,6/30/2021,6/30/2021,63021,82L-IMPORT PAYROLL,D104,HJ,,1.78,32179.11
6175,6/30/2021,6/30/2021,63021,82L-IMPORT PAYROLL,D104,HJ,,3.38,32175.73
6175,6/30/2021,6/30/2021,63021,82L-IMPORT PAYROLL,D104,HJ,,5.23,32170.5
6175,6/30/2021,6/30/2021,63021,82L-IMPORT PAYROLL,D104,HJ,,11.96,32158.54
6175,6/30/2021,6/30/2021,63021,82L-IMPORT PAYROLL,D104,HJ,,14.83,32143.71
6175,6/30/2021,6/30/2021,63021,82L-IMPORT PAYROLL,D104,HJ,,14.83,32128.88
6175,6/30/2021,6/30/2021,63021,82L-IMPORT PAYROLL,D104,HJ,,14.83,32114.05
6175,6/30/2021,6/30/2021,63021,82L-IMPORT PAYROLL,D104,HJ,,25.48,32088.57
6175,6/30/2021,6/30/2021,63021,82L-IMPORT PAYROLL,D104,HJ,,35.65,32052.92
6175,6/30/2021,6/30/2021,63021,82L-IMPORT PAYROLL,D104,HJ,,44.2,32008.72
6175,6/30/2021,6/30/2021,63021,82L-IMPORT PAYROLL,D105,HJ,,1.78,32006.94
6175,6/30/2021,6/30/2021,63021,82L-IMPORT PAYROLL,D105,HJ,,1.78,32005.16
6175,6/30/2021,6/30/2021,63021,82L-IMPORT PAYROLL,D105,HJ,,1.78,32003.38
6175,6/30/2021,6/30/2021,63021,82L-IMPORT PAYROLL,D105,HJ,,11.96,31991.42
6175,6/30/2021,6/30/2021,63021,82L-IMPORT PAYROLL,D105,HJ,,14.83,31976.59
6175,6/30/2021,6/30/2021,63021,82L-IMPORT PAYROLL,D105,HJ,,14.83,31961.76
6175,6/30/2021,6/30/2021,63021,82L-IMPORT PAYROLL,D107,HJ,,1.78,31959.98
6175,6/30/2021,6/30/2021,63021,82L-IMPORT PAYROLL,D107,HJ,,3.56,31956.42
6175,6/30/2021,6/30/2021,63021,82L-IMPORT PAYROLL,D107,HJ,,5.23,31951.19
6175,6/30/2021,6/30/2021,63021,82L-IMPORT PAYROLL,D107,HJ,,11.96,31939.23
6175,6/30/2021,6/30/2021,63021,82L-IMPORT PAYROLL,D107,HJ,,25.48,31913.75
6175,6/30/2021,6/30/2021,63021,82L-IMPORT PAYROLL,D107,HJ,,31.6,31882.15
6175,6/30/2021,6/30/2021,63021,82L-IMPORT PAYROLL,D107,HJ,,35.65,31846.5
6175,6/30/2021,6/30/2021,63021,82L-IMPORT PAYROLL,D107,HJ,,35.65,31810.85
6175,6/30/2021,6/30/2021,63021,82L-IMPORT PAYROLL,D109,HJ,,1.78,31809.07
6175,6/30/2021,6/30/2021,63021,82L-IMPORT PAYROLL,D109,HJ,,1.78,31807.29
6175,6/30/2021,6/30/2021,63021,82L-IMPORT PAYROLL,D109,HJ,,1.78,31805.51
6175,6/30/2021,6/30/2021,63021,82L-IMPORT PAYROLL,D109,HJ,,1.78,31803.73
6175,6/30/2021,6/30/2021,63021,82L-IMPORT PAYROLL,D109,HJ,,1.78,31801.95
6175,6/30/2021,6/30/2021,63021,82L-IMPORT PAYROLL,D109,HJ,,5.23,31796.72
6175,6/30/2021,6/30/2021,63021,82L-IMPORT PAYROLL,D109,HJ,,5.23,31791.49
6175,6/30/2021,6/30/2021,63021,82L-IMPORT PAYROLL,D109,HJ,,11.96,31779.53
6175,6/30/2021,6/30/2021,63021,82L-IMPORT PAYROLL,D109,HJ,,11.96,31767.57
6175,6/30/2021,6/30/2021,63021,82L-IMPORT PAYROLL,D109,HJ,,14.83,31752.74
6175,6/30/2021,6/30/2021,63021,82L-IMPORT PAYROLL,D109,HJ,,14.83,31737.91
6175,6/30/2021,6/30/2021,63021,82L-IMPORT PAYROLL,D109,HJ,,14.83,31723.08
6175,6/30/2021,6/30/2021,63021,82L-IMPORT PAYROLL,D109,HJ,,44.2,31678.88
6175,6/30/2021,6/30/2021,63021,82L-IMPORT PAYROLL,D109,HJ,,44.2,31634.68
6175,6/30/2021,6/30/2021,63021,82L-IMPORT PAYROLL,D111,HJ,,1.78,31632.9
6175,6/30/2021,6/30/2021,63021,82L-IMPORT PAYROLL,D111,HJ,,1.78,31631.12
6175,6/30/2021,6/30/2021,63021,82L-IMPORT PAYROLL,D111,HJ,,1.78,31629.34
6175,6/30/2021,6/30/2021,63021,82L-IMPORT PAYROLL,D111,HJ,,1.78,31627.56
6175,6/30/2021,6/30/2021,63021,82L-IMPORT PAYROLL,D111,HJ,,1.78,31625.78
6175,6/30/2021,6/30/2021,63021,82L-IMPORT PAYROLL,D111,HJ,,11.96,31613.82
6175,6/30/2021,6/30/2021,63021,82L-IMPORT PAYROLL,D111,HJ,,11.96,31601.86
6175,6/30/2021,6/30/2021,63021,82L-IMPORT PAYROLL,D111,HJ,,11.96,31589.9
6175,6/30/2021,6/30/2021,63021,82L-IMPORT PAYROLL,D111,HJ,,11.96,31577.94
6175,6/30/2021,6/30/2021,63021,82L-IMPORT PAYROLL,D112,HJ,,3.56,31574.38
6175,6/30/2021,6/30/2021,63021,82L-IMPORT PAYROLL,D112,HJ,,31.6,31542.78
6175,6/30/2021,6/30/2021,63021,82L-IMPORT PAYROLL,D108,HJ,,1.78,31541
6175,6/30/2021,6/30/2021,63021,82L-IMPORT PAYROLL,D108,HJ,,1.78,31539.22
6175,6/30/2021,6/30/2021,63021,82L-IMPORT PAYROLL,D108,HJ,,1.78,31537.44
6175,6/30/2021,6/30/2021,63021,82L-IMPORT PAYROLL,D108,HJ,,1.78,31535.66
6175,6/30/2021,6/30/2021,63021,82L-IMPORT PAYROLL,D108,HJ,,1.78,31533.88
6175,6/30/2021,6/30/2021,63021,82L-IMPORT PAYROLL,D108,HJ,,1.78,31532.1
6175,6/30/2021,6/30/2021,63021,82L-IMPORT PAYROLL,D108,HJ,,1.78,31530.32
6175,6/30/2021,6/30/2021,63021,82L-IMPORT PAYROLL,D108,HJ,,1.78,31528.54
6175,6/30/2021,6/30/2021,63021,82L-IMPORT PAYROLL,D108,HJ,,1.78,31526.76
6175,6/30/2021,6/30/2021,63021,82L-IMPORT PAYROLL,D108,HJ,,1.78,31524.98
6175,6/30/2021,6/30/2021,63021,82L-IMPORT PAYROLL,D108,HJ,,1.78,31523.2
6175,6/30/2021,6/30/2021,63021,82L-IMPORT PAYROLL,D108,HJ,,1.78,31521.42
6175,6/30/2021,6/30/2021,63021,82L-IMPORT PAYROLL,D108,HJ,,1.78,31519.64
6175,6/30/2021,6/30/2021,63021,82L-IMPORT PAYROLL,D108,HJ,,1.78,31517.86
6175,6/30/2021,6/30/2021,63021,82L-IMPORT PAYROLL,D108,HJ,,1.78,31516.08
6175,6/30/2021,6/30/2021,63021,82L-IMPORT PAYROLL,D108,HJ,,11.96,31504.12
6175,6/30/2021,6/30/2021,63021,82L-IMPORT PAYROLL,D108,HJ,,11.96,31492.16
6175,6/30/2021,6/30/2021,63021,82L-IMPORT PAYROLL,D108,HJ,,11.96,31480.2
6175,6/30/2021,6/30/2021,63021,82L-IMPORT PAYROLL,D108,HJ,,11.96,31468.24
6175,6/30/2021,6/30/2021,63021,82L-IMPORT PAYROLL,D108,HJ,,11.96,31456.28
6175,6/30/2021,6/30/2021,63021,82L-IMPORT PAYROLL,D108,HJ,,11.96,31444.32
6175,6/30/2021,6/30/2021,63021,82L-IMPORT PAYROLL,D108,HJ,,11.96,31432.36
6175,6/30/2021,6/30/2021,63021,82L-IMPORT PAYROLL,D108,HJ,,11.96,31420.4
6175,6/30/2021,6/30/2021,63021,82L-IMPORT PAYROLL,D108,HJ,,11.96,31408.44
6175,6/30/2021,6/30/2021,63021,82L-IMPORT PAYROLL,D108,HJ,,11.96,31396.48
6175,6/30/2021,6/30/2021,63021,82L-IMPORT PAYROLL,D108,HJ,,14.83,31381.65
6175,6/30/2021,6/30/2021,63021,82L-IMPORT PAYROLL,D108,HJ,,14.83,31366.82
6175,6/30/2021,6/30/2021,63021,82L-IMPORT PAYROLL,D108,HJ,,14.83,31351.99
6175,6/30/2021,6/30/2021,63021,82L-IMPORT PAYROLL,D108,HJ,,14.83,31337.16
6175,6/30/2021,6/30/2021,63021,82L-IMPORT PAYROLL,D108,HJ,,14.83,31322.33
6175,6/30/2021,6/30/2021,63021,82L-IMPORT PAYROLL,D108,HJ,,35.65,31286.68
6175,6/30/2021,6/30/2021,63021,82L-IMPORT PAYROLL,D108,HJ,,1.78,31284.9
6175,6/30/2021,6/30/2021,63021,82L-IMPORT PAYROLL,D108,HJ,,1.78,31283.12
6175,6/30/2021,6/30/2021,63021,82L-IMPORT PAYROLL,D108,HJ,,1.78,31281.34
6175,6/30/2021,6/30/2021,63021,82L-IMPORT PAYROLL,D108,HJ,,1.78,31279.56
6175,6/30/2021,6/30/2021,63021,82L-IMPORT PAYROLL,D108,HJ,,11.96,31267.6
6175,6/30/2021,6/30/2021,63021,82L-IMPORT PAYROLL,D108,HJ,,11.96,31255.64
6175,6/30/2021,6/30/2021,63021,82L-IMPORT PAYROLL,D108,HJ,,14.83,31240.81
6175,6/30/2021,6/30/2021,63021,82L-IMPORT PAYROLL,D108,HJ,,14.83,31225.98
6175,6/30/2021,6/30/2021,Entry to correct the expense amount base,Entry to correct the expense amount based on ADP Timecard using SPARKMATH as activity code,D999,GJ,,56.46,31169.52
6175,6/30/2021,6/30/2021,Entry to correct the expense amount base,Entry to correct the expense amount based on ADP Timecard using SPARKMATH as activity code,D999,GJ,56.46,,31225.98
6175, Totals for 6175 - Staff Dental and Vision Insurance,,,,,,70883.95,39657.97,31225.98
6190,6190 - Staff Fringe Cost Allocation (Balance forward As of 07/01/2020) ,,,,,,,,0
6190,3/2/2021,3/2/2021,TASC,Bill.Com Import,D104,HJ,1174.59,,1174.59
6190,3/2/2021,3/2/2021,TASC,Bill.Com Import,D104,HJ,1174.59,,2349.18
6190,3/31/2021,3/31/2021,ESI Group,Bill.Com Import,D104,HJ,8225.7,,10574.88
6190,4/1/2021,4/1/2021,Transamerica,Bill.Com Import,D103,HJ,135,,10709.88
6190,5/5/2021,5/5/2021,Transamerica,Life Policy for Monivett Acevedo,D103,HJ,135,,10844.88
6190,6/15/2021,6/15/2021,TASC,Bill.Com Import,D104,HJ,165,,11009.88
6190, Totals for 6190 - Staff Fringe Cost Allocation,,,,,,11009.88,0,11009.88
6200,6200 - AmeriCorps Saga Fellow Stipend (Balance forward As of 07/01/2020) ,,,,,,,,0
6200,7/1/2020,7/1/2020,AC-R&C,To reverse and correct the GL coding-Correct: To record the Americorps disallowance -Payment of Disallowance by lowering expense,D107,HJ,,120692,-120692
6200,7/31/2020,7/31/2020,202007,Adj to reallocate Salaries FICA and benefits from GM3 - ACY2 to G-BL-To reallocate GM3 - ACY2 Expense,D108,HJ,,10454.48,-131146.48
6200,7/31/2020,7/31/2020,202007,Adj to reallocate Salaries FICA and benefits from GM3 - ACY2 to G-BL-To reallocate GM3 - ACY2 Expense,D108,HJ,10454.48,,-120692
6200,8/15/2020,8/15/2020,LUX-PRPD-081520,LUX-IMPORT PAYROLL-CORSEY SAMANTHA RENEE,D108,HJ,461.27,,-120230.73
6200,8/15/2020,8/15/2020,LUX-PRPD-081520,LUX-IMPORT PAYROLL-DAILY JAMES L,D108,HJ,999.45,,-119231.28
6200,8/15/2020,8/15/2020,LUX-PRPD-081520,LUX-IMPORT PAYROLL-DOYAL JAMI D,D108,HJ,999.45,,-118231.83
6200,8/15/2020,8/15/2020,LUX-PRPD-081520,LUX-IMPORT PAYROLL-GIRONA MERCEDES MAE,D108,HJ,461.27,,-117770.56
6200,8/15/2020,8/15/2020,LUX-PRPD-081520,LUX-IMPORT PAYROLL-GREEN TAYLOR,D108,HJ,461.27,,-117309.29
6200,8/15/2020,8/15/2020,LUX-PRPD-081520,LUX-IMPORT PAYROLL-HABENSTREIT LILY,D108,HJ,461.27,,-116848.02
6200,8/15/2020,8/15/2020,LUX-PRPD-081520,LUX-IMPORT PAYROLL-HAMMER CAROLINE,D108,HJ,461.27,,-116386.75
6200,8/15/2020,8/15/2020,LUX-PRPD-081520,LUX-IMPORT PAYROLL-KITTUR KIRAN,D108,HJ,461.27,,-115925.48
6200,8/15/2020,8/15/2020,LUX-PRPD-081520,LUX-IMPORT PAYROLL-MARGONO YULIN,D108,HJ,461.27,,-115464.21
6200,8/15/2020,8/15/2020,LUX-PRPD-081520,LUX-IMPORT PAYROLL-MAXWELL JENNEE,D108,HJ,1000,,-114464.21
6200,8/15/2020,8/15/2020,LUX-PRPD-081520,LUX-IMPORT PAYROLL-MENSAH NADINE,D108,HJ,999.45,,-113464.76
6200,8/15/2020,8/15/2020,LUX-PRPD-081520,LUX-IMPORT PAYROLL-SUSSMAN LAYTON,D108,HJ,461.27,,-113003.49
6200,8/15/2020,8/15/2020,LUX-PRPD-081520,LUX-IMPORT PAYROLL-UY ERICA,D108,HJ,1094.64,,-111908.85
6200,8/15/2020,8/15/2020,LUX-PRPD-081520,LUX-IMPORT PAYROLL-VIRADIYA ASHINI,D108,HJ,461.27,,-111447.58
6200,8/15/2020,8/15/2020,LUX-PRPD-081520,LUX-IMPORT PAYROLL-WHITAKER ALEXIS,D108,HJ,999.45,,-110448.13
6200,8/15/2020,8/15/2020,LUX-PRPD-081520,LUX-IMPORT PAYROLL-ZEMBA TARAI,D108,HJ,1094.64,,-109353.49
6200,8/31/2020,8/31/2020,202008,Adj to reallocate Salaries FICA and benefits from GM3 - ACY2 to G-BL-To reallocate GM3 - ACY2 Expense,D108,HJ,,10454.48,-119807.97
6200,8/31/2020,8/31/2020,202008,Adj to reallocate Salaries FICA and benefits from GM3 - ACY2 to G-BL-To reallocate GM3 - ACY2 Expense,D108,HJ,10454.48,,-109353.49
6200,8/31/2020,8/31/2020,LUX-PRPD-083120,LUX-PRPD-083120 -Payroll-AC STIPENDS-CHICAGO,D108,HJ,102161.65,,-7191.84
6200,8/31/2020,8/31/2020,LUX-PRPD-083120,LUX-PRPD-083120 -Payroll-AC STIPENDS-NYC,D108,HJ,1119.05,,-6072.79
6200,8/31/2020,8/31/2020,LUX-PRPD-083120,LUX-PRPD-083120 -Payroll-AC STIPENDS-DC,D108,HJ,18685.68,,12612.89
6200,8/31/2020,8/31/2020,To NYC OM Wage,LUX-PRPD-083120 -Payroll (Reclassification of GL)-To NYC OM Wage to GL 6110,D108,HJ,,1119.05,11493.84
6200,9/15/2020,9/15/2020,LUX-PRPD-091520,LUX-PRPD-091520-LUX-PRPD-091520 -Payroll,D108,HJ,100657.74,,112151.58
6200,9/15/2020,9/15/2020,LUX-PRPD-091520,LUX-PRPD-091520-LUX-PRPD-091520 -Payroll,D108,HJ,18180.48,,130332.06
6200,9/30/2020,9/30/2020,202009,Adj to reallocate Salaries FICA and benefits from GM3 - ACY2 to G-BL-To reallocate GM3 - ACY2 Expense,D108,HJ,,15181.1,115150.96
6200,9/30/2020,9/30/2020,202009,Adj to reallocate Salaries FICA and benefits from GM3 - ACY2 to G-BL-To reallocate GM3 - ACY2 Expense,D108,HJ,15181.1,,130332.06
6200,9/30/2020,9/30/2020,20200930,Adj to Reconcile GM3 - ACY2-Adj to Reconcile GM3 - ACY2,D108,HJ,,327.71,130004.35
6200,9/30/2020,9/30/2020,20200930,Adj to Reconcile GM3 - ACY2-Adj to Reconcile GM3 - ACY2,D108,HJ,327.71,,130332.06
6200,9/30/2020,9/30/2020,LUX-PRPD-093020,LUX-PRPD-093020-Payroll,D108,HJ,101274.35,,231606.41
6200,9/30/2020,9/30/2020,LUX-PRPD-093020,LUX-PRPD-093020-Payroll,D108,HJ,18180.48,,249786.89
6200,10/15/2020,10/15/2020,JE-21-0061,LUX-PRPD-101520-LUX-PRPD-101520,D108,HJ,100295.67,,350082.56
6200,10/15/2020,10/15/2020,JE-21-0061,LUX-PRPD-101520-LUX-PRPD-101520,D108,HJ,18180.48,,368263.04
6200,10/31/2020,10/31/2020,202010,Adj to reallocate Salaries FICA and benefits from GM3 - ACY2 to G-BL-To reallocate GM3 - ACY2 Expense,D108,HJ,,13017.23,355245.81
6200,10/31/2020,10/31/2020,202010,Adj to reallocate Salaries FICA and benefits from GM3 - ACY2 to G-BL-To reallocate GM3 - ACY2 Expense,D108,HJ,13017.23,,368263.04
6200,10/31/2020,10/31/2020,JE-21-0062,LUX-PRPD-103120-LUX-PRPD-103120,D108,HJ,105980.39,,474243.43
6200,10/31/2020,10/31/2020,JE-21-0062,LUX-PRPD-103120-LUX-PRPD-103120,D108,HJ,18180.48,,492423.91
6200,11/12/2020,11/12/2020,JE-21-0089,LUX-PRPD-111520-LUX-PRPD-101520,D108,HJ,104551.71,,596975.62
6200,11/12/2020,11/12/2020,JE-21-0089,LUX-PRPD-111520-LUX-PRPD-101520,D108,HJ,18180.48,,615156.1
6200,11/27/2020,11/27/2020,JE-21-0091,LUX-PRPD-113020-LUX-PRPD-113020,D108,HJ,104551.71,,719707.81
6200,11/27/2020,11/27/2020,JE-21-0091,LUX-PRPD-113020-LUX-PRPD-113020,D108,HJ,18180.48,,737888.29
6200,11/30/2020,11/30/2020,202011,Adj to reallocate Salaries FICA and benefits from GM3 - ACY2 to G-BL-To reallocate GM3 - ACY2 Expense,D108,HJ,,18441.94,719446.35
6200,11/30/2020,11/30/2020,202011,Adj to reallocate Salaries FICA and benefits from GM3 - ACY2 to G-BL-To reallocate GM3 - ACY2 Expense,D108,HJ,18441.94,,737888.29
6200,12/15/2020,12/15/2020,JE-21-0112,LUX-PRPD-121520-LUX-PRPD-121520,D108,HJ,103108.03,,840996.32
6200,12/15/2020,12/15/2020,JE-21-0112,LUX-PRPD-121520-LUX-PRPD-121520,D108,HJ,18180.48,,859176.8
6200,12/31/2020,12/31/2020,JE-21-0113,LUX-PRPD-123120-LUX-PRPD-123120,D108,HJ,103138.03,,962314.83
6200,12/31/2020,12/31/2020,JE-21-0113,LUX-PRPD-123120-LUX-PRPD-123120,D108,HJ,18180.48,,980495.31
6200,1/15/2021,1/15/2021,JE-21-0145,LUX PayrollLUX-PRPPD-01152021-LUX-PRPD-01152021,D108,HJ,100115.21,,1080610.52
6200,1/15/2021,1/15/2021,JE-21-0145,LUX PayrollLUX-PRPPD-01152021-LUX-PRPD-01152021,D108,HJ,17365.54,,1097976.06
6200,1/31/2021,1/31/2021,JE-21-0151,LUX PRPD- 013121-LUX-PRPD-013121,D108,HJ,97873.51,,1195849.57
6200,1/31/2021,1/31/2021,JE-21-0151,LUX PRPD- 013121-LUX-PRPD-013121,D108,HJ,17181.03,,1213030.6
6200,2/15/2021,2/15/2021,JE-21-0169,LUX PRPD- 021521-LUX-PRPD-02152021,D108,HJ,99349.09,,1312379.69
6200,2/15/2021,2/15/2021,JE-21-0169,LUX PRPD- 021521-LUX-PRPD-02152021,D108,HJ,17181.03,,1329560.72
6200,2/28/2021,2/28/2021,JE-21-0175,LUX PRPD -02282021-LUX-PRPD-022821,D108,HJ,100024.98,,1429585.7
6200,2/28/2021,2/28/2021,JE-21-0175,LUX PRPD -02282021-LUX-PRPD-022821,D108,HJ,17181.03,,1446766.73
6200,3/12/2021,3/12/2021,JE-21-0187,LUX Payroll -PRPD 031521,D108,HJ,98686.53,,1545453.26
6200,3/12/2021,3/12/2021,JE-21-0187,LUX Payroll -PRPD 031521,D108,HJ,17181.03,,1562634.29
6200,3/31/2021,3/31/2021,JE-21-0188,LUX Payroll- PRPD 03312021,D108,HJ,98686.53,,1661320.82
6200,3/31/2021,3/31/2021,JE-21-0188,LUX Payroll- PRPD 03312021,D108,HJ,16550.59,,1677871.41
6200,4/15/2021,4/15/2021,JE-21-0200,LUX PRPD -041521,D108,HJ,98506.07,,1776377.48
6200,4/15/2021,4/15/2021,JE-21-0200,LUX PR 20210415 REV &CORR,D108,HJ,,98506.07,1677871.41
6200,4/15/2021,4/15/2021,JE-21-0200,LUX PR 20210415 REV &CORR,D108,HJ,98506.07,,1776377.48
6200,4/15/2021,4/15/2021,JE-21-0200,LUX PRPD -041521,D108,HJ,16181.58,,1792559.06
6200,4/15/2021,4/15/2021,JE-21-0200,LUX PR 20210415 REV &CORR,D108,HJ,,16181.58,1776377.48
6200,4/15/2021,4/15/2021,JE-21-0200,LUX PR 20210415 REV &CORR,D108,HJ,16181.58,,1792559.06
6200,4/30/2021,4/30/2021,JE-21-0204,LUX Payroll 4-30-2021,D108,HJ,97709,,1890268.06
6200,4/30/2021,4/30/2021,JE-21-0204,PR LUX 20210430,D108,HJ,,97709,1792559.06
6200,4/30/2021,4/30/2021,JE-21-0204,PR LUX 20210430,D108,HJ,97709,,1890268.06
6200,4/30/2021,4/30/2021,JE-21-0204,LUX Payroll 4-30-2021,D108,HJ,16181.58,,1906449.64
6200,4/30/2021,4/30/2021,JE-21-0204,PR LUX 20210430,D108,HJ,,16181.58,1890268.06
6200,4/30/2021,4/30/2021,JE-21-0204,PR LUX 20210430,D108,HJ,16181.58,,1906449.64
6200,5/13/2021,5/13/2021,JE-21-0226,LUX Payroll- PRPD 05152021,D108,HJ,97709,,2004158.64
6200,5/13/2021,5/13/2021,JE-21-0226,LUX Payroll- PRPD 05152021,D108,HJ,16181.58,,2020340.22
6200,5/27/2021,5/27/2021,JE-21-0227,LUX PAyroll - PRPD 05312021,D108,HJ,96641.24,,2116981.46
6200,5/27/2021,5/27/2021,JE-21-0227,LUX PAyroll - PRPD 05312021,D108,HJ,16181.58,,2133163.04
6200,6/14/2021,6/14/2021,JE-21-0238,PRPD 06152021 LUX,D108,HJ,95753.94,,2228916.98
6200,6/14/2021,6/14/2021,JE-21-0238,PRPD 06152021 LUX,D108,HJ,16181.58,,2245098.56
6200,6/30/2021,6/30/2021,JE-21-0245,LUX PR-PD 20210630,D108,HJ,44021.2,,2289119.76
6200,6/30/2021,6/30/2021,JE-21-0245,LUX PR-PD 20210630,D108,HJ,8928.56,,2298048.32
6200, Totals for 6200 - AmeriCorps Saga Fellow Stipend,,,,,,2716314.54,418266.22,2298048.32
6210,6210 - AmeriCorps PR Taxes (Balance forward As of 07/01/2020) ,,,,,,,,0
6210,8/15/2020,8/15/2020,LUX-PRPD-081520,LUX-IMPORT PAYROLL-Import Payroll,D107,HJ,,1.25,-1.25
6210,8/15/2020,8/15/2020,LUX-PRPD-081520,LUX-IMPORT PAYROLL-Import Payroll,D107,HJ,,1.3,-2.55
6210,8/15/2020,8/15/2020,LUX-PRPD-081520,LUX-IMPORT PAYROLL-Import Payroll,D107,HJ,,15.4,-17.95
6210,8/15/2020,8/15/2020,LUX-PRPD-081520,LUX-IMPORT PAYROLL-CORSEY SAMANTHA RENEE,D108,HJ,2.86,,-15.09
6210,8/15/2020,8/15/2020,LUX-PRPD-081520,LUX-IMPORT PAYROLL-CORSEY SAMANTHA RENEE,D108,HJ,5.51,,-9.58
6210,8/15/2020,8/15/2020,LUX-PRPD-081520,LUX-IMPORT PAYROLL-CORSEY SAMANTHA RENEE,D108,HJ,23.54,,13.96
6210,8/15/2020,8/15/2020,LUX-PRPD-081520,LUX-IMPORT PAYROLL-DAILY JAMES L,D108,HJ,14.49,,28.45
6210,8/15/2020,8/15/2020,LUX-PRPD-081520,LUX-IMPORT PAYROLL-DAILY JAMES L,D108,HJ,61.97,,90.42
6210,8/15/2020,8/15/2020,LUX-PRPD-081520,LUX-IMPORT PAYROLL-DOYAL JAMI D,D108,HJ,14.49,,104.91
6210,8/15/2020,8/15/2020,LUX-PRPD-081520,LUX-IMPORT PAYROLL-DOYAL JAMI D,D108,HJ,61.97,,166.88
6210,8/15/2020,8/15/2020,LUX-PRPD-081520,LUX-IMPORT PAYROLL-GIRONA MERCEDES MAE,D108,HJ,6.69,,173.57
6210,8/15/2020,8/15/2020,LUX-PRPD-081520,LUX-IMPORT PAYROLL-GIRONA MERCEDES MAE,D108,HJ,28.6,,202.17
6210,8/15/2020,8/15/2020,LUX-PRPD-081520,LUX-IMPORT PAYROLL-GREEN TAYLOR,D108,HJ,6.66,,208.83
6210,8/15/2020,8/15/2020,LUX-PRPD-081520,LUX-IMPORT PAYROLL-GREEN TAYLOR,D108,HJ,28.49,,237.32
6210,8/15/2020,8/15/2020,LUX-PRPD-081520,LUX-IMPORT PAYROLL-HABENSTREIT LILY,D108,HJ,6.49,,243.81
6210,8/15/2020,8/15/2020,LUX-PRPD-081520,LUX-IMPORT PAYROLL-HABENSTREIT LILY,D108,HJ,27.75,,271.56
6210,8/15/2020,8/15/2020,LUX-PRPD-081520,LUX-IMPORT PAYROLL-HAMMER CAROLINE,D108,HJ,2.86,,274.42
6210,8/15/2020,8/15/2020,LUX-PRPD-081520,LUX-IMPORT PAYROLL-HAMMER CAROLINE,D108,HJ,6.69,,281.11
6210,8/15/2020,8/15/2020,LUX-PRPD-081520,LUX-IMPORT PAYROLL-HAMMER CAROLINE,D108,HJ,28.6,,309.71
6210,8/15/2020,8/15/2020,LUX-PRPD-081520,LUX-IMPORT PAYROLL-KITTUR KIRAN,D108,HJ,6.69,,316.4
6210,8/15/2020,8/15/2020,LUX-PRPD-081520,LUX-IMPORT PAYROLL-KITTUR KIRAN,D108,HJ,28.6,,345
6210,8/15/2020,8/15/2020,LUX-PRPD-081520,LUX-IMPORT PAYROLL-MARGONO YULIN,D108,HJ,6.69,,351.69
6210,8/15/2020,8/15/2020,LUX-PRPD-081520,LUX-IMPORT PAYROLL-MARGONO YULIN,D108,HJ,28.6,,380.29
6210,8/15/2020,8/15/2020,LUX-PRPD-081520,LUX-IMPORT PAYROLL-MAXWELL JENNEE,D108,HJ,14.5,,394.79
6210,8/15/2020,8/15/2020,LUX-PRPD-081520,LUX-IMPORT PAYROLL-MAXWELL JENNEE,D108,HJ,62,,456.79
6210,8/15/2020,8/15/2020,LUX-PRPD-081520,LUX-IMPORT PAYROLL-MENSAH NADINE,D108,HJ,14.32,,471.11
6210,8/15/2020,8/15/2020,LUX-PRPD-081520,LUX-IMPORT PAYROLL-MENSAH NADINE,D108,HJ,61.22,,532.33
6210,8/15/2020,8/15/2020,LUX-PRPD-081520,LUX-IMPORT PAYROLL-SUSSMAN LAYTON,D108,HJ,2.86,,535.19
6210,8/15/2020,8/15/2020,LUX-PRPD-081520,LUX-IMPORT PAYROLL-SUSSMAN LAYTON,D108,HJ,5.57,,540.76
6210,8/15/2020,8/15/2020,LUX-PRPD-081520,LUX-IMPORT PAYROLL-SUSSMAN LAYTON,D108,HJ,23.83,,564.59
6210,8/15/2020,8/15/2020,LUX-PRPD-081520,LUX-IMPORT PAYROLL-UY ERICA,D108,HJ,15.87,,580.46
6210,8/15/2020,8/15/2020,LUX-PRPD-081520,LUX-IMPORT PAYROLL-UY ERICA,D108,HJ,67.87,,648.33
6210,8/15/2020,8/15/2020,LUX-PRPD-081520,LUX-IMPORT PAYROLL-VIRADIYA ASHINI,D108,HJ,6.69,,655.02
6210,8/15/2020,8/15/2020,LUX-PRPD-081520,LUX-IMPORT PAYROLL-VIRADIYA ASHINI,D108,HJ,28.6,,683.62
6210,8/15/2020,8/15/2020,LUX-PRPD-081520,LUX-IMPORT PAYROLL-WHITAKER ALEXIS,D108,HJ,14.49,,698.11
6210,8/15/2020,8/15/2020,LUX-PRPD-081520,LUX-IMPORT PAYROLL-WHITAKER ALEXIS,D108,HJ,61.97,,760.08
6210,8/15/2020,8/15/2020,LUX-PRPD-081520,LUX-IMPORT PAYROLL-ZEMBA TARAI,D108,HJ,6.79,,766.87
6210,8/15/2020,8/15/2020,LUX-PRPD-081520,LUX-IMPORT PAYROLL-ZEMBA TARAI,D108,HJ,14.73,,781.6
6210,8/15/2020,8/15/2020,LUX-PRPD-081520,LUX-IMPORT PAYROLL-ZEMBA TARAI,D108,HJ,64.71,,846.31
6210,8/31/2020,8/31/2020,LUX-PRPD-083120,LUX-PRPD-083120 -Payroll-FICA CHI,D108,HJ,7554.35,,8400.66
6210,8/31/2020,8/31/2020,LUX-PRPD-083120,LUX-PRPD-083120 -Payroll-FICA NYC,D108,HJ,85.61,,8486.27
6210,8/31/2020,8/31/2020,LUX-PRPD-083120,LUX-PRPD-083120 -Payroll-FICA DC,D108,HJ,1398.23,,9884.5
6210,9/15/2020,9/15/2020,LUX-PRPD-091520,LUX-PRPD-091520-LUX-PRPD-091520 -Payroll,D108,HJ,7502.28,,17386.78
6210,9/15/2020,9/15/2020,LUX-PRPD-091520,LUX-PRPD-091520-LUX-PRPD-091520 -Payroll,D108,HJ,1450.82,,18837.6
6210,9/30/2020,9/30/2020,LUX-PRPD-093020,LUX-PRPD-093020-Payroll,D108,HJ,7398.22,,26235.82
6210,9/30/2020,9/30/2020,LUX-PRPD-093020,LUX-PRPD-093020-Payroll,D108,HJ,1365.61,,27601.43
6210,10/15/2020,10/15/2020,JE-21-0061,LUX-PRPD-101520-LUX-PRPD-101520,D108,HJ,7301.31,,34902.74
6210,10/15/2020,10/15/2020,JE-21-0061,LUX-PRPD-101520-LUX-PRPD-101520,D108,HJ,25.39,,34928.13
6210,10/15/2020,10/15/2020,JE-21-0061,LUX-PRPD-101520-LUX-PRPD-101520,D108,HJ,1365.61,,36293.74
6210,10/31/2020,10/31/2020,JE-21-0062,LUX-PRPD-103120-LUX-PRPD-103120,D108,HJ,7713.89,,44007.63
6210,10/31/2020,10/31/2020,JE-21-0062,LUX-PRPD-103120-LUX-PRPD-103120,D108,HJ,25.39,,44033.02
6210,10/31/2020,10/31/2020,JE-21-0062,LUX-PRPD-103120-LUX-PRPD-103120,D108,HJ,1365.61,,45398.63
6210,11/12/2020,11/12/2020,JE-21-0089,LUX-PRPD-111520-LUX-PRPD-101520,D108,HJ,7705.71,,53104.34
6210,11/12/2020,11/12/2020,JE-21-0089,LUX-PRPD-111520-LUX-PRPD-101520,D108,HJ,25.39,,53129.73
6210,11/12/2020,11/12/2020,JE-21-0089,LUX-PRPD-111520-LUX-PRPD-101520,D108,HJ,1365.61,,54495.34
6210,11/27/2020,11/27/2020,JE-21-0091,LUX-PRPD-113020-LUX-PRPD-113020,D108,HJ,7647.62,,62142.96
6210,11/27/2020,11/27/2020,JE-21-0091,LUX-PRPD-113020-LUX-PRPD-113020,D108,HJ,25.39,,62168.35
6210,11/27/2020,11/27/2020,JE-21-0091,LUX-PRPD-113020-LUX-PRPD-113020,D108,HJ,1365.61,,63533.96
6210,12/15/2020,12/15/2020,JE-21-0112,LUX-PRPD-121520-LUX-PRPD-121520,D108,HJ,1.43,,63535.39
6210,12/15/2020,12/15/2020,JE-21-0112,LUX-PRPD-121520-LUX-PRPD-121520,D108,HJ,7509.33,,71044.72
6210,12/15/2020,12/15/2020,JE-21-0112,LUX-PRPD-121520-LUX-PRPD-121520,D108,HJ,35.31,,71080.03
6210,12/15/2020,12/15/2020,JE-21-0112,LUX-PRPD-121520-LUX-PRPD-121520,D108,HJ,1365.61,,72445.64
6210,12/31/2020,12/31/2020,JE-21-0113,LUX-PRPD-123120-LUX-PRPD-123120,D108,HJ,1.43,,72447.07
6210,12/31/2020,12/31/2020,JE-21-0113,LUX-PRPD-123120-LUX-PRPD-123120,D108,HJ,7548.28,,79995.35
6210,12/31/2020,12/31/2020,JE-21-0113,LUX-PRPD-123120-LUX-PRPD-123120,D108,HJ,35.31,,80030.66
6210,12/31/2020,12/31/2020,JE-21-0113,LUX-PRPD-123120-LUX-PRPD-123120,D108,HJ,1365.61,,81396.27
6210,1/15/2021,1/15/2021,JE-21-0145,LUX PayrollLUX-PRPPD-01152021-LUX-PRPD-01152021,D108,HJ,1.43,,81397.7
6210,1/15/2021,1/15/2021,JE-21-0145,LUX PayrollLUX-PRPPD-01152021-LUX-PRPD-01152021,D108,HJ,7646.42,,89044.12
6210,1/15/2021,1/15/2021,JE-21-0145,LUX PayrollLUX-PRPPD-01152021-LUX-PRPD-01152021,D108,HJ,30.25,,89074.37
6210,1/15/2021,1/15/2021,JE-21-0145,LUX PayrollLUX-PRPPD-01152021-LUX-PRPD-01152021,D108,HJ,1309.51,,90383.88
6210,1/31/2021,1/31/2021,JE-21-0151,LUX PRPD- 013121-LUX-PRPD-013121,D108,HJ,1.43,,90385.31
6210,1/31/2021,1/31/2021,JE-21-0151,LUX PRPD- 013121-LUX-PRPD-013121,D108,HJ,7300.83,,97686.14
6210,1/31/2021,1/31/2021,JE-21-0151,LUX PRPD- 013121-LUX-PRPD-013121,D108,HJ,29.11,,97715.25
6210,1/31/2021,1/31/2021,JE-21-0151,LUX PRPD- 013121-LUX-PRPD-013121,D108,HJ,1295.39,,99010.64
6210,2/15/2021,2/15/2021,JE-21-0169,LUX PRPD- 021521-LUX-PRPD-02152021,D108,HJ,1.43,,99012.07
6210,2/15/2021,2/15/2021,JE-21-0169,LUX PRPD- 021521-LUX-PRPD-02152021,D108,HJ,7277.28,,106289.35
6210,2/15/2021,2/15/2021,JE-21-0169,LUX PRPD- 021521-LUX-PRPD-02152021,D108,HJ,29.11,,106318.46
6210,2/15/2021,2/15/2021,JE-21-0169,LUX PRPD- 021521-LUX-PRPD-02152021,D108,HJ,1295.39,,107613.85
6210,2/28/2021,2/28/2021,JE-21-0175,LUX PRPD -02282021-LUX-PRPD-022821,D108,HJ,1.43,,107615.28
6210,2/28/2021,2/28/2021,JE-21-0175,LUX PRPD -02282021-LUX-PRPD-022821,D108,HJ,7430.46,,115045.74
6210,2/28/2021,2/28/2021,JE-21-0175,LUX PRPD -02282021-LUX-PRPD-022821,D108,HJ,29.11,,115074.85
6210,2/28/2021,2/28/2021,JE-21-0175,LUX PRPD -02282021-LUX-PRPD-022821,D108,HJ,1295.39,,116370.24
6210,3/12/2021,3/12/2021,JE-21-0187,LUX Payroll -PRPD 031521,D108,HJ,1.43,,116371.67
6210,3/12/2021,3/12/2021,JE-21-0187,LUX Payroll -PRPD 031521,D108,HJ,7316.67,,123688.34
6210,3/12/2021,3/12/2021,JE-21-0187,LUX Payroll -PRPD 031521,D108,HJ,29.11,,123717.45
6210,3/12/2021,3/12/2021,JE-21-0187,LUX Payroll -PRPD 031521,D108,HJ,1295.39,,125012.84
6210,3/31/2021,3/31/2021,JE-21-0188,LUX Payroll- PRPD 03312021,D108,HJ,1.43,,125014.27
6210,3/31/2021,3/31/2021,JE-21-0188,LUX Payroll- PRPD 03312021,D108,HJ,7326.53,,132340.8
6210,3/31/2021,3/31/2021,JE-21-0188,LUX Payroll- PRPD 03312021,D108,HJ,29.11,,132369.91
6210,3/31/2021,3/31/2021,JE-21-0188,LUX Payroll- PRPD 03312021,D108,HJ,1247.16,,133617.07
6210,4/12/2021,4/12/2021,ADP,ADP state UI filings and penalties April 2021,D104,HJ,69.62,,133686.69
6210,4/12/2021,4/12/2021,ADP,ADP state UI filings and penalties April 2021,D104,HJ,225.24,,133911.93
6210,4/12/2021,4/12/2021,ADP,ADP state UI filings and penalties April 2021,D104,HJ,69.62,,133981.55
6210,4/12/2021,4/12/2021,ADP,ADP state UI filings and penalties April 2021,D104,HJ,45.04,,134026.59
6210,4/15/2021,4/15/2021,JE-21-0200,LUX PRPD -041521,D108,HJ,1.43,,134028.02
6210,4/15/2021,4/15/2021,JE-21-0200,LUX PRPD -041521,D108,HJ,7304.46,,141332.48
6210,4/15/2021,4/15/2021,JE-21-0200,LUX PR 20210415 REV &CORR,D108,HJ,,1.43,141331.05
6210,4/15/2021,4/15/2021,JE-21-0200,LUX PR 20210415 REV &CORR,D108,HJ,1.43,,141332.48
6210,4/15/2021,4/15/2021,JE-21-0200,LUX PR 20210415 REV &CORR,D108,HJ,,7304.46,134028.02
6210,4/15/2021,4/15/2021,JE-21-0200,LUX PR 20210415 REV &CORR,D108,HJ,7304.46,,141332.48
6210,4/15/2021,4/15/2021,JE-21-0200,LUX PRPD -041521,D108,HJ,22.32,,141354.8
6210,4/15/2021,4/15/2021,JE-21-0200,LUX PRPD -041521,D108,HJ,1218.93,,142573.73
6210,4/15/2021,4/15/2021,JE-21-0200,LUX PR 20210415 REV &CORR,D108,HJ,,22.32,142551.41
6210,4/15/2021,4/15/2021,JE-21-0200,LUX PR 20210415 REV &CORR,D108,HJ,22.32,,142573.73
6210,4/15/2021,4/15/2021,JE-21-0200,LUX PR 20210415 REV &CORR,D108,HJ,,1218.93,141354.8
6210,4/15/2021,4/15/2021,JE-21-0200,LUX PR 20210415 REV &CORR,D108,HJ,1218.93,,142573.73
6210,4/23/2021,4/23/2021,ADP,ADP state UI filings and penalties April 2021,D104,HJ,33,,142606.73
6210,4/23/2021,4/23/2021,ADP,ADP state UI filings and penalties April 2021,D104,HJ,123.93,,142730.66
6210,4/23/2021,4/23/2021,ADP,ADP state UI filings and penalties April 2021,D104,HJ,165.24,,142895.9
6210,4/23/2021,4/23/2021,ADP,ADP state UI filings and penalties April 2021,D104,HJ,214.86,,143110.76
6210,4/23/2021,4/23/2021,ADP,ADP state UI filings and penalties April 2021,D104,HJ,106.77,,143217.53
6210,4/23/2021,4/23/2021,ADP,ADP state UI filings and penalties April 2021,D104,HJ,400.95,,143618.48
6210,4/23/2021,4/23/2021,ADP,ADP state UI filings and penalties April 2021,D104,HJ,534.6,,144153.08
6210,4/23/2021,4/23/2021,ADP,ADP state UI filings and penalties April 2021,D104,HJ,695.13,,144848.21
6210,4/23/2021,4/23/2021,ADP,ADP state UI filings and penalties April 2021,D104,HJ,33,,144881.21
6210,4/23/2021,4/23/2021,ADP,ADP state UI filings and penalties April 2021,D104,HJ,123.93,,145005.14
6210,4/23/2021,4/23/2021,ADP,ADP state UI filings and penalties April 2021,D104,HJ,165.24,,145170.38
6210,4/23/2021,4/23/2021,ADP,ADP state UI filings and penalties April 2021,D104,HJ,214.86,,145385.24
6210,4/23/2021,4/23/2021,ADP,ADP state UI filings and penalties April 2021,D104,HJ,18.6,,145403.84
6210,4/23/2021,4/23/2021,ADP,ADP state UI filings and penalties April 2021,D104,HJ,21.35,,145425.19
6210,4/23/2021,4/23/2021,ADP,ADP state UI filings and penalties April 2021,D104,HJ,80.19,,145505.38
6210,4/23/2021,4/23/2021,ADP,ADP state UI filings and penalties April 2021,D104,HJ,106.92,,145612.3
6210,4/23/2021,4/23/2021,ADP,ADP state UI filings and penalties April 2021,D104,HJ,139.03,,145751.33
6210,4/27/2021,4/27/2021,ADP,ADP state UI filings and penalties April 2021,D104,HJ,26.86,,145778.19
6210,4/27/2021,4/27/2021,ADP,ADP state UI filings and penalties April 2021,D104,HJ,55.08,,145833.27
6210,4/27/2021,4/27/2021,ADP,ADP state UI filings and penalties April 2021,D104,HJ,23,,145856.27
6210,4/27/2021,4/27/2021,ADP,ADP state UI filings and penalties April 2021,D104,HJ,85,,145941.27
6210,4/27/2021,4/27/2021,ADP,ADP state UI filings and penalties April 2021,D104,HJ,86.9,,146028.17
6210,4/27/2021,4/27/2021,ADP,ADP state UI filings and penalties April 2021,D104,HJ,178.2,,146206.37
6210,4/27/2021,4/27/2021,ADP,ADP state UI filings and penalties April 2021,D104,HJ,26.86,,146233.23
6210,4/27/2021,4/27/2021,ADP,ADP state UI filings and penalties April 2021,D104,HJ,55.08,,146288.31
6210,4/27/2021,4/27/2021,ADP,ADP state UI filings and penalties April 2021,D104,HJ,17.38,,146305.69
6210,4/27/2021,4/27/2021,ADP,ADP state UI filings and penalties April 2021,D104,HJ,35.64,,146341.33
6210,4/30/2021,4/30/2021,JE-21-0204,LUX Payroll 4-30-2021,D108,HJ,1.43,,146342.76
6210,4/30/2021,4/30/2021,JE-21-0204,LUX Payroll 4-30-2021,D108,HJ,7256.15,,153598.91
6210,4/30/2021,4/30/2021,JE-21-0204,PR LUX 20210430,D108,HJ,,1.43,153597.48
6210,4/30/2021,4/30/2021,JE-21-0204,PR LUX 20210430,D108,HJ,1.43,,153598.91
6210,4/30/2021,4/30/2021,JE-21-0204,PR LUX 20210430,D108,HJ,,7256.15,146342.76
6210,4/30/2021,4/30/2021,JE-21-0204,PR LUX 20210430,D108,HJ,7256.15,,153598.91
6210,4/30/2021,4/30/2021,JE-21-0204,LUX Payroll 4-30-2021,D108,HJ,22.32,,153621.23
6210,4/30/2021,4/30/2021,JE-21-0204,LUX Payroll 4-30-2021,D108,HJ,1218.93,,154840.16
6210,4/30/2021,4/30/2021,JE-21-0204,PR LUX 20210430,D108,HJ,,22.32,154817.84
6210,4/30/2021,4/30/2021,JE-21-0204,PR LUX 20210430,D108,HJ,22.32,,154840.16
6210,4/30/2021,4/30/2021,JE-21-0204,PR LUX 20210430,D108,HJ,,1218.93,153621.23
6210,4/30/2021,4/30/2021,JE-21-0204,PR LUX 20210430,D108,HJ,1218.93,,154840.16
6210,5/3/2021,5/3/2021,ADP,ADP state UI filings and penatlies May 2021,D104,HJ,60.52,,154900.68
6210,5/3/2021,5/3/2021,ADP,ADP state UI filings and penatlies May 2021,D104,HJ,195.8,,155096.48
6210,5/3/2021,5/3/2021,ADP,ADP state UI filings and penatlies May 2021,D104,HJ,60.52,,155157
6210,5/3/2021,5/3/2021,ADP,ADP state UI filings and penatlies May 2021,D104,HJ,39.16,,155196.16
6210,5/12/2021,5/12/2021,ADP,ADP state UI filings and penatlies May 2021,D104,HJ,44.29,,155240.45
6210,5/12/2021,5/12/2021,ADP,ADP state UI filings and penatlies May 2021,D104,HJ,143.29,,155383.74
6210,5/12/2021,5/12/2021,ADP,ADP state UI filings and penatlies May 2021,D104,HJ,44.29,,155428.03
6210,5/12/2021,5/12/2021,ADP,ADP state UI filings and penatlies May 2021,D104,HJ,28.65,,155456.68
6210,5/13/2021,5/13/2021,JE-21-0226,LUX Payroll- PRPD 05152021,D108,HJ,1.43,,155458.11
6210,5/13/2021,5/13/2021,JE-21-0226,LUX Payroll- PRPD 05152021,D108,HJ,7268.35,,162726.46
6210,5/13/2021,5/13/2021,JE-21-0226,LUX Payroll- PRPD 05152021,D108,HJ,22.32,,162748.78
6210,5/13/2021,5/13/2021,JE-21-0226,LUX Payroll- PRPD 05152021,D108,HJ,1218.93,,163967.71
6210,5/27/2021,5/27/2021,JE-21-0227,LUX PAyroll - PRPD 05312021,D108,HJ,1.43,,163969.14
6210,5/27/2021,5/27/2021,JE-21-0227,LUX PAyroll - PRPD 05312021,D108,HJ,7200.87,,171170.01
6210,5/27/2021,5/27/2021,JE-21-0227,LUX PAyroll - PRPD 05312021,D108,HJ,22.32,,171192.33
6210,5/27/2021,5/27/2021,JE-21-0227,LUX PAyroll - PRPD 05312021,D108,HJ,1218.93,,172411.26
6210,6/2/2021,6/2/2021,ADP,ADP state UI filings and penalties June 2021,D104,HJ,18.6,,172429.86
6210,6/14/2021,6/14/2021,JE-21-0238,PRPD 06152021 LUX,D108,HJ,1.43,,172431.29
6210,6/14/2021,6/14/2021,JE-21-0238,PRPD 06152021 LUX,D108,HJ,7124.57,,179555.86
6210,6/14/2021,6/14/2021,JE-21-0238,PRPD 06152021 LUX,D108,HJ,22.32,,179578.18
6210,6/14/2021,6/14/2021,JE-21-0238,PRPD 06152021 LUX,D108,HJ,1218.93,,180797.11
6210,6/30/2021,6/30/2021,JE-21-0245,LUX PR-PD 20210630,D108,HJ,0.66,,180797.77
6210,6/30/2021,6/30/2021,JE-21-0245,LUX PR-PD 20210630,D108,HJ,3239.49,,184037.26
6210,6/30/2021,6/30/2021,JE-21-0245,LUX PR-PD 20210630,D108,HJ,12.31,,184049.57
6210,6/30/2021,6/30/2021,JE-21-0245,LUX PR-PD 20210630,D108,HJ,664.06,,184713.63
6210, Totals for 6210 - AmeriCorps PR Taxes,,,,,,201777.55,17063.92,184713.63
6220,6220 - Fellow Stipends (Balance forward As of 07/01/2020) ,,,,,,,,0
6220,9/8/2020,9/8/2020,20200908,Called back Kai English the Direct Deposit for a mistake PR-Called back Kai English the Direct Deposit for a mistake PR,D108,HJ,,874.75,-874.75
6220,9/14/2020,9/14/2020,HRKnowledge,ACH for Jeanette Croen's salary-ACH for Jeanette Croen's salary,D108,HJ,837.68,,-37.07
6220,9/24/2020,9/24/2020,20200924,Called back Kai English the Direct Deposit for a mistake PR-Called back Kai English the Direct Deposit for a mistake PR,D108,HJ,874.75,,837.68
6220, Totals for 6220 - Fellow Stipends,,,,,,1712.43,874.75,837.68
6270,6270 - AmeriCorps Fellows Workers Compensation (Balance forward As of 07/01/2020) ,,,,,,,,0
6270,8/15/2020,8/15/2020,LUX-PRPD-081520,LUX-IMPORT PAYROLL-Workers Comp,D108,HJ,21.08,,21.08
6270,8/31/2020,8/31/2020,LUX-PRPD-083120,LUX-PRPD-083120 -Payroll-Workers Comp Exp: Pay-by-pay,D107,HJ,211.04,,232.12
6270,9/15/2020,9/15/2020,LUX-PRPD-091520,LUX-PRPD-091520-LUX-PRPD-091520 -Payroll,D107,HJ,210.36,,442.48
6270,9/30/2020,9/30/2020,LUX-PRPD-093020,LUX-PRPD-093020-Payroll,D107,HJ,209.16,,651.64
6270,10/15/2020,10/15/2020,JE-21-0061,LUX-PRPD-101520-LUX-PRPD-101520,D107,HJ,207.19,,858.83
6270,10/31/2020,10/31/2020,20201031,To correct the function coding-To correct the function coding,D107,HJ,,1045.64,-186.81
6270,10/31/2020,10/31/2020,20201031,To correct the function coding-To correct the function coding,D107,HJ,1045.64,,858.83
6270,10/31/2020,10/31/2020,JE-21-0062,LUX-PRPD-103120-LUX-PRPD-103120,D107,HJ,207.89,,1066.72
6270,11/12/2020,11/12/2020,JE-21-0089,LUX-PRPD-111520-LUX-PRPD-101520,D107,HJ,211.81,,1278.53
6270,11/27/2020,11/27/2020,JE-21-0091,LUX-PRPD-113020-LUX-PRPD-113020,D107,HJ,209.85,,1488.38
6270,12/15/2020,12/15/2020,JE-21-0112,LUX-PRPD-121520-LUX-PRPD-121520,D107,HJ,215.87,,1704.25
6270,12/31/2020,12/31/2020,JE-21-0113,LUX-PRPD-123120-LUX-PRPD-123120,D107,HJ,215.45,,1919.7
6270,1/15/2021,1/15/2021,JE-21-0145,LUX PayrollLUX-PRPPD-01152021-LUX-PRPD-01152021,D107,HJ,278.46,,2198.16
6270,1/31/2021,1/31/2021,JE-21-0151,LUX PRPD- 013121-LUX-PRPD-013121,D107,HJ,578.09,,2776.25
6270,2/15/2021,2/15/2021,JE-21-0169,LUX PRPD- 021521-LUX-PRPD-02152021,D107,HJ,276.39,,3052.64
6270,2/28/2021,2/28/2021,JE-21-0175,LUX PRPD -02282021-LUX-PRPD-022821,D107,HJ,279.1,,3331.74
6270,3/12/2021,3/12/2021,JE-21-0187,LUX Payroll -PRPD 031521,D107,HJ,275.35,,3607.09
6270,3/31/2021,3/31/2021,JE-21-0188,LUX Payroll- PRPD 03312021,D107,HJ,272.51,,3879.6
6270,4/15/2021,4/15/2021,JE-21-0200,LUX PRPD -041521,D107,HJ,268.15,,4147.75
6270,4/15/2021,4/15/2021,JE-21-0200,LUX PR 20210415 REV &CORR,D107,HJ,,268.15,3879.6
6270,4/15/2021,4/15/2021,JE-21-0200,LUX PR 20210415 REV &CORR,D107,HJ,268.15,,4147.75
6270,4/30/2021,4/30/2021,JE-21-0204,LUX Payroll 4-30-2021,D107,HJ,265.92,,4413.67
6270,4/30/2021,4/30/2021,JE-21-0204,PR LUX 20210430,D107,HJ,,265.92,4147.75
6270,4/30/2021,4/30/2021,JE-21-0204,PR LUX 20210430,D107,HJ,265.92,,4413.67
6270,5/13/2021,5/13/2021,JE-21-0226,LUX Payroll- PRPD 05152021,D107,HJ,265.92,,4679.59
6270,5/27/2021,5/27/2021,JE-21-0227,LUX PAyroll - PRPD 05312021,D107,HJ,262.92,,4942.51
6270,6/14/2021,6/14/2021,JE-21-0238,PRPD 06152021 LUX,D107,HJ,260.44,,5202.95
6270,6/30/2021,6/30/2021,JE-21-0245,LUX PR-PD 20210630,D107,HJ,121.83,,5324.78
6270, Totals for 6270 - AmeriCorps Fellows Workers Compensation,,,,,,6904.49,1579.71,5324.78
6280,6280 - AmeriCorps Health Insurance (Balance forward As of 07/01/2020) ,,,,,,,,0
6280,7/1/2020,7/1/2020,BCBS -July,BCBS- July - BCBS Health Insurance-July -BCBS Health Insurance,D108,HJ,14617.64,,14617.64
6280,7/1/2020,7/1/2020,BCBS -July,BCBS- July - BCBS Health Insurance-July -BCBS Health Insurance,D108,HJ,3670.28,,18287.92
6280,7/1/2020,7/1/2020,BCBS -July,BCBS- July - BCBS Health Insurance-July -BCBS Health Insurance,D108,HJ,2081.72,,20369.64
6280,7/9/2020,7/9/2020,20200709,To Record TASC Credit For Fellows-To record TASC credit for fellows,D108,HJ,,1081.89,19287.75
6280,8/3/2020,8/3/2020,BCBS -August,BCBS - August Health Insurance-August -BCBS Health Insurance,D108,HJ,10408.6,,29696.35
6280,8/3/2020,8/3/2020,BCBS -August,BCBS - August Health Insurance-August -BCBS Health Insurance,D108,HJ,2629.42,,32325.77
6280,8/3/2020,8/3/2020,BCBS -August,BCBS - August Health Insurance-August -BCBS Health Insurance,D108,HJ,1040.86,,33366.63
6280,8/15/2020,8/15/2020,LUX-PRPD-081520,LUX-IMPORT PAYROLL-CORSEY SAMANTHA RENEE,D108,HJ,,65,33301.63
6280,8/15/2020,8/15/2020,LUX-PRPD-081520,LUX-IMPORT PAYROLL-SUSSMAN LAYTON,D108,HJ,,65,33236.63
6280,8/15/2020,8/15/2020,LUX-PRPD-081520,LUX-IMPORT PAYROLL-ZEMBA TARAI,D108,HJ,,65,33171.63
6280,8/31/2020,8/31/2020,LUX-PRPD-083120,LUX-PRPD-083120 -Payroll-HEALTH-CHICAGO,D108,HJ,,1236.9,31934.73
6280,8/31/2020,8/31/2020,LUX-PRPD-083120,LUX-PRPD-083120 -Payroll-HEALTH-DC,D108,HJ,,325,31609.73
6280,9/1/2020,9/1/2020,BCBS,BCBS - September 82L Invoices-BCBS - September 82L Invoices,D108,HJ,,10333.22,21276.51
6280,9/1/2020,9/1/2020,BCBS,BCBS - September 82L Invoices-BCBS - September 82L Invoices,D108,HJ,81.81,,21358.32
6280,9/10/2020,9/10/2020,BCBS,BCBS - September LUX Invoices-BCBS - September LUX Invoices,D108,HJ,14005.58,,35363.9
6280,9/10/2020,9/10/2020,BCBS,BCBS - September LUX Invoices-BCBS - September LUX Invoices,D108,HJ,1561.29,,36925.19
6280,9/15/2020,9/15/2020,LUX-PRPD-091520,LUX-PRPD-091520-LUX-PRPD-091520 -Payroll,D108,HJ,,1821.9,35103.29
6280,9/15/2020,9/15/2020,LUX-PRPD-091520,LUX-PRPD-091520-LUX-PRPD-091520 -Payroll,D108,HJ,,325,34778.29
6280,9/30/2020,9/30/2020,LUX-PRPD-093020,LUX-PRPD-093020-Payroll,D108,HJ,,2042.6,32735.69
6280,9/30/2020,9/30/2020,LUX-PRPD-093020,LUX-PRPD-093020-Payroll,D108,HJ,,260,32475.69
6280,10/1/2020,10/1/2020,BCBS,October BCBS Payment-BCBS - October BCBS,D108,HJ,,11986.2,20489.49
6280,10/1/2020,10/1/2020,BCBS,October BCBS Payment-BCBS - October BCBS,D108,HJ,,1561.29,18928.2
6280,10/15/2020,10/15/2020,JE-21-0061,LUX-PRPD-101520-LUX-PRPD-101520,D108,HJ,,1823.56,17104.64
6280,10/15/2020,10/15/2020,JE-21-0061,LUX-PRPD-101520-LUX-PRPD-101520,D108,HJ,,260,16844.64
6280,10/31/2020,10/31/2020,JE-21-0062,LUX-PRPD-103120-LUX-PRPD-103120,D108,HJ,,1821.78,15022.86
6280,10/31/2020,10/31/2020,JE-21-0062,LUX-PRPD-103120-LUX-PRPD-103120,D108,HJ,,260,14762.86
6280,11/2/2020,11/2/2020,BCBS,November BCBS Payment for October Americorp Portion-BCBS - November Payment,D108,HJ,11752.04,,26514.9
6280,11/2/2020,11/2/2020,BCBS,November BCBS Payment for October Americorp Portion-BCBS - November Payment,D108,HJ,4650.73,,31165.63
6280,11/5/2020,11/5/2020,BCBS,November BCBS Payments-BCBS - November Invoices,D108,HJ,3564.54,,34730.17
6280,11/12/2020,11/12/2020,JE-21-0089,LUX-PRPD-111520-LUX-PRPD-101520,D108,HJ,,1821.78,32908.39
6280,11/12/2020,11/12/2020,JE-21-0089,LUX-PRPD-111520-LUX-PRPD-101520,D108,HJ,,260,32648.39
6280,11/27/2020,11/27/2020,JE-21-0091,LUX-PRPD-113020-LUX-PRPD-113020,D108,HJ,,1755,30893.39
6280,11/27/2020,11/27/2020,JE-21-0091,LUX-PRPD-113020-LUX-PRPD-113020,D108,HJ,,260,30633.39
6280,12/1/2020,12/1/2020,BCBS,December BCBS Payment-BCBS - December BCBS,D108,HJ,4813.57,,35446.96
6280,12/15/2020,12/15/2020,JE-21-0112,LUX-PRPD-121520-LUX-PRPD-121520,D108,HJ,,1690,33756.96
6280,12/15/2020,12/15/2020,JE-21-0112,LUX-PRPD-121520-LUX-PRPD-121520,D108,HJ,,260,33496.96
6280,12/31/2020,12/31/2020,JE-21-0113,LUX-PRPD-123120-LUX-PRPD-123120,D108,HJ,,1690,31806.96
6280,12/31/2020,12/31/2020,JE-21-0113,LUX-PRPD-123120-LUX-PRPD-123120,D108,HJ,,260,31546.96
6280,1/4/2021,1/4/2021,BCBS,January 2021 BCBS Payment-BCBS - January 2021 BCBS,D108,HJ,11876.56,,43423.52
6280,1/15/2021,1/15/2021,JE-21-0145,LUX PayrollLUX-PRPPD-01152021-LUX-PRPD-01152021,D108,HJ,,1690,41733.52
6280,1/15/2021,1/15/2021,JE-21-0145,LUX PayrollLUX-PRPPD-01152021-LUX-PRPD-01152021,D108,HJ,,195,41538.52
6280,1/31/2021,1/31/2021,JE-21-0151,LUX PRPD- 013121-LUX-PRPD-013121,D108,HJ,,1625,39913.52
6280,1/31/2021,1/31/2021,JE-21-0151,LUX PRPD- 013121-LUX-PRPD-013121,D108,HJ,,195,39718.52
6280,2/1/2021,2/1/2021,BCBS,BCBS February Payment-BCBS - February 2021 BCBS,D108,HJ,6273.96,,45992.48
6280,2/15/2021,2/15/2021,JE-21-0169,LUX PRPD- 021521-LUX-PRPD-02152021,D108,HJ,,1625,44367.48
6280,2/15/2021,2/15/2021,JE-21-0169,LUX PRPD- 021521-LUX-PRPD-02152021,D108,HJ,,195,44172.48
6280,2/28/2021,2/28/2021,JE-21-0175,LUX PRPD -02282021-LUX-PRPD-022821,D108,HJ,,1696.92,42475.56
6280,2/28/2021,2/28/2021,JE-21-0175,LUX PRPD -02282021-LUX-PRPD-022821,D108,HJ,,195,42280.56
6280,3/3/2021,3/3/2021,BCBS,March 2021 BCBS payment,D108,HJ,6326.01,,48606.57
6280,3/12/2021,3/12/2021,JE-21-0187,LUX Payroll -PRPD 031521,D108,HJ,,1761.92,46844.65
6280,3/12/2021,3/12/2021,JE-21-0187,LUX Payroll -PRPD 031521,D108,HJ,,195,46649.65
6280,3/31/2021,3/31/2021,JE-21-0188,LUX Payroll- PRPD 03312021,D108,HJ,,1761.92,44887.73
6280,3/31/2021,3/31/2021,JE-21-0188,LUX Payroll- PRPD 03312021,D108,HJ,,195,44692.73
6280,4/2/2021,4/2/2021,BCBS,April 2021 BCBS Payment,D108,HJ,10067.4,,54760.13
6280,4/15/2021,4/15/2021,JE-21-0200,LUX PRPD -041521,D108,HJ,,1898.84,52861.29
6280,4/15/2021,4/15/2021,JE-21-0200,LUX PR 20210415 REV &CORR,D108,HJ,,1898.84,50962.45
6280,4/15/2021,4/15/2021,JE-21-0200,LUX PR 20210415 REV &CORR,D108,HJ,1898.84,,52861.29
6280,4/15/2021,4/15/2021,JE-21-0200,LUX PRPD -041521,D108,HJ,,195,52666.29
6280,4/15/2021,4/15/2021,JE-21-0200,LUX PR 20210415 REV &CORR,D108,HJ,,195,52471.29
6280,4/15/2021,4/15/2021,JE-21-0200,LUX PR 20210415 REV &CORR,D108,HJ,195,,52666.29
6280,4/30/2021,4/30/2021,JE-21-0204,LUX Payroll 4-30-2021,D108,HJ,,1833.84,50832.45
6280,4/30/2021,4/30/2021,JE-21-0204,PR LUX 20210430,D108,HJ,,1833.84,48998.61
6280,4/30/2021,4/30/2021,JE-21-0204,PR LUX 20210430,D108,HJ,1833.84,,50832.45
6280,4/30/2021,4/30/2021,JE-21-0204,LUX Payroll 4-30-2021,D108,HJ,,195,50637.45
6280,4/30/2021,4/30/2021,JE-21-0204,PR LUX 20210430,D108,HJ,,195,50442.45
6280,4/30/2021,4/30/2021,JE-21-0204,PR LUX 20210430,D108,HJ,195,,50637.45
6280,5/3/2021,5/3/2021,BCBS,BCBS MAy 2021 Payment,D108,HJ,8022.68,,58660.13
6280,5/13/2021,5/13/2021,JE-21-0226,LUX Payroll- PRPD 05152021,D108,HJ,,1833.84,56826.29
6280,5/13/2021,5/13/2021,JE-21-0226,LUX Payroll- PRPD 05152021,D108,HJ,,195,56631.29
6280,5/27/2021,5/27/2021,JE-21-0227,LUX PAyroll - PRPD 05312021,D108,HJ,,1768.84,54862.45
6280,5/27/2021,5/27/2021,JE-21-0227,LUX PAyroll - PRPD 05312021,D108,HJ,,195,54667.45
6280,6/1/2021,6/1/2021,BCBS,BCBS June 2021 Payment,D108,HJ,7809.4,,62476.85
6280,6/14/2021,6/14/2021,JE-21-0238,PRPD 06152021 LUX,D108,HJ,,1768.84,60708.01
6280,6/14/2021,6/14/2021,JE-21-0238,PRPD 06152021 LUX,D108,HJ,,195,60513.01
6280,6/30/2021,6/30/2021,JE-21-0245,LUX PR-PD 20210630,D108,HJ,,1631.92,58881.09
6280,6/30/2021,6/30/2021,JE-21-0245,LUX PR-PD 20210630,D108,HJ,,195,58686.09
6280, Totals for 6280 - AmeriCorps Health Insurance,,,,,,129376.77,70690.68,58686.09
6290,6290 - AmeriCorps Fellow Dental and Vision Insurance (Balance forward As of 07/01/2020) ,,,,,,,,0
6290,7/1/2020,7/1/2020,BCBS -July,BCBS- July - BCBS Health Insurance-July -BCBS Health Insurance,D108,HJ,1294.39,,1294.39
6290,7/1/2020,7/1/2020,BCBS -July,BCBS- July - BCBS Health Insurance-July -BCBS Health Insurance,D108,HJ,388.9,,1683.29
6290,7/1/2020,7/1/2020,BCBS -July,BCBS- July - BCBS Health Insurance-July -BCBS Health Insurance,D108,HJ,143.49,,1826.78
6290,7/2/2020,7/2/2020,1.94E+12,Blue 20/20 Vision Insurance -July Invoice-Blue 20/20 Vision Insurance -July Invoice,D108,HJ,109.42,,1936.2
6290,7/2/2020,7/2/2020,1.94E+12,Blue 20/20 Vision Insurance -July Invoice-Blue 20/20 Vision Insurance -July Invoice,D108,HJ,55.67,,1991.87
6290,7/2/2020,7/2/2020,1.94E+12,Blue 20/20 Vision Insurance -July Invoice-Blue 20/20 Vision Insurance -July Invoice,D108,HJ,26.88,,2018.75
6290,8/3/2020,8/3/2020,BCBS -August,BCBS - August Health Insurance-August -BCBS Health Insurance,D108,HJ,1064.78,,3083.53
6290,8/3/2020,8/3/2020,BCBS -August,BCBS - August Health Insurance-August -BCBS Health Insurance,D108,HJ,413.36,,3496.89
6290,8/3/2020,8/3/2020,BCBS -August,BCBS - August Health Insurance-August -BCBS Health Insurance,D108,HJ,47.83,,3544.72
6290,8/10/2020,8/10/2020,JE-21-0011,Blue 20/20 Vision Insurance - August Invoice-Blue 20/20 Vision Insurance -August Invoice,D108,HJ,20.55,,3565.27
6290,8/10/2020,8/10/2020,JE-21-0011,Blue 20/20 Vision Insurance - August Invoice-Blue 20/20 Vision Insurance -August Invoice,D108,HJ,66.48,,3631.75
6290,8/10/2020,8/10/2020,JE-21-0011,Blue 20/20 Vision Insurance - August Invoice-Blue 20/20 Vision Insurance -August Invoice,D108,HJ,20.55,,3652.3
6290,8/10/2020,8/10/2020,JE-21-0011,Blue 20/20 Vision Insurance - August Invoice-Blue 20/20 Vision Insurance -August Invoice,D108,HJ,13.29,,3665.59
6290,8/15/2020,8/15/2020,LUX-PRPD-081520,LUX-IMPORT PAYROLL-CORSEY SAMANTHA RENEE,D108,HJ,,1.78,3663.81
6290,8/15/2020,8/15/2020,LUX-PRPD-081520,LUX-IMPORT PAYROLL-CORSEY SAMANTHA RENEE,D108,HJ,,14.83,3648.98
6290,8/15/2020,8/15/2020,LUX-PRPD-081520,LUX-IMPORT PAYROLL-GREEN TAYLOR,D108,HJ,,1.78,3647.2
6290,8/15/2020,8/15/2020,LUX-PRPD-081520,LUX-IMPORT PAYROLL-HABENSTREIT LILY,D108,HJ,,1.78,3645.42
6290,8/15/2020,8/15/2020,LUX-PRPD-081520,LUX-IMPORT PAYROLL-HABENSTREIT LILY,D108,HJ,,11.96,3633.46
6290,8/15/2020,8/15/2020,LUX-PRPD-081520,LUX-IMPORT PAYROLL-MENSAH NADINE,D108,HJ,,11.96,3621.5
6290,8/15/2020,8/15/2020,LUX-PRPD-081520,LUX-IMPORT PAYROLL-SUSSMAN LAYTON,D108,HJ,,11.96,3609.54
6290,8/15/2020,8/15/2020,LUX-PRPD-081520,LUX-IMPORT PAYROLL-ZEMBA TARAI,D108,HJ,,1.78,3607.76
6290,8/15/2020,8/15/2020,LUX-PRPD-081520,LUX-IMPORT PAYROLL-ZEMBA TARAI,D108,HJ,,11.96,3595.8
6290,8/31/2020,8/31/2020,LUX-PRPD-083120,LUX-PRPD-083120 -Payroll-DENTAL-CHICAGO,D108,HJ,,250.93,3344.87
6290,8/31/2020,8/31/2020,LUX-PRPD-083120,LUX-PRPD-083120 -Payroll-VISION-CHICAGO,D108,HJ,,30.26,3314.61
6290,8/31/2020,8/31/2020,LUX-PRPD-083120,LUX-PRPD-083120 -Payroll-DENTAL-DC,D108,HJ,,74.63,3239.98
6290,8/31/2020,8/31/2020,LUX-PRPD-083120,LUX-PRPD-083120 -Payroll-VISION-DC,D108,HJ,,8.9,3231.08
6290,9/1/2020,9/1/2020,BCBS,BCBS - September 82L Invoices-BCBS - September 82L Invoices,D108,HJ,,615.53,2615.55
6290,9/1/2020,9/1/2020,BCBS,BCBS - September 82L Invoices-BCBS - September 82L Invoices,D108,HJ,112.88,,2728.43
6290,9/2/2020,9/2/2020,JE-21-0031,Blue 20/20 Vision Insurance - September Inv-Blue 20/20 Vision Insurance -September Invoice,D108,HJ,7.11,,2735.54
6290,9/2/2020,9/2/2020,JE-21-0031,Blue 20/20 Vision Insurance - September Inv-Blue 20/20 Vision Insurance -September Invoice,D108,HJ,35.55,,2771.09
6290,9/2/2020,9/2/2020,JE-21-0031,Blue 20/20 Vision Insurance - September Inv-Blue 20/20 Vision Insurance -September Invoice,D108,HJ,7.11,,2778.2
6290,9/10/2020,9/10/2020,BCBS,BCBS - September LUX Invoices-BCBS - September LUX Invoices,D108,HJ,1434.9,,4213.1
6290,9/10/2020,9/10/2020,BCBS,BCBS - September LUX Invoices-BCBS - September LUX Invoices,D108,HJ,143.49,,4356.59
6290,9/15/2020,9/15/2020,LUX-PRPD-091520,LUX-PRPD-091520-LUX-PRPD-091520 -Payroll,D108,HJ,,48.06,4308.53
6290,9/15/2020,9/15/2020,LUX-PRPD-091520,LUX-PRPD-091520-LUX-PRPD-091520 -Payroll,D108,HJ,,325.56,3982.97
6290,9/15/2020,9/15/2020,LUX-PRPD-091520,LUX-PRPD-091520-LUX-PRPD-091520 -Payroll,D108,HJ,,8.9,3974.07
6290,9/15/2020,9/15/2020,LUX-PRPD-091520,LUX-PRPD-091520-LUX-PRPD-091520 -Payroll,D108,HJ,,74.63,3899.44
6290,9/30/2020,9/30/2020,LUX-PRPD-093020,LUX-PRPD-093020-Payroll,D108,HJ,,55.18,3844.26
6290,9/30/2020,9/30/2020,LUX-PRPD-093020,LUX-PRPD-093020-Payroll,D108,HJ,,400.61,3443.65
6290,9/30/2020,9/30/2020,LUX-PRPD-093020,LUX-PRPD-093020-Payroll,D108,HJ,,7.12,3436.53
6290,9/30/2020,9/30/2020,LUX-PRPD-093020,LUX-PRPD-093020-Payroll,D108,HJ,,62.67,3373.86
6290,10/1/2020,10/1/2020,BCBS,October BCBS Payment-BCBS - October BCBS,D108,HJ,,856.46,2517.4
6290,10/1/2020,10/1/2020,BCBS,October BCBS Payment-BCBS - October BCBS,D108,HJ,,143.49,2373.91
6290,10/2/2020,10/2/2020,JE-21-0073,Blue 20/20 Vision Insurance-Blue 20/20 Vision Insurance -October Invoice,D108,HJ,191.97,,2565.88
6290,10/2/2020,10/2/2020,JE-21-0073,Blue 20/20 Vision Insurance-Credit,D108,HJ,,21.33,2544.55
6290,10/2/2020,10/2/2020,JE-21-0073,Blue 20/20 Vision Insurance-Blue 20/20 Vision Insurance -October Invoice,D108,HJ,21.33,,2565.88
6290,10/15/2020,10/15/2020,JE-21-0061,LUX-PRPD-101520-LUX-PRPD-101520,D108,HJ,,51.62,2514.26
6290,10/15/2020,10/15/2020,JE-21-0061,LUX-PRPD-101520-LUX-PRPD-101520,D108,HJ,,362.75,2151.51
6290,10/15/2020,10/15/2020,JE-21-0061,LUX-PRPD-101520-LUX-PRPD-101520,D108,HJ,,7.12,2144.39
6290,10/15/2020,10/15/2020,JE-21-0061,LUX-PRPD-101520-LUX-PRPD-101520,D108,HJ,,62.67,2081.72
6290,10/31/2020,10/31/2020,JE-21-0062,LUX-PRPD-103120-LUX-PRPD-103120,D108,HJ,,53.4,2028.32
6290,10/31/2020,10/31/2020,JE-21-0062,LUX-PRPD-103120-LUX-PRPD-103120,D108,HJ,,374.71,1653.61
6290,10/31/2020,10/31/2020,JE-21-0062,LUX-PRPD-103120-LUX-PRPD-103120,D108,HJ,,7.12,1646.49
6290,10/31/2020,10/31/2020,JE-21-0062,LUX-PRPD-103120-LUX-PRPD-103120,D108,HJ,,62.67,1583.82
6290,11/2/2020,11/2/2020,BCBS,November BCBS Payment for October Americorp Portion-BCBS - November Payment,D108,HJ,185.7,,1769.52
6290,11/2/2020,11/2/2020,BCBS,November BCBS Payment for October Americorp Portion-BCBS - November Payment,D108,HJ,144.63,,1914.15
6290,11/3/2020,11/3/2020,JE-21-0085,Blue 20/20 Vision Insurance November Inv 82L-Blue 20/20 Vision Insurance November Inv 82L,D108,HJ,7.11,,1921.26
6290,11/3/2020,11/3/2020,JE-21-0085,Blue 20/20 Vision Insurance November Inv 82L-Blue 20/20 Vision Insurance November Inv 82L,D108,HJ,7.11,,1928.37
6290,11/3/2020,11/3/2020,JE-21-0086,Blue 20/20 Vision Insurance November Inv LUX-Blue 20/20 Vision Insurance -November Inv LUX,D108,HJ,213.3,,2141.67
6290,11/3/2020,11/3/2020,JE-21-0086,Blue 20/20 Vision Insurance November Inv LUX-Blue 20/20 Vision Insurance -November Inv LUX,D108,HJ,28.44,,2170.11
6290,11/5/2020,11/5/2020,BCBS,November BCBS Payments-BCBS - November Invoices,D108,HJ,31992.87,,34162.98
6290,11/5/2020,11/5/2020,BCBS,November BCBS Payments-BCBS - November Invoices,D108,HJ,2326.61,,36489.59
6290,11/12/2020,11/12/2020,JE-21-0089,LUX-PRPD-111520-LUX-PRPD-101520,D108,HJ,,53.4,36436.19
6290,11/12/2020,11/12/2020,JE-21-0089,LUX-PRPD-111520-LUX-PRPD-101520,D108,HJ,,359.88,36076.31
6290,11/12/2020,11/12/2020,JE-21-0089,LUX-PRPD-111520-LUX-PRPD-101520,D108,HJ,,7.12,36069.19
6290,11/12/2020,11/12/2020,JE-21-0089,LUX-PRPD-111520-LUX-PRPD-101520,D108,HJ,,62.67,36006.52
6290,11/27/2020,11/27/2020,JE-21-0091,LUX-PRPD-113020-LUX-PRPD-113020,D108,HJ,,53.4,35953.12
6290,11/27/2020,11/27/2020,JE-21-0091,LUX-PRPD-113020-LUX-PRPD-113020,D108,HJ,,359.88,35593.24
6290,11/27/2020,11/27/2020,JE-21-0091,LUX-PRPD-113020-LUX-PRPD-113020,D108,HJ,,7.12,35586.12
6290,11/27/2020,11/27/2020,JE-21-0091,LUX-PRPD-113020-LUX-PRPD-113020,D108,HJ,,62.67,35523.45
6290,12/1/2020,12/1/2020,BCBS,December BCBS Payment-BCBS - December BCBS,D108,HJ,14091.24,,49614.69
6290,12/1/2020,12/1/2020,BCBS,December BCBS Payment-BCBS - December BCBS,D108,HJ,2326.61,,51941.3
6290,12/3/2020,12/3/2020,JE-21-0110,Blue 20/20 Vision Insurance - December Inv Lux-Blue 20/20 Vision Insurance -December Inv LUX,D108,HJ,362.61,,52303.91
6290,12/3/2020,12/3/2020,JE-21-0110,Blue 20/20 Vision Insurance - December Inv Lux-Blue 20/20 Vision Insurance -December Inv LUX,D108,HJ,21.33,,52325.24
6290,12/3/2020,12/3/2020,JE-21-0111,Blue 20/20 Vision Insurance - December Inv 82L-Blue 20/20 Vision Insurance December Inv 82L,D108,HJ,48.93,,52374.17
6290,12/3/2020,12/3/2020,JE-21-0111,Blue 20/20 Vision Insurance - December Inv 82L-Blue 20/20 Vision Insurance December Inv 82L,D108,HJ,7.11,,52381.28
6290,12/15/2020,12/15/2020,JE-21-0112,LUX-PRPD-121520-LUX-PRPD-121520,D108,HJ,,51.62,52329.66
6290,12/15/2020,12/15/2020,JE-21-0112,LUX-PRPD-121520-LUX-PRPD-121520,D108,HJ,,347.92,51981.74
6290,12/15/2020,12/15/2020,JE-21-0112,LUX-PRPD-121520-LUX-PRPD-121520,D108,HJ,,7.12,51974.62
6290,12/15/2020,12/15/2020,JE-21-0112,LUX-PRPD-121520-LUX-PRPD-121520,D108,HJ,,62.67,51911.95
6290,12/31/2020,12/31/2020,JE-21-0113,LUX-PRPD-123120-LUX-PRPD-123120,D108,HJ,,51.62,51860.33
6290,12/31/2020,12/31/2020,JE-21-0113,LUX-PRPD-123120-LUX-PRPD-123120,D108,HJ,,347.92,51512.41
6290,12/31/2020,12/31/2020,JE-21-0113,LUX-PRPD-123120-LUX-PRPD-123120,D108,HJ,,7.12,51505.29
6290,12/31/2020,12/31/2020,JE-21-0113,LUX-PRPD-123120-LUX-PRPD-123120,D108,HJ,,62.67,51442.62
6290,1/4/2021,1/4/2021,BCBS,January 2021 BCBS Payment-BCBS - January 2021 BCBS,D108,HJ,11054.89,,62497.51
6290,1/4/2021,1/4/2021,BCBS,January 2021 BCBS Payment-BCBS - January 2021 BCBS,D108,HJ,2326.61,,64824.12
6290,1/5/2021,1/5/2021,JE-21-0146,Blue 20/20 Vision Insurance - January Inv LUX-Blue 20/20 Vision Insurance -January Inv LUX,D108,HJ,319.95,,65144.07
6290,1/5/2021,1/5/2021,JE-21-0146,Blue 20/20 Vision Insurance - January Inv LUX-Blue 20/20 Vision Insurance -January Inv LUX,D108,HJ,28.44,,65172.51
6290,1/5/2021,1/5/2021,JE-21-0147,Blue 20/20 Vision Insurance- January Inv 82L-Blue 20/20 Vision Insurance January Inv 82L,D108,HJ,35.13,,65207.64
6290,1/5/2021,1/5/2021,JE-21-0147,Blue 20/20 Vision Insurance- January Inv 82L-Blue 20/20 Vision Insurance January Inv 82L,D108,HJ,7.11,,65214.75
6290,1/15/2021,1/15/2021,JE-21-0145,LUX PayrollLUX-PRPPD-01152021-LUX-PRPD-01152021,D108,HJ,,49.84,65164.91
6290,1/15/2021,1/15/2021,JE-21-0145,LUX PayrollLUX-PRPPD-01152021-LUX-PRPD-01152021,D108,HJ,,347.92,64816.99
6290,1/15/2021,1/15/2021,JE-21-0145,LUX PayrollLUX-PRPPD-01152021-LUX-PRPD-01152021,D108,HJ,,5.34,64811.65
6290,1/15/2021,1/15/2021,JE-21-0145,LUX PayrollLUX-PRPPD-01152021-LUX-PRPD-01152021,D108,HJ,,47.84,64763.81
6290,1/31/2021,1/31/2021,JE-21-0151,LUX PRPD- 013121-LUX-PRPD-013121,D108,HJ,,49.84,64713.97
6290,1/31/2021,1/31/2021,JE-21-0151,LUX PRPD- 013121-LUX-PRPD-013121,D108,HJ,,335.96,64378.01
6290,1/31/2021,1/31/2021,JE-21-0151,LUX PRPD- 013121-LUX-PRPD-013121,D108,HJ,,5.34,64372.67
6290,1/31/2021,1/31/2021,JE-21-0151,LUX PRPD- 013121-LUX-PRPD-013121,D108,HJ,,47.84,64324.83
6290,2/1/2021,2/1/2021,BCBS,BCBS February Payment-BCBS - February 2021 BCBS,D108,HJ,13146.16,,77470.99
6290,2/1/2021,2/1/2021,BCBS,BCBS February Payment-BCBS - February 2021 BCBS,D108,HJ,1255.12,,78726.11
6290,2/2/2021,2/2/2021,JE-21-0165,Blue 20/20 Vision Insurance February Inv 82L-Blue 20/20 Vision Insurance February Inv 82L,D108,HJ,42.24,,78768.35
6290,2/2/2021,2/2/2021,JE-21-0165,Blue 20/20 Vision Insurance February Inv 82L-Blue 20/20 Vision Insurance February Inv 82L,D108,HJ,7.11,,78775.46
6290,2/2/2021,2/2/2021,JE-21-0166,Blue 20/20 Vision Insurance - February Inv LUX-Blue 20/20 Vision Insurance -February Inv LUX,D108,HJ,184.86,,78960.32
6290,2/2/2021,2/2/2021,JE-21-0166,Blue 20/20 Vision Insurance - February Inv LUX-Blue 20/20 Vision Insurance -February Inv LUX,D108,HJ,21.33,,78981.65
6290,2/15/2021,2/15/2021,JE-21-0169,LUX PRPD- 021521-LUX-PRPD-02152021,D108,HJ,,49.84,78931.81
6290,2/15/2021,2/15/2021,JE-21-0169,LUX PRPD- 021521-LUX-PRPD-02152021,D108,HJ,,335.96,78595.85
6290,2/15/2021,2/15/2021,JE-21-0169,LUX PRPD- 021521-LUX-PRPD-02152021,D108,HJ,,5.34,78590.51
6290,2/15/2021,2/15/2021,JE-21-0169,LUX PRPD- 021521-LUX-PRPD-02152021,D108,HJ,,47.84,78542.67
6290,2/28/2021,2/28/2021,JE-21-0175,LUX PRPD -02282021-LUX-PRPD-022821,D108,HJ,,51.62,78491.05
6290,2/28/2021,2/28/2021,JE-21-0175,LUX PRPD -02282021-LUX-PRPD-022821,D108,HJ,,335.96,78155.09
6290,2/28/2021,2/28/2021,JE-21-0175,LUX PRPD -02282021-LUX-PRPD-022821,D108,HJ,,5.34,78149.75
6290,2/28/2021,2/28/2021,JE-21-0175,LUX PRPD -02282021-LUX-PRPD-022821,D108,HJ,,47.84,78101.91
6290,3/3/2021,3/3/2021,BCBS,March 2021 BCBS payment,D108,HJ,11606.65,,89708.56
6290,3/3/2021,3/3/2021,BCBS,March 2021 BCBS payment,D108,HJ,1752.61,,91461.17
6290,3/3/2021,3/3/2021,JE-21-0185,Blue 20/20 Vision Insurance - February 82L,D108,HJ,,0.42,91460.75
6290,3/3/2021,3/3/2021,JE-21-0185,Blue 20/20 Vision Insurance - February 82L,D108,HJ,7.11,,91467.86
6290,3/3/2021,3/3/2021,JE-21-0186,Blue 20/20 Vision Ins - March Payment LUX,D108,HJ,191.97,,91659.83
6290,3/3/2021,3/3/2021,JE-21-0186,Blue 20/20 Vision Ins - March Payment LUX,D108,HJ,21.33,,91681.16
6290,3/12/2021,3/12/2021,JE-21-0187,LUX Payroll -PRPD 031521,D108,HJ,,51.62,91629.54
6290,3/12/2021,3/12/2021,JE-21-0187,LUX Payroll -PRPD 031521,D108,HJ,,333.09,91296.45
6290,3/12/2021,3/12/2021,JE-21-0187,LUX Payroll -PRPD 031521,D108,HJ,,5.34,91291.11
6290,3/12/2021,3/12/2021,JE-21-0187,LUX Payroll -PRPD 031521,D108,HJ,,47.84,91243.27
6290,3/31/2021,3/31/2021,JE-21-0188,LUX Payroll- PRPD 03312021,D108,HJ,,51.62,91191.65
6290,3/31/2021,3/31/2021,JE-21-0188,LUX Payroll- PRPD 03312021,D108,HJ,,333.09,90858.56
6290,3/31/2021,3/31/2021,JE-21-0188,LUX Payroll- PRPD 03312021,D108,HJ,,5.34,90853.22
6290,3/31/2021,3/31/2021,JE-21-0188,LUX Payroll- PRPD 03312021,D108,HJ,,47.84,90805.38
6290,4/2/2021,4/2/2021,BCBS,April 2021 BCBS Payment,D108,HJ,18348.19,,109153.57
6290,4/2/2021,4/2/2021,BCBS,April 2021 BCBS Payment,D108,HJ,1752.61,,110906.18
6290,4/2/2021,4/2/2021,JE-21-0202,Blue 20/20 Vision Ins - April Inv LUX,D108,HJ,270.18,,111176.36
6290,4/2/2021,4/2/2021,JE-21-0202,Blue 20/20 Vision Ins - April Inv LUX,D108,HJ,21.33,,111197.69
6290,4/2/2021,4/2/2021,JE-21-0203,Blue 20/20 April Inv Payment 82L,D108,HJ,195.72,,111393.41
6290,4/2/2021,4/2/2021,JE-21-0203,Blue 20/20 April Inv Payment 82L,D108,HJ,,21.33,111372.08
6290,4/15/2021,4/15/2021,JE-21-0200,LUX PRPD -041521,D108,HJ,,51.62,111320.46
6290,4/15/2021,4/15/2021,JE-21-0200,LUX PRPD -041521,D108,HJ,,347.92,110972.54
6290,4/15/2021,4/15/2021,JE-21-0200,LUX PR 20210415 REV &CORR,D108,HJ,,51.62,110920.92
6290,4/15/2021,4/15/2021,JE-21-0200,LUX PR 20210415 REV &CORR,D108,HJ,51.62,,110972.54
6290,4/15/2021,4/15/2021,JE-21-0200,LUX PR 20210415 REV &CORR,D108,HJ,,347.92,110624.62
6290,4/15/2021,4/15/2021,JE-21-0200,LUX PR 20210415 REV &CORR,D108,HJ,347.92,,110972.54
6290,4/15/2021,4/15/2021,JE-21-0200,LUX PRPD -041521,D108,HJ,,5.34,110967.2
6290,4/15/2021,4/15/2021,JE-21-0200,LUX PRPD -041521,D108,HJ,,47.84,110919.36
6290,4/15/2021,4/15/2021,JE-21-0200,LUX PR 20210415 REV &CORR,D108,HJ,,5.34,110914.02
6290,4/15/2021,4/15/2021,JE-21-0200,LUX PR 20210415 REV &CORR,D108,HJ,5.34,,110919.36
6290,4/15/2021,4/15/2021,JE-21-0200,LUX PR 20210415 REV &CORR,D108,HJ,,47.84,110871.52
6290,4/15/2021,4/15/2021,JE-21-0200,LUX PR 20210415 REV &CORR,D108,HJ,47.84,,110919.36
6290,4/30/2021,4/30/2021,JE-21-0204,LUX Payroll 4-30-2021,D108,HJ,,49.84,110869.52
6290,4/30/2021,4/30/2021,JE-21-0204,LUX Payroll 4-30-2021,D108,HJ,,335.96,110533.56
6290,4/30/2021,4/30/2021,JE-21-0204,PR LUX 20210430,D108,HJ,,49.84,110483.72
6290,4/30/2021,4/30/2021,JE-21-0204,PR LUX 20210430,D108,HJ,49.84,,110533.56
6290,4/30/2021,4/30/2021,JE-21-0204,PR LUX 20210430,D108,HJ,,335.96,110197.6
6290,4/30/2021,4/30/2021,JE-21-0204,PR LUX 20210430,D108,HJ,335.96,,110533.56
6290,4/30/2021,4/30/2021,JE-21-0204,LUX Payroll 4-30-2021,D108,HJ,,5.34,110528.22
6290,4/30/2021,4/30/2021,JE-21-0204,LUX Payroll 4-30-2021,D108,HJ,,47.84,110480.38
6290,4/30/2021,4/30/2021,JE-21-0204,PR LUX 20210430,D108,HJ,,5.34,110475.04
6290,4/30/2021,4/30/2021,JE-21-0204,PR LUX 20210430,D108,HJ,5.34,,110480.38
6290,4/30/2021,4/30/2021,JE-21-0204,PR LUX 20210430,D108,HJ,,47.84,110432.54
6290,4/30/2021,4/30/2021,JE-21-0204,PR LUX 20210430,D108,HJ,47.84,,110480.38
6290,5/3/2021,5/3/2021,BCBS,BCBS MAy 2021 Payment,D108,HJ,13057.04,,123537.42
6290,5/3/2021,5/3/2021,BCBS,BCBS MAy 2021 Payment,D108,HJ,1752.61,,125290.03
6290,5/4/2021,5/4/2021,1,Blue 20/20 Vision Insurance,D108,HJ,56.04,,125346.07
6290,5/4/2021,5/4/2021,1,blUE 20/20 Vision payment May,D108,HJ,149.31,,125495.38
6290,5/4/2021,5/4/2021,1,blUE 20/20 Vision payment May,D108,HJ,21.33,,125516.71
6290,5/13/2021,5/13/2021,JE-21-0226,LUX Payroll- PRPD 05152021,D108,HJ,,49.84,125466.87
6290,5/13/2021,5/13/2021,JE-21-0226,LUX Payroll- PRPD 05152021,D108,HJ,,335.96,125130.91
6290,5/13/2021,5/13/2021,JE-21-0226,LUX Payroll- PRPD 05152021,D108,HJ,,5.34,125125.57
6290,5/13/2021,5/13/2021,JE-21-0226,LUX Payroll- PRPD 05152021,D108,HJ,,47.84,125077.73
6290,5/27/2021,5/27/2021,JE-21-0227,LUX PAyroll - PRPD 05312021,D108,HJ,,49.84,125027.89
6290,5/27/2021,5/27/2021,JE-21-0227,LUX PAyroll - PRPD 05312021,D108,HJ,,324,124703.89
6290,5/27/2021,5/27/2021,JE-21-0227,LUX PAyroll - PRPD 05312021,D108,HJ,,5.34,124698.55
6290,5/27/2021,5/27/2021,JE-21-0227,LUX PAyroll - PRPD 05312021,D108,HJ,,47.84,124650.71
6290,6/1/2021,6/1/2021,BCBS,BCBS June 2021 Payment,D108,HJ,11833.18,,136483.89
6290,6/1/2021,6/1/2021,BCBS,BCBS June 2021 Payment,D108,HJ,1752.61,,138236.5
6290,6/2/2021,6/2/2021,1,Blue 20/20 Vision Ins LUX,D108,HJ,177.75,,138414.25
6290,6/2/2021,6/2/2021,1,Blue 20/20 Vision Ins 82L June Payment,D108,HJ,56.04,,138470.29
6290,6/2/2021,6/2/2021,1,Blue 20/20 Vision Ins LUX,D108,HJ,21.33,,138491.62
6290,6/14/2021,6/14/2021,JE-21-0238,PRPD 06152021 LUX,D108,HJ,,48.06,138443.56
6290,6/14/2021,6/14/2021,JE-21-0238,PRPD 06152021 LUX,D108,HJ,,324,138119.56
6290,6/14/2021,6/14/2021,JE-21-0238,PRPD 06152021 LUX,D108,HJ,,5.34,138114.22
6290,6/14/2021,6/14/2021,JE-21-0238,PRPD 06152021 LUX,D108,HJ,,47.84,138066.38
6290,6/30/2021,6/30/2021,JE-21-0245,LUX PR-PD 20210630,D108,HJ,,46.28,138020.1
6290,6/30/2021,6/30/2021,JE-21-0245,LUX PR-PD 20210630,D108,HJ,,324,137696.1
6290,6/30/2021,6/30/2021,JE-21-0245,LUX PR-PD 20210630,D108,HJ,,5.34,137690.76
6290,6/30/2021,6/30/2021,JE-21-0245,LUX PR-PD 20210630,D108,HJ,,47.84,137642.92
6290, Totals for 6290 - AmeriCorps Fellow Dental and Vision Insurance,,,,,,149749.12,12106.2,137642.92
6295,6295 - Staff Condolence/Morale (Balance forward As of 07/01/2020) ,,,,,,,,0
6295,7/3/2020,7/3/2020,Maryellen Leneghan,Imported from Bank of America Visa-Staff condolence when family member passed,D108,HJ,37.99,,37.99
6295,7/16/2020,7/16/2020,Myesha Hossain,Imported from Bank of America Visa-Acquisition of site,D108,HJ,42.64,,80.63
6295,10/14/2020,10/14/2020,Angela Mason,Imported from reimbursements-Condolences O. P.,D111,HJ,64.18,,144.81
6295,12/11/2020,12/11/2020,Thomas Fischaber,Imported from Bank of America Visa-Adaptive Learning CFT,D109,HJ,86.99,,231.8
6295,12/11/2020,12/11/2020,Thomas Fischaber,Imported from Bank of America Visa-Adaptive Learning CFT,D109,HJ,86.99,,318.79
6295,12/11/2020,12/11/2020,Thomas Fischaber,Imported from Bank of America Visa-Adaptive Learning CFT,D109,HJ,105.6,,424.39
6295,12/11/2020,12/11/2020,Thomas Fischaber,Imported from Bank of America Visa-Adaptive Learning CFT,D109,HJ,114,,538.39
6295,12/12/2020,12/12/2020,Thomas Fischaber,Imported from Bank of America Visa-Adaptive Learning CFT,D109,HJ,77,,615.39
6295,12/21/2020,12/21/2020,Thomas Fischaber,Imported from Bank of America Visa-Holiday celebration,D109,HJ,25,,640.39
6295,12/22/2020,12/22/2020,Thomas Fischaber,Imported from Bank of America Visa-Care package,D109,HJ,6.92,,647.31
6295,12/22/2020,12/22/2020,Thomas Fischaber,Imported from Bank of America Visa-Care package,D109,HJ,68.8,,716.11
6295,12/22/2020,12/22/2020,Thomas Fischaber,Imported from Bank of America Visa-Holiday celebration,D109,HJ,19.58,,735.69
6295,12/22/2020,12/22/2020,Thomas Fischaber,Imported from Bank of America Visa-Holiday celebration,D109,HJ,19.93,,755.62
6295,12/22/2020,12/22/2020,Thomas Fischaber,Imported from Bank of America Visa-Holiday celebration,D109,HJ,21.39,,777.01
6295,1/21/2021,1/21/2021,Thomas Fischaber,Imported from Bank of America Visa-condolences,D109,HJ,83.84,,860.85
6295,2/4/2021,2/4/2021,Monivett Acevedo,Imported from reimbursements-Sympathy gift for Gillian,D107,HJ,36.93,,897.78
6295,2/5/2021,2/5/2021,Tiffani Bibb,Imported from Bank of America Visa-Wellness Contest,D104,HJ,101.39,,999.17
6295,2/11/2021,2/11/2021,Thomas Fischaber,Imported from Bank of America Visa-gift card thank you,D109,HJ,100,,1099.17
6295,4/2/2021,4/2/2021,Myesha Hossain,Imported from Bank of America Visa,D108,HJ,37.84,,1137.01
6295,5/1/2021,5/1/2021,Myesha Hossain,Imported from Bank of America Visa,D108,HJ,80.56,,1217.57
6295,6/11/2021,6/11/2021,Tiffany Jordan,Imported from Bank of America Visa,D108,HJ,93.47,,1311.04
6295,6/18/2021,6/18/2021,Tiffany Jordan,Imported from Bank of America Visa,D108,HJ,160.41,,1471.45
6295,6/23/2021,6/23/2021,Tiffany Jordan,Imported from Bank of America Visa,D108,HJ,,160.41,1311.04
6295,6/24/2021,6/24/2021,Tiffani Bibb,Imported from Bank of America Visa,D104,HJ,17.73,,1328.77
6295,6/28/2021,6/28/2021,Thomas Fischaber,Imported from Bank of America Visa,D109,HJ,100.11,,1428.88
6295,6/30/2021,6/30/2021,Thomas Fischaber,Imported from Bank of America Visa,D109,HJ,86.64,,1515.52
6295, Totals for 6295 - Staff Condolence/Morale,,,,,,1675.93,160.41,1515.52
6300,6300 - Consultants and Contracted Services (Balance forward As of 07/01/2020) ,,,,,,,,0
6300,7/1/2020,7/1/2020,2689,To expense DEIC consulting service-To expense DEIC consulting service,D107,HJ,7062,,7062
6300,7/2/2020,7/2/2020,Impact Catalysts,Bill.Com Import-Payment 1 of 3 for Business planning,D107,HJ,10000,,17062
6300,7/2/2020,7/2/2020,Media Cause,Bill.Com Import-Digital marketing Schedule B. Ad Grant and Digital Recruitment Campaign 5.01 to 5.31,D107,HJ,19949,,37011
6300,7/8/2020,7/8/2020,Catherine M Tierney,Bill.Com Import-Florida district research,D107,HJ,350,,37361
6300,7/8/2020,7/8/2020,Julie Balfour,Bill.Com Import-1 of 3 consulting services performed for June 1st to June 30th 2020,D102,HJ,3333.33,,40694.33
6300,7/13/2020,7/13/2020,Feinberg Hanson,Bill.Com Import-Service rendered in June,D102,HJ,608.1,,41302.43
6300,7/13/2020,7/13/2020,Media Cause,Bill.Com Import-Digital marketing Schedule B. Ad Grant and Digital Recruitment Campaign 6.1 to 6.30,D107,HJ,23223,,64525.43
6300,7/22/2020,7/22/2020,Board Member Connect,Bill.Com Import-Intro board candidates for consideration,D107,HJ,2000,,66525.43
6300,7/22/2020,7/22/2020,Whiteboard,Bill.Com Import-Consulting fee for June 2020 biz dev and market research,D107,HJ,7500,,74025.43
6300,7/27/2020,7/27/2020,Leslie Wade LLC,Bill.Com Import-HR Diagnostic. Initial Payment. HR Consulting Service June 2020,D104,HJ,7744,,81769.43
6300,7/30/2020,7/30/2020,Exponent Partners,Bill.Com Import-Building a Custom database system for X Co.  on Salesforce,D107,HJ,875,,82644.43
6300,8/3/2020,8/3/2020,Catherine M Tierney,Bill.Com Import-Algebra I Achievement Research Research on reopening protocols,D107,HJ,62.5,,82706.93
6300,8/4/2020,8/4/2020,Impact Catalysts,Bill.Com Import-Payment 2 of 3 for Business planning for the merger and acquisition project,D107,HJ,10000,,92706.93
6300,8/4/2020,8/4/2020,Julie Balfour,Bill.Com Import-2 of 3 consulting services performed for July 1st - July 31th 2020,D107,HJ,3333.33,,96040.26
6300,8/14/2020,8/14/2020,AAFCPAS,Bill.Com Import-Progress invoice on due diligence consulting project.,D103,HJ,4000,,100040.26
6300,8/14/2020,8/14/2020,Feinberg Hanson,Bill.Com Import-Service rendered in July,D107,HJ,13077.72,,113117.98
6300,8/14/2020,8/14/2020,Media Cause,Bill.Com Import-Digital marketing Schedule B. Ad Grant and Digital Recruitment Campaign 7.01.20 to 7.31.20,D107,HJ,26200,,139317.98
6300,8/18/2020,8/18/2020,Confianza,Bill.Com Import-Technical Assistance with X Co. . Education program development,D101,HJ,200,,139517.98
6300,8/19/2020,8/19/2020,Catherine M Tierney,Bill.Com Import--,D107,HJ,37.5,,139555.48
6300,8/19/2020,8/19/2020,Catherine M Tierney,Bill.Com Import--,D107,HJ,87.5,,139642.98
6300,8/21/2020,8/21/2020,Appcast Inc.,Bill.Com Import-June 2020 Appcast Applies Recruitment Campaign project with Media Cause,D107,HJ,804.95,,140447.93
6300,8/21/2020,8/21/2020,Whiteboard,Bill.Com Import-Consulting fee for July 2020 biz dev and market research,D107,HJ,7500,,147947.93
6300,8/26/2020,8/26/2020,Appcast Inc.,Bill.Com Import-May 2020 Appcast applies recruitment,D107,HJ,2108,,150055.93
6300,8/26/2020,8/26/2020,Leslie Wade LLC,Bill.Com Import-Organizational Change Consulting Service July 2020,D104,HJ,6448,,156503.93
6300,8/31/2020,8/31/2020,Tiffany Cardona,Bill.Com Import-Decision-making rights project,D107,HJ,2499.6,,159003.53
6300,8/31/2020,8/31/2020,VIGOROUS INT.,Bill.Com Import-Related to DEIC work,D107,HJ,7062,,166065.53
6300,9/2/2020,9/2/2020,Whiteboard,Bill.Com Import-Consulting fee for survey project fee,D107,HJ,10000,,176065.53
6300,9/3/2020,9/3/2020,Julie Balfour,Bill.Com Import-3 of 3 consulting services performed for August 1st to August 31th 2020,D107,HJ,3333.33,,179398.86
6300,9/9/2020,9/9/2020,Nafepa,Bill.Com Import-Online tutoring survey related to white board advisor,D107,HJ,2000,,181398.86
6300,9/14/2020,9/14/2020,Myesha Hossain,Imported from Bank of America Visa-Moving Men for Supplies,D108,HJ,155.95,,181554.81
6300,9/15/2020,9/15/2020,Confianza,Bill.Com Import-Consultation with X Co.  leadership August 17 2020,D101,HJ,200,,181754.81
6300,9/15/2020,9/15/2020,Feinberg Hanson,Bill.Com Import-Service rendered in August,D107,HJ,9136.77,,190891.58
6300,9/15/2020,9/15/2020,Impact Catalysts,Bill.Com Import-Payment 3 of 3 for Business planning,D107,HJ,5000,,195891.58
6300,9/15/2020,9/15/2020,Myesha Hossain,Imported from Bank of America Visa-Moving Men Tip,D108,HJ,20,,195911.58
6300,9/15/2020,9/15/2020,Myesha Hossain,Imported from Bank of America Visa-Refund,D108,HJ,,5.95,195905.63
6300,9/21/2020,9/21/2020,Appcast Inc.,Bill.Com Import-July 2020 Appcast Applies Recruitment,D107,HJ,7373.75,,203279.38
6300,9/22/2020,9/22/2020,Whiteboard,Bill.Com Import-Consulting fee for survey project fee,D107,HJ,8191.65,,211471.03
6300,9/24/2020,9/24/2020,Catherine M Tierney,Bill.Com Import-Notetaking for leadership call,D107,HJ,40,,211511.03
6300,9/25/2020,9/25/2020,Dstillery Inc.,Bill.Com Import-Digital Marketing. Related to Media Cause. Impressions,D107,HJ,1830.86,,213341.89
6300,9/25/2020,9/25/2020,Leslie Wade LLC,Bill.Com Import-Organizational Change Consulting Service-August 2020,D104,HJ,6432,,219773.89
6300,9/25/2020,9/25/2020,Media Cause,Bill.Com Import-Digital Marketing. Schedule B. Ad Grant & Digital Recruitment Campaign 8.01.20 to 8.31.20,D111,HJ,13884,,233657.89
6300,10/1/2020,10/1/2020,Catherine M Tierney,Bill.Com Import-Notetaking for leadership call 9.25,D107,HJ,40,,233697.89
6300,10/1/2020,10/1/2020,Myesha Hossain,Imported from reimbursements-HPHS site set up,D108,HJ,195.95,,233893.84
6300,10/1/2020,10/1/2020,Myesha Hossain,Imported from reimbursements-Site set up,D108,HJ,,5.95,233887.89
6300,10/7/2020,10/7/2020,Julie Balfour,Bill.Com Import-1 of 3 Agreement extension for September 1st - September 30th 2020,D102,HJ,3333.33,,237221.22
6300,10/15/2020,10/15/2020,Catherine M Tierney,Bill.Com Import-Notetaking for call with Alex and Friday,D107,HJ,100,,237321.22
6300,10/21/2020,10/21/2020,Leslie Wade LLC,Bill.Com Import-Organizational Change Consulting Service-September 2020,D104,HJ,7520,,244841.22
6300,10/22/2020,10/22/2020,Appcast Inc.,Bill.Com Import-Digital marketing. August 2020 Appcast applies recruitment,D107,HJ,1202.98,,246044.2
6300,10/22/2020,10/22/2020,Media Cause,Bill.Com Import-Digital Marketing. Schedule C. Digital Recruitment Retainer9.01.20 to 9.30.20,D111,HJ,14314,,260358.2
6300,10/22/2020,10/22/2020,Whiteboard,Bill.Com Import-Fee for September Services,D107,HJ,7500,,267858.2
6300,10/30/2020,10/30/2020,Catherine M Tierney,Bill.Com Import-Notetaking cross team leadership call 10.16,D107,HJ,40,,267898.2
6300,11/10/2020,11/10/2020,Catherine M Tierney,Bill.Com Import-Notetaking cross team call 10.30,D107,HJ,20,,267918.2
6300,11/10/2020,11/10/2020,Julie Balfour,Bill.Com Import-2 of 3 Agreement extension.consulting services performed for September 1st September 30th 2020,D107,HJ,3333.33,,271251.53
6300,11/18/2020,11/18/2020,AAFCPAS,Bill.Com Import-Final Bill for the financial statement audit for the year ended June 30 2020,D103,HJ,12000,,283251.53
6300,11/18/2020,11/18/2020,Apollon & Partners,Bill.Com Import-Consultant.Advisor,D107,HJ,10000,,293251.53
6300,11/19/2020,11/19/2020,Media Cause,Bill.Com Import-Digital Marketing. Schedule C. Digital Recruitment Retainer Extension 10.01.20 to 10.31.20,D111,HJ,9598,,302849.53
6300,11/19/2020,11/19/2020,VIGOROUS INT.,Bill.Com Import-Related to DEIC work,D107,HJ,7062,,309911.53
6300,11/19/2020,11/19/2020,Whiteboard,Bill.Com Import-Fee for September Services,D107,HJ,8640.03,,318551.56
6300,11/25/2020,11/25/2020,Tiffany Cardona,Bill.Com Import-Decision-making rights project,D107,HJ,4700.4,,323251.96
6300,12/1/2020,12/1/2020,20201201,To move revenue and expenses from discontinued grants-To move revenue and expenses from GATES to G-BL,D107,HJ,,350,322901.96
6300,12/1/2020,12/1/2020,20201201,To move revenue and expenses from discontinued grants-To move revenue and expenses from GATES to G-BL,D107,HJ,350,,323251.96
6300,12/1/2020,12/1/2020,Quinn Result Coach,Bill.Com Import-12 Session Coaching engagement and organizational health workshop held with senior leadership,D107,HJ,1275,,324526.96
6300,12/8/2020,12/8/2020,Julie Balfour,Bill.Com Import-3 of 3 Agreement extension. consulting services performed for November 1st - November 31th 2020,D107,HJ,3333.34,,327860.3
6300,12/10/2020,12/10/2020,Leslie Wade LLC,Bill.Com Import-Organizational Change Consulting Service October 2020,D107,HJ,8352,,336212.3
6300,12/11/2020,12/11/2020,Mighty Good Agency,Bill.Com Import-Brand strategy Package,D107,HJ,5000,,341212.3
6300,12/21/2020,12/21/2020,Michael Goldstein,Bill.Com Import-Research on lowering costs and Identifying the mechanisms to maximize X Co.  tutoring.,D107,HJ,15000,,356212.3
6300,12/21/2020,12/21/2020,Tess Brownson,Bill.Com Import-Art for City or Alkwar Presentation,D109,HJ,1500,,357712.3
6300,12/21/2020,12/21/2020,Whiteboard,Bill.Com Import-Fee for November Services,D107,HJ,7500,,365212.3
6300,12/22/2020,12/22/2020,Media Cause,Bill.Com Import-Digital Marketing. Schedule C. Digital Recruitment Retainer Extension 11.01.20 to 11.30.20,D111,HJ,12674,,377886.3
6300,12/30/2020,12/30/2020,Mighty Good Agency,Bill.Com Import-Brand strategy Package,D107,HJ,4000,,381886.3
6300,12/31/2020,12/31/2020,20201231,Actual vs Budget Reclass as of 12/31/2020-Actual vs Budget Reclass as of 12/31/2020,D104,HJ,,20624,361262.3
6300,12/31/2020,12/31/2020,20201231,Actual vs Budget Reclass as of 12/31/2020-Actual vs Budget Reclass as of 12/31/2020,D107,HJ,20624,,381886.3
6300,12/31/2020,12/31/2020,20201231,Actual vs Budget Reclass as of 12/31/2020-Actual vs Budget Reclass as of 12/31/2020,D107,HJ,,21186,360700.3
6300,12/31/2020,12/31/2020,20201231,Actual vs Budget Reclass as of 12/31/2020-Actual vs Budget Reclass as of 12/31/2020,D111,HJ,1487.5,,362187.8
6300,12/31/2020,12/31/2020,20201231,Actual vs Budget Reclass as of 12/31/2020-Actual vs Budget Reclass as of 12/31/2020,D111,HJ,4812.5,,367000.3
6300,1/6/2021,1/6/2021,Tiffany Cardona,Bill.Com Import-Decision.making rights project,D107,HJ,3888,,370888.3
6300,1/7/2021,1/7/2021,Abacus Bookkeeping,Bill.Com Import-WootMath Bookkeeper Services to provide information to X Co. ,D109,HJ,125,,371013.3
6300,1/19/2021,1/19/2021,Julie Balfour,Bill.Com Import-1 of 3 Agreement extension. consulting services performed for Dec 1 to Feb 28 2020,D107,HJ,3333.33,,374346.63
6300,1/20/2021,1/20/2021,Leslie Wade LLC,Bill.Com Import-Organizational Change Consulting Service December 2020,D107,HJ,17104,,391450.63
6300,1/20/2021,1/20/2021,Whiteboard,Bill.Com Import-Fee for December Services and PR newswire,D107,HJ,8576.85,,400027.48
6300,1/21/2021,1/21/2021,AAFCPAS,Bill.Com Import-Final invoice for X Co.  Woot consulting project,D103,HJ,1000,,401027.48
6300,1/22/2021,1/22/2021,Media Cause,Bill.Com Import-Digital Marketing. Schedule C. Digital Recruitment Retainer Extension 12.01.20 to 12.31.20,D111,HJ,12451,,413478.48
6300,1/26/2021,1/26/2021,Leslie Wade LLC,Bill.Com Import-Organizational Change Consulting Service Nov 2020,D107,HJ,20352,,433830.48
6300,1/28/2021,1/28/2021,Amy Smith,Bill.Com Import-Contract to provide video coding. service provided Dec 2020 to Jan 2021,D109,HJ,660,,434490.48
6300,2/4/2021,2/4/2021,Abacus Bookkeeping,Bill.Com Import-WootMath Bookkeeper Services to provide information to X Co.  January 2021,D109,HJ,204.18,,434694.66
6300,2/4/2021,2/4/2021,Lisis Alvarez,Bill.Com Import-Consulting services in January including transcription top 40 districts teaching Lic.,D107,HJ,1440,,436134.66
6300,2/5/2021,2/5/2021,Julie Balfour,Bill.Com Import-2 of 3 Agreement extension. Consulting services January 2021,D107,HJ,3333.33,,439467.99
6300,2/11/2021,2/11/2021,Mighty Good Agency,Bill.Com Import-Brand strategy Package,D107,HJ,13000,,452467.99
6300,2/16/2021,2/16/2021,Leslie Wade LLC,Bill.Com Import-Organizational Improvement Consulting Service January 2021,D107,HJ,10400,,462867.99
6300,2/18/2021,2/18/2021,Leslie Wade LLC,Bill.Com Import-Organizational Improvement Consulting Service Jan.Feb 2021,D107,HJ,10400,,473267.99
6300,2/18/2021,2/18/2021,Tiffany Cardona,Bill.Com Import-Training session with the larger leadership group. Decision making rights project Jan 2021,D107,HJ,1390.8,,474658.79
6300,2/19/2021,2/19/2021,VIGOROUS INT.,Bill.Com Import-4 of 4 contract fee. Related to DEIC work.,D104,HJ,7061,,481719.79
6300,2/23/2021,2/23/2021,Confianza,Bill.Com Import-Consultation with X Co.  leadership. Site Director Training,D101,HJ,2500,,484219.79
6300,2/23/2021,2/23/2021,Tiffany Cardona,Bill.Com Import-Training session with the larger leadership group. Decision making rights project Dec.Jan 2021,D107,HJ,3844.8,,488064.59
6300,2/24/2021,2/24/2021,Apollon & Partners,Bill.Com Import-Consultant. Advisor Nov. 1 to Jan. 31 2021,D107,HJ,7000,,495064.59
6300,3/5/2021,3/5/2021,Julie Balfour,Bill.Com Import,D107,HJ,3333.34,,498397.93
6300,3/17/2021,3/17/2021,Leslie Wade LLC,Bill.Com Import,D107,HJ,10400,,508797.93
6300,4/7/2021,4/7/2021,Julie Balfour,Bill.Com Import,D107,HJ,3333.33,,512131.26
6300,4/7/2021,4/7/2021,Karl W. Reid,Bill.Com Import,D107,HJ,330,,512461.26
6300,4/22/2021,4/22/2021,Leslie Wade LLC,Bill.Com Import,D107,HJ,10400,,522861.26
6300,4/23/2021,4/23/2021,Karl W. Reid,Bill.Com Import,D107,HJ,930,,523791.26
6300,5/4/2021,5/4/2021,Mighty Good Agency,Bill.Com Import,D107,HJ,17750,,541541.26
6300,5/5/2021,5/5/2021,Exponent Partners,Bill.Com Import,D105,HJ,7500,,549041.26
6300,5/7/2021,5/7/2021,Whiteboard,Bill.Com Import,D107,HJ,17500,,566541.26
6300,5/11/2021,5/11/2021,Julie Balfour,Bill.Com Import,D107,HJ,3333.33,,569874.59
6300,5/11/2021,5/11/2021,Karl W. Reid,Bill.Com Import,D107,HJ,240,,570114.59
6300,5/14/2021,5/14/2021,Tess Brownson,Bill.Com Import,D109,HJ,1000,,571114.59
6300,5/24/2021,5/24/2021,Leslie Wade LLC,Bill.Com Import,D107,HJ,10400,,581514.59
6300,5/31/2021,5/31/2021,JE-21-0222,ADJ to reclassify funding source,D107,HJ,,10000,571514.59
6300,5/31/2021,5/31/2021,JE-21-0222,ADJ to reclassify funding source,D107,HJ,10000,,581514.59
6300,5/31/2021,5/31/2021,JE-21-0222,ADJ to reclassify funding source,D107,HJ,,30094.86,551419.73
6300,5/31/2021,5/31/2021,JE-21-0222,ADJ to reclassify funding source,D107,HJ,30094.86,,581514.59
6300,5/31/2021,5/31/2021,JE-21-0222,ADJ to reclassify funding source,D111,HJ,,1600.9,579913.69
6300,5/31/2021,5/31/2021,JE-21-0222,ADJ to reclassify funding source,D111,HJ,1600.9,,581514.59
6300,6/1/2021,6/1/2021,1,Julie Balfour Department Reclassification,D102,HJ,,3333.33,578181.26
6300,6/1/2021,6/1/2021,1,Julie Balfour Department Reclassification,D102,HJ,,3333.33,574847.93
6300,6/1/2021,6/1/2021,1,Julie Balfour Department Reclassification,D107,HJ,3333.33,,578181.26
6300,6/1/2021,6/1/2021,1,Julie Balfour Department Reclassification,D107,HJ,3333.33,,581514.59
6300,6/1/2021,6/1/2021,1,To reclassify Expenses bet departments,D104,HJ,26.07,,581540.66
6300,6/1/2021,6/1/2021,1,To reclassify Expenses bet departments,D104,HJ,21186,,602726.66
6300,6/2/2021,6/2/2021,UC Boulder,Bill.Com Import,D109,HJ,15042.54,,617769.2
6300,6/2/2021,6/2/2021,UC Boulder,Bill.Com Import,D109,HJ,20805.86,,638575.06
6300,6/4/2021,6/4/2021,Julie Balfour,Bill.Com Import,D107,HJ,3333.34,,641908.4
6300,6/10/2021,6/10/2021,Mighty Good Agency,Bill.Com Import,D107,HJ,1500,,643408.4
6300,6/14/2021,6/14/2021,Wipfli LLP,Bill.Com Import,D103,HJ,9000,,652408.4
6300,6/15/2021,6/15/2021,Carpenter Bernier Co,Bill.Com Import,D107,HJ,8880,,661288.4
6300,6/15/2021,6/15/2021,Karl W. Reid,Bill.Com Import,D107,HJ,1059.6,,662348
6300,6/21/2021,6/21/2021,Leslie Wade LLC,Bill.Com Import,D107,HJ,10400,,672748
6300,6/30/2021,6/30/2021,Apollon & Partners,Bill.Com Import,D107,HJ,2000,,674748
6300,6/30/2021,6/30/2021,Julie Balfour,Bill.Com Import,D102,HJ,3333.33,,678081.33
6300, Totals for 6300 - Consultants and Contracted Services,,,,,,768615.65,90534.32,678081.33
6310,6310 - Contingency for Project (Balance forward As of 07/01/2020) ,,,,,,,,0
6310,3/19/2021,3/19/2021,Whiteboard,Bill.Com Import,D107,HJ,17500,,17500
6310,4/7/2021,4/7/2021,Whiteboard,Bill.Com Import,D107,HJ,7500,,25000
6310,4/22/2021,4/22/2021,Whiteboard,Bill.Com Import,D107,HJ,17725,,42725
6310,5/21/2021,5/21/2021,Whiteboard,Bill.Com Import,D107,HJ,36500,,79225
6310,6/28/2021,6/28/2021,Whiteboard,Bill.Com Import,D107,HJ,5000,,84225
6310,6/28/2021,6/28/2021,Whiteboard,Bill.Com Import,D107,HJ,10000,,94225
6310,6/28/2021,6/28/2021,Whiteboard,Bill.Com Import,D107,HJ,17500,,111725
6310,6/28/2021,6/28/2021,Whiteboard,Bill.Com Import,D107,HJ,19772.76,,131497.76
6310,6/30/2021,6/30/2021,Whiteboard,Bill.Com Import,D107,HJ,525,,132022.76
6310,6/30/2021,6/30/2021,Whiteboard,Bill.Com Import,D107,HJ,795,,132817.76
6310,6/30/2021,6/30/2021,Whiteboard,Bill.Com Import,D107,HJ,2275,,135092.76
6310,6/30/2021,6/30/2021,Whiteboard,Bill.Com Import,D107,HJ,3445,,138537.76
6310,6/30/2021,6/30/2021,Whiteboard,Bill.Com Import,D107,HJ,14700,,153237.76
6310,6/30/2021,6/30/2021,Whiteboard,Bill.Com Import,D107,HJ,22260,,175497.76
6310, Totals for 6310 - Contingency for Project,,,,,,175497.76,0,175497.76
6350,6350 - Professional Services- Accounting and Legal Fees (Balance forward As of 07/01/2020) ,,,,,,,,0
6350,10/1/2020,10/1/2020,Littler Mendelson,Bill.Com Import-Legal Services for FY20,D107,HJ,570,,570
6350,10/21/2020,10/21/2020,Feinberg Hanson,Bill.Com Import-Service rendered in September,D107,HJ,14193.33,,14763.33
6350,11/20/2020,11/20/2020,Feinberg Hanson,Bill.Com Import-Service rendered in September,D107,HJ,3173,,17936.33
6350,11/20/2020,11/20/2020,Hutchinson Black,Bill.Com Import-For Services Rendered Through October 31 2020,D109,HJ,928,,18864.33
6350,11/24/2020,11/24/2020,Crawford Maunu PLLC,Bill.Com Import-Professional Services,D107,HJ,515,,19379.33
6350,12/10/2020,12/10/2020,Feinberg Hanson,Bill.Com Import-Service rendered in November,D107,HJ,6555.94,,25935.27
6350,12/21/2020,12/21/2020,Hutchinson Black,Bill.Com Import-For Services Rendered Through November 30 2020,D109,HJ,145,,26080.27
6350,1/7/2021,1/7/2021,Littler Mendelson,Bill.Com Import-Legal Services for the period of November 2020,D107,HJ,1881,,27961.27
6350,1/22/2021,1/22/2021,Feinberg Hanson,Bill.Com Import-Service rendered in December 2020,D109,HJ,3939,,31900.27
6350,1/27/2021,1/27/2021,Littler Mendelson,Bill.Com Import-Legal Services for the period of December 2020,D104,HJ,1462.5,,33362.77
6350,2/17/2021,2/17/2021,Feinberg Hanson,Bill.Com Import-Service rendered in January 2021,D109,HJ,7839,,41201.77
6350,2/17/2021,2/17/2021,Littler Mendelson,Bill.Com Import-Legal Services for the period of January 2021,D107,HJ,178.5,,41380.27
6350,2/17/2021,2/17/2021,Thomas Fischaber,Imported from Bank of America Visa-Simbulus insurance close-out,D109,HJ,2835,,44215.27
6350,2/18/2021,2/18/2021,AAFCPAS,Bill.Com Import-2nd 50 percent Invoice for preparation of Federal form 990 and state filing end 06.30.20,D103,HJ,1875,,46090.27
6350,3/17/2021,3/17/2021,Feinberg Hanson,Bill.Com Import,D109,HJ,4026,,50116.27
6350,3/17/2021,3/17/2021,Hutchinson Black,Bill.Com Import,D109,HJ,289,,50405.27
6350,3/31/2021,3/31/2021,Abacus Bookkeeping,Bill.Com Import,D109,HJ,37.5,,50442.77
6350,4/21/2021,4/21/2021,Feinberg Hanson,Bill.Com Import,D109,HJ,702,,51144.77
6350,5/21/2021,5/21/2021,Attorney's At Law,Deposit 20210521,D107,HJ,,289,50855.77
6350,5/21/2021,5/21/2021,Littler Mendelson,Bill.Com Import,D107,HJ,152.5,,51008.27
6350,5/24/2021,5/24/2021,RobbinsSalomonPatt,Bill.Com Import,D107,HJ,2989.5,,53997.77
6350,6/2/2021,6/2/2021,RobbinsSalomonPatt,Bill.Com Import,D107,HJ,3416.5,,57414.27
6350,6/2/2021,6/2/2021,Thomas Fischaber,Imported from Bank of America Visa,D109,HJ,1280,,58694.27
6350,6/30/2021,6/30/2021,AAFCPAS,Bill.Com Import,D103,HJ,15750,,74444.27
6350,6/30/2021,6/30/2021,Feinberg Hanson,Bill.Com Import,D107,HJ,1890,,76334.27
6350,6/30/2021,6/30/2021,RobbinsSalomonPatt,Bill.Com Import,D107,HJ,1495.5,,77829.77
6350, Totals for 6350 - Professional Services- Accounting and Legal Fees,,,,,,78118.77,289,77829.77
6360,6360 - Software and Subscription Services (Balance forward As of 07/01/2020) ,,,,,,,,0
6360,7/1/2020,7/1/2020,Antonio Gutierrez,Imported from Bank of America Visa-Expense Reporting,D107,HJ,1226.42,,1226.42
6360,7/1/2020,7/1/2020,Elizabeth Peinado,Imported from Bank of America Visa-Annual Greenhouse subscription,D111,HJ,935,,2161.42
6360,7/1/2020,7/1/2020,Elizabeth Peinado,Imported from Bank of America Visa-Annual Greenhouse subscription,D111,HJ,1445,,3606.42
6360,7/1/2020,7/1/2020,Elizabeth Peinado,Imported from Bank of America Visa-Annual Greenhouse subscription,D111,HJ,1445,,5051.42
6360,7/1/2020,7/1/2020,Elizabeth Peinado,Imported from Bank of America Visa-Annual Greenhouse subscription,D111,HJ,4675,,9726.42
6360,7/2/2020,7/2/2020,Miriam Kamya,Imported from Bank of America Visa-Monthly LinkedIn Subscription,D102,HJ,59.99,,9786.41
6360,7/2/2020,7/2/2020,Uriel Guadarrama,Imported from Bank of America Visa-Zoom host add on for Chris,D105,HJ,199.8,,9986.21
6360,7/3/2020,7/3/2020,Antonio Gutierrez,Imported from Bank of America Visa-Storage Space for google drive,D107,HJ,1.99,,9988.2
6360,7/5/2020,7/5/2020,Alan Safran,Imported from Bank of America Visa-Monthly google storage for Alan,D102,HJ,1.99,,9990.19
6360,7/8/2020,7/8/2020,Monivett Acevedo,Imported from Bank of America Visa-Abila -Financial Training,D103,HJ,460,,10450.19
6360,7/8/2020,7/8/2020,Monivett Acevedo,Imported from Bank of America Visa-Adobe Acrobat,D103,HJ,14.99,,10465.18
6360,7/8/2020,7/8/2020,Monivett Acevedo,Imported from Bank of America Visa-Bill.com AP,D103,HJ,156.6,,10621.78
6360,7/9/2020,7/9/2020,Joseph Zarate,Imported from Bank of America Visa-acrobat,D105,HJ,118.41,,10740.19
6360,7/10/2020,7/10/2020,Monivett Acevedo,Imported from Bank of America Visa-Abila,D103,HJ,,460,10280.19
6360,7/10/2020,7/10/2020,Uriel Guadarrama,Imported from Bank of America Visa-Zoom annual license for Claice,D105,HJ,291.72,,10571.91
6360,7/12/2020,7/12/2020,Antonio Gutierrez,Imported from Bank of America Visa-Phone and Fax System,D107,HJ,234.79,,10806.7
6360,7/14/2020,7/14/2020,Halley Bowman,Imported from Bank of America Visa-managing and PD materials. HBR subscription,D101,HJ,11.65,,10818.35
6360,7/14/2020,7/14/2020,Halley Bowman,Imported from Bank of America Visa-managing and PD materials. HBR subscription,D101,HJ,18.01,,10836.36
6360,7/14/2020,7/14/2020,Halley Bowman,Imported from Bank of America Visa-managing and PD materials. HBR subscription,D101,HJ,18.01,,10854.37
6360,7/14/2020,7/14/2020,Halley Bowman,Imported from Bank of America Visa-managing and PD materials. HBR subscription,D101,HJ,58.26,,10912.63
6360,7/14/2020,7/14/2020,Jennifer Winans,Imported from Bank of America Visa-Indeed; Recruitment Expenses,D111,HJ,5001.71,,15914.34
6360,7/18/2020,7/18/2020,Joseph Zarate,Imported from Bank of America Visa-Microsoft License monthly charges,D105,HJ,30.11,,15944.45
6360,7/23/2020,7/23/2020,Elizabeth Peinado,Imported from Bank of America Visa-Math Assessment Subscription,D111,HJ,4.39,,15948.84
6360,7/23/2020,7/23/2020,Elizabeth Peinado,Imported from Bank of America Visa-Math Assessment Subscription,D111,HJ,6.79,,15955.63
6360,7/23/2020,7/23/2020,Elizabeth Peinado,Imported from Bank of America Visa-Math Assessment Subscription,D111,HJ,6.79,,15962.42
6360,7/23/2020,7/23/2020,Elizabeth Peinado,Imported from Bank of America Visa-Math Assessment Subscription,D111,HJ,21.98,,15984.4
6360,7/23/2020,7/23/2020,Salesforce.org,Bill.Com Import-Fellows Licenses Lightning platform starter Enterprise edition. Quantity 217,D108,HJ,2656.08,,18640.48
6360,7/23/2020,7/23/2020,Salesforce.org,Bill.Com Import-Fellows Licenses Lightning platform starter Enterprise edition. Quantity 217,D108,HJ,8593.2,,27233.68
6360,7/23/2020,7/23/2020,Salesforce.org,Bill.Com Import-Fellows Licenses Lightning platform starter Enterprise edition. Quantity 217,D108,HJ,2656.08,,29889.76
6360,7/23/2020,7/23/2020,Salesforce.org,Bill.Com Import-Fellows Licenses Lightning platform starter Enterprise edition. Quantity 217,D108,HJ,1718.64,,31608.4
6360,7/30/2020,7/30/2020,Abila,Bill.Com Import-MIP Fund Accounting monthly software subscription,D103,HJ,250,,31858.4
6360,7/30/2020,7/30/2020,Antonio Gutierrez,Imported from Bank of America Visa-Unknown,D107,HJ,,1.99,31856.41
6360,7/30/2020,7/30/2020,Antonio Gutierrez,Imported from Bank of America Visa-Unknown,D107,HJ,1.99,,31858.4
6360,7/30/2020,7/30/2020,Uriel Guadarrama,Imported from Bank of America Visa-1 more Zoom license for BC SD,D105,HJ,14.38,,31872.78
6360,7/30/2020,7/30/2020,Uriel Guadarrama,Imported from Bank of America Visa-6 monthly licenses for BC SDs NAT staff,D105,HJ,13.3,,31886.08
6360,7/30/2020,7/30/2020,Uriel Guadarrama,Imported from Bank of America Visa-6 monthly licenses for BC SDs NAT staff,D105,HJ,13.31,,31899.39
6360,7/31/2020,7/31/2020,Abila,Bill.Com Import-Additional User purchase for Hernan and Executive seats for RPOMs,D103,HJ,110,,32009.39
6360,8/1/2020,8/1/2020,Antonio Gutierrez,Imported from Bank of America Visa-Expense Reporting,D107,HJ,1226.42,,33235.81
6360,8/1/2020,8/1/2020,Uriel Guadarrama,Imported from Bank of America Visa-17 monthly licenses for CHI SDs,D105,HJ,235.82,,33471.63
6360,8/1/2020,8/1/2020,Uriel Guadarrama,Imported from Bank of America Visa-14 monthly licenses for DC NYC SDs,D105,HJ,40.78,,33512.41
6360,8/1/2020,8/1/2020,Uriel Guadarrama,Imported from Bank of America Visa-14 monthly licenses for DC NYC SDs,D105,HJ,153.43,,33665.84
6360,8/1/2020,8/1/2020,Uriel Guadarrama,Imported from Bank of America Visa-Upgrade to Business from Pro,D105,HJ,3.52,,33669.36
6360,8/1/2020,8/1/2020,Uriel Guadarrama,Imported from Bank of America Visa-Upgrade to Business from Pro,D105,HJ,14.07,,33683.43
6360,8/1/2020,8/1/2020,Uriel Guadarrama,Imported from Bank of America Visa-Upgrade to Business from Pro,D105,HJ,28.13,,33711.56
6360,8/1/2020,8/1/2020,Uriel Guadarrama,Imported from Bank of America Visa-Upgrade to Business from Pro,D105,HJ,50.99,,33762.55
6360,8/1/2020,8/1/2020,Uriel Guadarrama,Imported from Bank of America Visa-Upgrade to Business from Pro,D105,HJ,79.11,,33841.66
6360,8/3/2020,8/3/2020,Antonio Gutierrez,Imported from Bank of America Visa-Storage Space,D107,HJ,1.99,,33843.65
6360,8/4/2020,8/4/2020,Woot Math Inc,Bill.Com Import-Woot Math platform for the 1st semester of FY21 for 4112 students. For NYC CHI and BWC-FL.,D108,HJ,29347.25,,63190.9
6360,8/4/2020,8/4/2020,Woot Math Inc,Bill.Com Import-Woot Math platform for the 1st semester of FY21 for 4112 students. For NYC CHI and BWC-FL.,D108,HJ,58694.5,,121885.4
6360,8/4/2020,8/4/2020,Woot Math Inc,Bill.Com Import-Woot Math platform for the 1st semester of FY21 for 4112 students. For NYC CHI and BWC-FL.,D108,HJ,29347.25,,151232.65
6360,8/5/2020,8/5/2020,Alan Safran,Imported from Bank of America Visa-Extra google storage for Alan,D102,HJ,1.99,,151234.64
6360,8/7/2020,8/7/2020,HRKnowledge,New training and development software Zyware-New training and development software Zyware,D104,HJ,4000,,155234.64
6360,8/8/2020,8/8/2020,Monivett Acevedo,Imported from Bank of America Visa-Accounts payable invoice,D103,HJ,195.26,,155429.9
6360,8/8/2020,8/8/2020,Monivett Acevedo,Imported from Bank of America Visa-Adobe,D103,HJ,14.99,,155444.89
6360,8/10/2020,8/10/2020,Uriel Guadarrama,Imported from Bank of America Visa-Document Studio for Jashive,D105,HJ,39,,155483.89
6360,8/12/2020,8/12/2020,Antonio Gutierrez,Imported from Bank of America Visa-Agent of record services,D107,HJ,299,,155782.89
6360,8/12/2020,8/12/2020,Antonio Gutierrez,Imported from Bank of America Visa-online phone and fax,D107,HJ,234.79,,156017.68
6360,8/12/2020,8/12/2020,Mahaliah Sejour,Imported from Bank of America Visa-Adobe video editor,D108,HJ,21.24,,156038.92
6360,8/14/2020,8/14/2020,Uriel Guadarrama,Imported from Bank of America Visa-Adobe apps for Mahaliah and Myesha,D105,HJ,5.94,,156044.86
6360,8/14/2020,8/14/2020,Uriel Guadarrama,Imported from Bank of America Visa-Adobe apps for Mahaliah and Myesha,D105,HJ,9.18,,156054.04
6360,8/14/2020,8/14/2020,Uriel Guadarrama,Imported from Bank of America Visa-Adobe apps for Mahaliah and Myesha,D105,HJ,9.18,,156063.22
6360,8/14/2020,8/14/2020,Uriel Guadarrama,Imported from Bank of America Visa-Adobe apps for Mahaliah and Myesha,D105,HJ,29.7,,156092.92
6360,8/15/2020,8/15/2020,Mahaliah Sejour,Imported from Bank of America Visa-Adobe trial refund,D108,HJ,,21.24,156071.68
6360,8/17/2020,8/17/2020,Uriel Guadarrama,Imported from Bank of America Visa-Document Studio for Jashive,D105,HJ,59.4,,156131.08
6360,8/18/2020,8/18/2020,Joseph Zarate,Imported from Bank of America Visa-New hire equipment,D105,HJ,347.7,,156478.78
6360,8/21/2020,8/21/2020,Elizabeth Peinado,Imported from Bank of America Visa-Math Assessment software,D111,HJ,4.39,,156483.17
6360,8/21/2020,8/21/2020,Elizabeth Peinado,Imported from Bank of America Visa-Math Assessment software,D111,HJ,6.79,,156489.96
6360,8/21/2020,8/21/2020,Elizabeth Peinado,Imported from Bank of America Visa-Math Assessment software,D111,HJ,6.79,,156496.75
6360,8/21/2020,8/21/2020,Elizabeth Peinado,Imported from Bank of America Visa-Math Assessment software,D111,HJ,21.98,,156518.73
6360,8/27/2020,8/27/2020,Salesforce.org,Bill.Com Import-Sales Cloud. Enterprise Edition,D108,HJ,66.52,,156585.25
6360,8/27/2020,8/27/2020,Salesforce.org,Bill.Com Import-Sales Cloud. Enterprise Edition,D108,HJ,215.23,,156800.48
6360,8/27/2020,8/27/2020,Salesforce.org,Bill.Com Import-Sales Cloud. Enterprise Edition,D108,HJ,66.52,,156867
6360,8/27/2020,8/27/2020,Salesforce.org,Bill.Com Import-Sales Cloud. Enterprise Edition,D108,HJ,43.05,,156910.05
6360,8/27/2020,8/27/2020,Uriel Guadarrama,Imported from Bank of America Visa-Zoom for SDs,D105,HJ,88.78,,156998.83
6360,8/27/2020,8/27/2020,Uriel Guadarrama,Imported from Bank of America Visa-Zoom for SDs,D105,HJ,137.21,,157136.04
6360,8/27/2020,8/27/2020,Uriel Guadarrama,Imported from Bank of America Visa-Zoom for SDs,D105,HJ,137.21,,157273.25
6360,8/27/2020,8/27/2020,Uriel Guadarrama,Imported from Bank of America Visa-Zoom for SDs,D105,HJ,443.9,,157717.15
6360,8/28/2020,8/28/2020,Abila,Bill.Com Import-Additional Users and subscriptions,D103,HJ,250,,157967.15
6360,8/28/2020,8/28/2020,Culture Amp,Bill.Com Import-Engagement Standard for up to 250 users,D104,HJ,9185.31,,167152.46
6360,8/31/2020,8/31/2020,Abila,Bill.Com Import-Additional Users and subscriptions,D103,HJ,110,,167262.46
6360,9/1/2020,9/1/2020,Antonio Gutierrez,Imported from Bank of America Visa-expense reporting,D107,HJ,1226.38,,168488.84
6360,9/2/2020,9/2/2020,Antonio Gutierrez,Imported from Bank of America Visa-storage space for google drive,D107,HJ,1.99,,168490.83
6360,9/2/2020,9/2/2020,Elecia D Lacey,Imported from Bank of America Visa-Final charge on behalf of Elecia,D104,HJ,49,,168539.83
6360,9/3/2020,9/3/2020,Uriel Guadarrama,Imported from Bank of America Visa-Monday.com licenses for 5 more users,D105,HJ,1456.55,,169996.38
6360,9/4/2020,9/4/2020,20200904,Cash Received from Facebook-Cash Received from Facebook,D107,HJ,,140,169856.38
6360,9/4/2020,9/4/2020,Alan Safran,Imported from Bank of America Visa-Monthly google storage cost,D107,HJ,1.99,,169858.37
6360,9/8/2020,9/8/2020,Monivett Acevedo,Imported from Bank of America Visa-ADOBE,D103,HJ,14.99,,169873.36
6360,9/8/2020,9/8/2020,Monivett Acevedo,Imported from Bank of America Visa-monthly accounting module,D103,HJ,210.77,,170084.13
6360,9/9/2020,9/9/2020,MCGRAW HILL,Bill.Com Import-Annual Aleks license for tech program. 137 quantity 31OCT 21,D101,HJ,4458.65,,174542.78
6360,9/9/2020,9/9/2020,MCGRAW HILL,Bill.Com Import-Annual Aleks license for tech program. 137 quantity 31OCT 21,D101,HJ,14425.09,,188967.87
6360,9/9/2020,9/9/2020,MCGRAW HILL,Bill.Com Import-Annual Aleks license for tech program. 137 quantity 31OCT 21,D101,HJ,4458.65,,193426.52
6360,9/9/2020,9/9/2020,MCGRAW HILL,Bill.Com Import-Annual Aleks license for tech program. 137 quantity 31OCT 21,D101,HJ,2885.05,,196311.57
6360,9/11/2020,9/11/2020,Amena Wallace,Imported from Bank of America Visa-Recruitment Inbox and Drive storage,D111,HJ,19.99,,196331.56
6360,9/12/2020,9/12/2020,Antonio Gutierrez,Imported from Bank of America Visa-phone and fax system,D107,HJ,234.79,,196566.35
6360,9/15/2020,9/15/2020,Uriel Guadarrama,Imported from Bank of America Visa-Up to 10 mail merge licenses for recruitment team,D105,HJ,240,,196806.35
6360,9/18/2020,9/18/2020,Joseph Zarate,Imported from Bank of America Visa-New hire equipment,D105,HJ,259.12,,197065.47
6360,9/21/2020,9/21/2020,Elizabeth Peinado,Imported from Bank of America Visa-Math assessment software,D111,HJ,4.39,,197069.86
6360,9/21/2020,9/21/2020,Elizabeth Peinado,Imported from Bank of America Visa-Math assessment software,D111,HJ,6.79,,197076.65
6360,9/21/2020,9/21/2020,Elizabeth Peinado,Imported from Bank of America Visa-Math assessment software,D111,HJ,6.79,,197083.44
6360,9/21/2020,9/21/2020,Elizabeth Peinado,Imported from Bank of America Visa-Math assessment software,D111,HJ,21.98,,197105.42
6360,9/21/2020,9/21/2020,Monivett Acevedo,Imported from Bank of America Visa-Amazon Prime annual fee,D103,HJ,499,,197604.42
6360,9/22/2020,9/22/2020,Antonio Gutierrez,Imported from Bank of America Visa-Compensation Analysis,D107,HJ,379,,197983.42
6360,9/22/2020,9/22/2020,Antonio Gutierrez,Imported from Bank of America Visa-Compensation Analysis,D107,HJ,399,,198382.42
6360,9/22/2020,9/22/2020,Joseph Zarate,Imported from Bank of America Visa-anti virus,D105,HJ,8,,198390.42
6360,9/22/2020,9/22/2020,Salesforce.org,Bill.Com Import-Lightning Platform Starter- Enterprise Edition,D105,HJ,132.6,,198523.02
6360,9/22/2020,9/22/2020,Salesforce.org,Bill.Com Import-Lightning Platform Starter- Enterprise Edition,D105,HJ,429,,198952.02
6360,9/22/2020,9/22/2020,Salesforce.org,Bill.Com Import-Lightning Platform Starter- Enterprise Edition,D105,HJ,132.6,,199084.62
6360,9/22/2020,9/22/2020,Salesforce.org,Bill.Com Import-Lightning Platform Starter- Enterprise Edition,D105,HJ,85.8,,199170.42
6360,9/22/2020,9/22/2020,Uriel Guadarrama,Imported from Bank of America Visa-Annual Zoom license for AJ,D105,HJ,75.76,,199246.18
6360,9/27/2020,9/27/2020,Uriel Guadarrama,Imported from Bank of America Visa-Zoom accounts for Andrew Cathryn Alan,D105,HJ,47.78,,199293.96
6360,9/30/2020,9/30/2020,Abila,Bill.Com Import-Additional Users and subscriptions,D103,HJ,110,,199403.96
6360,9/30/2020,9/30/2020,Abila,Bill.Com Import-Subscriptions,D103,HJ,250,,199653.96
6360,10/1/2020,10/1/2020,Antonio Gutierrez,Imported from reimbursements-expense reporting,D107,HJ,1226.38,,200880.34
6360,10/2/2020,10/2/2020,Antonio Gutierrez,Imported from reimbursements-Google Drive Storage,D107,HJ,1.99,,200882.33
6360,10/4/2020,10/4/2020,Alan Safran,Imported from reimbursements-Extra google storage for Alan,D102,HJ,1.99,,200884.32
6360,10/8/2020,10/8/2020,Elizabeth Peinado,Imported from reimbursements-Recruiter - corporate,D111,HJ,409.41,,201293.73
6360,10/8/2020,10/8/2020,Elizabeth Peinado,Imported from reimbursements-Recruiter - corporate,D111,HJ,632.72,,201926.45
6360,10/8/2020,10/8/2020,Elizabeth Peinado,Imported from reimbursements-Recruiter - corporate,D111,HJ,632.72,,202559.17
6360,10/8/2020,10/8/2020,Elizabeth Peinado,Imported from reimbursements-Recruiter - corporate,D111,HJ,2047.03,,204606.2
6360,10/8/2020,10/8/2020,Monivett Acevedo,Imported from reimbursements-Adobe Subscription,D103,HJ,14.99,,204621.19
6360,10/8/2020,10/8/2020,Monivett Acevedo,Imported from reimbursements-Bill.com fee,D103,HJ,159.72,,204780.91
6360,10/8/2020,10/8/2020,Uriel Guadarrama,Imported from reimbursements-Zoom licenses for Nancy Quionna,D105,HJ,20.18,,204801.09
6360,10/9/2020,10/9/2020,Tiffani Bibb,Imported from reimbursements-Approval Tool,D104,HJ,480,,205281.09
6360,10/9/2020,10/9/2020,Uriel Guadarrama,Imported from reimbursements-Zoom for Recruitment,D105,HJ,70.82,,205351.91
6360,10/12/2020,10/12/2020,Antonio Gutierrez,Imported from reimbursements-online phone and fax,D107,HJ,235.07,,205586.98
6360,10/14/2020,10/14/2020,Monivett Acevedo,Imported from reimbursements-Grammarly,D103,HJ,139.95,,205726.93
6360,10/17/2020,10/17/2020,Elizabeth Peinado,Imported from reimbursements-Scheduling software,D111,HJ,158.4,,205885.33
6360,10/17/2020,10/17/2020,Elizabeth Peinado,Imported from reimbursements-Scheduling software,D111,HJ,244.8,,206130.13
6360,10/17/2020,10/17/2020,Elizabeth Peinado,Imported from reimbursements-Scheduling software,D111,HJ,244.8,,206374.93
6360,10/17/2020,10/17/2020,Elizabeth Peinado,Imported from reimbursements-Scheduling software,D111,HJ,792,,207166.93
6360,10/18/2020,10/18/2020,Joseph Zarate,Imported from reimbursements-Microsoft License monthly charges,D105,HJ,311.48,,207478.41
6360,10/19/2020,10/19/2020,Antonio Gutierrez,Imported from reimbursements-Media Subscription,D111,HJ,47.88,,207526.29
6360,10/21/2020,10/21/2020,Elizabeth Peinado,Imported from reimbursements-Math assessment software,D111,HJ,4.39,,207530.68
6360,10/21/2020,10/21/2020,Elizabeth Peinado,Imported from reimbursements-Math assessment software,D111,HJ,6.79,,207537.47
6360,10/21/2020,10/21/2020,Elizabeth Peinado,Imported from reimbursements-Math assessment software,D111,HJ,6.79,,207544.26
6360,10/21/2020,10/21/2020,Elizabeth Peinado,Imported from reimbursements-Math assessment software,D111,HJ,21.98,,207566.24
6360,10/21/2020,10/21/2020,Joseph Zarate,Imported from reimbursements-Adobe license fees,D105,HJ,234.19,,207800.43
6360,10/21/2020,10/21/2020,Uriel Guadarrama,Imported from reimbursements-5 more Monday licenses for Woot,D105,HJ,1418.5,,209218.93
6360,10/21/2020,10/21/2020,Uriel Guadarrama,Imported from reimbursements-Webinar for AJ,D105,HJ,134.74,,209353.67
6360,10/21/2020,10/21/2020,Uriel Guadarrama,Imported from reimbursements-Zoom for Krista Marks,D105,HJ,67.34,,209421.01
6360,10/24/2020,10/24/2020,Joseph Zarate,Imported from reimbursements-software,D105,HJ,113.43,,209534.44
6360,10/26/2020,10/26/2020,Cathryn Cook,Imported from reimbursements-Adobe Creative Cloud for Kyra DeTone,D105,HJ,382.37,,209916.81
6360,10/26/2020,10/26/2020,Uriel Guadarrama,Imported from reimbursements-Monday licenses for Woot team,D105,HJ,1073.34,,210990.15
6360,10/27/2020,10/27/2020,Uriel Guadarrama,Imported from reimbursements-Dropbox for Woot team,D105,HJ,78.95,,211069.1
6360,10/27/2020,10/27/2020,Uriel Guadarrama,Imported from reimbursements-Monthly charge for SD Zoom accounts,D105,HJ,15.93,,211085.03
6360,10/27/2020,10/27/2020,Uriel Guadarrama,Imported from reimbursements-Monthly charge for SD Zoom accounts,D105,HJ,31.85,,211116.88
6360,10/27/2020,10/27/2020,Uriel Guadarrama,Imported from reimbursements-Monthly charge for SD Zoom accounts,D105,HJ,31.85,,211148.73
6360,10/28/2020,10/28/2020,Abila,Bill.Com Import-Subscriptions,D103,HJ,5936.51,,217085.24
6360,10/28/2020,10/28/2020,Uriel Guadarrama,Imported from reimbursements-Dropbox for Adam Gillian,D105,HJ,77.11,,217162.35
6360,10/30/2020,10/30/2020,Abila,Bill.Com Import-Additional Users and Subscriptions,D103,HJ,110,,217272.35
6360,10/30/2020,10/30/2020,Economic Research,Bill.Com Import-Salary Assessor,D104,HJ,3489,,220761.35
6360,10/30/2020,10/30/2020,Elizabeth Peinado,Imported from reimbursements-Recruiter- corporate seat,D111,HJ,409.41,,221170.76
6360,10/30/2020,10/30/2020,Elizabeth Peinado,Imported from reimbursements-Recruiter- corporate seat,D111,HJ,632.72,,221803.48
6360,10/30/2020,10/30/2020,Elizabeth Peinado,Imported from reimbursements-Recruiter- corporate seat,D111,HJ,632.72,,222436.2
6360,10/30/2020,10/30/2020,Elizabeth Peinado,Imported from reimbursements-Recruiter- corporate seat,D111,HJ,2047.03,,224483.23
6360,11/2/2020,11/2/2020,Angela Mason,Imported from Bank of America Visa-PayPro,D104,HJ,719.4,,225202.63
6360,11/3/2020,11/3/2020,Antonio Gutierrez,Imported from Bank of America Visa-Google Drive Storage,D107,HJ,1.99,,225204.62
6360,11/3/2020,11/3/2020,Thomas Fischaber,Imported from Bank of America Visa-code repository subscription,D109,HJ,94,,225298.62
6360,11/3/2020,11/3/2020,Thomas Fischaber,Imported from Bank of America Visa-wootmath.com email provider,D109,HJ,36.78,,225335.4
6360,11/4/2020,11/4/2020,Alan Safran,Imported from Bank of America Visa-Alan monthly google storage,D107,HJ,1.99,,225337.39
6360,11/4/2020,11/4/2020,EDUCATION WEEK,Bill.Com Import-EDWEEK.ORG SITE LICENSE renewal 11.15.20-11.15.21,D107,HJ,416.75,,225754.14
6360,11/4/2020,11/4/2020,Joseph Zarate,Imported from Bank of America Visa-software,D105,HJ,48.57,,225802.71
6360,11/6/2020,11/6/2020,Thomas Fischaber,Imported from Bank of America Visa-Software for wootmath.com,D109,HJ,1248,,227050.71
6360,11/6/2020,11/6/2020,Uriel Guadarrama,Imported from Bank of America Visa-5 more licences,D105,HJ,1170.98,,228221.69
6360,11/8/2020,11/8/2020,Monivett Acevedo,Imported from Bank of America Visa-Accounts payable module,D103,HJ,154.05,,228375.74
6360,11/8/2020,11/8/2020,Monivett Acevedo,Imported from Bank of America Visa-Adobe for Finance,D103,HJ,14.99,,228390.73
6360,11/8/2020,11/8/2020,Thomas Fischaber,Imported from Bank of America Visa-Phone system for Woot Math,D109,HJ,59,,228449.73
6360,11/8/2020,11/8/2020,Thomas Fischaber,Imported from Bank of America Visa-Software for woottutor.com,D109,HJ,7,,228456.73
6360,11/9/2020,11/9/2020,Salesforce.org,Bill.Com Import-Lightning Platform Starter. Enterprise Edition,D105,HJ,59.98,,228516.71
6360,11/9/2020,11/9/2020,Salesforce.org,Bill.Com Import-Lightning Platform Starter. Enterprise Edition,D105,HJ,194.04,,228710.75
6360,11/9/2020,11/9/2020,Salesforce.org,Bill.Com Import-Lightning Platform Starter. Enterprise Edition,D105,HJ,59.98,,228770.73
6360,11/9/2020,11/9/2020,Salesforce.org,Bill.Com Import-Lightning Platform Starter. Enterprise Edition,D105,HJ,38.81,,228809.54
6360,11/9/2020,11/9/2020,Thomas Fischaber,Imported from Bank of America Visa-tutorial recording servers,D109,HJ,119,,228928.54
6360,11/10/2020,11/10/2020,Halley Bowman,Imported from Bank of America Visa-Editing program,D101,HJ,15.39,,228943.93
6360,11/10/2020,11/10/2020,Halley Bowman,Imported from Bank of America Visa-Editing program,D101,HJ,23.79,,228967.72
6360,11/10/2020,11/10/2020,Halley Bowman,Imported from Bank of America Visa-Editing program,D101,HJ,23.79,,228991.51
6360,11/10/2020,11/10/2020,Halley Bowman,Imported from Bank of America Visa-Editing program,D101,HJ,76.98,,229068.49
6360,11/10/2020,11/10/2020,Uriel Guadarrama,Imported from Bank of America Visa-Tax refund from Monday,D105,HJ,,60.76,229007.73
6360,11/10/2020,11/10/2020,Uriel Guadarrama,Imported from Bank of America Visa-Tax refund from Monday,D105,HJ,,66.29,228941.44
6360,11/10/2020,11/10/2020,Uriel Guadarrama,Imported from Bank of America Visa-Tax refund from Monday,D105,HJ,,80.3,228861.14
6360,11/10/2020,11/10/2020,Uriel Guadarrama,Imported from Bank of America Visa-Tax refund from Monday,D105,HJ,,82.45,228778.69
6360,11/10/2020,11/10/2020,Uriel Guadarrama,Imported from Bank of America Visa-Tax refund from Monday,D105,HJ,,114.48,228664.21
6360,11/11/2020,11/11/2020,Joseph Zarate,Imported from Bank of America Visa-software,D105,HJ,44.42,,228708.63
6360,11/11/2020,11/11/2020,Joseph Zarate,Imported from Bank of America Visa-software,D105,HJ,44.42,,228753.05
6360,11/11/2020,11/11/2020,Thomas Fischaber,Imported from Bank of America Visa-Backup software,D109,HJ,9.99,,228763.04
6360,11/12/2020,11/12/2020,Antonio Gutierrez,Imported from Bank of America Visa-phone and fax system,D107,HJ,235.07,,228998.11
6360,11/14/2020,11/14/2020,Antonio Gutierrez,Imported from Bank of America Visa-Expense Reporting,D103,HJ,780.92,,229779.03
6360,11/16/2020,11/16/2020,Uriel Guadarrama,Imported from Bank of America Visa-Tax refund from Monday,D105,HJ,,55.23,229723.8
6360,11/18/2020,11/18/2020,Uriel Guadarrama,Imported from Bank of America Visa-Tax refund from Monday,D105,HJ,,281.65,229442.15
6360,11/21/2020,11/21/2020,Joseph Zarate,Imported from Bank of America Visa-software,D105,HJ,281.56,,229723.71
6360,11/23/2020,11/23/2020,Thomas Fischaber,Imported from Bank of America Visa-Google Play store subscription for Woot Math app,D109,HJ,25,,229748.71
6360,11/24/2020,11/24/2020,MCGRAW HILL,Bill.Com Import-Annual Aleks license for tech program. 500 quantity 31OCT21 . All for Chicago,D105,HJ,9990,,239738.71
6360,11/27/2020,11/27/2020,Uriel Guadarrama,Imported from Bank of America Visa-Monthly Zoom for staff,D105,HJ,15.93,,239754.64
6360,11/27/2020,11/27/2020,Uriel Guadarrama,Imported from Bank of America Visa-Monthly Zoom for staff,D105,HJ,31.85,,239786.49
6360,11/27/2020,11/27/2020,Uriel Guadarrama,Imported from Bank of America Visa-Monthly Zoom for staff,D105,HJ,31.85,,239818.34
6360,12/1/2020,12/1/2020,Abila,Bill.Com Import-Additional Users and Subscriptions,D103,HJ,110,,239928.34
6360,12/1/2020,12/1/2020,Abila,Bill.Com Import-Additional Users and Subscriptions,D103,HJ,250,,240178.34
6360,12/1/2020,12/1/2020,Antonio Gutierrez,Imported from Bank of America Visa-Expense Reporting,D107,HJ,530.67,,240709.01
6360,12/3/2020,12/3/2020,Antonio Gutierrez,Imported from Bank of America Visa-Storage Space,D107,HJ,1.99,,240711
6360,12/3/2020,12/3/2020,Thomas Fischaber,Imported from Bank of America Visa-Email marketing,D109,HJ,14.95,,240725.95
6360,12/3/2020,12/3/2020,Thomas Fischaber,Imported from Bank of America Visa-Software repository,D109,HJ,94,,240819.95
6360,12/5/2020,12/5/2020,Alan Safran,Imported from Bank of America Visa-Monthly Google storage for Alan,D102,HJ,1.99,,240821.94
6360,12/8/2020,12/8/2020,Monivett Acevedo,Imported from Bank of America Visa-AP system,D103,HJ,174.69,,240996.63
6360,12/8/2020,12/8/2020,Monivett Acevedo,Imported from Bank of America Visa-Monthly subscription for ADOBE,D107,HJ,14.99,,241011.62
6360,12/8/2020,12/8/2020,Thomas Fischaber,Imported from Bank of America Visa-Phone system for Woot Math,D109,HJ,59,,241070.62
6360,12/8/2020,12/8/2020,Thomas Fischaber,Imported from Bank of America Visa-SW for server management,D109,HJ,7,,241077.62
6360,12/9/2020,12/9/2020,Thomas Fischaber,Imported from Bank of America Visa-Stock photos for marketing,D109,HJ,29.87,,241107.49
6360,12/10/2020,12/10/2020,Halley Bowman,Imported from Bank of America Visa-NCTM for Halley.curriculum team,D101,HJ,16.39,,241123.88
6360,12/10/2020,12/10/2020,Halley Bowman,Imported from Bank of America Visa-NCTM for Halley.curriculum team,D101,HJ,25.33,,241149.21
6360,12/10/2020,12/10/2020,Halley Bowman,Imported from Bank of America Visa-NCTM for Halley.curriculum team,D101,HJ,25.33,,241174.54
6360,12/10/2020,12/10/2020,Halley Bowman,Imported from Bank of America Visa-NCTM for Halley.curriculum team,D101,HJ,81.95,,241256.49
6360,12/10/2020,12/10/2020,Maryellen Leneghan,Imported from Bank of America Visa-video software fee for the year refunded wrong purchase,D108,HJ,31.99,,241288.48
6360,12/11/2020,12/11/2020,Joseph Zarate,Imported from Bank of America Visa-Equipment,D105,HJ,23.53,,241312.01
6360,12/11/2020,12/11/2020,Maryellen Leneghan,Imported from Bank of America Visa-Refund for video platform for the year,D108,HJ,,31.99,241280.02
6360,12/11/2020,12/11/2020,Maryellen Leneghan,Imported from Bank of America Visa-video software fee for the year for 3 regions,D108,HJ,0.64,,241280.66
6360,12/11/2020,12/11/2020,Maryellen Leneghan,Imported from Bank of America Visa-video software fee for the year for 3 regions,D108,HJ,4.95,,241285.61
6360,12/11/2020,12/11/2020,Maryellen Leneghan,Imported from Bank of America Visa-video software fee for the year for 3 regions,D108,HJ,35.99,,241321.6
6360,12/11/2020,12/11/2020,Thomas Fischaber,Imported from Bank of America Visa-Backups,D109,HJ,9.99,,241331.59
6360,12/12/2020,12/12/2020,Antonio Gutierrez,Imported from Bank of America Visa-Online Phone and Fax,D107,HJ,235.07,,241566.66
6360,12/14/2020,12/14/2020,Maryellen Leneghan,Imported from Bank of America Visa-Refund for video platform for the year,D108,HJ,,0.64,241566.02
6360,12/14/2020,12/14/2020,Maryellen Leneghan,Imported from Bank of America Visa-video software fee for the year for 3 regions,D108,HJ,0.1,,241566.12
6360,12/14/2020,12/14/2020,Maryellen Leneghan,Imported from Bank of America Visa-video software fee for the year for 3 regions,D108,HJ,0.72,,241566.84
6360,12/17/2020,12/17/2020,Thomas Fischaber,Imported from Bank of America Visa-Refund . Woot Math testing,D109,HJ,,58.95,241507.89
6360,12/17/2020,12/17/2020,Thomas Fischaber,Imported from Bank of America Visa-Woot Math testing,D109,HJ,58.95,,241566.84
6360,12/18/2020,12/18/2020,Joseph Zarate,Imported from Bank of America Visa-software,D105,HJ,281.56,,241848.4
6360,12/21/2020,12/21/2020,Elizabeth Peinado,Imported from Bank of America Visa-Math Assessment Subscription,D111,HJ,4.39,,241852.79
6360,12/21/2020,12/21/2020,Elizabeth Peinado,Imported from Bank of America Visa-Math Assessment Subscription,D111,HJ,6.79,,241859.58
6360,12/21/2020,12/21/2020,Elizabeth Peinado,Imported from Bank of America Visa-Math Assessment Subscription,D111,HJ,6.79,,241866.37
6360,12/21/2020,12/21/2020,Elizabeth Peinado,Imported from Bank of America Visa-Math Assessment Subscription,D111,HJ,21.98,,241888.35
6360,12/21/2020,12/21/2020,Uriel Guadarrama,Imported from Bank of America Visa-Monday for new Academics members,D105,HJ,620.95,,242509.3
6360,12/22/2020,12/22/2020,Uriel Guadarrama,Imported from Bank of America Visa-Tax refund for new Monday licenses,D105,HJ,,35.15,242474.15
6360,12/27/2020,12/27/2020,Uriel Guadarrama,Imported from Bank of America Visa-Monthly Zoom for 5 users,D105,HJ,15.93,,242490.08
6360,12/27/2020,12/27/2020,Uriel Guadarrama,Imported from Bank of America Visa-Monthly Zoom for 5 users,D105,HJ,31.85,,242521.93
6360,12/27/2020,12/27/2020,Uriel Guadarrama,Imported from Bank of America Visa-Monthly Zoom for 5 users,D105,HJ,31.85,,242553.78
6360,12/29/2020,12/29/2020,Abila,Bill.Com Import-Additional Users and Subscriptions,D103,HJ,250,,242803.78
6360,12/30/2020,12/30/2020,Abila,Bill.Com Import-Additional Users and Subscriptions,D103,HJ,110,,242913.78
6360,12/30/2020,12/30/2020,Antonio Gutierrez,Imported from Bank of America Visa-Expense Reporting,D103,HJ,780.92,,243694.7
6360,12/31/2020,12/31/2020,20201231,Actual vs Budget Reclass as of 12/31/2020-Actual vs Budget Reclass as of 12/31/2020,D101,HJ,,26227.44,217467.26
6360,12/31/2020,12/31/2020,20201231,Actual vs Budget Reclass as of 12/31/2020-Actual vs Budget Reclass as of 12/31/2020,D105,HJ,2724.19,,220191.45
6360,12/31/2020,12/31/2020,20201231,Actual vs Budget Reclass as of 12/31/2020-Actual vs Budget Reclass as of 12/31/2020,D105,HJ,26227.44,,246418.89
6360,12/31/2020,12/31/2020,20201231,Actual vs Budget Reclass as of 12/31/2020-Actual vs Budget Reclass as of 12/31/2020,D105,HJ,32069.85,,278488.74
6360,12/31/2020,12/31/2020,20201231,Actual vs Budget Reclass as of 12/31/2020-Actual vs Budget Reclass as of 12/31/2020,D105,HJ,33557.35,,312046.09
6360,12/31/2020,12/31/2020,20201231,Actual vs Budget Reclass as of 12/31/2020-Actual vs Budget Reclass as of 12/31/2020,D105,HJ,67502.93,,379549.02
6360,12/31/2020,12/31/2020,20201231,Actual vs Budget Reclass as of 12/31/2020-Actual vs Budget Reclass as of 12/31/2020,D107,HJ,,299,379250.02
6360,12/31/2020,12/31/2020,20201231,Actual vs Budget Reclass as of 12/31/2020-Actual vs Budget Reclass as of 12/31/2020,D107,HJ,299,,379549.02
6360,12/31/2020,12/31/2020,20201231,Actual vs Budget Reclass as of 12/31/2020-Actual vs Budget Reclass as of 12/31/2020,D108,HJ,,41.76,379507.26
6360,12/31/2020,12/31/2020,20201231,Actual vs Budget Reclass as of 12/31/2020-Actual vs Budget Reclass as of 12/31/2020,D108,HJ,,2724.19,376783.07
6360,12/31/2020,12/31/2020,20201231,Actual vs Budget Reclass as of 12/31/2020-Actual vs Budget Reclass as of 12/31/2020,D108,HJ,,33557.35,343225.72
6360,12/31/2020,12/31/2020,20201231,Actual vs Budget Reclass as of 12/31/2020-Actual vs Budget Reclass as of 12/31/2020,D108,HJ,,33557.35,309668.37
6360,12/31/2020,12/31/2020,20201231,Actual vs Budget Reclass as of 12/31/2020-Actual vs Budget Reclass as of 12/31/2020,D108,HJ,,72315.43,237352.94
6360,12/31/2020,12/31/2020,20201231,Actual vs Budget Reclass as of 12/31/2020-Actual vs Budget Reclass as of 12/31/2020,D111,HJ,,130215.68,107137.26
6360,1/3/2021,1/3/2021,Antonio Gutierrez,Imported from Bank of America Visa-Storage Space for google drive,D107,HJ,1.99,,107139.25
6360,1/3/2021,1/3/2021,Thomas Fischaber,Imported from Bank of America Visa-sw repository,D109,HJ,94,,107233.25
6360,1/4/2021,1/4/2021,Uriel Guadarrama,Imported from Bank of America Visa-Dropbox for mpires,D105,HJ,7.8,,107241.05
6360,1/5/2021,1/5/2021,Alan Safran,Imported from Bank of America Visa-Google Storage for Alan Monthly Subscription,D107,HJ,1.99,,107243.04
6360,1/5/2021,1/5/2021,Antonio Gutierrez,Imported from Bank of America Visa-Computer security,D107,HJ,95.61,,107338.65
6360,1/6/2021,1/6/2021,Thomas Fischaber,Imported from Bank of America Visa-email marketing,D109,HJ,33.28,,107371.93
6360,1/8/2021,1/8/2021,Halley Bowman,Imported from Bank of America Visa-Editing.plagiarism software for Mallory Parets,D101,HJ,8.25,,107380.18
6360,1/8/2021,1/8/2021,Halley Bowman,Imported from Bank of America Visa-Editing.plagiarism software for Mallory Parets,D101,HJ,12.75,,107392.93
6360,1/8/2021,1/8/2021,Halley Bowman,Imported from Bank of America Visa-Editing.plagiarism software for Mallory Parets,D101,HJ,12.75,,107405.68
6360,1/8/2021,1/8/2021,Halley Bowman,Imported from Bank of America Visa-Editing.plagiarism software for Mallory Parets,D101,HJ,41.25,,107446.93
6360,1/8/2021,1/8/2021,Monivett Acevedo,Imported from Bank of America Visa-AP services,D107,HJ,199.07,,107646
6360,1/8/2021,1/8/2021,Monivett Acevedo,Imported from Bank of America Visa-Adobe Subscription,D107,HJ,14.99,,107660.99
6360,1/8/2021,1/8/2021,Thomas Fischaber,Imported from Bank of America Visa-docker,D109,HJ,53,,107713.99
6360,1/8/2021,1/8/2021,Thomas Fischaber,Imported from Bank of America Visa-woot math phone,D109,HJ,59,,107772.99
6360,1/9/2021,1/9/2021,Thomas Fischaber,Imported from Bank of America Visa-stock photo,D109,HJ,29.87,,107802.86
6360,1/10/2021,1/10/2021,Mahaliah Sejour,Imported from Bank of America Visa-video edit,D108,HJ,21.24,,107824.1
6360,1/11/2021,1/11/2021,Thomas Fischaber,Imported from Bank of America Visa-backup,D109,HJ,9.99,,107834.09
6360,1/12/2021,1/12/2021,Antonio Gutierrez,Imported from Bank of America Visa-Online phone and fax,D107,HJ,235.79,,108069.88
6360,1/12/2021,1/12/2021,Carnegie Learning,Bill.Com Import-MATHia Professional Development,D112,HJ,4500,,112569.88
6360,1/14/2021,1/14/2021,Clever Inc.,Bill.Com Import-8 Month Subscription for 800 connections . Nov20 to June21. Simbulus Inc dba Woot Math,D109,HJ,12000,,124569.88
6360,1/15/2021,1/15/2021,Uriel Guadarrama,Imported from Bank of America Visa-Zoom annual for Alan,D105,HJ,42.38,,124612.26
6360,1/17/2021,1/17/2021,Antonio Gutierrez,Imported from Bank of America Visa-Marketing,D107,HJ,4,,124616.26
6360,1/18/2021,1/18/2021,Joseph Zarate,Imported from Bank of America Visa-Microsoft License monthly charges,D105,HJ,299.05,,124915.31
6360,1/20/2021,1/20/2021,Uriel Guadarrama,Imported from Bank of America Visa-Annual Dropbox licenses for National teams,D105,HJ,3024,,127939.31
6360,1/21/2021,1/21/2021,Elizabeth Peinado,Imported from Bank of America Visa-Math Assessment subscription,D111,HJ,4.39,,127943.7
6360,1/21/2021,1/21/2021,Elizabeth Peinado,Imported from Bank of America Visa-Math Assessment subscription,D111,HJ,6.79,,127950.49
6360,1/21/2021,1/21/2021,Elizabeth Peinado,Imported from Bank of America Visa-Math Assessment subscription,D111,HJ,6.79,,127957.28
6360,1/21/2021,1/21/2021,Elizabeth Peinado,Imported from Bank of America Visa-Math Assessment subscription,D111,HJ,21.98,,127979.26
6360,1/25/2021,1/25/2021,Joseph Zarate,Imported from Bank of America Visa-Adobe license fees,D105,HJ,3925.21,,131904.47
6360,1/26/2021,1/26/2021,Joseph Zarate,Imported from Bank of America Visa-Twilio,D109,HJ,100,,132004.47
6360,1/26/2021,1/26/2021,Knowre Americas Inc,Bill.Com Import-Knowre Marth Professional Development,D112,HJ,4000,,136004.47
6360,1/27/2021,1/27/2021,Uriel Guadarrama,Imported from Bank of America Visa-Monthly Zoom licenses,D105,HJ,15.93,,136020.4
6360,1/27/2021,1/27/2021,Uriel Guadarrama,Imported from Bank of America Visa-Monthly Zoom licenses,D105,HJ,15.93,,136036.33
6360,1/27/2021,1/27/2021,Uriel Guadarrama,Imported from Bank of America Visa-Monthly Zoom licenses,D105,HJ,31.85,,136068.18
6360,1/29/2021,1/29/2021,Elizabeth Peinado,Imported from Bank of America Visa-Recruiter Subscription for Talent Team,D111,HJ,409.4,,136477.58
6360,1/29/2021,1/29/2021,Elizabeth Peinado,Imported from Bank of America Visa-Recruiter Subscription for Talent Team,D111,HJ,632.72,,137110.3
6360,1/29/2021,1/29/2021,Elizabeth Peinado,Imported from Bank of America Visa-Recruiter Subscription for Talent Team,D111,HJ,632.72,,137743.02
6360,1/29/2021,1/29/2021,Elizabeth Peinado,Imported from Bank of America Visa-Recruiter Subscription for Talent Team,D111,HJ,2047.02,,139790.04
6360,2/1/2021,2/1/2021,Abila,Bill.Com Import-Monthly Cost for users and subscriptions,D103,HJ,250,,140040.04
6360,2/1/2021,2/1/2021,Antonio Gutierrez,Imported from Bank of America Visa-Expense Reporting,D103,HJ,780.92,,140820.96
6360,2/1/2021,2/1/2021,Monivett Acevedo,Imported from Bank of America Visa-Storage,D107,HJ,19.99,,140840.95
6360,2/1/2021,2/1/2021,Thomas Fischaber,Imported from Bank of America Visa-docker,D109,HJ,468,,141308.95
6360,2/2/2021,2/2/2021,Abila,Bill.Com Import-Monthly cost of additional Users and Subscriptions,D103,HJ,110,,141418.95
6360,2/2/2021,2/2/2021,Thomas Fischaber,Imported from Bank of America Visa-woot math email,D109,HJ,84,,141502.95
6360,2/3/2021,2/3/2021,Antonio Gutierrez,Imported from Bank of America Visa-google drive storage,D107,HJ,1.99,,141504.94
6360,2/3/2021,2/3/2021,Thomas Fischaber,Imported from Bank of America Visa-code repository,D109,HJ,94,,141598.94
6360,2/3/2021,2/3/2021,Thomas Fischaber,Imported from Bank of America Visa-email marketing,D109,HJ,35.15,,141634.09
6360,2/4/2021,2/4/2021,Alan Safran,Imported from Bank of America Visa-Google Storage for Alan Monthly Subscription,D107,HJ,1.99,,141636.08
6360,2/4/2021,2/4/2021,Uriel Guadarrama,Imported from Bank of America Visa-Monthly Zoom license for kdetone,D105,HJ,11.82,,141647.9
6360,2/5/2021,2/5/2021,DocuSign,Bill.Com Import-E.signature business pro edition envelope subs and premier support,D104,HJ,5000,,146647.9
6360,2/8/2021,2/8/2021,Monivett Acevedo,Imported from Bank of America Visa-AP module,D107,HJ,178.18,,146826.08
6360,2/8/2021,2/8/2021,Monivett Acevedo,Imported from Bank of America Visa-Adobe for CFO,D107,HJ,14.99,,146841.07
6360,2/8/2021,2/8/2021,Thomas Fischaber,Imported from Bank of America Visa-woot math phone system,D109,HJ,59,,146900.07
6360,2/9/2021,2/9/2021,Thomas Fischaber,Imported from Bank of America Visa-marketing photos,D109,HJ,29.87,,146929.94
6360,2/11/2021,2/11/2021,Joseph Zarate,Imported from Bank of America Visa-Returns,D105,HJ,206.53,,147136.47
6360,2/12/2021,2/12/2021,Antonio Gutierrez,Imported from Bank of America Visa-Online Phone and Fax,D107,HJ,235.79,,147372.26
6360,2/12/2021,2/12/2021,Thomas Fischaber,Imported from Bank of America Visa-backup software,D109,HJ,9.99,,147382.25
6360,2/17/2021,2/17/2021,Antonio Gutierrez,Imported from Bank of America Visa-media subscription,D107,HJ,4,,147386.25
6360,2/19/2021,2/19/2021,Joseph Zarate,Imported from Bank of America Visa-software,D105,HJ,299.9,,147686.15
6360,2/21/2021,2/21/2021,Elizabeth Peinado,Imported from Bank of America Visa-Math Assessment subscription,D111,HJ,4.39,,147690.54
6360,2/21/2021,2/21/2021,Elizabeth Peinado,Imported from Bank of America Visa-Math Assessment subscription,D111,HJ,6.79,,147697.33
6360,2/21/2021,2/21/2021,Elizabeth Peinado,Imported from Bank of America Visa-Math Assessment subscription,D111,HJ,6.79,,147704.12
6360,2/21/2021,2/21/2021,Elizabeth Peinado,Imported from Bank of America Visa-Math Assessment subscription,D111,HJ,21.98,,147726.1
6360,2/23/2021,2/23/2021,Joseph Zarate,Imported from Bank of America Visa-software,D105,HJ,1298,,149024.1
6360,2/25/2021,2/25/2021,Amena Wallace,Imported from Bank of America Visa-Survey Monkey Annual Subscription,D104,HJ,288,,149312.1
6360,3/1/2021,3/1/2021,Antonio Gutierrez,Imported from Bank of America Visa,D103,HJ,780.92,,150093.02
6360,3/1/2021,3/1/2021,Thomas Fischaber,Imported from Bank of America Visa,D109,HJ,84,,150177.02
6360,3/1/2021,3/1/2021,Uriel Guadarrama,Imported from Bank of America Visa,D105,HJ,15.93,,150192.95
6360,3/1/2021,3/1/2021,Uriel Guadarrama,Imported from Bank of America Visa,D105,HJ,31.85,,150224.8
6360,3/1/2021,3/1/2021,Uriel Guadarrama,Imported from Bank of America Visa,D105,HJ,31.85,,150256.65
6360,3/2/2021,3/2/2021,Antonio Gutierrez,Imported from Bank of America Visa,D107,HJ,1.99,,150258.64
6360,3/2/2021,3/2/2021,Elizabeth Peinado,Imported from Bank of America Visa,D111,HJ,4.39,,150263.03
6360,3/2/2021,3/2/2021,Elizabeth Peinado,Imported from Bank of America Visa,D111,HJ,6.79,,150269.82
6360,3/2/2021,3/2/2021,Elizabeth Peinado,Imported from Bank of America Visa,D111,HJ,6.79,,150276.61
6360,3/2/2021,3/2/2021,Elizabeth Peinado,Imported from Bank of America Visa,D111,HJ,21.98,,150298.59
6360,3/2/2021,3/2/2021,Thomas Fischaber,Imported from Bank of America Visa,D109,HJ,,94,150204.59
6360,3/2/2021,3/2/2021,Uriel Guadarrama,Imported from Bank of America Visa,D106,HJ,1358.26,,151562.85
6360,3/3/2021,3/3/2021,Joseph Zarate,Imported from Bank of America Visa,D105,HJ,582.48,,152145.33
6360,3/3/2021,3/3/2021,Mathspace,Bill.Com Import,D112,HJ,4500,,156645.33
6360,3/5/2021,3/5/2021,Alan Safran,Imported from Bank of America Visa,D107,HJ,1.99,,156647.32
6360,3/5/2021,3/5/2021,Thomas Fischaber,Imported from Bank of America Visa,D109,HJ,14.95,,156662.27
6360,3/8/2021,3/8/2021,Thomas Fischaber,Imported from Bank of America Visa,D109,HJ,59,,156721.27
6360,3/9/2021,3/9/2021,Thomas Fischaber,Imported from Bank of America Visa,D109,HJ,29.87,,156751.14
6360,3/9/2021,3/9/2021,Uriel Guadarrama,Imported from Bank of America Visa,D106,HJ,145.91,,156897.05
6360,3/10/2021,3/10/2021,Monivett Acevedo,Imported from Bank of America Visa,D107,HJ,14.99,,156912.04
6360,3/10/2021,3/10/2021,Uriel Guadarrama,Imported from Bank of America Visa,D106,HJ,,81.5,156830.54
6360,3/12/2021,3/12/2021,Antonio Gutierrez,Imported from Bank of America Visa,D107,HJ,235.79,,157066.33
6360,3/12/2021,3/12/2021,Monivett Acevedo,Imported from Bank of America Visa,D107,HJ,223.76,,157290.09
6360,3/12/2021,3/12/2021,Thomas Fischaber,Imported from Bank of America Visa,D109,HJ,9.99,,157300.08
6360,3/13/2021,3/13/2021,Tiffani Bibb,Imported from Bank of America Visa,D104,HJ,26.07,,157326.15
6360,3/16/2021,3/16/2021,Joseph Zarate,Imported from Bank of America Visa,D105,HJ,373.89,,157700.04
6360,3/16/2021,3/16/2021,Uriel Guadarrama,Imported from Bank of America Visa,D106,HJ,,72.27,157627.77
6360,3/17/2021,3/17/2021,Antonio Gutierrez,Imported from Bank of America Visa,D107,HJ,4,,157631.77
6360,3/17/2021,3/17/2021,Joseph Zarate,Imported from Bank of America Visa,D105,HJ,212.24,,157844.01
6360,3/18/2021,3/18/2021,Antonio Gutierrez,Imported from Bank of America Visa,D107,HJ,15.93,,157859.94
6360,3/18/2021,3/18/2021,Wipfli LLP,Bill.Com Import,D103,HJ,6000,,163859.94
6360,3/19/2021,3/19/2021,Joseph Zarate,Imported from Bank of America Visa,D105,HJ,326.73,,164186.67
6360,3/19/2021,3/19/2021,Sage Intacct,Bill.Com Import,D103,HJ,39718.1,,203904.77
6360,3/24/2021,3/24/2021,Abila,Bill.Com Import,D103,HJ,110,,204014.77
6360,3/24/2021,3/24/2021,Abila,Bill.Com Import,D103,HJ,250,,204264.77
6360,3/24/2021,3/24/2021,claice Jackson,Imported from Bank of America Visa,D108,HJ,67.45,,204332.22
6360,3/24/2021,3/24/2021,HP Inc.,Bill.Com Import,D105,HJ,18609.88,,222942.1
6360,3/24/2021,3/24/2021,Joseph Zarate,Imported from Bank of America Visa,D105,HJ,74.98,,223017.08
6360,3/24/2021,3/24/2021,Thomas Fischaber,Imported from Bank of America Visa,D109,HJ,40.78,,223057.86
6360,3/24/2021,3/24/2021,Thomas Fischaber,Imported from Bank of America Visa,D109,HJ,94,,223151.86
6360,3/24/2021,3/24/2021,Uriel Guadarrama,Imported from Bank of America Visa,D105,HJ,15.93,,223167.79
6360,3/24/2021,3/24/2021,Uriel Guadarrama,Imported from Bank of America Visa,D105,HJ,31.85,,223199.64
6360,3/24/2021,3/24/2021,Uriel Guadarrama,Imported from Bank of America Visa,D105,HJ,31.85,,223231.49
6360,4/1/2021,4/1/2021,Amena Wallace,Imported from Bank of America Visa,D104,HJ,14.95,,223246.44
6360,4/1/2021,4/1/2021,Antonio Gutierrez,Imported from Bank of America Visa,D103,HJ,780.92,,224027.36
6360,4/1/2021,4/1/2021,Antonio Gutierrez,Imported from Bank of America Visa,D107,HJ,19.11,,224046.47
6360,4/1/2021,4/1/2021,claice Jackson,Imported from Bank of America Visa,D108,HJ,,67.45,223979.02
6360,4/1/2021,4/1/2021,Mahaliah Sejour,Imported from Bank of America Visa,D108,HJ,21.24,,224000.26
6360,4/1/2021,4/1/2021,Thomas Fischaber,Imported from Bank of America Visa,D109,HJ,9.99,,224010.25
6360,4/2/2021,4/2/2021,Joseph Zarate,Imported from Bank of America Visa,D105,HJ,3024.54,,227034.79
6360,4/5/2021,4/5/2021,Joseph Zarate,Imported from Bank of America Visa,D105,HJ,12578,,239612.79
6360,4/5/2021,4/5/2021,Thomas Fischaber,Imported from Bank of America Visa,D109,HJ,572.88,,240185.67
6360,4/5/2021,4/5/2021,Wipfli LLP,Bill.Com Import,D103,HJ,13999,,254184.67
6360,4/7/2021,4/7/2021,Angela Mason,Imported from Bank of America Visa,D104,HJ,32.69,,254217.36
6360,4/7/2021,4/7/2021,Monivett Acevedo,Imported from Bank of America Visa,D107,HJ,14.99,,254232.35
6360,4/7/2021,4/7/2021,Monivett Acevedo,Imported from Bank of America Visa,D107,HJ,228.7,,254461.05
6360,4/7/2021,4/7/2021,Thomas Fischaber,Imported from Bank of America Visa,D109,HJ,29.87,,254490.92
6360,4/7/2021,4/7/2021,Thomas Fischaber,Imported from Bank of America Visa,D109,HJ,59,,254549.92
6360,4/12/2021,4/12/2021,Antonio Gutierrez,Imported from Bank of America Visa,D107,HJ,235.17,,254785.09
6360,4/12/2021,4/12/2021,Joseph Zarate,Imported from Bank of America Visa,D105,HJ,34.24,,254819.33
6360,4/13/2021,4/13/2021,Franklin Covey,Bill.Com Import,D104,HJ,22473,,277292.33
6360,4/13/2021,4/13/2021,Tiffani Bibb,Imported from Bank of America Visa,D104,HJ,26.07,,277318.4
6360,4/15/2021,4/15/2021,JumpCloud Inc,Bill.Com Import,D109,HJ,3442.5,,280760.9
6360,4/15/2021,4/15/2021,Thomas Fischaber,Imported from Bank of America Visa,D109,HJ,,25,280735.9
6360,4/15/2021,4/15/2021,Thomas Fischaber,Imported from Bank of America Visa,D109,HJ,,25,280710.9
6360,4/15/2021,4/15/2021,Tiffani Bibb,Imported from reimbursements,D104,HJ,92.9,,280803.8
6360,4/15/2021,4/15/2021,Tiffani Bibb,Imported from reimbursements,D104,HJ,649,,281452.8
6360,4/16/2021,4/16/2021,Antonio Gutierrez,Imported from Bank of America Visa,D107,HJ,4,,281456.8
6360,4/16/2021,4/16/2021,Antonio Gutierrez,Imported from Bank of America Visa,D107,HJ,15.93,,281472.73
6360,4/16/2021,4/16/2021,Joseph Zarate,Imported from Bank of America Visa,D105,HJ,351.13,,281823.86
6360,4/19/2021,4/19/2021,Thomas Fischaber,Imported from Bank of America Visa,D109,HJ,84,,281907.86
6360,4/21/2021,4/21/2021,Elizabeth Peinado,Imported from Bank of America Visa,D111,HJ,4.39,,281912.25
6360,4/21/2021,4/21/2021,Elizabeth Peinado,Imported from Bank of America Visa,D111,HJ,6.79,,281919.04
6360,4/21/2021,4/21/2021,Elizabeth Peinado,Imported from Bank of America Visa,D111,HJ,6.79,,281925.83
6360,4/21/2021,4/21/2021,Elizabeth Peinado,Imported from Bank of America Visa,D111,HJ,21.98,,281947.81
6360,4/22/2021,4/22/2021,Thomas Fischaber,Imported from Bank of America Visa,D109,HJ,99,,282046.81
6360,4/23/2021,4/23/2021,Antonio Gutierrez,Imported from Bank of America Visa,D107,HJ,12.99,,282059.8
6360,4/27/2021,4/27/2021,Joseph Zarate,Imported from Bank of America Visa,D105,HJ,161.43,,282221.23
6360,4/27/2021,4/27/2021,Thomas Fischaber,Imported from Bank of America Visa,D109,HJ,42.37,,282263.6
6360,4/27/2021,4/27/2021,Uriel Guadarrama,Imported from Bank of America Visa,D105,HJ,15.93,,282279.53
6360,4/27/2021,4/27/2021,Uriel Guadarrama,Imported from Bank of America Visa,D105,HJ,31.85,,282311.38
6360,4/27/2021,4/27/2021,Uriel Guadarrama,Imported from Bank of America Visa,D105,HJ,31.85,,282343.23
6360,4/29/2021,4/29/2021,Antonio Gutierrez,Imported from Bank of America Visa,D107,HJ,1.99,,282345.22
6360,4/29/2021,4/29/2021,Thomas Fischaber,Imported from Bank of America Visa,D109,HJ,94,,282439.22
6360,4/30/2021,4/30/2021,Alan Safran,Imported from Bank of America Visa,D107,HJ,1.99,,282441.21
6360,4/30/2021,4/30/2021,Thomas Fischaber,Imported from Bank of America Visa,D109,HJ,14.95,,282456.16
6360,5/1/2021,5/1/2021,Mahaliah Sejour,Imported from Bank of America Visa,D108,HJ,21.24,,282477.4
6360,5/3/2021,5/3/2021,Antonio Gutierrez,Imported from Bank of America Visa,D111,HJ,1.99,,282479.39
6360,5/3/2021,5/3/2021,Thomas Fischaber,Imported from Bank of America Visa,D109,HJ,69,,282548.39
6360,5/4/2021,5/4/2021,Thomas Fischaber,Imported from Bank of America Visa,D109,HJ,40.02,,282588.41
6360,5/5/2021,5/5/2021,Alan Safran,Imported from Bank of America Visa,D107,HJ,1.99,,282590.4
6360,5/5/2021,5/5/2021,Antonio Gutierrez,Imported from Bank of America Visa,D111,HJ,,12.99,282577.41
6360,5/7/2021,5/7/2021,Monivett Acevedo,Imported from Bank of America Visa,D107,HJ,14.99,,282592.4
6360,5/7/2021,5/7/2021,Monivett Acevedo,Imported from Bank of America Visa,D107,HJ,239.1,,282831.5
6360,5/7/2021,5/7/2021,Thomas Fischaber,Imported from Bank of America Visa,D109,HJ,29.87,,282861.37
6360,5/7/2021,5/7/2021,Thomas Fischaber,Imported from Bank of America Visa,D109,HJ,59,,282920.37
6360,5/11/2021,5/11/2021,Antonio Gutierrez,Imported from Bank of America Visa,D111,HJ,19.11,,282939.48
6360,5/11/2021,5/11/2021,Thomas Fischaber,Imported from Bank of America Visa,D109,HJ,9.99,,282949.47
6360,5/12/2021,5/12/2021,Antonio Gutierrez,Imported from Bank of America Visa,D111,HJ,235.17,,283184.64
6360,5/17/2021,5/17/2021,Antonio Gutierrez,Imported from Bank of America Visa,D111,HJ,4,,283188.64
6360,5/17/2021,5/17/2021,Antonio Gutierrez,Imported from Bank of America Visa,D111,HJ,15.93,,283204.57
6360,5/17/2021,5/17/2021,Nicole Horton,Imported from Bank of America Visa,D108,HJ,1,,283205.57
6360,5/18/2021,5/18/2021,Antonio Gutierrez,Imported from Bank of America Visa,D111,HJ,618.92,,283824.49
6360,5/18/2021,5/18/2021,Joseph Zarate,Imported from Bank of America Visa,D105,HJ,375.6,,284200.09
6360,5/19/2021,5/19/2021,Thomas Fischaber,Imported from Bank of America Visa,D109,HJ,84,,284284.09
6360,5/20/2021,5/20/2021,Antonio Gutierrez,Imported from Bank of America Visa,D111,HJ,6.75,,284290.84
6360,5/20/2021,5/20/2021,Thomas Fischaber,Imported from Bank of America Visa,D109,HJ,39,,284329.84
6360,5/21/2021,5/21/2021,Elizabeth Peinado,Imported from Bank of America Visa,D111,HJ,4.39,,284334.23
6360,5/21/2021,5/21/2021,Elizabeth Peinado,Imported from Bank of America Visa,D111,HJ,6.79,,284341.02
6360,5/21/2021,5/21/2021,Elizabeth Peinado,Imported from Bank of America Visa,D111,HJ,6.79,,284347.81
6360,5/21/2021,5/21/2021,Elizabeth Peinado,Imported from Bank of America Visa,D111,HJ,21.98,,284369.79
6360,5/21/2021,5/21/2021,Thomas Fischaber,Imported from Bank of America Visa,D109,HJ,0.78,,284370.57
6360,5/26/2021,5/26/2021,Antonio Gutierrez,Imported from Bank of America Visa,D107,HJ,49,,284419.57
6360,5/26/2021,5/26/2021,Joseph Zarate,Imported from Bank of America Visa,D105,HJ,79.63,,284499.2
6360,5/26/2021,5/26/2021,Odalis Polanco,Imported from Bank of America Visa,D103,HJ,780.92,,285280.12
6360,5/28/2021,5/28/2021,Thomas Fischaber,Imported from Bank of America Visa,D109,HJ,48.9,,285329.02
6360,6/1/2021,6/1/2021,Odalis Polanco,Imported from Bank of America Visa,D103,HJ,780.92,,286109.94
6360,6/2/2021,6/2/2021,Alan Safran,Imported from Bank of America Visa,D107,HJ,83.4,,286193.34
6360,6/2/2021,6/2/2021,Antonio Gutierrez,Imported from Bank of America Visa,D107,HJ,180,,286373.34
6360,6/2/2021,6/2/2021,Elizabeth Peinado,Imported from Bank of America Visa,D111,HJ,4.39,,286377.73
6360,6/2/2021,6/2/2021,Elizabeth Peinado,Imported from Bank of America Visa,D111,HJ,6.79,,286384.52
6360,6/2/2021,6/2/2021,Elizabeth Peinado,Imported from Bank of America Visa,D111,HJ,6.79,,286391.31
6360,6/2/2021,6/2/2021,Elizabeth Peinado,Imported from Bank of America Visa,D111,HJ,21.98,,286413.29
6360,6/2/2021,6/2/2021,Thomas Fischaber,Imported from Bank of America Visa,D109,HJ,84,,286497.29
6360,6/4/2021,6/4/2021,Alan Safran,Imported from Bank of America Visa,D107,HJ,1.99,,286499.28
6360,6/7/2021,6/7/2021,Monivett Acevedo,Imported from Bank of America Visa,D107,HJ,14.99,,286514.27
6360,6/7/2021,6/7/2021,Thomas Fischaber,Imported from Bank of America Visa,D109,HJ,59,,286573.27
6360,6/8/2021,6/8/2021,Odalis Polanco,Imported from Bank of America Visa,D103,HJ,235.27,,286808.54
6360,6/8/2021,6/8/2021,Thomas Fischaber,Imported from Bank of America Visa,D109,HJ,29.87,,286838.41
6360,6/10/2021,6/10/2021,Joseph Zarate,Imported from Bank of America Visa,D105,HJ,2614.91,,289453.32
6360,6/10/2021,6/10/2021,Mahaliah Sejour,Imported from Bank of America Visa,D108,HJ,21.24,,289474.56
6360,6/10/2021,6/10/2021,Tiffani Bibb,Imported from Bank of America Visa,D104,HJ,39,,289513.56
6360,6/11/2021,6/11/2021,Antonio Gutierrez,Imported from Bank of America Visa,D107,HJ,235.17,,289748.73
6360,6/11/2021,6/11/2021,Thomas Fischaber,Imported from Bank of America Visa,D109,HJ,9.99,,289758.72
6360,6/14/2021,6/14/2021,Thomas Fischaber,Imported from Bank of America Visa,D109,HJ,8.75,,289767.47
6360,6/15/2021,6/15/2021,Greenhouse Software,Bill.Com Import,D104,HJ,272.5,,290039.97
6360,6/15/2021,6/15/2021,Greenhouse Software,Bill.Com Import,D104,HJ,1180.8,,291220.77
6360,6/15/2021,6/15/2021,Greenhouse Software,Bill.Com Import,D104,HJ,7629.8,,298850.57
6360,6/16/2021,6/16/2021,Abila,Bill.Com Import,D103,HJ,110,,298960.57
6360,6/16/2021,6/16/2021,Abila,Bill.Com Import,D103,HJ,250,,299210.57
6360,6/16/2021,6/16/2021,Antonio Gutierrez,Imported from Bank of America Visa,D107,HJ,4,,299214.57
6360,6/16/2021,6/16/2021,Joseph Zarate,Imported from Bank of America Visa,D105,HJ,214.9,,299429.47
6360,6/16/2021,6/16/2021,Joseph Zarate,Imported from Bank of America Visa,D105,HJ,427.42,,299856.89
6360,6/16/2021,6/16/2021,Uriel Guadarrama,Imported from Bank of America Visa,D105,HJ,99.88,,299956.77
6360,6/16/2021,6/16/2021,Uriel Guadarrama,Imported from Bank of America Visa,D105,HJ,99.88,,300056.65
6360,6/17/2021,6/17/2021,Antonio Gutierrez,Imported from Bank of America Visa,D107,HJ,15.93,,300072.58
6360,6/18/2021,6/18/2021,Antonio Gutierrez,Imported from Bank of America Visa,D107,HJ,658.91,,300731.49
6360,6/18/2021,6/18/2021,Joseph Zarate,Imported from Bank of America Visa,D105,HJ,434.98,,301166.47
6360,6/18/2021,6/18/2021,Maryellen Leneghan,Imported from Bank of America Visa,D107,HJ,1607,,302773.47
6360,6/18/2021,6/18/2021,Thomas Fischaber,Imported from Bank of America Visa,D109,HJ,249,,303022.47
6360,6/21/2021,6/21/2021,Alan Safran,Imported from Bank of America Visa,D109,HJ,16.25,,303038.72
6360,6/22/2021,6/22/2021,Alan Safran,Imported from Bank of America Visa,D109,HJ,15,,303053.72
6360,6/23/2021,6/23/2021,Alan Safran,Imported from Bank of America Visa,D109,HJ,45,,303098.72
6360,6/23/2021,6/23/2021,Thomas Fischaber,Imported from Bank of America Visa,D109,HJ,198,,303296.72
6360,6/24/2021,6/24/2021,Joseph Zarate,Imported from Bank of America Visa,D105,HJ,79.63,,303376.35
6360,6/24/2021,6/24/2021,Thomas Fischaber,Imported from Bank of America Visa,D109,HJ,0.78,,303377.13
6360,6/24/2021,6/24/2021,Thomas Fischaber,Imported from Bank of America Visa,D109,HJ,27.44,,303404.57
6360,6/24/2021,6/24/2021,Thomas Fischaber,Imported from Bank of America Visa,D109,HJ,39,,303443.57
6360,6/28/2021,6/28/2021,Antonio Gutierrez,Imported from Bank of America Visa,D107,HJ,1.99,,303445.56
6360,6/28/2021,6/28/2021,Thomas Fischaber,Imported from Bank of America Visa,D109,HJ,14.95,,303460.51
6360,6/28/2021,6/28/2021,Thomas Fischaber,Imported from Bank of America Visa,D109,HJ,69,,303529.51
6360,6/28/2021,6/28/2021,Tiffani Bibb,Imported from Bank of America Visa,D104,HJ,443.69,,303973.2
6360, Totals for 6360 - Software and Subscription Services,,,,,,604780.73,300807.53,303973.2
6361,6361 - A/V Hosting (Balance forward As of 07/01/2020) ,,,,,,,,0
6361,11/1/2020,11/1/2020,Thomas Fischaber,Imported from Bank of America Visa-Tutor app AV,D109,HJ,10.16,,10.16
6361,11/1/2020,11/1/2020,Thomas Fischaber,Imported from Bank of America Visa-Tutor app AV,D109,HJ,10.24,,20.4
6361,11/1/2020,11/1/2020,Thomas Fischaber,Imported from Bank of America Visa-Tutor app AV,D109,HJ,10.29,,30.69
6361,11/1/2020,11/1/2020,Thomas Fischaber,Imported from Bank of America Visa-Tutor app AV,D109,HJ,10.7,,41.39
6361,11/1/2020,11/1/2020,Thomas Fischaber,Imported from Bank of America Visa-Tutor app AV,D109,HJ,11.45,,52.84
6361,11/1/2020,11/1/2020,Thomas Fischaber,Imported from Bank of America Visa-Tutor application av,D109,HJ,10.01,,62.85
6361,11/1/2020,11/1/2020,Thomas Fischaber,Imported from Bank of America Visa-Tutor application av,D109,HJ,10.34,,73.19
6361,11/1/2020,11/1/2020,Thomas Fischaber,Imported from Bank of America Visa-Tutor application av,D109,HJ,11,,84.19
6361,11/3/2020,11/3/2020,Thomas Fischaber,Imported from Bank of America Visa-Tutor application av,D109,HJ,10.01,,94.2
6361,11/3/2020,11/3/2020,Thomas Fischaber,Imported from Bank of America Visa-Tutor application av,D109,HJ,10.05,,104.25
6361,11/3/2020,11/3/2020,Thomas Fischaber,Imported from Bank of America Visa-Tutor application av,D109,HJ,10.1,,114.35
6361,11/3/2020,11/3/2020,Thomas Fischaber,Imported from Bank of America Visa-Tutor application av,D109,HJ,10.69,,125.04
6361,11/3/2020,11/3/2020,Thomas Fischaber,Imported from Bank of America Visa-Tutor application av,D109,HJ,10.92,,135.96
6361,11/3/2020,11/3/2020,Thomas Fischaber,Imported from Bank of America Visa-Tutor application av,D109,HJ,11.25,,147.21
6361,11/4/2020,11/4/2020,Thomas Fischaber,Imported from Bank of America Visa-Tutor application av,D109,HJ,10,,157.21
6361,11/4/2020,11/4/2020,Thomas Fischaber,Imported from Bank of America Visa-Tutor application av,D109,HJ,10.27,,167.48
6361,11/4/2020,11/4/2020,Thomas Fischaber,Imported from Bank of America Visa-Tutor application av,D109,HJ,10.53,,178.01
6361,11/4/2020,11/4/2020,Thomas Fischaber,Imported from Bank of America Visa-Tutor application av,D109,HJ,10.74,,188.75
6361,11/4/2020,11/4/2020,Thomas Fischaber,Imported from Bank of America Visa-Tutor application av,D109,HJ,11.17,,199.92
6361,11/4/2020,11/4/2020,Thomas Fischaber,Imported from Bank of America Visa-Tutor application av,D109,HJ,11.88,,211.8
6361,11/4/2020,11/4/2020,Thomas Fischaber,Imported from Bank of America Visa-Tutor application av,D109,HJ,500,,711.8
6361,11/5/2020,11/5/2020,Thomas Fischaber,Imported from Bank of America Visa-Tutor application av,D109,HJ,10.04,,721.84
6361,11/5/2020,11/5/2020,Thomas Fischaber,Imported from Bank of America Visa-Tutor application av,D109,HJ,10.26,,732.1
6361,11/5/2020,11/5/2020,Thomas Fischaber,Imported from Bank of America Visa-Tutor application av,D109,HJ,10.4,,742.5
6361,11/5/2020,11/5/2020,Thomas Fischaber,Imported from Bank of America Visa-Tutor application av,D109,HJ,10.6,,753.1
6361,11/5/2020,11/5/2020,Thomas Fischaber,Imported from Bank of America Visa-Tutor application av,D109,HJ,10.61,,763.71
6361,11/5/2020,11/5/2020,Thomas Fischaber,Imported from Bank of America Visa-Tutor application av,D109,HJ,10.86,,774.57
6361,11/5/2020,11/5/2020,Thomas Fischaber,Imported from Bank of America Visa-Tutor application av,D109,HJ,10.94,,785.51
6361,11/5/2020,11/5/2020,Thomas Fischaber,Imported from Bank of America Visa-Tutor application av,D109,HJ,11.1,,796.61
6361,11/5/2020,11/5/2020,Thomas Fischaber,Imported from Bank of America Visa-Tutor application av,D109,HJ,11.17,,807.78
6361,11/5/2020,11/5/2020,Thomas Fischaber,Imported from Bank of America Visa-Tutor application av,D109,HJ,47.93,,855.71
6361,11/5/2020,11/5/2020,Thomas Fischaber,Imported from Bank of America Visa-Tutor application av,D109,HJ,985.77,,1841.48
6361,11/6/2020,11/6/2020,Thomas Fischaber,Imported from Bank of America Visa-Tutor application av,D109,HJ,10.32,,1851.8
6361,11/6/2020,11/6/2020,Thomas Fischaber,Imported from Bank of America Visa-Tutor application av,D109,HJ,10.35,,1862.15
6361,11/6/2020,11/6/2020,Thomas Fischaber,Imported from Bank of America Visa-Tutor application av,D109,HJ,10.41,,1872.56
6361,11/6/2020,11/6/2020,Thomas Fischaber,Imported from Bank of America Visa-Tutor application av,D109,HJ,11.03,,1883.59
6361,11/18/2020,11/18/2020,Thomas Fischaber,Imported from Bank of America Visa-Tutor application AV,D109,HJ,990.04,,2873.63
6361,12/2/2020,12/2/2020,Thomas Fischaber,Imported from Bank of America Visa-AV for tutoring platform,D109,HJ,990.33,,3863.96
6361,12/9/2020,12/9/2020,Thomas Fischaber,Imported from Bank of America Visa-A.V for tutoring platform,D109,HJ,990.03,,4853.99
6361,12/17/2020,12/17/2020,Thomas Fischaber,Imported from Bank of America Visa-AV for tutoring platform,D109,HJ,990.72,,5844.71
6361,1/7/2021,1/7/2021,Thomas Fischaber,Imported from Bank of America Visa-av hosting,D109,HJ,992.39,,6837.1
6361,1/15/2021,1/15/2021,Thomas Fischaber,Imported from Bank of America Visa-av hosting,D109,HJ,990.75,,7827.85
6361,1/26/2021,1/26/2021,Thomas Fischaber,Imported from Bank of America Visa-av hosting,D109,HJ,400,,8227.85
6361,1/26/2021,1/26/2021,Thomas Fischaber,Imported from Bank of America Visa-av hosting,D109,HJ,990.56,,9218.41
6361,1/27/2021,1/27/2021,Thomas Fischaber,Imported from Bank of America Visa-av hosting,D109,HJ,1000,,10218.41
6361,4/1/2021,4/1/2021,"Twilio, Inc.",Bill.Com Import,D109,HJ,3174.09,,13392.5
6361,4/1/2021,4/1/2021,"Twilio, Inc.",Bill.Com Import,D109,HJ,3192.49,,16584.99
6361,5/27/2021,5/27/2021,"Twilio, Inc.",Bill.Com Import,D109,HJ,3551.8,,20136.79
6361,6/30/2021,6/30/2021,"Twilio, Inc.",Bill.Com Import,D109,HJ,593.85,,20730.64
6361, Totals for 6361 - A/V Hosting,,,,,,20730.64,0,20730.64
6362,6362 - Server Hosting Expense (Balance forward As of 07/01/2020) ,,,,,,,,0
6362,11/1/2020,11/1/2020,Thomas Fischaber,Imported from Bank of America Visa-servers for marketing pages,D109,HJ,82.21,,82.21
6362,11/1/2020,11/1/2020,Thomas Fischaber,Imported from Bank of America Visa-tutorial recording servers,D109,HJ,119,,201.21
6362,11/3/2020,11/3/2020,Thomas Fischaber,Imported from Bank of America Visa-wootmath.com and woottutor.com servers,D109,HJ,2079.5,,2280.71
6362,12/3/2020,12/3/2020,Thomas Fischaber,Imported from Bank of America Visa-Woot Math & Woot Tutor servers,D109,HJ,2029.46,,4310.17
6362,12/9/2020,12/9/2020,Thomas Fischaber,Imported from Bank of America Visa-Tutoring platform . recording servers,D109,HJ,88.29,,4398.46
6362,1/1/2021,1/1/2021,Thomas Fischaber,Imported from Bank of America Visa-marketing servers,D109,HJ,82.21,,4480.67
6362,1/1/2021,1/1/2021,Thomas Fischaber,Imported from Bank of America Visa-recording servers,D109,HJ,238,,4718.67
6362,1/3/2021,1/3/2021,Thomas Fischaber,Imported from Bank of America Visa-servers,D109,HJ,2071.77,,6790.44
6362,2/1/2021,2/1/2021,Thomas Fischaber,Imported from Bank of America Visa-server hardware,D109,HJ,238,,7028.44
6362,2/1/2021,2/1/2021,Thomas Fischaber,Imported from Bank of America Visa-servers,D109,HJ,82.21,,7110.65
6362,2/3/2021,2/3/2021,Thomas Fischaber,Imported from Bank of America Visa-aws hosting,D109,HJ,2105.76,,9216.41
6362,3/1/2021,3/1/2021,Thomas Fischaber,Imported from Bank of America Visa,D109,HJ,82.21,,9298.62
6362,3/1/2021,3/1/2021,Thomas Fischaber,Imported from Bank of America Visa,D109,HJ,238,,9536.62
6362,3/24/2021,3/24/2021,Thomas Fischaber,Imported from Bank of America Visa,D109,HJ,2395.04,,11931.66
6362,4/1/2021,4/1/2021,Thomas Fischaber,Imported from Bank of America Visa,D109,HJ,82.21,,12013.87
6362,4/1/2021,4/1/2021,Thomas Fischaber,Imported from Bank of America Visa,D109,HJ,238,,12251.87
6362,4/29/2021,4/29/2021,Thomas Fischaber,Imported from Bank of America Visa,D109,HJ,2567.99,,14819.86
6362,5/1/2021,5/1/2021,Thomas Fischaber,Imported from Bank of America Visa,D109,HJ,82.21,,14902.07
6362,5/1/2021,5/1/2021,Thomas Fischaber,Imported from Bank of America Visa,D109,HJ,238,,15140.07
6362,5/19/2021,5/19/2021,Thomas Fischaber,Imported from Bank of America Visa,D109,HJ,2521.07,,17661.14
6362,6/1/2021,6/1/2021,Thomas Fischaber,Imported from Bank of America Visa,D109,HJ,11,,17672.14
6362,6/1/2021,6/1/2021,Thomas Fischaber,Imported from Bank of America Visa,D109,HJ,12,,17684.14
6362,6/1/2021,6/1/2021,Thomas Fischaber,Imported from Bank of America Visa,D109,HJ,12,,17696.14
6362,6/1/2021,6/1/2021,Thomas Fischaber,Imported from Bank of America Visa,D109,HJ,12,,17708.14
6362,6/1/2021,6/1/2021,Thomas Fischaber,Imported from Bank of America Visa,D109,HJ,12,,17720.14
6362,6/1/2021,6/1/2021,Thomas Fischaber,Imported from Bank of America Visa,D109,HJ,12,,17732.14
6362,6/1/2021,6/1/2021,Thomas Fischaber,Imported from Bank of America Visa,D109,HJ,12,,17744.14
6362,6/1/2021,6/1/2021,Thomas Fischaber,Imported from Bank of America Visa,D109,HJ,12,,17756.14
6362,6/1/2021,6/1/2021,Thomas Fischaber,Imported from Bank of America Visa,D109,HJ,82.21,,17838.35
6362,6/1/2021,6/1/2021,Thomas Fischaber,Imported from Bank of America Visa,D109,HJ,238,,18076.35
6362,6/2/2021,6/2/2021,Thomas Fischaber,Imported from Bank of America Visa,D109,HJ,12,,18088.35
6362,6/2/2021,6/2/2021,Thomas Fischaber,Imported from Bank of America Visa,D109,HJ,12,,18100.35
6362,6/28/2021,6/28/2021,Thomas Fischaber,Imported from Bank of America Visa,D109,HJ,2266.78,,20367.13
6362, Totals for 6362 - Server Hosting Expense,,,,,,20367.13,0,20367.13
6370,6370 - Professional Development (Balance forward As of 07/01/2020) ,,,,,,,,0
6370,7/1/2020,7/1/2020,Halley Bowman,Imported from Bank of America Visa-PD book for MS project for Steve,D101,HJ,23.76,,23.76
6370,7/1/2020,7/1/2020,Halley Bowman,Imported from Bank of America Visa-PD book for Steve on MS project,D101,HJ,30.49,,54.25
6370,7/1/2020,7/1/2020,Halley Bowman,Imported from Bank of America Visa-PD books for MS project for Halley,D101,HJ,45.01,,99.26
6370,7/9/2020,7/9/2020,Halley Bowman,Imported from Bank of America Visa-PD book for Curriculum Writer,D101,HJ,1.1,,100.36
6370,7/9/2020,7/9/2020,Halley Bowman,Imported from Bank of America Visa-PD book for Curriculum Writer,D101,HJ,1.7,,102.06
6370,7/9/2020,7/9/2020,Halley Bowman,Imported from Bank of America Visa-PD book for Curriculum Writer,D101,HJ,1.7,,103.76
6370,7/9/2020,7/9/2020,Halley Bowman,Imported from Bank of America Visa-PD book for Curriculum Writer,D101,HJ,5.49,,109.25
6370,7/11/2020,7/11/2020,Halley Bowman,Imported from Bank of America Visa-PD book for Curriculum Writer,D101,HJ,1.1,,110.35
6370,7/11/2020,7/11/2020,Halley Bowman,Imported from Bank of America Visa-PD book for Curriculum Writer,D101,HJ,1.7,,112.05
6370,7/11/2020,7/11/2020,Halley Bowman,Imported from Bank of America Visa-PD book for Curriculum Writer,D101,HJ,1.7,,113.75
6370,7/11/2020,7/11/2020,Halley Bowman,Imported from Bank of America Visa-PD book for Curriculum Writer,D101,HJ,5.49,,119.24
6370,7/14/2020,7/14/2020,Monivett Acevedo,Imported from Bank of America Visa-HBR unlimited access for Finance and Grants,D103,HJ,180,,299.24
6370,7/21/2020,7/21/2020,Halley Bowman,Imported from Bank of America Visa-book for Mallory,D101,HJ,3.74,,302.98
6370,7/21/2020,7/21/2020,Halley Bowman,Imported from Bank of America Visa-book for Mallory,D101,HJ,5.78,,308.76
6370,7/21/2020,7/21/2020,Halley Bowman,Imported from Bank of America Visa-book for Mallory,D101,HJ,5.78,,314.54
6370,7/21/2020,7/21/2020,Halley Bowman,Imported from Bank of America Visa-book for Mallory,D101,HJ,18.68,,333.22
6370,7/24/2020,7/24/2020,Halley Bowman,Imported from Bank of America Visa-Reference book for MS project for Emily,D101,HJ,31.63,,364.85
6370,7/24/2020,7/24/2020,Mahaliah Sejour,Imported from Bank of America Visa-project management,D108,HJ,49,,413.85
6370,7/25/2020,7/25/2020,Halley Bowman,Imported from Bank of America Visa-Reference book for Mallory for PD,D101,HJ,3.23,,417.08
6370,7/25/2020,7/25/2020,Halley Bowman,Imported from Bank of America Visa-Reference book for Mallory for PD,D101,HJ,4.99,,422.07
6370,7/25/2020,7/25/2020,Halley Bowman,Imported from Bank of America Visa-Reference book for Mallory for PD,D101,HJ,4.99,,427.06
6370,7/25/2020,7/25/2020,Halley Bowman,Imported from Bank of America Visa-Reference book for Mallory for PD,D101,HJ,16.14,,443.2
6370,7/27/2020,7/27/2020,Halley Bowman,Imported from Bank of America Visa-Reference books for Halley,D101,HJ,6.9,,450.1
6370,7/27/2020,7/27/2020,Halley Bowman,Imported from Bank of America Visa-Reference books for Halley,D101,HJ,10.67,,460.77
6370,7/27/2020,7/27/2020,Halley Bowman,Imported from Bank of America Visa-Reference books for Halley,D101,HJ,10.67,,471.44
6370,7/27/2020,7/27/2020,Halley Bowman,Imported from Bank of America Visa-Reference books for Halley,D101,HJ,34.5,,505.94
6370,8/8/2020,8/8/2020,Chris D PLACEHOLDER,Imported from Bank of America Visa-Book for Team PD,D105,HJ,11.68,,517.62
6370,8/9/2020,8/9/2020,Chris D PLACEHOLDER,Imported from Bank of America Visa-Book for team PD,D105,HJ,11.68,,529.3
6370,8/9/2020,8/9/2020,Chris D PLACEHOLDER,Imported from Bank of America Visa-Book sent for team PD,D105,HJ,11.94,,541.24
6370,8/11/2020,8/11/2020,Chris D PLACEHOLDER,Imported from Bank of America Visa-Book for team PD,D105,HJ,11.65,,552.89
6370,8/11/2020,8/11/2020,Chris D PLACEHOLDER,Imported from Bank of America Visa-Book for team PD,D105,HJ,11.68,,564.57
6370,8/14/2020,8/14/2020,Antonio Gutierrez,Imported from Bank of America Visa-Professional Development,D107,HJ,9.52,,574.09
6370,8/17/2020,8/17/2020,Halley Bowman,Imported from Bank of America Visa-Staff bookclub,D101,HJ,1.75,,575.84
6370,8/17/2020,8/17/2020,Halley Bowman,Imported from Bank of America Visa-Staff bookclub,D101,HJ,2.7,,578.54
6370,8/17/2020,8/17/2020,Halley Bowman,Imported from Bank of America Visa-Staff bookclub,D101,HJ,2.7,,581.24
6370,8/17/2020,8/17/2020,Halley Bowman,Imported from Bank of America Visa-Staff bookclub,D101,HJ,8.74,,589.98
6370,8/20/2020,8/20/2020,Jennifer Winans,Imported from Bank of America Visa-Recruitment PD,D111,HJ,299.94,,889.92
6370,8/20/2020,8/20/2020,Myesha Hossain,Imported from Bank of America Visa-Training,D108,HJ,9.88,,899.8
6370,8/21/2020,8/21/2020,Myesha Hossain,Imported from Bank of America Visa-Training,D108,HJ,13.6,,913.4
6370,8/22/2020,8/22/2020,Myesha Hossain,Imported from Bank of America Visa-Training,D108,HJ,13.99,,927.39
6370,8/22/2020,8/22/2020,Myesha Hossain,Imported from Bank of America Visa-Training,D108,HJ,15.5,,942.89
6370,8/24/2020,8/24/2020,Monivett Acevedo,Imported from Bank of America Visa-Marketing PD,D103,HJ,203.29,,1146.18
6370,8/24/2020,8/24/2020,Myesha Hossain,Imported from Bank of America Visa-Training,D108,HJ,13.03,,1159.21
6370,8/24/2020,8/24/2020,Myesha Hossain,Imported from Bank of America Visa-Training,D108,HJ,17.69,,1176.9
6370,8/24/2020,8/24/2020,Nicole Prahin,Imported from Bank of America Visa-Rented Resource for Fellow Training access,D108,HJ,1.99,,1178.89
6370,8/25/2020,8/25/2020,Jennifer Winans,Imported from Bank of America Visa-Recruitment PD,D111,HJ,169.22,,1348.11
6370,8/26/2020,8/26/2020,Jennifer Winans,Imported from Bank of America Visa-Recruitment PD,D111,HJ,3.38,,1351.49
6370,8/26/2020,8/26/2020,Myesha Hossain,Imported from Bank of America Visa-Training,D108,HJ,13.38,,1364.87
6370,8/27/2020,8/27/2020,Myesha Hossain,Imported from Bank of America Visa-Fellow Training,D108,HJ,10.14,,1375.01
6370,8/27/2020,8/27/2020,Myesha Hossain,Imported from Bank of America Visa-Training,D108,HJ,13.38,,1388.39
6370,8/28/2020,8/28/2020,Antonio Gutierrez,Imported from Bank of America Visa-Professional Development,D107,HJ,13.92,,1402.31
6370,8/28/2020,8/28/2020,Myesha Hossain,Imported from Bank of America Visa-Training,D108,HJ,19.52,,1421.83
6370,8/28/2020,8/28/2020,Myesha Hossain,Imported from Bank of America Visa-Training,D108,HJ,20.22,,1442.05
6370,9/9/2020,9/9/2020,Kyra Detone,Imported from Bank of America Visa-Gallup Strengths Test Fee. Grants Team Professional Dev,D102,HJ,53.11,,1495.16
6370,9/10/2020,9/10/2020,Monivett Acevedo,Imported from Bank of America Visa-Teams activity handbook,D103,HJ,49.99,,1545.15
6370,9/15/2020,9/15/2020,Tiffani Bibb,Imported from Bank of America Visa-Assessment for HR Admin Team,D104,HJ,59.97,,1605.12
6370,9/16/2020,9/16/2020,Monivett Acevedo,Imported from Bank of America Visa-Gallup strengths activity book,D103,HJ,122.81,,1727.93
6370,9/19/2020,9/19/2020,Tiffani Bibb,Imported from Bank of America Visa-Compensation Course for PD,D104,HJ,1285,,3012.93
6370,9/25/2020,9/25/2020,Monivett Acevedo,Imported from Bank of America Visa-Blue Ocean Strategy,D103,HJ,18.62,,3031.55
6370,9/29/2020,9/29/2020,Chris D PLACEHOLDER,Imported from Bank of America Visa-Curriculum Material for PD,D107,HJ,37.13,,3068.68
6370,10/1/2020,10/1/2020,Cathryn Cook,Imported from reimbursements-Strengthsfinder tests for ISA team,D105,HJ,159.34,,3228.02
6370,10/1/2020,10/1/2020,Monivett Acevedo,Imported from reimbursements-Professional Development,D109,HJ,23.98,,3252
6370,10/1/2020,10/1/2020,Nicole Prahin,Imported from reimbursements-PD Book for DoP can take out NP Office Supply budget,D108,HJ,91.35,,3343.35
6370,10/1/2020,10/1/2020,Nicole Prahin,Imported from reimbursements-PD Book for RPOM can take out NP Office Supply budget,D108,HJ,11.68,,3355.03
6370,10/6/2020,10/6/2020,Nicole Prahin,Imported from reimbursements-PD book,D108,HJ,32.64,,3387.67
6370,10/9/2020,10/9/2020,Elizabeth Peinado,Imported from reimbursements-SHRM subscription,D111,HJ,24.09,,3411.76
6370,10/9/2020,10/9/2020,Elizabeth Peinado,Imported from reimbursements-SHRM subscription,D111,HJ,37.23,,3448.99
6370,10/9/2020,10/9/2020,Elizabeth Peinado,Imported from reimbursements-SHRM subscription,D111,HJ,37.23,,3486.22
6370,10/9/2020,10/9/2020,Elizabeth Peinado,Imported from reimbursements-SHRM subscription,D111,HJ,120.45,,3606.67
6370,10/17/2020,10/17/2020,Monivett Acevedo,Imported from reimbursements-Professional Development,D103,HJ,13.89,,3620.56
6370,10/17/2020,10/17/2020,Monivett Acevedo,Imported from reimbursements-Professional Development,D109,HJ,8.95,,3629.51
6370,10/20/2020,10/20/2020,Tiffani Bibb,Imported from reimbursements-Book for Performance Management,D104,HJ,159.05,,3788.56
6370,10/20/2020,10/20/2020,Tiffani Bibb,Imported from reimbursements-Book for performance Management-E Peinaldo,D104,HJ,160.52,,3949.08
6370,10/21/2020,10/21/2020,Harvard University,Bill.Com Import-Strategic Data project fellowship cohort 12 Pymt 1,D107,HJ,24500,,28449.08
6370,10/22/2020,10/22/2020,Monivett Acevedo,Imported from reimbursements-Book. The power of..,D103,HJ,8.52,,28457.6
6370,10/23/2020,10/23/2020,Monivett Acevedo,Imported from reimbursements-Professional Development,D103,HJ,37.65,,28495.25
6370,10/23/2020,10/23/2020,Monivett Acevedo,Imported from reimbursements-Text for engineering team,D109,HJ,36.92,,28532.17
6370,10/24/2020,10/24/2020,Monivett Acevedo,Imported from reimbursements-Books for new engineer,D109,HJ,153.41,,28685.58
6370,10/24/2020,10/24/2020,Monivett Acevedo,Imported from reimbursements-The power of ..,D103,HJ,8.59,,28694.17
6370,10/25/2020,10/25/2020,Monivett Acevedo,Imported from reimbursements-Book. The power of..,D109,HJ,8.46,,28702.63
6370,11/3/2020,11/3/2020,Maryellen Leneghan,Imported from Bank of America Visa-Staff professional development book,D108,HJ,11.65,,28714.28
6370,11/3/2020,11/3/2020,Nicole Prahin,Imported from Bank of America Visa-Reimbursement of PD book that couldnt be shipped bc out of stock,D108,HJ,,32.64,28681.64
6370,11/4/2020,11/4/2020,Cathryn Cook,Imported from Bank of America Visa-Strengthsfinder tests for me and Uriel,D105,HJ,84.98,,28766.62
6370,11/21/2020,11/21/2020,Halley Bowman,Imported from Bank of America Visa-PD books for bookclubs,D101,HJ,3.78,,28770.4
6370,11/21/2020,11/21/2020,Halley Bowman,Imported from Bank of America Visa-PD books for bookclubs,D101,HJ,5.83,,28776.23
6370,11/21/2020,11/21/2020,Halley Bowman,Imported from Bank of America Visa-PD books for bookclubs,D101,HJ,5.83,,28782.06
6370,11/21/2020,11/21/2020,Halley Bowman,Imported from Bank of America Visa-PD books for bookclubs,D101,HJ,18.88,,28800.94
6370,12/1/2020,12/1/2020,Elizabeth Peinado,Imported from Bank of America Visa-Competency Training Korn Ferry Interview Guide,D111,HJ,19.5,,28820.44
6370,12/1/2020,12/1/2020,Elizabeth Peinado,Imported from Bank of America Visa-Competency Training Korn Ferry Interview Guide,D111,HJ,30.14,,28850.58
6370,12/1/2020,12/1/2020,Elizabeth Peinado,Imported from Bank of America Visa-Competency Training Korn Ferry Interview Guide,D111,HJ,30.14,,28880.72
6370,12/1/2020,12/1/2020,Elizabeth Peinado,Imported from Bank of America Visa-Competency Training Korn Ferry Interview Guide,D111,HJ,97.49,,28978.21
6370,12/1/2020,12/1/2020,Elizabeth Peinado,Imported from Bank of America Visa-Competency Training. Korn Ferry Interview Guide,D111,HJ,17.45,,28995.66
6370,12/1/2020,12/1/2020,Elizabeth Peinado,Imported from Bank of America Visa-Competency Training. Korn Ferry Interview Guide,D111,HJ,26.97,,29022.63
6370,12/1/2020,12/1/2020,Elizabeth Peinado,Imported from Bank of America Visa-Competency Training. Korn Ferry Interview Guide,D111,HJ,26.97,,29049.6
6370,12/1/2020,12/1/2020,Elizabeth Peinado,Imported from Bank of America Visa-Competency Training. Korn Ferry Interview Guide,D111,HJ,87.28,,29136.88
6370,12/3/2020,12/3/2020,Monivett Acevedo,Imported from Bank of America Visa-Pricing tool FORIO,D107,HJ,75,,29211.88
6370,12/3/2020,12/3/2020,Monivett Acevedo,Imported from Bank of America Visa-Professional Development,D107,HJ,34.24,,29246.12
6370,12/8/2020,12/8/2020,Tiffani Bibb,Imported from Bank of America Visa-Team Assessment for HR Admin and Talent,D104,HJ,376,,29622.12
6370,12/10/2020,12/10/2020,Halley Bowman,Imported from Bank of America Visa-Book for Emily for PD,D101,HJ,34.2,,29656.32
6370,12/10/2020,12/10/2020,Halley Bowman,Imported from Bank of America Visa-Book for Emily for PD,D101,HJ,37,,29693.32
6370,12/10/2020,12/10/2020,Halley Bowman,Imported from Bank of America Visa-book for Mallory for PD,D101,HJ,3.84,,29697.16
6370,12/10/2020,12/10/2020,Halley Bowman,Imported from Bank of America Visa-book for Mallory for PD,D101,HJ,5.93,,29703.09
6370,12/10/2020,12/10/2020,Halley Bowman,Imported from Bank of America Visa-book for Mallory for PD,D101,HJ,5.93,,29709.02
6370,12/10/2020,12/10/2020,Halley Bowman,Imported from Bank of America Visa-book for Mallory for PD,D101,HJ,19.21,,29728.23
6370,12/13/2020,12/13/2020,Amena Wallace,Imported from Bank of America Visa-Books for DEIB,D104,HJ,84.18,,29812.41
6370,12/13/2020,12/13/2020,Halley Bowman,Imported from Bank of America Visa-PD book for Halley,D101,HJ,4.07,,29816.48
6370,12/13/2020,12/13/2020,Halley Bowman,Imported from Bank of America Visa-PD book for Halley,D101,HJ,6.29,,29822.77
6370,12/13/2020,12/13/2020,Halley Bowman,Imported from Bank of America Visa-PD book for Halley,D101,HJ,6.29,,29829.06
6370,12/13/2020,12/13/2020,Halley Bowman,Imported from Bank of America Visa-PD book for Halley,D101,HJ,20.36,,29849.42
6370,12/13/2020,12/13/2020,Halley Bowman,Imported from Bank of America Visa-PD books for Mallory,D101,HJ,3.55,,29852.97
6370,12/13/2020,12/13/2020,Halley Bowman,Imported from Bank of America Visa-PD books for Mallory,D101,HJ,5.48,,29858.45
6370,12/13/2020,12/13/2020,Halley Bowman,Imported from Bank of America Visa-PD books for Mallory,D101,HJ,5.48,,29863.93
6370,12/13/2020,12/13/2020,Halley Bowman,Imported from Bank of America Visa-PD books for Mallory,D101,HJ,17.75,,29881.68
6370,12/20/2020,12/20/2020,Halley Bowman,Imported from Bank of America Visa-Starting books for Anna Hernandez,D101,HJ,8.98,,29890.66
6370,12/20/2020,12/20/2020,Halley Bowman,Imported from Bank of America Visa-Starting books for Anna Hernandez,D101,HJ,13.87,,29904.53
6370,12/20/2020,12/20/2020,Halley Bowman,Imported from Bank of America Visa-Starting books for Anna Hernandez,D101,HJ,13.87,,29918.4
6370,12/20/2020,12/20/2020,Halley Bowman,Imported from Bank of America Visa-Starting books for Anna Hernandez,D101,HJ,44.89,,29963.29
6370,12/20/2020,12/20/2020,Halley Bowman,Imported from Bank of America Visa-book for dept heads recommended by Chris,D101,HJ,10.03,,29973.32
6370,12/20/2020,12/20/2020,Halley Bowman,Imported from Bank of America Visa-book for dept heads recommended by Chris,D101,HJ,15.49,,29988.81
6370,12/20/2020,12/20/2020,Halley Bowman,Imported from Bank of America Visa-book for dept heads recommended by Chris,D101,HJ,15.49,,30004.3
6370,12/20/2020,12/20/2020,Halley Bowman,Imported from Bank of America Visa-book for dept heads recommended by Chris,D101,HJ,50.13,,30054.43
6370,12/24/2020,12/24/2020,Halley Bowman,Imported from Bank of America Visa-book for Ashlee Cooper,D101,HJ,2.61,,30057.04
6370,12/24/2020,12/24/2020,Halley Bowman,Imported from Bank of America Visa-book for Ashlee Cooper,D101,HJ,4.04,,30061.08
6370,12/24/2020,12/24/2020,Halley Bowman,Imported from Bank of America Visa-book for Ashlee Cooper,D101,HJ,4.04,,30065.12
6370,12/24/2020,12/24/2020,Halley Bowman,Imported from Bank of America Visa-book for Ashlee Cooper,D101,HJ,13.06,,30078.18
6370,12/31/2020,12/31/2020,20201231,Statement of Functional Activities Reclass-Statement of Functional Activities Reclass,D108,HJ,,24500,5578.18
6370,12/31/2020,12/31/2020,20201231,Statement of Functional Activities Reclass-Statement of Functional Activities Reclass,D108,HJ,24500,,30078.18
6370,12/31/2020,12/31/2020,20201231,Actual vs Budget Reclass as of 12/31/2020-Actual vs Budget Reclass as of 12/31/2020,D107,HJ,,23.44,30054.74
6370,12/31/2020,12/31/2020,20201231,Actual vs Budget Reclass as of 12/31/2020-Actual vs Budget Reclass as of 12/31/2020,D107,HJ,,37.13,30017.61
6370,12/31/2020,12/31/2020,20201231,Actual vs Budget Reclass as of 12/31/2020-Actual vs Budget Reclass as of 12/31/2020,D107,HJ,37.13,,30054.74
6370,1/4/2021,1/4/2021,Halley Bowman,Imported from Bank of America Visa-bookclub book for Halley,D101,HJ,1.73,,30056.47
6370,1/4/2021,1/4/2021,Halley Bowman,Imported from Bank of America Visa-bookclub book for Halley,D101,HJ,2.68,,30059.15
6370,1/4/2021,1/4/2021,Halley Bowman,Imported from Bank of America Visa-bookclub book for Halley,D101,HJ,2.68,,30061.83
6370,1/4/2021,1/4/2021,Halley Bowman,Imported from Bank of America Visa-bookclub book for Halley,D101,HJ,8.66,,30070.49
6370,1/17/2021,1/17/2021,Alan Safran,Imported from Bank of America Visa-Book for Alan Professional Development,D107,HJ,39.26,,30109.75
6370,1/20/2021,1/20/2021,Halley Bowman,Imported from Bank of America Visa-Starting book for Mika,D101,HJ,1.75,,30111.5
6370,1/20/2021,1/20/2021,Halley Bowman,Imported from Bank of America Visa-Starting book for Mika,D101,HJ,2.71,,30114.21
6370,1/20/2021,1/20/2021,Halley Bowman,Imported from Bank of America Visa-Starting book for Mika,D101,HJ,2.71,,30116.92
6370,1/20/2021,1/20/2021,Halley Bowman,Imported from Bank of America Visa-Starting book for Mika,D101,HJ,8.78,,30125.7
6370,1/25/2021,1/25/2021,Kyra Detone,Imported from Bank of America Visa-Webinar Registration Fee.Win Grants for Racial Equity,D102,HJ,69,,30194.7
6370,1/25/2021,1/25/2021,Kyra Detone,Imported from Bank of America Visa-Webinar Registration Fee.Win Grants for Racial Equity,D102,HJ,69,,30263.7
6370,1/27/2021,1/27/2021,Halley Bowman,Imported from Bank of America Visa-PD book for Ashlee,D101,HJ,40.67,,30304.37
6370,1/27/2021,1/27/2021,Halley Bowman,Imported from Bank of America Visa-PD books for Anna Hernandez,D101,HJ,133.1,,30437.47
6370,2/2/2021,2/2/2021,Elizabeth Peinado,Imported from Bank of America Visa-Podcast learning tool . This American Life,D111,HJ,0.22,,30437.69
6370,2/2/2021,2/2/2021,Elizabeth Peinado,Imported from Bank of America Visa-Podcast learning tool . This American Life,D111,HJ,0.34,,30438.03
6370,2/2/2021,2/2/2021,Elizabeth Peinado,Imported from Bank of America Visa-Podcast learning tool . This American Life,D111,HJ,0.34,,30438.37
6370,2/2/2021,2/2/2021,Elizabeth Peinado,Imported from Bank of America Visa-Podcast learning tool . This American Life,D111,HJ,1.1,,30439.47
6370,2/2/2021,2/2/2021,Myesha Hossain,Imported from Bank of America Visa-Fellow PD,D108,HJ,13.99,,30453.46
6370,2/2/2021,2/2/2021,Nicole Prahin,Imported from Bank of America Visa-Professional Development,D108,HJ,12.5,,30465.96
6370,2/3/2021,2/3/2021,Maryellen Leneghan,Imported from Bank of America Visa-Competencies Book,D108,HJ,79.19,,30545.15
6370,2/3/2021,2/3/2021,Myesha Hossain,Imported from Bank of America Visa-Fellow PD,D108,HJ,8.9,,30554.05
6370,2/3/2021,2/3/2021,Myesha Hossain,Imported from Bank of America Visa-Fellow PD,D108,HJ,13.71,,30567.76
6370,2/3/2021,2/3/2021,Myesha Hossain,Imported from Bank of America Visa-Fellow PD,D108,HJ,15.99,,30583.75
6370,2/4/2021,2/4/2021,Myesha Hossain,Imported from Bank of America Visa-PD Raffle,D108,HJ,5.99,,30589.74
6370,2/4/2021,2/4/2021,Nicole Prahin,Imported from Bank of America Visa-Professional Development,D108,HJ,59,,30648.74
6370,2/9/2021,2/9/2021,Halley Bowman,Imported from Bank of America Visa-PD book for Emily,D101,HJ,15.89,,30664.63
6370,2/9/2021,2/9/2021,Halley Bowman,Imported from Bank of America Visa-PD book for Halley,D101,HJ,5.8,,30670.43
6370,2/9/2021,2/9/2021,Halley Bowman,Imported from Bank of America Visa-PD book for Halley,D101,HJ,8.96,,30679.39
6370,2/9/2021,2/9/2021,Halley Bowman,Imported from Bank of America Visa-PD book for Halley,D101,HJ,8.96,,30688.35
6370,2/9/2021,2/9/2021,Halley Bowman,Imported from Bank of America Visa-PD book for Halley,D101,HJ,29.01,,30717.36
6370,2/9/2021,2/9/2021,Myesha Hossain,Imported from Bank of America Visa-Vision board raffle,D108,HJ,17.99,,30735.35
6370,2/14/2021,2/14/2021,Halley Bowman,Imported from Bank of America Visa-PD book for Mallory,D101,HJ,6.15,,30741.5
6370,2/14/2021,2/14/2021,Halley Bowman,Imported from Bank of America Visa-PD book for Mallory,D101,HJ,9.5,,30751
6370,2/14/2021,2/14/2021,Halley Bowman,Imported from Bank of America Visa-PD book for Mallory,D101,HJ,9.5,,30760.5
6370,2/14/2021,2/14/2021,Halley Bowman,Imported from Bank of America Visa-PD book for Mallory,D101,HJ,30.74,,30791.24
6370,2/14/2021,2/14/2021,Myesha Hossain,Imported from Bank of America Visa-Vision board raffle,D108,HJ,13.59,,30804.83
6370,2/15/2021,2/15/2021,Halley Bowman,Imported from Bank of America Visa-fellow book club book for Halley,D101,HJ,1.99,,30806.82
6370,2/15/2021,2/15/2021,Halley Bowman,Imported from Bank of America Visa-fellow book club book for Halley,D101,HJ,3.08,,30809.9
6370,2/15/2021,2/15/2021,Halley Bowman,Imported from Bank of America Visa-fellow book club book for Halley,D101,HJ,3.08,,30812.98
6370,2/15/2021,2/15/2021,Halley Bowman,Imported from Bank of America Visa-fellow book club book for Halley,D101,HJ,9.97,,30822.95
6370,2/16/2021,2/16/2021,Myesha Hossain,Imported from Bank of America Visa-SD PD,D108,HJ,5.99,,30828.94
6370,2/16/2021,2/16/2021,Myesha Hossain,Imported from Bank of America Visa-SD PD,D108,HJ,5.99,,30834.93
6370,2/17/2021,2/17/2021,Myesha Hossain,Imported from Bank of America Visa-SD PD,D108,HJ,5.99,,30840.92
6370,2/17/2021,2/17/2021,Myesha Hossain,Imported from Bank of America Visa-SD PD,D108,HJ,5.99,,30846.91
6370,2/17/2021,2/17/2021,Myesha Hossain,Imported from Bank of America Visa-SD PD,D108,HJ,5.99,,30852.9
6370,2/17/2021,2/17/2021,Tiffani Bibb,Imported from Bank of America Visa-Compensation Course for PD,D104,HJ,350,,31202.9
6370,2/18/2021,2/18/2021,Halley Bowman,Imported from Bank of America Visa-Conference for Anna Hernandez EML Specialist,D101,HJ,8.25,,31211.15
6370,2/18/2021,2/18/2021,Halley Bowman,Imported from Bank of America Visa-Conference for Anna Hernandez EML Specialist,D101,HJ,12.75,,31223.9
6370,2/18/2021,2/18/2021,Halley Bowman,Imported from Bank of America Visa-Conference for Anna Hernandez EML Specialist,D101,HJ,12.75,,31236.65
6370,2/18/2021,2/18/2021,Halley Bowman,Imported from Bank of America Visa-Conference for Anna Hernandez EML Specialist,D101,HJ,20.9,,31257.55
6370,2/18/2021,2/18/2021,Halley Bowman,Imported from Bank of America Visa-Conference for Anna Hernandez EML Specialist,D101,HJ,32.3,,31289.85
6370,2/18/2021,2/18/2021,Halley Bowman,Imported from Bank of America Visa-Conference for Anna Hernandez EML Specialist,D101,HJ,32.3,,31322.15
6370,2/18/2021,2/18/2021,Halley Bowman,Imported from Bank of America Visa-Conference for Anna Hernandez EML Specialist,D101,HJ,41.25,,31363.4
6370,2/18/2021,2/18/2021,Halley Bowman,Imported from Bank of America Visa-Conference for Anna Hernandez EML Specialist,D101,HJ,104.5,,31467.9
6370,2/19/2021,2/19/2021,Tiffani Bibb,Imported from Bank of America Visa-Assessment for HR Admin Team,D104,HJ,59.97,,31527.87
6370,2/19/2021,2/19/2021,Tiffani Bibb,Imported from Bank of America Visa-Assessment for HR Admin Team,D104,HJ,141,,31668.87
6370,2/23/2021,2/23/2021,Halley Bowman,Imported from Bank of America Visa-working geniuses quiz,D101,HJ,1.38,,31670.25
6370,2/23/2021,2/23/2021,Halley Bowman,Imported from Bank of America Visa-working geniuses quiz,D101,HJ,2.12,,31672.37
6370,2/23/2021,2/23/2021,Halley Bowman,Imported from Bank of America Visa-working geniuses quiz,D101,HJ,2.13,,31674.5
6370,2/23/2021,2/23/2021,Halley Bowman,Imported from Bank of America Visa-working geniuses quiz,D101,HJ,6.87,,31681.37
6370,2/23/2021,2/23/2021,Myesha Hossain,Imported from Bank of America Visa-SD PD,D108,HJ,5.99,,31687.36
6370,2/25/2021,2/25/2021,Joseph Zarate,Imported from Bank of America Visa-credit return,D105,HJ,,1.19,31686.17
6370,3/1/2021,3/1/2021,Monivett Acevedo,Imported from Bank of America Visa,D107,HJ,16.9,,31703.07
6370,3/1/2021,3/1/2021,Myesha Hossain,Imported from Bank of America Visa,D108,HJ,28.6,,31731.67
6370,3/2/2021,3/2/2021,Monivett Acevedo,Imported from Bank of America Visa,D107,HJ,53.11,,31784.78
6370,3/2/2021,3/2/2021,Tiffani Bibb,Imported from Bank of America Visa,D104,HJ,83.98,,31868.76
6370,3/2/2021,3/2/2021,Tiffani Bibb,Imported from Bank of America Visa,D104,HJ,83.98,,31952.74
6370,3/3/2021,3/3/2021,Monivett Acevedo,Imported from Bank of America Visa,D107,HJ,49.99,,32002.73
6370,3/5/2021,3/5/2021,Maryellen Leneghan,Imported from Bank of America Visa,D108,HJ,19.99,,32022.72
6370,3/5/2021,3/5/2021,Myesha Hossain,Imported from Bank of America Visa,D108,HJ,,2.21,32020.51
6370,3/10/2021,3/10/2021,Halley Bowman,Imported from Bank of America Visa,D101,HJ,3.64,,32024.15
6370,3/10/2021,3/10/2021,Halley Bowman,Imported from Bank of America Visa,D101,HJ,3.64,,32027.79
6370,3/10/2021,3/10/2021,Halley Bowman,Imported from Bank of America Visa,D101,HJ,5.62,,32033.41
6370,3/10/2021,3/10/2021,Halley Bowman,Imported from Bank of America Visa,D101,HJ,5.62,,32039.03
6370,3/10/2021,3/10/2021,Halley Bowman,Imported from Bank of America Visa,D101,HJ,5.62,,32044.65
6370,3/10/2021,3/10/2021,Halley Bowman,Imported from Bank of America Visa,D101,HJ,5.62,,32050.27
6370,3/10/2021,3/10/2021,Halley Bowman,Imported from Bank of America Visa,D101,HJ,18.19,,32068.46
6370,3/10/2021,3/10/2021,Halley Bowman,Imported from Bank of America Visa,D101,HJ,18.19,,32086.65
6370,3/15/2021,3/15/2021,Halley Bowman,Imported from Bank of America Visa,D101,HJ,1.63,,32088.28
6370,3/15/2021,3/15/2021,Halley Bowman,Imported from Bank of America Visa,D101,HJ,2.51,,32090.79
6370,3/15/2021,3/15/2021,Halley Bowman,Imported from Bank of America Visa,D101,HJ,2.51,,32093.3
6370,3/15/2021,3/15/2021,Halley Bowman,Imported from Bank of America Visa,D101,HJ,8.14,,32101.44
6370,3/18/2021,3/18/2021,Halley Bowman,Imported from Bank of America Visa,D101,HJ,8.69,,32110.13
6370,3/18/2021,3/18/2021,Halley Bowman,Imported from Bank of America Visa,D101,HJ,13.43,,32123.56
6370,3/18/2021,3/18/2021,Halley Bowman,Imported from Bank of America Visa,D101,HJ,13.43,,32136.99
6370,3/18/2021,3/18/2021,Halley Bowman,Imported from Bank of America Visa,D101,HJ,43.45,,32180.44
6370,3/18/2021,3/18/2021,Nicole Prahin,Imported from Bank of America Visa,D108,HJ,79,,32259.44
6370,3/22/2021,3/22/2021,Monivett Acevedo,Imported from Bank of America Visa,D107,HJ,49.99,,32309.43
6370,3/24/2021,3/24/2021,Halley Bowman,Imported from Bank of America Visa,D101,HJ,1.75,,32311.18
6370,3/24/2021,3/24/2021,Halley Bowman,Imported from Bank of America Visa,D101,HJ,2.7,,32313.88
6370,3/24/2021,3/24/2021,Halley Bowman,Imported from Bank of America Visa,D101,HJ,2.7,,32316.58
6370,3/24/2021,3/24/2021,Halley Bowman,Imported from Bank of America Visa,D101,HJ,8.74,,32325.32
6370,3/24/2021,3/24/2021,Monivett Acevedo,Imported from Bank of America Visa,D107,HJ,21.24,,32346.56
6370,3/24/2021,3/24/2021,Thomas Fischaber,Imported from Bank of America Visa,D109,HJ,209.94,,32556.5
6370,4/1/2021,4/1/2021,Nicole Prahin,Imported from Bank of America Visa,D108,HJ,51.39,,32607.89
6370,4/7/2021,4/7/2021,Halley Bowman,Imported from Bank of America Visa,D101,HJ,4.74,,32612.63
6370,4/7/2021,4/7/2021,Halley Bowman,Imported from Bank of America Visa,D101,HJ,7.33,,32619.96
6370,4/7/2021,4/7/2021,Halley Bowman,Imported from Bank of America Visa,D101,HJ,7.33,,32627.29
6370,4/7/2021,4/7/2021,Halley Bowman,Imported from Bank of America Visa,D101,HJ,23.71,,32651
6370,4/7/2021,4/7/2021,Nicole Prahin,Imported from Bank of America Visa,D108,HJ,22,,32673
6370,4/15/2021,4/15/2021,Tiffani Bibb,Imported from reimbursements,D107,HJ,2395,,35068
6370,4/16/2021,4/16/2021,Tiffani Bibb,Imported from Bank of America Visa,D104,HJ,81.99,,35149.99
6370,4/16/2021,4/16/2021,Tiffani Bibb,Imported from Bank of America Visa,D104,HJ,81.99,,35231.98
6370,4/16/2021,4/16/2021,Tiffani Bibb,Imported from Bank of America Visa,D104,HJ,81.99,,35313.97
6370,4/16/2021,4/16/2021,Tiffani Bibb,Imported from Bank of America Visa,D104,HJ,81.99,,35395.96
6370,4/19/2021,4/19/2021,Tiffani Bibb,Imported from Bank of America Visa,D104,HJ,81.99,,35477.95
6370,4/19/2021,4/19/2021,Tiffani Bibb,Imported from Bank of America Visa,D104,HJ,81.99,,35559.94
6370,4/19/2021,4/19/2021,Tiffani Bibb,Imported from Bank of America Visa,D104,HJ,81.99,,35641.93
6370,4/19/2021,4/19/2021,Tiffani Bibb,Imported from Bank of America Visa,D104,HJ,86.91,,35728.84
6370,4/23/2021,4/23/2021,Tiffani Bibb,Imported from Bank of America Visa,D104,HJ,3295,,39023.84
6370,4/23/2021,4/23/2021,Tiffani Bibb,Imported from Bank of America Visa,D104,HJ,,81.99,38941.85
6370,4/27/2021,4/27/2021,Halley Bowman,Imported from Bank of America Visa,D101,HJ,13.63,,38955.48
6370,4/27/2021,4/27/2021,Halley Bowman,Imported from Bank of America Visa,D101,HJ,26.45,,38981.93
6370,4/27/2021,4/27/2021,Tiffani Bibb,Imported from Bank of America Visa,D104,HJ,80.86,,39062.79
6370,5/5/2021,5/5/2021,Tiffani Bibb,Imported from Bank of America Visa,D104,HJ,279,,39341.79
6370,5/7/2021,5/7/2021,Halley Bowman,Imported from Bank of America Visa,D101,HJ,7.44,,39349.23
6370,5/7/2021,5/7/2021,Halley Bowman,Imported from Bank of America Visa,D101,HJ,11.49,,39360.72
6370,5/7/2021,5/7/2021,Halley Bowman,Imported from Bank of America Visa,D101,HJ,37.19,,39397.91
6370,5/7/2021,5/7/2021,Halley Bowman,Imported from Bank of America Visa,D109,HJ,11.49,,39409.4
6370,5/10/2021,5/10/2021,Halley Bowman,Imported from Bank of America Visa,D101,HJ,22.58,,39431.98
6370,5/10/2021,5/10/2021,Halley Bowman,Imported from Bank of America Visa,D101,HJ,34.89,,39466.87
6370,5/10/2021,5/10/2021,Halley Bowman,Imported from Bank of America Visa,D101,HJ,112.87,,39579.74
6370,5/10/2021,5/10/2021,Halley Bowman,Imported from Bank of America Visa,D109,HJ,34.89,,39614.63
6370,5/11/2021,5/11/2021,Halley Bowman,Imported from Bank of America Visa,D101,HJ,1.9,,39616.53
6370,5/11/2021,5/11/2021,Halley Bowman,Imported from Bank of America Visa,D101,HJ,2.94,,39619.47
6370,5/11/2021,5/11/2021,Halley Bowman,Imported from Bank of America Visa,D101,HJ,9.51,,39628.98
6370,5/11/2021,5/11/2021,Halley Bowman,Imported from Bank of America Visa,D109,HJ,2.94,,39631.92
6370,5/11/2021,5/11/2021,Mahaliah Sejour,Imported from Bank of America Visa,D108,HJ,14.18,,39646.1
6370,5/12/2021,5/12/2021,Nicole Prahin,Imported from Bank of America Visa,D108,HJ,87.18,,39733.28
6370,5/12/2021,5/12/2021,Nicole Prahin,Imported from Bank of America Visa,D108,HJ,87.98,,39821.26
6370,5/14/2021,5/14/2021,Odalis Polanco,Imported from Bank of America Visa,D103,HJ,150,,39971.26
6370,5/14/2021,5/14/2021,Tiffani Bibb,Imported from Bank of America Visa,D104,HJ,150,,40121.26
6370,5/20/2021,5/20/2021,Mahaliah Sejour,Imported from Bank of America Visa,D108,HJ,30.46,,40151.72
6370,5/20/2021,5/20/2021,Mahaliah Sejour,Imported from Bank of America Visa,D108,HJ,34.93,,40186.65
6370,5/20/2021,5/20/2021,Nicole Prahin,Imported from Bank of America Visa,D108,HJ,199.9,,40386.55
6370,5/21/2021,5/21/2021,Mahaliah Sejour,Imported from Bank of America Visa,D108,HJ,19.9,,40406.45
6370,5/21/2021,5/21/2021,Mahaliah Sejour,Imported from Bank of America Visa,D108,HJ,31.9,,40438.35
6370,5/27/2021,5/27/2021,Nicole Prahin,Imported from Bank of America Visa,D108,HJ,104.16,,40542.51
6370,5/28/2021,5/28/2021,Nicole Prahin,Imported from Bank of America Visa,D108,HJ,85.55,,40628.06
6370,6/7/2021,6/7/2021,Halley Bowman,Imported from Bank of America Visa,D101,HJ,18.33,,40646.39
6370,6/8/2021,6/8/2021,Halley Bowman,Imported from Bank of America Visa,D101,HJ,33.37,,40679.76
6370,6/8/2021,6/8/2021,Halley Bowman,Imported from Bank of America Visa,D101,HJ,45.64,,40725.4
6370,6/11/2021,6/11/2021,Monivett Acevedo,Imported from Bank of America Visa,D107,HJ,8.79,,40734.19
6370,6/15/2021,6/15/2021,Thomas Fischaber,Imported from Bank of America Visa,D109,HJ,800,,41534.19
6370,6/24/2021,6/24/2021,Halley Bowman,Imported from Bank of America Visa,D101,HJ,12.78,,41546.97
6370,6/24/2021,6/24/2021,Nicole Prahin,Imported from Bank of America Visa,D108,HJ,8.71,,41555.68
6370,6/28/2021,6/28/2021,Halley Bowman,Imported from Bank of America Visa,D101,HJ,11.99,,41567.67
6370,6/28/2021,6/28/2021,Kyra Detone,Imported from Bank of America Visa,D102,HJ,150,,41717.67
6370, Totals for 6370 - Professional Development,,,,,,66396.27,24678.6,41717.67
6380,6380 - Business Registration and Filing Fees (Balance forward As of 07/01/2020) ,,,,,,,,0
6380,7/2/2020,7/2/2020,Monivett Acevedo,Imported from Bank of America Visa-SAM Registration Renewal,D103,HJ,49,,49
6380,7/10/2020,7/10/2020,Monivett Acevedo,Imported from Bank of America Visa-COI for CPS,D103,HJ,12,,61
6380,7/25/2020,7/25/2020,Monivett Acevedo,Imported from Bank of America Visa-Filing fee for Colorado,D103,HJ,100,,161
6380,7/27/2020,7/27/2020,Registration Section,Registration Section - Div of Corporations-Check 2019 - Registration Section - Div of Corporations,D103,HJ,70,,231
6380,7/27/2020,7/27/2020,Registration Section,Registration Section - Div of Corporations-Check 2020 Registration Section - Div of Corporations,D103,HJ,8.75,,239.75
6380,7/30/2020,7/30/2020,Voices for National,Bill.Com Import-Voices for National Service Membership Dues. Fiscal Year 2021 from July 1 2020 to June 30 2021,D107,HJ,1500,,1739.75
6380,8/7/2020,8/7/2020,ADP,State and Local Jurisdiction fees-State and Local Jurisdiction fees,D104,HJ,62.65,,1802.4
6380,9/29/2020,9/29/2020,Antonio Gutierrez,Imported from Bank of America Visa-filing fee,D107,HJ,3.5,,1805.9
6380,9/29/2020,9/29/2020,Antonio Gutierrez,Imported from Bank of America Visa-filing fee,D107,HJ,15,,1820.9
6380,9/29/2020,9/29/2020,Antonio Gutierrez,Imported from Bank of America Visa-filing fee,D107,HJ,299,,2119.9
6380,10/1/2020,10/1/2020,Monivett Acevedo,Imported from reimbursements-register for TSA pre check,D103,HJ,85,,2204.9
6380,10/1/2020,10/1/2020,Monivett Acevedo,Imported from reimbursements-Business Registration and Filing Fees,D103,HJ,3,,2207.9
6380,10/1/2020,10/1/2020,Monivett Acevedo,Imported from reimbursements-Business Registration and Filing Fees,D103,HJ,12,,2219.9
6380,10/16/2020,10/16/2020,WM,Cash received from Woot Math Acquisition-Cash received from Woot Math Acquisition,D109,HJ,5356.31,,7576.21
6380,11/17/2020,11/17/2020,20201117,Settlement of Q Philogene small claims case-Settlement of Q Philogene small claims case,D107,HJ,1400,,8976.21
6380,11/20/2020,11/20/2020,2023,EPTL filing fee-EPTL filing fee,D103,HJ,250,,9226.21
6380,11/24/2020,11/24/2020,Emptech,Bill.Com Import-TASC Tax Advisory Services,D103,HJ,1596,,10822.21
6380,11/27/2020,11/27/2020,Emptech,Bill.Com Import-TASC Tax Advisory Services,D103,HJ,1596,,12418.21
6380,12/10/2020,12/10/2020,Emptech,Bill.Com Import-TASC Tax Advisory Services. payment 3 of 4,D103,HJ,1596,,14014.21
6380,12/21/2020,12/21/2020,Antonio Gutierrez,Imported from Bank of America Visa-Registered Agent Fee Maryland,D107,HJ,49,,14063.21
6380,12/29/2020,12/29/2020,Emptech,Bill.Com Import-TASC Tax Advisory Services. payment 4 of 4,D103,HJ,1596,,15659.21
6380,12/31/2020,12/31/2020,20201231,Actual vs Budget Reclass as of 12/31/2020-Actual vs Budget Reclass as of 12/31/2020,D103,HJ,62.65,,15721.86
6380,12/31/2020,12/31/2020,20201231,Actual vs Budget Reclass as of 12/31/2020-Actual vs Budget Reclass as of 12/31/2020,D104,HJ,,62.65,15659.21
6380,1/14/2021,1/14/2021,Emptech,Bill.Com Import-TASC Tax Advisory Services. payment 4 of 4,D103,HJ,333,,15992.21
6380,1/14/2021,1/14/2021,Internal Revenue Ser,Bill.Com Import-Late fee penalty form 5500,D103,HJ,8750,,24742.21
6380,1/20/2021,1/20/2021,Monivett Acevedo,Imported from Bank of America Visa-1099 filings,D107,HJ,29.9,,24772.11
6380,1/25/2021,1/25/2021,Emptech,Bill.Com Import-TASC Tax Advisory Services. payment 12.16.20,D103,HJ,333,,25105.11
6380,1/28/2021,1/28/2021,Emptech,Bill.Com Import-TASC Tax Advisory Services. payment 2 of 4,D103,HJ,333,,25438.11
6380,1/28/2021,1/28/2021,Monivett Acevedo,Imported from Bank of America Visa-1099 filings,D107,HJ,7.45,,25445.56
6380,2/2/2021,2/2/2021,Tiffani Bibb,Imported from Bank of America Visa-Labor And Insurance Fees for Washington-,D103,HJ,70.48,,25516.04
6380,2/2/2021,2/2/2021,Tiffani Bibb,Imported from Bank of America Visa-Labor And Insurance Fees for Washington-,D103,HJ,112.68,,25628.72
6380,2/2/2021,2/2/2021,Tiffani Bibb,Imported from Bank of America Visa-Labor And Insurance Fees for Washington-processing fee,D103,HJ,3.95,,25632.67
6380,2/2/2021,2/2/2021,Tiffani Bibb,Imported from Bank of America Visa-Labor and Insurance Fees for WA,D103,HJ,3.95,,25636.62
6380,2/5/2021,2/5/2021,Kira Graves,Settlement Agreement and general release between Kira Graces and X Co. -Settlement Agreement and general release between Kira Graces and X Co. ,D103,HJ,1700,,27336.62
6380,2/10/2021,2/10/2021,InCorp Services Inc,Bill.Com Import-Registered. Resident Agent Service for IL,D103,HJ,99,,27435.62
6380,2/22/2021,2/22/2021,IL Secretary of Stat,X Co.  IL Secretary of State Filing Fee-X Co.  IL Secretary of State Filing Fee,D103,HJ,10,,27445.62
6380,2/25/2021,2/25/2021,MA Attorney General,Filing for the MA Form PC for FY20-Filing for the MA Form PC for FY20,D103,HJ,1000,,28445.62
6380,3/10/2021,3/10/2021,Monivett Acevedo,Imported from Bank of America Visa,D107,HJ,3,,28448.62
6380,3/10/2021,3/10/2021,Monivett Acevedo,Imported from Bank of America Visa,D107,HJ,3.5,,28452.12
6380,3/10/2021,3/10/2021,Monivett Acevedo,Imported from Bank of America Visa,D107,HJ,9,,28461.12
6380,3/10/2021,3/10/2021,Monivett Acevedo,Imported from Bank of America Visa,D107,HJ,9,,28470.12
6380,3/10/2021,3/10/2021,Monivett Acevedo,Imported from Bank of America Visa,D107,HJ,12,,28482.12
6380,3/10/2021,3/10/2021,Monivett Acevedo,Imported from Bank of America Visa,D107,HJ,15,,28497.12
6380,3/10/2021,3/10/2021,Monivett Acevedo,Imported from Bank of America Visa,D107,HJ,250,,28747.12
6380,3/10/2021,3/10/2021,Monivett Acevedo,Imported from Bank of America Visa,D107,HJ,300,,29047.12
6380,3/10/2021,3/10/2021,Monivett Acevedo,Imported from Bank of America Visa,D107,HJ,300,,29347.12
6380,3/12/2021,3/12/2021,Monivett Acevedo,Imported from Bank of America Visa,D107,HJ,4.5,,29351.62
6380,3/12/2021,3/12/2021,Monivett Acevedo,Imported from Bank of America Visa,D107,HJ,9,,29360.62
6380,3/12/2021,3/12/2021,Monivett Acevedo,Imported from Bank of America Visa,D107,HJ,45,,29405.62
6380,3/12/2021,3/12/2021,Monivett Acevedo,Imported from Bank of America Visa,D107,HJ,150,,29555.62
6380,3/15/2021,3/15/2021,Monivett Acevedo,Imported from Bank of America Visa,D107,HJ,51.5,,29607.12
6380,3/17/2021,3/17/2021,Monivett Acevedo,Imported from Bank of America Visa,D107,HJ,50,,29657.12
6380,3/17/2021,3/17/2021,Monivett Acevedo,Imported from Bank of America Visa,D107,HJ,50,,29707.12
6380,3/17/2021,3/17/2021,Monivett Acevedo,Imported from Bank of America Visa,D107,HJ,50,,29757.12
6380,3/22/2021,3/22/2021,Monivett Acevedo,Imported from Bank of America Visa,D107,HJ,130,,29887.12
6380,3/24/2021,3/24/2021,Emptech,Bill.Com Import,D103,HJ,333,,30220.12
6380,3/24/2021,3/24/2021,Monivett Acevedo,Imported from Bank of America Visa,D107,HJ,125,,30345.12
6380,3/24/2021,3/24/2021,Monivett Acevedo,Imported from Bank of America Visa,D107,HJ,130,,30475.12
6380,3/24/2021,3/24/2021,Monivett Acevedo,Imported from Bank of America Visa,D107,HJ,225,,30700.12
6380,4/5/2021,4/5/2021,ADP,ADP state UI filings and penalties April 2021,D103,HJ,29.17,,30729.29
6380,4/5/2021,4/5/2021,Monivett Acevedo,Imported from Bank of America Visa,D107,HJ,6,,30735.29
6380,4/7/2021,4/7/2021,Monivett Acevedo,Imported from Bank of America Visa,D107,HJ,7,,30742.29
6380,4/7/2021,4/7/2021,Monivett Acevedo,Imported from Bank of America Visa,D107,HJ,125,,30867.29
6380,4/12/2021,4/12/2021,ADP,ADP state UI filings and penalties April 2021,D103,HJ,30.71,,30898
6380,4/12/2021,4/12/2021,Monivett Acevedo,Imported from Bank of America Visa,D107,HJ,25.68,,30923.68
6380,4/13/2021,4/13/2021,Emptech,Bill.Com Import,D103,HJ,593.38,,31517.06
6380,4/13/2021,4/13/2021,Monivett Acevedo,Imported from Bank of America Visa,D107,HJ,131.25,,31648.31
6380,4/16/2021,4/16/2021,Tiffani Bibb,Imported from Bank of America Visa,D104,HJ,3.95,,31652.26
6380,4/16/2021,4/16/2021,Tiffani Bibb,Imported from Bank of America Visa,D104,HJ,106.13,,31758.39
6380,4/27/2021,4/27/2021,Emptech,Bill.Com Import,D103,HJ,860,,32618.39
6380,4/28/2021,4/28/2021,Monivett Acevedo,Imported from Bank of America Visa,D107,HJ,45,,32663.39
6380,5/1/2021,5/1/2021,Monivett Acevedo,Imported from Bank of America Visa,D107,HJ,,150,32513.39
6380,5/11/2021,5/11/2021,Emptech,Bill.Com Import,D103,HJ,765,,33278.39
6380,5/11/2021,5/11/2021,RI DOT,Tax Exemption Request from RI,D103,HJ,25,,33303.39
6380,5/12/2021,5/12/2021,ADP,ADP state UI filings and penatlies May 2021,D103,HJ,33.84,,33337.23
6380,5/14/2021,5/14/2021,ADP,ADP state UI filings and penatlies May 2021,D103,HJ,71.23,,33408.46
6380,6/1/2021,6/1/2021,1,To reclassify Expenses bet departments,D104,HJ,,110.08,33298.38
6380,6/1/2021,6/1/2021,1,To reclassify Expenses bet departments,D107,HJ,110.08,,33408.46
6380,6/1/2021,6/1/2021,Emptech,Bill.Com Import,D103,HJ,255,,33663.46
6380,6/7/2021,6/7/2021,Emptech,Bill.Com Import,D103,HJ,592,,34255.46
6380,6/10/2021,6/10/2021,CD-21-0313,Check 2028,D107,HJ,25,,34280.46
6380,6/24/2021,6/24/2021,Monivett Acevedo,Imported from Bank of America Visa,D107,HJ,50,,34330.46
6380,6/24/2021,6/24/2021,Odalis Polanco,Imported from Bank of America Visa,D103,HJ,10,,34340.46
6380, Totals for 6380 - Business Registration and Filing Fees,,,,,,34663.19,322.73,34340.46
6400,6400 - Space Rental (Balance forward As of 07/01/2020) ,,,,,,,,0
6400,7/2/2020,7/2/2020,Angela Mason,Imported from Bank of America Visa-Chicago Storage,D111,HJ,149,,149
6400,7/2/2020,7/2/2020,Angela Mason,Imported from Bank of America Visa-Chicago Storage,D111,HJ,173,,322
6400,7/29/2020,7/29/2020,Myesha Hossain,Imported from Bank of America Visa-Storage,D108,HJ,56.59,,378.59
6400,7/30/2020,7/30/2020,Myesha Hossain,Imported from Bank of America Visa-Storage,D108,HJ,19.59,,398.18
6400,8/2/2020,8/2/2020,Angela Mason,Imported from Bank of America Visa-Storage Unit for Chicago,D107,HJ,149,,547.18
6400,8/2/2020,8/2/2020,Angela Mason,Imported from Bank of America Visa-Storage units for Chicago,D107,HJ,173,,720.18
6400,8/3/2020,8/3/2020,City Colleges of Chi,Bill.Com Import-Rental space for training 08.19-08.23,D108,HJ,,3845,-3124.82
6400,8/3/2020,8/3/2020,City Colleges of Chi,Bill.Com Import-Rental space for training 08.19-08.23,D108,HJ,3845,,720.18
6400,8/10/2020,8/10/2020,City Colleges of Chi,Bill.Com Import-Rental space for training 08.19-08.23,D108,HJ,,3845,-3124.82
6400,8/14/2020,8/14/2020,City Colleges of Chi,Bill.Com Import-Rental space for training 08.19-08.23,D108,HJ,3845,,720.18
6400,8/27/2020,8/27/2020,City Colleges of Chi,Bill.Com Import-Rental space for training 08.19 to 08.23,D108,HJ,,3845,-3124.82
6400,8/29/2020,8/29/2020,Myesha Hossain,Imported from Bank of America Visa-Storage,D108,HJ,95.3,,-3029.52
6400,9/2/2020,9/2/2020,Angela Mason,Imported from Bank of America Visa-Storage unit,D111,HJ,149,,-2880.52
6400,9/2/2020,9/2/2020,Angela Mason,Imported from Bank of America Visa-Storage unit Chicago,D111,HJ,173,,-2707.52
6400,9/21/2020,9/21/2020,Myesha Hossain,Imported from Bank of America Visa-Storage,D108,HJ,37,,-2670.52
6400,10/2/2020,10/2/2020,Angela Mason,Imported from reimbursements-Chicago storage unit,D111,HJ,149,,-2521.52
6400,10/2/2020,10/2/2020,Angela Mason,Imported from reimbursements-Chicago storage unit,D111,HJ,173,,-2348.52
6400,10/24/2020,10/24/2020,Myesha Hossain,Imported from reimbursements-Storage,D108,HJ,157.35,,-2191.17
6400,11/2/2020,11/2/2020,Angela Mason,Imported from Bank of America Visa-Chicago storage unit,D107,HJ,149,,-2042.17
6400,11/2/2020,11/2/2020,Angela Mason,Imported from Bank of America Visa-Chicago storage unit,D107,HJ,173,,-1869.17
6400,11/18/2020,11/18/2020,Myesha Hossain,Imported from Bank of America Visa-NYC Storage,D107,HJ,159.3,,-1709.87
6400,12/2/2020,12/2/2020,Mahaliah Sejour,Imported from Bank of America Visa-storage unit,D107,HJ,149,,-1560.87
6400,12/2/2020,12/2/2020,Mahaliah Sejour,Imported from Bank of America Visa-storage unit,D107,HJ,173,,-1387.87
6400,12/21/2020,12/21/2020,Myesha Hossain,Imported from Bank of America Visa-NYC Storage,D107,HJ,159.3,,-1228.57
6400,12/31/2020,12/31/2020,20201231,Actual vs Budget Reclass as of 12/31/2020-Actual vs Budget Reclass as of 12/31/2020,D104,HJ,21186,,19957.43
6400,12/31/2020,12/31/2020,20201231,Actual vs Budget Reclass as of 12/31/2020-Actual vs Budget Reclass as of 12/31/2020,D107,HJ,190.94,,20148.37
6400,12/31/2020,12/31/2020,20201231,Actual vs Budget Reclass as of 12/31/2020-Actual vs Budget Reclass as of 12/31/2020,D107,HJ,966,,21114.37
6400,12/31/2020,12/31/2020,20201231,Actual vs Budget Reclass as of 12/31/2020-Actual vs Budget Reclass as of 12/31/2020,D108,HJ,,556.77,20557.6
6400,12/31/2020,12/31/2020,20201231,Actual vs Budget Reclass as of 12/31/2020-Actual vs Budget Reclass as of 12/31/2020,D108,HJ,,3845.01,16712.59
6400,12/31/2020,12/31/2020,20201231,Actual vs Budget Reclass as of 12/31/2020-Actual vs Budget Reclass as of 12/31/2020,D108,HJ,3845.01,,20557.6
6400,12/31/2020,12/31/2020,20201231,Actual vs Budget Reclass as of 12/31/2020-Actual vs Budget Reclass as of 12/31/2020,D111,HJ,,1110.99,19446.61
6400,1/2/2021,1/2/2021,Mahaliah Sejour,Imported from Bank of America Visa-Programs storage,D107,HJ,149,,19595.61
6400,1/2/2021,1/2/2021,Mahaliah Sejour,Imported from Bank of America Visa-Recruitment storage,D107,HJ,173,,19768.61
6400,1/6/2021,1/6/2021,Thomas Fischaber,Imported from Bank of America Visa-woot math office storage,D109,HJ,1200,,20968.61
6400,1/24/2021,1/24/2021,Myesha Hossain,Imported from Bank of America Visa-Storage,D107,HJ,159.3,,21127.91
6400,2/2/2021,2/2/2021,Mahaliah Sejour,Imported from Bank of America Visa-programs storage,D107,HJ,149,,21276.91
6400,2/2/2021,2/2/2021,Mahaliah Sejour,Imported from Bank of America Visa-recruitment storage,D107,HJ,173,,21449.91
6400,2/22/2021,2/22/2021,Myesha Hossain,Imported from Bank of America Visa-NYC Storage,D107,HJ,159.3,,21609.21
6400,3/2/2021,3/2/2021,Mahaliah Sejour,Imported from Bank of America Visa,D107,HJ,149,,21758.21
6400,3/2/2021,3/2/2021,Mahaliah Sejour,Imported from Bank of America Visa,D107,HJ,173,,21931.21
6400,3/22/2021,3/22/2021,Myesha Hossain,Imported from Bank of America Visa,D107,HJ,177.95,,22109.16
6400,4/1/2021,4/1/2021,Thomas Fischaber,Imported from Bank of America Visa,D109,HJ,800,,22909.16
6400,4/1/2021,4/1/2021,Thomas Fischaber,Imported from Bank of America Visa,D109,HJ,700,,23609.16
6400,4/2/2021,4/2/2021,Mahaliah Sejour,Imported from Bank of America Visa,D107,HJ,149,,23758.16
6400,4/2/2021,4/2/2021,Mahaliah Sejour,Imported from Bank of America Visa,D107,HJ,173,,23931.16
6400,4/19/2021,4/19/2021,Myesha Hossain,Imported from Bank of America Visa,D108,HJ,177.95,,24109.11
6400,4/22/2021,4/22/2021,Thomas Fischaber,Imported from Bank of America Visa,D109,HJ,800,,24909.11
6400,5/1/2021,5/1/2021,Mahaliah Sejour,Imported from Bank of America Visa,D107,HJ,149,,25058.11
6400,5/1/2021,5/1/2021,Mahaliah Sejour,Imported from Bank of America Visa,D107,HJ,173,,25231.11
6400,5/1/2021,5/1/2021,Thomas Fischaber,Imported from Bank of America Visa,D109,HJ,700,,25931.11
6400,5/24/2021,5/24/2021,Myesha Hossain,Imported from Bank of America Visa,D108,HJ,177.95,,26109.06
6400,6/1/2021,6/1/2021,1,To reclassify Expenses bet departments,D104,HJ,,21186,4923.06
6400,6/1/2021,6/1/2021,Mahaliah Sejour,Imported from Bank of America Visa,D107,HJ,149,,5072.06
6400,6/1/2021,6/1/2021,Mahaliah Sejour,Imported from Bank of America Visa,D107,HJ,173,,5245.06
6400,6/1/2021,6/1/2021,Thomas Fischaber,Imported from Bank of America Visa,D109,HJ,700,,5945.06
6400,6/2/2021,6/2/2021,Myesha Hossain,Imported from Bank of America Visa,D107,HJ,177.95,,6123.01
6400,6/24/2021,6/24/2021,Myesha Hossain,Imported from Bank of America Visa,D107,HJ,106.84,,6229.85
6400, Totals for 6400 - Space Rental,,,,,,44463.62,38233.77,6229.85
6420,6420 - Rent and Utilities (Balance forward As of 07/01/2020) ,,,,,,,,0
6420,7/1/2020,7/1/2020,correct entry,To reduce the monthly rent amount to tie with agreement-Correct amount for Walnut St from 6/1/2020-5/1/2022,D107,HJ,,18.78,-18.78
6420,7/1/2020,7/1/2020,Eversource,Bill.Com Import-September Electricity Aug 14 2019 to Sep 14 2019,D107,HJ,0.66,,-18.12
6420,7/1/2020,7/1/2020,Fix Accrued Rent,To clear office rent accrual for 4 months-Fix Accrued Rent for Walnut St from 6/1/2020-9/1/2020,D107,HJ,,2178.87,-2196.99
6420,7/1/2020,7/1/2020,Fix Accrued Rent,To clear office rent accrual for 4 months-Fix Accrued Rent for Walnut St from 6/1/2020-9/1/2020,D107,HJ,,2747.06,-4944.05
6420,7/1/2020,7/1/2020,July 2020 Rent,Rent for Boston office-To record rent for Boston Office,D107,HJ,,1630.23,-6574.28
6420,7/1/2020,7/1/2020,July 2020 Rent,Rent for Boston office-To record rent for Boston Office,D107,HJ,1630.23,,-4944.05
6420,7/1/2020,7/1/2020,Recurring rent,Accrual for Walnut St from 6/1/2020-11/30/2022-Accrual for Walnut St from 6/1/2020-5/1/2022,D107,HJ,2197.65,,-2746.4
6420,7/8/2020,7/8/2020,Eversource,July electricity expenses-July electricity expenses,D107,HJ,32.46,,-2713.94
6420,7/9/2020,7/9/2020,Inspire Business Cen,July rent and June credit for Jackson Center-July rent and June credit for Jackson Center,D113,HJ,,475,-3188.94
6420,7/9/2020,7/9/2020,Inspire Business Cen,July rent and June credit for Jackson Center-July rent and June credit for Jackson Center,D113,HJ,500,,-2688.94
6420,7/23/2020,7/23/2020,Mighty Good Agency,Bill.Com Import-Brand strategy for the M&A.,D107,HJ,1750,,-938.94
6420,7/24/2020,7/24/2020,Walnut Street Realty,Bill.Com Import-Monthly rent for Newton office Suite 102.,D107,HJ,2178.87,,1239.93
6420,8/1/2020,8/1/2020,correct entry,To reduce the monthly rent amount to tie with agreement-Correct amount for Walnut St from 6/1/2020-5/1/2022,D107,HJ,,18.78,1221.15
6420,8/1/2020,8/1/2020,Fix Accrued Rent,To clear office rent accrual for 4 months-Fix Accrued Rent for Walnut St from 6/1/2020-9/1/2020,D107,HJ,,2178.87,-957.72
6420,8/1/2020,8/1/2020,Recurring rent,Accrual for Walnut St from 6/1/2020-11/30/2022-Accrual for Walnut St from 6/1/2020-5/1/2022,D107,HJ,2197.65,,1239.93
6420,8/10/2020,8/10/2020,Inspire Business Cen,August Jackson Center rent-August Jackson Center rent,D107,HJ,500,,1739.93
6420,8/11/2020,8/11/2020,Eversource,August electricity expense-August electricity expense,D107,HJ,30.34,,1770.27
6420,8/26/2020,8/26/2020,Eversource,Bill.Com Import-Bill.Com Import,D107,HJ,0.66,,1770.93
6420,8/26/2020,8/26/2020,Walnut Street Realty,Bill.Com Import-Recurring Bill Monthly rent for office at Newton,D107,HJ,2178.87,,3949.8
6420,8/28/2020,8/28/2020,Eversource,Bill.Com Import-September Electricity 08.14 to 09.14,D107,HJ,,0.66,3949.14
6420,9/1/2020,9/1/2020,correct entry,To reduce the monthly rent amount to tie with agreement-Correct amount for Walnut St from 6/1/2020-5/1/2022,D107,HJ,,18.78,3930.36
6420,9/1/2020,9/1/2020,Fix Accrued Rent,To clear office rent accrual for 4 months-Fix Accrued Rent for Walnut St from 6/1/2020-9/1/2020,D107,HJ,,2178.87,1751.49
6420,9/1/2020,9/1/2020,Recurring rent,Accrual for Walnut St from 6/1/2020-11/30/2022-Accrual for Walnut St from 6/1/2020-5/1/2022,D107,HJ,2197.65,,3949.14
6420,9/1/2020,9/1/2020,20-Sep,To accrue Inspire Business Center Sep Oct and Nov remaining rent-To accrue Inspire Business Center Sep Oct and Nov remaining rent,D107,HJ,475,,4424.14
6420,9/8/2020,9/8/2020,Eversource,September electricity expense-September electricity expense,D107,HJ,38.74,,4462.88
6420,9/9/2020,9/9/2020,Inspire Business Cen,Jackson Center September rent-Jackson Center September rent,D107,HJ,500,,4962.88
6420,9/25/2020,9/25/2020,Walnut Street Realty,Bill.Com Import-Recurring Bill Monthly rent for office at Newton,D107,HJ,2178.87,,7141.75
6420,10/1/2020,10/1/2020,correct entry,To reduce the monthly rent amount to tie with agreement-Correct amount for Walnut St from 6/1/2020-5/1/2022,D107,HJ,,18.78,7122.97
6420,10/1/2020,10/1/2020,Fix 2Q Rent,To clear office rent accrual for 2Q-FY20-Fix Accrued Rent for Walnut St from 10/1/2020-12/1/2020,D107,HJ,,2178.87,4944.1
6420,10/1/2020,10/1/2020,20-Oct,To accrue Inspire Business Center Sep Oct and Nov remaining rent-To accrue Inspire Business Center Sep Oct and Nov remaining rent,D107,HJ,475,,5419.1
6420,10/1/2020,10/1/2020,Recurring rent,Accrual for Walnut St from 6/1/2020-11/30/2022-Accrual for Walnut St from 6/1/2020-5/1/2022,D107,HJ,2197.65,,7616.75
6420,10/5/2020,10/5/2020,Comcast,October Comcast payment-October Comcast payment for office,D107,HJ,139.55,,7756.3
6420,10/7/2020,10/7/2020,Eversource,October Eversource payment-October Eversource payment,D107,HJ,31.93,,7788.23
6420,10/9/2020,10/9/2020,Inspire Business Cen,Jackson Center October rent-Jackson Center October rent,D107,HJ,500,,8288.23
6420,10/27/2020,10/27/2020,Walnut Street Realty,Bill.Com Import-Recurring Bill Monthly rent for office at Newton,D107,HJ,2178.87,,10467.1
6420,11/1/2020,11/1/2020,correct entry,To reduce the monthly rent amount to tie with agreement-Correct amount for Walnut St from 6/1/2020-5/1/2022,D107,HJ,,18.78,10448.32
6420,11/1/2020,11/1/2020,Fix 2Q Rent,To clear office rent accrual for 2Q-FY20-Fix Accrued Rent for Walnut St from 10/1/2020-12/1/2020,D107,HJ,,2178.87,8269.45
6420,11/1/2020,11/1/2020,20-Nov,To accrue Inspire Business Center Sep Oct and Nov remaining rent-To accrue Inspire Business Center Sep Oct and Nov remaining rent,D107,HJ,475,,8744.45
6420,11/1/2020,11/1/2020,Recurring rent,Accrual for Walnut St from 6/1/2020-11/30/2022-Accrual for Walnut St from 6/1/2020-5/1/2022,D107,HJ,2197.65,,10942.1
6420,11/5/2020,11/5/2020,Comcast,November Comcast payment-November Comcast payment,D107,HJ,139.55,,11081.65
6420,11/8/2020,11/8/2020,Inspire Business Cen,Jackson center part of the rent for November-Jackson center part of the rent for November,D107,HJ,500,,11581.65
6420,11/10/2020,11/10/2020,Eversource,November electricity expense-November electricity expense,D107,HJ,37.71,,11619.36
6420,11/17/2020,11/17/2020,CB,To correct the department coding for CB-To correct the department coding for CB,D105,HJ,25,,11644.36
6420,11/17/2020,11/17/2020,CB,To correct the department coding for CB-To correct the department coding for CB,D113,HJ,,25,11619.36
6420,12/1/2020,12/1/2020,correct entry,To reduce the monthly rent amount to tie with agreement-Correct amount for Walnut St from 6/1/2020-5/1/2022,D107,HJ,,18.78,11600.58
6420,12/1/2020,12/1/2020,Fix 2Q Rent,To clear office rent accrual for 2Q-FY20-Fix Accrued Rent for Walnut St from 10/1/2020-12/1/2020,D107,HJ,,2178.87,9421.71
6420,12/1/2020,12/1/2020,Recurring rent,Accrual for Walnut St from 6/1/2020-11/30/2022-Accrual for Walnut St from 6/1/2020-5/1/2022,D107,HJ,2197.65,,11619.36
6420,12/1/2020,12/1/2020,Walnut Street Realty,Bill.Com Import-Recurring Bill Monthly rent for office at Newton,D107,HJ,2261.13,,13880.49
6420,12/7/2020,12/7/2020,Comcast,December Comcast payment-December Comcast payment,D107,HJ,139.55,,14020.04
6420,12/8/2020,12/8/2020,Eversource,December Eversource payment-December Eversource payment,D107,HJ,35.76,,14055.8
6420,12/9/2020,12/9/2020,Inspire Business Cen,Jackson center December rent payment-Jackson center December rent parking,D107,HJ,988.3,,15044.1
6420,12/14/2020,12/14/2020,Eversource,Bill.Com Import-September Electricity 08.14.to 09.14,D107,HJ,,0.66,15043.44
6420,12/14/2020,12/14/2020,Eversource,Bill.Com Import-September Electricity 08.14.to 09.14,D107,HJ,0.66,,15044.1
6420,12/24/2020,12/24/2020,Walnut Street Realty,Bill.Com Import-Recurring Bill Monthly rent for office at Newton,D107,HJ,2192.58,,17236.68
6420,12/31/2020,12/31/2020,Eversource,Fixing Pay-by-Pay amount and Eversource-Fixing Pay-by-Pay amount and Eversource,D107,HJ,,1.66,17235.02
6420,1/1/2021,1/1/2021,correct entry,To reduce the monthly rent amount to tie with agreement-Correct amount for Walnut St from 6/1/2020-5/1/2022,D107,HJ,,18.78,17216.24
6420,1/1/2021,1/1/2021,Recurring rent,Accrual for Walnut St from 6/1/2020-11/30/2022-Accrual for Walnut St from 6/1/2020-5/1/2022,D107,HJ,2197.65,,19413.89
6420,1/11/2021,1/11/2021,Eversource,January Eversource Payment-January Eversource Payment,D107,HJ,40.97,,19454.86
6420,1/11/2021,1/11/2021,Inspire Business Cen,Jackson Center January rent parking Inspire Business Center-Jackson Center January rent parking Inspire Business Center,D107,HJ,975,,20429.86
6420,1/20/2021,1/20/2021,Inspire Business Cen,Jackson Center January rent parking Inspire Business Center-Jackson Center January rent parking Inspire Business Center,D107,HJ,3,,20432.86
6420,1/31/2021,1/31/2021,20210131,To Adj Walnut Accrued amount-To Adj Walnut Accrued amount,D107,HJ,13.71,,20446.57
6420,2/1/2021,2/1/2021,correct entry,To reduce the monthly rent amount to tie with agreement-Correct amount for Walnut St from 6/1/2020-5/1/2022,D107,HJ,,18.78,20427.79
6420,2/1/2021,2/1/2021,Recurring rent,Accrual for Walnut St from 6/1/2020-11/30/2022-Accrual for Walnut St from 6/1/2020-5/1/2022,D107,HJ,2197.65,,22625.44
6420,2/1/2021,2/1/2021,Recurring rent,JE-20-0026 Rev-Accrual for Walnut St from 6/1/2020-5/1/2022,D107,HJ,,2197.65,20427.79
6420,2/1/2021,2/1/2021,Recurring rent,JE-20-0026 Rev-Correct amount for Walnut St from 6/1/2020-5/1/2022,D107,HJ,18.78,,20446.57
6420,2/9/2021,2/9/2021,Eversource,February Eversource Payment-February Eversource Payment,D107,HJ,128.8,,20575.37
6420,2/9/2021,2/9/2021,Inspire Business Cen,Jackson Center February Rent parking Inspire Business Center-Jackson Center February Rent parking Inspire Business Center,D107,HJ,975,,21550.37
6420,2/23/2021,2/23/2021,Walnut Street Realty,Bill.Com Import-Recurring Bill Monthly rent for office at Newton,D107,HJ,2192.58,,23742.95
6420,3/1/2021,3/1/2021,correct entry,To reduce the monthly rent amount to tie with agreement,D107,HJ,,18.78,23724.17
6420,3/1/2021,3/1/2021,correct entry,JE-20-0026 Rev,D107,HJ,18.78,,23742.95
6420,3/1/2021,3/1/2021,Recurring rent,Accrual for Walnut St from 6/1/2020-11/30/2022,D107,HJ,2197.65,,25940.6
6420,3/1/2021,3/1/2021,Recurring rent,JE-20-0026 Rev,D107,HJ,,2197.65,23742.95
6420,3/9/2021,3/9/2021,Inspire Business Cen,"Jackson Center March Rent, parking, Inspire Business Center",D107,HJ,975,,24717.95
6420,3/10/2021,3/10/2021,Eversource,March Eversource Payment,D107,HJ,116.49,,24834.44
6420,3/24/2021,3/24/2021,Walnut Street Realty,Bill.Com Import,D107,HJ,2192.58,,27027.02
6420,4/1/2021,4/1/2021,2VTTZG-D3-6,Accrual for Walnut St from 6/1/2020-11/30/2022,D107,HJ,2197.65,,29224.67
6420,4/1/2021,4/1/2021,2VTTZG-D3-6,JE-20-0026 Rev,D107,HJ,18.78,,29243.45
6420,4/1/2021,4/1/2021,2VTTZG-D3-6,JE-20-0026 Rev,D107,HJ,,2197.65,27045.8
6420,4/1/2021,4/1/2021,2VTTZG-D3-6,To reduce the monthly rent amount to tie with agreement,D107,HJ,,18.78,27027.02
6420,4/7/2021,4/7/2021,Eversource,March Eversource Bill,D107,HJ,38.33,,27065.35
6420,4/9/2021,4/9/2021,Inspire Business Cen,"Jackson Center April Rent, Parking, Inspire Business Center",D107,HJ,975.2,,28040.55
6420,4/21/2021,4/21/2021,Walnut Street Realty,Bill.Com Import,D107,HJ,2192.58,,30233.13
6420,5/1/2021,5/1/2021,202007-202104,Accrual for Walnut St from 6/1/2020-11/30/2022,D107,HJ,2197.65,,32430.78
6420,5/1/2021,5/1/2021,202007-202104,JE-20-0026 Rev,D107,HJ,18.78,,32449.56
6420,5/1/2021,5/1/2021,202007-202104,JE-20-0026 Rev,D107,HJ,,2197.65,30251.91
6420,5/1/2021,5/1/2021,202007-202104,To reduce the monthly rent amount to tie with agreement,D107,HJ,,18.78,30233.13
6420,5/10/2021,5/10/2021,Inspire Business Cen,Jackson Center Payment,D107,HJ,984.8,,31217.93
6420,5/11/2021,5/11/2021,Eversource,Eversource May 2021,D107,HJ,32.98,,31250.91
6420,5/26/2021,5/26/2021,Walnut Street Realty,Bill.Com Import,D107,HJ,2192.58,,33443.49
6420,6/1/2021,6/1/2021,CD-21-0323,Accrual for Walnut St from 6/1/2020-11/30/2022,D107,HJ,2197.65,,35641.14
6420,6/1/2021,6/1/2021,CD-21-0323,JE-20-0026 Rev,D107,HJ,18.78,,35659.92
6420,6/1/2021,6/1/2021,CD-21-0323,JE-20-0026 Rev,D107,HJ,,2197.65,33462.27
6420,6/1/2021,6/1/2021,CD-21-0323,To reduce the monthly rent amount to tie with agreement,D107,HJ,,18.78,33443.49
6420,6/8/2021,6/8/2021,Eversource,Eversource Payment June 2021,D107,HJ,31.18,,33474.67
6420,6/8/2021,6/8/2021,West End Investments,Bill.Com Import,D109,HJ,1250,,34724.67
6420,6/9/2021,6/9/2021,Inspire Business Cen,Jackson,D107,HJ,985.8,,35710.47
6420,6/28/2021,6/28/2021,Walnut Street Realty,Bill.Com Import,D107,HJ,2192.58,,37903.05
6420,6/28/2021,6/28/2021,West End Investments,Bill.Com Import,D109,HJ,1250,,39153.05
6420, Totals for 6420 - Rent and Utilities,,,,,,68320.15,29167.1,39153.05
6430,6430 - Postage and Mailing Services (Balance forward As of 07/01/2020) ,,,,,,,,0
6430,7/1/2020,7/1/2020,Joseph Zarate,Imported from Bank of America Visa-For laptop returns,D105,HJ,22.8,,22.8
6430,7/1/2020,7/1/2020,Joseph Zarate,Imported from Bank of America Visa-Return Equipment,D105,HJ,49.95,,72.75
6430,7/1/2020,7/1/2020,Stephen O'Donnell,Imported from reimbursements-Shipping laptops from NYC to Chi,D102,HJ,573.48,,646.23
6430,7/2/2020,7/2/2020,Elizabeth Peinado,Imported from Bank of America Visa-New hire packages,D111,HJ,4.76,,650.99
6430,7/2/2020,7/2/2020,Elizabeth Peinado,Imported from Bank of America Visa-New hire packages,D111,HJ,7.36,,658.35
6430,7/2/2020,7/2/2020,Elizabeth Peinado,Imported from Bank of America Visa-New hire packages,D111,HJ,7.36,,665.71
6430,7/2/2020,7/2/2020,Elizabeth Peinado,Imported from Bank of America Visa-New hire packages,D111,HJ,23.82,,689.53
6430,7/2/2020,7/2/2020,Joseph Zarate,Imported from Bank of America Visa-Return Equipment,D105,HJ,22.8,,712.33
6430,7/3/2020,7/3/2020,Joseph Zarate,Imported from Bank of America Visa-Overnight equipment,D105,HJ,158.48,,870.81
6430,7/3/2020,7/3/2020,Joseph Zarate,Imported from Bank of America Visa-Shipping work item,D105,HJ,10.46,,881.27
6430,7/3/2020,7/3/2020,Joseph Zarate,Imported from Bank of America Visa-Shipping work item,D105,HJ,17.57,,898.84
6430,7/3/2020,7/3/2020,Joseph Zarate,Imported from Bank of America Visa-shipping,D105,HJ,21.1,,919.94
6430,7/5/2020,7/5/2020,Alan Safran,Imported from Bank of America Visa-FL business expenses,D102,HJ,47.04,,966.98
6430,7/6/2020,7/6/2020,Joseph Zarate,Imported from Bank of America Visa-shipping,D105,HJ,21.1,,988.08
6430,7/7/2020,7/7/2020,Joseph Zarate,Imported from Bank of America Visa-shipping,D105,HJ,8.4,,996.48
6430,7/7/2020,7/7/2020,Joseph Zarate,Imported from Bank of America Visa-shipping,D105,HJ,15.05,,1011.53
6430,7/7/2020,7/7/2020,Joseph Zarate,Imported from Bank of America Visa-shipping,D105,HJ,22.8,,1034.33
6430,7/7/2020,7/7/2020,Myesha Hossain,Imported from Bank of America Visa-Packaging supplies,D108,HJ,15.26,,1049.59
6430,7/7/2020,7/7/2020,Myesha Hossain,Imported from Bank of America Visa-Return equipment to Zarate,D108,HJ,67.2,,1116.79
6430,7/8/2020,7/8/2020,Joseph Zarate,Imported from Bank of America Visa-shipping,D105,HJ,22.8,,1139.59
6430,7/9/2020,7/9/2020,Joseph Zarate,Imported from Bank of America Visa-Partial refund,D105,HJ,,6.05,1133.54
6430,7/9/2020,7/9/2020,Joseph Zarate,Imported from Bank of America Visa-shipping,D105,HJ,21.1,,1154.64
6430,7/10/2020,7/10/2020,Joseph Zarate,Imported from Bank of America Visa-Partial refund,D105,HJ,,6.05,1148.59
6430,7/11/2020,7/11/2020,Joseph Zarate,Imported from Bank of America Visa-shipping,D105,HJ,15.05,,1163.64
6430,7/12/2020,7/12/2020,Joseph Zarate,Imported from Bank of America Visa-shipping,D105,HJ,54.02,,1217.66
6430,7/13/2020,7/13/2020,Joseph Zarate,Imported from Bank of America Visa-shipping,D105,HJ,15.05,,1232.71
6430,7/13/2020,7/13/2020,Monivett Acevedo,Imported from Bank of America Visa-book of stamps,D103,HJ,11,,1243.71
6430,7/16/2020,7/16/2020,Joseph Zarate,Imported from Bank of America Visa-shipping,D105,HJ,21.1,,1264.81
6430,7/17/2020,7/17/2020,Joseph Zarate,Imported from Bank of America Visa-shipping,D105,HJ,28.85,,1293.66
6430,7/18/2020,7/18/2020,Elizabeth Peinado,Imported from Bank of America Visa-New hire packages,D111,HJ,7.14,,1300.8
6430,7/18/2020,7/18/2020,Elizabeth Peinado,Imported from Bank of America Visa-New hire packages,D111,HJ,11.04,,1311.84
6430,7/18/2020,7/18/2020,Elizabeth Peinado,Imported from Bank of America Visa-New hire packages,D111,HJ,11.04,,1322.88
6430,7/18/2020,7/18/2020,Elizabeth Peinado,Imported from Bank of America Visa-New hire packages,D111,HJ,35.73,,1358.61
6430,7/18/2020,7/18/2020,Gabriel Hallinan,Imported from reimbursements-Fellow personal item retrieval,D108,HJ,10.72,,1369.33
6430,7/18/2020,7/18/2020,Gabriel Hallinan,Imported from reimbursements-Fellow personal item retrieval,D108,HJ,10.72,,1380.05
6430,7/18/2020,7/18/2020,Gabriel Hallinan,Imported from reimbursements-Fellow personal item retrieval,D108,HJ,10.72,,1390.77
6430,7/18/2020,7/18/2020,Gabriel Hallinan,Imported from reimbursements-Fellow personal item retrieval,D108,HJ,21.65,,1412.42
6430,7/18/2020,7/18/2020,Gabriel Hallinan,Imported from reimbursements-Fellow personal item retrieval,D108,HJ,32.82,,1445.24
6430,7/30/2020,7/30/2020,Joseph Zarate,Imported from Bank of America Visa-shipping,D105,HJ,15.05,,1460.29
6430,8/3/2020,8/3/2020,Joseph Zarate,Imported from Bank of America Visa-Returns,D105,HJ,15.05,,1475.34
6430,8/4/2020,8/4/2020,Joseph Zarate,Imported from Bank of America Visa-shipping,D105,HJ,77.9,,1553.24
6430,8/5/2020,8/5/2020,Nicole Prahin,Imported from Bank of America Visa-Mailed Melissa & Claice X Co.  swag,D108,HJ,32.08,,1585.32
6430,8/6/2020,8/6/2020,Joseph Zarate,Imported from Bank of America Visa-New hire equipment,D105,HJ,75.25,,1660.57
6430,8/7/2020,8/7/2020,Joseph Zarate,Imported from Bank of America Visa-New hire equipment,D105,HJ,44.08,,1704.65
6430,8/7/2020,8/7/2020,Myesha Hossain,Imported from Bank of America Visa-Fellow Belongings,D108,HJ,42.29,,1746.94
6430,8/7/2020,8/7/2020,Myesha Hossain,Imported from Bank of America Visa-Mail out Fellow belongings,D108,HJ,45.89,,1792.83
6430,8/8/2020,8/8/2020,Elizabeth Peinado,Imported from Bank of America Visa-New hire packages,D111,HJ,6.52,,1799.35
6430,8/8/2020,8/8/2020,Elizabeth Peinado,Imported from Bank of America Visa-New hire packages,D111,HJ,10.07,,1809.42
6430,8/8/2020,8/8/2020,Elizabeth Peinado,Imported from Bank of America Visa-New hire packages,D111,HJ,10.07,,1819.49
6430,8/8/2020,8/8/2020,Elizabeth Peinado,Imported from Bank of America Visa-New hire packages,D111,HJ,32.59,,1852.08
6430,8/8/2020,8/8/2020,Joseph Zarate,Imported from Bank of America Visa-returns,D105,HJ,22.8,,1874.88
6430,8/10/2020,8/10/2020,Elizabeth Peinado,Imported from Bank of America Visa-New hire packages,D111,HJ,7.11,,1881.99
6430,8/10/2020,8/10/2020,Elizabeth Peinado,Imported from Bank of America Visa-New hire packages,D111,HJ,10.98,,1892.97
6430,8/10/2020,8/10/2020,Elizabeth Peinado,Imported from Bank of America Visa-New hire packages,D111,HJ,10.98,,1903.95
6430,8/10/2020,8/10/2020,Elizabeth Peinado,Imported from Bank of America Visa-New hire packages,D111,HJ,35.53,,1939.48
6430,8/10/2020,8/10/2020,Joseph Zarate,Imported from Bank of America Visa-New hire equipment,D105,HJ,15.05,,1954.53
6430,8/10/2020,8/10/2020,Joseph Zarate,Imported from Bank of America Visa-Returns,D105,HJ,15.05,,1969.58
6430,8/11/2020,8/11/2020,Elizabeth Peinado,Imported from Bank of America Visa-New hire packages,D111,HJ,11.71,,1981.29
6430,8/11/2020,8/11/2020,Elizabeth Peinado,Imported from Bank of America Visa-New hire packages,D111,HJ,18.1,,1999.39
6430,8/11/2020,8/11/2020,Elizabeth Peinado,Imported from Bank of America Visa-New hire packages,D111,HJ,18.1,,2017.49
6430,8/11/2020,8/11/2020,Elizabeth Peinado,Imported from Bank of America Visa-New hire packages,D111,HJ,21.62,,2039.11
6430,8/11/2020,8/11/2020,Elizabeth Peinado,Imported from Bank of America Visa-New hire packages,D111,HJ,33.4,,2072.51
6430,8/11/2020,8/11/2020,Elizabeth Peinado,Imported from Bank of America Visa-New hire packages,D111,HJ,33.41,,2105.92
6430,8/11/2020,8/11/2020,Elizabeth Peinado,Imported from Bank of America Visa-New hire packages,D111,HJ,58.54,,2164.46
6430,8/11/2020,8/11/2020,Elizabeth Peinado,Imported from Bank of America Visa-New hire packages,D111,HJ,108.07,,2272.53
6430,8/12/2020,8/12/2020,Joseph Zarate,Imported from Bank of America Visa-New hire equipment,D105,HJ,1.44,,2273.97
6430,8/12/2020,8/12/2020,Joseph Zarate,Imported from Bank of America Visa-New hire equipment,D105,HJ,,4.15,2269.82
6430,8/12/2020,8/12/2020,Joseph Zarate,Imported from Bank of America Visa-New hire equipment,D105,HJ,15.05,,2284.87
6430,8/12/2020,8/12/2020,Joseph Zarate,Imported from Bank of America Visa-New hire equipment,D105,HJ,30.1,,2314.97
6430,8/12/2020,8/12/2020,Joseph Zarate,Imported from Bank of America Visa-New hire equipment,D105,HJ,41.69,,2356.66
6430,8/12/2020,8/12/2020,Joseph Zarate,Imported from Bank of America Visa-New hire equipment,D105,HJ,45.15,,2401.81
6430,8/12/2020,8/12/2020,Joseph Zarate,Imported from Bank of America Visa-New hire equipment.returns,D105,HJ,22.8,,2424.61
6430,8/12/2020,8/12/2020,Joseph Zarate,Imported from Bank of America Visa-New hire equipment.returns,D105,HJ,45.15,,2469.76
6430,8/12/2020,8/12/2020,Joseph Zarate,Imported from Bank of America Visa-Return Equipment,D105,HJ,21.1,,2490.86
6430,8/13/2020,8/13/2020,Joseph Zarate,Imported from Bank of America Visa-New hire equipment,D105,HJ,21.1,,2511.96
6430,8/13/2020,8/13/2020,Joseph Zarate,Imported from Bank of America Visa-returns,D105,HJ,15.05,,2527.01
6430,8/14/2020,8/14/2020,Joseph Zarate,Imported from Bank of America Visa-New hire equipment,D105,HJ,0.99,,2528
6430,8/14/2020,8/14/2020,Joseph Zarate,Imported from Bank of America Visa-New hire equipment,D105,HJ,1,,2529
6430,8/14/2020,8/14/2020,Joseph Zarate,Imported from Bank of America Visa-New hire equipment,D105,HJ,10.18,,2539.18
6430,8/14/2020,8/14/2020,Joseph Zarate,Imported from Bank of America Visa-New hire equipment,D105,HJ,10.18,,2549.36
6430,8/14/2020,8/14/2020,Joseph Zarate,Imported from Bank of America Visa-New hire equipment,D105,HJ,10.2,,2559.56
6430,8/14/2020,8/14/2020,Joseph Zarate,Imported from Bank of America Visa-New hire equipment,D105,HJ,10.2,,2569.76
6430,8/14/2020,8/14/2020,Joseph Zarate,Imported from Bank of America Visa-New hire equipment,D105,HJ,10.2,,2579.96
6430,8/14/2020,8/14/2020,Joseph Zarate,Imported from Bank of America Visa-New hire equipment,D105,HJ,10.9,,2590.86
6430,8/14/2020,8/14/2020,Joseph Zarate,Imported from Bank of America Visa-New hire equipment,D105,HJ,11.65,,2602.51
6430,8/14/2020,8/14/2020,Joseph Zarate,Imported from Bank of America Visa-New hire equipment,D105,HJ,11.65,,2614.16
6430,8/14/2020,8/14/2020,Joseph Zarate,Imported from Bank of America Visa-New hire equipment,D105,HJ,11.65,,2625.81
6430,8/14/2020,8/14/2020,Joseph Zarate,Imported from Bank of America Visa-New hire equipment,D105,HJ,11.65,,2637.46
6430,8/14/2020,8/14/2020,Joseph Zarate,Imported from Bank of America Visa-New hire equipment,D105,HJ,11.65,,2649.11
6430,8/14/2020,8/14/2020,Joseph Zarate,Imported from Bank of America Visa-New hire equipment,D105,HJ,11.65,,2660.76
6430,8/14/2020,8/14/2020,Joseph Zarate,Imported from Bank of America Visa-New hire equipment,D105,HJ,11.65,,2672.41
6430,8/14/2020,8/14/2020,Joseph Zarate,Imported from Bank of America Visa-New hire equipment,D105,HJ,12.35,,2684.76
6430,8/14/2020,8/14/2020,Joseph Zarate,Imported from Bank of America Visa-New hire equipment,D105,HJ,13.1,,2697.86
6430,8/14/2020,8/14/2020,Joseph Zarate,Imported from Bank of America Visa-New hire equipment,D105,HJ,15.05,,2712.91
6430,8/14/2020,8/14/2020,Joseph Zarate,Imported from Bank of America Visa-New hire equipment,D105,HJ,25.35,,2738.26
6430,8/14/2020,8/14/2020,Joseph Zarate,Imported from Bank of America Visa-New hire equipment,D105,HJ,26.82,,2765.08
6430,8/14/2020,8/14/2020,Joseph Zarate,Imported from Bank of America Visa-New hire equipment,D105,HJ,26.82,,2791.9
6430,8/14/2020,8/14/2020,Joseph Zarate,Imported from Bank of America Visa-New hire equipment,D105,HJ,26.82,,2818.72
6430,8/14/2020,8/14/2020,Joseph Zarate,Imported from Bank of America Visa-New hire equipment,D105,HJ,26.82,,2845.54
6430,8/14/2020,8/14/2020,Joseph Zarate,Imported from Bank of America Visa-New hire equipment,D105,HJ,26.82,,2872.36
6430,8/14/2020,8/14/2020,Joseph Zarate,Imported from Bank of America Visa-New hire equipment,D105,HJ,26.82,,2899.18
6430,8/14/2020,8/14/2020,Joseph Zarate,Imported from Bank of America Visa-New hire equipment,D105,HJ,26.82,,2926
6430,8/14/2020,8/14/2020,Joseph Zarate,Imported from Bank of America Visa-New hire equipment,D105,HJ,37.61,,2963.61
6430,8/14/2020,8/14/2020,Joseph Zarate,Imported from Bank of America Visa-New hire equipment,D105,HJ,39.77,,3003.38
6430,8/14/2020,8/14/2020,Joseph Zarate,Imported from Bank of America Visa-New hire equipment,D105,HJ,110.96,,3114.34
6430,8/14/2020,8/14/2020,Joseph Zarate,Imported from Bank of America Visa-New hire equipment,D105,HJ,148.33,,3262.67
6430,8/14/2020,8/14/2020,Joseph Zarate,Imported from Bank of America Visa-New hire equipment,D105,HJ,202.58,,3465.25
6430,8/14/2020,8/14/2020,Joseph Zarate,Imported from Bank of America Visa-Return Equipment,D105,HJ,21.1,,3486.35
6430,8/14/2020,8/14/2020,Joseph Zarate,Imported from Bank of America Visa-returns,D105,HJ,21.1,,3507.45
6430,8/14/2020,8/14/2020,Myesha Hossain,Imported from Bank of America Visa-Packaging supplies,D108,HJ,8.7,,3516.15
6430,8/15/2020,8/15/2020,Joseph Zarate,Imported from Bank of America Visa-New hire equipment,D105,HJ,10.18,,3526.33
6430,8/15/2020,8/15/2020,Joseph Zarate,Imported from Bank of America Visa-New hire equipment,D105,HJ,10.18,,3536.51
6430,8/15/2020,8/15/2020,Joseph Zarate,Imported from Bank of America Visa-New hire equipment,D105,HJ,10.18,,3546.69
6430,8/15/2020,8/15/2020,Joseph Zarate,Imported from Bank of America Visa-New hire equipment,D105,HJ,10.18,,3556.87
6430,8/15/2020,8/15/2020,Joseph Zarate,Imported from Bank of America Visa-New hire equipment,D105,HJ,10.18,,3567.05
6430,8/15/2020,8/15/2020,Joseph Zarate,Imported from Bank of America Visa-New hire equipment,D105,HJ,10.18,,3577.23
6430,8/15/2020,8/15/2020,Joseph Zarate,Imported from Bank of America Visa-New hire equipment,D105,HJ,10.88,,3588.11
6430,8/15/2020,8/15/2020,Joseph Zarate,Imported from Bank of America Visa-New hire equipment,D105,HJ,11.46,,3599.57
6430,8/15/2020,8/15/2020,Joseph Zarate,Imported from Bank of America Visa-New hire equipment,D105,HJ,11.46,,3611.03
6430,8/15/2020,8/15/2020,Joseph Zarate,Imported from Bank of America Visa-New hire equipment,D105,HJ,11.65,,3622.68
6430,8/15/2020,8/15/2020,Joseph Zarate,Imported from Bank of America Visa-New hire equipment,D105,HJ,11.65,,3634.33
6430,8/15/2020,8/15/2020,Joseph Zarate,Imported from Bank of America Visa-New hire equipment,D105,HJ,11.65,,3645.98
6430,8/15/2020,8/15/2020,Joseph Zarate,Imported from Bank of America Visa-New hire equipment,D105,HJ,11.65,,3657.63
6430,8/15/2020,8/15/2020,Joseph Zarate,Imported from Bank of America Visa-New hire equipment,D105,HJ,11.65,,3669.28
6430,8/15/2020,8/15/2020,Joseph Zarate,Imported from Bank of America Visa-New hire equipment,D105,HJ,11.65,,3680.93
6430,8/15/2020,8/15/2020,Joseph Zarate,Imported from Bank of America Visa-New hire equipment,D105,HJ,11.65,,3692.58
6430,8/15/2020,8/15/2020,Joseph Zarate,Imported from Bank of America Visa-New hire equipment,D105,HJ,11.65,,3704.23
6430,8/15/2020,8/15/2020,Joseph Zarate,Imported from Bank of America Visa-New hire equipment,D105,HJ,11.65,,3715.88
6430,8/15/2020,8/15/2020,Joseph Zarate,Imported from Bank of America Visa-New hire equipment,D105,HJ,11.65,,3727.53
6430,8/15/2020,8/15/2020,Joseph Zarate,Imported from Bank of America Visa-New hire equipment,D105,HJ,24.83,,3752.36
6430,8/15/2020,8/15/2020,Joseph Zarate,Imported from Bank of America Visa-New hire equipment,D105,HJ,145.56,,3897.92
6430,8/17/2020,8/17/2020,Joseph Zarate,Imported from Bank of America Visa-New hire equipment,D105,HJ,1,,3898.92
6430,8/17/2020,8/17/2020,Joseph Zarate,Imported from Bank of America Visa-New hire equipment,D105,HJ,1,,3899.92
6430,8/17/2020,8/17/2020,Joseph Zarate,Imported from Bank of America Visa-New hire equipment,D105,HJ,1,,3900.92
6430,8/17/2020,8/17/2020,Joseph Zarate,Imported from Bank of America Visa-New hire equipment,D105,HJ,1,,3901.92
6430,8/17/2020,8/17/2020,Joseph Zarate,Imported from Bank of America Visa-New hire equipment,D105,HJ,4.15,,3906.07
6430,8/17/2020,8/17/2020,Joseph Zarate,Imported from Bank of America Visa-New hire equipment,D105,HJ,4.15,,3910.22
6430,8/17/2020,8/17/2020,Joseph Zarate,Imported from Bank of America Visa-New hire equipment,D105,HJ,8.3,,3918.52
6430,8/17/2020,8/17/2020,Joseph Zarate,Imported from Bank of America Visa-New hire equipment,D105,HJ,50.2,,3968.72
6430,8/17/2020,8/17/2020,Joseph Zarate,Imported from Bank of America Visa-New hire equipment,D105,HJ,58.1,,4026.82
6430,8/17/2020,8/17/2020,Joseph Zarate,Imported from Bank of America Visa-Return Equipment,D105,HJ,15.05,,4041.87
6430,8/18/2020,8/18/2020,Joseph Zarate,Imported from Bank of America Visa-New hire equipment,D105,HJ,7.75,,4049.62
6430,8/18/2020,8/18/2020,Joseph Zarate,Imported from Bank of America Visa-New hire equipment,D105,HJ,15.05,,4064.67
6430,8/18/2020,8/18/2020,Joseph Zarate,Imported from Bank of America Visa-New hire equipment,D105,HJ,20.1,,4084.77
6430,8/18/2020,8/18/2020,Joseph Zarate,Imported from Bank of America Visa-New hire equipment,D105,HJ,66,,4150.77
6430,8/18/2020,8/18/2020,Joseph Zarate,Imported from Bank of America Visa-New hire equipment.returns,D105,HJ,45.15,,4195.92
6430,8/19/2020,8/19/2020,Joseph Zarate,Imported from Bank of America Visa-New hire equipment,D105,HJ,13.38,,4209.3
6430,8/19/2020,8/19/2020,Joseph Zarate,Imported from Bank of America Visa-New hire equipment,D105,HJ,13.39,,4222.69
6430,8/19/2020,8/19/2020,Joseph Zarate,Imported from Bank of America Visa-New hire equipment,D105,HJ,13.39,,4236.08
6430,8/19/2020,8/19/2020,Joseph Zarate,Imported from Bank of America Visa-New hire equipment,D105,HJ,13.39,,4249.47
6430,8/19/2020,8/19/2020,Joseph Zarate,Imported from Bank of America Visa-New hire equipment.returns,D105,HJ,31.1,,4280.57
6430,8/20/2020,8/20/2020,Joseph Zarate,Imported from Bank of America Visa-New hire equipment,D105,HJ,15.05,,4295.62
6430,8/20/2020,8/20/2020,Joseph Zarate,Imported from Bank of America Visa-New hire equipment,D105,HJ,15.05,,4310.67
6430,8/20/2020,8/20/2020,Joseph Zarate,Imported from Bank of America Visa-New hire equipment,D105,HJ,29.04,,4339.71
6430,8/21/2020,8/21/2020,Joseph Zarate,Imported from Bank of America Visa-New hire equipment,D105,HJ,38.5,,4378.21
6430,8/21/2020,8/21/2020,Joseph Zarate,Imported from Bank of America Visa-New hire equipment,D105,HJ,68.4,,4446.61
6430,8/21/2020,8/21/2020,Joseph Zarate,Imported from Bank of America Visa-New hire equipment.returns,D105,HJ,15.05,,4461.66
6430,8/21/2020,8/21/2020,Joseph Zarate,Imported from Bank of America Visa-refund,D105,HJ,,6.8,4454.86
6430,8/21/2020,8/21/2020,Joseph Zarate,Imported from Bank of America Visa-returns,D105,HJ,7.75,,4462.61
6430,8/22/2020,8/22/2020,Joseph Zarate,Imported from Bank of America Visa-New hire equipment,D105,HJ,21.1,,4483.71
6430,8/24/2020,8/24/2020,Joseph Zarate,Imported from Bank of America Visa-New hire equipment,D105,HJ,7.52,,4491.23
6430,8/24/2020,8/24/2020,Joseph Zarate,Imported from Bank of America Visa-New hire equipment,D105,HJ,7.53,,4498.76
6430,8/24/2020,8/24/2020,Joseph Zarate,Imported from Bank of America Visa-New hire equipment,D105,HJ,15.05,,4513.81
6430,8/24/2020,8/24/2020,Joseph Zarate,Imported from Bank of America Visa-New hire equipment,D105,HJ,15.05,,4528.86
6430,8/24/2020,8/24/2020,Joseph Zarate,Imported from Bank of America Visa-New hire equipment,D105,HJ,579.97,,5108.83
6430,8/24/2020,8/24/2020,Joseph Zarate,Imported from Bank of America Visa-New hire equipment.returns,D105,HJ,28.85,,5137.68
6430,8/24/2020,8/24/2020,Joseph Zarate,Imported from Bank of America Visa-return,D105,HJ,15.05,,5152.73
6430,8/25/2020,8/25/2020,Joseph Zarate,Imported from Bank of America Visa-New hire equipment,D105,HJ,33.2,,5185.93
6430,8/25/2020,8/25/2020,Joseph Zarate,Imported from Bank of America Visa-New hire equipment.returns,D105,HJ,61.65,,5247.58
6430,8/25/2020,8/25/2020,Nicole Prahin,Imported from Bank of America Visa-X Co.  swag sent to CSSI Director,D108,HJ,9.2,,5256.78
6430,8/26/2020,8/26/2020,Joseph Zarate,Imported from Bank of America Visa-New hire equipment,D105,HJ,15.05,,5271.83
6430,8/26/2020,8/26/2020,Joseph Zarate,Imported from Bank of America Visa-New hire equipment,D105,HJ,60.2,,5332.03
6430,8/27/2020,8/27/2020,Joseph Zarate,Imported from Bank of America Visa-New hire equipment,D105,HJ,15.05,,5347.08
6430,8/27/2020,8/27/2020,Joseph Zarate,Imported from Bank of America Visa-equipment,D105,HJ,8.3,,5355.38
6430,8/28/2020,8/28/2020,Joseph Zarate,Imported from Bank of America Visa-New hire equipment.returns,D105,HJ,29.4,,5384.78
6430,8/28/2020,8/28/2020,Myesha Hossain,Imported from Bank of America Visa-Packaging supplies,D108,HJ,41.89,,5426.67
6430,8/29/2020,8/29/2020,Myesha Hossain,Imported from Bank of America Visa-Staff Appreciation,D108,HJ,180.7,,5607.37
6430,9/1/2020,9/1/2020,Joseph Zarate,Imported from Bank of America Visa-New hire equipment,D105,HJ,,6.75,5600.62
6430,9/1/2020,9/1/2020,Joseph Zarate,Imported from Bank of America Visa-New hire equipment,D105,HJ,11.67,,5612.29
6430,9/1/2020,9/1/2020,Joseph Zarate,Imported from Bank of America Visa-New hire equipment,D105,HJ,11.68,,5623.97
6430,9/1/2020,9/1/2020,Joseph Zarate,Imported from Bank of America Visa-shipping,D105,HJ,8.3,,5632.27
6430,9/2/2020,9/2/2020,Joseph Zarate,Imported from Bank of America Visa-New hire equipment returns,D105,HJ,21.1,,5653.37
6430,9/5/2020,9/5/2020,Joseph Zarate,Imported from Bank of America Visa-New hire equipment,D105,HJ,139.88,,5793.25
6430,9/11/2020,9/11/2020,Antonio Gutierrez,Imported from Bank of America Visa-stamps for face mask mailing,D107,HJ,60,,5853.25
6430,9/11/2020,9/11/2020,Joseph Zarate,Imported from Bank of America Visa-New hire equipment,D105,HJ,25,,5878.25
6430,9/12/2020,9/12/2020,Antonio Gutierrez,Imported from Bank of America Visa-Supplies. face mask postage,D107,HJ,10,,5888.25
6430,9/14/2020,9/14/2020,Joseph Zarate,Imported from Bank of America Visa-equipment,D105,HJ,30.1,,5918.35
6430,9/17/2020,9/17/2020,Joseph Zarate,Imported from Bank of America Visa-equipment,D105,HJ,8.3,,5926.65
6430,9/18/2020,9/18/2020,Joseph Zarate,Imported from Bank of America Visa-New hire equipment,D105,HJ,8.3,,5934.95
6430,9/21/2020,9/21/2020,Antonio Gutierrez,Imported from Bank of America Visa-PPE masks,D102,HJ,13.41,,5948.36
6430,9/21/2020,9/21/2020,Joseph Zarate,Imported from Bank of America Visa-New hire equipment,D105,HJ,15.05,,5963.41
6430,9/21/2020,9/21/2020,Joseph Zarate,Imported from Bank of America Visa-New hire equipment,D105,HJ,16.8,,5980.21
6430,9/21/2020,9/21/2020,Joseph Zarate,Imported from Bank of America Visa-New hire equipment,D105,HJ,16.8,,5997.01
6430,9/25/2020,9/25/2020,Myesha Hossain,Imported from Bank of America Visa-Packaging supplies,D108,HJ,4.99,,6002
6430,9/25/2020,9/25/2020,Myesha Hossain,Imported from Bank of America Visa-Packaging supplies,D108,HJ,9.48,,6011.48
6430,9/26/2020,9/26/2020,Joseph Zarate,Imported from Bank of America Visa-equipment,D105,HJ,7.75,,6019.23
6430,9/26/2020,9/26/2020,Mahaliah Sejour,Imported from Bank of America Visa-USPS shipping labels,D108,HJ,60.2,,6079.43
6430,9/26/2020,9/26/2020,Mahaliah Sejour,Imported from Bank of America Visa-USPS shipping labels,D108,HJ,60.2,,6139.63
6430,9/28/2020,9/28/2020,Joseph Zarate,Imported from Bank of America Visa-Returns,D105,HJ,78.8,,6218.43
6430,9/28/2020,9/28/2020,Myesha Hossain,Imported from Bank of America Visa-IT Return laptops,D108,HJ,92.7,,6311.13
6430,9/29/2020,9/29/2020,Myesha Hossain,Imported from Bank of America Visa-Classroom posters,D108,HJ,108.6,,6419.73
6430,10/1/2020,10/1/2020,Joseph Zarate,Imported from reimbursements-Replacement/return,D105,HJ,16.15,,6435.88
6430,10/1/2020,10/1/2020,Joseph Zarate,Imported from reimbursements-equipment,D105,HJ,16.15,,6452.03
6430,10/2/2020,10/2/2020,Joseph Zarate,Imported from reimbursements-equipment,D105,HJ,60.2,,6512.23
6430,10/2/2020,10/2/2020,Joseph Zarate,Imported from reimbursements-equipment,D105,HJ,75.25,,6587.48
6430,10/2/2020,10/2/2020,Joseph Zarate,Imported from reimbursements-new hire equipment,D105,HJ,30.1,,6617.58
6430,10/2/2020,10/2/2020,Joseph Zarate,Imported from reimbursements-new hire equipment shipments,D105,HJ,75.25,,6692.83
6430,10/2/2020,10/2/2020,Myesha Hossain,Imported from reimbursements-Headphones for HPHS,D108,HJ,5.9,,6698.73
6430,10/7/2020,10/7/2020,Mahaliah Sejour,Imported from reimbursements-usps shipping labels,D108,HJ,71.96,,6770.69
6430,10/9/2020,10/9/2020,Joseph Zarate,Imported from reimbursements-shipments,D105,HJ,15.05,,6785.74
6430,10/9/2020,10/9/2020,Joseph Zarate,Imported from reimbursements-shipments,D105,HJ,15.05,,6800.79
6430,10/11/2020,10/11/2020,Antonio Gutierrez,Imported from reimbursements-Shipping postage for swag,D107,HJ,19.11,,6819.9
6430,10/13/2020,10/13/2020,Joseph Zarate,Imported from reimbursements-equipment returns,D105,HJ,21.1,,6841
6430,10/13/2020,10/13/2020,Joseph Zarate,Imported from reimbursements-returns,D105,HJ,42.2,,6883.2
6430,10/13/2020,10/13/2020,Joseph Zarate,Imported from reimbursements-shipments,D105,HJ,60.2,,6943.4
6430,10/13/2020,10/13/2020,Joseph Zarate,Imported from reimbursements-shipments,D105,HJ,60.2,,7003.6
6430,10/13/2020,10/13/2020,Myesha Hossain,Imported from reimbursements-PPE posters,D108,HJ,16.2,,7019.8
6430,10/14/2020,10/14/2020,Joseph Zarate,Imported from reimbursements-equipment,D105,HJ,8.4,,7028.2
6430,10/15/2020,10/15/2020,Antonio Gutierrez,Imported from reimbursements-shipping fee for swag,D107,HJ,34.12,,7062.32
6430,10/15/2020,10/15/2020,Joseph Zarate,Imported from reimbursements-equipment shipment,D105,HJ,33.6,,7095.92
6430,10/19/2020,10/19/2020,Joseph Zarate,Imported from reimbursements-equipment shipment,D105,HJ,15.05,,7110.97
6430,10/19/2020,10/19/2020,Joseph Zarate,Imported from reimbursements-equipment shipment,D105,HJ,21.1,,7132.07
6430,10/20/2020,10/20/2020,Myesha Hossain,Imported from reimbursements-PPE,D108,HJ,123.3,,7255.37
6430,10/21/2020,10/21/2020,Elizabeth Peinado,Imported from reimbursements-Woot Welcome packages,D111,HJ,3.33,,7258.7
6430,10/21/2020,10/21/2020,Elizabeth Peinado,Imported from reimbursements-Woot Welcome packages,D111,HJ,4,,7262.7
6430,10/21/2020,10/21/2020,Elizabeth Peinado,Imported from reimbursements-Woot Welcome packages,D111,HJ,4.26,,7266.96
6430,10/21/2020,10/21/2020,Elizabeth Peinado,Imported from reimbursements-Woot Welcome packages,D111,HJ,4.7,,7271.66
6430,10/21/2020,10/21/2020,Elizabeth Peinado,Imported from reimbursements-Woot Welcome packages,D111,HJ,5.15,,7276.81
6430,10/21/2020,10/21/2020,Elizabeth Peinado,Imported from reimbursements-Woot Welcome packages,D111,HJ,5.15,,7281.96
6430,10/21/2020,10/21/2020,Elizabeth Peinado,Imported from reimbursements-Woot Welcome packages,D111,HJ,6.18,,7288.14
6430,10/21/2020,10/21/2020,Elizabeth Peinado,Imported from reimbursements-Woot Welcome packages,D111,HJ,6.18,,7294.32
6430,10/21/2020,10/21/2020,Elizabeth Peinado,Imported from reimbursements-Woot Welcome packages,D111,HJ,6.58,,7300.9
6430,10/21/2020,10/21/2020,Elizabeth Peinado,Imported from reimbursements-Woot Welcome packages,D111,HJ,6.58,,7307.48
6430,10/21/2020,10/21/2020,Elizabeth Peinado,Imported from reimbursements-Woot Welcome packages,D111,HJ,7.26,,7314.74
6430,10/21/2020,10/21/2020,Elizabeth Peinado,Imported from reimbursements-Woot Welcome packages,D111,HJ,7.26,,7322
6430,10/21/2020,10/21/2020,Elizabeth Peinado,Imported from reimbursements-Woot Welcome packages,D111,HJ,16.67,,7338.67
6430,10/21/2020,10/21/2020,Elizabeth Peinado,Imported from reimbursements-Woot Welcome packages,D111,HJ,19.99,,7358.66
6430,10/21/2020,10/21/2020,Elizabeth Peinado,Imported from reimbursements-Woot Welcome packages,D111,HJ,21.28,,7379.94
6430,10/21/2020,10/21/2020,Elizabeth Peinado,Imported from reimbursements-Woot Welcome packages,D111,HJ,23.47,,7403.41
6430,10/21/2020,10/21/2020,iaklestad,Imported from reimbursements-Welcome Packages,D111,HJ,65.85,,7469.26
6430,10/22/2020,10/22/2020,Joseph Zarate,Imported from reimbursements-equipment returns,D105,HJ,22.8,,7492.06
6430,10/23/2020,10/23/2020,Joseph Zarate,Imported from reimbursements-equipment shipments,D105,HJ,10.08,,7502.14
6430,10/23/2020,10/23/2020,Joseph Zarate,Imported from reimbursements-equipment shipments,D105,HJ,10.08,,7512.22
6430,10/23/2020,10/23/2020,Joseph Zarate,Imported from reimbursements-equipment shipments,D105,HJ,10.39,,7522.61
6430,10/26/2020,10/26/2020,Joseph Zarate,Imported from reimbursements-equipment shipment,D105,HJ,15.05,,7537.66
6430,10/26/2020,10/26/2020,Myesha Hossain,Imported from reimbursements-PPE,D108,HJ,,123.3,7414.36
6430,10/29/2020,10/29/2020,Myesha Hossain,Imported from reimbursements-Packaging supplies,D108,HJ,25.28,,7439.64
6430,11/1/2020,11/1/2020,Joseph Zarate,Imported from Bank of America Visa-equipment returns,D105,HJ,22.8,,7462.44
6430,11/1/2020,11/1/2020,Joseph Zarate,Imported from Bank of America Visa-equipment shipment,D105,HJ,7.75,,7470.19
6430,11/1/2020,11/1/2020,Mahaliah Sejour,Imported from Bank of America Visa-shipped X Co.  gift to fellow,D108,HJ,26.35,,7496.54
6430,11/1/2020,11/1/2020,Myesha Hossain,Imported from Bank of America Visa-Key Players Appreciation,D108,HJ,35.75,,7532.29
6430,11/2/2020,11/2/2020,Joseph Zarate,Imported from Bank of America Visa-equipment returns,D105,HJ,36.15,,7568.44
6430,11/2/2020,11/2/2020,Joseph Zarate,Imported from Bank of America Visa-equipment shipment,D105,HJ,15.05,,7583.49
6430,11/2/2020,11/2/2020,Joseph Zarate,Imported from Bank of America Visa-equipment shipment,D105,HJ,26.95,,7610.44
6430,11/4/2020,11/4/2020,iaklestad,Imported from Bank of America Visa-Fellow Welcome Packages,D111,HJ,15.05,,7625.49
6430,11/4/2020,11/4/2020,Joseph Zarate,Imported from Bank of America Visa-equipment returns,D105,HJ,22.8,,7648.29
6430,11/6/2020,11/6/2020,Joseph Zarate,Imported from Bank of America Visa-equipment shipment,D105,HJ,15.05,,7663.34
6430,11/9/2020,11/9/2020,Joseph Zarate,Imported from Bank of America Visa-equipment shipment.returns,D105,HJ,42.2,,7705.54
6430,11/10/2020,11/10/2020,Antonio Gutierrez,Imported from Bank of America Visa-SWAG Shipment to Staff,D107,HJ,11.98,,7717.52
6430,11/10/2020,11/10/2020,hliporace,Imported from reimbursements-Shipping label to send Documents to Colorado Department of Reven,D103,HJ,24.3,,7741.82
6430,11/10/2020,11/10/2020,Joseph Zarate,Imported from Bank of America Visa-equipment returns,D105,HJ,42.2,,7784.02
6430,11/10/2020,11/10/2020,Joseph Zarate,Imported from Bank of America Visa-equipment shipment,D105,HJ,15.05,,7799.07
6430,11/10/2020,11/10/2020,Myesha Hossain,Imported from Bank of America Visa-Staff Appreciation,D108,HJ,40.67,,7839.74
6430,11/11/2020,11/11/2020,Antonio Gutierrez,Imported from Bank of America Visa-Shipment of Swag to staff,D107,HJ,19.11,,7858.85
6430,11/11/2020,11/11/2020,Thomas Fischaber,Imported from Bank of America Visa-Mailing laptop to Chicago office,D109,HJ,26.1,,7884.95
6430,11/12/2020,11/12/2020,Joseph Zarate,Imported from Bank of America Visa-equipment shipment,D105,HJ,15.05,,7900
6430,11/17/2020,11/17/2020,Joseph Zarate,Imported from Bank of America Visa-equipment returns,D105,HJ,28.85,,7928.85
6430,11/20/2020,11/20/2020,Alan Safran,Imported from Bank of America Visa-Alan Fedex charge,D102,HJ,30.95,,7959.8
6430,11/20/2020,11/20/2020,Joseph Zarate,Imported from Bank of America Visa-equipment,D105,HJ,7.75,,7967.55
6430,11/20/2020,11/20/2020,Joseph Zarate,Imported from Bank of America Visa-equipment,D105,HJ,7.75,,7975.3
6430,11/23/2020,11/23/2020,iaklestad,Imported from Bank of America Visa-Mailing Welcome Packages,D111,HJ,92.1,,8067.4
6430,11/23/2020,11/23/2020,Joseph Zarate,Imported from Bank of America Visa-New hire equipment,D105,HJ,15.05,,8082.45
6430,11/23/2020,11/23/2020,Joseph Zarate,Imported from Bank of America Visa-New hire equipment,D105,HJ,15.05,,8097.5
6430,11/23/2020,11/23/2020,Joseph Zarate,Imported from Bank of America Visa-New hire equipment,D105,HJ,60.2,,8157.7
6430,11/25/2020,11/25/2020,Joseph Zarate,Imported from Bank of America Visa-Pilot program shipment,D105,HJ,15.05,,8172.75
6430,11/25/2020,11/25/2020,Joseph Zarate,Imported from Bank of America Visa-Pilot program shipment,D105,HJ,30.1,,8202.85
6430,11/28/2020,11/28/2020,Mahaliah Sejour,Imported from Bank of America Visa-Fellows gifts,D108,HJ,42.3,,8245.15
6430,11/28/2020,11/28/2020,Mahaliah Sejour,Imported from Bank of America Visa-Fellows gifts,D108,HJ,42.3,,8287.45
6430,12/1/2020,12/1/2020,Joseph Zarate,Imported from Bank of America Visa-equipment shipment,D105,HJ,8.3,,8295.75
6430,12/1/2020,12/1/2020,Joseph Zarate,Imported from Bank of America Visa-equipment shipment,D105,HJ,8.4,,8304.15
6430,12/1/2020,12/1/2020,Mahaliah Sejour,Imported from Bank of America Visa-X Co.  award shipping,D108,HJ,7.5,,8311.65
6430,12/4/2020,12/4/2020,Joseph Zarate,Imported from Bank of America Visa-equipment shipment,D105,HJ,7.75,,8319.4
6430,12/5/2020,12/5/2020,Antonio Gutierrez,Imported from Bank of America Visa-Supplies.face mask postage,D107,HJ,34.79,,8354.19
6430,12/7/2020,12/7/2020,iaklestad,Imported from Bank of America Visa-Fellow Welcome Packages,D111,HJ,22.4,,8376.59
6430,12/8/2020,12/8/2020,iaklestad,Imported from Bank of America Visa-Fellow Welcome Packages,D111,HJ,56.25,,8432.84
6430,12/11/2020,12/11/2020,Antonio Gutierrez,Imported from Bank of America Visa-Shipping postage for swag,D107,HJ,19.11,,8451.95
6430,12/11/2020,12/11/2020,Antonio Gutierrez,Imported from Bank of America Visa-Supplies.face mask postage,D107,HJ,11.67,,8463.62
6430,12/11/2020,12/11/2020,Myesha Hossain,Imported from Bank of America Visa-Staff Appreciation,D108,HJ,12.53,,8476.15
6430,12/15/2020,12/15/2020,Antonio Gutierrez,Imported from Bank of America Visa-Swag shipment,D107,HJ,23.65,,8499.8
6430,12/15/2020,12/15/2020,Joseph Zarate,Imported from Bank of America Visa-equipment shipment,D105,HJ,16.8,,8516.6
6430,12/17/2020,12/17/2020,Elizabeth Peinado,Imported from Bank of America Visa-New hire packages,D111,HJ,9.21,,8525.81
6430,12/17/2020,12/17/2020,Elizabeth Peinado,Imported from Bank of America Visa-New hire packages,D111,HJ,14.24,,8540.05
6430,12/17/2020,12/17/2020,Elizabeth Peinado,Imported from Bank of America Visa-New hire packages,D111,HJ,14.24,,8554.29
6430,12/17/2020,12/17/2020,Elizabeth Peinado,Imported from Bank of America Visa-New hire packages,D111,HJ,46.06,,8600.35
6430,12/18/2020,12/18/2020,Joseph Zarate,Imported from Bank of America Visa-New hire equipment,D105,HJ,29.5,,8629.85
6430,12/21/2020,12/21/2020,Stephen Lipscomb,Bill.Com Import-Postage,D108,HJ,499.69,,9129.54
6430,12/22/2020,12/22/2020,Elizabeth Peinado,Imported from Bank of America Visa-New hire packages,D111,HJ,2.11,,9131.65
6430,12/22/2020,12/22/2020,Elizabeth Peinado,Imported from Bank of America Visa-New hire packages,D111,HJ,3.26,,9134.91
6430,12/22/2020,12/22/2020,Elizabeth Peinado,Imported from Bank of America Visa-New hire packages,D111,HJ,3.26,,9138.17
6430,12/22/2020,12/22/2020,Elizabeth Peinado,Imported from Bank of America Visa-New hire packages,D111,HJ,10.52,,9148.69
6430,12/29/2020,12/29/2020,Joseph Zarate,Imported from Bank of America Visa-equipment returns,D105,HJ,28.08,,9176.77
6430,12/30/2020,12/30/2020,iaklestad,Imported from Bank of America Visa-Fellow Welcome Packages,D111,HJ,55.85,,9232.62
6430,1/5/2021,1/5/2021,Joseph Zarate,Imported from Bank of America Visa-Returns,D105,HJ,21.1,,9253.72
6430,1/5/2021,1/5/2021,Joseph Zarate,Imported from Bank of America Visa-equipment,D105,HJ,160.5,,9414.22
6430,1/5/2021,1/5/2021,Joseph Zarate,Imported from Bank of America Visa-equipment shipment,D105,HJ,25.9,,9440.12
6430,1/6/2021,1/6/2021,Joseph Zarate,Imported from Bank of America Visa-Returns,D105,HJ,15.05,,9455.17
6430,1/6/2021,1/6/2021,Joseph Zarate,Imported from Bank of America Visa-equipment,D105,HJ,197.74,,9652.91
6430,1/6/2021,1/6/2021,Joseph Zarate,Imported from Bank of America Visa-equipment shipment,D109,HJ,7.75,,9660.66
6430,1/6/2021,1/6/2021,Joseph Zarate,Imported from Bank of America Visa-equipment shipment,D109,HJ,7.75,,9668.41
6430,1/7/2021,1/7/2021,iaklestad,Imported from Bank of America Visa-Welcome Package Mailing,D111,HJ,29.65,,9698.06
6430,1/7/2021,1/7/2021,Joseph Zarate,Imported from Bank of America Visa-Returns,D105,HJ,22.8,,9720.86
6430,1/8/2021,1/8/2021,iaklestad,Imported from Bank of America Visa-Welcome Package Mailing,D111,HJ,28.7,,9749.56
6430,1/8/2021,1/8/2021,Joseph Zarate,Imported from Bank of America Visa-Returns,D105,HJ,15.05,,9764.61
6430,1/11/2021,1/11/2021,Antonio Gutierrez,Imported from Bank of America Visa-SWAG Shipment to Staff,D107,HJ,19.11,,9783.72
6430,1/13/2021,1/13/2021,Joseph Zarate,Imported from Bank of America Visa-Returns,D109,HJ,24.57,,9808.29
6430,1/13/2021,1/13/2021,Joseph Zarate,Imported from Bank of America Visa-Returns,D109,HJ,49.88,,9858.17
6430,1/14/2021,1/14/2021,Joseph Zarate,Imported from Bank of America Visa-Returns,D105,HJ,15.05,,9873.22
6430,1/14/2021,1/14/2021,Joseph Zarate,Imported from Bank of America Visa-equipment,D105,HJ,6.05,,9879.27
6430,1/16/2021,1/16/2021,Halley Bowman,Imported from Bank of America Visa-Mailing textbook to Mallory,D101,HJ,0.64,,9879.91
6430,1/16/2021,1/16/2021,Halley Bowman,Imported from Bank of America Visa-Mailing textbook to Mallory,D101,HJ,1,,9880.91
6430,1/16/2021,1/16/2021,Halley Bowman,Imported from Bank of America Visa-Mailing textbook to Mallory,D101,HJ,1,,9881.91
6430,1/16/2021,1/16/2021,Halley Bowman,Imported from Bank of America Visa-Mailing textbook to Mallory,D101,HJ,3.22,,9885.13
6430,1/19/2021,1/19/2021,Joseph Zarate,Imported from Bank of America Visa-equipment,D105,HJ,35.39,,9920.52
6430,1/19/2021,1/19/2021,Joseph Zarate,Imported from Bank of America Visa-equipment shipment,D109,HJ,7.75,,9928.27
6430,1/19/2021,1/19/2021,Joseph Zarate,Imported from Bank of America Visa-equipment shipment,D109,HJ,7.75,,9936.02
6430,1/21/2021,1/21/2021,Antonio Gutierrez,Imported from Bank of America Visa-SWAG Shipment to Staff,D107,HJ,98.55,,10034.57
6430,1/21/2021,1/21/2021,Myesha Hossain,Imported from Bank of America Visa-HSFI Team Time,D108,HJ,27.75,,10062.32
6430,1/26/2021,1/26/2021,Joseph Zarate,Imported from Bank of America Visa-equipment,D105,HJ,17.29,,10079.61
6430,2/1/2021,2/1/2021,iaklestad,Imported from Bank of America Visa-Welcome Package Mailing,D111,HJ,31,,10110.61
6430,2/1/2021,2/1/2021,Joseph Zarate,Imported from Bank of America Visa-Returns,D105,HJ,21.9,,10132.51
6430,2/1/2021,2/1/2021,Joseph Zarate,Imported from Bank of America Visa-Returns,D105,HJ,21.9,,10154.41
6430,2/1/2021,2/1/2021,Joseph Zarate,Imported from Bank of America Visa-shipping,D105,HJ,4.4,,10158.81
6430,2/2/2021,2/2/2021,Joseph Zarate,Imported from Bank of America Visa-equipment shipment,D105,HJ,16.96,,10175.77
6430,2/5/2021,2/5/2021,Joseph Zarate,Imported from Bank of America Visa-Returns,D105,HJ,31,,10206.77
6430,2/5/2021,2/5/2021,Joseph Zarate,Imported from Bank of America Visa-Returns,D105,HJ,31,,10237.77
6430,2/5/2021,2/5/2021,Miranda Cortez,Imported from Bank of America Visa-Mailing recruitment materials,D111,HJ,12.67,,10250.44
6430,2/5/2021,2/5/2021,Miranda Cortez,Imported from Bank of America Visa-Mailing recruitment materials,D111,HJ,12.67,,10263.11
6430,2/5/2021,2/5/2021,Miranda Cortez,Imported from Bank of America Visa-Mailing recruitment materials,D111,HJ,12.68,,10275.79
6430,2/5/2021,2/5/2021,Miranda Cortez,Imported from Bank of America Visa-Mailing recruitment materials,D111,HJ,12.68,,10288.47
6430,2/6/2021,2/6/2021,Joseph Zarate,Imported from Bank of America Visa-Returns,D105,HJ,23.45,,10311.92
6430,2/6/2021,2/6/2021,Joseph Zarate,Imported from Bank of America Visa-Returns,D105,HJ,77.5,,10389.42
6430,2/7/2021,2/7/2021,Alan Safran,Imported from Bank of America Visa-fedex HR expenses,D107,HJ,28.2,,10417.62
6430,2/8/2021,2/8/2021,Joseph Zarate,Imported from Bank of America Visa-Equipment,D105,HJ,34.14,,10451.76
6430,2/8/2021,2/8/2021,Joseph Zarate,Imported from Bank of America Visa-Equipment,D105,HJ,179.21,,10630.97
6430,2/8/2021,2/8/2021,Joseph Zarate,Imported from Bank of America Visa-Returns,D105,HJ,15.5,,10646.47
6430,2/9/2021,2/9/2021,Joseph Zarate,Imported from Bank of America Visa-equipment shipment,D105,HJ,42.36,,10688.83
6430,2/10/2021,2/10/2021,Joseph Zarate,Imported from Bank of America Visa-Returns,D105,HJ,20.19,,10709.02
6430,2/11/2021,2/11/2021,Antonio Gutierrez,Imported from Bank of America Visa-subscription,D107,HJ,19.11,,10728.13
6430,2/12/2021,2/12/2021,Elizabeth Peinado,Imported from Bank of America Visa-Mail anniversary gift to Miranda,D111,HJ,0.47,,10728.6
6430,2/12/2021,2/12/2021,Elizabeth Peinado,Imported from Bank of America Visa-Mail anniversary gift to Miranda,D111,HJ,0.73,,10729.33
6430,2/12/2021,2/12/2021,Elizabeth Peinado,Imported from Bank of America Visa-Mail anniversary gift to Miranda,D111,HJ,0.73,,10730.06
6430,2/12/2021,2/12/2021,Elizabeth Peinado,Imported from Bank of America Visa-Mail anniversary gift to Miranda,D111,HJ,2.37,,10732.43
6430,2/16/2021,2/16/2021,Joseph Zarate,Imported from Bank of America Visa-Returns,D105,HJ,15.5,,10747.93
6430,2/17/2021,2/17/2021,Joseph Zarate,Imported from Bank of America Visa-Equipment,D105,HJ,34.45,,10782.38
6430,2/17/2021,2/17/2021,Joseph Zarate,Imported from Bank of America Visa-Returns,D105,HJ,15.5,,10797.88
6430,2/22/2021,2/22/2021,iaklestad,Imported from Bank of America Visa-Welcome Package Mailing,D111,HJ,37.35,,10835.23
6430,2/24/2021,2/24/2021,Joseph Zarate,Imported from Bank of America Visa-Equipment,D105,HJ,35.6,,10870.83
6430,2/24/2021,2/24/2021,Joseph Zarate,Imported from Bank of America Visa-Returns,D105,HJ,21.9,,10892.73
6430,2/25/2021,2/25/2021,iaklestad,Imported from Bank of America Visa-Welcome Package Mailing,D111,HJ,44.95,,10937.68
6430,2/25/2021,2/25/2021,Joseph Zarate,Imported from Bank of America Visa-credit return,D105,HJ,,87.44,10850.24
6430,3/1/2021,3/1/2021,Alan Safran,Imported from Bank of America Visa,D107,HJ,9,,10859.24
6430,3/1/2021,3/1/2021,Halley Bowman,Imported from Bank of America Visa,D101,HJ,0.72,,10859.96
6430,3/1/2021,3/1/2021,Halley Bowman,Imported from Bank of America Visa,D101,HJ,1.1,,10861.06
6430,3/1/2021,3/1/2021,Halley Bowman,Imported from Bank of America Visa,D101,HJ,1.11,,10862.17
6430,3/1/2021,3/1/2021,Halley Bowman,Imported from Bank of America Visa,D101,HJ,3.57,,10865.74
6430,3/1/2021,3/1/2021,iaklestad,Imported from Bank of America Visa,D111,HJ,15.5,,10881.24
6430,3/1/2021,3/1/2021,Joseph Zarate,Imported from Bank of America Visa,D105,HJ,26.65,,10907.89
6430,3/1/2021,3/1/2021,Joseph Zarate,Imported from Bank of America Visa,D105,HJ,26.65,,10934.54
6430,3/1/2021,3/1/2021,Joseph Zarate,Imported from Bank of America Visa,D109,HJ,73.78,,11008.32
6430,3/2/2021,3/2/2021,Joseph Zarate,Imported from Bank of America Visa,D105,HJ,86.99,,11095.31
6430,3/5/2021,3/5/2021,Alan Safran,Imported from Bank of America Visa,D107,HJ,24.3,,11119.61
6430,3/5/2021,3/5/2021,Joseph Zarate,Imported from Bank of America Visa,D105,HJ,29.85,,11149.46
6430,3/5/2021,3/5/2021,Joseph Zarate,Imported from Bank of America Visa,D105,HJ,29.85,,11179.31
6430,3/5/2021,3/5/2021,Joseph Zarate,Imported from Bank of America Visa,D105,HJ,29.85,,11209.16
6430,3/5/2021,3/5/2021,Joseph Zarate,Imported from Bank of America Visa,D105,HJ,91.85,,11301.01
6430,3/8/2021,3/8/2021,Antonio Gutierrez,Imported from Bank of America Visa,D107,HJ,100,,11401.01
6430,3/8/2021,3/8/2021,Antonio Gutierrez,Imported from Bank of America Visa,D107,HJ,100,,11501.01
6430,3/9/2021,3/9/2021,Myesha Hossain,Imported from Bank of America Visa,D108,HJ,26.55,,11527.56
6430,3/9/2021,3/9/2021,Myesha Hossain,Imported from Bank of America Visa,D108,HJ,59.85,,11587.41
6430,3/10/2021,3/10/2021,Antonio Gutierrez,Imported from Bank of America Visa,D107,HJ,19.11,,11606.52
6430,3/10/2021,3/10/2021,Joseph Zarate,Imported from Bank of America Visa,D105,HJ,94.38,,11700.9
6430,3/10/2021,3/10/2021,Joseph Zarate,Imported from Bank of America Visa,D105,HJ,153.66,,11854.56
6430,3/10/2021,3/10/2021,Joseph Zarate,Imported from Bank of America Visa,D105,HJ,488.6,,12343.16
6430,3/12/2021,3/12/2021,Antonio Gutierrez,Imported from Bank of America Visa,D107,HJ,20.28,,12363.44
6430,3/12/2021,3/12/2021,Joseph Zarate,Imported from Bank of America Visa,D105,HJ,8.55,,12371.99
6430,3/12/2021,3/12/2021,Joseph Zarate,Imported from Bank of America Visa,D105,HJ,43.8,,12415.79
6430,3/15/2021,3/15/2021,Joseph Zarate,Imported from Bank of America Visa,D105,HJ,117.09,,12532.88
6430,3/16/2021,3/16/2021,Joseph Zarate,Imported from Bank of America Visa,D105,HJ,176.62,,12709.5
6430,3/16/2021,3/16/2021,Joseph Zarate,Imported from Bank of America Visa,D105,HJ,193.77,,12903.27
6430,3/16/2021,3/16/2021,Joseph Zarate,Imported from Bank of America Visa,D105,HJ,193.78,,13097.05
6430,3/19/2021,3/19/2021,Alan Safran,Imported from Bank of America Visa,D104,HJ,45.94,,13142.99
6430,3/19/2021,3/19/2021,Joseph Zarate,Imported from Bank of America Visa,D105,HJ,171.66,,13314.65
6430,3/22/2021,3/22/2021,Joseph Zarate,Imported from Bank of America Visa,D105,HJ,15.62,,13330.27
6430,3/22/2021,3/22/2021,Joseph Zarate,Imported from Bank of America Visa,D105,HJ,15.62,,13345.89
6430,3/22/2021,3/22/2021,Joseph Zarate,Imported from Bank of America Visa,D105,HJ,46.88,,13392.77
6430,3/22/2021,3/22/2021,Joseph Zarate,Imported from Bank of America Visa,D105,HJ,46.95,,13439.72
6430,3/22/2021,3/22/2021,Tiffani Bibb,Imported from Bank of America Visa,D104,HJ,78,,13517.72
6430,3/24/2021,3/24/2021,Antonio Gutierrez,Imported from Bank of America Visa,D107,HJ,42.5,,13560.22
6430,3/24/2021,3/24/2021,iaklestad,Imported from Bank of America Visa,D111,HJ,50.85,,13611.07
6430,3/24/2021,3/24/2021,Joseph Zarate,Imported from Bank of America Visa,D105,HJ,25.33,,13636.4
6430,3/24/2021,3/24/2021,Joseph Zarate,Imported from Bank of America Visa,D105,HJ,51.42,,13687.82
6430,3/24/2021,3/24/2021,Tiffani Bibb,Imported from Bank of America Visa,D104,HJ,146.85,,13834.67
6430,3/31/2021,3/31/2021,iaklestad,Imported from Bank of America Visa,D111,HJ,25.05,,13859.72
6430,3/31/2021,3/31/2021,Joseph Zarate,Imported from Bank of America Visa,D105,HJ,11.55,,13871.27
6430,4/1/2021,4/1/2021,Alan Safran,Imported from Bank of America Visa,D107,HJ,13,,13884.27
6430,4/1/2021,4/1/2021,iaklestad,Imported from Bank of America Visa,D111,HJ,19.65,,13903.92
6430,4/1/2021,4/1/2021,Joseph Zarate,Imported from Bank of America Visa,D105,HJ,20.13,,13924.05
6430,4/2/2021,4/2/2021,Joseph Zarate,Imported from Bank of America Visa,D105,HJ,25.57,,13949.62
6430,4/2/2021,4/2/2021,Joseph Zarate,Imported from Bank of America Visa,D105,HJ,52.38,,14002
6430,4/13/2021,4/13/2021,Joseph Zarate,Imported from Bank of America Visa,D105,HJ,21.9,,14023.9
6430,4/13/2021,4/13/2021,Joseph Zarate,Imported from Bank of America Visa,D105,HJ,30.91,,14054.81
6430,4/13/2021,4/13/2021,Joseph Zarate,Imported from Bank of America Visa,D105,HJ,111.19,,14166
6430,4/13/2021,4/13/2021,Myesha Hossain,Imported from Bank of America Visa,D108,HJ,43,,14209
6430,4/16/2021,4/16/2021,Joseph Zarate,Imported from Bank of America Visa,D105,HJ,15.5,,14224.5
6430,4/21/2021,4/21/2021,iaklestad,Imported from Bank of America Visa,D111,HJ,4.15,,14228.65
6430,4/21/2021,4/21/2021,Myesha Hossain,Imported from Bank of America Visa,D108,HJ,80.7,,14309.35
6430,4/23/2021,4/23/2021,Joseph Zarate,Imported from Bank of America Visa,D105,HJ,72.95,,14382.3
6430,4/27/2021,4/27/2021,Joseph Zarate,Imported from Bank of America Visa,D105,HJ,25.65,,14407.95
6430,4/27/2021,4/27/2021,Joseph Zarate,Imported from Bank of America Visa,D105,HJ,2.48,,14410.43
6430,4/27/2021,4/27/2021,Joseph Zarate,Imported from Bank of America Visa,D105,HJ,25.31,,14435.74
6430,4/30/2021,4/30/2021,Joseph Zarate,Imported from Bank of America Visa,D105,HJ,32.14,,14467.88
6430,5/1/2021,5/1/2021,Joseph Zarate,Imported from Bank of America Visa,D105,HJ,38.89,,14506.77
6430,5/1/2021,5/1/2021,Joseph Zarate,Imported from Bank of America Visa,D105,HJ,38.89,,14545.66
6430,5/1/2021,5/1/2021,Joseph Zarate,Imported from Bank of America Visa,D105,HJ,40.06,,14585.72
6430,5/1/2021,5/1/2021,Kyra Detone,Imported from Bank of America Visa,D102,HJ,94.15,,14679.87
6430,5/5/2021,5/5/2021,Alan Safran,Imported from Bank of America Visa,D107,HJ,11,,14690.87
6430,5/5/2021,5/5/2021,Joseph Zarate,Imported from Bank of America Visa,D105,HJ,99.56,,14790.43
6430,5/5/2021,5/5/2021,Myesha Hossain,Imported from Bank of America Visa,D108,HJ,57.6,,14848.03
6430,5/6/2021,5/6/2021,Antonio Gutierrez,Imported from Bank of America Visa,D111,HJ,50,,14898.03
6430,5/11/2021,5/11/2021,iaklestad,Imported from Bank of America Visa,D111,HJ,46.5,,14944.53
6430,5/11/2021,5/11/2021,Joseph Zarate,Imported from Bank of America Visa,D105,HJ,49.06,,14993.59
6430,5/11/2021,5/11/2021,Joseph Zarate,Imported from Bank of America Visa,D105,HJ,76.25,,15069.84
6430,5/11/2021,5/11/2021,Tiffani Bibb,Imported from Bank of America Visa,D104,HJ,13.94,,15083.78
6430,5/14/2021,5/14/2021,Joseph Zarate,Imported from Bank of America Visa,D105,HJ,76.85,,15160.63
6430,5/17/2021,5/17/2021,Alan Safran,Imported from Bank of America Visa,D107,HJ,8.8,,15169.43
6430,5/18/2021,5/18/2021,Joseph Zarate,Imported from Bank of America Visa,D105,HJ,21.9,,15191.33
6430,5/18/2021,5/18/2021,Joseph Zarate,Imported from Bank of America Visa,D105,HJ,32.46,,15223.79
6430,5/19/2021,5/19/2021,Joseph Zarate,Imported from Bank of America Visa,D105,HJ,34.98,,15258.77
6430,5/20/2021,5/20/2021,Myesha Hossain,Imported from Bank of America Visa,D108,HJ,71.3,,15330.07
6430,5/21/2021,5/21/2021,Joseph Zarate,Imported from Bank of America Visa,D105,HJ,15.5,,15345.57
6430,5/21/2021,5/21/2021,Joseph Zarate,Imported from Bank of America Visa,D105,HJ,55.5,,15401.07
6430,5/24/2021,5/24/2021,Joseph Zarate,Imported from Bank of America Visa,D105,HJ,65.74,,15466.81
6430,5/25/2021,5/25/2021,Myesha Hossain,Imported from Bank of America Visa,D108,HJ,40.8,,15507.61
6430,6/1/2021,6/1/2021,iaklestad,Imported from Bank of America Visa,D111,HJ,31,,15538.61
6430,6/1/2021,6/1/2021,Joseph Zarate,Imported from Bank of America Visa,D105,HJ,111.45,,15650.06
6430,6/2/2021,6/2/2021,Joseph Zarate,Imported from Bank of America Visa,D105,HJ,67.57,,15717.63
6430,6/2/2021,6/2/2021,Joseph Zarate,Imported from Bank of America Visa,D105,HJ,100,,15817.63
6430,6/2/2021,6/2/2021,Joseph Zarate,Imported from Bank of America Visa,D105,HJ,100,,15917.63
6430,6/2/2021,6/2/2021,Joseph Zarate,Imported from Bank of America Visa,D105,HJ,100,,16017.63
6430,6/2/2021,6/2/2021,Joseph Zarate,Imported from Bank of America Visa,D105,HJ,100,,16117.63
6430,6/2/2021,6/2/2021,Joseph Zarate,Imported from Bank of America Visa,D105,HJ,100,,16217.63
6430,6/4/2021,6/4/2021,Antonio Gutierrez,Imported from Bank of America Visa,D111,HJ,294.4,,16512.03
6430,6/4/2021,6/4/2021,Denise Parham-Gantt,Imported from Bank of America Visa,D112,HJ,50,,16562.03
6430,6/4/2021,6/4/2021,Denise Parham-Gantt,Imported from Bank of America Visa,D112,HJ,200,,16762.03
6430,6/4/2021,6/4/2021,Joseph Zarate,Imported from Bank of America Visa,D105,HJ,46.5,,16808.53
6430,6/4/2021,6/4/2021,Joseph Zarate,Imported from Bank of America Visa,D105,HJ,50,,16858.53
6430,6/4/2021,6/4/2021,Joseph Zarate,Imported from Bank of America Visa,D105,HJ,50,,16908.53
6430,6/4/2021,6/4/2021,Joseph Zarate,Imported from Bank of America Visa,D105,HJ,100,,17008.53
6430,6/8/2021,6/8/2021,Joseph Zarate,Imported from Bank of America Visa,D105,HJ,100,,17108.53
6430,6/8/2021,6/8/2021,Joseph Zarate,Imported from Bank of America Visa,D105,HJ,15.5,,17124.03
6430,6/8/2021,6/8/2021,Joseph Zarate,Imported from Bank of America Visa,D105,HJ,46.5,,17170.53
6430,6/9/2021,6/9/2021,Alan Safran,Imported from Bank of America Visa,D107,HJ,11,,17181.53
6430,6/10/2021,6/10/2021,Joseph Zarate,Imported from Bank of America Visa,D105,HJ,15.5,,17197.03
6430,6/10/2021,6/10/2021,Joseph Zarate,Imported from Bank of America Visa,D105,HJ,15.5,,17212.53
6430,6/10/2021,6/10/2021,Joseph Zarate,Imported from Bank of America Visa,D105,HJ,100,,17312.53
6430,6/11/2021,6/11/2021,Antonio Gutierrez,Imported from Bank of America Visa,D111,HJ,19.11,,17331.64
6430,6/11/2021,6/11/2021,Joseph Zarate,Imported from Bank of America Visa,D105,HJ,100,,17431.64
6430,6/14/2021,6/14/2021,Joseph Zarate,Imported from Bank of America Visa,D105,HJ,100,,17531.64
6430,6/14/2021,6/14/2021,Joseph Zarate,Imported from Bank of America Visa,D105,HJ,100,,17631.64
6430,6/15/2021,6/15/2021,Joseph Zarate,Imported from Bank of America Visa,D105,HJ,25.46,,17657.1
6430,6/15/2021,6/15/2021,Joseph Zarate,Imported from Bank of America Visa,D105,HJ,120.04,,17777.14
6430,6/16/2021,6/16/2021,Joseph Zarate,Imported from Bank of America Visa,D105,HJ,104.61,,17881.75
6430,6/16/2021,6/16/2021,Joseph Zarate,Imported from Bank of America Visa,D105,HJ,100,,17981.75
6430,6/16/2021,6/16/2021,Joseph Zarate,Imported from Bank of America Visa,D105,HJ,100,,18081.75
6430,6/16/2021,6/16/2021,Joseph Zarate,Imported from Bank of America Visa,D105,HJ,143.8,,18225.55
6430,6/17/2021,6/17/2021,iaklestad,Imported from Bank of America Visa,D111,HJ,5,,18230.55
6430,6/17/2021,6/17/2021,Joseph Zarate,Imported from Bank of America Visa,D105,HJ,100,,18330.55
6430,6/22/2021,6/22/2021,Joseph Zarate,Imported from Bank of America Visa,D105,HJ,150.88,,18481.43
6430,6/23/2021,6/23/2021,Sharanya Balasubrama,Imported from reimbursements,D108,HJ,47.4,,18528.83
6430,6/24/2021,6/24/2021,Elizabeth Peinado,Imported from Bank of America Visa,D111,HJ,0.9,,18529.73
6430,6/24/2021,6/24/2021,Elizabeth Peinado,Imported from Bank of America Visa,D111,HJ,1.39,,18531.12
6430,6/24/2021,6/24/2021,Elizabeth Peinado,Imported from Bank of America Visa,D111,HJ,1.39,,18532.51
6430,6/24/2021,6/24/2021,Elizabeth Peinado,Imported from Bank of America Visa,D111,HJ,4.47,,18536.98
6430,6/24/2021,6/24/2021,Joseph Zarate,Imported from Bank of America Visa,D105,HJ,24.07,,18561.05
6430,6/24/2021,6/24/2021,Joseph Zarate,Imported from Bank of America Visa,D105,HJ,31.22,,18592.27
6430,6/24/2021,6/24/2021,Joseph Zarate,Imported from Bank of America Visa,D105,HJ,75.93,,18668.2
6430,6/24/2021,6/24/2021,Joseph Zarate,Imported from Bank of America Visa,D105,HJ,187.84,,18856.04
6430,6/24/2021,6/24/2021,Joseph Zarate,Imported from Bank of America Visa,D105,HJ,320.23,,19176.27
6430,6/24/2021,6/24/2021,Joseph Zarate,Imported from Bank of America Visa,D105,HJ,2000,,21176.27
6430,6/24/2021,6/24/2021,Myesha Hossain,Imported from Bank of America Visa,D108,HJ,30.6,,21206.87
6430,6/24/2021,6/24/2021,Tiffani Bibb,Imported from Bank of America Visa,D104,HJ,17.89,,21224.76
6430,6/28/2021,6/28/2021,Joseph Zarate,Imported from Bank of America Visa,D105,HJ,15.5,,21240.26
6430,6/28/2021,6/28/2021,Joseph Zarate,Imported from Bank of America Visa,D105,HJ,25.2,,21265.46
6430,6/28/2021,6/28/2021,Joseph Zarate,Imported from Bank of America Visa,D105,HJ,46.5,,21311.96
6430,6/28/2021,6/28/2021,Joseph Zarate,Imported from Bank of America Visa,D105,HJ,61.69,,21373.65
6430, Totals for 6430 - Postage and Mailing Services,,,,,,21614.19,240.54,21373.65
6440,6440 - Printing and Copying (Balance forward As of 07/01/2020) ,,,,,,,,0
6440,7/30/2020,7/30/2020,C & L Printing,Bill.Com Import-Printing of posters Cleveland HS expenses,D108,HJ,650.47,,650.47
6440,8/11/2020,8/11/2020,Elizabeth Peinado,Imported from Bank of America Visa-Paper materials for new hire packages,D111,HJ,5.93,,656.4
6440,8/11/2020,8/11/2020,Elizabeth Peinado,Imported from Bank of America Visa-Paper materials for new hire packages,D111,HJ,9.16,,665.56
6440,8/11/2020,8/11/2020,Elizabeth Peinado,Imported from Bank of America Visa-Paper materials for new hire packages,D111,HJ,9.16,,674.72
6440,8/11/2020,8/11/2020,Elizabeth Peinado,Imported from Bank of America Visa-Paper materials for new hire packages,D111,HJ,29.63,,704.35
6440,9/25/2020,9/25/2020,Myesha Hossain,Imported from Bank of America Visa-Printing and Copying,D108,HJ,303.59,,1007.94
6440,10/13/2020,10/13/2020,Myesha Hossain,Imported from reimbursements-Mailing tubes,D108,HJ,8.69,,1016.63
6440,10/13/2020,10/13/2020,Myesha Hossain,Imported from reimbursements-PPE posters,D108,HJ,202.4,,1219.03
6440,11/7/2020,11/7/2020,Nicole Prahin,Imported from Bank of America Visa-Ink for at home work use,D108,HJ,5.35,,1224.38
6440,11/17/2020,11/17/2020,Mahaliah Sejour,Imported from Bank of America Visa-MS printer,D108,HJ,5.35,,1229.73
6440,11/20/2020,11/20/2020,iaklestad,Imported from Bank of America Visa-Fellow Welcome Packages,D111,HJ,23.03,,1252.76
6440,1/8/2021,1/8/2021,iaklestad,Imported from Bank of America Visa-Welcome Package Flyer,D111,HJ,4.54,,1257.3
6440,1/16/2021,1/16/2021,Mahaliah Sejour,Imported from Bank of America Visa-MS printer,D108,HJ,5.35,,1262.65
6440,2/16/2021,2/16/2021,Mahaliah Sejour,Imported from Bank of America Visa-MS printer,D108,HJ,5.35,,1268
6440,3/18/2021,3/18/2021,Tiffani Bibb,Imported from Bank of America Visa,D104,HJ,109.78,,1377.78
6440,4/19/2021,4/19/2021,Tiffani Bibb,Imported from Bank of America Visa,D104,HJ,53.75,,1431.53
6440,5/1/2021,5/1/2021,Kyra Detone,Imported from Bank of America Visa,D102,HJ,1.56,,1433.09
6440,5/1/2021,5/1/2021,Kyra Detone,Imported from Bank of America Visa,D102,HJ,4.68,,1437.77
6440,5/1/2021,5/1/2021,Kyra Detone,Imported from Bank of America Visa,D102,HJ,251.39,,1689.16
6440, Totals for 6440 - Printing and Copying,,,,,,1689.16,0,1689.16
6450,6450 - Phone and Internet expenses (Balance forward As of 07/01/2020) ,,,,,,,,0
6450,7/6/2020,7/6/2020,Comcast,Comcast July internet expenses-Comcast July internet expenses,D107,HJ,139.55,,139.55
6450,7/8/2020,7/8/2020,CB-2,To correct the department coding for CB-To correct the department coding for CB,D105,HJ,304,,443.55
6450,7/8/2020,7/8/2020,CB-2,To correct the department coding for CB-To correct the department coding for CB,D113,HJ,,304,139.55
6450,7/8/2020,7/8/2020,CB-2,To correct the department coding for CB-To correct the department coding for CB,D105,HJ,983.54,,1123.09
6450,7/8/2020,7/8/2020,CB-2,To correct the department coding for CB-To correct the department coding for CB,D113,HJ,,983.54,139.55
6450,7/8/2020,7/8/2020,CB-2,To correct the department coding for CB-To correct the department coding for CB,D105,HJ,304,,443.55
6450,7/8/2020,7/8/2020,CB-2,To correct the department coding for CB-To correct the department coding for CB,D113,HJ,,304,139.55
6450,7/8/2020,7/8/2020,CB-2,To correct the department coding for CB-To correct the department coding for CB,D105,HJ,196.71,,336.26
6450,7/8/2020,7/8/2020,CB-2,To correct the department coding for CB-To correct the department coding for CB,D113,HJ,,196.71,139.55
6450,7/8/2020,7/8/2020,Verizon,Mifi devices for College Board-Mifi devices for College Board,D113,HJ,450.8,,590.35
6450,7/8/2020,7/8/2020,Verizon,Mifi devices for College Board-Mifi devices for College Board,D113,HJ,1337.45,,1927.8
6450,7/10/2020,7/10/2020,Odalis Polanco,Imported from reimbursements-Finance retreat,D103,HJ,12,,1939.8
6450,7/16/2020,7/16/2020,Nicole Prahin,Imported from Bank of America Visa-Google drive storage space,D108,HJ,2.13,,1941.93
6450,7/17/2020,7/17/2020,T-Mobile,Phone expenses for July-Phone expenses for July,D108,HJ,95.47,,2037.4
6450,7/17/2020,7/17/2020,T-Mobile,Phone expenses for July-Phone expenses for July,D108,HJ,308.88,,2346.28
6450,7/17/2020,7/17/2020,T-Mobile,Phone expenses for July-Phone expenses for July,D108,HJ,95.47,,2441.75
6450,7/17/2020,7/17/2020,T-Mobile,Phone expenses for July-Phone expenses for July,D108,HJ,61.78,,2503.53
6450,7/30/2020,7/30/2020,Kika Enterprises LL,Bill.Com Import-506 Verizon hotspots used for 500 HP Netbooks for The College Board contract. A mifi for Monivett,D103,HJ,,97.99,2405.54
6450,7/30/2020,7/30/2020,Kika Enterprises LL,Bill.Com Import-506 Verizon hotspots used for 500 HP Netbooks for The College Board contract. A mifi for Monivett,D103,HJ,97.99,,2503.53
6450,8/5/2020,8/5/2020,Comcast,August Internet expense-August Internet expense,D107,HJ,139.55,,2643.08
6450,8/7/2020,8/7/2020,Verizon,August Mifi devices for fellows-August Mifi devices for fellows,D107,HJ,450.8,,3093.88
6450,8/7/2020,8/7/2020,Verizon,August Mifi devices for fellows-August Mifi devices for fellows,D107,HJ,2339.55,,5433.43
6450,8/17/2020,8/17/2020,Nicole Prahin,Imported from Bank of America Visa-Google drive storage space,D108,HJ,2.13,,5435.56
6450,8/17/2020,8/17/2020,T-Mobile,August T-mobile phone expenses-August T-mobile phone expenses,D107,HJ,561.6,,5997.16
6450,9/8/2020,9/8/2020,Comcast,September Internet expenses-Comcast-September Internet expenses-Comcast,D107,HJ,139.55,,6136.71
6450,9/10/2020,9/10/2020,Verizon,September Mifi devices for fellows-September Mifi devices for fellows,D107,HJ,450.8,,6587.51
6450,9/16/2020,9/16/2020,Nicole Prahin,Imported from Bank of America Visa-Google drive storage space,D108,HJ,2.13,,6589.64
6450,9/17/2020,9/17/2020,T-Mobile,August phone expenses for fellows-August phone expenses for fellows,D108,HJ,95.47,,6685.11
6450,9/17/2020,9/17/2020,T-Mobile,August phone expenses for fellows-August phone expenses for fellows,D108,HJ,308.88,,6993.99
6450,9/17/2020,9/17/2020,T-Mobile,August phone expenses for fellows-August phone expenses for fellows,D108,HJ,95.47,,7089.46
6450,9/17/2020,9/17/2020,T-Mobile,August phone expenses for fellows-August phone expenses for fellows,D108,HJ,61.78,,7151.24
6450,9/23/2020,9/23/2020,iaklestad,Imported from reimbursements-Recruitment Call,D111,HJ,89.64,,7240.88
6450,9/25/2020,9/25/2020,Alexander Randolph,Bill.Com Import-Recruitment: International call for Candidate during an interview.,D111,HJ,55.35,,7296.23
6450,10/7/2020,10/7/2020,Verizon,October Mifi devices for fellow-October Mifi devices for fellow,D105,HJ,76.64,,7372.87
6450,10/7/2020,10/7/2020,Verizon,October Mifi devices for fellow-October Mifi devices for fellow,D105,HJ,452.33,,7825.2
6450,10/7/2020,10/7/2020,Verizon,October Mifi devices for fellow-October Mifi devices for fellow,D105,HJ,247.63,,8072.83
6450,10/7/2020,10/7/2020,Verizon,October Mifi devices for fellow-October Mifi devices for fellow,D105,HJ,1463.41,,9536.24
6450,10/7/2020,10/7/2020,Verizon,October Mifi devices for fellow-October Mifi devices for fellow,D105,HJ,76.64,,9612.88
6450,10/7/2020,10/7/2020,Verizon,October Mifi devices for fellow-October Mifi devices for fellow,D105,HJ,452.33,,10065.21
6450,10/7/2020,10/7/2020,Verizon,October Mifi devices for fellow-October Mifi devices for fellow,D105,HJ,49.58,,10114.79
6450,10/7/2020,10/7/2020,Verizon,October Mifi devices for fellow-October Mifi devices for fellow,D105,HJ,292.68,,10407.47
6450,10/16/2020,10/16/2020,Nicole Prahin,Imported from reimbursements-Google drive storage space,D108,HJ,2.13,,10409.6
6450,10/19/2020,10/19/2020,T-Mobile,September T-mobile mi-fi expenses for fellow-September T-mobile mi-fi expenses for fellow,D105,HJ,95.47,,10505.07
6450,10/19/2020,10/19/2020,T-Mobile,September T-mobile mi-fi expenses for fellow-September T-mobile mi-fi expenses for fellow,D105,HJ,308.88,,10813.95
6450,10/19/2020,10/19/2020,T-Mobile,September T-mobile mi-fi expenses for fellow-September T-mobile mi-fi expenses for fellow,D105,HJ,95.47,,10909.42
6450,10/19/2020,10/19/2020,T-Mobile,September T-mobile mi-fi expenses for fellow-September T-mobile mi-fi expenses for fellow,D105,HJ,61.78,,10971.2
6450,11/9/2020,11/9/2020,Verizon,Mifi devices for fellows for November-Mifi devices for fellows for November,D105,HJ,76.64,,11047.84
6450,11/9/2020,11/9/2020,Verizon,Mifi devices for fellows for November-Mifi devices for fellows for November,D105,HJ,657.03,,11704.87
6450,11/9/2020,11/9/2020,Verizon,Mifi devices for fellows for November-Mifi devices for fellows for November,D105,HJ,247.94,,11952.81
6450,11/9/2020,11/9/2020,Verizon,Mifi devices for fellows for November-Mifi devices for fellows for November,D105,HJ,2125.71,,14078.52
6450,11/9/2020,11/9/2020,Verizon,Mifi devices for fellows for November-Mifi devices for fellows for November,D105,HJ,76.64,,14155.16
6450,11/9/2020,11/9/2020,Verizon,Mifi devices for fellows for November-Mifi devices for fellows for November,D105,HJ,657.03,,14812.19
6450,11/9/2020,11/9/2020,Verizon,Mifi devices for fellows for November-Mifi devices for fellows for November,D105,HJ,49.58,,14861.77
6450,11/9/2020,11/9/2020,Verizon,Mifi devices for fellows for November-Mifi devices for fellows for November,D105,HJ,425.14,,15286.91
6450,11/17/2020,11/17/2020,T-Mobile,November phone expenses for fellows-November phone expenses for fellows,D107,HJ,95.47,,15382.38
6450,11/17/2020,11/17/2020,T-Mobile,November phone expenses for fellows-November phone expenses for fellows,D107,HJ,308.88,,15691.26
6450,11/17/2020,11/17/2020,T-Mobile,November phone expenses for fellows-November phone expenses for fellows,D107,HJ,95.47,,15786.73
6450,11/17/2020,11/17/2020,T-Mobile,November phone expenses for fellows-November phone expenses for fellows,D107,HJ,61.78,,15848.51
6450,12/9/2020,12/9/2020,Verizon,Mifi devices for fellows for December-Mifi devices for fellows for December,D105,HJ,76.64,,15925.15
6450,12/9/2020,12/9/2020,Verizon,Mifi devices for fellows for December-Mifi devices for fellows for December,D105,HJ,555.85,,16481
6450,12/9/2020,12/9/2020,Verizon,Mifi devices for fellows for December-Mifi devices for fellows for December,D105,HJ,247.94,,16728.94
6450,12/9/2020,12/9/2020,Verizon,Mifi devices for fellows for December-Mifi devices for fellows for December,D105,HJ,1798.34,,18527.28
6450,12/9/2020,12/9/2020,Verizon,Mifi devices for fellows for December-Mifi devices for fellows for December,D105,HJ,76.64,,18603.92
6450,12/9/2020,12/9/2020,Verizon,Mifi devices for fellows for December-Mifi devices for fellows for December,D105,HJ,555.85,,19159.77
6450,12/9/2020,12/9/2020,Verizon,Mifi devices for fellows for December-Mifi devices for fellows for December,D105,HJ,49.58,,19209.35
6450,12/9/2020,12/9/2020,Verizon,Mifi devices for fellows for December-Mifi devices for fellows for December,D105,HJ,359.66,,19569.01
6450,12/17/2020,12/17/2020,T-Mobile,November Phone Expenses for Fellows-December Phone Expenses for Fellows,D105,HJ,95.47,,19664.48
6450,12/17/2020,12/17/2020,T-Mobile,November Phone Expenses for Fellows-December Phone Expenses for Fellows,D105,HJ,308.88,,19973.36
6450,12/17/2020,12/17/2020,T-Mobile,November Phone Expenses for Fellows-December Phone Expenses for Fellows,D105,HJ,95.47,,20068.83
6450,12/17/2020,12/17/2020,T-Mobile,November Phone Expenses for Fellows-December Phone Expenses for Fellows,D105,HJ,61.78,,20130.61
6450,12/31/2020,12/31/2020,20201231,Actual vs Budget Reclass as of 12/31/2020-Actual vs Budget Reclass as of 12/31/2020,D107,HJ,123.56,,20254.17
6450,12/31/2020,12/31/2020,20201231,Actual vs Budget Reclass as of 12/31/2020-Actual vs Budget Reclass as of 12/31/2020,D107,HJ,190.94,,20445.11
6450,12/31/2020,12/31/2020,20201231,Actual vs Budget Reclass as of 12/31/2020-Actual vs Budget Reclass as of 12/31/2020,D107,HJ,626.29,,21071.4
6450,12/31/2020,12/31/2020,20201231,Actual vs Budget Reclass as of 12/31/2020-Actual vs Budget Reclass as of 12/31/2020,D108,HJ,,123.56,20947.84
6450,12/31/2020,12/31/2020,20201231,Actual vs Budget Reclass as of 12/31/2020-Actual vs Budget Reclass as of 12/31/2020,D108,HJ,,190.94,20756.9
6450,12/31/2020,12/31/2020,20201231,Actual vs Budget Reclass as of 12/31/2020-Actual vs Budget Reclass as of 12/31/2020,D108,HJ,,626.29,20130.61
6450,1/5/2021,1/5/2021,Comcast,December Comcast Payment-December Comcast Payment,D107,HJ,139.55,,20270.16
6450,1/7/2021,1/7/2021,Verizon,Wifi services pay for Fellows January-Wifi services pay for Fellows January,D105,HJ,76.64,,20346.8
6450,1/7/2021,1/7/2021,Verizon,Wifi services pay for Fellows January-Wifi services pay for Fellows January,D105,HJ,993.21,,21340.01
6450,1/7/2021,1/7/2021,Verizon,Wifi services pay for Fellows January-Wifi services pay for Fellows January,D105,HJ,247.94,,21587.95
6450,1/7/2021,1/7/2021,Verizon,Wifi services pay for Fellows January-Wifi services pay for Fellows January,D105,HJ,3213.31,,24801.26
6450,1/7/2021,1/7/2021,Verizon,Wifi services pay for Fellows January-Wifi services pay for Fellows January,D105,HJ,76.64,,24877.9
6450,1/7/2021,1/7/2021,Verizon,Wifi services pay for Fellows January-Wifi services pay for Fellows January,D105,HJ,993.21,,25871.11
6450,1/7/2021,1/7/2021,Verizon,Wifi services pay for Fellows January-Wifi services pay for Fellows January,D105,HJ,49.58,,25920.69
6450,1/7/2021,1/7/2021,Verizon,Wifi services pay for Fellows January-Wifi services pay for Fellows January,D105,HJ,642.66,,26563.35
6450,1/19/2021,1/19/2021,T-Mobile,January Phone Expenses for Fellows-January Phone Expenses for Fellows,D105,HJ,95.47,,26658.82
6450,1/19/2021,1/19/2021,T-Mobile,January Phone Expenses for Fellows-January Phone Expenses for Fellows,D105,HJ,308.88,,26967.7
6450,1/19/2021,1/19/2021,T-Mobile,January Phone Expenses for Fellows-January Phone Expenses for Fellows,D105,HJ,95.47,,27063.17
6450,1/19/2021,1/19/2021,T-Mobile,January Phone Expenses for Fellows-January Phone Expenses for Fellows,D105,HJ,61.78,,27124.95
6450,2/5/2021,2/5/2021,Comcast,January Comcast Payment-January Comcast Payment,D107,HJ,139.55,,27264.5
6450,2/9/2021,2/9/2021,Verizon,Wifi services pay for fellows February-Wifi services pay for fellows February,D105,HJ,76.64,,27341.14
6450,2/9/2021,2/9/2021,Verizon,Wifi services pay for fellows February-Wifi services pay for fellows February,D105,HJ,880.11,,28221.25
6450,2/9/2021,2/9/2021,Verizon,Wifi services pay for fellows February-Wifi services pay for fellows February,D105,HJ,247.94,,28469.19
6450,2/9/2021,2/9/2021,Verizon,Wifi services pay for fellows February-Wifi services pay for fellows February,D105,HJ,2847.41,,31316.6
6450,2/9/2021,2/9/2021,Verizon,Wifi services pay for fellows February-Wifi services pay for fellows February,D105,HJ,76.64,,31393.24
6450,2/9/2021,2/9/2021,Verizon,Wifi services pay for fellows February-Wifi services pay for fellows February,D105,HJ,880.11,,32273.35
6450,2/9/2021,2/9/2021,Verizon,Wifi services pay for fellows February-Wifi services pay for fellows February,D105,HJ,49.58,,32322.93
6450,2/9/2021,2/9/2021,Verizon,Wifi services pay for fellows February-Wifi services pay for fellows February,D105,HJ,569.47,,32892.4
6450,2/17/2021,2/17/2021,T-Mobile,February Phone Expenses for Fellows-February Phone Expenses for Fellows,D105,HJ,95.47,,32987.87
6450,2/17/2021,2/17/2021,T-Mobile,February Phone Expenses for Fellows-February Phone Expenses for Fellows,D105,HJ,308.88,,33296.75
6450,2/17/2021,2/17/2021,T-Mobile,February Phone Expenses for Fellows-February Phone Expenses for Fellows,D105,HJ,95.47,,33392.22
6450,2/17/2021,2/17/2021,T-Mobile,February Phone Expenses for Fellows-February Phone Expenses for Fellows,D105,HJ,61.78,,33454
6450,3/5/2021,3/5/2021,Comcast,March Comcast Payment,D107,HJ,139.55,,33593.55
6450,3/9/2021,3/9/2021,Verizon,Wifi services pay for Fellows March,D105,HJ,76.64,,33670.19
6450,3/9/2021,3/9/2021,Verizon,Wifi services pay for Fellows March,D105,HJ,1025.38,,34695.57
6450,3/9/2021,3/9/2021,Verizon,Wifi services pay for Fellows March,D105,HJ,247.94,,34943.51
6450,3/9/2021,3/9/2021,Verizon,Wifi services pay for Fellows March,D105,HJ,3317.4,,38260.91
6450,3/9/2021,3/9/2021,Verizon,Wifi services pay for Fellows March,D105,HJ,76.64,,38337.55
6450,3/9/2021,3/9/2021,Verizon,Wifi services pay for Fellows March,D105,HJ,1025.38,,39362.93
6450,3/9/2021,3/9/2021,Verizon,Wifi services pay for Fellows March,D105,HJ,49.58,,39412.51
6450,3/9/2021,3/9/2021,Verizon,Wifi services pay for Fellows March,D105,HJ,663.47,,40075.98
6450,3/17/2021,3/17/2021,T-Mobile,March Phone Expenses for Fellows,D105,HJ,95.47,,40171.45
6450,3/17/2021,3/17/2021,T-Mobile,March Phone Expenses for Fellows,D105,HJ,308.88,,40480.33
6450,3/17/2021,3/17/2021,T-Mobile,March Phone Expenses for Fellows,D105,HJ,95.47,,40575.8
6450,3/17/2021,3/17/2021,T-Mobile,March Phone Expenses for Fellows,D105,HJ,61.78,,40637.58
6450,4/5/2021,4/5/2021,Comcast,April Comcast Payment,D107,HJ,139.55,,40777.13
6450,4/7/2021,4/7/2021,Verizon,Wifi services pay for fellows April Payment,D105,HJ,76.64,,40853.77
6450,4/7/2021,4/7/2021,Verizon,Wifi services pay for fellows April Payment,D105,HJ,1051.54,,41905.31
6450,4/7/2021,4/7/2021,Verizon,Wifi services pay for fellows April Payment,D105,HJ,247.94,,42153.25
6450,4/7/2021,4/7/2021,Verizon,Wifi services pay for fellows April Payment,D105,HJ,3402.04,,45555.29
6450,4/7/2021,4/7/2021,Verizon,Wifi services pay for fellows April Payment,D105,HJ,76.64,,45631.93
6450,4/7/2021,4/7/2021,Verizon,Wifi services pay for fellows April Payment,D105,HJ,1051.54,,46683.47
6450,4/7/2021,4/7/2021,Verizon,Wifi services pay for fellows April Payment,D105,HJ,49.58,,46733.05
6450,4/7/2021,4/7/2021,Verizon,Wifi services pay for fellows April Payment,D105,HJ,680.4,,47413.45
6450,4/19/2021,4/19/2021,T-Mobile,T-Mobile Bill,D105,HJ,95.47,,47508.92
6450,4/19/2021,4/19/2021,T-Mobile,T-Mobile Bill,D105,HJ,308.88,,47817.8
6450,4/19/2021,4/19/2021,T-Mobile,T-Mobile Bill,D105,HJ,95.47,,47913.27
6450,4/19/2021,4/19/2021,T-Mobile,T-Mobile Bill,D105,HJ,61.78,,47975.05
6450,5/5/2021,5/5/2021,Comcast,Comcast Payment May,D107,HJ,139.55,,48114.6
6450,5/7/2021,5/7/2021,Verizon,Verizon May 2021,D105,HJ,1037.58,,49152.18
6450,5/7/2021,5/7/2021,Verizon,Verizon May 2021,D105,HJ,76.64,,49228.82
6450,5/7/2021,5/7/2021,Verizon,Verizon May 2021,D105,HJ,3356.87,,52585.69
6450,5/7/2021,5/7/2021,Verizon,Verizon May 2021,D105,HJ,247.94,,52833.63
6450,5/7/2021,5/7/2021,Verizon,Verizon May 2021,D105,HJ,1037.58,,53871.21
6450,5/7/2021,5/7/2021,Verizon,Verizon May 2021,D105,HJ,76.64,,53947.85
6450,5/7/2021,5/7/2021,Verizon,Verizon May 2021,D105,HJ,671.37,,54619.22
6450,5/7/2021,5/7/2021,Verizon,Verizon May 2021,D105,HJ,49.58,,54668.8
6450,5/14/2021,5/14/2021,Monivett Acevedo,Imported from Bank of America Visa,D107,HJ,8,,54676.8
6450,5/14/2021,5/14/2021,Tiffani Bibb,Imported from Bank of America Visa,D104,HJ,26.07,,54702.87
6450,5/17/2021,5/17/2021,T-Mobile,T-Mobile May Bill,D105,HJ,95.47,,54798.34
6450,5/17/2021,5/17/2021,T-Mobile,T-Mobile May Bill,D105,HJ,308.88,,55107.22
6450,5/17/2021,5/17/2021,T-Mobile,T-Mobile May Bill,D105,HJ,95.47,,55202.69
6450,5/17/2021,5/17/2021,T-Mobile,T-Mobile May Bill,D105,HJ,61.78,,55264.47
6450,6/1/2021,6/1/2021,1,To reclassify Expenses bet departments,D104,HJ,,26.07,55238.4
6450,6/7/2021,6/7/2021,Comcast,June Comcast Bill,D107,HJ,139.55,,55377.95
6450,6/9/2021,6/9/2021,Verizon,Verizon Bill June 2021,D105,HJ,76.64,,55454.59
6450,6/9/2021,6/9/2021,Verizon,Verizon Bill June 2021,D105,HJ,1106.82,,56561.41
6450,6/9/2021,6/9/2021,Verizon,Verizon Bill June 2021,D105,HJ,247.94,,56809.35
6450,6/9/2021,6/9/2021,Verizon,Verizon Bill June 2021,D105,HJ,3580.89,,60390.24
6450,6/9/2021,6/9/2021,Verizon,Verizon Bill June 2021,D105,HJ,76.64,,60466.88
6450,6/9/2021,6/9/2021,Verizon,Verizon Bill June 2021,D105,HJ,1106.82,,61573.7
6450,6/9/2021,6/9/2021,Verizon,Verizon Bill June 2021,D105,HJ,49.58,,61623.28
6450,6/9/2021,6/9/2021,Verizon,Verizon Bill June 2021,D105,HJ,716.17,,62339.45
6450,6/17/2021,6/17/2021,T-Mobile,T-Mobile June Payment,D105,HJ,95.47,,62434.92
6450,6/17/2021,6/17/2021,T-Mobile,T-Mobile June Payment,D105,HJ,308.88,,62743.8
6450,6/17/2021,6/17/2021,T-Mobile,T-Mobile June Payment,D105,HJ,95.47,,62839.27
6450,6/17/2021,6/17/2021,T-Mobile,T-Mobile June Payment,D105,HJ,61.78,,62901.05
6450,6/28/2021,6/28/2021,Monivett Acevedo,Imported from Bank of America Visa,D107,HJ,15,,62916.05
6450, Totals for 6450 - Phone and Internet expenses,,,,,,65769.15,2853.1,62916.05
6500,6500 - Classroom Supplies (Balance forward As of 07/01/2020) ,,,,,,,,0
6500,8/24/2020,8/24/2020,Myesha Hossain,Imported from Bank of America Visa-Tech Cleaner,D108,HJ,237.8,,237.8
6500,8/25/2020,8/25/2020,Myesha Hossain,Imported from Bank of America Visa-A. Philip Randolph Supplies,D108,HJ,25.49,,263.29
6500,8/25/2020,8/25/2020,Myesha Hossain,Imported from Bank of America Visa-A. Philip Randolph Supplies,D108,HJ,25.49,,288.78
6500,8/25/2020,8/25/2020,Myesha Hossain,Imported from Bank of America Visa-A. Philip Randolph Supplies,D108,HJ,107.63,,396.41
6500,8/25/2020,8/25/2020,Myesha Hossain,Imported from Bank of America Visa-Cleveland Supplies,D108,HJ,47.95,,444.36
6500,8/25/2020,8/25/2020,Myesha Hossain,Imported from Bank of America Visa-HSFI supplies,D108,HJ,47.95,,492.31
6500,8/25/2020,8/25/2020,Myesha Hossain,Imported from Bank of America Visa-HSFI supplies,D108,HJ,47.95,,540.26
6500,8/25/2020,8/25/2020,Myesha Hossain,Imported from Bank of America Visa-HSHPHS Supplies,D108,HJ,50.98,,591.24
6500,8/25/2020,8/25/2020,Myesha Hossain,Imported from Bank of America Visa-HSHPHS Supplies,D108,HJ,215.26,,806.5
6500,8/25/2020,8/25/2020,Myesha Hossain,Imported from Bank of America Visa-PPE & Cleaning supplies,D108,HJ,95.9,,902.4
6500,8/25/2020,8/25/2020,Myesha Hossain,Imported from Bank of America Visa-PPE & Cleaning supplies,D108,HJ,107.63,,1010.03
6500,8/26/2020,8/26/2020,Myesha Hossain,Imported from Bank of America Visa-A. Philip Randolph Supplies,D108,HJ,32.99,,1043.02
6500,8/26/2020,8/26/2020,Myesha Hossain,Imported from Bank of America Visa-PPE and Cleaning Supplies,D108,HJ,107.63,,1150.65
6500,8/27/2020,8/27/2020,Myesha Hossain,Imported from Bank of America Visa-DoP PPE,D108,HJ,4.5,,1155.15
6500,8/27/2020,8/27/2020,Myesha Hossain,Imported from Bank of America Visa-PPE Gear for Staff,D108,HJ,4.8,,1159.95
6500,8/27/2020,8/27/2020,Myesha Hossain,Imported from Bank of America Visa-PPE Gear for Staff,D108,HJ,7.8,,1167.75
6500,8/27/2020,8/27/2020,Myesha Hossain,Imported from Bank of America Visa-PPE Gear for Staff,D108,HJ,32.99,,1200.74
6500,8/28/2020,8/28/2020,Myesha Hossain,Imported from Bank of America Visa-PPE Gear for Staff,D108,HJ,8.32,,1209.06
6500,8/28/2020,8/28/2020,Myesha Hossain,Imported from Bank of America Visa-PPE Gear for Staff,D108,HJ,9.99,,1219.05
6500,8/29/2020,8/29/2020,Myesha Hossain,Imported from Bank of America Visa-PPE Gear for Staff,D108,HJ,65.98,,1285.03
6500,9/1/2020,9/1/2020,Myesha Hossain,Imported from Bank of America Visa-PPE,D108,HJ,32.99,,1318.02
6500,9/1/2020,9/1/2020,Myesha Hossain,Imported from Bank of America Visa-PPE Gear for APR,D108,HJ,25.49,,1343.51
6500,9/14/2020,9/14/2020,Myesha Hossain,Imported from Bank of America Visa-Dewey Supplies,D108,HJ,156.57,,1500.08
6500,9/14/2020,9/14/2020,Myesha Hossain,Imported from Bank of America Visa-HSFI supplies,D108,HJ,18,,1518.08
6500,9/14/2020,9/14/2020,Myesha Hossain,Imported from Bank of America Visa-HSFI supplies,D108,HJ,256.77,,1774.85
6500,9/18/2020,9/18/2020,Myesha Hossain,Imported from Bank of America Visa-HSFI supplies,D108,HJ,37.75,,1812.6
6500,9/20/2020,9/20/2020,Myesha Hossain,Imported from Bank of America Visa-PPE Gear for Staff,D108,HJ,6.99,,1819.59
6500,9/20/2020,9/20/2020,Myesha Hossain,Imported from Bank of America Visa-PPE Gear for Staff,D108,HJ,9.99,,1829.58
6500,9/26/2020,9/26/2020,Myesha Hossain,Imported from Bank of America Visa-PPE,D108,HJ,7.49,,1837.07
6500,9/27/2020,9/27/2020,Myesha Hossain,Imported from Bank of America Visa-HSFI ppe,D108,HJ,7.49,,1844.56
6500,9/27/2020,9/27/2020,Myesha Hossain,Imported from Bank of America Visa-PPE Dewey,D108,HJ,7.49,,1852.05
6500,9/28/2020,9/28/2020,Myesha Hossain,Imported from Bank of America Visa-PPE HSHP,D108,HJ,7.49,,1859.54
6500,9/28/2020,9/28/2020,Myesha Hossain,Imported from Bank of America Visa-PPE supplies,D108,HJ,4.36,,1863.9
6500,9/29/2020,9/29/2020,Maryellen Leneghan,Imported from Bank of America Visa-PPE and Cleaning Supplies for BC Sites,D108,HJ,13.27,,1877.17
6500,9/29/2020,9/29/2020,Maryellen Leneghan,Imported from Bank of America Visa-PPE and Cleaning Supplies for BC Sites,D108,HJ,13.27,,1890.44
6500,9/29/2020,9/29/2020,Maryellen Leneghan,Imported from Bank of America Visa-PPE and Cleaning Supplies for BC Sites,D108,HJ,13.27,,1903.71
6500,9/29/2020,9/29/2020,Maryellen Leneghan,Imported from Bank of America Visa-PPE and Cleaning Supplies for BC Sites,D108,HJ,13.27,,1916.98
6500,9/29/2020,9/29/2020,Maryellen Leneghan,Imported from Bank of America Visa-PPE and Cleaning Supplies for BC Sites,D108,HJ,28.31,,1945.29
6500,9/29/2020,9/29/2020,Maryellen Leneghan,Imported from Bank of America Visa-PPE and Cleaning Supplies for BC Sites,D108,HJ,598.71,,2544
6500,9/29/2020,9/29/2020,Maryellen Leneghan,Imported from Bank of America Visa-PPE and Cleaning Supplies for BC Sites,D108,HJ,598.71,,3142.71
6500,9/29/2020,9/29/2020,Maryellen Leneghan,Imported from Bank of America Visa-PPE and Cleaning Supplies for BC Sites,D108,HJ,598.71,,3741.42
6500,9/29/2020,9/29/2020,Maryellen Leneghan,Imported from Bank of America Visa-PPE and Cleaning Supplies for BC Sites,D108,HJ,598.71,,4340.13
6500,9/29/2020,9/29/2020,Maryellen Leneghan,Imported from Bank of America Visa-PPE and Cleaning Supplies for DC Sites,D108,HJ,6.58,,4346.71
6500,9/29/2020,9/29/2020,Maryellen Leneghan,Imported from Bank of America Visa-PPE and Cleaning Supplies for DC Sites,D108,HJ,13.14,,4359.85
6500,9/29/2020,9/29/2020,Maryellen Leneghan,Imported from Bank of America Visa-PPE and Cleaning Supplies for DC Sites,D108,HJ,28.57,,4388.42
6500,9/29/2020,9/29/2020,Maryellen Leneghan,Imported from Bank of America Visa-PPE and Cleaning Supplies for DC Sites,D108,HJ,434.23,,4822.65
6500,9/29/2020,9/29/2020,Maryellen Leneghan,Imported from Bank of America Visa-PPE and Cleaning Supplies for DC Sites,D108,HJ,732.8,,5555.45
6500,9/29/2020,9/29/2020,Myesha Hossain,Imported from Bank of America Visa-Bathroom passes,D108,HJ,4.99,,5560.44
6500,9/29/2020,9/29/2020,Myesha Hossain,Imported from Bank of America Visa-Bathroom passes,D108,HJ,4.99,,5565.43
6500,9/29/2020,9/29/2020,Myesha Hossain,Imported from Bank of America Visa-PPE material,D108,HJ,4.99,,5570.42
6500,10/1/2020,10/1/2020,Maryellen Leneghan,Imported from reimbursements-PPE and Cleaning Supplies for DC Sites,D108,HJ,13.55,,5583.97
6500,10/1/2020,10/1/2020,Myesha Hossain,Imported from reimbursements-Fingerprinting,D108,HJ,135.31,,5719.28
6500,10/1/2020,10/1/2020,Myesha Hossain,Imported from reimbursements-PPE,D108,HJ,4.99,,5724.27
6500,10/4/2020,10/4/2020,Myesha Hossain,Imported from reimbursements-HPHS,D108,HJ,7.99,,5732.26
6500,10/7/2020,10/7/2020,Maryellen Leneghan,Imported from reimbursements-BC supplies for headphone storage due to COVID,D108,HJ,8.66,,5740.92
6500,10/7/2020,10/7/2020,Maryellen Leneghan,Imported from reimbursements-BC supplies for headphone storage due to COVID,D108,HJ,8.66,,5749.58
6500,10/7/2020,10/7/2020,Maryellen Leneghan,Imported from reimbursements-BC supplies for headphone storage due to COVID,D108,HJ,8.66,,5758.24
6500,10/7/2020,10/7/2020,Maryellen Leneghan,Imported from reimbursements-BC supplies for headphone storage due to COVID,D108,HJ,8.66,,5766.9
6500,10/8/2020,10/8/2020,Maryellen Leneghan,Imported from reimbursements-BC BOY site materials,D108,HJ,10.17,,5777.07
6500,10/8/2020,10/8/2020,Maryellen Leneghan,Imported from reimbursements-BC BOY site materials,D108,HJ,10.17,,5787.24
6500,10/8/2020,10/8/2020,Maryellen Leneghan,Imported from reimbursements-BC BOY site materials,D108,HJ,10.17,,5797.41
6500,10/8/2020,10/8/2020,Maryellen Leneghan,Imported from reimbursements-BC BOY site materials,D108,HJ,14.45,,5811.86
6500,10/8/2020,10/8/2020,Maryellen Leneghan,Imported from reimbursements-BC BOY site materials,D108,HJ,14.45,,5826.31
6500,10/8/2020,10/8/2020,Maryellen Leneghan,Imported from reimbursements-BC BOY site materials,D108,HJ,14.45,,5840.76
6500,10/8/2020,10/8/2020,Maryellen Leneghan,Imported from reimbursements-BC BOY site materials,D108,HJ,14.45,,5855.21
6500,10/8/2020,10/8/2020,Maryellen Leneghan,Imported from reimbursements-BC BOY site materials,D108,HJ,29.41,,5884.62
6500,10/8/2020,10/8/2020,Maryellen Leneghan,Imported from reimbursements-BC BOY site materials,D108,HJ,29.41,,5914.03
6500,10/8/2020,10/8/2020,Maryellen Leneghan,Imported from reimbursements-BC BOY site materials,D108,HJ,29.41,,5943.44
6500,10/8/2020,10/8/2020,Maryellen Leneghan,Imported from reimbursements-BC BOY site materials,D108,HJ,39.57,,5983.01
6500,10/8/2020,10/8/2020,Maryellen Leneghan,Imported from reimbursements-BC BOY site materials,D108,HJ,44.38,,6027.39
6500,10/8/2020,10/8/2020,Maryellen Leneghan,Imported from reimbursements-BC BOY site materials,D108,HJ,44.38,,6071.77
6500,10/8/2020,10/8/2020,Maryellen Leneghan,Imported from reimbursements-BC BOY site materials,D108,HJ,75.75,,6147.52
6500,10/8/2020,10/8/2020,Maryellen Leneghan,Imported from reimbursements-BC BOY site materials,D108,HJ,97.52,,6245.04
6500,10/8/2020,10/8/2020,Maryellen Leneghan,Imported from reimbursements-BC BOY site materials,D108,HJ,97.52,,6342.56
6500,10/8/2020,10/8/2020,Maryellen Leneghan,Imported from reimbursements-BC BOY site materials,D108,HJ,97.52,,6440.08
6500,10/8/2020,10/8/2020,Maryellen Leneghan,Imported from reimbursements-BC BOY site materials,D108,HJ,149.95,,6590.03
6500,10/8/2020,10/8/2020,Maryellen Leneghan,Imported from reimbursements-BC BOY site materials,D108,HJ,149.95,,6739.98
6500,10/8/2020,10/8/2020,Maryellen Leneghan,Imported from reimbursements-BC BOY site materials,D108,HJ,149.95,,6889.93
6500,10/8/2020,10/8/2020,Maryellen Leneghan,Imported from reimbursements-BC BOY site materials,D108,HJ,149.95,,7039.88
6500,10/8/2020,10/8/2020,Maryellen Leneghan,Imported from reimbursements-BC BOY site materials,D108,HJ,236.2,,7276.08
6500,10/8/2020,10/8/2020,Maryellen Leneghan,Imported from reimbursements-BC BOY site materials,D108,HJ,834.06,,8110.14
6500,10/8/2020,10/8/2020,Maryellen Leneghan,Imported from reimbursements-BC BOY site materials,D108,HJ,1085.15,,9195.29
6500,10/8/2020,10/8/2020,Maryellen Leneghan,Imported from reimbursements-BC BOY site materials,D108,HJ,1092.59,,10287.88
6500,10/8/2020,10/8/2020,Maryellen Leneghan,Imported from reimbursements-BC BOY site materials,D108,HJ,1121.48,,11409.36
6500,10/8/2020,10/8/2020,Myesha Hossain,Imported from reimbursements-HPHS site set up,D108,HJ,9.22,,11418.58
6500,10/9/2020,10/9/2020,Maryellen Leneghan,Imported from reimbursements-BC BOY site materials,D108,HJ,16.79,,11435.37
6500,10/9/2020,10/9/2020,Maryellen Leneghan,Imported from reimbursements-BC BOY site materials,D108,HJ,22.99,,11458.36
6500,10/9/2020,10/9/2020,Maryellen Leneghan,Imported from reimbursements-BC BOY site materials,D108,HJ,44.38,,11502.74
6500,10/9/2020,10/9/2020,Maryellen Leneghan,Imported from reimbursements-BC BOY site materials,D108,HJ,44.38,,11547.12
6500,10/9/2020,10/9/2020,Maryellen Leneghan,Imported from reimbursements-BC BOY site materials,D108,HJ,91.97,,11639.09
6500,10/9/2020,10/9/2020,Maryellen Leneghan,Imported from reimbursements-BC BOY site materials,D108,HJ,95.98,,11735.07
6500,10/9/2020,10/9/2020,Maryellen Leneghan,Imported from reimbursements-BC BOY site materials,D108,HJ,95.98,,11831.05
6500,10/9/2020,10/9/2020,Maryellen Leneghan,Imported from reimbursements-BC BOY site materials,D108,HJ,106.99,,11938.04
6500,10/10/2020,10/10/2020,Maryellen Leneghan,Imported from reimbursements-BC BOY site materials,D108,HJ,95.98,,12034.02
6500,10/12/2020,10/12/2020,Maryellen Leneghan,Imported from reimbursements-BC BOY site materials,D108,HJ,143.97,,12177.99
6500,10/13/2020,10/13/2020,Maryellen Leneghan,Imported from reimbursements-Tax refund from staples order,D108,HJ,,1.86,12176.13
6500,10/13/2020,10/13/2020,Maryellen Leneghan,Imported from reimbursements-Tax refund from staples order,D108,HJ,,1.99,12174.14
6500,10/13/2020,10/13/2020,Maryellen Leneghan,Imported from reimbursements-Tax refund from staples order,D108,HJ,,15.46,12158.68
6500,10/13/2020,10/13/2020,Myesha Hossain,Imported from reimbursements-PPE for HPHS,D108,HJ,13.59,,12172.27
6500,10/14/2020,10/14/2020,Maryellen Leneghan,Imported from reimbursements-BC BOY site materials,D108,HJ,99.99,,12272.26
6500,10/14/2020,10/14/2020,Maryellen Leneghan,Imported from reimbursements-BC BOY site materials,D108,HJ,99.99,,12372.25
6500,10/14/2020,10/14/2020,Maryellen Leneghan,Imported from reimbursements-BOY supply orders for BC,D108,HJ,99.99,,12472.24
6500,10/14/2020,10/14/2020,Maryellen Leneghan,Imported from reimbursements-Tax refund from staples order,D108,HJ,,40.04,12432.2
6500,10/14/2020,10/14/2020,Maryellen Leneghan,Imported from reimbursements-Tax refund from staples order,D108,HJ,,40.04,12392.16
6500,10/14/2020,10/14/2020,Maryellen Leneghan,Imported from reimbursements-Tax refund from staples order,D108,HJ,,40.04,12352.12
6500,10/14/2020,10/14/2020,Maryellen Leneghan,Imported from reimbursements-Tax refund from staples order,D108,HJ,,40.04,12312.08
6500,10/14/2020,10/14/2020,Maryellen Leneghan,Imported from reimbursements-Tax refund from staples order,D108,HJ,,65.12,12246.96
6500,10/14/2020,10/14/2020,Maryellen Leneghan,Imported from reimbursements-Tax refund from staples order,D108,HJ,,81.55,12165.41
6500,10/14/2020,10/14/2020,Maryellen Leneghan,Imported from reimbursements-Tax refund from staples order,D108,HJ,,82.03,12083.38
6500,10/14/2020,10/14/2020,Maryellen Leneghan,Imported from reimbursements-Tax refund from staples order,D108,HJ,,83.91,11999.47
6500,10/20/2020,10/20/2020,Maryellen Leneghan,Imported from reimbursements-PPE and Cleaning Supplies for BC Sites,D108,HJ,14.5,,12013.97
6500,10/26/2020,10/26/2020,Maryellen Leneghan,Imported from reimbursements-PPE and Cleaning Supplies for BC Sites,D108,HJ,71.96,,12085.93
6500,10/29/2020,10/29/2020,Mahaliah Sejour,Imported from reimbursements-PPE,D108,HJ,254.94,,12340.87
6500,10/29/2020,10/29/2020,Mahaliah Sejour,Imported from reimbursements-PPE,D108,HJ,336.45,,12677.32
6500,11/4/2020,11/4/2020,Myesha Hossain,Imported from Bank of America Visa-Classroom supplies and student incentives,D108,HJ,79.19,,12756.51
6500,11/10/2020,11/10/2020,Nicole Prahin,Imported from Bank of America Visa-Organization planner,D108,HJ,25.06,,12781.57
6500,11/16/2020,11/16/2020,Nicole Prahin,Imported from Bank of America Visa-Google drive storage space,D108,HJ,2.13,,12783.7
6500,11/21/2020,11/21/2020,Elizabeth Peinado,Imported from Bank of America Visa-Math Assessment subscription,D111,HJ,4.39,,12788.09
6500,11/21/2020,11/21/2020,Elizabeth Peinado,Imported from Bank of America Visa-Math Assessment subscription,D111,HJ,6.79,,12794.88
6500,11/21/2020,11/21/2020,Elizabeth Peinado,Imported from Bank of America Visa-Math Assessment subscription,D111,HJ,6.79,,12801.67
6500,11/21/2020,11/21/2020,Elizabeth Peinado,Imported from Bank of America Visa-Math Assessment subscription,D111,HJ,21.98,,12823.65
6500,12/2/2020,12/2/2020,Mahaliah Sejour,Imported from Bank of America Visa-PPE supplies,D108,HJ,299.51,,13123.16
6500,12/2/2020,12/2/2020,Mahaliah Sejour,Imported from Bank of America Visa-PPE supplies,D108,HJ,494.57,,13617.73
6500,12/8/2020,12/8/2020,Myesha Hossain,Imported from Bank of America Visa-Dewey Team Time,D108,HJ,7.67,,13625.4
6500,12/19/2020,12/19/2020,Mahaliah Sejour,Imported from Bank of America Visa-PPE supplies,D108,HJ,241.77,,13867.17
6500,12/23/2020,12/23/2020,Myesha Hossain,Imported from Bank of America Visa-PPE,D108,HJ,79.99,,13947.16
6500,12/24/2020,12/24/2020,Myesha Hossain,Imported from Bank of America Visa-PPE,D108,HJ,29.97,,13977.13
6500,12/24/2020,12/24/2020,Myesha Hossain,Imported from Bank of America Visa-PPE,D108,HJ,59.98,,14037.11
6500,12/24/2020,12/24/2020,Myesha Hossain,Imported from Bank of America Visa-PPE Gear for Staff,D108,HJ,40.44,,14077.55
6500,12/26/2020,12/26/2020,Myesha Hossain,Imported from Bank of America Visa-PPE Gear for Staff,D108,HJ,20.97,,14098.52
6500,12/31/2020,12/31/2020,20201231,Actual vs Budget Reclass as of 12/31/2020-Actual vs Budget Reclass as of 12/31/2020,D107,HJ,23.44,,14121.96
6500,12/31/2020,12/31/2020,20201231,Actual vs Budget Reclass as of 12/31/2020-Actual vs Budget Reclass as of 12/31/2020,D108,HJ,41.76,,14163.72
6500,12/31/2020,12/31/2020,20201231,Actual vs Budget Reclass as of 12/31/2020-Actual vs Budget Reclass as of 12/31/2020,D108,HJ,365.83,,14529.55
6500,12/31/2020,12/31/2020,20201231,Actual vs Budget Reclass as of 12/31/2020-Actual vs Budget Reclass as of 12/31/2020,D111,HJ,144.99,,14674.54
6500,1/1/2021,1/1/2021,Mahaliah Sejour,Imported from Bank of America Visa-PPE supplies,D108,HJ,892.43,,15566.97
6500,1/28/2021,1/28/2021,Mahaliah Sejour,Imported from Bank of America Visa-google drive storage,D108,HJ,1.99,,15568.96
6500,2/9/2021,2/9/2021,Maryellen Leneghan,Imported from Bank of America Visa-Site supplies,D108,HJ,46.98,,15615.94
6500,2/9/2021,2/9/2021,Maryellen Leneghan,Imported from Bank of America Visa-Site supplies,D108,HJ,51.97,,15667.91
6500,2/10/2021,2/10/2021,Mahaliah Sejour,Imported from Bank of America Visa-video editing,D108,HJ,21.24,,15689.15
6500,2/16/2021,2/16/2021,Maryellen Leneghan,Imported from Bank of America Visa-Site supplies,D108,HJ,19.99,,15709.14
6500,3/1/2021,3/1/2021,Maryellen Leneghan,Imported from Bank of America Visa,D108,HJ,8.99,,15718.13
6500,3/10/2021,3/10/2021,Maryellen Leneghan,Imported from Bank of America Visa,D108,HJ,34.99,,15753.12
6500,3/10/2021,3/10/2021,Maryellen Leneghan,Imported from Bank of America Visa,D108,HJ,42.99,,15796.11
6500,3/22/2021,3/22/2021,Mahaliah Sejour,Imported from Bank of America Visa,D108,HJ,139.98,,15936.09
6500,3/24/2021,3/24/2021,Mahaliah Sejour,Imported from Bank of America Visa,D108,HJ,23.89,,15959.98
6500,3/24/2021,3/24/2021,Mahaliah Sejour,Imported from Bank of America Visa,D108,HJ,23.89,,15983.87
6500,3/24/2021,3/24/2021,Mahaliah Sejour,Imported from Bank of America Visa,D108,HJ,23.89,,16007.76
6500,3/24/2021,3/24/2021,Mahaliah Sejour,Imported from Bank of America Visa,D108,HJ,23.89,,16031.65
6500,3/24/2021,3/24/2021,Mahaliah Sejour,Imported from Bank of America Visa,D108,HJ,23.89,,16055.54
6500,3/24/2021,3/24/2021,Mahaliah Sejour,Imported from Bank of America Visa,D108,HJ,23.89,,16079.43
6500,3/24/2021,3/24/2021,Mahaliah Sejour,Imported from Bank of America Visa,D108,HJ,45.95,,16125.38
6500,3/24/2021,3/24/2021,Maryellen Leneghan,Imported from Bank of America Visa,D108,HJ,6.99,,16132.37
6500,4/1/2021,4/1/2021,Mahaliah Sejour,Imported from Bank of America Visa,D108,HJ,13.77,,16146.14
6500,4/1/2021,4/1/2021,Mahaliah Sejour,Imported from Bank of America Visa,D108,HJ,41.88,,16188.02
6500,4/1/2021,4/1/2021,Maryellen Leneghan,Imported from Bank of America Visa,D108,HJ,29.89,,16217.91
6500,4/7/2021,4/7/2021,Mahaliah Sejour,Imported from Bank of America Visa,D108,HJ,12.99,,16230.9
6500,4/7/2021,4/7/2021,Mahaliah Sejour,Imported from Bank of America Visa,D108,HJ,12.99,,16243.89
6500,4/7/2021,4/7/2021,Mahaliah Sejour,Imported from Bank of America Visa,D108,HJ,12.99,,16256.88
6500,4/7/2021,4/7/2021,Mahaliah Sejour,Imported from Bank of America Visa,D108,HJ,574.73,,16831.61
6500,4/7/2021,4/7/2021,Mahaliah Sejour,Imported from Bank of America Visa,D108,HJ,12.99,,16844.6
6500,4/7/2021,4/7/2021,Mahaliah Sejour,Imported from Bank of America Visa,D108,HJ,12.99,,16857.59
6500,4/7/2021,4/7/2021,Mahaliah Sejour,Imported from Bank of America Visa,D108,HJ,133.4,,16990.99
6500,4/7/2021,4/7/2021,Mahaliah Sejour,Imported from Bank of America Visa,D108,HJ,850.17,,17841.16
6500,4/7/2021,4/7/2021,Mahaliah Sejour,Imported from Bank of America Visa,D108,HJ,985.8,,18826.96
6500,4/9/2021,4/9/2021,Mahaliah Sejour,Imported from Bank of America Visa,D108,HJ,,135.63,18691.33
6500,4/9/2021,4/9/2021,Maryellen Leneghan,Imported from Bank of America Visa,D108,HJ,146.21,,18837.54
6500,4/12/2021,4/12/2021,Mahaliah Sejour,Imported from Bank of America Visa,D108,HJ,399.99,,19237.53
6500,4/13/2021,4/13/2021,Mahaliah Sejour,Imported from Bank of America Visa,D108,HJ,5.99,,19243.52
6500,4/13/2021,4/13/2021,Mahaliah Sejour,Imported from Bank of America Visa,D108,HJ,12.97,,19256.49
6500,4/13/2021,4/13/2021,Mahaliah Sejour,Imported from Bank of America Visa,D108,HJ,16.77,,19273.26
6500,4/13/2021,4/13/2021,Mahaliah Sejour,Imported from Bank of America Visa,D108,HJ,27.89,,19301.15
6500,4/13/2021,4/13/2021,Mahaliah Sejour,Imported from Bank of America Visa,D108,HJ,66.97,,19368.12
6500,4/13/2021,4/13/2021,Mahaliah Sejour,Imported from Bank of America Visa,D108,HJ,74.07,,19442.19
6500,4/13/2021,4/13/2021,Mahaliah Sejour,Imported from Bank of America Visa,D108,HJ,80.6,,19522.79
6500,4/13/2021,4/13/2021,Mahaliah Sejour,Imported from Bank of America Visa,D108,HJ,84.97,,19607.76
6500,4/13/2021,4/13/2021,Mahaliah Sejour,Imported from Bank of America Visa,D108,HJ,98.15,,19705.91
6500,4/13/2021,4/13/2021,Mahaliah Sejour,Imported from Bank of America Visa,D108,HJ,145.54,,19851.45
6500,4/13/2021,4/13/2021,Mahaliah Sejour,Imported from Bank of America Visa,D108,HJ,399.99,,20251.44
6500,4/13/2021,4/13/2021,Mahaliah Sejour,Imported from Bank of America Visa,D108,HJ,,850.17,19401.27
6500,4/13/2021,4/13/2021,Mahaliah Sejour,Imported from Bank of America Visa,D108,HJ,,850.17,18551.1
6500,4/15/2021,4/15/2021,Mahaliah Sejour,Imported from Bank of America Visa,D108,HJ,26.85,,18577.95
6500,4/15/2021,4/15/2021,Mahaliah Sejour,Imported from Bank of America Visa,D108,HJ,34.33,,18612.28
6500,4/15/2021,4/15/2021,Mahaliah Sejour,Imported from Bank of America Visa,D108,HJ,272.16,,18884.44
6500,4/16/2021,4/16/2021,Mahaliah Sejour,Imported from Bank of America Visa,D108,HJ,88.95,,18973.39
6500,4/16/2021,4/16/2021,Mahaliah Sejour,Imported from Bank of America Visa,D108,HJ,100.93,,19074.32
6500,4/16/2021,4/16/2021,Mahaliah Sejour,Imported from Bank of America Visa,D108,HJ,132.72,,19207.04
6500,4/16/2021,4/16/2021,Mahaliah Sejour,Imported from Bank of America Visa,D108,HJ,348.09,,19555.13
6500,4/19/2021,4/19/2021,Mahaliah Sejour,Imported from Bank of America Visa,D108,HJ,11.93,,19567.06
6500,4/19/2021,4/19/2021,Mahaliah Sejour,Imported from Bank of America Visa,D108,HJ,43.98,,19611.04
6500,4/19/2021,4/19/2021,Mahaliah Sejour,Imported from Bank of America Visa,D108,HJ,79.95,,19690.99
6500,4/19/2021,4/19/2021,Mahaliah Sejour,Imported from Bank of America Visa,D108,HJ,268,,19958.99
6500,4/21/2021,4/21/2021,Mahaliah Sejour,Imported from Bank of America Visa,D108,HJ,41.9,,20000.89
6500,4/21/2021,4/21/2021,Mahaliah Sejour,Imported from Bank of America Visa,D108,HJ,68.28,,20069.17
6500,4/21/2021,4/21/2021,Mahaliah Sejour,Imported from Bank of America Visa,D108,HJ,88.95,,20158.12
6500,4/21/2021,4/21/2021,Mahaliah Sejour,Imported from Bank of America Visa,D108,HJ,91.82,,20249.94
6500,4/21/2021,4/21/2021,Mahaliah Sejour,Imported from Bank of America Visa,D108,HJ,155.32,,20405.26
6500,4/21/2021,4/21/2021,Mahaliah Sejour,Imported from Bank of America Visa,D108,HJ,215.51,,20620.77
6500,4/23/2021,4/23/2021,Mahaliah Sejour,Imported from Bank of America Visa,D108,HJ,66.95,,20687.72
6500,4/23/2021,4/23/2021,Mahaliah Sejour,Imported from Bank of America Visa,D108,HJ,171.52,,20859.24
6500,4/23/2021,4/23/2021,Mahaliah Sejour,Imported from Bank of America Visa,D108,HJ,11.79,,20871.03
6500,4/23/2021,4/23/2021,Mahaliah Sejour,Imported from Bank of America Visa,D108,HJ,49.63,,20920.66
6500,4/23/2021,4/23/2021,Mahaliah Sejour,Imported from Bank of America Visa,D108,HJ,96.7,,21017.36
6500,4/28/2021,4/28/2021,Mahaliah Sejour,Imported from Bank of America Visa,D108,HJ,1.88,,21019.24
6500,4/28/2021,4/28/2021,Mahaliah Sejour,Imported from Bank of America Visa,D108,HJ,16.18,,21035.42
6500,4/28/2021,4/28/2021,Mahaliah Sejour,Imported from Bank of America Visa,D108,HJ,24.47,,21059.89
6500,4/30/2021,4/30/2021,Mary McNicholas,Imported from reimbursements,D108,HJ,16.49,,21076.38
6500,5/1/2021,5/1/2021,Mahaliah Sejour,Imported from Bank of America Visa,D108,HJ,13.99,,21090.37
6500,5/4/2021,5/4/2021,Mahaliah Sejour,Imported from Bank of America Visa,D108,HJ,6.45,,21096.82
6500,5/4/2021,5/4/2021,Mahaliah Sejour,Imported from Bank of America Visa,D108,HJ,6.45,,21103.27
6500,5/4/2021,5/4/2021,Mahaliah Sejour,Imported from Bank of America Visa,D108,HJ,47.93,,21151.2
6500,5/5/2021,5/5/2021,Anthony Onica,Imported from reimbursements,D108,HJ,39.4,,21190.6
6500,5/5/2021,5/5/2021,Mahaliah Sejour,Imported from Bank of America Visa,D108,HJ,6.05,,21196.65
6500,5/5/2021,5/5/2021,Mahaliah Sejour,Imported from Bank of America Visa,D108,HJ,6.45,,21203.1
6500,5/5/2021,5/5/2021,Mahaliah Sejour,Imported from Bank of America Visa,D108,HJ,6.45,,21209.55
6500,5/5/2021,5/5/2021,Mahaliah Sejour,Imported from Bank of America Visa,D108,HJ,6.45,,21216
6500,5/6/2021,5/6/2021,Melissa McElwee,Imported from reimbursements,D108,HJ,36.96,,21252.96
6500,5/7/2021,5/7/2021,Mahaliah Sejour,Imported from Bank of America Visa,D108,HJ,25.64,,21278.6
6500,5/7/2021,5/7/2021,Mahaliah Sejour,Imported from Bank of America Visa,D108,HJ,70.56,,21349.16
6500,5/7/2021,5/7/2021,Mahaliah Sejour,Imported from Bank of America Visa,D108,HJ,76.56,,21425.72
6500,5/7/2021,5/7/2021,Maryellen Leneghan,Imported from Bank of America Visa,D108,HJ,10.99,,21436.71
6500,5/17/2021,5/17/2021,Mahaliah Sejour,Imported from Bank of America Visa,D108,HJ,10.77,,21447.48
6500,5/20/2021,5/20/2021,Mahaliah Sejour,Imported from Bank of America Visa,D108,HJ,24.11,,21471.59
6500,5/21/2021,5/21/2021,Mahaliah Sejour,Imported from Bank of America Visa,D108,HJ,130.9,,21602.49
6500,5/24/2021,5/24/2021,Mahaliah Sejour,Imported from Bank of America Visa,D108,HJ,39.98,,21642.47
6500,5/25/2021,5/25/2021,Mahaliah Sejour,Imported from Bank of America Visa,D108,HJ,22.99,,21665.46
6500,5/25/2021,5/25/2021,Nicole Prahin,Imported from Bank of America Visa,D108,HJ,4.25,,21669.71
6500,5/25/2021,5/25/2021,Nicole Prahin,Imported from Bank of America Visa,D108,HJ,4.25,,21673.96
6500,5/25/2021,5/25/2021,Nicole Prahin,Imported from Bank of America Visa,D108,HJ,4.29,,21678.25
6500,5/25/2021,5/25/2021,Nicole Prahin,Imported from Bank of America Visa,D108,HJ,10.99,,21689.24
6500,5/25/2021,5/25/2021,Nicole Prahin,Imported from Bank of America Visa,D108,HJ,11.87,,21701.11
6500,5/25/2021,5/25/2021,Nicole Prahin,Imported from Bank of America Visa,D108,HJ,15.86,,21716.97
6500,5/25/2021,5/25/2021,Nicole Prahin,Imported from Bank of America Visa,D108,HJ,16.31,,21733.28
6500,5/25/2021,5/25/2021,Nicole Prahin,Imported from Bank of America Visa,D108,HJ,16.46,,21749.74
6500,5/25/2021,5/25/2021,Nicole Prahin,Imported from Bank of America Visa,D108,HJ,16.5,,21766.24
6500,5/25/2021,5/25/2021,Nicole Prahin,Imported from Bank of America Visa,D108,HJ,16.5,,21782.74
6500,5/26/2021,5/26/2021,Mahaliah Sejour,Imported from Bank of America Visa,D108,HJ,71.7,,21854.44
6500,5/26/2021,5/26/2021,Maryellen Leneghan,Imported from Bank of America Visa,D108,HJ,28.39,,21882.83
6500,5/26/2021,5/26/2021,Nicole Prahin,Imported from Bank of America Visa,D108,HJ,11.76,,21894.59
6500,5/26/2021,5/26/2021,Nicole Prahin,Imported from Bank of America Visa,D108,HJ,16.29,,21910.88
6500,6/11/2021,6/11/2021,Mahaliah Sejour,Imported from Bank of America Visa,D108,HJ,12.99,,21923.87
6500,6/11/2021,6/11/2021,Mahaliah Sejour,Imported from Bank of America Visa,D108,HJ,216.86,,22140.73
6500,6/11/2021,6/11/2021,Mahaliah Sejour,Imported from Bank of America Visa,D108,HJ,427.83,,22568.56
6500,6/23/2021,6/23/2021,Mahaliah Sejour,Imported from Bank of America Visa,D108,HJ,6.81,,22575.37
6500,6/28/2021,6/28/2021,Myesha Hossain,Imported from Bank of America Visa,D108,HJ,9.99,,22585.36
6500, Totals for 6500 - Classroom Supplies,,,,,,24913.41,2328.05,22585.36
6510,6510 - Office Supplies (Balance forward As of 07/01/2020) ,,,,,,,,0
6510,7/1/2020,7/1/2020,Halley Bowman,Imported from Bank of America Visa-white board markers,D101,HJ,1.39,,1.39
6510,7/1/2020,7/1/2020,Halley Bowman,Imported from Bank of America Visa-white board markers,D101,HJ,2.14,,3.53
6510,7/1/2020,7/1/2020,Halley Bowman,Imported from Bank of America Visa-white board markers,D101,HJ,2.14,,5.67
6510,7/1/2020,7/1/2020,Halley Bowman,Imported from Bank of America Visa-white board markers,D101,HJ,6.93,,12.6
6510,7/1/2020,7/1/2020,Joseph Zarate,Imported from Bank of America Visa-Equipment for new hire,D105,HJ,502.43,,515.03
6510,7/1/2020,7/1/2020,Joseph Zarate,Imported from Bank of America Visa-New hire equipment,D105,HJ,491.66,,1006.69
6510,7/1/2020,7/1/2020,Joseph Zarate,Imported from Bank of America Visa-Refund,D105,HJ,,39.88,966.81
6510,7/1/2020,7/1/2020,Monivett Acevedo,Imported from Bank of America Visa-Laptop table for standing desk,D103,HJ,73.59,,1040.4
6510,7/1/2020,7/1/2020,Monivett Acevedo,Imported from Bank of America Visa-Printer,D103,HJ,227.89,,1268.29
6510,7/2/2020,7/2/2020,Cathryn Cook,Imported from Bank of America Visa-Mouse for staff member with carpal tunnel,D105,HJ,4.51,,1272.8
6510,7/2/2020,7/2/2020,Cathryn Cook,Imported from Bank of America Visa-Mouse for staff member with carpal tunnel,D105,HJ,6.96,,1279.76
6510,7/2/2020,7/2/2020,Cathryn Cook,Imported from Bank of America Visa-Mouse for staff member with carpal tunnel,D105,HJ,6.96,,1286.72
6510,7/2/2020,7/2/2020,Cathryn Cook,Imported from Bank of America Visa-Mouse for staff member with carpal tunnel,D105,HJ,22.53,,1309.25
6510,7/2/2020,7/2/2020,Halley Bowman,Imported from Bank of America Visa-white board for office PD book,D101,HJ,8.37,,1317.62
6510,7/2/2020,7/2/2020,Halley Bowman,Imported from Bank of America Visa-white board for office PD book,D101,HJ,12.93,,1330.55
6510,7/2/2020,7/2/2020,Halley Bowman,Imported from Bank of America Visa-white board for office PD book,D101,HJ,12.93,,1343.48
6510,7/2/2020,7/2/2020,Halley Bowman,Imported from Bank of America Visa-white board for office PD book,D101,HJ,41.84,,1385.32
6510,7/6/2020,7/6/2020,Joseph Zarate,Imported from Bank of America Visa-Equipment,D105,HJ,10.79,,1396.11
6510,7/7/2020,7/7/2020,Joseph Zarate,Imported from Bank of America Visa-Equipment,D105,HJ,7.48,,1403.59
6510,7/7/2020,7/7/2020,Joseph Zarate,Imported from Bank of America Visa-cleaning supplies,D105,HJ,19.99,,1423.58
6510,7/8/2020,7/8/2020,Joseph Zarate,Imported from Bank of America Visa-Equipment,D105,HJ,12.59,,1436.17
6510,7/8/2020,7/8/2020,Joseph Zarate,Imported from Bank of America Visa-cleaning supplies,D105,HJ,29.96,,1466.13
6510,7/8/2020,7/8/2020,Mahaliah Sejour,Imported from Bank of America Visa-printer,D108,HJ,5.35,,1471.48
6510,7/8/2020,7/8/2020,Monivett Acevedo,Imported from Bank of America Visa-Office Monthly printer ink,D103,HJ,10.61,,1482.09
6510,7/8/2020,7/8/2020,Nicole Prahin,Imported from Bank of America Visa-Printing,D108,HJ,5.35,,1487.44
6510,7/11/2020,7/11/2020,Joseph Zarate,Imported from Bank of America Visa-New hire equipment,D105,HJ,9.12,,1496.56
6510,7/13/2020,7/13/2020,Halley Bowman,Imported from Bank of America Visa-wifi booster for Kami,D101,HJ,3.3,,1499.86
6510,7/13/2020,7/13/2020,Halley Bowman,Imported from Bank of America Visa-wifi booster for Kami,D101,HJ,5.1,,1504.96
6510,7/13/2020,7/13/2020,Halley Bowman,Imported from Bank of America Visa-wifi booster for Kami,D101,HJ,5.1,,1510.06
6510,7/13/2020,7/13/2020,Halley Bowman,Imported from Bank of America Visa-wifi booster for Kami,D101,HJ,16.49,,1526.55
6510,7/16/2020,7/16/2020,Mahaliah Sejour,Imported from Bank of America Visa-MS printer,D108,HJ,5.35,,1531.9
6510,7/17/2020,7/17/2020,Lativa Holder,Imported from Bank of America Visa-Storage Unit,D108,HJ,105.5,,1637.4
6510,7/17/2020,7/17/2020,Monivett Acevedo,Imported from Bank of America Visa-Office Monthly printer ink,D103,HJ,5.3,,1642.7
6510,7/17/2020,7/17/2020,Myesha Hossain,Imported from Bank of America Visa-Office Supplies,D108,HJ,6.99,,1649.69
6510,7/17/2020,7/17/2020,Myesha Hossain,Imported from Bank of America Visa-Office Supplies,D108,HJ,94.95,,1744.64
6510,7/19/2020,7/19/2020,Alan Safran,Imported from Bank of America Visa-HP instant Ink for office.,D102,HJ,10.61,,1755.25
6510,7/20/2020,7/20/2020,Mahaliah Sejour,Imported from Bank of America Visa-harlan printer,D108,HJ,5.35,,1760.6
6510,7/22/2020,7/22/2020,Myesha Hossain,Imported from Bank of America Visa-Office Supplies,D108,HJ,232.94,,1993.54
6510,7/22/2020,7/22/2020,Myesha Hossain,Imported from Bank of America Visa-PPE gear,D108,HJ,42.25,,2035.79
6510,7/22/2020,7/22/2020,Myesha Hossain,Imported from Bank of America Visa-PPE gear,D108,HJ,177.31,,2213.1
6510,7/23/2020,7/23/2020,Monivett Acevedo,Imported from Bank of America Visa-Office Monthly printer ink,D103,HJ,3.18,,2216.28
6510,7/25/2020,7/25/2020,Joseph Zarate,Imported from Bank of America Visa-New hire equipment,D105,HJ,13.99,,2230.27
6510,7/26/2020,7/26/2020,Joseph Zarate,Imported from Bank of America Visa-labels,D105,HJ,114.32,,2344.59
6510,7/27/2020,7/27/2020,Maryellen Leneghan,Imported from Bank of America Visa-Supplies for BC DoP,D108,HJ,7.74,,2352.33
6510,7/28/2020,7/28/2020,Monivett Acevedo,Imported from Bank of America Visa-Office Monthly printer ink,D103,HJ,10.61,,2362.94
6510,7/29/2020,7/29/2020,Elecia D Lacey,Imported from Bank of America Visa-Office Supplies - Printer Ink,D104,HJ,14.33,,2377.27
6510,7/30/2020,7/30/2020,Mahaliah Sejour,Imported from Bank of America Visa-MS mouse planner,D108,HJ,29.19,,2406.46
6510,8/1/2020,8/1/2020,Antonio Gutierrez,Imported from Bank of America Visa-Office Supplies,D107,HJ,74.36,,2480.82
6510,8/3/2020,8/3/2020,Antonio Gutierrez,Imported from Bank of America Visa-Office Supplies,D107,HJ,21.99,,2502.81
6510,8/3/2020,8/3/2020,Monivett Acevedo,Imported from Bank of America Visa-keyboard,D103,HJ,39.58,,2542.39
6510,8/3/2020,8/3/2020,Nicole Prahin,Imported from Bank of America Visa-Monitor for home work space,D108,HJ,139.98,,2682.37
6510,8/7/2020,8/7/2020,Monivett Acevedo,Imported from Bank of America Visa-office headsey,D103,HJ,26.74,,2709.11
6510,8/8/2020,8/8/2020,Mahaliah Sejour,Imported from Bank of America Visa-harlan printer,D108,HJ,5.35,,2714.46
6510,8/8/2020,8/8/2020,Monivett Acevedo,Imported from Bank of America Visa-Office Supplies,D103,HJ,10.61,,2725.07
6510,8/9/2020,8/9/2020,Chris D PLACEHOLDER,Imported from Bank of America Visa-Printer paper for home printer,D107,HJ,22.25,,2747.32
6510,8/11/2020,8/11/2020,Nicole Prahin,Imported from Bank of America Visa-Ink for at home work use,D108,HJ,5.35,,2752.67
6510,8/13/2020,8/13/2020,Joseph Zarate,Imported from Bank of America Visa-office supplies,D105,HJ,4.4,,2757.07
6510,8/13/2020,8/13/2020,Monivett Acevedo,Imported from Bank of America Visa-Mouse pad,D103,HJ,8.33,,2765.4
6510,8/13/2020,8/13/2020,Monivett Acevedo,Imported from Bank of America Visa-Ports for mouse and headset,D103,HJ,7.89,,2773.29
6510,8/16/2020,8/16/2020,Mahaliah Sejour,Imported from Bank of America Visa-MS printer,D108,HJ,5.35,,2778.64
6510,8/16/2020,8/16/2020,Monivett Acevedo,Imported from Bank of America Visa-Office Supplies,D103,HJ,5.3,,2783.94
6510,8/17/2020,8/17/2020,Joseph Zarate,Imported from Bank of America Visa-New hire equipment,D105,HJ,2.16,,2786.1
6510,8/17/2020,8/17/2020,Lativa Holder,Imported from Bank of America Visa-Storage Unit,D108,HJ,105.5,,2891.6
6510,8/18/2020,8/18/2020,Alan Safran,Imported from Bank of America Visa-HP Instant INK for Alan,D102,HJ,10.61,,2902.21
6510,8/18/2020,8/18/2020,Amena Wallace,Imported from Bank of America Visa-Office Supplies,D104,HJ,7.99,,2910.2
6510,8/19/2020,8/19/2020,Joseph Zarate,Imported from Bank of America Visa-shipping,D105,HJ,0.48,,2910.68
6510,8/20/2020,8/20/2020,Monivett Acevedo,Imported from Bank of America Visa-Mechanical Pencil,D103,HJ,9.9,,2920.58
6510,8/21/2020,8/21/2020,Mahaliah Sejour,Imported from Bank of America Visa-MS wireless mouse,D108,HJ,12.12,,2932.7
6510,8/21/2020,8/21/2020,Monivett Acevedo,Imported from reimbursements-home office chair,D107,HJ,74.88,,3007.58
6510,8/21/2020,8/21/2020,Monivett Acevedo,Imported from reimbursements-home office desk,D107,HJ,124.99,,3132.57
6510,8/21/2020,8/21/2020,Monivett Acevedo,Imported from Bank of America Visa-Daily planner,D103,HJ,26.7,,3159.27
6510,8/23/2020,8/23/2020,Monivett Acevedo,Imported from Bank of America Visa-Office Supplies,D103,HJ,3.18,,3162.45
6510,8/24/2020,8/24/2020,Mahaliah Sejour,Imported from Bank of America Visa-MS mouse,D108,HJ,12.99,,3175.44
6510,8/25/2020,8/25/2020,Denise Parham-Gantt,Imported from Bank of America Visa-office chair,D101,HJ,84.99,,3260.43
6510,8/26/2020,8/26/2020,Kyra Detone,Imported from Bank of America Visa-Laptop Stand. Grant Team Supplies Remote Work,D102,HJ,49.63,,3310.06
6510,8/28/2020,8/28/2020,Monivett Acevedo,Imported from Bank of America Visa-Office Ink,D103,HJ,10.61,,3320.67
6510,8/29/2020,8/29/2020,Tiffany Jordan,Imported from Bank of America Visa-Internet booster,D108,HJ,35.05,,3355.72
6510,8/30/2020,8/30/2020,Kyra Detone,Imported from Bank of America Visa-Wristpad & Mouse Pad. Grants Team Remote Work,D102,HJ,13.09,,3368.81
6510,9/2/2020,9/2/2020,Mahaliah Sejour,Imported from Bank of America Visa-MS mouse pad,D108,HJ,9.48,,3378.29
6510,9/3/2020,9/3/2020,Mahaliah Sejour,Imported from Bank of America Visa-harlan printer,D108,HJ,5.35,,3383.64
6510,9/3/2020,9/3/2020,Monivett Acevedo,Imported from Bank of America Visa-Ink for Office Printer,D103,HJ,10.61,,3394.25
6510,9/4/2020,9/4/2020,Angela Mason,Imported from Bank of America Visa-Pens calendar and planner,D111,HJ,42.1,,3436.35
6510,9/9/2020,9/9/2020,Denise Parham-Gantt,Imported from Bank of America Visa-collecting SAT devices for general use,D112,HJ,50,,3486.35
6510,9/9/2020,9/9/2020,Kyra Detone,Imported from Bank of America Visa-Wrist Rest. Mouse Pad. Supplies for Remote Work. Grants Team,D102,HJ,21.84,,3508.19
6510,9/9/2020,9/9/2020,Monivett Acevedo,Imported from Bank of America Visa-Home office supplies,D103,HJ,45.99,,3554.18
6510,9/10/2020,9/10/2020,Nicole Prahin,Imported from Bank of America Visa-Ink for at home work use,D108,HJ,5.35,,3559.53
6510,9/11/2020,9/11/2020,Antonio Gutierrez,Imported from Bank of America Visa-Office Supplies,D107,HJ,46.24,,3605.77
6510,9/11/2020,9/11/2020,Antonio Gutierrez,Imported from Bank of America Visa-supplies for distributing face masks to sites,D107,HJ,15.71,,3621.48
6510,9/15/2020,9/15/2020,Mahaliah Sejour,Imported from Bank of America Visa-MS printer,D108,HJ,5.35,,3626.83
6510,9/15/2020,9/15/2020,Monivett Acevedo,Imported from Bank of America Visa-Office Supplies,D103,HJ,25.67,,3652.5
6510,9/18/2020,9/18/2020,Alan Safran,Imported from Bank of America Visa-Monthly HP instant ink for office,D107,HJ,10.61,,3663.11
6510,9/23/2020,9/23/2020,Denise Parham-Gantt,Imported from Bank of America Visa-collecting SAT devices for general use,D105,HJ,100,,3763.11
6510,9/23/2020,9/23/2020,Denise Parham-Gantt,Imported from Bank of America Visa-collecting SAT devices for general use,D112,HJ,300,,4063.11
6510,9/23/2020,9/23/2020,Mahaliah Sejour,Imported from Bank of America Visa-Cart to tranfer care packages for SDs,D108,HJ,69.29,,4132.4
6510,9/23/2020,9/23/2020,Monivett Acevedo,Imported from Bank of America Visa-Office Supplies,D103,HJ,3.18,,4135.58
6510,9/23/2020,9/23/2020,Tiffani Bibb,Imported from Bank of America Visa-paper Shredder for Home office,D104,HJ,43.86,,4179.44
6510,9/28/2020,9/28/2020,Joseph Zarate,Imported from Bank of America Visa-Tape for shipement,D105,HJ,3.99,,4183.43
6510,9/28/2020,9/28/2020,Myesha Hossain,Imported from Bank of America Visa-Delivery materials,D108,HJ,16.07,,4199.5
6510,10/2/2020,10/2/2020,Monivett Acevedo,Imported from reimbursements-Office Supplies,D109,HJ,15.24,,4214.74
6510,10/2/2020,10/2/2020,Monivett Acevedo,Imported from reimbursements-Office Supplies,D109,HJ,58.99,,4273.73
6510,10/3/2020,10/3/2020,Tiffani Bibb,Imported from reimbursements-Printer Ink,D104,HJ,43.86,,4317.59
6510,10/7/2020,10/7/2020,Mahaliah Sejour,Imported from reimbursements-home office chair,D108,HJ,157.77,,4475.36
6510,10/7/2020,10/7/2020,Monivett Acevedo,Imported from reimbursements-Office Supplies,D109,HJ,139.3,,4614.66
6510,10/8/2020,10/8/2020,Monivett Acevedo,Imported from reimbursements-Office Supplies,D109,HJ,139.3,,4753.96
6510,10/13/2020,10/13/2020,Nicole Prahin,Imported from reimbursements-Printing,D108,HJ,5.35,,4759.31
6510,10/15/2020,10/15/2020,Antonio Gutierrez,Imported from reimbursements-Shipping Supplies,D107,HJ,14.29,,4773.6
6510,10/16/2020,10/16/2020,Mahaliah Sejour,Imported from reimbursements-MS printer,D108,HJ,5.35,,4778.95
6510,10/16/2020,10/16/2020,Monivett Acevedo,Imported from reimbursements-Office Supplies,D109,HJ,19.98,,4798.93
6510,10/16/2020,10/16/2020,Monivett Acevedo,Imported from reimbursements-Office Supplies,D109,HJ,268.98,,5067.91
6510,10/17/2020,10/17/2020,Monivett Acevedo,Imported from reimbursements-Office Supplies,D103,HJ,13.97,,5081.88
6510,10/17/2020,10/17/2020,Tiffani Bibb,Imported from reimbursements-Printer J Messing,D104,HJ,250,,5331.88
6510,10/17/2020,10/17/2020,Tiffani Bibb,Imported from reimbursements-Printer for home office-Replacement A Mason,D104,HJ,265.63,,5597.51
6510,10/17/2020,10/17/2020,Tiffani Bibb,Imported from reimbursements-Shredder for J Messing Home Office,D104,HJ,46.87,,5644.38
6510,10/18/2020,10/18/2020,Monivett Acevedo,Imported from reimbursements-Office Supplies,D103,HJ,10.35,,5654.73
6510,10/19/2020,10/19/2020,Alan Safran,Imported from reimbursements-Monthly HP instant Inks for office,D102,HJ,10.61,,5665.34
6510,10/20/2020,10/20/2020,Elizabeth Peinado,Imported from reimbursements-Ink for X Co.  printer,D111,HJ,12.66,,5678
6510,10/20/2020,10/20/2020,Elizabeth Peinado,Imported from reimbursements-Ink for X Co.  printer,D111,HJ,19.56,,5697.56
6510,10/20/2020,10/20/2020,Elizabeth Peinado,Imported from reimbursements-Ink for X Co.  printer,D111,HJ,19.56,,5717.12
6510,10/20/2020,10/20/2020,Elizabeth Peinado,Imported from reimbursements-Ink for X Co.  printer,D111,HJ,63.28,,5780.4
6510,10/21/2020,10/21/2020,Alan Safran,Imported from reimbursements-Book for Alan,D107,HJ,19.22,,5799.62
6510,10/21/2020,10/21/2020,Tiffani Bibb,Imported from reimbursements-Office Supplies,D104,HJ,,114.34,5685.28
6510,10/22/2020,10/22/2020,Elizabeth Peinado,Imported from reimbursements-Refund of taxes on ink purchase,D111,HJ,,0.74,5684.54
6510,10/22/2020,10/22/2020,Elizabeth Peinado,Imported from reimbursements-Refund of taxes on ink purchase,D111,HJ,,1.15,5683.39
6510,10/22/2020,10/22/2020,Elizabeth Peinado,Imported from reimbursements-Refund of taxes on ink purchase,D111,HJ,,1.15,5682.24
6510,10/22/2020,10/22/2020,Elizabeth Peinado,Imported from reimbursements-Refund of taxes on ink purchase,D111,HJ,,3.73,5678.51
6510,10/22/2020,10/22/2020,Monivett Acevedo,Imported from reimbursements-Office Supplies,D109,HJ,363.8,,6042.31
6510,10/22/2020,10/22/2020,Monivett Acevedo,Imported from reimbursements-Office Supplies,D109,HJ,367.06,,6409.37
6510,10/23/2020,10/23/2020,Monivett Acevedo,Imported from reimbursements-Office Supplies,D103,HJ,3.18,,6412.55
6510,10/23/2020,10/23/2020,Monivett Acevedo,Imported from reimbursements-Office Supplies,D109,HJ,25.13,,6437.68
6510,10/24/2020,10/24/2020,Monivett Acevedo,Imported from reimbursements-Office supplies,D109,HJ,102.96,,6540.64
6510,10/24/2020,10/24/2020,Monivett Acevedo,Imported from reimbursements-Office supplies for home,D109,HJ,178.83,,6719.47
6510,10/25/2020,10/25/2020,Monivett Acevedo,Imported from reimbursements-Office Supplies,D109,HJ,58.7,,6778.17
6510,11/3/2020,11/3/2020,Thomas Fischaber,Imported from Bank of America Visa-office chair,D109,HJ,173.2,,6951.37
6510,11/3/2020,11/3/2020,Thomas Fischaber,Imported from Bank of America Visa-office chair,D109,HJ,499,,7450.37
6510,11/4/2020,11/4/2020,Thomas Fischaber,Imported from Bank of America Visa-Monitor cables and switch,D109,HJ,435.52,,7885.89
6510,11/9/2020,11/9/2020,Monivett Acevedo,Imported from Bank of America Visa-Office Supplies,D107,HJ,3.18,,7889.07
6510,11/12/2020,11/12/2020,Joseph Zarate,Imported from Bank of America Visa-Equipment,D105,HJ,10.5,,7899.57
6510,11/13/2020,11/13/2020,Joseph Zarate,Imported from Bank of America Visa-equipment,D105,HJ,10.48,,7910.05
6510,11/13/2020,11/13/2020,Myesha Hossain,Imported from Bank of America Visa-SD Office Supplies WFH,D108,HJ,12.99,,7923.04
6510,11/18/2020,11/18/2020,Joseph Zarate,Imported from Bank of America Visa-New hire equipment,D105,HJ,8.59,,7931.63
6510,11/18/2020,11/18/2020,Joseph Zarate,Imported from Bank of America Visa-equipment,D105,HJ,104.68,,8036.31
6510,11/18/2020,11/18/2020,Monivett Acevedo,Imported from Bank of America Visa-Monitor stand for Director of F&A,D103,HJ,87.99,,8124.3
6510,11/18/2020,11/18/2020,Monivett Acevedo,Imported from Bank of America Visa-Monitor stands,D107,HJ,87.99,,8212.29
6510,11/19/2020,11/19/2020,Alan Safran,Imported from Bank of America Visa-HP Ink for Alan,D107,HJ,10.61,,8222.9
6510,11/19/2020,11/19/2020,Joseph Zarate,Imported from Bank of America Visa-New hire equipment,D105,HJ,13.8,,8236.7
6510,11/23/2020,11/23/2020,Joseph Zarate,Imported from Bank of America Visa-equipment,D105,HJ,7.64,,8244.34
6510,11/23/2020,11/23/2020,Monivett Acevedo,Imported from Bank of America Visa-Office Supplies,D107,HJ,3.18,,8247.52
6510,12/1/2020,12/1/2020,Thomas Fischaber,Imported from Bank of America Visa-Office Supplies,D109,HJ,82.21,,8329.73
6510,12/1/2020,12/1/2020,Thomas Fischaber,Imported from Bank of America Visa-Office Supplies,D109,HJ,119,,8448.73
6510,12/8/2020,12/8/2020,Antonio Gutierrez,Imported from Bank of America Visa-Headphones,D107,HJ,112.31,,8561.04
6510,12/8/2020,12/8/2020,Monivett Acevedo,Imported from Bank of America Visa-Office Supplies,D107,HJ,3.18,,8564.22
6510,12/10/2020,12/10/2020,Mahaliah Sejour,Imported from Bank of America Visa-Awards trophy,D108,HJ,21.24,,8585.46
6510,12/11/2020,12/11/2020,Monivett Acevedo,Imported from Bank of America Visa-Office,D107,HJ,15.29,,8600.75
6510,12/13/2020,12/13/2020,Monivett Acevedo,Imported from Bank of America Visa-headphones,D107,HJ,159,,8759.75
6510,12/13/2020,12/13/2020,Nicole Prahin,Imported from Bank of America Visa-Printing for at home office,D108,HJ,5.35,,8765.1
6510,12/15/2020,12/15/2020,Elizabeth Peinado,Imported from Bank of America Visa-Card Stock paper for welcome package notes,D111,HJ,0.73,,8765.83
6510,12/15/2020,12/15/2020,Elizabeth Peinado,Imported from Bank of America Visa-Card Stock paper for welcome package notes,D111,HJ,1.12,,8766.95
6510,12/15/2020,12/15/2020,Elizabeth Peinado,Imported from Bank of America Visa-Card Stock paper for welcome package notes,D111,HJ,1.12,,8768.07
6510,12/15/2020,12/15/2020,Elizabeth Peinado,Imported from Bank of America Visa-Card Stock paper for welcome package notes,D111,HJ,3.63,,8771.7
6510,12/15/2020,12/15/2020,Mahaliah Sejour,Imported from Bank of America Visa-MS printer,D108,HJ,5.35,,8777.05
6510,12/16/2020,12/16/2020,Nicole Prahin,Imported from Bank of America Visa-Google drive storage space,D108,HJ,2.13,,8779.18
6510,12/17/2020,12/17/2020,Antonio Gutierrez,Imported from Bank of America Visa-Media Subscription,D107,HJ,4,,8783.18
6510,12/19/2020,12/19/2020,Alan Safran,Imported from Bank of America Visa-HP Ink for Alan printer,D107,HJ,5.3,,8788.48
6510,12/19/2020,12/19/2020,Joseph Zarate,Imported from Bank of America Visa-New hire equipment,D105,HJ,103.97,,8892.45
6510,12/23/2020,12/23/2020,Monivett Acevedo,Imported from Bank of America Visa-Office ink,D107,HJ,3.18,,8895.63
6510,12/31/2020,12/31/2020,20201231,Actual vs Budget Reclass as of 12/31/2020-Actual vs Budget Reclass as of 12/31/2020,D101,HJ,,84.99,8810.64
6510,12/31/2020,12/31/2020,20201231,Actual vs Budget Reclass as of 12/31/2020-Actual vs Budget Reclass as of 12/31/2020,D112,HJ,84.99,,8895.63
6510,1/7/2021,1/7/2021,Joseph Zarate,Imported from Bank of America Visa-equipment,D105,HJ,10.38,,8906.01
6510,1/7/2021,1/7/2021,Tiffani Bibb,Imported from Bank of America Visa-Desk for home office,D104,HJ,338.61,,9244.62
6510,1/8/2021,1/8/2021,Joseph Zarate,Imported from Bank of America Visa-equipment,D105,HJ,117.69,,9362.31
6510,1/8/2021,1/8/2021,Monivett Acevedo,Imported from Bank of America Visa-Office Supplies,D107,HJ,3.18,,9365.49
6510,1/12/2021,1/12/2021,Nicole Prahin,Imported from Bank of America Visa-Ink for at home work use,D108,HJ,5.35,,9370.84
6510,1/14/2021,1/14/2021,Joseph Zarate,Imported from Bank of America Visa-Equipment,D105,HJ,187.54,,9558.38
6510,1/16/2021,1/16/2021,Halley Bowman,Imported from Bank of America Visa-Wifi booster for Ashlee,D101,HJ,3.3,,9561.68
6510,1/16/2021,1/16/2021,Halley Bowman,Imported from Bank of America Visa-Wifi booster for Ashlee,D101,HJ,5.1,,9566.78
6510,1/16/2021,1/16/2021,Halley Bowman,Imported from Bank of America Visa-Wifi booster for Ashlee,D101,HJ,5.1,,9571.88
6510,1/16/2021,1/16/2021,Halley Bowman,Imported from Bank of America Visa-Wifi booster for Ashlee,D101,HJ,16.49,,9588.37
6510,1/17/2021,1/17/2021,Nicole Prahin,Imported from Bank of America Visa-Google drive storage space,D108,HJ,2.13,,9590.5
6510,1/18/2021,1/18/2021,Halley Bowman,Imported from Bank of America Visa-batteries for Emily,D101,HJ,11.65,,9602.15
6510,1/20/2021,1/20/2021,Alan Safran,Imported from Bank of America Visa-Purchase of HP Ink,D107,HJ,5.3,,9607.45
6510,1/20/2021,1/20/2021,Joseph Zarate,Imported from Bank of America Visa-Equipment,D105,HJ,7.99,,9615.44
6510,1/21/2021,1/21/2021,Joseph Zarate,Imported from Bank of America Visa-equipment,D105,HJ,164.28,,9779.72
6510,1/22/2021,1/22/2021,Halley Bowman,Imported from Bank of America Visa-notebook for Halley to take notes,D101,HJ,1.51,,9781.23
6510,1/22/2021,1/22/2021,Halley Bowman,Imported from Bank of America Visa-notebook for Halley to take notes,D101,HJ,2.34,,9783.57
6510,1/22/2021,1/22/2021,Halley Bowman,Imported from Bank of America Visa-notebook for Halley to take notes,D101,HJ,2.34,,9785.91
6510,1/22/2021,1/22/2021,Halley Bowman,Imported from Bank of America Visa-notebook for Halley to take notes,D101,HJ,7.58,,9793.49
6510,1/24/2021,1/24/2021,Halley Bowman,Imported from Bank of America Visa-pens,D101,HJ,1.91,,9795.4
6510,1/24/2021,1/24/2021,Halley Bowman,Imported from Bank of America Visa-pens,D101,HJ,2.95,,9798.35
6510,1/24/2021,1/24/2021,Halley Bowman,Imported from Bank of America Visa-pens,D101,HJ,2.95,,9801.3
6510,1/24/2021,1/24/2021,Halley Bowman,Imported from Bank of America Visa-pens,D101,HJ,9.53,,9810.83
6510,1/26/2021,1/26/2021,Monivett Acevedo,Imported from Bank of America Visa-Post It White Board,D107,HJ,35.79,,9846.62
6510,1/26/2021,1/26/2021,Myesha Hossain,Imported from Bank of America Visa-charge to IT,D105,HJ,13.02,,9859.64
6510,2/1/2021,2/1/2021,Alexander Randolph,Bill.Com Import-purchase of headphones and microphone for work,D111,HJ,37.87,,9897.51
6510,2/1/2021,2/1/2021,Monivett Acevedo,Imported from Bank of America Visa-Computer HDMI connector,D107,HJ,16.99,,9914.5
6510,2/1/2021,2/1/2021,Monivett Acevedo,Imported from Bank of America Visa-Office Supplies,D107,HJ,3.18,,9917.68
6510,2/2/2021,2/2/2021,Joseph Zarate,Imported from Bank of America Visa-Equipment,D105,HJ,37.49,,9955.17
6510,2/4/2021,2/4/2021,Halley Bowman,Imported from Bank of America Visa-Computer Stand for Mika Iwasaki,D101,HJ,2.32,,9957.49
6510,2/4/2021,2/4/2021,Halley Bowman,Imported from Bank of America Visa-Computer Stand for Mika Iwasaki,D101,HJ,3.59,,9961.08
6510,2/4/2021,2/4/2021,Halley Bowman,Imported from Bank of America Visa-Computer Stand for Mika Iwasaki,D101,HJ,3.59,,9964.67
6510,2/4/2021,2/4/2021,Halley Bowman,Imported from Bank of America Visa-Computer Stand for Mika Iwasaki,D101,HJ,11.63,,9976.3
6510,2/4/2021,2/4/2021,Joseph Zarate,Imported from Bank of America Visa-Equipment,D105,HJ,25.9,,10002.2
6510,2/4/2021,2/4/2021,Monivett Acevedo,Imported from reimbursements-Finance Planning,D107,HJ,12.99,,10015.19
6510,2/6/2021,2/6/2021,Monivett Acevedo,Imported from Bank of America Visa-Laptop Sleeve,D107,HJ,16.14,,10031.33
6510,2/7/2021,2/7/2021,Maryellen Leneghan,Imported from Bank of America Visa-Supply for ML home office,D108,HJ,59.11,,10090.44
6510,2/8/2021,2/8/2021,Antonio Gutierrez,Imported from Bank of America Visa-external hard drive,D107,HJ,109.99,,10200.43
6510,2/8/2021,2/8/2021,Monivett Acevedo,Imported from Bank of America Visa-Office Supplies,D107,HJ,3.18,,10203.61
6510,2/10/2021,2/10/2021,Joseph Zarate,Imported from Bank of America Visa-TESTING,D105,HJ,69.88,,10273.49
6510,2/11/2021,2/11/2021,Odalis Polanco,Imported from reimbursements-Home Office desk,D103,HJ,213.99,,10487.48
6510,2/11/2021,2/11/2021,Odalis Polanco,Imported from reimbursements-new laptop charger,D103,HJ,33.95,,10521.43
6510,2/12/2021,2/12/2021,Antonio Gutierrez,Imported from Bank of America Visa-marketing high definition web camera,D107,HJ,219.44,,10740.87
6510,2/12/2021,2/12/2021,Nicole Prahin,Imported from Bank of America Visa-Office Supplies,D108,HJ,5.35,,10746.22
6510,2/16/2021,2/16/2021,Nicole Prahin,Imported from Bank of America Visa-Google drive storage space,D108,HJ,2.17,,10748.39
6510,2/17/2021,2/17/2021,Elizabeth Peinado,Imported from Bank of America Visa-Envelops for mailing new hire packages,D111,HJ,0.81,,10749.2
6510,2/17/2021,2/17/2021,Elizabeth Peinado,Imported from Bank of America Visa-Envelops for mailing new hire packages,D111,HJ,1.26,,10750.46
6510,2/17/2021,2/17/2021,Elizabeth Peinado,Imported from Bank of America Visa-Envelops for mailing new hire packages,D111,HJ,1.26,,10751.72
6510,2/17/2021,2/17/2021,Elizabeth Peinado,Imported from Bank of America Visa-Envelops for mailing new hire packages,D111,HJ,4.06,,10755.78
6510,2/17/2021,2/17/2021,Halley Bowman,Imported from Bank of America Visa-laptop stand,D101,HJ,25.43,,10781.21
6510,2/19/2021,2/19/2021,Alan Safran,Imported from Bank of America Visa-Purchase of HP Ink,D107,HJ,5.3,,10786.51
6510,2/19/2021,2/19/2021,Joseph Zarate,Imported from Bank of America Visa-refund,D105,HJ,,10.55,10775.96
6510,2/20/2021,2/20/2021,Halley Bowman,Imported from Bank of America Visa-desk lamp,D101,HJ,3.03,,10778.99
6510,2/20/2021,2/20/2021,Halley Bowman,Imported from Bank of America Visa-desk lamp,D101,HJ,4.68,,10783.67
6510,2/20/2021,2/20/2021,Halley Bowman,Imported from Bank of America Visa-desk lamp,D101,HJ,4.68,,10788.35
6510,2/20/2021,2/20/2021,Halley Bowman,Imported from Bank of America Visa-desk lamp,D101,HJ,15.16,,10803.51
6510,2/20/2021,2/20/2021,Halley Bowman,Imported from Bank of America Visa-laptop stand,D101,HJ,4.2,,10807.71
6510,2/20/2021,2/20/2021,Halley Bowman,Imported from Bank of America Visa-laptop stand,D101,HJ,6.49,,10814.2
6510,2/20/2021,2/20/2021,Halley Bowman,Imported from Bank of America Visa-laptop stand,D101,HJ,6.49,,10820.69
6510,2/20/2021,2/20/2021,Halley Bowman,Imported from Bank of America Visa-laptop stand,D101,HJ,20.97,,10841.66
6510,2/23/2021,2/23/2021,Mahaliah Sejour,Imported from Bank of America Visa-notebooks,D108,HJ,37.59,,10879.25
6510,2/23/2021,2/23/2021,Monivett Acevedo,Imported from Bank of America Visa-Office Ink Boston,D107,HJ,3.18,,10882.43
6510,2/24/2021,2/24/2021,Thomas Fischaber,Imported from Bank of America Visa-office supply - desk,D109,HJ,216.6,,11099.03
6510,2/25/2021,2/25/2021,Halley Bowman,Imported from Bank of America Visa-laptop stand return,D101,HJ,,25.43,11073.6
6510,3/1/2021,3/1/2021,Mahaliah Sejour,Imported from Bank of America Visa,D108,HJ,1.99,,11075.59
6510,3/1/2021,3/1/2021,Monivett Acevedo,Imported from Bank of America Visa,D107,HJ,134.79,,11210.38
6510,3/1/2021,3/1/2021,Tiffani Bibb,Imported from Bank of America Visa,D104,HJ,28.46,,11238.84
6510,3/2/2021,3/2/2021,Monivett Acevedo,Imported from Bank of America Visa,D107,HJ,17.99,,11256.83
6510,3/3/2021,3/3/2021,Joseph Zarate,Imported from Bank of America Visa,D105,HJ,28.25,,11285.08
6510,3/3/2021,3/3/2021,Tiffani Bibb,Imported from Bank of America Visa,D104,HJ,29.99,,11315.07
6510,3/10/2021,3/10/2021,Mahaliah Sejour,Imported from Bank of America Visa,D108,HJ,21.24,,11336.31
6510,3/10/2021,3/10/2021,Nicole Prahin,Imported from Bank of America Visa,D108,HJ,5.35,,11341.66
6510,3/16/2021,3/16/2021,Mahaliah Sejour,Imported from Bank of America Visa,D108,HJ,5.35,,11347.01
6510,3/16/2021,3/16/2021,Thomas Fischaber,Imported from Bank of America Visa,D109,HJ,121.05,,11468.06
6510,3/17/2021,3/17/2021,Mahaliah Sejour,Imported from Bank of America Visa,D108,HJ,32.78,,11500.84
6510,3/17/2021,3/17/2021,Nicole Prahin,Imported from Bank of America Visa,D108,HJ,2.17,,11503.01
6510,3/18/2021,3/18/2021,Joseph Zarate,Imported from Bank of America Visa,D105,HJ,34.99,,11538
6510,3/18/2021,3/18/2021,Joseph Zarate,Imported from Bank of America Visa,D105,HJ,119.61,,11657.61
6510,3/18/2021,3/18/2021,Mahaliah Sejour,Imported from Bank of America Visa,D108,HJ,99.89,,11757.5
6510,3/19/2021,3/19/2021,Alan Safran,Imported from Bank of America Visa,D107,HJ,29.74,,11787.24
6510,3/24/2021,3/24/2021,Antonio Gutierrez,Imported from Bank of America Visa,D107,HJ,42.49,,11829.73
6510,3/24/2021,3/24/2021,Joseph Zarate,Imported from Bank of America Visa,D105,HJ,,7.03,11822.7
6510,3/24/2021,3/24/2021,Mahaliah Sejour,Imported from Bank of America Visa,D108,HJ,1.99,,11824.69
6510,3/24/2021,3/24/2021,Maryellen Leneghan,Imported from Bank of America Visa,D108,HJ,19.92,,11844.61
6510,3/24/2021,3/24/2021,Maryellen Leneghan,Imported from Bank of America Visa,D108,HJ,60.15,,11904.76
6510,3/31/2021,3/31/2021,Antonio Gutierrez,Imported from Bank of America Visa,D107,HJ,98.94,,12003.7
6510,4/1/2021,4/1/2021,Denise Parham-Gantt,Imported from Bank of America Visa,D112,HJ,84,,12087.7
6510,4/1/2021,4/1/2021,Joseph Zarate,Imported from Bank of America Visa,D105,HJ,15.48,,12103.18
6510,4/1/2021,4/1/2021,Joseph Zarate,Imported from Bank of America Visa,D105,HJ,307.97,,12411.15
6510,4/1/2021,4/1/2021,Joseph Zarate,Imported from Bank of America Visa,D105,HJ,317.97,,12729.12
6510,4/1/2021,4/1/2021,Tiffani Bibb,Imported from Bank of America Visa,D104,HJ,6.06,,12735.18
6510,4/1/2021,4/1/2021,Tiffani Bibb,Imported from Bank of America Visa,D104,HJ,57.92,,12793.1
6510,4/2/2021,4/2/2021,Thomas Fischaber,Imported from Bank of America Visa,D109,HJ,19.94,,12813.04
6510,4/7/2021,4/7/2021,Denise Parham-Gantt,Imported from Bank of America Visa,D112,HJ,85.49,,12898.53
6510,4/9/2021,4/9/2021,Denise Parham-Gantt,Imported from Bank of America Visa,D112,HJ,186.99,,13085.52
6510,4/12/2021,4/12/2021,Joseph Zarate,Imported from Bank of America Visa,D105,HJ,307.97,,13393.49
6510,4/12/2021,4/12/2021,Nicole Prahin,Imported from Bank of America Visa,D108,HJ,5.35,,13398.84
6510,4/13/2021,4/13/2021,Joseph Zarate,Imported from Bank of America Visa,D105,HJ,199.97,,13598.81
6510,4/13/2021,4/13/2021,Joseph Zarate,Imported from Bank of America Visa,D105,HJ,199.97,,13798.78
6510,4/13/2021,4/13/2021,Joseph Zarate,Imported from Bank of America Visa,D105,HJ,199.97,,13998.75
6510,4/13/2021,4/13/2021,Joseph Zarate,Imported from Bank of America Visa,D105,HJ,199.97,,14198.72
6510,4/13/2021,4/13/2021,Joseph Zarate,Imported from Bank of America Visa,D105,HJ,,119.99,14078.73
6510,4/16/2021,4/16/2021,Alan Safran,Imported from Bank of America Visa,D107,HJ,11.68,,14090.41
6510,4/16/2021,4/16/2021,Denise Parham-Gantt,Imported from Bank of America Visa,D112,HJ,13.99,,14104.4
6510,4/16/2021,4/16/2021,Joseph Zarate,Imported from Bank of America Visa,D105,HJ,199.97,,14304.37
6510,4/16/2021,4/16/2021,Joseph Zarate,Imported from Bank of America Visa,D105,HJ,12.74,,14317.11
6510,4/16/2021,4/16/2021,Joseph Zarate,Imported from Bank of America Visa,D105,HJ,199.97,,14517.08
6510,4/16/2021,4/16/2021,Joseph Zarate,Imported from Bank of America Visa,D105,HJ,199.97,,14717.05
6510,4/16/2021,4/16/2021,Joseph Zarate,Imported from Bank of America Visa,D105,HJ,199.97,,14917.02
6510,4/16/2021,4/16/2021,Joseph Zarate,Imported from Bank of America Visa,D105,HJ,199.97,,15116.99
6510,4/16/2021,4/16/2021,Joseph Zarate,Imported from Bank of America Visa,D105,HJ,199.97,,15316.96
6510,4/16/2021,4/16/2021,Joseph Zarate,Imported from Bank of America Visa,D105,HJ,199.97,,15516.93
6510,4/16/2021,4/16/2021,Joseph Zarate,Imported from Bank of America Visa,D105,HJ,207.96,,15724.89
6510,4/16/2021,4/16/2021,Joseph Zarate,Imported from Bank of America Visa,D105,HJ,30.51,,15755.4
6510,4/16/2021,4/16/2021,Joseph Zarate,Imported from Bank of America Visa,D105,HJ,124.99,,15880.39
6510,4/16/2021,4/16/2021,Joseph Zarate,Imported from Bank of America Visa,D105,HJ,35.99,,15916.38
6510,4/16/2021,4/16/2021,Mahaliah Sejour,Imported from Bank of America Visa,D108,HJ,5.35,,15921.73
6510,4/16/2021,4/16/2021,Nicole Prahin,Imported from Bank of America Visa,D108,HJ,2.17,,15923.9
6510,4/19/2021,4/19/2021,Joseph Zarate,Imported from Bank of America Visa,D105,HJ,319.96,,16243.86
6510,4/23/2021,4/23/2021,Joseph Zarate,Imported from Bank of America Visa,D105,HJ,51.13,,16294.99
6510,4/27/2021,4/27/2021,Joseph Zarate,Imported from Bank of America Visa,D105,HJ,23.74,,16318.73
6510,4/27/2021,4/27/2021,Joseph Zarate,Imported from Bank of America Visa,D105,HJ,29.74,,16348.47
6510,4/27/2021,4/27/2021,Joseph Zarate,Imported from Bank of America Visa,D105,HJ,159.96,,16508.43
6510,4/27/2021,4/27/2021,Joseph Zarate,Imported from Bank of America Visa,D105,HJ,311.52,,16819.95
6510,4/27/2021,4/27/2021,Joseph Zarate,Imported from Bank of America Visa,D105,HJ,311.52,,17131.47
6510,4/27/2021,4/27/2021,Joseph Zarate,Imported from Bank of America Visa,D105,HJ,467.28,,17598.75
6510,4/27/2021,4/27/2021,Joseph Zarate,Imported from Bank of America Visa,D105,HJ,484.73,,18083.48
6510,4/27/2021,4/27/2021,Joseph Zarate,Imported from Bank of America Visa,D105,HJ,501.76,,18585.24
6510,4/27/2021,4/27/2021,Joseph Zarate,Imported from Bank of America Visa,D105,HJ,2076.8,,20662.04
6510,4/27/2021,4/27/2021,Mahaliah Sejour,Imported from Bank of America Visa,D108,HJ,1.99,,20664.03
6510,4/28/2021,4/28/2021,Joseph Zarate,Imported from Bank of America Visa,D105,HJ,32.99,,20697.02
6510,5/1/2021,5/1/2021,Kyra Detone,Imported from Bank of America Visa,D102,HJ,2.17,,20699.19
6510,5/1/2021,5/1/2021,Kyra Detone,Imported from Bank of America Visa,D102,HJ,37.12,,20736.31
6510,5/1/2021,5/1/2021,Monivett Acevedo,Imported from Bank of America Visa,D107,HJ,41.02,,20777.33
6510,5/1/2021,5/1/2021,Monivett Acevedo,Imported from Bank of America Visa,D107,HJ,283.64,,21060.97
6510,5/4/2021,5/4/2021,Joseph Zarate,Imported from Bank of America Visa,D105,HJ,9.97,,21070.94
6510,5/4/2021,5/4/2021,Joseph Zarate,Imported from Bank of America Visa,D105,HJ,43.58,,21114.52
6510,5/5/2021,5/5/2021,Denise Parham-Gantt,Imported from Bank of America Visa,D109,HJ,7.99,,21122.51
6510,5/5/2021,5/5/2021,Joseph Zarate,Imported from Bank of America Visa,D105,HJ,35.51,,21158.02
6510,5/7/2021,5/7/2021,Joseph Zarate,Imported from Bank of America Visa,D105,HJ,129.59,,21287.61
6510,5/7/2021,5/7/2021,Monivett Acevedo,Imported from Bank of America Visa,D107,HJ,43.95,,21331.56
6510,5/11/2021,5/11/2021,Joseph Zarate,Imported from Bank of America Visa,D105,HJ,59.99,,21391.55
6510,5/11/2021,5/11/2021,Monivett Acevedo,Imported from Bank of America Visa,D107,HJ,,43.95,21347.6
6510,5/13/2021,5/13/2021,Joseph Zarate,Imported from Bank of America Visa,D105,HJ,20.19,,21367.79
6510,5/13/2021,5/13/2021,Joseph Zarate,Imported from Bank of America Visa,D105,HJ,20.19,,21387.98
6510,5/13/2021,5/13/2021,Joseph Zarate,Imported from Bank of America Visa,D108,HJ,63.59,,21451.57
6510,5/13/2021,5/13/2021,Nicole Prahin,Imported from Bank of America Visa,D108,HJ,5.35,,21456.92
6510,5/14/2021,5/14/2021,Mahaliah Sejour,Imported from Bank of America Visa,D108,HJ,5.35,,21462.27
6510,5/14/2021,5/14/2021,Mahaliah Sejour,Imported from Bank of America Visa,D108,HJ,8.57,,21470.84
6510,5/14/2021,5/14/2021,Maryellen Leneghan,Imported from Bank of America Visa,D108,HJ,77.12,,21547.96
6510,5/14/2021,5/14/2021,Odalis Polanco,Imported from Bank of America Visa,D103,HJ,10.57,,21558.53
6510,5/17/2021,5/17/2021,Alan Safran,Imported from Bank of America Visa,D107,HJ,6.36,,21564.89
6510,5/17/2021,5/17/2021,Antonio Gutierrez,Imported from Bank of America Visa,D107,HJ,48.84,,21613.73
6510,5/17/2021,5/17/2021,claice Jackson,Imported from Bank of America Visa,D108,HJ,61.47,,21675.2
6510,5/17/2021,5/17/2021,Joseph Zarate,Imported from Bank of America Visa,D105,HJ,106.89,,21782.09
6510,5/17/2021,5/17/2021,Joseph Zarate,Imported from Bank of America Visa,D105,HJ,449,,22231.09
6510,5/17/2021,5/17/2021,Mahaliah Sejour,Imported from Bank of America Visa,D108,HJ,6.42,,22237.51
6510,5/17/2021,5/17/2021,Nicole Prahin,Imported from Bank of America Visa,D108,HJ,2.17,,22239.68
6510,5/18/2021,5/18/2021,Joseph Zarate,Imported from Bank of America Visa,D105,HJ,14.97,,22254.65
6510,5/18/2021,5/18/2021,Joseph Zarate,Imported from Bank of America Visa,D105,HJ,449,,22703.65
6510,5/18/2021,5/18/2021,Mahaliah Sejour,Imported from Bank of America Visa,D108,HJ,5.35,,22709
6510,5/18/2021,5/18/2021,Myesha Hossain,Imported from Bank of America Visa,D108,HJ,18.95,,22727.95
6510,5/18/2021,5/18/2021,Myesha Hossain,Imported from Bank of America Visa,D108,HJ,48.21,,22776.16
6510,5/19/2021,5/19/2021,Joseph Zarate,Imported from Bank of America Visa,D105,HJ,29.98,,22806.14
6510,5/20/2021,5/20/2021,Joseph Zarate,Imported from Bank of America Visa,D108,HJ,32.88,,22839.02
6510,5/20/2021,5/20/2021,Joseph Zarate,Imported from Bank of America Visa,D105,HJ,179.99,,23019.01
6510,5/20/2021,5/20/2021,Josh Hall,Imported from Bank of America Visa,D107,HJ,16.18,,23035.19
6510,5/21/2021,5/21/2021,Joseph Zarate,Imported from Bank of America Visa,D105,HJ,18.99,,23054.18
6510,5/21/2021,5/21/2021,Joseph Zarate,Imported from Bank of America Visa,D105,HJ,124.99,,23179.17
6510,5/21/2021,5/21/2021,Joseph Zarate,Imported from Bank of America Visa,D105,HJ,129.46,,23308.63
6510,5/21/2021,5/21/2021,Josh Hall,Imported from Bank of America Visa,D107,HJ,68.03,,23376.66
6510,5/21/2021,5/21/2021,Josh Hall,Imported from Bank of America Visa,D107,HJ,39.95,,23416.61
6510,5/21/2021,5/21/2021,Josh Hall,Imported from Bank of America Visa,D107,HJ,164.98,,23581.59
6510,5/21/2021,5/21/2021,Maryellen Leneghan,Imported from Bank of America Visa,D108,HJ,26.49,,23608.08
6510,5/21/2021,5/21/2021,Tiffany Jordan,Imported from Bank of America Visa,D108,HJ,235.45,,23843.53
6510,5/24/2021,5/24/2021,Joseph Zarate,Imported from Bank of America Visa,D105,HJ,75.98,,23919.51
6510,5/24/2021,5/24/2021,Joseph Zarate,Imported from Bank of America Visa,D105,HJ,82.06,,24001.57
6510,5/24/2021,5/24/2021,Joseph Zarate,Imported from Bank of America Visa,D105,HJ,85,,24086.57
6510,5/24/2021,5/24/2021,Joseph Zarate,Imported from Bank of America Visa,D105,HJ,151.96,,24238.53
6510,5/24/2021,5/24/2021,Mahaliah Sejour,Imported from Bank of America Visa,D108,HJ,5.35,,24243.88
6510,5/24/2021,5/24/2021,Monivett Acevedo,Imported from Bank of America Visa,D107,HJ,109.98,,24353.86
6510,5/24/2021,5/24/2021,Tiffany Jordan,Imported from Bank of America Visa,D108,HJ,108.99,,24462.85
6510,5/26/2021,5/26/2021,Mahaliah Sejour,Imported from Bank of America Visa,D108,HJ,1.99,,24464.84
6510,5/26/2021,5/26/2021,Monivett Acevedo,Imported from Bank of America Visa,D107,HJ,36.99,,24501.83
6510,5/26/2021,5/26/2021,Thomas Fischaber,Imported from Bank of America Visa,D109,HJ,30.23,,24532.06
6510,6/1/2021,6/1/2021,Joseph Zarate,Imported from Bank of America Visa,D105,HJ,112.99,,24645.05
6510,6/1/2021,6/1/2021,Joseph Zarate,Imported from Bank of America Visa,D105,HJ,367.5,,25012.55
6510,6/2/2021,6/2/2021,Joseph Zarate,Imported from Bank of America Visa,D105,HJ,399,,25411.55
6510,6/2/2021,6/2/2021,Mahaliah Sejour,Imported from Bank of America Visa,D108,HJ,5.35,,25416.9
6510,6/2/2021,6/2/2021,Mahaliah Sejour,Imported from Bank of America Visa,D108,HJ,5.35,,25422.25
6510,6/2/2021,6/2/2021,Myesha Hossain,Imported from Bank of America Visa,D108,HJ,5.94,,25428.19
6510,6/2/2021,6/2/2021,Myesha Hossain,Imported from Bank of America Visa,D108,HJ,133.95,,25562.14
6510,6/4/2021,6/4/2021,Joseph Zarate,Imported from Bank of America Visa,D105,HJ,39.99,,25602.13
6510,6/4/2021,6/4/2021,Joseph Zarate,Imported from Bank of America Visa,D105,HJ,338.99,,25941.12
6510,6/4/2021,6/4/2021,Mahaliah Sejour,Imported from Bank of America Visa,D108,HJ,5.35,,25946.47
6510,6/8/2021,6/8/2021,Joseph Zarate,Imported from Bank of America Visa,D105,HJ,6.99,,25953.46
6510,6/8/2021,6/8/2021,Joseph Zarate,Imported from Bank of America Visa,D105,HJ,6.99,,25960.45
6510,6/8/2021,6/8/2021,Nicole Prahin,Imported from Bank of America Visa,D108,HJ,5.35,,25965.8
6510,6/11/2021,6/11/2021,Halley Bowman,Imported from Bank of America Visa,D101,HJ,2.67,,25968.47
6510,6/11/2021,6/11/2021,Halley Bowman,Imported from Bank of America Visa,D101,HJ,4.13,,25972.6
6510,6/11/2021,6/11/2021,Halley Bowman,Imported from Bank of America Visa,D101,HJ,4.13,,25976.73
6510,6/11/2021,6/11/2021,Halley Bowman,Imported from Bank of America Visa,D101,HJ,13.34,,25990.07
6510,6/14/2021,6/14/2021,Joseph Zarate,Imported from Bank of America Visa,D105,HJ,83.97,,26074.04
6510,6/15/2021,6/15/2021,Joseph Zarate,Imported from Bank of America Visa,D105,HJ,6.99,,26081.03
6510,6/15/2021,6/15/2021,Maryellen Leneghan,Imported from Bank of America Visa,D108,HJ,20.17,,26101.2
6510,6/16/2021,6/16/2021,Nicole Prahin,Imported from Bank of America Visa,D108,HJ,2.17,,26103.37
6510,6/17/2021,6/17/2021,Joseph Zarate,Imported from Bank of America Visa,D105,HJ,434.12,,26537.49
6510,6/17/2021,6/17/2021,Myesha Hossain,Imported from Bank of America Visa,D108,HJ,10.99,,26548.48
6510,6/18/2021,6/18/2021,Alan Safran,Imported from Bank of America Visa,D107,HJ,15.93,,26564.41
6510,6/18/2021,6/18/2021,Mahaliah Sejour,Imported from Bank of America Visa,D108,HJ,5.35,,26569.76
6510,6/18/2021,6/18/2021,Mahaliah Sejour,Imported from Bank of America Visa,D108,HJ,5.35,,26575.11
6510,6/22/2021,6/22/2021,Alan Safran,Imported from Bank of America Visa,D109,HJ,118.62,,26693.73
6510,6/22/2021,6/22/2021,Joseph Zarate,Imported from Bank of America Visa,D105,HJ,388.89,,27082.62
6510,6/24/2021,6/24/2021,Joseph Zarate,Imported from Bank of America Visa,D105,HJ,22.91,,27105.53
6510,6/24/2021,6/24/2021,Joseph Zarate,Imported from Bank of America Visa,D105,HJ,29.84,,27135.37
6510,6/24/2021,6/24/2021,Mahaliah Sejour,Imported from Bank of America Visa,D108,HJ,1.99,,27137.36
6510,6/28/2021,6/28/2021,Mahaliah Sejour,Imported from Bank of America Visa,D108,HJ,5.35,,27142.71
6510, Totals for 6510 - Office Supplies,,,,,,27595.64,452.93,27142.71
6515,6515 - Hardware -Laptop and Tech Equipment (Balance forward As of 07/01/2020) ,,,,,,,,0
6515,7/1/2020,7/1/2020,Joseph Zarate,Imported from Bank of America Visa-Equipment,D105,HJ,461.99,,461.99
6515,7/1/2020,7/1/2020,Joseph Zarate,Imported from Bank of America Visa-Equipment,D105,HJ,461.99,,923.98
6515,7/1/2020,7/1/2020,Joseph Zarate,Imported from Bank of America Visa-New hire equipment,D105,HJ,468.99,,1392.97
6515,7/2/2020,7/2/2020,Joseph Zarate,Imported from Bank of America Visa-Equipment,D105,HJ,39.75,,1432.72
6515,7/2/2020,7/2/2020,Joseph Zarate,Imported from Bank of America Visa-Equipment,D105,HJ,808.92,,2241.64
6515,7/2/2020,7/2/2020,Joseph Zarate,Imported from Bank of America Visa-Refund,D105,HJ,21.19,,2262.83
6515,7/5/2020,7/5/2020,Joseph Zarate,Imported from Bank of America Visa-Equipment,D105,HJ,832.88,,3095.71
6515,7/6/2020,7/6/2020,Joseph Zarate,Imported from Bank of America Visa-Equipment,D105,HJ,725,,3820.71
6515,7/7/2020,7/7/2020,Joseph Zarate,Imported from Bank of America Visa-Equipment,D105,HJ,118.79,,3939.5
6515,7/7/2020,7/7/2020,Joseph Zarate,Imported from Bank of America Visa-Equipment,D105,HJ,455,,4394.5
6515,7/7/2020,7/7/2020,Joseph Zarate,Imported from Bank of America Visa-Equipment,D105,HJ,455,,4849.5
6515,7/7/2020,7/7/2020,Joseph Zarate,Imported from Bank of America Visa-Equipment,D105,HJ,455,,5304.5
6515,7/7/2020,7/7/2020,Joseph Zarate,Imported from Bank of America Visa-Equipment,D105,HJ,516.06,,5820.56
6515,7/7/2020,7/7/2020,Joseph Zarate,Imported from Bank of America Visa-Equipment,D105,HJ,699.95,,6520.51
6515,7/7/2020,7/7/2020,Joseph Zarate,Imported from Bank of America Visa-Equipment,D105,HJ,1062.08,,7582.59
6515,7/9/2020,7/9/2020,Joseph Zarate,Imported from Bank of America Visa-Equipment,D105,HJ,455,,8037.59
6515,7/9/2020,7/9/2020,Joseph Zarate,Imported from Bank of America Visa-Equipment,D105,HJ,455,,8492.59
6515,7/9/2020,7/9/2020,Joseph Zarate,Imported from Bank of America Visa-Equipment,D105,HJ,463.99,,8956.58
6515,7/10/2020,7/10/2020,Joseph Zarate,Imported from Bank of America Visa-Equipment,D105,HJ,455,,9411.58
6515,7/10/2020,7/10/2020,Joseph Zarate,Imported from Bank of America Visa-New hire equipment,D105,HJ,450,,9861.58
6515,7/13/2020,7/13/2020,Joseph Zarate,Imported from Bank of America Visa-New hire equipment,D105,HJ,106.08,,9967.66
6515,7/13/2020,7/13/2020,Joseph Zarate,Imported from Bank of America Visa-New hire equipment,D105,HJ,638.99,,10606.65
6515,7/13/2020,7/13/2020,Joseph Zarate,Imported from Bank of America Visa-New hire equipment,D105,HJ,725,,11331.65
6515,7/14/2020,7/14/2020,Joseph Zarate,Imported from Bank of America Visa-Equipment,D105,HJ,1104.99,,12436.64
6515,7/14/2020,7/14/2020,Joseph Zarate,Imported from Bank of America Visa-New hire equipment,D105,HJ,19.99,,12456.63
6515,7/14/2020,7/14/2020,Joseph Zarate,Imported from Bank of America Visa-New hire equipment,D105,HJ,116.98,,12573.61
6515,7/16/2020,7/16/2020,Joseph Zarate,Imported from Bank of America Visa-New hire equipment,D105,HJ,746.57,,13320.18
6515,7/16/2020,7/16/2020,Joseph Zarate,Imported from Bank of America Visa-New hire equipment,D105,HJ,795,,14115.18
6515,7/17/2020,7/17/2020,Myesha Hossain,Imported from Bank of America Visa-Hardware Laptop and Tech Equipment,D108,HJ,84.97,,14200.15
6515,7/18/2020,7/18/2020,Joseph Zarate,Imported from Bank of America Visa-New hire equipment,D105,HJ,30.98,,14231.13
6515,7/18/2020,7/18/2020,Myesha Hossain,Imported from Bank of America Visa-Laptop equipment,D108,HJ,6.99,,14238.12
6515,7/19/2020,7/19/2020,Joseph Zarate,Imported from Bank of America Visa-New hire equipment,D105,HJ,29.99,,14268.11
6515,7/20/2020,7/20/2020,Joseph Zarate,Imported from Bank of America Visa-New hire equipment,D105,HJ,6.99,,14275.1
6515,7/20/2020,7/20/2020,Joseph Zarate,Imported from Bank of America Visa-New hire equipment,D105,HJ,11.99,,14287.09
6515,7/20/2020,7/20/2020,Joseph Zarate,Imported from Bank of America Visa-New hire equipment,D105,HJ,109.99,,14397.08
6515,7/20/2020,7/20/2020,Joseph Zarate,Imported from Bank of America Visa-New hire equipment,D105,HJ,124.67,,14521.75
6515,7/20/2020,7/20/2020,Joseph Zarate,Imported from Bank of America Visa-New hire equipment,D105,HJ,638.99,,15160.74
6515,7/20/2020,7/20/2020,Joseph Zarate,Imported from Bank of America Visa-New hire equipment,D105,HJ,779,,15939.74
6515,7/21/2020,7/21/2020,Joseph Zarate,Imported from Bank of America Visa-New hire equipment,D105,HJ,124.67,,16064.41
6515,7/21/2020,7/21/2020,Joseph Zarate,Imported from Bank of America Visa-New hire equipment,D105,HJ,229,,16293.41
6515,7/21/2020,7/21/2020,Joseph Zarate,Imported from Bank of America Visa-New hire equipment,D105,HJ,463.99,,16757.4
6515,7/21/2020,7/21/2020,Joseph Zarate,Imported from Bank of America Visa-New hire equipment,D105,HJ,463.99,,17221.39
6515,7/22/2020,7/22/2020,Joseph Zarate,Imported from Bank of America Visa-New hire equipment,D105,HJ,37.2,,17258.59
6515,7/22/2020,7/22/2020,Joseph Zarate,Imported from Bank of America Visa-New hire equipment,D105,HJ,229,,17487.59
6515,7/22/2020,7/22/2020,Joseph Zarate,Imported from Bank of America Visa-New hire equipment,D105,HJ,242.74,,17730.33
6515,7/23/2020,7/23/2020,Joseph Zarate,Imported from Bank of America Visa-New hire equipment,D105,HJ,229,,17959.33
6515,7/23/2020,7/23/2020,Joseph Zarate,Imported from Bank of America Visa-New hire equipment,D105,HJ,242.74,,18202.07
6515,7/23/2020,7/23/2020,Maryellen Leneghan,Imported from Bank of America Visa-Supplies for BC DoP,D108,HJ,149.48,,18351.55
6515,7/24/2020,7/24/2020,Joseph Zarate,Imported from Bank of America Visa-New hire equipment,D105,HJ,468,,18819.55
6515,7/24/2020,7/24/2020,Joseph Zarate,Imported from Bank of America Visa-New hire equipment,D105,HJ,468,,19287.55
6515,7/24/2020,7/24/2020,Joseph Zarate,Imported from Bank of America Visa-New hire equipment,D105,HJ,468,,19755.55
6515,7/24/2020,7/24/2020,Maryellen Leneghan,Imported from Bank of America Visa-Montior fo DC DoP,D108,HJ,90.07,,19845.62
6515,7/25/2020,7/25/2020,Joseph Zarate,Imported from Bank of America Visa-New hire equipment,D105,HJ,203.64,,20049.26
6515,7/26/2020,7/26/2020,Joseph Zarate,Imported from Bank of America Visa-New hire equipment,D105,HJ,220,,20269.26
6515,7/26/2020,7/26/2020,Joseph Zarate,Imported from Bank of America Visa-New hire equipment,D105,HJ,249.99,,20519.25
6515,7/26/2020,7/26/2020,Joseph Zarate,Imported from Bank of America Visa-New hire equipment,D105,HJ,257,,20776.25
6515,7/26/2020,7/26/2020,Joseph Zarate,Imported from Bank of America Visa-New hire equipment,D105,HJ,267.84,,21044.09
6515,7/27/2020,7/27/2020,Cathryn Cook,Imported from Bank of America Visa-Monitor for Nicole Prahin Chicago SDoP,D105,HJ,114.67,,21158.76
6515,7/27/2020,7/27/2020,Joseph Zarate,Imported from Bank of America Visa-New hire equipment,D105,HJ,165.98,,21324.74
6515,7/28/2020,7/28/2020,Joseph Zarate,Imported from Bank of America Visa-Equipment,D105,HJ,9.99,,21334.73
6515,7/28/2020,7/28/2020,Joseph Zarate,Imported from Bank of America Visa-Equipment,D105,HJ,102.1,,21436.83
6515,7/28/2020,7/28/2020,Joseph Zarate,Imported from Bank of America Visa-New hire equipment,D105,HJ,112.09,,21548.92
6515,7/28/2020,7/28/2020,Joseph Zarate,Imported from Bank of America Visa-New hire equipment,D105,HJ,229,,21777.92
6515,7/28/2020,7/28/2020,Joseph Zarate,Imported from Bank of America Visa-repairs,D105,HJ,64.4,,21842.32
6515,7/30/2020,7/30/2020,Joseph Zarate,Imported from Bank of America Visa-New hire equipment,D105,HJ,800.3,,22642.62
6515,8/1/2020,8/1/2020,Joseph Zarate,Imported from Bank of America Visa-New hire equipment,D105,HJ,169.98,,22812.6
6515,8/1/2020,8/1/2020,Joseph Zarate,Imported from Bank of America Visa-New hire equipment,D105,HJ,169.98,,22982.58
6515,8/1/2020,8/1/2020,Joseph Zarate,Imported from Bank of America Visa-New hire equipment,D105,HJ,169.98,,23152.56
6515,8/1/2020,8/1/2020,Joseph Zarate,Imported from Bank of America Visa-New hire equipment,D105,HJ,169.98,,23322.54
6515,8/1/2020,8/1/2020,Joseph Zarate,Imported from Bank of America Visa-Refund issued,D105,HJ,,468,22854.54
6515,8/4/2020,8/4/2020,Chris D PLACEHOLDER,Imported from Bank of America Visa-Office supplies for Nicole Prahin,D108,HJ,95.74,,22950.28
6515,8/4/2020,8/4/2020,Joseph Zarate,Imported from Bank of America Visa-Equipment for new hire,D105,HJ,258.99,,23209.27
6515,8/4/2020,8/4/2020,Joseph Zarate,Imported from Bank of America Visa-Equipment for new hire,D105,HJ,258.99,,23468.26
6515,8/4/2020,8/4/2020,Joseph Zarate,Imported from Bank of America Visa-Equipment for new hire,D105,HJ,258.99,,23727.25
6515,8/4/2020,8/4/2020,Joseph Zarate,Imported from Bank of America Visa-Equipment for new hire,D105,HJ,258.99,,23986.24
6515,8/4/2020,8/4/2020,Joseph Zarate,Imported from Bank of America Visa-Equipment for new hire,D105,HJ,276.15,,24262.39
6515,8/4/2020,8/4/2020,Joseph Zarate,Imported from Bank of America Visa-New hire equipment,D105,HJ,258.99,,24521.38
6515,8/4/2020,8/4/2020,Joseph Zarate,Imported from Bank of America Visa-New hire equipment,D105,HJ,258.99,,24780.37
6515,8/5/2020,8/5/2020,Joseph Zarate,Imported from Bank of America Visa-Equipment,D105,HJ,36.99,,24817.36
6515,8/5/2020,8/5/2020,Joseph Zarate,Imported from Bank of America Visa-New hire equipment,D105,HJ,174.89,,24992.25
6515,8/5/2020,8/5/2020,Joseph Zarate,Imported from Bank of America Visa-New hire equipment,D105,HJ,200.59,,25192.84
6515,8/5/2020,8/5/2020,Joseph Zarate,Imported from Bank of America Visa-New hire equipment,D105,HJ,244,,25436.84
6515,8/5/2020,8/5/2020,Joseph Zarate,Imported from Bank of America Visa-New hire equipment,D105,HJ,244,,25680.84
6515,8/5/2020,8/5/2020,Joseph Zarate,Imported from Bank of America Visa-New hire equipment,D105,HJ,244,,25924.84
6515,8/5/2020,8/5/2020,Joseph Zarate,Imported from Bank of America Visa-New hire equipment,D105,HJ,264.99,,26189.83
6515,8/6/2020,8/6/2020,Joseph Zarate,Imported from Bank of America Visa-New hire equipment,D105,HJ,221.04,,26410.87
6515,8/6/2020,8/6/2020,Joseph Zarate,Imported from Bank of America Visa-New hire equipment,D105,HJ,249,,26659.87
6515,8/6/2020,8/6/2020,Joseph Zarate,Imported from Bank of America Visa-New hire equipment,D105,HJ,253.73,,26913.6
6515,8/6/2020,8/6/2020,Joseph Zarate,Imported from Bank of America Visa-New hire equipment,D105,HJ,255,,27168.6
6515,8/6/2020,8/6/2020,Joseph Zarate,Imported from Bank of America Visa-New hire equipment,D105,HJ,266.43,,27435.03
6515,8/6/2020,8/6/2020,Joseph Zarate,Imported from Bank of America Visa-New hire equipment,D105,HJ,269.54,,27704.57
6515,8/7/2020,8/7/2020,Joseph Zarate,Imported from Bank of America Visa-New hire equipment,D105,HJ,264.99,,27969.56
6515,8/7/2020,8/7/2020,Joseph Zarate,Imported from Bank of America Visa-New hire equipment,D105,HJ,289.76,,28259.32
6515,8/7/2020,8/7/2020,Joseph Zarate,Imported from Bank of America Visa-New hire equipment,D105,HJ,295.97,,28555.29
6515,8/8/2020,8/8/2020,Joseph Zarate,Imported from Bank of America Visa-New hire equipment,D105,HJ,9.89,,28565.18
6515,8/8/2020,8/8/2020,Joseph Zarate,Imported from Bank of America Visa-New hire equipment,D105,HJ,10.68,,28575.86
6515,8/8/2020,8/8/2020,Joseph Zarate,Imported from Bank of America Visa-New hire equipment,D105,HJ,260,,28835.86
6515,8/8/2020,8/8/2020,Joseph Zarate,Imported from Bank of America Visa-New hire equipment,D105,HJ,260,,29095.86
6515,8/8/2020,8/8/2020,Joseph Zarate,Imported from Bank of America Visa-New hire equipment,D105,HJ,264.99,,29360.85
6515,8/8/2020,8/8/2020,Joseph Zarate,Imported from Bank of America Visa-New hire equipment,D105,HJ,264.99,,29625.84
6515,8/8/2020,8/8/2020,Joseph Zarate,Imported from Bank of America Visa-New hire equipment,D105,HJ,264.99,,29890.83
6515,8/8/2020,8/8/2020,Joseph Zarate,Imported from Bank of America Visa-New hire equipment,D105,HJ,281.82,,30172.65
6515,8/8/2020,8/8/2020,Joseph Zarate,Imported from Bank of America Visa-New hire equipment,D105,HJ,284.07,,30456.72
6515,8/8/2020,8/8/2020,Joseph Zarate,Imported from Bank of America Visa-New hire equipment,D105,HJ,295.74,,30752.46
6515,8/8/2020,8/8/2020,Joseph Zarate,Imported from Bank of America Visa-equipment,D105,HJ,88.89,,30841.35
6515,8/8/2020,8/8/2020,Myesha Hossain,Imported from Bank of America Visa-Fellow Training,D108,HJ,15.49,,30856.84
6515,8/9/2020,8/9/2020,Joseph Zarate,Imported from Bank of America Visa-New hire equipment,D105,HJ,9.89,,30866.73
6515,8/9/2020,8/9/2020,Joseph Zarate,Imported from Bank of America Visa-New hire equipment,D105,HJ,9.89,,30876.62
6515,8/9/2020,8/9/2020,Joseph Zarate,Imported from Bank of America Visa-New hire equipment,D105,HJ,9.89,,30886.51
6515,8/9/2020,8/9/2020,Joseph Zarate,Imported from Bank of America Visa-New hire equipment,D105,HJ,9.89,,30896.4
6515,8/9/2020,8/9/2020,Joseph Zarate,Imported from Bank of America Visa-New hire equipment,D105,HJ,9.89,,30906.29
6515,8/9/2020,8/9/2020,Joseph Zarate,Imported from Bank of America Visa-New hire equipment,D105,HJ,10.48,,30916.77
6515,8/9/2020,8/9/2020,Joseph Zarate,Imported from Bank of America Visa-New hire equipment,D105,HJ,10.58,,30927.35
6515,8/9/2020,8/9/2020,Joseph Zarate,Imported from Bank of America Visa-New hire equipment,D105,HJ,10.68,,30938.03
6515,8/9/2020,8/9/2020,Joseph Zarate,Imported from Bank of America Visa-New hire equipment,D105,HJ,10.73,,30948.76
6515,8/9/2020,8/9/2020,Joseph Zarate,Imported from Bank of America Visa-New hire equipment,D105,HJ,184.86,,31133.62
6515,8/9/2020,8/9/2020,Joseph Zarate,Imported from Bank of America Visa-New hire equipment,D105,HJ,267.99,,31401.61
6515,8/9/2020,8/9/2020,Joseph Zarate,Imported from Bank of America Visa-New hire equipment,D105,HJ,267.99,,31669.6
6515,8/9/2020,8/9/2020,Joseph Zarate,Imported from Bank of America Visa-New hire equipment,D105,HJ,279,,31948.6
6515,8/9/2020,8/9/2020,Joseph Zarate,Imported from Bank of America Visa-New hire equipment,D105,HJ,279,,32227.6
6515,8/9/2020,8/9/2020,Joseph Zarate,Imported from Bank of America Visa-New hire equipment,D105,HJ,279,,32506.6
6515,8/9/2020,8/9/2020,Joseph Zarate,Imported from Bank of America Visa-New hire equipment,D105,HJ,279,,32785.6
6515,8/9/2020,8/9/2020,Joseph Zarate,Imported from Bank of America Visa-New hire equipment,D105,HJ,279,,33064.6
6515,8/9/2020,8/9/2020,Joseph Zarate,Imported from Bank of America Visa-New hire equipment,D105,HJ,279,,33343.6
6515,8/9/2020,8/9/2020,Joseph Zarate,Imported from Bank of America Visa-New hire equipment,D105,HJ,279,,33622.6
6515,8/9/2020,8/9/2020,Joseph Zarate,Imported from Bank of America Visa-New hire equipment,D105,HJ,279,,33901.6
6515,8/9/2020,8/9/2020,Joseph Zarate,Imported from Bank of America Visa-New hire equipment,D105,HJ,279,,34180.6
6515,8/9/2020,8/9/2020,Joseph Zarate,Imported from Bank of America Visa-New hire equipment,D105,HJ,279,,34459.6
6515,8/9/2020,8/9/2020,Joseph Zarate,Imported from Bank of America Visa-New hire equipment,D105,HJ,279,,34738.6
6515,8/9/2020,8/9/2020,Joseph Zarate,Imported from Bank of America Visa-New hire equipment,D105,HJ,279,,35017.6
6515,8/9/2020,8/9/2020,Joseph Zarate,Imported from Bank of America Visa-New hire equipment,D105,HJ,279,,35296.6
6515,8/9/2020,8/9/2020,Joseph Zarate,Imported from Bank of America Visa-New hire equipment,D105,HJ,279,,35575.6
6515,8/9/2020,8/9/2020,Joseph Zarate,Imported from Bank of America Visa-New hire equipment,D105,HJ,279,,35854.6
6515,8/9/2020,8/9/2020,Joseph Zarate,Imported from Bank of America Visa-New hire equipment,D105,HJ,279,,36133.6
6515,8/9/2020,8/9/2020,Joseph Zarate,Imported from Bank of America Visa-New hire equipment,D105,HJ,281.82,,36415.42
6515,8/9/2020,8/9/2020,Joseph Zarate,Imported from Bank of America Visa-New hire equipment,D105,HJ,285.74,,36701.16
6515,8/9/2020,8/9/2020,Joseph Zarate,Imported from Bank of America Visa-New hire equipment,D105,HJ,286.75,,36987.91
6515,8/9/2020,8/9/2020,Joseph Zarate,Imported from Bank of America Visa-equipment,D105,HJ,99.24,,37087.15
6515,8/10/2020,8/10/2020,Joseph Zarate,Imported from Bank of America Visa-New hire equipment,D105,HJ,9.89,,37097.04
6515,8/10/2020,8/10/2020,Joseph Zarate,Imported from Bank of America Visa-New hire equipment,D105,HJ,9.89,,37106.93
6515,8/10/2020,8/10/2020,Joseph Zarate,Imported from Bank of America Visa-New hire equipment,D105,HJ,9.89,,37116.82
6515,8/10/2020,8/10/2020,Joseph Zarate,Imported from Bank of America Visa-New hire equipment,D105,HJ,9.89,,37126.71
6515,8/10/2020,8/10/2020,Joseph Zarate,Imported from Bank of America Visa-New hire equipment,D105,HJ,9.89,,37136.6
6515,8/10/2020,8/10/2020,Joseph Zarate,Imported from Bank of America Visa-New hire equipment,D105,HJ,9.89,,37146.49
6515,8/10/2020,8/10/2020,Joseph Zarate,Imported from Bank of America Visa-New hire equipment,D105,HJ,10.83,,37157.32
6515,8/10/2020,8/10/2020,Joseph Zarate,Imported from Bank of America Visa-New hire equipment,D105,HJ,10.99,,37168.31
6515,8/10/2020,8/10/2020,Joseph Zarate,Imported from Bank of America Visa-New hire equipment,D105,HJ,19.99,,37188.3
6515,8/10/2020,8/10/2020,Joseph Zarate,Imported from Bank of America Visa-New hire equipment,D105,HJ,19.99,,37208.29
6515,8/10/2020,8/10/2020,Joseph Zarate,Imported from Bank of America Visa-New hire equipment,D105,HJ,19.99,,37228.28
6515,8/10/2020,8/10/2020,Joseph Zarate,Imported from Bank of America Visa-New hire equipment,D105,HJ,19.99,,37248.27
6515,8/10/2020,8/10/2020,Joseph Zarate,Imported from Bank of America Visa-New hire equipment,D105,HJ,19.99,,37268.26
6515,8/10/2020,8/10/2020,Joseph Zarate,Imported from Bank of America Visa-New hire equipment,D105,HJ,19.99,,37288.25
6515,8/10/2020,8/10/2020,Joseph Zarate,Imported from Bank of America Visa-New hire equipment,D105,HJ,19.99,,37308.24
6515,8/10/2020,8/10/2020,Joseph Zarate,Imported from Bank of America Visa-New hire equipment,D105,HJ,19.99,,37328.23
6515,8/10/2020,8/10/2020,Joseph Zarate,Imported from Bank of America Visa-New hire equipment,D105,HJ,19.99,,37348.22
6515,8/10/2020,8/10/2020,Joseph Zarate,Imported from Bank of America Visa-New hire equipment,D105,HJ,21.19,,37369.41
6515,8/10/2020,8/10/2020,Joseph Zarate,Imported from Bank of America Visa-New hire equipment,D105,HJ,21.26,,37390.67
6515,8/10/2020,8/10/2020,Joseph Zarate,Imported from Bank of America Visa-New hire equipment,D105,HJ,21.39,,37412.06
6515,8/10/2020,8/10/2020,Joseph Zarate,Imported from Bank of America Visa-New hire equipment,D105,HJ,21.39,,37433.45
6515,8/10/2020,8/10/2020,Joseph Zarate,Imported from Bank of America Visa-New hire equipment,D105,HJ,21.39,,37454.84
6515,8/10/2020,8/10/2020,Joseph Zarate,Imported from Bank of America Visa-New hire equipment,D105,HJ,21.39,,37476.23
6515,8/10/2020,8/10/2020,Joseph Zarate,Imported from Bank of America Visa-New hire equipment,D105,HJ,21.54,,37497.77
6515,8/10/2020,8/10/2020,Joseph Zarate,Imported from Bank of America Visa-New hire equipment,D105,HJ,21.59,,37519.36
6515,8/10/2020,8/10/2020,Joseph Zarate,Imported from Bank of America Visa-New hire equipment,D105,HJ,21.59,,37540.95
6515,8/10/2020,8/10/2020,Joseph Zarate,Imported from Bank of America Visa-New hire equipment,D105,HJ,21.69,,37562.64
6515,8/10/2020,8/10/2020,Joseph Zarate,Imported from Bank of America Visa-New hire equipment,D105,HJ,21.69,,37584.33
6515,8/10/2020,8/10/2020,Joseph Zarate,Imported from Bank of America Visa-New hire equipment,D105,HJ,21.89,,37606.22
6515,8/10/2020,8/10/2020,Joseph Zarate,Imported from Bank of America Visa-New hire equipment,D105,HJ,31.35,,37637.57
6515,8/10/2020,8/10/2020,Joseph Zarate,Imported from Bank of America Visa-New hire equipment,D105,HJ,260,,37897.57
6515,8/10/2020,8/10/2020,Joseph Zarate,Imported from Bank of America Visa-New hire equipment,D105,HJ,267.99,,38165.56
6515,8/10/2020,8/10/2020,Joseph Zarate,Imported from Bank of America Visa-New hire equipment,D105,HJ,290.1,,38455.66
6515,8/10/2020,8/10/2020,Joseph Zarate,Imported from Bank of America Visa-equipment,D105,HJ,31.35,,38487.01
6515,8/10/2020,8/10/2020,Joseph Zarate,Imported from Bank of America Visa-equipment,D105,HJ,31.35,,38518.36
6515,8/11/2020,8/11/2020,Joseph Zarate,Imported from Bank of America Visa-New hire equipment,D105,HJ,9.89,,38528.25
6515,8/11/2020,8/11/2020,Joseph Zarate,Imported from Bank of America Visa-New hire equipment,D105,HJ,9.89,,38538.14
6515,8/11/2020,8/11/2020,Joseph Zarate,Imported from Bank of America Visa-New hire equipment,D105,HJ,9.89,,38548.03
6515,8/11/2020,8/11/2020,Joseph Zarate,Imported from Bank of America Visa-New hire equipment,D105,HJ,9.89,,38557.92
6515,8/11/2020,8/11/2020,Joseph Zarate,Imported from Bank of America Visa-New hire equipment,D105,HJ,9.89,,38567.81
6515,8/11/2020,8/11/2020,Joseph Zarate,Imported from Bank of America Visa-New hire equipment,D105,HJ,9.89,,38577.7
6515,8/11/2020,8/11/2020,Joseph Zarate,Imported from Bank of America Visa-New hire equipment,D105,HJ,10.48,,38588.18
6515,8/11/2020,8/11/2020,Joseph Zarate,Imported from Bank of America Visa-New hire equipment,D105,HJ,10.58,,38598.76
6515,8/11/2020,8/11/2020,Joseph Zarate,Imported from Bank of America Visa-New hire equipment,D105,HJ,10.99,,38609.75
6515,8/11/2020,8/11/2020,Joseph Zarate,Imported from Bank of America Visa-New hire equipment,D105,HJ,114.35,,38724.1
6515,8/11/2020,8/11/2020,Joseph Zarate,Imported from Bank of America Visa-New hire equipment,D105,HJ,114.35,,38838.45
6515,8/11/2020,8/11/2020,Joseph Zarate,Imported from Bank of America Visa-New hire equipment,D105,HJ,114.35,,38952.8
6515,8/11/2020,8/11/2020,Joseph Zarate,Imported from Bank of America Visa-New hire equipment,D105,HJ,114.35,,39067.15
6515,8/11/2020,8/11/2020,Joseph Zarate,Imported from Bank of America Visa-New hire equipment,D105,HJ,260,,39327.15
6515,8/11/2020,8/11/2020,Joseph Zarate,Imported from Bank of America Visa-New hire equipment,D105,HJ,267.99,,39595.14
6515,8/11/2020,8/11/2020,Joseph Zarate,Imported from Bank of America Visa-equipment,D105,HJ,114.35,,39709.49
6515,8/11/2020,8/11/2020,Joseph Zarate,Imported from Bank of America Visa-equipment,D105,HJ,125.34,,39834.83
6515,8/12/2020,8/12/2020,Joseph Zarate,Imported from Bank of America Visa-New hire equipment,D105,HJ,9.89,,39844.72
6515,8/12/2020,8/12/2020,Joseph Zarate,Imported from Bank of America Visa-New hire equipment,D105,HJ,88.89,,39933.61
6515,8/12/2020,8/12/2020,Joseph Zarate,Imported from Bank of America Visa-New hire equipment,D105,HJ,88.89,,40022.5
6515,8/12/2020,8/12/2020,Joseph Zarate,Imported from Bank of America Visa-New hire equipment,D105,HJ,88.89,,40111.39
6515,8/12/2020,8/12/2020,Joseph Zarate,Imported from Bank of America Visa-New hire equipment,D105,HJ,88.89,,40200.28
6515,8/12/2020,8/12/2020,Joseph Zarate,Imported from Bank of America Visa-New hire equipment,D105,HJ,88.89,,40289.17
6515,8/12/2020,8/12/2020,Joseph Zarate,Imported from Bank of America Visa-New hire equipment,D105,HJ,88.89,,40378.06
6515,8/12/2020,8/12/2020,Joseph Zarate,Imported from Bank of America Visa-New hire equipment,D105,HJ,88.89,,40466.95
6515,8/12/2020,8/12/2020,Joseph Zarate,Imported from Bank of America Visa-New hire equipment,D105,HJ,88.89,,40555.84
6515,8/12/2020,8/12/2020,Joseph Zarate,Imported from Bank of America Visa-New hire equipment,D105,HJ,88.89,,40644.73
6515,8/12/2020,8/12/2020,Joseph Zarate,Imported from Bank of America Visa-New hire equipment,D105,HJ,88.89,,40733.62
6515,8/12/2020,8/12/2020,Joseph Zarate,Imported from Bank of America Visa-New hire equipment,D105,HJ,88.89,,40822.51
6515,8/12/2020,8/12/2020,Joseph Zarate,Imported from Bank of America Visa-New hire equipment,D105,HJ,88.89,,40911.4
6515,8/12/2020,8/12/2020,Joseph Zarate,Imported from Bank of America Visa-New hire equipment,D105,HJ,88.89,,41000.29
6515,8/12/2020,8/12/2020,Joseph Zarate,Imported from Bank of America Visa-New hire equipment,D105,HJ,88.89,,41089.18
6515,8/12/2020,8/12/2020,Joseph Zarate,Imported from Bank of America Visa-New hire equipment,D105,HJ,88.89,,41178.07
6515,8/12/2020,8/12/2020,Joseph Zarate,Imported from Bank of America Visa-New hire equipment,D105,HJ,88.89,,41266.96
6515,8/12/2020,8/12/2020,Joseph Zarate,Imported from Bank of America Visa-New hire equipment,D105,HJ,88.89,,41355.85
6515,8/12/2020,8/12/2020,Joseph Zarate,Imported from Bank of America Visa-New hire equipment,D105,HJ,88.89,,41444.74
6515,8/12/2020,8/12/2020,Joseph Zarate,Imported from Bank of America Visa-New hire equipment,D105,HJ,88.89,,41533.63
6515,8/12/2020,8/12/2020,Joseph Zarate,Imported from Bank of America Visa-New hire equipment,D105,HJ,88.89,,41622.52
6515,8/12/2020,8/12/2020,Joseph Zarate,Imported from Bank of America Visa-New hire equipment,D105,HJ,88.89,,41711.41
6515,8/12/2020,8/12/2020,Joseph Zarate,Imported from Bank of America Visa-New hire equipment,D105,HJ,88.89,,41800.3
6515,8/12/2020,8/12/2020,Joseph Zarate,Imported from Bank of America Visa-New hire equipment,D105,HJ,88.89,,41889.19
6515,8/12/2020,8/12/2020,Joseph Zarate,Imported from Bank of America Visa-New hire equipment,D105,HJ,88.89,,41978.08
6515,8/12/2020,8/12/2020,Joseph Zarate,Imported from Bank of America Visa-New hire equipment,D105,HJ,88.89,,42066.97
6515,8/12/2020,8/12/2020,Joseph Zarate,Imported from Bank of America Visa-New hire equipment,D105,HJ,88.89,,42155.86
6515,8/12/2020,8/12/2020,Joseph Zarate,Imported from Bank of America Visa-New hire equipment,D105,HJ,88.89,,42244.75
6515,8/12/2020,8/12/2020,Joseph Zarate,Imported from Bank of America Visa-New hire equipment,D105,HJ,94.22,,42338.97
6515,8/12/2020,8/12/2020,Joseph Zarate,Imported from Bank of America Visa-New hire equipment,D105,HJ,94.53,,42433.5
6515,8/12/2020,8/12/2020,Joseph Zarate,Imported from Bank of America Visa-New hire equipment,D105,HJ,95.11,,42528.61
6515,8/12/2020,8/12/2020,Joseph Zarate,Imported from Bank of America Visa-New hire equipment,D105,HJ,95.11,,42623.72
6515,8/12/2020,8/12/2020,Joseph Zarate,Imported from Bank of America Visa-New hire equipment,D105,HJ,95.11,,42718.83
6515,8/12/2020,8/12/2020,Joseph Zarate,Imported from Bank of America Visa-New hire equipment,D105,HJ,96.45,,42815.28
6515,8/13/2020,8/13/2020,Joseph Zarate,Imported from Bank of America Visa-New hire equipment,D105,HJ,9.98,,42825.26
6515,8/13/2020,8/13/2020,Joseph Zarate,Imported from Bank of America Visa-New hire equipment,D105,HJ,9.98,,42835.24
6515,8/13/2020,8/13/2020,Joseph Zarate,Imported from Bank of America Visa-New hire equipment,D105,HJ,9.98,,42845.22
6515,8/13/2020,8/13/2020,Joseph Zarate,Imported from Bank of America Visa-New hire equipment,D105,HJ,9.98,,42855.2
6515,8/13/2020,8/13/2020,Joseph Zarate,Imported from Bank of America Visa-New hire equipment,D105,HJ,9.98,,42865.18
6515,8/13/2020,8/13/2020,Joseph Zarate,Imported from Bank of America Visa-New hire equipment,D105,HJ,9.98,,42875.16
6515,8/13/2020,8/13/2020,Joseph Zarate,Imported from Bank of America Visa-New hire equipment,D105,HJ,9.98,,42885.14
6515,8/13/2020,8/13/2020,Joseph Zarate,Imported from Bank of America Visa-New hire equipment,D105,HJ,9.98,,42895.12
6515,8/13/2020,8/13/2020,Joseph Zarate,Imported from Bank of America Visa-New hire equipment,D105,HJ,9.98,,42905.1
6515,8/13/2020,8/13/2020,Joseph Zarate,Imported from Bank of America Visa-New hire equipment,D105,HJ,9.98,,42915.08
6515,8/13/2020,8/13/2020,Joseph Zarate,Imported from Bank of America Visa-New hire equipment,D105,HJ,9.98,,42925.06
6515,8/13/2020,8/13/2020,Joseph Zarate,Imported from Bank of America Visa-New hire equipment,D105,HJ,9.98,,42935.04
6515,8/13/2020,8/13/2020,Joseph Zarate,Imported from Bank of America Visa-New hire equipment,D105,HJ,9.98,,42945.02
6515,8/13/2020,8/13/2020,Joseph Zarate,Imported from Bank of America Visa-New hire equipment,D105,HJ,9.98,,42955
6515,8/13/2020,8/13/2020,Joseph Zarate,Imported from Bank of America Visa-New hire equipment,D105,HJ,10.68,,42965.68
6515,8/13/2020,8/13/2020,Joseph Zarate,Imported from Bank of America Visa-New hire equipment,D105,HJ,10.99,,42976.67
6515,8/13/2020,8/13/2020,Joseph Zarate,Imported from Bank of America Visa-New hire equipment,D105,HJ,14.99,,42991.66
6515,8/13/2020,8/13/2020,Joseph Zarate,Imported from Bank of America Visa-New hire equipment,D105,HJ,19.75,,43011.41
6515,8/13/2020,8/13/2020,Joseph Zarate,Imported from Bank of America Visa-New hire equipment,D105,HJ,19.75,,43031.16
6515,8/13/2020,8/13/2020,Joseph Zarate,Imported from Bank of America Visa-New hire equipment,D105,HJ,19.75,,43050.91
6515,8/13/2020,8/13/2020,Joseph Zarate,Imported from Bank of America Visa-New hire equipment,D105,HJ,21.03,,43071.94
6515,8/13/2020,8/13/2020,Joseph Zarate,Imported from Bank of America Visa-New hire equipment,D105,HJ,49.49,,43121.43
6515,8/13/2020,8/13/2020,Joseph Zarate,Imported from Bank of America Visa-New hire equipment,D105,HJ,49.99,,43171.42
6515,8/13/2020,8/13/2020,Joseph Zarate,Imported from Bank of America Visa-New hire equipment,D105,HJ,54.04,,43225.46
6515,8/13/2020,8/13/2020,Joseph Zarate,Imported from Bank of America Visa-New hire equipment,D105,HJ,88.89,,43314.35
6515,8/13/2020,8/13/2020,Joseph Zarate,Imported from Bank of America Visa-New hire equipment,D105,HJ,88.89,,43403.24
6515,8/13/2020,8/13/2020,Joseph Zarate,Imported from Bank of America Visa-New hire equipment,D105,HJ,88.89,,43492.13
6515,8/13/2020,8/13/2020,Joseph Zarate,Imported from Bank of America Visa-New hire equipment,D105,HJ,88.89,,43581.02
6515,8/13/2020,8/13/2020,Joseph Zarate,Imported from Bank of America Visa-New hire equipment,D105,HJ,88.89,,43669.91
6515,8/13/2020,8/13/2020,Joseph Zarate,Imported from Bank of America Visa-New hire equipment,D105,HJ,94.22,,43764.13
6515,8/13/2020,8/13/2020,Joseph Zarate,Imported from Bank of America Visa-New hire equipment,D105,HJ,95.33,,43859.46
6515,8/13/2020,8/13/2020,Joseph Zarate,Imported from Bank of America Visa-New hire equipment,D105,HJ,97.33,,43956.79
6515,8/13/2020,8/13/2020,Joseph Zarate,Imported from Bank of America Visa-New hire equipment,D105,HJ,104.68,,44061.47
6515,8/13/2020,8/13/2020,Joseph Zarate,Imported from Bank of America Visa-New hire equipment,D105,HJ,140.67,,44202.14
6515,8/13/2020,8/13/2020,Joseph Zarate,Imported from Bank of America Visa-New hire equipment,D105,HJ,260,,44462.14
6515,8/13/2020,8/13/2020,Joseph Zarate,Imported from Bank of America Visa-New hire equipment.returns,D105,HJ,94.53,,44556.67
6515,8/13/2020,8/13/2020,Joseph Zarate,Imported from Bank of America Visa-equipment,D105,HJ,9.98,,44566.65
6515,8/14/2020,8/14/2020,Joseph Zarate,Imported from Bank of America Visa-New hire equipment,D105,HJ,12.03,,44578.68
6515,8/14/2020,8/14/2020,Joseph Zarate,Imported from Bank of America Visa-New hire equipment,D105,HJ,14.99,,44593.67
6515,8/14/2020,8/14/2020,Joseph Zarate,Imported from Bank of America Visa-New hire equipment,D105,HJ,14.99,,44608.66
6515,8/14/2020,8/14/2020,Joseph Zarate,Imported from Bank of America Visa-New hire equipment,D105,HJ,49.99,,44658.65
6515,8/14/2020,8/14/2020,Joseph Zarate,Imported from Bank of America Visa-New hire equipment,D105,HJ,49.99,,44708.64
6515,8/14/2020,8/14/2020,Joseph Zarate,Imported from Bank of America Visa-New hire equipment,D105,HJ,49.99,,44758.63
6515,8/14/2020,8/14/2020,Joseph Zarate,Imported from Bank of America Visa-New hire equipment,D105,HJ,49.99,,44808.62
6515,8/14/2020,8/14/2020,Joseph Zarate,Imported from Bank of America Visa-New hire equipment,D105,HJ,94.22,,44902.84
6515,8/14/2020,8/14/2020,Joseph Zarate,Imported from Bank of America Visa-New hire equipment,D105,HJ,94.22,,44997.06
6515,8/14/2020,8/14/2020,Joseph Zarate,Imported from Bank of America Visa-New hire equipment,D105,HJ,94.22,,45091.28
6515,8/14/2020,8/14/2020,Joseph Zarate,Imported from Bank of America Visa-New hire equipment,D105,HJ,119.67,,45210.95
6515,8/14/2020,8/14/2020,Joseph Zarate,Imported from Bank of America Visa-New hire equipment,D105,HJ,144.87,,45355.82
6515,8/14/2020,8/14/2020,Joseph Zarate,Imported from Bank of America Visa-New hire equipment,D105,HJ,324.8,,45680.62
6515,8/14/2020,8/14/2020,Joseph Zarate,Imported from Bank of America Visa-New hire equipment,D105,HJ,579,,46259.62
6515,8/14/2020,8/14/2020,Joseph Zarate,Imported from Bank of America Visa-equipment,D105,HJ,16.41,,46276.03
6515,8/15/2020,8/15/2020,Joseph Zarate,Imported from Bank of America Visa-New hire equipment,D105,HJ,9.98,,46286.01
6515,8/15/2020,8/15/2020,Joseph Zarate,Imported from Bank of America Visa-New hire equipment,D105,HJ,88.89,,46374.9
6515,8/15/2020,8/15/2020,Joseph Zarate,Imported from Bank of America Visa-New hire equipment,D105,HJ,94.22,,46469.12
6515,8/15/2020,8/15/2020,Joseph Zarate,Imported from Bank of America Visa-New hire equipment,D105,HJ,95.45,,46564.57
6515,8/15/2020,8/15/2020,Joseph Zarate,Imported from Bank of America Visa-New hire equipment,D105,HJ,295,,46859.57
6515,8/15/2020,8/15/2020,Joseph Zarate,Imported from Bank of America Visa-New hire equipment,D105,HJ,316.39,,47175.96
6515,8/16/2020,8/16/2020,Joseph Zarate,Imported from Bank of America Visa-New hire equipment,D105,HJ,88.89,,47264.85
6515,8/16/2020,8/16/2020,Joseph Zarate,Imported from Bank of America Visa-New hire equipment,D105,HJ,119.62,,47384.47
6515,8/17/2020,8/17/2020,Joseph Zarate,Imported from Bank of America Visa-New hire equipment,D105,HJ,16.04,,47400.51
6515,8/18/2020,8/18/2020,Joseph Zarate,Imported from Bank of America Visa-New hire equipment,D105,HJ,15.15,,47415.66
6515,8/18/2020,8/18/2020,Joseph Zarate,Imported from Bank of America Visa-New hire equipment,D105,HJ,16.05,,47431.71
6515,8/18/2020,8/18/2020,Joseph Zarate,Imported from Bank of America Visa-New hire equipment,D105,HJ,16.05,,47447.76
6515,8/18/2020,8/18/2020,Joseph Zarate,Imported from Bank of America Visa-New hire equipment,D105,HJ,16.05,,47463.81
6515,8/18/2020,8/18/2020,Joseph Zarate,Imported from Bank of America Visa-New hire equipment,D105,HJ,16.06,,47479.87
6515,8/18/2020,8/18/2020,Joseph Zarate,Imported from Bank of America Visa-New hire equipment,D105,HJ,16.06,,47495.93
6515,8/18/2020,8/18/2020,Joseph Zarate,Imported from Bank of America Visa-New hire equipment,D105,HJ,16.06,,47511.99
6515,8/18/2020,8/18/2020,Joseph Zarate,Imported from Bank of America Visa-New hire equipment,D105,HJ,16.06,,47528.05
6515,8/18/2020,8/18/2020,Joseph Zarate,Imported from Bank of America Visa-New hire equipment,D105,HJ,19.01,,47547.06
6515,8/18/2020,8/18/2020,Joseph Zarate,Imported from Bank of America Visa-New hire equipment,D105,HJ,19.01,,47566.07
6515,8/18/2020,8/18/2020,Joseph Zarate,Imported from Bank of America Visa-New hire equipment,D105,HJ,19.01,,47585.08
6515,8/18/2020,8/18/2020,Joseph Zarate,Imported from Bank of America Visa-New hire equipment,D105,HJ,19.01,,47604.09
6515,8/18/2020,8/18/2020,Joseph Zarate,Imported from Bank of America Visa-New hire equipment,D105,HJ,19.01,,47623.1
6515,8/18/2020,8/18/2020,Joseph Zarate,Imported from Bank of America Visa-New hire equipment,D105,HJ,19.01,,47642.11
6515,8/18/2020,8/18/2020,Joseph Zarate,Imported from Bank of America Visa-New hire equipment,D105,HJ,19.01,,47661.12
6515,8/18/2020,8/18/2020,Joseph Zarate,Imported from Bank of America Visa-New hire equipment,D105,HJ,19.01,,47680.13
6515,8/18/2020,8/18/2020,Joseph Zarate,Imported from Bank of America Visa-New hire equipment,D105,HJ,19.01,,47699.14
6515,8/18/2020,8/18/2020,Joseph Zarate,Imported from Bank of America Visa-New hire equipment,D105,HJ,19.01,,47718.15
6515,8/18/2020,8/18/2020,Joseph Zarate,Imported from Bank of America Visa-New hire equipment,D105,HJ,19.01,,47737.16
6515,8/18/2020,8/18/2020,Joseph Zarate,Imported from Bank of America Visa-New hire equipment,D105,HJ,19.01,,47756.17
6515,8/18/2020,8/18/2020,Joseph Zarate,Imported from Bank of America Visa-New hire equipment,D105,HJ,19.01,,47775.18
6515,8/18/2020,8/18/2020,Joseph Zarate,Imported from Bank of America Visa-New hire equipment,D105,HJ,19.01,,47794.19
6515,8/18/2020,8/18/2020,Joseph Zarate,Imported from Bank of America Visa-New hire equipment,D105,HJ,19.01,,47813.2
6515,8/18/2020,8/18/2020,Joseph Zarate,Imported from Bank of America Visa-New hire equipment,D105,HJ,19.01,,47832.21
6515,8/18/2020,8/18/2020,Joseph Zarate,Imported from Bank of America Visa-New hire equipment,D105,HJ,19.01,,47851.22
6515,8/18/2020,8/18/2020,Joseph Zarate,Imported from Bank of America Visa-New hire equipment,D105,HJ,19.01,,47870.23
6515,8/18/2020,8/18/2020,Joseph Zarate,Imported from Bank of America Visa-New hire equipment,D105,HJ,19.09,,47889.32
6515,8/18/2020,8/18/2020,Joseph Zarate,Imported from Bank of America Visa-New hire equipment,D105,HJ,19.09,,47908.41
6515,8/18/2020,8/18/2020,Joseph Zarate,Imported from Bank of America Visa-New hire equipment,D105,HJ,19.09,,47927.5
6515,8/18/2020,8/18/2020,Joseph Zarate,Imported from Bank of America Visa-New hire equipment,D105,HJ,19.09,,47946.59
6515,8/18/2020,8/18/2020,Joseph Zarate,Imported from Bank of America Visa-New hire equipment,D105,HJ,19.09,,47965.68
6515,8/18/2020,8/18/2020,Joseph Zarate,Imported from Bank of America Visa-New hire equipment,D105,HJ,19.09,,47984.77
6515,8/18/2020,8/18/2020,Joseph Zarate,Imported from Bank of America Visa-New hire equipment,D105,HJ,19.09,,48003.86
6515,8/18/2020,8/18/2020,Joseph Zarate,Imported from Bank of America Visa-New hire equipment,D105,HJ,19.09,,48022.95
6515,8/18/2020,8/18/2020,Joseph Zarate,Imported from Bank of America Visa-New hire equipment,D105,HJ,19.09,,48042.04
6515,8/18/2020,8/18/2020,Joseph Zarate,Imported from Bank of America Visa-New hire equipment,D105,HJ,19.09,,48061.13
6515,8/18/2020,8/18/2020,Joseph Zarate,Imported from Bank of America Visa-New hire equipment,D105,HJ,19.09,,48080.22
6515,8/18/2020,8/18/2020,Joseph Zarate,Imported from Bank of America Visa-New hire equipment,D105,HJ,19.09,,48099.31
6515,8/18/2020,8/18/2020,Joseph Zarate,Imported from Bank of America Visa-New hire equipment,D105,HJ,19.09,,48118.4
6515,8/18/2020,8/18/2020,Joseph Zarate,Imported from Bank of America Visa-New hire equipment,D105,HJ,19.09,,48137.49
6515,8/18/2020,8/18/2020,Joseph Zarate,Imported from Bank of America Visa-New hire equipment,D105,HJ,19.09,,48156.58
6515,8/18/2020,8/18/2020,Joseph Zarate,Imported from Bank of America Visa-New hire equipment,D105,HJ,19.09,,48175.67
6515,8/18/2020,8/18/2020,Joseph Zarate,Imported from Bank of America Visa-New hire equipment,D105,HJ,19.09,,48194.76
6515,8/18/2020,8/18/2020,Joseph Zarate,Imported from Bank of America Visa-New hire equipment,D105,HJ,19.09,,48213.85
6515,8/18/2020,8/18/2020,Joseph Zarate,Imported from Bank of America Visa-New hire equipment,D105,HJ,19.09,,48232.94
6515,8/18/2020,8/18/2020,Joseph Zarate,Imported from Bank of America Visa-New hire equipment,D105,HJ,19.09,,48252.03
6515,8/18/2020,8/18/2020,Joseph Zarate,Imported from Bank of America Visa-New hire equipment,D105,HJ,19.09,,48271.12
6515,8/18/2020,8/18/2020,Joseph Zarate,Imported from Bank of America Visa-New hire equipment,D105,HJ,19.09,,48290.21
6515,8/18/2020,8/18/2020,Joseph Zarate,Imported from Bank of America Visa-New hire equipment,D105,HJ,19.09,,48309.3
6515,8/18/2020,8/18/2020,Joseph Zarate,Imported from Bank of America Visa-New hire equipment,D105,HJ,19.09,,48328.39
6515,8/18/2020,8/18/2020,Joseph Zarate,Imported from Bank of America Visa-New hire equipment,D105,HJ,19.09,,48347.48
6515,8/18/2020,8/18/2020,Joseph Zarate,Imported from Bank of America Visa-New hire equipment,D105,HJ,19.09,,48366.57
6515,8/18/2020,8/18/2020,Joseph Zarate,Imported from Bank of America Visa-New hire equipment,D105,HJ,19.09,,48385.66
6515,8/18/2020,8/18/2020,Joseph Zarate,Imported from Bank of America Visa-New hire equipment,D105,HJ,19.09,,48404.75
6515,8/18/2020,8/18/2020,Joseph Zarate,Imported from Bank of America Visa-New hire equipment,D105,HJ,19.09,,48423.84
6515,8/18/2020,8/18/2020,Joseph Zarate,Imported from Bank of America Visa-New hire equipment,D105,HJ,20.24,,48444.08
6515,8/18/2020,8/18/2020,Joseph Zarate,Imported from Bank of America Visa-New hire equipment,D105,HJ,20.34,,48464.42
6515,8/18/2020,8/18/2020,Joseph Zarate,Imported from Bank of America Visa-New hire equipment,D105,HJ,20.34,,48484.76
6515,8/18/2020,8/18/2020,Joseph Zarate,Imported from Bank of America Visa-New hire equipment,D105,HJ,20.35,,48505.11
6515,8/18/2020,8/18/2020,Joseph Zarate,Imported from Bank of America Visa-New hire equipment,D105,HJ,20.43,,48525.54
6515,8/18/2020,8/18/2020,Joseph Zarate,Imported from Bank of America Visa-New hire equipment,D105,HJ,20.57,,48546.11
6515,8/18/2020,8/18/2020,Joseph Zarate,Imported from Bank of America Visa-New hire equipment,D105,HJ,20.64,,48566.75
6515,8/18/2020,8/18/2020,Joseph Zarate,Imported from Bank of America Visa-New hire equipment,D105,HJ,20.99,,48587.74
6515,8/18/2020,8/18/2020,Joseph Zarate,Imported from Bank of America Visa-New hire equipment,D105,HJ,47,,48634.74
6515,8/18/2020,8/18/2020,Joseph Zarate,Imported from Bank of America Visa-New hire equipment,D105,HJ,47,,48681.74
6515,8/18/2020,8/18/2020,Joseph Zarate,Imported from Bank of America Visa-New hire equipment,D105,HJ,47,,48728.74
6515,8/18/2020,8/18/2020,Joseph Zarate,Imported from Bank of America Visa-New hire equipment,D105,HJ,50.29,,48779.03
6515,8/18/2020,8/18/2020,Joseph Zarate,Imported from Bank of America Visa-New hire equipment,D105,HJ,88.89,,48867.92
6515,8/18/2020,8/18/2020,Joseph Zarate,Imported from Bank of America Visa-New hire equipment,D105,HJ,109.81,,48977.73
6515,8/18/2020,8/18/2020,Joseph Zarate,Imported from Bank of America Visa-New hire equipment,D105,HJ,136.17,,49113.9
6515,8/19/2020,8/19/2020,Joseph Zarate,Imported from Bank of America Visa-New hire equipment,D105,HJ,10.99,,49124.89
6515,8/19/2020,8/19/2020,Joseph Zarate,Imported from Bank of America Visa-New hire equipment,D105,HJ,14.99,,49139.88
6515,8/19/2020,8/19/2020,Joseph Zarate,Imported from Bank of America Visa-New hire equipment,D105,HJ,47,,49186.88
6515,8/19/2020,8/19/2020,Joseph Zarate,Imported from Bank of America Visa-New hire equipment,D105,HJ,47,,49233.88
6515,8/19/2020,8/19/2020,Joseph Zarate,Imported from Bank of America Visa-New hire equipment,D105,HJ,47,,49280.88
6515,8/19/2020,8/19/2020,Joseph Zarate,Imported from Bank of America Visa-New hire equipment,D105,HJ,47,,49327.88
6515,8/19/2020,8/19/2020,Joseph Zarate,Imported from Bank of America Visa-New hire equipment,D105,HJ,47,,49374.88
6515,8/19/2020,8/19/2020,Joseph Zarate,Imported from Bank of America Visa-New hire equipment,D105,HJ,47,,49421.88
6515,8/19/2020,8/19/2020,Joseph Zarate,Imported from Bank of America Visa-New hire equipment,D105,HJ,47,,49468.88
6515,8/19/2020,8/19/2020,Joseph Zarate,Imported from Bank of America Visa-New hire equipment,D105,HJ,47,,49515.88
6515,8/19/2020,8/19/2020,Joseph Zarate,Imported from Bank of America Visa-New hire equipment,D105,HJ,47,,49562.88
6515,8/19/2020,8/19/2020,Joseph Zarate,Imported from Bank of America Visa-New hire equipment,D105,HJ,50.29,,49613.17
6515,8/19/2020,8/19/2020,Joseph Zarate,Imported from Bank of America Visa-New hire equipment,D105,HJ,50.95,,49664.12
6515,8/19/2020,8/19/2020,Joseph Zarate,Imported from Bank of America Visa-New hire equipment,D105,HJ,88.89,,49753.01
6515,8/19/2020,8/19/2020,Joseph Zarate,Imported from Bank of America Visa-New hire equipment,D105,HJ,95.33,,49848.34
6515,8/20/2020,8/20/2020,Joseph Zarate,Imported from Bank of America Visa-New hire equipment,D105,HJ,9.89,,49858.23
6515,8/20/2020,8/20/2020,Joseph Zarate,Imported from Bank of America Visa-New hire equipment,D105,HJ,9.89,,49868.12
6515,8/20/2020,8/20/2020,Joseph Zarate,Imported from Bank of America Visa-New hire equipment,D105,HJ,9.89,,49878.01
6515,8/20/2020,8/20/2020,Joseph Zarate,Imported from Bank of America Visa-New hire equipment,D105,HJ,9.89,,49887.9
6515,8/20/2020,8/20/2020,Joseph Zarate,Imported from Bank of America Visa-New hire equipment,D105,HJ,9.89,,49897.79
6515,8/20/2020,8/20/2020,Joseph Zarate,Imported from Bank of America Visa-New hire equipment,D105,HJ,9.89,,49907.68
6515,8/20/2020,8/20/2020,Joseph Zarate,Imported from Bank of America Visa-New hire equipment,D105,HJ,9.89,,49917.57
6515,8/20/2020,8/20/2020,Joseph Zarate,Imported from Bank of America Visa-New hire equipment,D105,HJ,9.89,,49927.46
6515,8/20/2020,8/20/2020,Joseph Zarate,Imported from Bank of America Visa-New hire equipment,D105,HJ,9.89,,49937.35
6515,8/20/2020,8/20/2020,Joseph Zarate,Imported from Bank of America Visa-New hire equipment,D105,HJ,9.89,,49947.24
6515,8/20/2020,8/20/2020,Joseph Zarate,Imported from Bank of America Visa-New hire equipment,D105,HJ,9.89,,49957.13
6515,8/20/2020,8/20/2020,Joseph Zarate,Imported from Bank of America Visa-New hire equipment,D105,HJ,9.89,,49967.02
6515,8/20/2020,8/20/2020,Joseph Zarate,Imported from Bank of America Visa-New hire equipment,D105,HJ,9.89,,49976.91
6515,8/20/2020,8/20/2020,Joseph Zarate,Imported from Bank of America Visa-New hire equipment,D105,HJ,9.89,,49986.8
6515,8/20/2020,8/20/2020,Joseph Zarate,Imported from Bank of America Visa-New hire equipment,D105,HJ,9.89,,49996.69
6515,8/20/2020,8/20/2020,Joseph Zarate,Imported from Bank of America Visa-New hire equipment,D105,HJ,9.89,,50006.58
6515,8/20/2020,8/20/2020,Joseph Zarate,Imported from Bank of America Visa-New hire equipment,D105,HJ,9.89,,50016.47
6515,8/20/2020,8/20/2020,Joseph Zarate,Imported from Bank of America Visa-New hire equipment,D105,HJ,9.89,,50026.36
6515,8/20/2020,8/20/2020,Joseph Zarate,Imported from Bank of America Visa-New hire equipment,D105,HJ,9.89,,50036.25
6515,8/20/2020,8/20/2020,Joseph Zarate,Imported from Bank of America Visa-New hire equipment,D105,HJ,9.89,,50046.14
6515,8/20/2020,8/20/2020,Joseph Zarate,Imported from Bank of America Visa-New hire equipment,D105,HJ,9.89,,50056.03
6515,8/20/2020,8/20/2020,Joseph Zarate,Imported from Bank of America Visa-New hire equipment,D105,HJ,9.89,,50065.92
6515,8/20/2020,8/20/2020,Joseph Zarate,Imported from Bank of America Visa-New hire equipment,D105,HJ,9.89,,50075.81
6515,8/20/2020,8/20/2020,Joseph Zarate,Imported from Bank of America Visa-New hire equipment,D105,HJ,9.89,,50085.7
6515,8/20/2020,8/20/2020,Joseph Zarate,Imported from Bank of America Visa-New hire equipment,D105,HJ,9.89,,50095.59
6515,8/20/2020,8/20/2020,Joseph Zarate,Imported from Bank of America Visa-New hire equipment,D105,HJ,9.89,,50105.48
6515,8/20/2020,8/20/2020,Joseph Zarate,Imported from Bank of America Visa-New hire equipment,D105,HJ,9.89,,50115.37
6515,8/20/2020,8/20/2020,Joseph Zarate,Imported from Bank of America Visa-New hire equipment,D105,HJ,9.89,,50125.26
6515,8/20/2020,8/20/2020,Joseph Zarate,Imported from Bank of America Visa-New hire equipment,D105,HJ,9.89,,50135.15
6515,8/20/2020,8/20/2020,Joseph Zarate,Imported from Bank of America Visa-New hire equipment,D105,HJ,9.89,,50145.04
6515,8/20/2020,8/20/2020,Joseph Zarate,Imported from Bank of America Visa-New hire equipment,D105,HJ,9.89,,50154.93
6515,8/20/2020,8/20/2020,Joseph Zarate,Imported from Bank of America Visa-New hire equipment,D105,HJ,9.89,,50164.82
6515,8/20/2020,8/20/2020,Joseph Zarate,Imported from Bank of America Visa-New hire equipment,D105,HJ,9.89,,50174.71
6515,8/20/2020,8/20/2020,Joseph Zarate,Imported from Bank of America Visa-New hire equipment,D105,HJ,9.89,,50184.6
6515,8/20/2020,8/20/2020,Joseph Zarate,Imported from Bank of America Visa-New hire equipment,D105,HJ,9.89,,50194.49
6515,8/20/2020,8/20/2020,Joseph Zarate,Imported from Bank of America Visa-New hire equipment,D105,HJ,9.89,,50204.38
6515,8/20/2020,8/20/2020,Joseph Zarate,Imported from Bank of America Visa-New hire equipment,D105,HJ,9.89,,50214.27
6515,8/20/2020,8/20/2020,Joseph Zarate,Imported from Bank of America Visa-New hire equipment,D105,HJ,9.89,,50224.16
6515,8/20/2020,8/20/2020,Joseph Zarate,Imported from Bank of America Visa-New hire equipment,D105,HJ,9.89,,50234.05
6515,8/20/2020,8/20/2020,Joseph Zarate,Imported from Bank of America Visa-New hire equipment,D105,HJ,9.89,,50243.94
6515,8/20/2020,8/20/2020,Joseph Zarate,Imported from Bank of America Visa-New hire equipment,D105,HJ,9.89,,50253.83
6515,8/20/2020,8/20/2020,Joseph Zarate,Imported from Bank of America Visa-New hire equipment,D105,HJ,9.89,,50263.72
6515,8/20/2020,8/20/2020,Joseph Zarate,Imported from Bank of America Visa-New hire equipment,D105,HJ,9.89,,50273.61
6515,8/20/2020,8/20/2020,Joseph Zarate,Imported from Bank of America Visa-New hire equipment,D105,HJ,9.89,,50283.5
6515,8/20/2020,8/20/2020,Joseph Zarate,Imported from Bank of America Visa-New hire equipment,D105,HJ,9.89,,50293.39
6515,8/20/2020,8/20/2020,Joseph Zarate,Imported from Bank of America Visa-New hire equipment,D105,HJ,9.89,,50303.28
6515,8/20/2020,8/20/2020,Joseph Zarate,Imported from Bank of America Visa-New hire equipment,D105,HJ,9.89,,50313.17
6515,8/20/2020,8/20/2020,Joseph Zarate,Imported from Bank of America Visa-New hire equipment,D105,HJ,9.89,,50323.06
6515,8/20/2020,8/20/2020,Joseph Zarate,Imported from Bank of America Visa-New hire equipment,D105,HJ,9.89,,50332.95
6515,8/20/2020,8/20/2020,Joseph Zarate,Imported from Bank of America Visa-New hire equipment,D105,HJ,9.89,,50342.84
6515,8/20/2020,8/20/2020,Joseph Zarate,Imported from Bank of America Visa-New hire equipment,D105,HJ,9.89,,50352.73
6515,8/20/2020,8/20/2020,Joseph Zarate,Imported from Bank of America Visa-New hire equipment,D105,HJ,10.43,,50363.16
6515,8/20/2020,8/20/2020,Joseph Zarate,Imported from Bank of America Visa-New hire equipment,D105,HJ,10.48,,50373.64
6515,8/20/2020,8/20/2020,Joseph Zarate,Imported from Bank of America Visa-New hire equipment,D105,HJ,10.55,,50384.19
6515,8/20/2020,8/20/2020,Joseph Zarate,Imported from Bank of America Visa-New hire equipment,D105,HJ,10.55,,50394.74
6515,8/20/2020,8/20/2020,Joseph Zarate,Imported from Bank of America Visa-New hire equipment,D105,HJ,10.58,,50405.32
6515,8/20/2020,8/20/2020,Joseph Zarate,Imported from Bank of America Visa-New hire equipment,D105,HJ,10.66,,50415.98
6515,8/20/2020,8/20/2020,Joseph Zarate,Imported from Bank of America Visa-New hire equipment,D105,HJ,10.69,,50426.67
6515,8/20/2020,8/20/2020,Joseph Zarate,Imported from Bank of America Visa-New hire equipment,D105,HJ,10.72,,50437.39
6515,8/20/2020,8/20/2020,Joseph Zarate,Imported from Bank of America Visa-New hire equipment,D105,HJ,10.76,,50448.15
6515,8/20/2020,8/20/2020,Joseph Zarate,Imported from Bank of America Visa-New hire equipment,D105,HJ,10.99,,50459.14
6515,8/20/2020,8/20/2020,Joseph Zarate,Imported from Bank of America Visa-New hire equipment,D105,HJ,10.99,,50470.13
6515,8/20/2020,8/20/2020,Joseph Zarate,Imported from Bank of America Visa-New hire equipment,D105,HJ,10.99,,50481.12
6515,8/20/2020,8/20/2020,Joseph Zarate,Imported from Bank of America Visa-New hire equipment,D105,HJ,10.99,,50492.11
6515,8/20/2020,8/20/2020,Joseph Zarate,Imported from Bank of America Visa-New hire equipment,D105,HJ,10.99,,50503.1
6515,8/20/2020,8/20/2020,Joseph Zarate,Imported from Bank of America Visa-New hire equipment,D105,HJ,11.76,,50514.86
6515,8/20/2020,8/20/2020,Joseph Zarate,Imported from Bank of America Visa-New hire equipment,D105,HJ,,12.03,50502.83
6515,8/20/2020,8/20/2020,Joseph Zarate,Imported from Bank of America Visa-New hire equipment,D105,HJ,21.5,,50524.33
6515,8/20/2020,8/20/2020,Joseph Zarate,Imported from Bank of America Visa-New hire equipment,D105,HJ,21.5,,50545.83
6515,8/20/2020,8/20/2020,Joseph Zarate,Imported from Bank of America Visa-New hire equipment,D105,HJ,21.5,,50567.33
6515,8/20/2020,8/20/2020,Joseph Zarate,Imported from Bank of America Visa-New hire equipment,D105,HJ,21.5,,50588.83
6515,8/20/2020,8/20/2020,Joseph Zarate,Imported from Bank of America Visa-New hire equipment,D105,HJ,21.5,,50610.33
6515,8/20/2020,8/20/2020,Joseph Zarate,Imported from Bank of America Visa-New hire equipment,D105,HJ,21.5,,50631.83
6515,8/20/2020,8/20/2020,Joseph Zarate,Imported from Bank of America Visa-New hire equipment,D105,HJ,21.5,,50653.33
6515,8/20/2020,8/20/2020,Joseph Zarate,Imported from Bank of America Visa-New hire equipment,D105,HJ,21.5,,50674.83
6515,8/20/2020,8/20/2020,Joseph Zarate,Imported from Bank of America Visa-New hire equipment,D105,HJ,21.5,,50696.33
6515,8/20/2020,8/20/2020,Joseph Zarate,Imported from Bank of America Visa-New hire equipment,D105,HJ,21.5,,50717.83
6515,8/20/2020,8/20/2020,Joseph Zarate,Imported from Bank of America Visa-New hire equipment,D105,HJ,21.5,,50739.33
6515,8/20/2020,8/20/2020,Joseph Zarate,Imported from Bank of America Visa-New hire equipment,D105,HJ,21.5,,50760.83
6515,8/20/2020,8/20/2020,Joseph Zarate,Imported from Bank of America Visa-New hire equipment,D105,HJ,21.5,,50782.33
6515,8/20/2020,8/20/2020,Joseph Zarate,Imported from Bank of America Visa-New hire equipment,D105,HJ,21.5,,50803.83
6515,8/20/2020,8/20/2020,Joseph Zarate,Imported from Bank of America Visa-New hire equipment,D105,HJ,21.5,,50825.33
6515,8/20/2020,8/20/2020,Joseph Zarate,Imported from Bank of America Visa-New hire equipment,D105,HJ,21.5,,50846.83
6515,8/20/2020,8/20/2020,Joseph Zarate,Imported from Bank of America Visa-New hire equipment,D105,HJ,21.5,,50868.33
6515,8/20/2020,8/20/2020,Joseph Zarate,Imported from Bank of America Visa-New hire equipment,D105,HJ,21.84,,50890.17
6515,8/20/2020,8/20/2020,Joseph Zarate,Imported from Bank of America Visa-New hire equipment,D105,HJ,22.87,,50913.04
6515,8/20/2020,8/20/2020,Joseph Zarate,Imported from Bank of America Visa-New hire equipment,D105,HJ,22.92,,50935.96
6515,8/20/2020,8/20/2020,Joseph Zarate,Imported from Bank of America Visa-New hire equipment,D105,HJ,23.06,,50959.02
6515,8/20/2020,8/20/2020,Joseph Zarate,Imported from Bank of America Visa-New hire equipment,D105,HJ,47,,51006.02
6515,8/20/2020,8/20/2020,Joseph Zarate,Imported from Bank of America Visa-New hire equipment,D105,HJ,47,,51053.02
6515,8/20/2020,8/20/2020,Joseph Zarate,Imported from Bank of America Visa-New hire equipment,D105,HJ,47,,51100.02
6515,8/20/2020,8/20/2020,Joseph Zarate,Imported from Bank of America Visa-New hire equipment,D105,HJ,47,,51147.02
6515,8/20/2020,8/20/2020,Joseph Zarate,Imported from Bank of America Visa-New hire equipment,D105,HJ,47,,51194.02
6515,8/20/2020,8/20/2020,Joseph Zarate,Imported from Bank of America Visa-New hire equipment,D105,HJ,47,,51241.02
6515,8/20/2020,8/20/2020,Joseph Zarate,Imported from Bank of America Visa-New hire equipment,D105,HJ,47,,51288.02
6515,8/20/2020,8/20/2020,Joseph Zarate,Imported from Bank of America Visa-New hire equipment,D105,HJ,47,,51335.02
6515,8/20/2020,8/20/2020,Joseph Zarate,Imported from Bank of America Visa-New hire equipment,D105,HJ,47,,51382.02
6515,8/20/2020,8/20/2020,Joseph Zarate,Imported from Bank of America Visa-New hire equipment,D105,HJ,47,,51429.02
6515,8/20/2020,8/20/2020,Joseph Zarate,Imported from Bank of America Visa-New hire equipment,D105,HJ,47,,51476.02
6515,8/20/2020,8/20/2020,Joseph Zarate,Imported from Bank of America Visa-New hire equipment,D105,HJ,47,,51523.02
6515,8/20/2020,8/20/2020,Joseph Zarate,Imported from Bank of America Visa-New hire equipment,D105,HJ,47,,51570.02
6515,8/20/2020,8/20/2020,Joseph Zarate,Imported from Bank of America Visa-New hire equipment,D105,HJ,47,,51617.02
6515,8/20/2020,8/20/2020,Joseph Zarate,Imported from Bank of America Visa-New hire equipment,D105,HJ,47,,51664.02
6515,8/20/2020,8/20/2020,Joseph Zarate,Imported from Bank of America Visa-New hire equipment,D105,HJ,47,,51711.02
6515,8/20/2020,8/20/2020,Joseph Zarate,Imported from Bank of America Visa-New hire equipment,D105,HJ,47,,51758.02
6515,8/20/2020,8/20/2020,Joseph Zarate,Imported from Bank of America Visa-New hire equipment,D105,HJ,47,,51805.02
6515,8/20/2020,8/20/2020,Joseph Zarate,Imported from Bank of America Visa-New hire equipment,D105,HJ,47,,51852.02
6515,8/20/2020,8/20/2020,Joseph Zarate,Imported from Bank of America Visa-New hire equipment,D105,HJ,47,,51899.02
6515,8/20/2020,8/20/2020,Joseph Zarate,Imported from Bank of America Visa-New hire equipment,D105,HJ,47,,51946.02
6515,8/20/2020,8/20/2020,Joseph Zarate,Imported from Bank of America Visa-New hire equipment,D105,HJ,47,,51993.02
6515,8/20/2020,8/20/2020,Joseph Zarate,Imported from Bank of America Visa-New hire equipment,D105,HJ,47,,52040.02
6515,8/20/2020,8/20/2020,Joseph Zarate,Imported from Bank of America Visa-New hire equipment,D105,HJ,47,,52087.02
6515,8/20/2020,8/20/2020,Joseph Zarate,Imported from Bank of America Visa-New hire equipment,D105,HJ,47,,52134.02
6515,8/20/2020,8/20/2020,Joseph Zarate,Imported from Bank of America Visa-New hire equipment,D105,HJ,49,,52183.02
6515,8/20/2020,8/20/2020,Joseph Zarate,Imported from Bank of America Visa-refund,D105,HJ,,119.62,52063.4
6515,8/21/2020,8/21/2020,Joseph Zarate,Imported from Bank of America Visa-New hire equipment,D105,HJ,9.89,,52073.29
6515,8/21/2020,8/21/2020,Joseph Zarate,Imported from Bank of America Visa-New hire equipment,D105,HJ,9.89,,52083.18
6515,8/21/2020,8/21/2020,Joseph Zarate,Imported from Bank of America Visa-New hire equipment,D105,HJ,10.48,,52093.66
6515,8/21/2020,8/21/2020,Joseph Zarate,Imported from Bank of America Visa-New hire equipment,D105,HJ,10.58,,52104.24
6515,8/21/2020,8/21/2020,Joseph Zarate,Imported from Bank of America Visa-New hire equipment,D105,HJ,10.61,,52114.85
6515,8/21/2020,8/21/2020,Joseph Zarate,Imported from Bank of America Visa-New hire equipment,D105,HJ,10.71,,52125.56
6515,8/21/2020,8/21/2020,Joseph Zarate,Imported from Bank of America Visa-New hire equipment,D105,HJ,47,,52172.56
6515,8/21/2020,8/21/2020,Joseph Zarate,Imported from Bank of America Visa-New hire equipment,D105,HJ,47,,52219.56
6515,8/21/2020,8/21/2020,Joseph Zarate,Imported from Bank of America Visa-New hire equipment,D105,HJ,47,,52266.56
6515,8/21/2020,8/21/2020,Joseph Zarate,Imported from Bank of America Visa-New hire equipment,D105,HJ,47,,52313.56
6515,8/21/2020,8/21/2020,Joseph Zarate,Imported from Bank of America Visa-New hire equipment,D105,HJ,47,,52360.56
6515,8/21/2020,8/21/2020,Joseph Zarate,Imported from Bank of America Visa-New hire equipment,D105,HJ,49,,52409.56
6515,8/21/2020,8/21/2020,Joseph Zarate,Imported from Bank of America Visa-New hire equipment,D105,HJ,50.29,,52459.85
6515,8/21/2020,8/21/2020,Joseph Zarate,Imported from Bank of America Visa-New hire equipment,D105,HJ,52.8,,52512.65
6515,8/21/2020,8/21/2020,Joseph Zarate,Imported from Bank of America Visa-New hire equipment,D105,HJ,461,,52973.65
6515,8/21/2020,8/21/2020,Joseph Zarate,Imported from Bank of America Visa-refund,D105,HJ,,284.07,52689.58
6515,8/22/2020,8/22/2020,Joseph Zarate,Imported from Bank of America Visa-New hire equipment,D105,HJ,9.89,,52699.47
6515,8/22/2020,8/22/2020,Joseph Zarate,Imported from Bank of America Visa-New hire equipment,D105,HJ,9.98,,52709.45
6515,8/22/2020,8/22/2020,Joseph Zarate,Imported from Bank of America Visa-New hire equipment,D105,HJ,47,,52756.45
6515,8/22/2020,8/22/2020,Joseph Zarate,Imported from Bank of America Visa-New hire equipment,D105,HJ,47,,52803.45
6515,8/22/2020,8/22/2020,Joseph Zarate,Imported from Bank of America Visa-New hire equipment,D105,HJ,47,,52850.45
6515,8/22/2020,8/22/2020,Joseph Zarate,Imported from Bank of America Visa-New hire equipment,D105,HJ,47,,52897.45
6515,8/22/2020,8/22/2020,Joseph Zarate,Imported from Bank of America Visa-New hire equipment,D105,HJ,49,,52946.45
6515,8/22/2020,8/22/2020,Joseph Zarate,Imported from Bank of America Visa-New hire equipment,D105,HJ,147.54,,53093.99
6515,8/22/2020,8/22/2020,Joseph Zarate,Imported from Bank of America Visa-New hire equipment,D105,HJ,178.66,,53272.65
6515,8/23/2020,8/23/2020,Joseph Zarate,Imported from Bank of America Visa-New hire equipment,D105,HJ,29.99,,53302.64
6515,8/23/2020,8/23/2020,Joseph Zarate,Imported from Bank of America Visa-New hire equipment,D105,HJ,51.7,,53354.34
6515,8/23/2020,8/23/2020,Joseph Zarate,Imported from Bank of America Visa-refund,D105,HJ,,9.89,53344.45
6515,8/24/2020,8/24/2020,Joseph Zarate,Imported from Bank of America Visa-New hire equipment,D105,HJ,10.71,,53355.16
6515,8/24/2020,8/24/2020,Joseph Zarate,Imported from Bank of America Visa-New hire equipment,D105,HJ,568,,53923.16
6515,8/25/2020,8/25/2020,Halley Bowman,Imported from Bank of America Visa-Keyboard for Emily,D101,HJ,31.79,,53954.95
6515,8/25/2020,8/25/2020,Joseph Zarate,Imported from Bank of America Visa-New hire equipment,D105,HJ,9.89,,53964.84
6515,8/25/2020,8/25/2020,Joseph Zarate,Imported from Bank of America Visa-New hire equipment,D105,HJ,10.99,,53975.83
6515,8/25/2020,8/25/2020,Joseph Zarate,Imported from Bank of America Visa-New hire equipment,D105,HJ,23.75,,53999.58
6515,8/25/2020,8/25/2020,Joseph Zarate,Imported from Bank of America Visa-New hire equipment,D105,HJ,23.75,,54023.33
6515,8/26/2020,8/26/2020,Joseph Zarate,Imported from Bank of America Visa-New hire equipment,D105,HJ,79.99,,54103.32
6515,8/27/2020,8/27/2020,Joseph Zarate,Imported from Bank of America Visa-New hire equipment,D105,HJ,9.89,,54113.21
6515,8/27/2020,8/27/2020,Joseph Zarate,Imported from Bank of America Visa-New hire equipment,D105,HJ,9.89,,54123.1
6515,8/28/2020,8/28/2020,Joseph Zarate,Imported from Bank of America Visa-New hire equipment,D105,HJ,49,,54172.1
6515,8/30/2020,8/30/2020,Joseph Zarate,Imported from Bank of America Visa-refund,D105,HJ,,19.09,54153.01
6515,9/1/2020,9/1/2020,Joseph Zarate,Imported from Bank of America Visa-New hire equipment,D105,HJ,913.97,,55066.98
6515,9/2/2020,9/2/2020,Joseph Zarate,Imported from Bank of America Visa-New hire equipment,D105,HJ,24.99,,55091.97
6515,9/2/2020,9/2/2020,Joseph Zarate,Imported from Bank of America Visa-New hire equipment,D105,HJ,224.99,,55316.96
6515,9/2/2020,9/2/2020,Joseph Zarate,Imported from Bank of America Visa-New hire equipment,D105,HJ,224.99,,55541.95
6515,9/4/2020,9/4/2020,Joseph Zarate,Imported from Bank of America Visa-New hire equipment,D105,HJ,10.99,,55552.94
6515,9/4/2020,9/4/2020,Joseph Zarate,Imported from Bank of America Visa-New hire equipment,D105,HJ,10.99,,55563.93
6515,9/4/2020,9/4/2020,Joseph Zarate,Imported from Bank of America Visa-New hire equipment,D105,HJ,112.01,,55675.94
6515,9/5/2020,9/5/2020,Joseph Zarate,Imported from Bank of America Visa-New hire equipment,D105,HJ,79.99,,55755.93
6515,9/5/2020,9/5/2020,Joseph Zarate,Imported from Bank of America Visa-New hire equipment,D105,HJ,833.78,,56589.71
6515,9/6/2020,9/6/2020,Joseph Zarate,Imported from Bank of America Visa-New hire equipment,D105,HJ,79.99,,56669.7
6515,9/11/2020,9/11/2020,Joseph Zarate,Imported from Bank of America Visa-equipment,D105,HJ,17.59,,56687.29
6515,9/12/2020,9/12/2020,Joseph Zarate,Imported from Bank of America Visa-New hire equipment,D105,HJ,13.99,,56701.28
6515,9/12/2020,9/12/2020,Joseph Zarate,Imported from Bank of America Visa-New hire equipment,D105,HJ,104.68,,56805.96
6515,9/12/2020,9/12/2020,Joseph Zarate,Imported from Bank of America Visa-New hire equipment,D105,HJ,128.46,,56934.42
6515,9/12/2020,9/12/2020,Joseph Zarate,Imported from Bank of America Visa-equipment,D105,HJ,13.99,,56948.41
6515,9/12/2020,9/12/2020,Joseph Zarate,Imported from Bank of America Visa-equipment,D105,HJ,104.68,,57053.09
6515,9/12/2020,9/12/2020,Joseph Zarate,Imported from Bank of America Visa-equipment,D105,HJ,104.68,,57157.77
6515,9/13/2020,9/13/2020,Joseph Zarate,Imported from Bank of America Visa-New hire equipment,D105,HJ,11.12,,57168.89
6515,9/15/2020,9/15/2020,Myesha Hossain,Imported from Bank of America Visa-headphones for APR,D108,HJ,239.98,,57408.87
6515,9/15/2020,9/15/2020,Myesha Hossain,Imported from Bank of America Visa-headphones for HSFI,D108,HJ,119.99,,57528.86
6515,9/15/2020,9/15/2020,Tiffani Bibb,Imported from Bank of America Visa-Printer for home office,D104,HJ,213.88,,57742.74
6515,9/16/2020,9/16/2020,Myesha Hossain,Imported from Bank of America Visa-Headphones for Dewey,D108,HJ,119.99,,57862.73
6515,9/18/2020,9/18/2020,Joseph Zarate,Imported from Bank of America Visa-New hire equipment,D105,HJ,790,,58652.73
6515,9/18/2020,9/18/2020,Joseph Zarate,Imported from Bank of America Visa-equipment,D105,HJ,11.65,,58664.38
6515,9/18/2020,9/18/2020,Joseph Zarate,Imported from Bank of America Visa-equipment,D105,HJ,51.94,,58716.32
6515,9/23/2020,9/23/2020,Joseph Zarate,Imported from Bank of America Visa-equipment,D105,HJ,699,,59415.32
6515,9/24/2020,9/24/2020,Joseph Zarate,Imported from Bank of America Visa-New hire equipment,D105,HJ,309.29,,59724.61
6515,9/24/2020,9/24/2020,Joseph Zarate,Imported from Bank of America Visa-New hire equipment,D105,HJ,589.99,,60314.6
6515,9/24/2020,9/24/2020,Myesha Hossain,Imported from Bank of America Visa-Fellow tech supplies,D108,HJ,49,,60363.6
6515,9/25/2020,9/25/2020,Joseph Zarate,Imported from Bank of America Visa-New hire equipment,D105,HJ,81.99,,60445.59
6515,9/25/2020,9/25/2020,Joseph Zarate,Imported from Bank of America Visa-New hire equipment,D105,HJ,331.9,,60777.49
6515,9/25/2020,9/25/2020,Joseph Zarate,Imported from Bank of America Visa-equipment,D105,HJ,18.62,,60796.11
6515,9/25/2020,9/25/2020,Tiffani Bibb,Imported from Bank of America Visa-Printer for Angela's home office,D104,HJ,159.32,,60955.43
6515,9/26/2020,9/26/2020,Joseph Zarate,Imported from Bank of America Visa-New hire equipment,D105,HJ,58.98,,61014.41
6515,9/27/2020,9/27/2020,Joseph Zarate,Imported from Bank of America Visa-New hire equipment,D105,HJ,37.04,,61051.45
6515,9/27/2020,9/27/2020,Joseph Zarate,Imported from Bank of America Visa-New hire equipment,D105,HJ,160.58,,61212.03
6515,9/27/2020,9/27/2020,Joseph Zarate,Imported from Bank of America Visa-New hire equipment,D105,HJ,589.99,,61802.02
6515,9/27/2020,9/27/2020,Joseph Zarate,Imported from Bank of America Visa-New hire equipment,D105,HJ,726.12,,62528.14
6515,9/28/2020,9/28/2020,Joseph Zarate,Imported from Bank of America Visa-New hire equipment,D105,HJ,18.62,,62546.76
6515,9/28/2020,9/28/2020,Joseph Zarate,Imported from Bank of America Visa-New hire equipment,D105,HJ,88.34,,62635.1
6515,9/29/2020,9/29/2020,Joseph Zarate,Imported from Bank of America Visa-Repair equipment,D105,HJ,140.6,,62775.7
6515,10/1/2020,10/1/2020,Joseph Zarate,Imported from reimbursements-equipment,D105,HJ,299,,63074.7
6515,10/2/2020,10/2/2020,Joseph Zarate,Imported from reimbursements-equipment,D105,HJ,574,,63648.7
6515,10/2/2020,10/2/2020,Joseph Zarate,Imported from reimbursements-equipment,D105,HJ,574,,64222.7
6515,10/5/2020,10/5/2020,Joseph Zarate,Imported from reimbursements-equipment,D105,HJ,224.02,,64446.72
6515,10/5/2020,10/5/2020,Joseph Zarate,Imported from reimbursements-equipment,D105,HJ,224.02,,64670.74
6515,10/6/2020,10/6/2020,Joseph Zarate,Imported from reimbursements-replacement equipment,D105,HJ,10.58,,64681.32
6515,10/9/2020,10/9/2020,Joseph Zarate,Imported from reimbursements-equipment,D105,HJ,30.39,,64711.71
6515,10/9/2020,10/9/2020,Joseph Zarate,Imported from reimbursements-equipment,D105,HJ,30.39,,64742.1
6515,10/9/2020,10/9/2020,Joseph Zarate,Imported from reimbursements-equipment,D105,HJ,32.21,,64774.31
6515,10/9/2020,10/9/2020,Joseph Zarate,Imported from reimbursements-equipment,D105,HJ,32.59,,64806.9
6515,10/10/2020,10/10/2020,Joseph Zarate,Imported from reimbursements-equipment,D105,HJ,10.9,,64817.8
6515,10/10/2020,10/10/2020,Joseph Zarate,Imported from reimbursements-equipment,D105,HJ,33.2,,64851
6515,10/10/2020,10/10/2020,Joseph Zarate,Imported from reimbursements-equipment,D105,HJ,89.97,,64940.97
6515,10/10/2020,10/10/2020,Joseph Zarate,Imported from reimbursements-equipment,D105,HJ,89.97,,65030.94
6515,10/10/2020,10/10/2020,Joseph Zarate,Imported from reimbursements-equipment,D105,HJ,95.37,,65126.31
6515,10/10/2020,10/10/2020,Joseph Zarate,Imported from reimbursements-equipment,D105,HJ,95.37,,65221.68
6515,10/10/2020,10/10/2020,Joseph Zarate,Imported from reimbursements-equipment,D105,HJ,96.49,,65318.17
6515,10/11/2020,10/11/2020,Joseph Zarate,Imported from reimbursements-equipment,D105,HJ,14.24,,65332.41
6515,10/11/2020,10/11/2020,Joseph Zarate,Imported from reimbursements-equipment,D105,HJ,15.09,,65347.5
6515,10/11/2020,10/11/2020,Joseph Zarate,Imported from reimbursements-equipment,D105,HJ,15.09,,65362.59
6515,10/11/2020,10/11/2020,Joseph Zarate,Imported from reimbursements-equipment,D105,HJ,87.39,,65449.98
6515,10/11/2020,10/11/2020,Joseph Zarate,Imported from reimbursements-equipment,D105,HJ,95.37,,65545.35
6515,10/11/2020,10/11/2020,Joseph Zarate,Imported from reimbursements-refund,D105,HJ,,47,65498.35
6515,10/12/2020,10/12/2020,Joseph Zarate,Imported from reimbursements-equipment,D105,HJ,89.97,,65588.32
6515,10/12/2020,10/12/2020,Joseph Zarate,Imported from reimbursements-refund equipment,D105,HJ,,112.01,65476.31
6515,10/12/2020,10/12/2020,Joseph Zarate,Imported from reimbursements-refund equipment,D105,HJ,,112.01,65364.3
6515,10/14/2020,10/14/2020,Joseph Zarate,Imported from reimbursements-equipment,D105,HJ,,23,65341.3
6515,10/14/2020,10/14/2020,Joseph Zarate,Imported from reimbursements-equipment,D105,HJ,23,,65364.3
6515,10/14/2020,10/14/2020,Joseph Zarate,Imported from reimbursements-equipment,D105,HJ,23,,65387.3
6515,10/14/2020,10/14/2020,Joseph Zarate,Imported from reimbursements-equipment,D105,HJ,24.38,,65411.68
6515,10/14/2020,10/14/2020,Joseph Zarate,Imported from reimbursements-equipment,D105,HJ,24.67,,65436.35
6515,10/14/2020,10/14/2020,Joseph Zarate,Imported from reimbursements-equipment,D105,HJ,139.33,,65575.68
6515,10/14/2020,10/14/2020,Joseph Zarate,Imported from reimbursements-equipment return,D105,HJ,,24.67,65551.01
6515,10/15/2020,10/15/2020,Joseph Zarate,Imported from reimbursements-equipment,D105,HJ,,24.38,65526.63
6515,10/15/2020,10/15/2020,Joseph Zarate,Imported from reimbursements-equipment,D105,HJ,43.64,,65570.27
6515,10/15/2020,10/15/2020,Joseph Zarate,Imported from reimbursements-equipment,D105,HJ,104.68,,65674.95
6515,10/15/2020,10/15/2020,Joseph Zarate,Imported from reimbursements-equipment,D105,HJ,142.89,,65817.84
6515,10/15/2020,10/15/2020,Joseph Zarate,Imported from reimbursements-equipment,D105,HJ,209.36,,66027.2
6515,10/15/2020,10/15/2020,Joseph Zarate,Imported from reimbursements-equipment,D105,HJ,599,,66626.2
6515,10/15/2020,10/15/2020,Joseph Zarate,Imported from reimbursements-equipment,D105,HJ,638.98,,67265.18
6515,10/15/2020,10/15/2020,Joseph Zarate,Imported from reimbursements-equipment return,D105,HJ,,23,67242.18
6515,10/16/2020,10/16/2020,Joseph Zarate,Imported from reimbursements-equipment,D105,HJ,83.99,,67326.17
6515,10/17/2020,10/17/2020,Joseph Zarate,Imported from reimbursements-equipment,D105,HJ,119.36,,67445.53
6515,10/19/2020,10/19/2020,Joseph Zarate,Imported from reimbursements-equipment,D105,HJ,25,,67470.53
6515,10/20/2020,10/20/2020,Joseph Zarate,Imported from reimbursements-equipment,D105,HJ,104.68,,67575.21
6515,10/20/2020,10/20/2020,Joseph Zarate,Imported from reimbursements-equipment,D105,HJ,419,,67994.21
6515,10/20/2020,10/20/2020,Joseph Zarate,Imported from reimbursements-equipment,D105,HJ,582,,68576.21
6515,10/20/2020,10/20/2020,Thomas Fischaber,Imported from reimbursements-Fellow laptop testing,D105,HJ,439.89,,69016.1
6515,10/21/2020,10/21/2020,Joseph Zarate,Imported from reimbursements-equipment,D105,HJ,16.29,,69032.39
6515,10/21/2020,10/21/2020,Joseph Zarate,Imported from reimbursements-equipment,D105,HJ,27.98,,69060.37
6515,10/21/2020,10/21/2020,Monivett Acevedo,Imported from reimbursements-Hardware -Laptop and Tech Equipment,D109,HJ,611.01,,69671.38
6515,10/22/2020,10/22/2020,Joseph Zarate,Imported from reimbursements-equipment,D105,HJ,419,,70090.38
6515,10/22/2020,10/22/2020,Joseph Zarate,Imported from reimbursements-equipment,D105,HJ,569,,70659.38
6515,10/22/2020,10/22/2020,Thomas Fischaber,Imported from reimbursements-Computer for new hire,D105,HJ,1085,,71744.38
6515,10/23/2020,10/23/2020,Joseph Zarate,Imported from reimbursements-equipment,D105,HJ,11.99,,71756.37
6515,10/25/2020,10/25/2020,Joseph Zarate,Imported from reimbursements-equipment,D105,HJ,,582,71174.37
6515,10/27/2020,10/27/2020,Tiffany Jordan,Imported from reimbursements-Office Supply,D108,HJ,19.11,,71193.48
6515,10/29/2020,10/29/2020,Joseph Zarate,Imported from reimbursements-equipment,D105,HJ,480,,71673.48
6515,10/29/2020,10/29/2020,Joseph Zarate,Imported from reimbursements-equipment,D105,HJ,629,,72302.48
6515,11/5/2020,11/5/2020,Thomas Fischaber,Imported from Bank of America Visa-Monitor and cable,D109,HJ,410.13,,72712.61
6515,11/9/2020,11/9/2020,Joseph Zarate,Imported from Bank of America Visa-Pilot Program equipment,D105,HJ,3779.93,,76492.54
6515,11/17/2020,11/17/2020,Thomas Fischaber,Imported from Bank of America Visa-Fellow laptop for testing,D109,HJ,,439.89,76052.65
6515,11/23/2020,11/23/2020,Joseph Zarate,Imported from Bank of America Visa-Pilot Program equipment,D105,HJ,509,,76561.65
6515,12/15/2020,12/15/2020,Joseph Zarate,Imported from Bank of America Visa-New hire equipment,D105,HJ,1209,,77770.65
6515,1/8/2021,1/8/2021,Joseph Zarate,Imported from Bank of America Visa-equipment,D105,HJ,745.78,,78516.43
6515,1/13/2021,1/13/2021,Joseph Zarate,Imported from Bank of America Visa-equipment,D105,HJ,564.27,,79080.7
6515,1/21/2021,1/21/2021,Thomas Fischaber,Imported from Bank of America Visa-webcam,D109,HJ,25.63,,79106.33
6515,1/23/2021,1/23/2021,Joseph Zarate,Imported from Bank of America Visa-equipment,D105,HJ,1183.63,,80289.96
6515,1/25/2021,1/25/2021,Thomas Fischaber,Imported from Bank of America Visa-developer machine,D109,HJ,920.36,,81210.32
6515,1/25/2021,1/25/2021,Thomas Fischaber,Imported from Bank of America Visa-development computer,D109,HJ,1688.23,,82898.55
6515,1/26/2021,1/26/2021,Thomas Fischaber,Imported from Bank of America Visa-monitor,D109,HJ,251.95,,83150.5
6515,1/27/2021,1/27/2021,Joseph Zarate,Imported from Bank of America Visa-Equipment,D105,HJ,1183.63,,84334.13
6515,1/27/2021,1/27/2021,Joseph Zarate,Imported from Bank of America Visa-equipment,D105,HJ,609.93,,84944.06
6515,2/3/2021,2/3/2021,Joseph Zarate,Imported from Bank of America Visa-Equipment,D105,HJ,133.98,,85078.04
6515,2/3/2021,2/3/2021,Joseph Zarate,Imported from Bank of America Visa-Equipment,D105,HJ,267.96,,85346
6515,2/3/2021,2/3/2021,Joseph Zarate,Imported from Bank of America Visa-replacement equipment,D105,HJ,28.99,,85374.99
6515,2/4/2021,2/4/2021,Monivett Acevedo,Imported from reimbursements-Traveling Laptop,D105,HJ,962.99,,86337.98
6515,2/6/2021,2/6/2021,Joseph Zarate,Imported from Bank of America Visa-Equipment,D105,HJ,2581.62,,88919.6
6515,2/6/2021,2/6/2021,Joseph Zarate,Imported from Bank of America Visa-Equipment,D105,HJ,1271.54,,90191.14
6515,2/8/2021,2/8/2021,1st half order,HP Chromebooks Purchase-HP Chromebooks Purchase: 165 units on the 1st purchase,D105,HJ,118388.03,,208579.17
6515,2/8/2021,2/8/2021,1st half order,Reverseal of Chromebooks Temp Entry-HP Chromebooks Purchase,D105,HJ,,118388.03,90191.14
6515,2/9/2021,2/9/2021,Antonio Gutierrez,Imported from Bank of America Visa-Laptops for tutors,D105,HJ,16962.28,,107153.42
6515,2/9/2021,2/9/2021,Antonio Gutierrez,Imported from Bank of America Visa-Laptops for tutors,D105,HJ,54877.98,,162031.4
6515,2/9/2021,2/9/2021,Antonio Gutierrez,Imported from Bank of America Visa-Laptops for tutors,D105,HJ,16962.28,,178993.68
6515,2/9/2021,2/9/2021,Antonio Gutierrez,Imported from Bank of America Visa-Laptops for tutors,D105,HJ,10975.6,,189969.28
6515,2/9/2021,2/9/2021,Joseph Zarate,Imported from Bank of America Visa-equipment,D105,HJ,1339.99,,191309.27
6515,2/10/2021,2/10/2021,Joseph Zarate,Imported from Bank of America Visa-Equipment,D105,HJ,26.83,,191336.1
6515,2/10/2021,2/10/2021,Joseph Zarate,Imported from Bank of America Visa-Equipment,D105,HJ,445.96,,191782.06
6515,2/11/2021,2/11/2021,Joseph Zarate,Imported from Bank of America Visa-Equipment,D105,HJ,9.33,,191791.39
6515,2/11/2021,2/11/2021,Joseph Zarate,Imported from Bank of America Visa-Returns,D105,HJ,14.1,,191805.49
6515,2/13/2021,2/13/2021,Joseph Zarate,Imported from Bank of America Visa-equipment,D105,HJ,463.9,,192269.39
6515,2/14/2021,2/14/2021,Joseph Zarate,Imported from Bank of America Visa-equipment,D105,HJ,463.9,,192733.29
6515,2/16/2021,2/16/2021,Joseph Zarate,Imported from Bank of America Visa-Equipment,D105,HJ,460,,193193.29
6515,2/19/2021,2/19/2021,Joseph Zarate,Imported from Bank of America Visa-Equipment,D105,HJ,124.99,,193318.28
6515,2/21/2021,2/21/2021,Joseph Zarate,Imported from Bank of America Visa-Equipment,D105,HJ,104.95,,193423.23
6515,2/25/2021,2/25/2021,Joseph Zarate,Imported from Bank of America Visa-TESTING,D105,HJ,25.49,,193448.72
6515,2/25/2021,2/25/2021,Joseph Zarate,Imported from Bank of America Visa-TESTING,D105,HJ,319.99,,193768.71
6515,2/26/2021,2/26/2021,Joseph Zarate,Imported from Bank of America Visa-Equipment,D105,HJ,1486.44,,195255.15
6515,3/1/2021,3/1/2021,Joseph Zarate,Imported from Bank of America Visa,D109,HJ,10.99,,195266.14
6515,3/1/2021,3/1/2021,Joseph Zarate,Imported from Bank of America Visa,D109,HJ,10.99,,195277.13
6515,3/1/2021,3/1/2021,Joseph Zarate,Imported from Bank of America Visa,D109,HJ,10.99,,195288.12
6515,3/1/2021,3/1/2021,Joseph Zarate,Imported from Bank of America Visa,D109,HJ,11.87,,195299.99
6515,3/1/2021,3/1/2021,Joseph Zarate,Imported from Bank of America Visa,D109,HJ,24.99,,195324.98
6515,3/2/2021,3/2/2021,Joseph Zarate,Imported from Bank of America Visa,D105,HJ,11.76,,195336.74
6515,3/2/2021,3/2/2021,Joseph Zarate,Imported from Bank of America Visa,D105,HJ,42.86,,195379.6
6515,3/2/2021,3/2/2021,Joseph Zarate,Imported from Bank of America Visa,D105,HJ,95.99,,195475.59
6515,3/2/2021,3/2/2021,Joseph Zarate,Imported from Bank of America Visa,D105,HJ,95.99,,195571.58
6515,3/2/2021,3/2/2021,Joseph Zarate,Imported from Bank of America Visa,D105,HJ,95.99,,195667.57
6515,3/2/2021,3/2/2021,Joseph Zarate,Imported from Bank of America Visa,D105,HJ,95.99,,195763.56
6515,3/2/2021,3/2/2021,Thomas Fischaber,Imported from Bank of America Visa,D109,HJ,7.3,,195770.86
6515,3/5/2021,3/5/2021,Joseph Zarate,Imported from Bank of America Visa,D105,HJ,5.99,,195776.85
6515,3/5/2021,3/5/2021,Joseph Zarate,Imported from Bank of America Visa,D105,HJ,95.99,,195872.84
6515,3/5/2021,3/5/2021,Joseph Zarate,Imported from Bank of America Visa,D105,HJ,155.18,,196028.02
6515,3/5/2021,3/5/2021,Joseph Zarate,Imported from Bank of America Visa,D105,HJ,155.19,,196183.21
6515,3/8/2021,3/8/2021,Joseph Zarate,Imported from Bank of America Visa,D105,HJ,2798,,198981.21
6515,3/9/2021,3/9/2021,Joseph Zarate,Imported from Bank of America Visa,D105,HJ,13.02,,198994.23
6515,3/10/2021,3/10/2021,Joseph Zarate,Imported from Bank of America Visa,D105,HJ,13.02,,199007.25
6515,3/10/2021,3/10/2021,Joseph Zarate,Imported from Bank of America Visa,D105,HJ,30.42,,199037.67
6515,3/10/2021,3/10/2021,Joseph Zarate,Imported from Bank of America Visa,D105,HJ,119.99,,199157.66
6515,3/10/2021,3/10/2021,Joseph Zarate,Imported from Bank of America Visa,D105,HJ,199.59,,199357.25
6515,3/10/2021,3/10/2021,Joseph Zarate,Imported from Bank of America Visa,D105,HJ,1566.96,,200924.21
6515,3/10/2021,3/10/2021,Joseph Zarate,Imported from Bank of America Visa,D105,HJ,4490,,205414.21
6515,3/16/2021,3/16/2021,Joseph Zarate,Imported from Bank of America Visa,D105,HJ,13.39,,205427.6
6515,3/16/2021,3/16/2021,Joseph Zarate,Imported from Bank of America Visa,D105,HJ,174.72,,205602.32
6515,3/16/2021,3/16/2021,Joseph Zarate,Imported from Bank of America Visa,D105,HJ,1207.38,,206809.7
6515,3/18/2021,3/18/2021,Joseph Zarate,Imported from Bank of America Visa,D105,HJ,13.99,,206823.69
6515,3/19/2021,3/19/2021,Joseph Zarate,Imported from Bank of America Visa,D105,HJ,9.33,,206833.02
6515,3/19/2021,3/19/2021,Joseph Zarate,Imported from Bank of America Visa,D105,HJ,1339.38,,208172.4
6515,3/22/2021,3/22/2021,Joseph Zarate,Imported from Bank of America Visa,D105,HJ,119.96,,208292.36
6515,3/24/2021,3/24/2021,Joseph Zarate,Imported from Bank of America Visa,D105,HJ,139.46,,208431.82
6515,3/24/2021,3/24/2021,Joseph Zarate,Imported from Bank of America Visa,D105,HJ,1349.99,,209781.81
6515,3/31/2021,3/31/2021,Joseph Zarate,Imported from Bank of America Visa,D105,HJ,1355.38,,211137.19
6515,4/16/2021,4/16/2021,Joseph Zarate,Imported from Bank of America Visa,D105,HJ,1428.99,,212566.18
6515,4/27/2021,4/27/2021,Antonio Gutierrez,Imported from Bank of America Visa,D105,HJ,,996.48,211569.7
6515,4/27/2021,4/27/2021,Antonio Gutierrez,Imported from Bank of America Visa,D105,HJ,,3223.89,208345.81
6515,4/27/2021,4/27/2021,Antonio Gutierrez,Imported from Bank of America Visa,D105,HJ,,996.48,207349.33
6515,4/27/2021,4/27/2021,Antonio Gutierrez,Imported from Bank of America Visa,D105,HJ,,644.78,206704.55
6515,4/27/2021,4/27/2021,Joseph Zarate,Imported from Bank of America Visa,D105,HJ,1365,,208069.55
6515,4/30/2021,4/30/2021,Joseph Zarate,Imported from Bank of America Visa,D105,HJ,1429.98,,209499.53
6515,5/4/2021,5/4/2021,HP Inc.,Bill.Com Import,D105,HJ,115150,,324649.53
6515,5/5/2021,5/5/2021,Joseph Zarate,Imported from Bank of America Visa,D105,HJ,1357.38,,326006.91
6515,5/7/2021,5/7/2021,Joseph Zarate,Imported from Bank of America Visa,D105,HJ,4063.16,,330070.07
6515,5/14/2021,5/14/2021,Joseph Zarate,Imported from Bank of America Visa,D105,HJ,,32.99,330037.08
6515,5/14/2021,5/14/2021,Joseph Zarate,Imported from Bank of America Visa,D105,HJ,1273.94,,331311.02
6515,5/14/2021,5/14/2021,Joseph Zarate,Imported from Bank of America Visa,D105,HJ,1273.94,,332584.96
6515,5/14/2021,5/14/2021,Joseph Zarate,Imported from Bank of America Visa,D105,HJ,2547.88,,335132.84
6515,5/21/2021,5/21/2021,Joseph Zarate,Imported from Bank of America Visa,D105,HJ,1273.94,,336406.78
6515,5/21/2021,5/21/2021,Joseph Zarate,Imported from Bank of America Visa,D105,HJ,1273.94,,337680.72
6515,5/21/2021,5/21/2021,Joseph Zarate,Imported from Bank of America Visa,D105,HJ,399,,338079.72
6515,5/26/2021,5/26/2021,Joseph Zarate,Imported from Bank of America Visa,D105,HJ,,1357.38,336722.34
6515,5/26/2021,5/26/2021,Joseph Zarate,Imported from Bank of America Visa,D105,HJ,,4063.16,332659.18
6515,5/28/2021,5/28/2021,Joseph Zarate,Imported from Bank of America Visa,D105,HJ,4318.16,,336977.34
6515,5/31/2021,5/31/2021,1,HP Chromebook New Profit reclassification,D105,HJ,,16962.28,320015.06
6515,5/31/2021,5/31/2021,1,HP Chromebook New Profit reclassification,D105,HJ,16962.28,,336977.34
6515,5/31/2021,5/31/2021,1,HP Chromebook New Profit reclassification,D105,HJ,,54877.98,282099.36
6515,5/31/2021,5/31/2021,1,HP Chromebook New Profit reclassification,D105,HJ,54877.98,,336977.34
6515,5/31/2021,5/31/2021,1,HP Chromebook New Profit reclassification,D105,HJ,,16962.28,320015.06
6515,5/31/2021,5/31/2021,1,HP Chromebook New Profit reclassification,D105,HJ,16962.28,,336977.34
6515,5/31/2021,5/31/2021,1,HP Chromebook New Profit reclassification,D105,HJ,,10975.6,326001.74
6515,5/31/2021,5/31/2021,1,HP Chromebook New Profit reclassification,D105,HJ,10975.6,,336977.34
6515,6/2/2021,6/2/2021,Joseph Zarate,Imported from Bank of America Visa,D105,HJ,2880.27,,339857.61
6515,6/2/2021,6/2/2021,Joseph Zarate,Imported from Bank of America Visa,D105,HJ,2547.88,,342405.49
6515,6/4/2021,6/4/2021,Joseph Zarate,Imported from Bank of America Visa,D105,HJ,2547.88,,344953.37
6515,6/10/2021,6/10/2021,Joseph Zarate,Imported from Bank of America Visa,D105,HJ,2547.88,,347501.25
6515,6/16/2021,6/16/2021,Joseph Zarate,Imported from Bank of America Visa,D105,HJ,2980.27,,350481.52
6515, Totals for 6515 - Hardware -Laptop and Tech Equipment,,,,,,582263.51,231781.99,350481.52
6550,6550 - Fellow/Staff Swag and Gear (Balance forward As of 07/01/2020) ,,,,,,,,0
6550,2/19/2021,2/19/2021,Brandvia,Bill.Com Import-Purchasing of 30 Cozy Winter Day Gift set,D108,HJ,305.38,,305.38
6550,2/19/2021,2/19/2021,Brandvia,Bill.Com Import-Purchasing of 30 Cozy Winter Day Gift set,D108,HJ,988,,1293.38
6550,2/19/2021,2/19/2021,Brandvia,Bill.Com Import-Purchasing of 30 Cozy Winter Day Gift set,D108,HJ,305.38,,1598.76
6550,2/19/2021,2/19/2021,Brandvia,Bill.Com Import-Purchasing of 30 Cozy Winter Day Gift set,D108,HJ,197.61,,1796.37
6550, Totals for 6550 - Fellow/Staff Swag and Gear,,,,,,1796.37,0,1796.37
6600,6600 - Bank Service Fees and Charges (Balance forward As of 07/01/2020) ,,,,,,,,0
6600,7/1/2020,7/1/2020,Alan Safran,Imported from Bank of America Visa-Monthly bank fee,D103,HJ,15,,15
6600,7/22/2020,7/22/2020,20200722,To record individual donations-To record individual donations,D107,HJ,90,,105
6600,7/24/2020,7/24/2020,Elizabeth Peinado,Imported from Bank of America Visa-International fee for Classmarker,D111,HJ,0.09,,105.09
6600,7/24/2020,7/24/2020,Elizabeth Peinado,Imported from Bank of America Visa-International fee for Classmarker,D111,HJ,0.14,,105.23
6600,7/24/2020,7/24/2020,Elizabeth Peinado,Imported from Bank of America Visa-International fee for Classmarker,D111,HJ,0.14,,105.37
6600,7/24/2020,7/24/2020,Elizabeth Peinado,Imported from Bank of America Visa-International fee for Classmarker,D111,HJ,0.43,,105.8
6600,7/31/2020,7/31/2020,20200731,To record analysis fee and interest earned-To record analysis fee and interest earned,D107,HJ,5.05,,110.85
6600,8/3/2020,8/3/2020,Alan Safran,Imported from Bank of America Visa-Bank Service Fees and Charges,D102,HJ,15,,125.85
6600,8/5/2020,8/5/2020,20200805,Bank fees for individual donation-Bank fees for individual donation,D107,HJ,31.38,,157.23
6600,8/12/2020,8/12/2020,Uriel Guadarrama,Imported from Bank of America Visa-Fee for purchasing Document Studio from an Indian company,D105,HJ,0.78,,158.01
6600,8/17/2020,8/17/2020,20200817,Account analysis fee for #8984-Account analysis fee for #8984,D107,HJ,3.4,,161.41
6600,8/18/2020,8/18/2020,Uriel Guadarrama,Imported from Bank of America Visa-Fee for purchasing Document Studio from an Indian company,D105,HJ,1.19,,162.6
6600,8/24/2020,8/24/2020,Elizabeth Peinado,Imported from Bank of America Visa-international fee for math assessment software,D111,HJ,0.09,,162.69
6600,8/24/2020,8/24/2020,Elizabeth Peinado,Imported from Bank of America Visa-international fee for math assessment software,D111,HJ,0.14,,162.83
6600,8/24/2020,8/24/2020,Elizabeth Peinado,Imported from Bank of America Visa-international fee for math assessment software,D111,HJ,0.14,,162.97
6600,8/24/2020,8/24/2020,Elizabeth Peinado,Imported from Bank of America Visa-international fee for math assessment software,D111,HJ,0.43,,163.4
6600,9/1/2020,9/1/2020,Alan Safran,Imported from Bank of America Visa-Bank Service Fees and Charges,D103,HJ,15,,178.4
6600,9/22/2020,9/22/2020,Elizabeth Peinado,Imported from Bank of America Visa-International fee for math assessment software,D111,HJ,0.09,,178.49
6600,9/22/2020,9/22/2020,Elizabeth Peinado,Imported from Bank of America Visa-International fee for math assessment software,D111,HJ,0.14,,178.63
6600,9/22/2020,9/22/2020,Elizabeth Peinado,Imported from Bank of America Visa-International fee for math assessment software,D111,HJ,0.14,,178.77
6600,9/22/2020,9/22/2020,Elizabeth Peinado,Imported from Bank of America Visa-International fee for math assessment software,D111,HJ,0.43,,179.2
6600,10/1/2020,10/1/2020,20201001-rev,To reverse and correct the GL coding-To write off GL 1210-Old QB GL12002 Richard Hines related,D107,HJ,12964.23,,13143.43
6600,10/1/2020,10/1/2020,Alan Safran,Imported from reimbursements-Bank Service Fees and Charges,D103,HJ,15,,13158.43
6600,10/1/2020,10/1/2020,PPP-Int,To accrue PPP loan interest for October-To accrue PPP loan interest for October 2020-Jun 2021,D107,HJ,137.13,,13295.56
6600,10/1/2020,10/1/2020,PPP-Int,To reverse/forgive the PPP accrued loan interest,D107,HJ,,137.13,13158.43
6600,10/1/2020,10/1/2020,PPP-Int,To reverse/forgive the PPP accrued loan interest,D107,HJ,,137.13,13021.3
6600,10/1/2020,10/1/2020,PPP-Int,To reverse/forgive the PPP accrued loan interest,D107,HJ,,137.13,12884.17
6600,10/1/2020,10/1/2020,PPP-Int,To reverse/forgive the PPP accrued loan interest,D107,HJ,,137.13,12747.04
6600,10/1/2020,10/1/2020,PPP-Int,To reverse/forgive the PPP accrued loan interest,D107,HJ,,137.13,12609.91
6600,10/1/2020,10/1/2020,PPP-Int,To reverse/forgive the PPP accrued loan interest,D107,HJ,,137.13,12472.78
6600,10/15/2020,10/15/2020,20201015,Business account analysis fee-Business account analysis fee,D103,HJ,1.5,,12474.28
6600,10/22/2020,10/22/2020,Elizabeth Peinado,Imported from reimbursements-International fee for math assessment software,D111,HJ,0.09,,12474.37
6600,10/22/2020,10/22/2020,Elizabeth Peinado,Imported from reimbursements-International fee for math assessment software,D111,HJ,0.14,,12474.51
6600,10/22/2020,10/22/2020,Elizabeth Peinado,Imported from reimbursements-International fee for math assessment software,D111,HJ,0.14,,12474.65
6600,10/22/2020,10/22/2020,Elizabeth Peinado,Imported from reimbursements-International fee for math assessment software,D111,HJ,0.43,,12475.08
6600,11/1/2020,11/1/2020,PPP-Int,To accrue PPP loan interest for October-To accrue PPP loan interest for October 2020-Jun 2021,D107,HJ,137.13,,12612.21
6600,11/2/2020,11/2/2020,Alan Safran,Imported from Bank of America Visa-Bank monthly fee,D103,HJ,15,,12627.21
6600,11/16/2020,11/16/2020,20201116,Account analysis fee for November-Account analysis fee for November,D103,HJ,8.7,,12635.91
6600,11/23/2020,11/23/2020,Elizabeth Peinado,Imported from Bank of America Visa-International fee math assessment subscription,D111,HJ,0.09,,12636
6600,11/23/2020,11/23/2020,Elizabeth Peinado,Imported from Bank of America Visa-International fee math assessment subscription,D111,HJ,0.14,,12636.14
6600,11/23/2020,11/23/2020,Elizabeth Peinado,Imported from Bank of America Visa-International fee math assessment subscription,D111,HJ,0.14,,12636.28
6600,11/23/2020,11/23/2020,Elizabeth Peinado,Imported from Bank of America Visa-International fee math assessment subscription,D111,HJ,0.43,,12636.71
6600,12/1/2020,12/1/2020,Alan Safran,Imported from Bank of America Visa-Bank Service Fees and Charges,D103,HJ,15,,12651.71
6600,12/1/2020,12/1/2020,PPP-Int,To accrue PPP loan interest for October-To accrue PPP loan interest for October 2020-Jun 2021,D107,HJ,137.13,,12788.84
6600,12/22/2020,12/22/2020,Elizabeth Peinado,Imported from Bank of America Visa-Internernation Fee for Math Assessment Subscription,D111,HJ,0.09,,12788.93
6600,12/22/2020,12/22/2020,Elizabeth Peinado,Imported from Bank of America Visa-Internernation Fee for Math Assessment Subscription,D111,HJ,0.14,,12789.07
6600,12/22/2020,12/22/2020,Elizabeth Peinado,Imported from Bank of America Visa-Internernation Fee for Math Assessment Subscription,D111,HJ,0.14,,12789.21
6600,12/22/2020,12/22/2020,Elizabeth Peinado,Imported from Bank of America Visa-Internernation Fee for Math Assessment Subscription,D111,HJ,0.43,,12789.64
6600,12/31/2020,12/31/2020,20201231,Actual vs Budget Reclass as of 12/31/2020-Actual vs Budget Reclass as of 12/31/2020,D102,HJ,,15,12774.64
6600,12/31/2020,12/31/2020,20201231,Actual vs Budget Reclass as of 12/31/2020-Actual vs Budget Reclass as of 12/31/2020,D103,HJ,15,,12789.64
6600,12/31/2020,12/31/2020,20201231,Actual vs Budget Reclass as of 12/31/2020-Actual vs Budget Reclass as of 12/31/2020,D107,HJ,,9936.42,2853.22
6600,1/1/2021,1/1/2021,PPP-Int,To accrue PPP loan interest for October-To accrue PPP loan interest for October 2020-Jun 2021,D107,HJ,137.13,,2990.35
6600,1/4/2021,1/4/2021,Alan Safran,Imported from Bank of America Visa-Monthly CC Charge,D103,HJ,15,,3005.35
6600,1/15/2021,1/15/2021,20210115,Acct 8984 Analysis Fee 1005-Acct 8984 Analysis Fee 1005,D103,HJ,1.8,,3007.15
6600,1/22/2021,1/22/2021,Elizabeth Peinado,Imported from Bank of America Visa-Math assessment subscription is international,D111,HJ,0.09,,3007.24
6600,1/22/2021,1/22/2021,Elizabeth Peinado,Imported from Bank of America Visa-Math assessment subscription is international,D111,HJ,0.14,,3007.38
6600,1/22/2021,1/22/2021,Elizabeth Peinado,Imported from Bank of America Visa-Math assessment subscription is international,D111,HJ,0.14,,3007.52
6600,1/22/2021,1/22/2021,Elizabeth Peinado,Imported from Bank of America Visa-Math assessment subscription is international,D111,HJ,0.43,,3007.95
6600,2/1/2021,2/1/2021,Alan Safran,Imported from Bank of America Visa-Bank Service Fees and Charges,D103,HJ,15,,3022.95
6600,2/1/2021,2/1/2021,PPP-Int,To accrue PPP loan interest for October-To accrue PPP loan interest for October 2020-Jun 2021,D107,HJ,137.13,,3160.08
6600,2/16/2021,2/16/2021,20210216,Acct 8984 Analysis Fee 1005 Feb21-Acct 8984 Analysis Fee 1005 Feb21,D103,HJ,77.95,,3238.03
6600,2/22/2021,2/22/2021,Elizabeth Peinado,Imported from Bank of America Visa-International fee for Class Marker,D103,HJ,0.8,,3238.83
6600,3/1/2021,3/1/2021,Alan Safran,Imported from Bank of America Visa,D103,HJ,15,,3253.83
6600,3/1/2021,3/1/2021,PPP-Int,To accrue PPP loan interest for October,D107,HJ,137.13,,3390.96
6600,3/2/2021,3/2/2021,Elizabeth Peinado,Imported from Bank of America Visa,D103,HJ,0.8,,3391.76
6600,3/8/2021,3/8/2021,20210308,Acct 8984 Analysis Fee and Refund 1005 Mar21,D103,HJ,,73.65,3318.11
6600,4/1/2021,4/1/2021,2VTTZG-D3-6,To accrue PPP loan interest for October,D107,HJ,137.13,,3455.24
6600,4/1/2021,4/1/2021,2VTTZG-D3-6,To reverse/forgive the PPP accrued loan interest,D107,HJ,,137.13,3318.11
6600,4/1/2021,4/1/2021,Alan Safran,Imported from Bank of America Visa,D103,HJ,15,,3333.11
6600,4/15/2021,4/15/2021,202103,Acct 8984 Analysis Fee April 2021,D103,HJ,75.9,,3409.01
6600,4/22/2021,4/22/2021,Elizabeth Peinado,Imported from Bank of America Visa,D111,HJ,0.09,,3409.1
6600,4/22/2021,4/22/2021,Elizabeth Peinado,Imported from Bank of America Visa,D111,HJ,0.14,,3409.24
6600,4/22/2021,4/22/2021,Elizabeth Peinado,Imported from Bank of America Visa,D111,HJ,0.14,,3409.38
6600,4/22/2021,4/22/2021,Elizabeth Peinado,Imported from Bank of America Visa,D111,HJ,0.43,,3409.81
6600,4/30/2021,4/30/2021,Alan Safran,Imported from Bank of America Visa,D103,HJ,75,,3484.81
6600,4/30/2021,4/30/2021,Chris D PLACEHOLDER,Imported from Bank of America Visa,D103,HJ,75,,3559.81
6600,4/30/2021,4/30/2021,Uriel Guadarrama,Imported from Bank of America Visa,D103,HJ,75,,3634.81
6600,5/1/2021,5/1/2021,202007-202104,To accrue PPP loan interest for October,D107,HJ,137.13,,3771.94
6600,5/1/2021,5/1/2021,202007-202104,To reverse/forgive the PPP accrued loan interest,D107,HJ,,137.13,3634.81
6600,5/3/2021,5/3/2021,Alan Safran,Imported from Bank of America Visa,D103,HJ,15,,3649.81
6600,5/13/2021,5/13/2021,20210321,Acct 8984 Analysis Fee Refund May 2021,D103,HJ,,75.9,3573.91
6600,5/24/2021,5/24/2021,Elizabeth Peinado,Imported from Bank of America Visa,D111,HJ,0.09,,3574
6600,5/24/2021,5/24/2021,Elizabeth Peinado,Imported from Bank of America Visa,D111,HJ,0.14,,3574.14
6600,5/24/2021,5/24/2021,Elizabeth Peinado,Imported from Bank of America Visa,D111,HJ,0.14,,3574.28
6600,5/24/2021,5/24/2021,Elizabeth Peinado,Imported from Bank of America Visa,D111,HJ,0.43,,3574.71
6600,5/26/2021,5/26/2021,JE-21-054,Adjustment for Currency Difference,D107,HJ,40,,3614.71
6600,5/31/2021,5/31/2021,Antonio Gutierrez,Imported from Bank of America Visa,D103,HJ,75,,3689.71
6600,5/31/2021,5/31/2021,Elizabeth Peinado,Imported from Bank of America Visa,D111,HJ,8.25,,3697.96
6600,5/31/2021,5/31/2021,Elizabeth Peinado,Imported from Bank of America Visa,D111,HJ,12.75,,3710.71
6600,5/31/2021,5/31/2021,Elizabeth Peinado,Imported from Bank of America Visa,D111,HJ,12.75,,3723.46
6600,5/31/2021,5/31/2021,Elizabeth Peinado,Imported from Bank of America Visa,D111,HJ,41.25,,3764.71
6600,6/1/2021,6/1/2021,CD-21-0323,To accrue PPP loan interest for October,D107,HJ,137.13,,3901.84
6600,6/1/2021,6/1/2021,CD-21-0323,To reverse/forgive the PPP accrued loan interest,D107,HJ,,137.13,3764.71
6600,6/10/2021,6/10/2021,Tiffani Bibb,Imported from Bank of America Visa,D104,HJ,0.78,,3765.49
6600,6/21/2021,6/21/2021,Elizabeth Peinado,Imported from Bank of America Visa,D111,HJ,0.09,,3765.58
6600,6/21/2021,6/21/2021,Elizabeth Peinado,Imported from Bank of America Visa,D111,HJ,0.14,,3765.72
6600,6/21/2021,6/21/2021,Elizabeth Peinado,Imported from Bank of America Visa,D111,HJ,0.14,,3765.86
6600,6/21/2021,6/21/2021,Elizabeth Peinado,Imported from Bank of America Visa,D111,HJ,0.43,,3766.29
6600,6/24/2021,6/24/2021,202106,Acct 8984 Analysis Fee June 2021,D103,HJ,2.95,,3769.24
6600,6/30/2021,6/30/2021,Alan Safran,Imported from Bank of America Visa,D103,HJ,15,,3784.24
6600, Totals for 6600 - Bank Service Fees and Charges,,,,,,15119.38,11335.14,3784.24
6720,6720 - Meals All Staff Events (Balance forward As of 07/01/2020) ,,,,,,,,0
6720,4/23/2021,4/23/2021,Myesha Hossain,Imported from Bank of America Visa,D108,HJ,300.02,,300.02
6720,5/4/2021,5/4/2021,Kyra Detone,Imported from Bank of America Visa,D102,HJ,16.15,,316.17
6720, Totals for 6720 - Meals All Staff Events,,,,,,316.17,0,316.17
6730,6730 - Meals Per Diem (Balance forward As of 07/01/2020) ,,,,,,,,0
6730,7/1/2020,7/1/2020,Stephen O'Donnell,Imported from reimbursements-Meal Per Diem,D102,HJ,4.24,,4.24
6730,7/1/2020,7/1/2020,Stephen O'Donnell,Imported from reimbursements-Meal Per Diem,D102,HJ,8.29,,12.53
6730,7/1/2020,7/1/2020,Stephen O'Donnell,Imported from reimbursements-Meal Per Diem,D102,HJ,9.75,,22.28
6730,7/1/2020,7/1/2020,Stephen O'Donnell,Imported from reimbursements-Meal Per Diem,D102,HJ,10.25,,32.53
6730,7/1/2020,7/1/2020,Stephen O'Donnell,Imported from reimbursements-Meal Per Diem,D102,HJ,10.82,,43.35
6730,7/1/2020,7/1/2020,Stephen O'Donnell,Imported from reimbursements-Meal Per Diem,D102,HJ,13.91,,57.26
6730,7/1/2020,7/1/2020,Stephen O'Donnell,Imported from reimbursements-Meal Per Diem,D102,HJ,14.04,,71.3
6730,7/6/2020,7/6/2020,Odalis Polanco,Imported from reimbursements-1st day of new hire Brakfast and lunch,D103,HJ,82.87,,154.17
6730,12/21/2020,12/21/2020,Monivett Acevedo,Imported from Bank of America Visa-Coffee,D107,HJ,7.43,,161.6
6730,12/22/2020,12/22/2020,Monivett Acevedo,Imported from Bank of America Visa-Lunch.Dinner Boston trip,D107,HJ,22.47,,184.07
6730,5/1/2021,5/1/2021,Kyra Detone,Imported from Bank of America Visa,D102,HJ,5,,189.07
6730,5/1/2021,5/1/2021,Kyra Detone,Imported from Bank of America Visa,D102,HJ,9,,198.07
6730,5/1/2021,5/1/2021,Kyra Detone,Imported from Bank of America Visa,D102,HJ,11.75,,209.82
6730,5/1/2021,5/1/2021,Kyra Detone,Imported from Bank of America Visa,D102,HJ,14.6,,224.42
6730,5/4/2021,5/4/2021,Kyra Detone,Imported from Bank of America Visa,D102,HJ,12.75,,237.17
6730,5/24/2021,5/24/2021,Adam Hernan,Imported from reimbursements,D102,HJ,4.55,,241.72
6730,5/24/2021,5/24/2021,Adam Hernan,Imported from reimbursements,D102,HJ,12.2,,253.92
6730,5/24/2021,5/24/2021,Monivett Acevedo,Imported from reimbursements,D107,HJ,1.39,,255.31
6730,5/24/2021,5/24/2021,Monivett Acevedo,Imported from reimbursements,D107,HJ,5.75,,261.06
6730,5/24/2021,5/24/2021,Monivett Acevedo,Imported from reimbursements,D107,HJ,5.97,,267.03
6730,5/24/2021,5/24/2021,Monivett Acevedo,Imported from reimbursements,D107,HJ,6.43,,273.46
6730,5/24/2021,5/24/2021,Monivett Acevedo,Imported from reimbursements,D107,HJ,6.7,,280.16
6730,5/24/2021,5/24/2021,Monivett Acevedo,Imported from reimbursements,D107,HJ,10.06,,290.22
6730,5/28/2021,5/28/2021,Kyra Detone,Imported from Bank of America Visa,D102,HJ,63.68,,353.9
6730,6/8/2021,6/8/2021,Tiffani Bibb,Imported from Bank of America Visa,D104,HJ,26.23,,380.13
6730,6/8/2021,6/8/2021,Tiffani Bibb,Imported from Bank of America Visa,D104,HJ,33.98,,414.11
6730,6/8/2021,6/8/2021,Tiffani Bibb,Imported from Bank of America Visa,D104,HJ,34.55,,448.66
6730,6/8/2021,6/8/2021,Tiffani Bibb,Imported from Bank of America Visa,D104,HJ,125.24,,573.9
6730,6/10/2021,6/10/2021,Monivett Acevedo,Imported from reimbursements,D107,HJ,4.65,,578.55
6730,6/10/2021,6/10/2021,Monivett Acevedo,Imported from reimbursements,D107,HJ,6.37,,584.92
6730,6/10/2021,6/10/2021,Monivett Acevedo,Imported from reimbursements,D107,HJ,6.53,,591.45
6730,6/10/2021,6/10/2021,Monivett Acevedo,Imported from reimbursements,D107,HJ,14.86,,606.31
6730,6/10/2021,6/10/2021,Tiffani Bibb,Imported from Bank of America Visa,D104,HJ,29.2,,635.51
6730,6/10/2021,6/10/2021,Tiffani Bibb,Imported from Bank of America Visa,D104,HJ,74.02,,709.53
6730,6/10/2021,6/10/2021,Tiffani Bibb,Imported from Bank of America Visa,D104,HJ,23.29,,732.82
6730,6/10/2021,6/10/2021,Tiffani Bibb,Imported from Bank of America Visa,D104,HJ,36.17,,768.99
6730,6/28/2021,6/28/2021,Maryellen Leneghan,Imported from Bank of America Visa,D107,HJ,99.45,,868.44
6730,6/28/2021,6/28/2021,Monivett Acevedo,Imported from Bank of America Visa,D107,HJ,14.86,,883.3
6730, Totals for 6730 - Meals Per Diem,,,,,,883.3,0,883.3
6740,6740 - Meals Team Meetings (Balance forward As of 07/01/2020) ,,,,,,,,0
6740,8/21/2020,8/21/2020,Mahaliah Sejour,Imported from Bank of America Visa-DoP/RPOM site placement,D108,HJ,125.62,,125.62
6740,9/1/2020,9/1/2020,Kyra Detone,Imported from Bank of America Visa-Breakfast + Coffee for two; Finance & Grants Meeting,D102,HJ,23.22,,148.84
6740,9/1/2020,9/1/2020,Kyra Detone,Imported from Bank of America Visa-Lunch for two Finance Grants Meeting,D102,HJ,46.75,,195.59
6740,9/1/2020,9/1/2020,Monivett Acevedo,Imported from Bank of America Visa-Meals Team Meetings,D103,HJ,17.65,,213.24
6740,10/1/2020,10/1/2020,Monivett Acevedo,Imported from reimbursements-lunch with Finance team,D103,HJ,52.84,,266.08
6740,10/7/2020,10/7/2020,Odalis Polanco,Imported from reimbursements-Meals Team Meetings,D103,HJ,33,,299.08
6740,2/1/2021,2/1/2021,Monivett Acevedo,Imported from Bank of America Visa-Holiday Dinner for Finance Staff,D107,HJ,195,,494.08
6740,2/11/2021,2/11/2021,Odalis Polanco,Imported from reimbursements-Welcome Lunch with Manuel Pires,D103,HJ,42.8,,536.88
6740,5/5/2021,5/5/2021,Evelyn Villegas,Imported from reimbursements,D108,HJ,134,,670.88
6740,5/5/2021,5/5/2021,Kyra Detone,Imported from Bank of America Visa,D102,HJ,10.75,,681.63
6740,5/5/2021,5/5/2021,Kyra Detone,Imported from Bank of America Visa,D102,HJ,11.45,,693.08
6740,5/5/2021,5/5/2021,Kyra Detone,Imported from Bank of America Visa,D102,HJ,77,,770.08
6740,5/11/2021,5/11/2021,Thomas Fischaber,Imported from Bank of America Visa,D109,HJ,27.25,,797.33
6740,5/11/2021,5/11/2021,Thomas Fischaber,Imported from Bank of America Visa,D109,HJ,35.25,,832.58
6740,5/12/2021,5/12/2021,claice Jackson,Imported from Bank of America Visa,D108,HJ,12.82,,845.4
6740,5/13/2021,5/13/2021,Thomas Fischaber,Imported from Bank of America Visa,D109,HJ,32.64,,878.04
6740,5/20/2021,5/20/2021,Alan Safran,Imported from Bank of America Visa,D107,HJ,59.97,,938.01
6740,5/24/2021,5/24/2021,Alan Safran,Imported from Bank of America Visa,D107,HJ,54.94,,992.95
6740,5/28/2021,5/28/2021,Kyra Detone,Imported from Bank of America Visa,D102,HJ,9.05,,1002
6740,5/28/2021,5/28/2021,Kyra Detone,Imported from Bank of America Visa,D102,HJ,54.74,,1056.74
6740,6/1/2021,6/1/2021,Antonio Gutierrez,Imported from Bank of America Visa,D107,HJ,45,,1101.74
6740,6/10/2021,6/10/2021,Tiffani Bibb,Imported from Bank of America Visa,D104,HJ,133.17,,1234.91
6740,6/17/2021,6/17/2021,Antonio Gutierrez,Imported from Bank of America Visa,D107,HJ,20.54,,1255.45
6740,6/17/2021,6/17/2021,Antonio Gutierrez,Imported from Bank of America Visa,D107,HJ,30.39,,1285.84
6740,6/17/2021,6/17/2021,Antonio Gutierrez,Imported from Bank of America Visa,D107,HJ,118.86,,1404.7
6740,6/21/2021,6/21/2021,Grubhub,Bill.Com Import,D108,HJ,195.12,,1599.82
6740,6/21/2021,6/21/2021,Grubhub,Bill.Com Import,D108,HJ,904.78,,2504.6
6740,6/21/2021,6/21/2021,Grubhub,Bill.Com Import,D101,HJ,168.82,,2673.42
6740,6/21/2021,6/21/2021,Grubhub,Bill.Com Import,D103,HJ,31.8,,2705.22
6740,6/21/2021,6/21/2021,Grubhub,Bill.Com Import,D104,HJ,167.03,,2872.25
6740,6/21/2021,6/21/2021,Grubhub,Bill.Com Import,D107,HJ,31.8,,2904.05
6740,6/21/2021,6/21/2021,Grubhub,Bill.Com Import,D111,HJ,49.57,,2953.62
6740,6/21/2021,6/21/2021,Grubhub,Bill.Com Import,D108,HJ,553.96,,3507.58
6740,6/21/2021,6/21/2021,Grubhub,Bill.Com Import,D108,HJ,63.08,,3570.66
6740,6/28/2021,6/28/2021,Kyra Detone,Imported from Bank of America Visa,D102,HJ,67.63,,3638.29
6740,6/30/2021,6/30/2021,Grubhub,Bill.Com Import,D108,HJ,448.86,,4087.15
6740,6/30/2021,6/30/2021,Grubhub,Bill.Com Import,D108,HJ,2331.17,,6418.32
6740,6/30/2021,6/30/2021,Grubhub,Bill.Com Import,D101,HJ,125.95,,6544.27
6740,6/30/2021,6/30/2021,Grubhub,Bill.Com Import,D111,HJ,158.23,,6702.5
6740,6/30/2021,6/30/2021,Grubhub,Bill.Com Import,D108,HJ,305.59,,7008.09
6740, Totals for 6740 - Meals Team Meetings,,,,,,7008.09,0,7008.09
6750,6750 - Mileage Reimbursement (Balance forward As of 07/01/2020) ,,,,,,,,0
6750,9/29/2020,9/29/2020,Harper Kerkhoff,Imported from reimbursements-FIngerprinting,D108,HJ,609.5,,609.5
6750,10/7/2020,10/7/2020,claice Jackson,Imported from reimbursements-X Co.  Swag Dropoff,D108,HJ,11.5,,621
6750,11/20/2020,11/20/2020,claice Jackson,Imported from reimbursements-Staff Appreciation,D108,HJ,6.9,,627.9
6750,11/20/2020,11/20/2020,claice Jackson,Imported from reimbursements-Staff Appreciation,D108,HJ,10.93,,638.83
6750,11/20/2020,11/20/2020,claice Jackson,Imported from reimbursements-Staff Appreciation,D108,HJ,34.5,,673.33
6750,5/24/2021,5/24/2021,claice Jackson,Imported from reimbursements,D108,HJ,14,,687.33
6750,5/24/2021,5/24/2021,claice Jackson,Imported from reimbursements,D108,HJ,15.12,,702.45
6750,5/24/2021,5/24/2021,claice Jackson,Imported from reimbursements,D108,HJ,16.24,,718.69
6750,6/10/2021,6/10/2021,claice Jackson,Imported from reimbursements,D108,HJ,14.56,,733.25
6750,6/15/2021,6/15/2021,claice Jackson,Imported from reimbursements,D108,HJ,24.64,,757.89
6750,6/15/2021,6/15/2021,claice Jackson,Imported from reimbursements,D108,HJ,33.6,,791.49
6750, Totals for 6750 - Mileage Reimbursement,,,,,,791.49,0,791.49
6755,6755 - Career Fairs Fees (Balance forward As of 07/01/2020) ,,,,,,,,0
6755,9/18/2020,9/18/2020,iaklestad,Imported from Bank of America Visa-SUNY Stony Brook Fair,D111,HJ,75,,75
6755,9/18/2020,9/18/2020,Jennifer Winans,Imported from Bank of America Visa-Career Fair,D111,HJ,125,,200
6755,9/18/2020,9/18/2020,Miranda Cortez,Imported from Bank of America Visa-Career Fairs Fees,D111,HJ,150,,350
6755,9/19/2020,9/19/2020,iaklestad,Imported from Bank of America Visa-CUNY City College Fair,D111,HJ,211,,561
6755,9/21/2020,9/21/2020,Jennifer Winans,Imported from Bank of America Visa-Career Fair,D111,HJ,50,,611
6755,9/21/2020,9/21/2020,Jennifer Winans,Imported from Bank of America Visa-Career Fair,D111,HJ,200,,811
6755,9/21/2020,9/21/2020,Miranda Cortez,Imported from Bank of America Visa-Career Fairs Fees,D111,HJ,100,,911
6755,9/22/2020,9/22/2020,iaklestad,Imported from Bank of America Visa-Tufts Career Fair,D111,HJ,200,,1111
6755,9/23/2020,9/23/2020,iaklestad,Imported from Bank of America Visa-Career Fair,D111,HJ,100,,1211
6755,9/23/2020,9/23/2020,iaklestad,Imported from Bank of America Visa-Valparaiso Career Fair,D111,HJ,100,,1311
6755,9/23/2020,9/23/2020,Jennifer Winans,Imported from Bank of America Visa-Career Fair,D111,HJ,37.5,,1348.5
6755,9/25/2020,9/25/2020,iaklestad,Imported from Bank of America Visa-Career Fair UMich,D111,HJ,150,,1498.5
6755,1/21/2021,1/21/2021,Antonio Gutierrez,Imported from Bank of America Visa-Fellow Recruitment,D111,HJ,30,,1528.5
6755,4/5/2021,4/5/2021,Jennifer Winans,Imported from Bank of America Visa,D111,HJ,100,,1628.5
6755, Totals for 6755 - Career Fairs Fees,,,,,,1628.5,0,1628.5
6756,6756 - Fellow/Tutor Posting (Balance forward As of 07/01/2020) ,,,,,,,,0
6756,7/1/2020,7/1/2020,Elizabeth Peinado,Imported from Bank of America Visa-Job posting for all regions,D111,HJ,82.09,,82.09
6756,7/1/2020,7/1/2020,Elizabeth Peinado,Imported from Bank of America Visa-Job posting for all regions,D111,HJ,126.86,,208.95
6756,7/1/2020,7/1/2020,Elizabeth Peinado,Imported from Bank of America Visa-Job posting for all regions,D111,HJ,126.86,,335.81
6756,7/1/2020,7/1/2020,Elizabeth Peinado,Imported from Bank of America Visa-Job posting for all regions,D111,HJ,410.45,,746.26
6756,7/1/2020,7/1/2020,Elizabeth Peinado,Imported from Bank of America Visa-Job posting for all regions,D111,HJ,500.5,,1246.76
6756,7/1/2020,7/1/2020,Elizabeth Peinado,Imported from Bank of America Visa-Job posting for all regions,D111,HJ,550.65,,1797.41
6756,7/1/2020,7/1/2020,Elizabeth Peinado,Imported from Bank of America Visa-Job posting for all regions,D111,HJ,773.5,,2570.91
6756,7/1/2020,7/1/2020,Elizabeth Peinado,Imported from Bank of America Visa-Job posting for all regions,D111,HJ,773.5,,3344.41
6756,7/1/2020,7/1/2020,Elizabeth Peinado,Imported from Bank of America Visa-Job posting for all regions,D111,HJ,851.01,,4195.42
6756,7/1/2020,7/1/2020,Elizabeth Peinado,Imported from Bank of America Visa-Job posting for all regions,D111,HJ,851.01,,5046.43
6756,7/1/2020,7/1/2020,Elizabeth Peinado,Imported from Bank of America Visa-Job posting for all regions,D111,HJ,2502.5,,7548.93
6756,7/1/2020,7/1/2020,Elizabeth Peinado,Imported from Bank of America Visa-Job posting for all regions,D111,HJ,2753.26,,10302.19
6756,7/8/2020,7/8/2020,Elizabeth Peinado,Imported from Bank of America Visa-Job posting for all regions,D111,HJ,552.97,,10855.16
6756,7/8/2020,7/8/2020,Elizabeth Peinado,Imported from Bank of America Visa-Job posting for all regions,D111,HJ,854.59,,11709.75
6756,7/8/2020,7/8/2020,Elizabeth Peinado,Imported from Bank of America Visa-Job posting for all regions,D111,HJ,854.59,,12564.34
6756,7/8/2020,7/8/2020,Elizabeth Peinado,Imported from Bank of America Visa-Job posting for all regions,D111,HJ,2764.83,,15329.17
6756,7/13/2020,7/13/2020,Stryder,Bill.Com Import-Recruitment Platform. TES Platform and ATS Integration 4.5.2019 4.4.2020,D111,HJ,30000,,45329.17
6756,7/20/2020,7/20/2020,Elizabeth Peinado,Imported from Bank of America Visa-Job posting for all regions,D111,HJ,577.5,,45906.67
6756,7/20/2020,7/20/2020,Elizabeth Peinado,Imported from Bank of America Visa-Job posting for all regions,D111,HJ,892.5,,46799.17
6756,7/20/2020,7/20/2020,Elizabeth Peinado,Imported from Bank of America Visa-Job posting for all regions,D111,HJ,892.5,,47691.67
6756,7/20/2020,7/20/2020,Elizabeth Peinado,Imported from Bank of America Visa-Job posting for all regions,D111,HJ,2887.5,,50579.17
6756,7/22/2020,7/22/2020,Elizabeth Peinado,Imported from Bank of America Visa-Job posting for all regions,D111,HJ,550.95,,51130.12
6756,7/22/2020,7/22/2020,Elizabeth Peinado,Imported from Bank of America Visa-Job posting for all regions,D111,HJ,851.47,,51981.59
6756,7/22/2020,7/22/2020,Elizabeth Peinado,Imported from Bank of America Visa-Job posting for all regions,D111,HJ,851.47,,52833.06
6756,7/22/2020,7/22/2020,Elizabeth Peinado,Imported from Bank of America Visa-Job posting for all regions,D111,HJ,2754.74,,55587.8
6756,7/24/2020,7/24/2020,VIANT US LLC,Bill.Com Import-March Graduate Recruitment. Digital marketing campaign.,D111,HJ,3194.39,,58782.19
6756,7/27/2020,7/27/2020,Elizabeth Peinado,Imported from Bank of America Visa-Job posting for all regions,D111,HJ,551.55,,59333.74
6756,7/27/2020,7/27/2020,Elizabeth Peinado,Imported from Bank of America Visa-Job posting for all regions,D111,HJ,852.39,,60186.13
6756,7/27/2020,7/27/2020,Elizabeth Peinado,Imported from Bank of America Visa-Job posting for all regions,D111,HJ,852.39,,61038.52
6756,7/27/2020,7/27/2020,Elizabeth Peinado,Imported from Bank of America Visa-Job posting for all regions,D111,HJ,2757.74,,63796.26
6756,7/28/2020,7/28/2020,Elizabeth Peinado,Imported from Bank of America Visa-Job posting for all regions,D111,HJ,583,,64379.26
6756,7/28/2020,7/28/2020,Elizabeth Peinado,Imported from Bank of America Visa-Job posting for all regions,D111,HJ,901,,65280.26
6756,7/28/2020,7/28/2020,Elizabeth Peinado,Imported from Bank of America Visa-Job posting for all regions,D111,HJ,901,,66181.26
6756,7/28/2020,7/28/2020,Elizabeth Peinado,Imported from Bank of America Visa-Job posting for all regions,D111,HJ,2915,,69096.26
6756,7/31/2020,7/31/2020,Stryder,Bill.Com Import-Recruitment Platform. TES Platform and ATS Integration 4.5.2020 to 4.4.2021,D108,HJ,962.5,,70058.76
6756,7/31/2020,7/31/2020,Stryder,Bill.Com Import-Recruitment Platform. TES Platform and ATS Integration 4.5.2020 to 4.4.2021,D108,HJ,1487.5,,71546.26
6756,7/31/2020,7/31/2020,Stryder,Bill.Com Import-Recruitment Platform. TES Platform and ATS Integration 4.5.2020 to 4.4.2021,D108,HJ,1487.5,,73033.76
6756,7/31/2020,7/31/2020,Stryder,Bill.Com Import-Recruitment Platform. TES Platform and ATS Integration 4.5.2020 to 4.4.2021,D108,HJ,4812.5,,77846.26
6756,8/1/2020,8/1/2020,Elizabeth Peinado,Imported from Bank of America Visa-Fellow job postings all regions,D111,HJ,551.16,,78397.42
6756,8/1/2020,8/1/2020,Elizabeth Peinado,Imported from Bank of America Visa-Fellow job postings all regions,D111,HJ,851.79,,79249.21
6756,8/1/2020,8/1/2020,Elizabeth Peinado,Imported from Bank of America Visa-Fellow job postings all regions,D111,HJ,851.79,,80101
6756,8/1/2020,8/1/2020,Elizabeth Peinado,Imported from Bank of America Visa-Fellow job postings all regions,D111,HJ,2755.81,,82856.81
6756,8/1/2020,8/1/2020,Elizabeth Peinado,Imported from Bank of America Visa-Fellow job postings . all regions,D111,HJ,1.65,,82858.46
6756,8/1/2020,8/1/2020,Elizabeth Peinado,Imported from Bank of America Visa-Fellow job postings . all regions,D111,HJ,2.55,,82861.01
6756,8/1/2020,8/1/2020,Elizabeth Peinado,Imported from Bank of America Visa-Fellow job postings . all regions,D111,HJ,2.55,,82863.56
6756,8/1/2020,8/1/2020,Elizabeth Peinado,Imported from Bank of America Visa-Fellow job postings . all regions,D111,HJ,8.26,,82871.82
6756,8/2/2020,8/2/2020,Elizabeth Peinado,Imported from Bank of America Visa-Fellow job postings . all regions,D111,HJ,495,,83366.82
6756,8/2/2020,8/2/2020,Elizabeth Peinado,Imported from Bank of America Visa-Fellow job postings . all regions,D111,HJ,765,,84131.82
6756,8/2/2020,8/2/2020,Elizabeth Peinado,Imported from Bank of America Visa-Fellow job postings . all regions,D111,HJ,765,,84896.82
6756,8/2/2020,8/2/2020,Elizabeth Peinado,Imported from Bank of America Visa-Fellow job postings . all regions,D111,HJ,2475,,87371.82
6756,11/17/2020,11/17/2020,Stryder,Bill.Com Import-Recruitment Platform. TES Platform and ATS Integration 4.5.2020 TO 4.4.2021,D111,HJ,8750,,96121.82
6756,1/19/2021,1/19/2021,Antonio Gutierrez,Imported from Bank of America Visa-Fellow Recruitment,D111,HJ,299,,96420.82
6756,1/25/2021,1/25/2021,Antonio Gutierrez,Imported from Bank of America Visa-Fellow Recruitment,D111,HJ,900,,97320.82
6756,1/27/2021,1/27/2021,Antonio Gutierrez,Imported from Bank of America Visa-Fellow Recruitment,D111,HJ,392.53,,97713.35
6756,1/27/2021,1/27/2021,Stryder,Bill.Com Import-Recruitment Platform. TES Platform and ATS Integration 4.5.20 to 4.4.21 4th payment of 4,D111,HJ,1487.5,,99200.85
6756,1/27/2021,1/27/2021,Stryder,Bill.Com Import-Recruitment Platform. TES Platform and ATS Integration 4.5.20 to 4.4.21 4th payment of 4,D111,HJ,4812.5,,104013.35
6756,1/27/2021,1/27/2021,Stryder,Bill.Com Import-Recruitment Platform. TES Platform and ATS Integration 4.5.20 to 4.4.21 4th payment of 4,D111,HJ,1487.5,,105500.85
6756,1/27/2021,1/27/2021,Stryder,Bill.Com Import-Recruitment Platform. TES Platform and ATS Integration 4.5.20 to 4.4.21 4th payment of 4,D111,HJ,962.5,,106463.35
6756,2/1/2021,2/1/2021,Antonio Gutierrez,Imported from Bank of America Visa-Fellow Recruitment,D111,HJ,900,,107363.35
6756,2/1/2021,2/1/2021,Elizabeth Peinado,Imported from Bank of America Visa-Fellow posting for Chicagi,D111,HJ,5000,,112363.35
6756,2/4/2021,2/4/2021,Antonio Gutierrez,Imported from Bank of America Visa-Fellow Recruitment,D111,HJ,900,,113263.35
6756,2/9/2021,2/9/2021,Antonio Gutierrez,Imported from Bank of America Visa-Fellow Recruitment,D111,HJ,900,,114163.35
6756,2/14/2021,2/14/2021,Antonio Gutierrez,Imported from Bank of America Visa-Fellow Recruitment,D111,HJ,900,,115063.35
6756,2/19/2021,2/19/2021,Antonio Gutierrez,Imported from Bank of America Visa-Fellow Recruitment,D111,HJ,899.98,,115963.33
6756,2/19/2021,2/19/2021,Antonio Gutierrez,Imported from Bank of America Visa-Fellow recruitment,D111,HJ,338.99,,116302.32
6756,3/1/2021,3/1/2021,Antonio Gutierrez,Imported from Bank of America Visa,D111,HJ,182.93,,116485.25
6756,3/1/2021,3/1/2021,Antonio Gutierrez,Imported from Bank of America Visa,D111,HJ,900,,117385.25
6756,3/1/2021,3/1/2021,Elizabeth Peinado,Imported from Bank of America Visa,D111,HJ,198,,117583.25
6756,3/1/2021,3/1/2021,Elizabeth Peinado,Imported from Bank of America Visa,D111,HJ,306,,117889.25
6756,3/1/2021,3/1/2021,Elizabeth Peinado,Imported from Bank of America Visa,D111,HJ,306,,118195.25
6756,3/1/2021,3/1/2021,Elizabeth Peinado,Imported from Bank of America Visa,D111,HJ,550,,118745.25
6756,3/1/2021,3/1/2021,Elizabeth Peinado,Imported from Bank of America Visa,D111,HJ,850,,119595.25
6756,3/1/2021,3/1/2021,Elizabeth Peinado,Imported from Bank of America Visa,D111,HJ,850,,120445.25
6756,3/1/2021,3/1/2021,Elizabeth Peinado,Imported from Bank of America Visa,D111,HJ,990,,121435.25
6756,3/1/2021,3/1/2021,Elizabeth Peinado,Imported from Bank of America Visa,D111,HJ,2750,,124185.25
6756,3/1/2021,3/1/2021,Elizabeth Peinado,Imported from Bank of America Visa,D111,HJ,575.52,,124760.77
6756,3/1/2021,3/1/2021,Elizabeth Peinado,Imported from Bank of America Visa,D111,HJ,889.44,,125650.21
6756,3/1/2021,3/1/2021,Elizabeth Peinado,Imported from Bank of America Visa,D111,HJ,889.44,,126539.65
6756,3/1/2021,3/1/2021,Elizabeth Peinado,Imported from Bank of America Visa,D111,HJ,2877.6,,129417.25
6756,3/2/2021,3/2/2021,Antonio Gutierrez,Imported from Bank of America Visa,D111,HJ,900,,130317.25
6756,3/2/2021,3/2/2021,Antonio Gutierrez,Imported from Bank of America Visa,D111,HJ,900,,131217.25
6756,3/3/2021,3/3/2021,Antonio Gutierrez,Imported from Bank of America Visa,D111,HJ,900,,132117.25
6756,3/5/2021,3/5/2021,Antonio Gutierrez,Imported from Bank of America Visa,D111,HJ,900,,133017.25
6756,3/10/2021,3/10/2021,Antonio Gutierrez,Imported from Bank of America Visa,D111,HJ,900,,133917.25
6756,3/16/2021,3/16/2021,Antonio Gutierrez,Imported from Bank of America Visa,D111,HJ,900,,134817.25
6756,3/19/2021,3/19/2021,Elizabeth Peinado,Imported from Bank of America Visa,D111,HJ,511.5,,135328.75
6756,3/19/2021,3/19/2021,Elizabeth Peinado,Imported from Bank of America Visa,D111,HJ,790.5,,136119.25
6756,3/19/2021,3/19/2021,Elizabeth Peinado,Imported from Bank of America Visa,D111,HJ,790.5,,136909.75
6756,3/19/2021,3/19/2021,Elizabeth Peinado,Imported from Bank of America Visa,D111,HJ,2557.5,,139467.25
6756,3/24/2021,3/24/2021,Antonio Gutierrez,Imported from Bank of America Visa,D111,HJ,19.34,,139486.59
6756,4/1/2021,4/1/2021,Elizabeth Peinado,Imported from Bank of America Visa,D111,HJ,550,,140036.59
6756,4/1/2021,4/1/2021,Elizabeth Peinado,Imported from Bank of America Visa,D111,HJ,850,,140886.59
6756,4/1/2021,4/1/2021,Elizabeth Peinado,Imported from Bank of America Visa,D111,HJ,850,,141736.59
6756,4/1/2021,4/1/2021,Elizabeth Peinado,Imported from Bank of America Visa,D111,HJ,2750,,144486.59
6756,4/2/2021,4/2/2021,Antonio Gutierrez,Imported from Bank of America Visa,D111,HJ,900,,145386.59
6756,4/2/2021,4/2/2021,Elizabeth Peinado,Imported from Bank of America Visa,D111,HJ,330,,145716.59
6756,4/2/2021,4/2/2021,Elizabeth Peinado,Imported from Bank of America Visa,D111,HJ,510,,146226.59
6756,4/2/2021,4/2/2021,Elizabeth Peinado,Imported from Bank of America Visa,D111,HJ,510,,146736.59
6756,4/2/2021,4/2/2021,Elizabeth Peinado,Imported from Bank of America Visa,D111,HJ,1650,,148386.59
6756,4/5/2021,4/5/2021,Antonio Gutierrez,Imported from Bank of America Visa,D111,HJ,900,,149286.59
6756,4/16/2021,4/16/2021,Antonio Gutierrez,Imported from Bank of America Visa,D111,HJ,900,,150186.59
6756,4/16/2021,4/16/2021,Antonio Gutierrez,Imported from Bank of America Visa,D111,HJ,1072.91,,151259.5
6756,4/16/2021,4/16/2021,iaklestad,Imported from Bank of America Visa,D111,HJ,199,,151458.5
6756,4/19/2021,4/19/2021,Antonio Gutierrez,Imported from Bank of America Visa,D111,HJ,458.96,,151917.46
6756,4/21/2021,4/21/2021,Antonio Gutierrez,Imported from Bank of America Visa,D111,HJ,900,,152817.46
6756,4/23/2021,4/23/2021,Antonio Gutierrez,Imported from Bank of America Visa,D111,HJ,900,,153717.46
6756,4/23/2021,4/23/2021,WayUp Inc.,Bill.Com Import,D111,HJ,1657.5,,155374.96
6756,4/23/2021,4/23/2021,WayUp Inc.,Bill.Com Import,D111,HJ,5362.5,,160737.46
6756,4/23/2021,4/23/2021,WayUp Inc.,Bill.Com Import,D111,HJ,1657.5,,162394.96
6756,4/23/2021,4/23/2021,WayUp Inc.,Bill.Com Import,D111,HJ,1072.5,,163467.46
6756,4/27/2021,4/27/2021,Antonio Gutierrez,Imported from Bank of America Visa,D111,HJ,135.63,,163603.09
6756,4/27/2021,4/27/2021,Antonio Gutierrez,Imported from Bank of America Visa,D111,HJ,900,,164503.09
6756,4/27/2021,4/27/2021,Stryder,Bill.Com Import,D111,HJ,1785,,166288.09
6756,4/27/2021,4/27/2021,Stryder,Bill.Com Import,D111,HJ,5775,,172063.09
6756,4/27/2021,4/27/2021,Stryder,Bill.Com Import,D111,HJ,1785,,173848.09
6756,4/27/2021,4/27/2021,Stryder,Bill.Com Import,D111,HJ,1155,,175003.09
6756,4/28/2021,4/28/2021,Antonio Gutierrez,Imported from Bank of America Visa,D111,HJ,900,,175903.09
6756,4/28/2021,4/28/2021,Antonio Gutierrez,Imported from Bank of America Visa,D111,HJ,900,,176803.09
6756,5/1/2021,5/1/2021,Elizabeth Peinado,Imported from Bank of America Visa,D111,HJ,214.5,,177017.59
6756,5/1/2021,5/1/2021,Elizabeth Peinado,Imported from Bank of America Visa,D111,HJ,331.5,,177349.09
6756,5/1/2021,5/1/2021,Elizabeth Peinado,Imported from Bank of America Visa,D111,HJ,331.5,,177680.59
6756,5/1/2021,5/1/2021,Elizabeth Peinado,Imported from Bank of America Visa,D111,HJ,548.43,,178229.02
6756,5/1/2021,5/1/2021,Elizabeth Peinado,Imported from Bank of America Visa,D111,HJ,847.57,,179076.59
6756,5/1/2021,5/1/2021,Elizabeth Peinado,Imported from Bank of America Visa,D111,HJ,847.57,,179924.16
6756,5/1/2021,5/1/2021,Elizabeth Peinado,Imported from Bank of America Visa,D111,HJ,1072.5,,180996.66
6756,5/1/2021,5/1/2021,Elizabeth Peinado,Imported from Bank of America Visa,D111,HJ,2742.16,,183738.82
6756,5/1/2021,5/1/2021,Miranda Cortez,Imported from Bank of America Visa,D111,HJ,25,,183763.82
6756,5/1/2021,5/1/2021,Miranda Cortez,Imported from Bank of America Visa,D111,HJ,25,,183788.82
6756,5/10/2021,5/10/2021,Elizabeth Peinado,Imported from Bank of America Visa,D111,HJ,599.62,,184388.44
6756,5/10/2021,5/10/2021,Elizabeth Peinado,Imported from Bank of America Visa,D111,HJ,926.69,,185315.13
6756,5/10/2021,5/10/2021,Elizabeth Peinado,Imported from Bank of America Visa,D111,HJ,926.69,,186241.82
6756,5/10/2021,5/10/2021,Elizabeth Peinado,Imported from Bank of America Visa,D111,HJ,2998.12,,189239.94
6756,5/24/2021,5/24/2021,Elizabeth Peinado,Imported from Bank of America Visa,D111,HJ,525.25,,189765.19
6756,5/24/2021,5/24/2021,Elizabeth Peinado,Imported from Bank of America Visa,D111,HJ,811.75,,190576.94
6756,5/24/2021,5/24/2021,Elizabeth Peinado,Imported from Bank of America Visa,D111,HJ,811.75,,191388.69
6756,5/24/2021,5/24/2021,Elizabeth Peinado,Imported from Bank of America Visa,D111,HJ,2626.25,,194014.94
6756,5/26/2021,5/26/2021,Elizabeth Peinado,Imported from Bank of America Visa,D111,HJ,165,,194179.94
6756,5/26/2021,5/26/2021,Elizabeth Peinado,Imported from Bank of America Visa,D111,HJ,255,,194434.94
6756,5/26/2021,5/26/2021,Elizabeth Peinado,Imported from Bank of America Visa,D111,HJ,255,,194689.94
6756,5/26/2021,5/26/2021,Elizabeth Peinado,Imported from Bank of America Visa,D111,HJ,825,,195514.94
6756,6/1/2021,6/1/2021,Elizabeth Peinado,Imported from Bank of America Visa,D111,HJ,99,,195613.94
6756,6/1/2021,6/1/2021,Elizabeth Peinado,Imported from Bank of America Visa,D111,HJ,153,,195766.94
6756,6/1/2021,6/1/2021,Elizabeth Peinado,Imported from Bank of America Visa,D111,HJ,153,,195919.94
6756,6/1/2021,6/1/2021,Elizabeth Peinado,Imported from Bank of America Visa,D111,HJ,495,,196414.94
6756,6/1/2021,6/1/2021,Elizabeth Peinado,Imported from Bank of America Visa,D111,HJ,541.05,,196955.99
6756,6/1/2021,6/1/2021,Elizabeth Peinado,Imported from Bank of America Visa,D111,HJ,836.17,,197792.16
6756,6/1/2021,6/1/2021,Elizabeth Peinado,Imported from Bank of America Visa,D111,HJ,836.17,,198628.33
6756,6/1/2021,6/1/2021,Elizabeth Peinado,Imported from Bank of America Visa,D111,HJ,2705.26,,201333.59
6756,6/21/2021,6/21/2021,Elizabeth Peinado,Imported from Bank of America Visa,D111,HJ,551.32,,201884.91
6756,6/21/2021,6/21/2021,Elizabeth Peinado,Imported from Bank of America Visa,D111,HJ,852.04,,202736.95
6756,6/21/2021,6/21/2021,Elizabeth Peinado,Imported from Bank of America Visa,D111,HJ,852.04,,203588.99
6756,6/21/2021,6/21/2021,Elizabeth Peinado,Imported from Bank of America Visa,D111,HJ,2756.61,,206345.6
6756,6/21/2021,6/21/2021,iaklestad,Imported from Bank of America Visa,D111,HJ,2000,,208345.6
6756, Totals for 6756 - Fellow/Tutor Posting,,,,,,208345.6,0,208345.6
6757,6757 - Staff Position Posting (Balance forward As of 07/01/2020) ,,,,,,,,0
6757,7/9/2020,7/9/2020,Elizabeth Peinado,Imported from Bank of America Visa-Posting on Ed Week Top School Jobs,D111,HJ,32.45,,32.45
6757,7/9/2020,7/9/2020,Elizabeth Peinado,Imported from Bank of America Visa-Posting on Ed Week Top School Jobs,D111,HJ,32.45,,64.9
6757,7/9/2020,7/9/2020,Elizabeth Peinado,Imported from Bank of America Visa-Posting on Ed Week Top School Jobs,D111,HJ,50.15,,115.05
6757,7/9/2020,7/9/2020,Elizabeth Peinado,Imported from Bank of America Visa-Posting on Ed Week Top School Jobs,D111,HJ,50.15,,165.2
6757,7/9/2020,7/9/2020,Elizabeth Peinado,Imported from Bank of America Visa-Posting on Ed Week Top School Jobs,D111,HJ,50.15,,215.35
6757,7/9/2020,7/9/2020,Elizabeth Peinado,Imported from Bank of America Visa-Posting on Ed Week Top School Jobs,D111,HJ,50.15,,265.5
6757,7/9/2020,7/9/2020,Elizabeth Peinado,Imported from Bank of America Visa-Posting on Ed Week Top School Jobs,D111,HJ,121,,386.5
6757,7/9/2020,7/9/2020,Elizabeth Peinado,Imported from Bank of America Visa-Posting on Ed Week Top School Jobs,D111,HJ,132,,518.5
6757,7/9/2020,7/9/2020,Elizabeth Peinado,Imported from Bank of America Visa-Posting on Ed Week Top School Jobs,D111,HJ,162.25,,680.75
6757,7/9/2020,7/9/2020,Elizabeth Peinado,Imported from Bank of America Visa-Posting on Ed Week Top School Jobs,D111,HJ,162.25,,843
6757,7/9/2020,7/9/2020,Elizabeth Peinado,Imported from Bank of America Visa-Posting on Ed Week Top School Jobs,D111,HJ,187,,1030
6757,7/9/2020,7/9/2020,Elizabeth Peinado,Imported from Bank of America Visa-Posting on Ed Week Top School Jobs,D111,HJ,187,,1217
6757,7/9/2020,7/9/2020,Elizabeth Peinado,Imported from Bank of America Visa-Posting on Ed Week Top School Jobs,D111,HJ,204,,1421
6757,7/9/2020,7/9/2020,Elizabeth Peinado,Imported from Bank of America Visa-Posting on Ed Week Top School Jobs,D111,HJ,204,,1625
6757,7/9/2020,7/9/2020,Elizabeth Peinado,Imported from Bank of America Visa-Posting on Ed Week Top School Jobs,D111,HJ,605,,2230
6757,7/9/2020,7/9/2020,Elizabeth Peinado,Imported from Bank of America Visa-Posting on Ed Week Top School Jobs,D111,HJ,660,,2890
6757,7/21/2020,7/21/2020,Elizabeth Peinado,Imported from Bank of America Visa-Position advertisement across all regions,D111,HJ,12.18,,2902.18
6757,7/21/2020,7/21/2020,Elizabeth Peinado,Imported from Bank of America Visa-Position advertisement across all regions,D111,HJ,18.82,,2921
6757,7/21/2020,7/21/2020,Elizabeth Peinado,Imported from Bank of America Visa-Position advertisement across all regions,D111,HJ,18.82,,2939.82
6757,7/21/2020,7/21/2020,Elizabeth Peinado,Imported from Bank of America Visa-Position advertisement across all regions,D111,HJ,60.91,,3000.73
6757,7/22/2020,7/22/2020,Elizabeth Peinado,Imported from Bank of America Visa-Position advertisement across all regions,D111,HJ,11.04,,3011.77
6757,7/22/2020,7/22/2020,Elizabeth Peinado,Imported from Bank of America Visa-Position advertisement across all regions,D111,HJ,17.05,,3028.82
6757,7/22/2020,7/22/2020,Elizabeth Peinado,Imported from Bank of America Visa-Position advertisement across all regions,D111,HJ,17.05,,3045.87
6757,7/22/2020,7/22/2020,Elizabeth Peinado,Imported from Bank of America Visa-Position advertisement across all regions,D111,HJ,55.18,,3101.05
6757,7/23/2020,7/23/2020,Elizabeth Peinado,Imported from Bank of America Visa-Position advertisement across all regions,D111,HJ,11.07,,3112.12
6757,7/23/2020,7/23/2020,Elizabeth Peinado,Imported from Bank of America Visa-Position advertisement across all regions,D111,HJ,17.11,,3129.23
6757,7/23/2020,7/23/2020,Elizabeth Peinado,Imported from Bank of America Visa-Position advertisement across all regions,D111,HJ,17.11,,3146.34
6757,7/23/2020,7/23/2020,Elizabeth Peinado,Imported from Bank of America Visa-Position advertisement across all regions,D111,HJ,55.33,,3201.67
6757,7/24/2020,7/24/2020,Elizabeth Peinado,Imported from Bank of America Visa-Position advertisement across all regions,D111,HJ,28.59,,3230.26
6757,7/24/2020,7/24/2020,Elizabeth Peinado,Imported from Bank of America Visa-Position advertisement across all regions,D111,HJ,44.19,,3274.45
6757,7/24/2020,7/24/2020,Elizabeth Peinado,Imported from Bank of America Visa-Position advertisement across all regions,D111,HJ,44.19,,3318.64
6757,7/24/2020,7/24/2020,Elizabeth Peinado,Imported from Bank of America Visa-Position advertisement across all regions,D111,HJ,142.98,,3461.62
6757,7/25/2020,7/25/2020,Elizabeth Peinado,Imported from Bank of America Visa-Position advertisement across all regions,D111,HJ,29.42,,3491.04
6757,7/25/2020,7/25/2020,Elizabeth Peinado,Imported from Bank of America Visa-Position advertisement across all regions,D111,HJ,45.47,,3536.51
6757,7/25/2020,7/25/2020,Elizabeth Peinado,Imported from Bank of America Visa-Position advertisement across all regions,D111,HJ,45.47,,3581.98
6757,7/25/2020,7/25/2020,Elizabeth Peinado,Imported from Bank of America Visa-Position advertisement across all regions,D111,HJ,147.12,,3729.1
6757,7/26/2020,7/26/2020,Elizabeth Peinado,Imported from Bank of America Visa-Position advertisement across all regions,D111,HJ,28.66,,3757.76
6757,7/26/2020,7/26/2020,Elizabeth Peinado,Imported from Bank of America Visa-Position advertisement across all regions,D111,HJ,44.29,,3802.05
6757,7/26/2020,7/26/2020,Elizabeth Peinado,Imported from Bank of America Visa-Position advertisement across all regions,D111,HJ,44.29,,3846.34
6757,7/26/2020,7/26/2020,Elizabeth Peinado,Imported from Bank of America Visa-Position advertisement across all regions,D111,HJ,143.28,,3989.62
6757,7/27/2020,7/27/2020,Elizabeth Peinado,Imported from Bank of America Visa-Position advertisement across all regions,D111,HJ,72.01,,4061.63
6757,7/27/2020,7/27/2020,Elizabeth Peinado,Imported from Bank of America Visa-Position advertisement across all regions,D111,HJ,111.29,,4172.92
6757,7/27/2020,7/27/2020,Elizabeth Peinado,Imported from Bank of America Visa-Position advertisement across all regions,D111,HJ,111.29,,4284.21
6757,7/27/2020,7/27/2020,Elizabeth Peinado,Imported from Bank of America Visa-Position advertisement across all regions,D111,HJ,360.04,,4644.25
6757,7/28/2020,7/28/2020,Elizabeth Peinado,Imported from Bank of America Visa-Position advertisement across all regions,D111,HJ,55.53,,4699.78
6757,7/28/2020,7/28/2020,Elizabeth Peinado,Imported from Bank of America Visa-Position advertisement across all regions,D111,HJ,85.81,,4785.59
6757,7/28/2020,7/28/2020,Elizabeth Peinado,Imported from Bank of America Visa-Position advertisement across all regions,D111,HJ,85.81,,4871.4
6757,7/28/2020,7/28/2020,Elizabeth Peinado,Imported from Bank of America Visa-Position advertisement across all regions,D111,HJ,277.63,,5149.03
6757,7/29/2020,7/29/2020,Elizabeth Peinado,Imported from Bank of America Visa-Position advertisement across all regions,D111,HJ,55.47,,5204.5
6757,7/29/2020,7/29/2020,Elizabeth Peinado,Imported from Bank of America Visa-Position advertisement across all regions,D111,HJ,85.73,,5290.23
6757,7/29/2020,7/29/2020,Elizabeth Peinado,Imported from Bank of America Visa-Position advertisement across all regions,D111,HJ,85.73,,5375.96
6757,7/29/2020,7/29/2020,Elizabeth Peinado,Imported from Bank of America Visa-Position advertisement across all regions,D111,HJ,277.37,,5653.33
6757,7/30/2020,7/30/2020,Elizabeth Peinado,Imported from Bank of America Visa-Position advertisement across all regions,D111,HJ,55.44,,5708.77
6757,7/30/2020,7/30/2020,Elizabeth Peinado,Imported from Bank of America Visa-Position advertisement across all regions,D111,HJ,85.68,,5794.45
6757,7/30/2020,7/30/2020,Elizabeth Peinado,Imported from Bank of America Visa-Position advertisement across all regions,D111,HJ,85.68,,5880.13
6757,7/30/2020,7/30/2020,Elizabeth Peinado,Imported from Bank of America Visa-Position advertisement across all regions,D111,HJ,277.19,,6157.32
6757,7/31/2020,7/31/2020,Elizabeth Peinado,Imported from Bank of America Visa-Position advertisement across all regions,D111,HJ,105.85,,6263.17
6757,7/31/2020,7/31/2020,Elizabeth Peinado,Imported from Bank of America Visa-Position advertisement across all regions,D111,HJ,163.59,,6426.76
6757,7/31/2020,7/31/2020,Elizabeth Peinado,Imported from Bank of America Visa-Position advertisement across all regions,D111,HJ,163.59,,6590.35
6757,7/31/2020,7/31/2020,Elizabeth Peinado,Imported from Bank of America Visa-Position advertisement across all regions,D111,HJ,529.25,,7119.6
6757,9/1/2020,9/1/2020,Elizabeth Peinado,Imported from Bank of America Visa-Staf postings. all regions depts,D111,HJ,2.94,,7122.54
6757,9/1/2020,9/1/2020,Elizabeth Peinado,Imported from Bank of America Visa-Staf postings. all regions depts,D111,HJ,4.54,,7127.08
6757,9/1/2020,9/1/2020,Elizabeth Peinado,Imported from Bank of America Visa-Staf postings. all regions depts,D111,HJ,4.54,,7131.62
6757,9/1/2020,9/1/2020,Elizabeth Peinado,Imported from Bank of America Visa-Staf postings. all regions depts,D111,HJ,14.71,,7146.33
6757,9/1/2020,9/1/2020,Elizabeth Peinado,Imported from Bank of America Visa-Staf postings. all regions depts,D111,HJ,346.5,,7492.83
6757,9/1/2020,9/1/2020,Elizabeth Peinado,Imported from Bank of America Visa-Staf postings. all regions depts,D111,HJ,535.5,,8028.33
6757,9/1/2020,9/1/2020,Elizabeth Peinado,Imported from Bank of America Visa-Staf postings. all regions depts,D111,HJ,535.5,,8563.83
6757,9/1/2020,9/1/2020,Elizabeth Peinado,Imported from Bank of America Visa-Staf postings. all regions depts,D111,HJ,551.4,,9115.23
6757,9/1/2020,9/1/2020,Elizabeth Peinado,Imported from Bank of America Visa-Staf postings. all regions depts,D111,HJ,852.17,,9967.4
6757,9/1/2020,9/1/2020,Elizabeth Peinado,Imported from Bank of America Visa-Staf postings. all regions depts,D111,HJ,852.17,,10819.57
6757,9/1/2020,9/1/2020,Elizabeth Peinado,Imported from Bank of America Visa-Staf postings. all regions depts,D111,HJ,1732.5,,12552.07
6757,9/1/2020,9/1/2020,Elizabeth Peinado,Imported from Bank of America Visa-Staf postings. all regions depts,D111,HJ,2757.01,,15309.08
6757,9/25/2020,9/25/2020,Elizabeth Peinado,Imported from Bank of America Visa-Staf postings. all regions depts,D111,HJ,39.93,,15349.01
6757,9/25/2020,9/25/2020,Elizabeth Peinado,Imported from Bank of America Visa-Staf postings. all regions depts,D111,HJ,61.7,,15410.71
6757,9/25/2020,9/25/2020,Elizabeth Peinado,Imported from Bank of America Visa-Staf postings. all regions depts,D111,HJ,61.7,,15472.41
6757,9/25/2020,9/25/2020,Elizabeth Peinado,Imported from Bank of America Visa-Staf postings. all regions depts,D111,HJ,199.63,,15672.04
6757,10/1/2020,10/1/2020,Elizabeth Peinado,Imported from reimbursements-Advertising staff roles,D111,HJ,415.19,,16087.23
6757,10/1/2020,10/1/2020,Elizabeth Peinado,Imported from reimbursements-Advertising staff roles,D111,HJ,641.65,,16728.88
6757,10/1/2020,10/1/2020,Elizabeth Peinado,Imported from reimbursements-Advertising staff roles,D111,HJ,641.65,,17370.53
6757,10/1/2020,10/1/2020,Elizabeth Peinado,Imported from reimbursements-Advertising staff roles,D111,HJ,2075.94,,19446.47
6757,10/2/2020,10/2/2020,Elizabeth Peinado,Imported from reimbursements-Advertising staff roles,D111,HJ,280.5,,19726.97
6757,10/2/2020,10/2/2020,Elizabeth Peinado,Imported from reimbursements-Advertising staff roles,D111,HJ,433.5,,20160.47
6757,10/2/2020,10/2/2020,Elizabeth Peinado,Imported from reimbursements-Advertising staff roles,D111,HJ,433.5,,20593.97
6757,10/2/2020,10/2/2020,Elizabeth Peinado,Imported from reimbursements-Advertising staff roles,D111,HJ,1402.5,,21996.47
6757,11/1/2020,11/1/2020,Elizabeth Peinado,Imported from Bank of America Visa-Staff posting and advertising,D111,HJ,69.27,,22065.74
6757,11/1/2020,11/1/2020,Elizabeth Peinado,Imported from Bank of America Visa-Staff posting and advertising,D111,HJ,107.06,,22172.8
6757,11/1/2020,11/1/2020,Elizabeth Peinado,Imported from Bank of America Visa-Staff posting and advertising,D111,HJ,107.06,,22279.86
6757,11/1/2020,11/1/2020,Elizabeth Peinado,Imported from Bank of America Visa-Staff posting and advertising,D111,HJ,346.35,,22626.21
6757,11/13/2020,11/13/2020,iaklestad,Imported from Bank of America Visa-Job Board,D111,HJ,495,,23121.21
6757,4/13/2021,4/13/2021,Jennifer Winans,Imported from Bank of America Visa,D111,HJ,40,,23161.21
6757,4/16/2021,4/16/2021,Elizabeth Peinado,Imported from Bank of America Visa,D111,HJ,550.09,,23711.3
6757,4/16/2021,4/16/2021,Elizabeth Peinado,Imported from Bank of America Visa,D111,HJ,850.14,,24561.44
6757,4/16/2021,4/16/2021,Elizabeth Peinado,Imported from Bank of America Visa,D111,HJ,850.14,,25411.58
6757,4/16/2021,4/16/2021,Elizabeth Peinado,Imported from Bank of America Visa,D111,HJ,2750.44,,28162.02
6757,4/16/2021,4/16/2021,iaklestad,Imported from Bank of America Visa,D111,HJ,99,,28261.02
6757,4/16/2021,4/16/2021,iaklestad,Imported from Bank of America Visa,D111,HJ,199,,28460.02
6757,4/19/2021,4/19/2021,iaklestad,Imported from Bank of America Visa,D111,HJ,3.98,,28464
6757,4/19/2021,4/19/2021,iaklestad,Imported from Bank of America Visa,D111,HJ,25,,28489
6757,4/23/2021,4/23/2021,Elizabeth Peinado,Imported from Bank of America Visa,D111,HJ,551.48,,29040.48
6757,4/23/2021,4/23/2021,Elizabeth Peinado,Imported from Bank of America Visa,D111,HJ,852.29,,29892.77
6757,4/23/2021,4/23/2021,Elizabeth Peinado,Imported from Bank of America Visa,D111,HJ,852.29,,30745.06
6757,4/23/2021,4/23/2021,Elizabeth Peinado,Imported from Bank of America Visa,D111,HJ,2757.4,,33502.46
6757,5/1/2021,5/1/2021,Elizabeth Peinado,Imported from Bank of America Visa,D111,HJ,12.63,,33515.09
6757,5/1/2021,5/1/2021,Elizabeth Peinado,Imported from Bank of America Visa,D111,HJ,19.53,,33534.62
6757,5/1/2021,5/1/2021,Elizabeth Peinado,Imported from Bank of America Visa,D111,HJ,19.53,,33554.15
6757,5/1/2021,5/1/2021,Elizabeth Peinado,Imported from Bank of America Visa,D111,HJ,63.17,,33617.32
6757,5/1/2021,5/1/2021,Elizabeth Peinado,Imported from Bank of America Visa,D111,HJ,81.62,,33698.94
6757,5/1/2021,5/1/2021,Elizabeth Peinado,Imported from Bank of America Visa,D111,HJ,126.14,,33825.08
6757,5/1/2021,5/1/2021,Elizabeth Peinado,Imported from Bank of America Visa,D111,HJ,126.14,,33951.22
6757,5/1/2021,5/1/2021,Elizabeth Peinado,Imported from Bank of America Visa,D111,HJ,408.1,,34359.32
6757,5/1/2021,5/1/2021,Elizabeth Peinado,Imported from Bank of America Visa,D111,HJ,414.91,,34774.23
6757,5/1/2021,5/1/2021,Elizabeth Peinado,Imported from Bank of America Visa,D111,HJ,641.22,,35415.45
6757,5/1/2021,5/1/2021,Elizabeth Peinado,Imported from Bank of America Visa,D111,HJ,641.22,,36056.67
6757,5/1/2021,5/1/2021,Elizabeth Peinado,Imported from Bank of America Visa,D111,HJ,2074.53,,38131.2
6757,5/3/2021,5/3/2021,Elizabeth Peinado,Imported from Bank of America Visa,D111,HJ,26.9,,38158.1
6757,5/3/2021,5/3/2021,Elizabeth Peinado,Imported from Bank of America Visa,D111,HJ,41.58,,38199.68
6757,5/3/2021,5/3/2021,Elizabeth Peinado,Imported from Bank of America Visa,D111,HJ,41.58,,38241.26
6757,5/3/2021,5/3/2021,Elizabeth Peinado,Imported from Bank of America Visa,D111,HJ,134.5,,38375.76
6757,5/4/2021,5/4/2021,Elizabeth Peinado,Imported from Bank of America Visa,D111,HJ,15.46,,38391.22
6757,5/4/2021,5/4/2021,Elizabeth Peinado,Imported from Bank of America Visa,D111,HJ,23.9,,38415.12
6757,5/4/2021,5/4/2021,Elizabeth Peinado,Imported from Bank of America Visa,D111,HJ,23.9,,38439.02
6757,5/4/2021,5/4/2021,Elizabeth Peinado,Imported from Bank of America Visa,D111,HJ,77.32,,38516.34
6757,5/21/2021,5/21/2021,iaklestad,Imported from Bank of America Visa,D111,HJ,350,,38866.34
6757,5/24/2021,5/24/2021,iaklestad,Imported from Bank of America Visa,D111,HJ,100,,38966.34
6757,5/24/2021,5/24/2021,iaklestad,Imported from Bank of America Visa,D111,HJ,100,,39066.34
6757,5/24/2021,5/24/2021,iaklestad,Imported from Bank of America Visa,D111,HJ,100,,39166.34
6757,5/24/2021,5/24/2021,iaklestad,Imported from Bank of America Visa,D111,HJ,250,,39416.34
6757,5/24/2021,5/24/2021,iaklestad,Imported from Bank of America Visa,D111,HJ,250,,39666.34
6757,6/18/2021,6/18/2021,iaklestad,Imported from Bank of America Visa,D111,HJ,460,,40126.34
6757,6/23/2021,6/23/2021,Elizabeth Peinado,Imported from Bank of America Visa,D111,HJ,5.53,,40131.87
6757,6/23/2021,6/23/2021,Elizabeth Peinado,Imported from Bank of America Visa,D111,HJ,8.54,,40140.41
6757,6/23/2021,6/23/2021,Elizabeth Peinado,Imported from Bank of America Visa,D111,HJ,8.54,,40148.95
6757,6/23/2021,6/23/2021,Elizabeth Peinado,Imported from Bank of America Visa,D111,HJ,27.64,,40176.59
6757,6/24/2021,6/24/2021,Elizabeth Peinado,Imported from Bank of America Visa,D111,HJ,14.97,,40191.56
6757,6/24/2021,6/24/2021,Elizabeth Peinado,Imported from Bank of America Visa,D111,HJ,23.14,,40214.7
6757,6/24/2021,6/24/2021,Elizabeth Peinado,Imported from Bank of America Visa,D111,HJ,23.14,,40237.84
6757,6/24/2021,6/24/2021,Elizabeth Peinado,Imported from Bank of America Visa,D111,HJ,74.86,,40312.7
6757,6/28/2021,6/28/2021,Elizabeth Peinado,Imported from Bank of America Visa,D111,HJ,11.87,,40324.57
6757,6/28/2021,6/28/2021,Elizabeth Peinado,Imported from Bank of America Visa,D111,HJ,18.34,,40342.91
6757,6/28/2021,6/28/2021,Elizabeth Peinado,Imported from Bank of America Visa,D111,HJ,18.34,,40361.25
6757,6/28/2021,6/28/2021,Elizabeth Peinado,Imported from Bank of America Visa,D111,HJ,59.33,,40420.58
6757, Totals for 6757 - Staff Position Posting,,,,,,40420.58,0,40420.58
6758,6758 - Marketing Promotional Cost (Balance forward As of 07/01/2020) ,,,,,,,,0
6758,7/7/2020,7/7/2020,Antonio Gutierrez,Imported from Bank of America Visa-Fellow Recruitment,D107,HJ,900,,900
6758,7/8/2020,7/8/2020,Antonio Gutierrez,Imported from Bank of America Visa-X Co.  Website Fellow Recruitment,D107,HJ,77.94,,977.94
6758,7/9/2020,7/9/2020,Antonio Gutierrez,Imported from Bank of America Visa-Fellow Recruitment,D107,HJ,900,,1877.94
6758,7/11/2020,7/11/2020,Antonio Gutierrez,Imported from Bank of America Visa-Fellow Recruitment,D107,HJ,900,,2777.94
6758,7/12/2020,7/12/2020,Antonio Gutierrez,Imported from Bank of America Visa-Fellow Recruitment,D107,HJ,900,,3677.94
6758,7/13/2020,7/13/2020,Antonio Gutierrez,Imported from Bank of America Visa-Fellow Recruitment,D102,HJ,531.92,,4209.86
6758,7/14/2020,7/14/2020,Antonio Gutierrez,Imported from Bank of America Visa-Fellow Recruitment,D107,HJ,900,,5109.86
6758,7/16/2020,7/16/2020,Antonio Gutierrez,Imported from Bank of America Visa-Fellow Recruitment,D107,HJ,900,,6009.86
6758,7/17/2020,7/17/2020,Antonio Gutierrez,Imported from Bank of America Visa-Fellow Recruitment,D107,HJ,900,,6909.86
6758,7/18/2020,7/18/2020,Antonio Gutierrez,Imported from Bank of America Visa-Fellow Recruitment,D107,HJ,900,,7809.86
6758,7/19/2020,7/19/2020,Antonio Gutierrez,Imported from Bank of America Visa-Fellow Recruitment,D107,HJ,299,,8108.86
6758,7/19/2020,7/19/2020,Antonio Gutierrez,Imported from Bank of America Visa-Fellow Recruitment,D107,HJ,900,,9008.86
6758,7/20/2020,7/20/2020,Antonio Gutierrez,Imported from Bank of America Visa-Fellow Recruitment,D107,HJ,900,,9908.86
6758,7/20/2020,7/20/2020,Antonio Gutierrez,Imported from Bank of America Visa-X Co.  Website Fellow Recruitment,D107,HJ,300,,10208.86
6758,7/21/2020,7/21/2020,Antonio Gutierrez,Imported from Bank of America Visa-Fellow Recruitment,D107,HJ,900,,11108.86
6758,7/22/2020,7/22/2020,Antonio Gutierrez,Imported from Bank of America Visa-Fellow Recruitment,D107,HJ,900,,12008.86
6758,7/23/2020,7/23/2020,Antonio Gutierrez,Imported from Bank of America Visa-Fellow Recruitment,D107,HJ,900,,12908.86
6758,7/24/2020,7/24/2020,Antonio Gutierrez,Imported from Bank of America Visa-Fellow Recruitment,D107,HJ,900,,13808.86
6758,7/25/2020,7/25/2020,Antonio Gutierrez,Imported from Bank of America Visa-Fellow Recruitment,D107,HJ,900,,14708.86
6758,7/26/2020,7/26/2020,Antonio Gutierrez,Imported from Bank of America Visa-Fellow Recruitment,D107,HJ,900,,15608.86
6758,7/27/2020,7/27/2020,Antonio Gutierrez,Imported from Bank of America Visa-Fellow Recruitment,D107,HJ,215.96,,15824.82
6758,7/27/2020,7/27/2020,Antonio Gutierrez,Imported from Bank of America Visa-Fellow Recruitment,D107,HJ,900,,16724.82
6758,7/28/2020,7/28/2020,Antonio Gutierrez,Imported from Bank of America Visa-Fellow Recruitment,D107,HJ,900,,17624.82
6758,7/28/2020,7/28/2020,Antonio Gutierrez,Imported from Bank of America Visa-Fellow Recruitment,D107,HJ,900,,18524.82
6758,7/29/2020,7/29/2020,Antonio Gutierrez,Imported from Bank of America Visa-Fellow Recruitment,D107,HJ,900,,19424.82
6758,7/30/2020,7/30/2020,Antonio Gutierrez,Imported from Bank of America Visa-Fellow Recruitment,D107,HJ,900,,20324.82
6758,7/31/2020,7/31/2020,Antonio Gutierrez,Imported from Bank of America Visa-Fellow Recruitment,D107,HJ,900,,21224.82
6758,8/1/2020,8/1/2020,Antonio Gutierrez,Imported from Bank of America Visa-Fellow Recruitment,D107,HJ,900,,22124.82
6758,8/1/2020,8/1/2020,Antonio Gutierrez,Imported from Bank of America Visa-Fellow Recruitment,D107,HJ,900,,23024.82
6758,8/1/2020,8/1/2020,Antonio Gutierrez,Imported from Bank of America Visa-Fellow Recruitment,D107,HJ,900,,23924.82
6758,8/1/2020,8/1/2020,Antonio Gutierrez,Imported from Bank of America Visa-Fellow Recruitment,D107,HJ,900,,24824.82
6758,8/1/2020,8/1/2020,Elizabeth Peinado,Imported from Bank of America Visa-Fellow Staff advertising Brand Awareness,D111,HJ,108.61,,24933.43
6758,8/1/2020,8/1/2020,Elizabeth Peinado,Imported from Bank of America Visa-Fellow Staff advertising Brand Awareness,D111,HJ,167.85,,25101.28
6758,8/1/2020,8/1/2020,Elizabeth Peinado,Imported from Bank of America Visa-Fellow Staff advertising Brand Awareness,D111,HJ,167.85,,25269.13
6758,8/1/2020,8/1/2020,Elizabeth Peinado,Imported from Bank of America Visa-Fellow Staff advertising Brand Awareness,D111,HJ,543.06,,25812.19
6758,8/2/2020,8/2/2020,Antonio Gutierrez,Imported from Bank of America Visa-Fellow Recruitment,D107,HJ,900,,26712.19
6758,8/2/2020,8/2/2020,Antonio Gutierrez,Imported from Bank of America Visa-Fellow Recruitment,D107,HJ,900,,27612.19
6758,8/2/2020,8/2/2020,Elizabeth Peinado,Imported from Bank of America Visa-Fellow Staff advertising. Brand Awareness,D111,HJ,63.77,,27675.96
6758,8/2/2020,8/2/2020,Elizabeth Peinado,Imported from Bank of America Visa-Fellow Staff advertising. Brand Awareness,D111,HJ,98.56,,27774.52
6758,8/2/2020,8/2/2020,Elizabeth Peinado,Imported from Bank of America Visa-Fellow Staff advertising. Brand Awareness,D111,HJ,98.56,,27873.08
6758,8/2/2020,8/2/2020,Elizabeth Peinado,Imported from Bank of America Visa-Fellow Staff advertising. Brand Awareness,D111,HJ,318.86,,28191.94
6758,8/3/2020,8/3/2020,Antonio Gutierrez,Imported from Bank of America Visa-Fellow Recruitment,D107,HJ,900,,29091.94
6758,8/3/2020,8/3/2020,Antonio Gutierrez,Imported from Bank of America Visa-Fellow Recruitment,D107,HJ,900,,29991.94
6758,8/3/2020,8/3/2020,Antonio Gutierrez,Imported from Bank of America Visa-Fellow Recruitment,D107,HJ,900,,30891.94
6758,8/3/2020,8/3/2020,Elizabeth Peinado,Imported from Bank of America Visa-Fellow Staff advertising. Brand Awareness,D111,HJ,62.03,,30953.97
6758,8/3/2020,8/3/2020,Elizabeth Peinado,Imported from Bank of America Visa-Fellow Staff advertising. Brand Awareness,D111,HJ,95.86,,31049.83
6758,8/3/2020,8/3/2020,Elizabeth Peinado,Imported from Bank of America Visa-Fellow Staff advertising. Brand Awareness,D111,HJ,95.86,,31145.69
6758,8/3/2020,8/3/2020,Elizabeth Peinado,Imported from Bank of America Visa-Fellow Staff advertising. Brand Awareness,D111,HJ,310.14,,31455.83
6758,8/4/2020,8/4/2020,Antonio Gutierrez,Imported from Bank of America Visa-Fellow Recruitment,D107,HJ,900,,32355.83
6758,8/4/2020,8/4/2020,Antonio Gutierrez,Imported from Bank of America Visa-Fellow Recruitment,D107,HJ,900,,33255.83
6758,8/4/2020,8/4/2020,Elizabeth Peinado,Imported from Bank of America Visa-Fellow Staff advertising. Brand Awareness,D111,HJ,56.86,,33312.69
6758,8/4/2020,8/4/2020,Elizabeth Peinado,Imported from Bank of America Visa-Fellow Staff advertising. Brand Awareness,D111,HJ,87.88,,33400.57
6758,8/4/2020,8/4/2020,Elizabeth Peinado,Imported from Bank of America Visa-Fellow Staff advertising. Brand Awareness,D111,HJ,87.88,,33488.45
6758,8/4/2020,8/4/2020,Elizabeth Peinado,Imported from Bank of America Visa-Fellow Staff advertising. Brand Awareness,D111,HJ,284.3,,33772.75
6758,8/5/2020,8/5/2020,Antonio Gutierrez,Imported from Bank of America Visa-Fellow Recruitment,D107,HJ,900,,34672.75
6758,8/5/2020,8/5/2020,Elizabeth Peinado,Imported from Bank of America Visa-Fellow Staff advertising. Brand Awareness,D111,HJ,21.48,,34694.23
6758,8/5/2020,8/5/2020,Elizabeth Peinado,Imported from Bank of America Visa-Fellow Staff advertising. Brand Awareness,D111,HJ,33.19,,34727.42
6758,8/5/2020,8/5/2020,Elizabeth Peinado,Imported from Bank of America Visa-Fellow Staff advertising. Brand Awareness,D111,HJ,33.19,,34760.61
6758,8/5/2020,8/5/2020,Elizabeth Peinado,Imported from Bank of America Visa-Fellow Staff advertising. Brand Awareness,D111,HJ,107.38,,34867.99
6758,8/6/2020,8/6/2020,Elizabeth Peinado,Imported from Bank of America Visa-Fellow Staff advertising. Brand Awareness,D111,HJ,40.22,,34908.21
6758,8/6/2020,8/6/2020,Elizabeth Peinado,Imported from Bank of America Visa-Fellow Staff advertising. Brand Awareness,D111,HJ,62.16,,34970.37
6758,8/6/2020,8/6/2020,Elizabeth Peinado,Imported from Bank of America Visa-Fellow Staff advertising. Brand Awareness,D111,HJ,62.16,,35032.53
6758,8/6/2020,8/6/2020,Elizabeth Peinado,Imported from Bank of America Visa-Fellow Staff advertising. Brand Awareness,D111,HJ,201.08,,35233.61
6758,8/18/2020,8/18/2020,Elizabeth Peinado,Imported from Bank of America Visa-Fellow Staff advertising. Brand Awareness,D111,HJ,6.6,,35240.21
6758,8/18/2020,8/18/2020,Elizabeth Peinado,Imported from Bank of America Visa-Fellow Staff advertising. Brand Awareness,D111,HJ,10.2,,35250.41
6758,8/18/2020,8/18/2020,Elizabeth Peinado,Imported from Bank of America Visa-Fellow Staff advertising. Brand Awareness,D111,HJ,10.2,,35260.61
6758,8/18/2020,8/18/2020,Elizabeth Peinado,Imported from Bank of America Visa-Fellow Staff advertising. Brand Awareness,D111,HJ,33,,35293.61
6758,8/19/2020,8/19/2020,Antonio Gutierrez,Imported from Bank of America Visa-Fellow Recruitment,D107,HJ,299,,35592.61
6758,8/19/2020,8/19/2020,Antonio Gutierrez,Imported from Bank of America Visa-website,D107,HJ,637.48,,36230.09
6758,8/20/2020,8/20/2020,Elizabeth Peinado,Imported from Bank of America Visa-Fellow Staff advertising. Brand Awareness,D111,HJ,11.23,,36241.32
6758,8/20/2020,8/20/2020,Elizabeth Peinado,Imported from Bank of America Visa-Fellow Staff advertising. Brand Awareness,D111,HJ,17.35,,36258.67
6758,8/20/2020,8/20/2020,Elizabeth Peinado,Imported from Bank of America Visa-Fellow Staff advertising. Brand Awareness,D111,HJ,17.35,,36276.02
6758,8/20/2020,8/20/2020,Elizabeth Peinado,Imported from Bank of America Visa-Fellow Staff advertising. Brand Awareness,D111,HJ,56.13,,36332.15
6758,8/22/2020,8/22/2020,Elizabeth Peinado,Imported from Bank of America Visa-Fellow Staff advertising. Brand Awareness,D111,HJ,17.98,,36350.13
6758,8/22/2020,8/22/2020,Elizabeth Peinado,Imported from Bank of America Visa-Fellow Staff advertising. Brand Awareness,D111,HJ,27.78,,36377.91
6758,8/22/2020,8/22/2020,Elizabeth Peinado,Imported from Bank of America Visa-Fellow Staff advertising. Brand Awareness,D111,HJ,27.78,,36405.69
6758,8/22/2020,8/22/2020,Elizabeth Peinado,Imported from Bank of America Visa-Fellow Staff advertising. Brand Awareness,D111,HJ,89.88,,36495.57
6758,8/23/2020,8/23/2020,Elizabeth Peinado,Imported from Bank of America Visa-Fellow Staff advertising. Brand Awareness,D111,HJ,12.13,,36507.7
6758,8/23/2020,8/23/2020,Elizabeth Peinado,Imported from Bank of America Visa-Fellow Staff advertising. Brand Awareness,D111,HJ,18.74,,36526.44
6758,8/23/2020,8/23/2020,Elizabeth Peinado,Imported from Bank of America Visa-Fellow Staff advertising. Brand Awareness,D111,HJ,18.74,,36545.18
6758,8/23/2020,8/23/2020,Elizabeth Peinado,Imported from Bank of America Visa-Fellow Staff advertising. Brand Awareness,D111,HJ,60.62,,36605.8
6758,8/24/2020,8/24/2020,Antonio Gutierrez,Imported from Bank of America Visa-Fellow Recruitment,D107,HJ,900,,37505.8
6758,8/24/2020,8/24/2020,Elizabeth Peinado,Imported from Bank of America Visa-Fellow Staff advertising. Brand Awareness,D111,HJ,11.77,,37517.57
6758,8/24/2020,8/24/2020,Elizabeth Peinado,Imported from Bank of America Visa-Fellow Staff advertising. Brand Awareness,D111,HJ,18.19,,37535.76
6758,8/24/2020,8/24/2020,Elizabeth Peinado,Imported from Bank of America Visa-Fellow Staff advertising. Brand Awareness,D111,HJ,18.19,,37553.95
6758,8/24/2020,8/24/2020,Elizabeth Peinado,Imported from Bank of America Visa-Fellow Staff advertising. Brand Awareness,D111,HJ,58.87,,37612.82
6758,8/25/2020,8/25/2020,Elizabeth Peinado,Imported from Bank of America Visa-Fellow Staff advertising. Brand Awareness,D111,HJ,11.36,,37624.18
6758,8/25/2020,8/25/2020,Elizabeth Peinado,Imported from Bank of America Visa-Fellow Staff advertising. Brand Awareness,D111,HJ,17.55,,37641.73
6758,8/25/2020,8/25/2020,Elizabeth Peinado,Imported from Bank of America Visa-Fellow Staff advertising. Brand Awareness,D111,HJ,17.55,,37659.28
6758,8/25/2020,8/25/2020,Elizabeth Peinado,Imported from Bank of America Visa-Fellow Staff advertising. Brand Awareness,D111,HJ,56.77,,37716.05
6758,8/26/2020,8/26/2020,Antonio Gutierrez,Imported from Bank of America Visa-Fellow Recruitment,D107,HJ,525,,38241.05
6758,8/26/2020,8/26/2020,Elizabeth Peinado,Imported from Bank of America Visa-Fellow Staff advertising. Brand Awareness,D111,HJ,11.12,,38252.17
6758,8/26/2020,8/26/2020,Elizabeth Peinado,Imported from Bank of America Visa-Fellow Staff advertising. Brand Awareness,D111,HJ,17.19,,38269.36
6758,8/26/2020,8/26/2020,Elizabeth Peinado,Imported from Bank of America Visa-Fellow Staff advertising. Brand Awareness,D111,HJ,17.19,,38286.55
6758,8/26/2020,8/26/2020,Elizabeth Peinado,Imported from Bank of America Visa-Fellow Staff advertising. Brand Awareness,D111,HJ,55.6,,38342.15
6758,8/27/2020,8/27/2020,Antonio Gutierrez,Imported from Bank of America Visa-Fellow Recruitment,D107,HJ,151.69,,38493.84
6758,8/27/2020,8/27/2020,Antonio Gutierrez,Imported from Bank of America Visa-X Co.  Promotional gear for Monica Bahtt,D107,HJ,29.7,,38523.54
6758,8/28/2020,8/28/2020,Elizabeth Peinado,Imported from Bank of America Visa-Fellow Staff advertising. Brand Awareness,D111,HJ,20.37,,38543.91
6758,8/28/2020,8/28/2020,Elizabeth Peinado,Imported from Bank of America Visa-Fellow Staff advertising. Brand Awareness,D111,HJ,31.47,,38575.38
6758,8/28/2020,8/28/2020,Elizabeth Peinado,Imported from Bank of America Visa-Fellow Staff advertising. Brand Awareness,D111,HJ,31.47,,38606.85
6758,8/28/2020,8/28/2020,Elizabeth Peinado,Imported from Bank of America Visa-Fellow Staff advertising. Brand Awareness,D111,HJ,101.83,,38708.68
6758,9/1/2020,9/1/2020,Elizabeth Peinado,Imported from Bank of America Visa-National brand awareness,D111,HJ,7.46,,38716.14
6758,9/1/2020,9/1/2020,Elizabeth Peinado,Imported from Bank of America Visa-National brand awareness,D111,HJ,11.53,,38727.67
6758,9/1/2020,9/1/2020,Elizabeth Peinado,Imported from Bank of America Visa-National brand awareness,D111,HJ,11.53,,38739.2
6758,9/1/2020,9/1/2020,Elizabeth Peinado,Imported from Bank of America Visa-National brand awareness,D111,HJ,37.28,,38776.48
6758,9/1/2020,9/1/2020,Elizabeth Peinado,Imported from Bank of America Visa-Refund for remaining balance,D111,HJ,,58.21,38718.27
6758,9/1/2020,9/1/2020,Elizabeth Peinado,Imported from Bank of America Visa-Refund for remaining balance,D111,HJ,,89.96,38628.31
6758,9/1/2020,9/1/2020,Elizabeth Peinado,Imported from Bank of America Visa-Refund for remaining balance,D111,HJ,,89.96,38538.35
6758,9/1/2020,9/1/2020,Elizabeth Peinado,Imported from Bank of America Visa-Refund for remaining balance,D111,HJ,,291.07,38247.28
6758,9/2/2020,9/2/2020,Antonio Gutierrez,Imported from Bank of America Visa-Fellow Recruitment,D111,HJ,400,,38647.28
6758,9/3/2020,9/3/2020,Antonio Gutierrez,Imported from Bank of America Visa-Fellow Recruitment,D111,HJ,900,,39547.28
6758,9/11/2020,9/11/2020,Antonio Gutierrez,Imported from Bank of America Visa-Fellow Recruitment,D111,HJ,900,,40447.28
6758,9/19/2020,9/19/2020,Antonio Gutierrez,Imported from Bank of America Visa-Fellow Recruitment,D111,HJ,299,,40746.28
6758,9/20/2020,9/20/2020,Antonio Gutierrez,Imported from Bank of America Visa-Fellow Recruitment,D107,HJ,,16.09,40730.19
6758,9/25/2020,9/25/2020,Enabler Design,Bill.Com Import-Digital MArketing,D107,HJ,540,,41270.19
6758,9/27/2020,9/27/2020,Antonio Gutierrez,Imported from Bank of America Visa-Fellow Recruitment,D107,HJ,481.51,,41751.7
6758,10/6/2020,10/6/2020,Stran Promotional,Bill.Com Import-Promotional Material. Face masks,D107,HJ,5200.77,,46952.47
6758,10/15/2020,10/15/2020,Antonio Gutierrez,Imported from reimbursements-Website Domain Purchase,D107,HJ,63.51,,47015.98
6758,10/16/2020,10/16/2020,Dstillery Inc.,Bill.Com Import-Media for fellow recruitment,D111,HJ,1204.14,,48220.12
6758,10/16/2020,10/16/2020,Dstillery Inc.,Bill.Com Import-Media for fellow recruitment,D111,HJ,3895.76,,52115.88
6758,10/16/2020,10/16/2020,Dstillery Inc.,Bill.Com Import-Media for fellow recruitment,D111,HJ,1204.14,,53320.02
6758,10/16/2020,10/16/2020,Dstillery Inc.,Bill.Com Import-Media for fellow recruitment,D111,HJ,779.16,,54099.18
6758,10/19/2020,10/19/2020,Antonio Gutierrez,Imported from reimbursements-fellow recruitment,D111,HJ,299,,54398.18
6758,10/27/2020,10/27/2020,Antonio Gutierrez,Imported from reimbursements-fellow recruitment,D111,HJ,457.66,,54855.84
6758,10/29/2020,10/29/2020,Antonio Gutierrez,Imported from reimbursements-Fellow recruitment,D111,HJ,49,,54904.84
6758,11/11/2020,11/11/2020,Antonio Gutierrez,Imported from Bank of America Visa-Fellow Recruitment,D111,HJ,900,,55804.84
6758,11/12/2020,11/12/2020,Stran Promotional,Bill.Com Import-Promotional Material. Face masks,D107,HJ,222.58,,56027.42
6758,11/13/2020,11/13/2020,Antonio Gutierrez,Imported from Bank of America Visa-Fellow Recruitment,D111,HJ,900,,56927.42
6758,11/15/2020,11/15/2020,Antonio Gutierrez,Imported from Bank of America Visa-Fellow Recruitment,D111,HJ,900,,57827.42
6758,11/17/2020,11/17/2020,Antonio Gutierrez,Imported from Bank of America Visa-Fellow Recruitment,D111,HJ,900,,58727.42
6758,11/17/2020,11/17/2020,Antonio Gutierrez,Imported from Bank of America Visa-media subscription,D111,HJ,4,,58731.42
6758,11/19/2020,11/19/2020,Antonio Gutierrez,Imported from Bank of America Visa-Fellow Recruitment,D111,HJ,,10.54,58720.88
6758,11/19/2020,11/19/2020,Antonio Gutierrez,Imported from Bank of America Visa-Fellow Recruitment,D111,HJ,,33.56,58687.32
6758,11/19/2020,11/19/2020,Antonio Gutierrez,Imported from Bank of America Visa-Fellow Recruitment,D111,HJ,299,,58986.32
6758,11/27/2020,11/27/2020,Antonio Gutierrez,Imported from Bank of America Visa-Fellow Recruitment,D111,HJ,179.42,,59165.74
6758,12/10/2020,12/10/2020,Miranda Cortez,Imported from Bank of America Visa-Promotional materials for RT and marketing,D111,HJ,29.85,,59195.59
6758,12/10/2020,12/10/2020,Miranda Cortez,Imported from Bank of America Visa-Promotional materials for RT and marketing,D111,HJ,29.85,,59225.44
6758,12/10/2020,12/10/2020,Miranda Cortez,Imported from Bank of America Visa-Promotional materials for RT and marketing,D111,HJ,29.85,,59255.29
6758,12/10/2020,12/10/2020,Miranda Cortez,Imported from Bank of America Visa-Promotional materials for RT and marketing,D111,HJ,29.85,,59285.14
6758,12/19/2020,12/19/2020,Antonio Gutierrez,Imported from Bank of America Visa-Fellow Recruitment,D111,HJ,299,,59584.14
6758,12/21/2020,12/21/2020,Enabler Design,Bill.Com Import-Digital MArketing,D111,HJ,585,,60169.14
6758,1/8/2021,1/8/2021,Antonio Gutierrez,Imported from Bank of America Visa-Product Marketing Domain Purchases,D111,HJ,77.94,,60247.08
6758,1/13/2021,1/13/2021,Antonio Gutierrez,Imported from Bank of America Visa-Product Marketing Domain Purchases,D111,HJ,549.2,,60796.28
6758,1/13/2021,1/13/2021,Antonio Gutierrez,Imported from Bank of America Visa-Product Marketing Domain Purchases,D111,HJ,858.35,,61654.63
6758,1/14/2021,1/14/2021,Antonio Gutierrez,Imported from Bank of America Visa-Product Marketing Domain Purchases,D111,HJ,220.38,,61875.01
6758,1/18/2021,1/18/2021,Antonio Gutierrez,Imported from Bank of America Visa-Product Marketing Domain Purchases,D111,HJ,274.55,,62149.56
6758,1/22/2021,1/22/2021,Antonio Gutierrez,Imported from Bank of America Visa-Product Marketing Domain Purchases,D109,HJ,119.99,,62269.55
6758,1/25/2021,1/25/2021,Brandvia,Bill.Com Import-Purchasing of 250 Face Masks,D107,HJ,34.66,,62304.21
6758,1/25/2021,1/25/2021,Brandvia,Bill.Com Import-Purchasing of 250 Face Masks,D107,HJ,311.9,,62616.11
6758,1/25/2021,1/25/2021,Brandvia,Bill.Com Import-Purchasing of 250 Face Masks,D107,HJ,808.62,,63424.73
6758,1/25/2021,1/25/2021,Brandvia,Bill.Com Import-Purchasing of Marketing Materials with X Co.  logos,D107,HJ,572.61,,63997.34
6758,1/25/2021,1/25/2021,Brandvia,Bill.Com Import-Purchasing of Marketing Materials with X Co.  logos,D107,HJ,5153.5,,69150.84
6758,1/25/2021,1/25/2021,Brandvia,Bill.Com Import-Purchasing of Marketing Materials with X Co.  logos,D107,HJ,13360.92,,82511.76
6758,2/1/2021,2/1/2021,Antonio Gutierrez,Imported from Bank of America Visa-Website fee,D111,HJ,229.5,,82741.26
6758,2/9/2021,2/9/2021,Antonio Gutierrez,Imported from Bank of America Visa-web Domains,D111,HJ,125.36,,82866.62
6758,2/22/2021,2/22/2021,Antonio Gutierrez,Imported from Bank of America Visa-Fellow Recruitment,D111,HJ,900,,83766.62
6758,3/1/2021,3/1/2021,Antonio Gutierrez,Imported from Bank of America Visa,D107,HJ,828.62,,84595.24
6758,3/2/2021,3/2/2021,Brandvia,Bill.Com Import,D107,HJ,618.04,,85213.28
6758,3/2/2021,3/2/2021,Brandvia,Bill.Com Import,D109,HJ,618.03,,85831.31
6758,3/10/2021,3/10/2021,Antonio Gutierrez,Imported from Bank of America Visa,D107,HJ,280.5,,86111.81
6758,3/12/2021,3/12/2021,Antonio Gutierrez,Imported from Bank of America Visa,D107,HJ,1,,86112.81
6758,3/19/2021,3/19/2021,Antonio Gutierrez,Imported from Bank of America Visa,D111,HJ,378.98,,86491.79
6758,3/19/2021,3/19/2021,Brandvia,Bill.Com Import,D107,HJ,1932.46,,88424.25
6758,3/22/2021,3/22/2021,Antonio Gutierrez,Imported from Bank of America Visa,D107,HJ,100,,88524.25
6758,3/24/2021,3/24/2021,Antonio Gutierrez,Imported from Bank of America Visa,D111,HJ,900,,89424.25
6758,4/2/2021,4/2/2021,Antonio Gutierrez,Imported from Bank of America Visa,D107,HJ,27.95,,89452.2
6758,4/12/2021,4/12/2021,Antonio Gutierrez,Imported from Bank of America Visa,D107,HJ,15,,89467.2
6758,4/13/2021,4/13/2021,Antonio Gutierrez,Imported from Bank of America Visa,D107,HJ,,7.5,89459.7
6758,4/21/2021,4/21/2021,Brandvia,Bill.Com Import,D107,HJ,163.31,,89623.01
6758,4/21/2021,4/21/2021,Brandvia,Bill.Com Import,D107,HJ,707.68,,90330.69
6758,4/21/2021,4/21/2021,Brandvia,Bill.Com Import,D107,HJ,4572.69,,94903.38
6758,4/28/2021,4/28/2021,Antonio Gutierrez,Imported from Bank of America Visa,D111,HJ,40,,94943.38
6758,4/28/2021,4/28/2021,Antonio Gutierrez,Imported from Bank of America Visa,D111,HJ,500,,95443.38
6758,5/1/2021,5/1/2021,Antonio Gutierrez,Imported from Bank of America Visa,D111,HJ,900,,96343.38
6758,5/1/2021,5/1/2021,Antonio Gutierrez,Imported from Bank of America Visa,D111,HJ,900,,97243.38
6758,5/1/2021,5/1/2021,Antonio Gutierrez,Imported from Bank of America Visa,D111,HJ,999.75,,98243.13
6758,5/3/2021,5/3/2021,Antonio Gutierrez,Imported from Bank of America Visa,D111,HJ,496.18,,98739.31
6758,5/3/2021,5/3/2021,Antonio Gutierrez,Imported from Bank of America Visa,D111,HJ,900,,99639.31
6758,5/4/2021,5/4/2021,Antonio Gutierrez,Imported from Bank of America Visa,D111,HJ,503.32,,100142.63
6758,5/4/2021,5/4/2021,Antonio Gutierrez,Imported from Bank of America Visa,D111,HJ,900,,101042.63
6758,5/7/2021,5/7/2021,Antonio Gutierrez,Imported from Bank of America Visa,D111,HJ,900,,101942.63
6758,5/12/2021,5/12/2021,Antonio Gutierrez,Imported from Bank of America Visa,D111,HJ,900,,102842.63
6758,5/14/2021,5/14/2021,Antonio Gutierrez,Imported from Bank of America Visa,D111,HJ,900,,103742.63
6758,5/19/2021,5/19/2021,Antonio Gutierrez,Imported from Bank of America Visa,D111,HJ,900,,104642.63
6758,5/20/2021,5/20/2021,Antonio Gutierrez,Imported from Bank of America Visa,D111,HJ,900,,105542.63
6758,5/21/2021,5/21/2021,Antonio Gutierrez,Imported from Bank of America Visa,D111,HJ,900,,106442.63
6758,5/21/2021,5/21/2021,Brandvia,Bill.Com Import,D107,HJ,300.72,,106743.35
6758,5/21/2021,5/21/2021,Brandvia,Bill.Com Import,D107,HJ,1303.11,,108046.46
6758,5/21/2021,5/21/2021,Brandvia,Bill.Com Import,D107,HJ,8420.08,,116466.54
6758,5/26/2021,5/26/2021,Antonio Gutierrez,Imported from Bank of America Visa,D107,HJ,900,,117366.54
6758,5/27/2021,5/27/2021,Antonio Gutierrez,Imported from Bank of America Visa,D111,HJ,58.47,,117425.01
6758,5/28/2021,5/28/2021,Antonio Gutierrez,Imported from Bank of America Visa,D109,HJ,50,,117475.01
6758,5/28/2021,5/28/2021,Antonio Gutierrez,Imported from Bank of America Visa,D109,HJ,50,,117525.01
6758,5/28/2021,5/28/2021,Antonio Gutierrez,Imported from Bank of America Visa,D111,HJ,900,,118425.01
6758,5/30/2021,5/30/2021,Antonio Gutierrez,Imported from Bank of America Visa,D111,HJ,900,,119325.01
6758,6/1/2021,6/1/2021,20210528,To reclassify Expenses bet departments,D107,HJ,,70010.01,49315
6758,6/1/2021,6/1/2021,Antonio Gutierrez,Imported from Bank of America Visa,D111,HJ,354.46,,49669.46
6758,6/1/2021,6/1/2021,Antonio Gutierrez,Imported from Bank of America Visa,D111,HJ,545.54,,50215
6758,6/2/2021,6/2/2021,Antonio Gutierrez,Imported from Bank of America Visa,D111,HJ,100,,50315
6758,6/2/2021,6/2/2021,Antonio Gutierrez,Imported from Bank of America Visa,D111,HJ,110,,50425
6758,6/2/2021,6/2/2021,Antonio Gutierrez,Imported from Bank of America Visa,D111,HJ,790,,51215
6758,6/2/2021,6/2/2021,Antonio Gutierrez,Imported from Bank of America Visa,D111,HJ,800,,52015
6758,6/4/2021,6/4/2021,Antonio Gutierrez,Imported from Bank of America Visa,D111,HJ,900,,52915
6758,6/11/2021,6/11/2021,Antonio Gutierrez,Imported from Bank of America Visa,D111,HJ,251,,53166
6758,6/11/2021,6/11/2021,Antonio Gutierrez,Imported from Bank of America Visa,D111,HJ,649,,53815
6758,6/14/2021,6/14/2021,Antonio Gutierrez,Imported from Bank of America Visa,D111,HJ,248,,54063
6758,6/14/2021,6/14/2021,Antonio Gutierrez,Imported from Bank of America Visa,D111,HJ,652,,54715
6758,6/16/2021,6/16/2021,Antonio Gutierrez,Imported from Bank of America Visa,D111,HJ,144,,54859
6758,6/16/2021,6/16/2021,Antonio Gutierrez,Imported from Bank of America Visa,D111,HJ,756,,55615
6758,6/17/2021,6/17/2021,Antonio Gutierrez,Imported from Bank of America Visa,D111,HJ,103,,55718
6758,6/17/2021,6/17/2021,Antonio Gutierrez,Imported from Bank of America Visa,D111,HJ,100,,55818
6758,6/17/2021,6/17/2021,Antonio Gutierrez,Imported from Bank of America Visa,D111,HJ,797,,56615
6758,6/23/2021,6/23/2021,Antonio Gutierrez,Imported from Bank of America Visa,D111,HJ,500,,57115
6758,6/23/2021,6/23/2021,Antonio Gutierrez,Imported from Bank of America Visa,D111,HJ,900,,58015
6758,6/24/2021,6/24/2021,Antonio Gutierrez,Imported from Bank of America Visa,D111,HJ,500,,58515
6758,6/24/2021,6/24/2021,Antonio Gutierrez,Imported from Bank of America Visa,D111,HJ,574.04,,59089.04
6758,6/24/2021,6/24/2021,Antonio Gutierrez,Imported from Bank of America Visa,D111,HJ,900,,59989.04
6758,6/24/2021,6/24/2021,Antonio Gutierrez,Imported from Bank of America Visa,D111,HJ,900,,60889.04
6758,6/24/2021,6/24/2021,Antonio Gutierrez,Imported from Bank of America Visa,D111,HJ,900,,61789.04
6758,6/28/2021,6/28/2021,Antonio Gutierrez,Imported from Bank of America Visa,D111,HJ,259.95,,62048.99
6758,6/28/2021,6/28/2021,Antonio Gutierrez,Imported from Bank of America Visa,D111,HJ,640.05,,62689.04
6758, Totals for 6758 - Marketing Promotional Cost,,,,,,133295.94,70606.9,62689.04
6759,6759 - Digital Marketing (Balance forward As of 07/01/2020) ,,,,,,,,0
6759,12/31/2020,12/31/2020,20201231,Actual vs Budget Reclass as of 12/31/2020-Actual vs Budget Reclass as of 12/31/2020,D111,HJ,130215.68,,130215.68
6759,2/22/2021,2/22/2021,Media Cause,Bill.Com Import-Digital Marketing. Schedule C. Digital Recruitment Retainer Extension 1.1.21 to 1.31.21,D111,HJ,16739,,146954.68
6759,3/5/2021,3/5/2021,Enabler Design,Bill.Com Import,D111,HJ,195,,147149.68
6759,3/22/2021,3/22/2021,Media Cause,Bill.Com Import,D111,HJ,14457,,161606.68
6759,3/24/2021,3/24/2021,Appcast Inc.,Bill.Com Import,D111,HJ,1088,,162694.68
6759,4/21/2021,4/21/2021,Appcast Inc.,Bill.Com Import,D111,HJ,586.5,,163281.18
6759,4/21/2021,4/21/2021,Media Cause,Bill.Com Import,D111,HJ,3458.75,,166739.93
6759,4/21/2021,4/21/2021,Media Cause,Bill.Com Import,D111,HJ,13478,,180217.93
6759,5/1/2021,5/1/2021,Widespread-HubSpot,Digital marketing plan for X Co.  Widespread.,D110,HJ,2711.5,,182929.43
6759,5/11/2021,5/11/2021,Enabler Design,Bill.Com Import,D111,HJ,150,,183079.43
6759,5/21/2021,5/21/2021,Appcast Inc.,Bill.Com Import,D111,HJ,569.5,,183648.93
6759,5/21/2021,5/21/2021,Media Cause,Bill.Com Import,D111,HJ,2755,,186403.93
6759,5/21/2021,5/21/2021,Media Cause,Bill.Com Import,D111,HJ,4717.5,,191121.43
6759,5/21/2021,5/21/2021,Media Cause,Bill.Com Import,D111,HJ,22068.75,,213190.18
6759,5/21/2021,5/21/2021,Teads Inc,Bill.Com Import,D111,HJ,2839.7,,216029.88
6759,6/1/2021,6/1/2021,20210528,To reclassify Expenses bet departments,D111,HJ,70010.01,,286039.89
6759,6/1/2021,6/1/2021,CD-21-0323,Digital marketing plan for X Co.  Widespread.,D110,HJ,2711.5,,288751.39
6759,6/2/2021,6/2/2021,Appcast Inc.,Bill.Com Import,D111,HJ,80.75,,288832.14
6759,6/21/2021,6/21/2021,Media Cause,Bill.Com Import,D111,HJ,5605,,294437.14
6759,6/21/2021,6/21/2021,Media Cause,Bill.Com Import,D111,HJ,14301.25,,308738.39
6759,6/21/2021,6/21/2021,Media Cause,Bill.Com Import,D111,HJ,16355,,325093.39
6759,6/22/2021,6/22/2021,Teads Inc,Bill.Com Import,D111,HJ,3166.94,,328260.33
6759,6/28/2021,6/28/2021,"Dstillery, Inc.",Bill.Com Import,D111,HJ,1515.78,,329776.11
6759,6/28/2021,6/28/2021,"Dstillery, Inc.",Bill.Com Import,D111,HJ,1836,,331612.11
6759,6/28/2021,6/28/2021,"Dstillery, Inc.",Bill.Com Import,D111,HJ,4903.99,,336516.1
6759,6/28/2021,6/28/2021,"Dstillery, Inc.",Bill.Com Import,D111,HJ,5940,,342456.1
6759,6/28/2021,6/28/2021,"Dstillery, Inc.",Bill.Com Import,D111,HJ,1515.78,,343971.88
6759,6/28/2021,6/28/2021,"Dstillery, Inc.",Bill.Com Import,D111,HJ,1836,,345807.88
6759,6/28/2021,6/28/2021,"Dstillery, Inc.",Bill.Com Import,D111,HJ,980.8,,346788.68
6759,6/28/2021,6/28/2021,"Dstillery, Inc.",Bill.Com Import,D111,HJ,1188,,347976.68
6759,6/30/2021,6/30/2021,Appcast Inc.,Bill.Com Import,D111,HJ,1844.5,,349821.18
6759,6/30/2021,6/30/2021,Media Cause,Bill.Com Import,D111,HJ,15928.75,,365749.93
6759,6/30/2021,6/30/2021,Media Cause,Bill.Com Import,D111,HJ,29883.75,,395633.68
6759,6/30/2021,6/30/2021,Teads Inc,Bill.Com Import,D111,HJ,1553.9,,397187.58
6759, Totals for 6759 - Digital Marketing,,,,,,397187.58,0,397187.58
6770,6770 - Fellow Emergency Relief Fund (Balance forward As of 07/01/2020) ,,,,,,,,0
6770,8/4/2020,8/4/2020,Jorge Ramirez,Bill.Com Import-Relocation Grant for L. Guererro sec. housing. 600 for deposit and 35 for partial pymt,D108,HJ,635,,635
6770,8/5/2020,8/5/2020,Jennifer Winans,Imported from Bank of America Visa-Chicago Fellow Flight,D111,HJ,78.1,,713.1
6770,8/6/2020,8/6/2020,Jennifer Winans,Imported from Bank of America Visa-Chicago Fellow Uhaul,D111,HJ,1000,,1713.1
6770,8/21/2020,8/21/2020,Jennifer Winans,Imported from Bank of America Visa-Bag fees for flight - Chicago ACM,D111,HJ,30,,1743.1
6770,8/21/2020,8/21/2020,Jennifer Winans,Imported from Bank of America Visa-Bag fees for flight - Chicago ACM,D111,HJ,40,,1783.1
6770,8/26/2020,8/26/2020,2020-07 Relocation,Bill.Com Import-Relocation Assistance Grant for Aleysha Ward. 200 moving fee and 675 1st month rent.,D108,HJ,875,,2658.1
6770, Totals for 6770 - Fellow Emergency Relief Fund,,,,,,2658.1,0,2658.1
6780,6780 - Student Incentives (Balance forward As of 07/01/2020) ,,,,,,,,0
6780,11/3/2020,11/3/2020,Mahaliah Sejour,Imported from Bank of America Visa-Fellows gifts,D108,HJ,14.84,,14.84
6780,11/15/2020,11/15/2020,Mahaliah Sejour,Imported from Bank of America Visa-Fellows gifts,D108,HJ,11.65,,26.49
6780,11/23/2020,11/23/2020,Myesha Hossain,Imported from Bank of America Visa-Student Incentives,D108,HJ,87,,113.49
6780,11/24/2020,11/24/2020,Myesha Hossain,Imported from Bank of America Visa-Refund,D108,HJ,,87,26.49
6780,11/24/2020,11/24/2020,Myesha Hossain,Imported from Bank of America Visa-Student Incentives,D108,HJ,21.75,,48.24
6780,11/24/2020,11/24/2020,Myesha Hossain,Imported from Bank of America Visa-Student Incentives,D108,HJ,21.75,,69.99
6780,11/25/2020,11/25/2020,Myesha Hossain,Imported from Bank of America Visa-Student Incentives,D108,HJ,21.75,,91.74
6780,11/25/2020,11/25/2020,Myesha Hossain,Imported from Bank of America Visa-Student Incentives,D108,HJ,21.75,,113.49
6780,1/11/2021,1/11/2021,Myesha Hossain,Imported from Bank of America Visa-Lincoln student incentive,D108,HJ,11.99,,125.48
6780,1/11/2021,1/11/2021,Myesha Hossain,Imported from Bank of America Visa-Lincoln student incentive,D108,HJ,11.99,,137.47
6780,1/11/2021,1/11/2021,Myesha Hossain,Imported from Bank of America Visa-Lincoln student incentive,D108,HJ,11.99,,149.46
6780,1/11/2021,1/11/2021,Myesha Hossain,Imported from Bank of America Visa-Lincoln student incentive,D108,HJ,11.99,,161.45
6780,1/13/2021,1/13/2021,Myesha Hossain,Imported from Bank of America Visa-Lincoln student incentive,D108,HJ,16.88,,178.33
6780,3/1/2021,3/1/2021,Maryellen Leneghan,Imported from Bank of America Visa,D108,HJ,5.89,,184.22
6780,3/1/2021,3/1/2021,Maryellen Leneghan,Imported from Bank of America Visa,D108,HJ,6.45,,190.67
6780,3/1/2021,3/1/2021,Maryellen Leneghan,Imported from Bank of America Visa,D108,HJ,6.59,,197.26
6780,3/1/2021,3/1/2021,Maryellen Leneghan,Imported from Bank of America Visa,D108,HJ,6.79,,204.05
6780,3/1/2021,3/1/2021,Maryellen Leneghan,Imported from Bank of America Visa,D108,HJ,6.99,,211.04
6780,3/1/2021,3/1/2021,Maryellen Leneghan,Imported from Bank of America Visa,D108,HJ,6.99,,218.03
6780,3/1/2021,3/1/2021,Maryellen Leneghan,Imported from Bank of America Visa,D108,HJ,7.99,,226.02
6780,3/1/2021,3/1/2021,Maryellen Leneghan,Imported from Bank of America Visa,D108,HJ,7.99,,234.01
6780,3/1/2021,3/1/2021,Maryellen Leneghan,Imported from Bank of America Visa,D108,HJ,8.75,,242.76
6780,3/1/2021,3/1/2021,Maryellen Leneghan,Imported from Bank of America Visa,D108,HJ,8.99,,251.75
6780,3/1/2021,3/1/2021,Maryellen Leneghan,Imported from Bank of America Visa,D108,HJ,8.99,,260.74
6780,3/1/2021,3/1/2021,Maryellen Leneghan,Imported from Bank of America Visa,D108,HJ,10.35,,271.09
6780,3/1/2021,3/1/2021,Myesha Hossain,Imported from Bank of America Visa,D108,HJ,10.99,,282.08
6780,3/1/2021,3/1/2021,Myesha Hossain,Imported from Bank of America Visa,D108,HJ,10.99,,293.07
6780,3/1/2021,3/1/2021,Myesha Hossain,Imported from Bank of America Visa,D108,HJ,10.99,,304.06
6780,3/1/2021,3/1/2021,Myesha Hossain,Imported from Bank of America Visa,D108,HJ,10.99,,315.05
6780,3/2/2021,3/2/2021,Myesha Hossain,Imported from Bank of America Visa,D108,HJ,10.99,,326.04
6780,3/2/2021,3/2/2021,Myesha Hossain,Imported from Bank of America Visa,D108,HJ,10.99,,337.03
6780,3/2/2021,3/2/2021,Myesha Hossain,Imported from Bank of America Visa,D108,HJ,10.99,,348.02
6780,3/3/2021,3/3/2021,Myesha Hossain,Imported from Bank of America Visa,D108,HJ,104.52,,452.54
6780,3/8/2021,3/8/2021,Myesha Hossain,Imported from Bank of America Visa,D108,HJ,8.95,,461.49
6780,3/8/2021,3/8/2021,Myesha Hossain,Imported from Bank of America Visa,D108,HJ,8.99,,470.48
6780,3/8/2021,3/8/2021,Myesha Hossain,Imported from Bank of America Visa,D108,HJ,14.5,,484.98
6780,3/10/2021,3/10/2021,Maryellen Leneghan,Imported from Bank of America Visa,D108,HJ,7.48,,492.46
6780,3/13/2021,3/13/2021,Maryellen Leneghan,Imported from Bank of America Visa,D108,HJ,7.68,,500.14
6780,3/15/2021,3/15/2021,Maryellen Leneghan,Imported from Bank of America Visa,D108,HJ,6.98,,507.12
6780,3/15/2021,3/15/2021,Maryellen Leneghan,Imported from Bank of America Visa,D108,HJ,7.99,,515.11
6780,3/17/2021,3/17/2021,Myesha Hossain,Imported from Bank of America Visa,D108,HJ,6.99,,522.1
6780,3/24/2021,3/24/2021,Maryellen Leneghan,Imported from Bank of America Visa,D108,HJ,6.99,,529.09
6780,3/31/2021,3/31/2021,Maryellen Leneghan,Imported from Bank of America Visa,D108,HJ,9.59,,538.68
6780,4/2/2021,4/2/2021,Myesha Hossain,Imported from Bank of America Visa,D108,HJ,9.79,,548.47
6780,4/2/2021,4/2/2021,Myesha Hossain,Imported from Bank of America Visa,D108,HJ,14.99,,563.46
6780,4/2/2021,4/2/2021,Myesha Hossain,Imported from Bank of America Visa,D108,HJ,20,,583.46
6780,4/5/2021,4/5/2021,Mahaliah Sejour,Imported from Bank of America Visa,D108,HJ,23.95,,607.41
6780,4/5/2021,4/5/2021,Mahaliah Sejour,Imported from Bank of America Visa,D108,HJ,22.48,,629.89
6780,4/5/2021,4/5/2021,Mahaliah Sejour,Imported from Bank of America Visa,D108,HJ,22.48,,652.37
6780,4/5/2021,4/5/2021,Mahaliah Sejour,Imported from Bank of America Visa,D108,HJ,22.48,,674.85
6780,4/5/2021,4/5/2021,Mahaliah Sejour,Imported from Bank of America Visa,D108,HJ,22.48,,697.33
6780,4/5/2021,4/5/2021,Mahaliah Sejour,Imported from Bank of America Visa,D108,HJ,22.48,,719.81
6780,4/5/2021,4/5/2021,Mahaliah Sejour,Imported from Bank of America Visa,D108,HJ,22.48,,742.29
6780,4/5/2021,4/5/2021,Mahaliah Sejour,Imported from Bank of America Visa,D108,HJ,22.48,,764.77
6780,4/5/2021,4/5/2021,Mahaliah Sejour,Imported from Bank of America Visa,D108,HJ,23.95,,788.72
6780,4/5/2021,4/5/2021,Mahaliah Sejour,Imported from Bank of America Visa,D108,HJ,23.95,,812.67
6780,4/5/2021,4/5/2021,Mahaliah Sejour,Imported from Bank of America Visa,D108,HJ,23.95,,836.62
6780,4/5/2021,4/5/2021,Mahaliah Sejour,Imported from Bank of America Visa,D108,HJ,23.95,,860.57
6780,4/5/2021,4/5/2021,Mahaliah Sejour,Imported from Bank of America Visa,D108,HJ,24.96,,885.53
6780,4/5/2021,4/5/2021,Myesha Hossain,Imported from Bank of America Visa,D108,HJ,13.96,,899.49
6780,4/7/2021,4/7/2021,Mahaliah Sejour,Imported from Bank of America Visa,D108,HJ,23.95,,923.44
6780,4/7/2021,4/7/2021,Myesha Hossain,Imported from Bank of America Visa,D108,HJ,13.96,,937.4
6780,4/7/2021,4/7/2021,Myesha Hossain,Imported from Bank of America Visa,D108,HJ,14.5,,951.9
6780,4/9/2021,4/9/2021,Myesha Hossain,Imported from Bank of America Visa,D108,HJ,50.97,,1002.87
6780,4/9/2021,4/9/2021,Myesha Hossain,Imported from Bank of America Visa,D108,HJ,116.32,,1119.19
6780,4/12/2021,4/12/2021,Mahaliah Sejour,Imported from Bank of America Visa,D108,HJ,40.67,,1159.86
6780,4/12/2021,4/12/2021,Myesha Hossain,Imported from Bank of America Visa,D108,HJ,15.99,,1175.85
6780,4/13/2021,4/13/2021,Mahaliah Sejour,Imported from Bank of America Visa,D108,HJ,21.9,,1197.75
6780,4/13/2021,4/13/2021,Myesha Hossain,Imported from Bank of America Visa,D108,HJ,15.98,,1213.73
6780,4/15/2021,4/15/2021,Myesha Hossain,Imported from Bank of America Visa,D108,HJ,6.99,,1220.72
6780,4/15/2021,4/15/2021,Myesha Hossain,Imported from Bank of America Visa,D108,HJ,6.99,,1227.71
6780,4/15/2021,4/15/2021,Myesha Hossain,Imported from Bank of America Visa,D108,HJ,14.34,,1242.05
6780,4/15/2021,4/15/2021,Myesha Hossain,Imported from Bank of America Visa,D108,HJ,14.99,,1257.04
6780,4/15/2021,4/15/2021,Myesha Hossain,Imported from Bank of America Visa,D108,HJ,15.99,,1273.03
6780,4/16/2021,4/16/2021,Mahaliah Sejour,Imported from Bank of America Visa,D108,HJ,47.27,,1320.3
6780,4/16/2021,4/16/2021,Myesha Hossain,Imported from Bank of America Visa,D108,HJ,6.99,,1327.29
6780,4/16/2021,4/16/2021,Myesha Hossain,Imported from Bank of America Visa,D108,HJ,6.99,,1334.28
6780,4/23/2021,4/23/2021,Maryellen Leneghan,Imported from Bank of America Visa,D108,HJ,7.53,,1341.81
6780,4/23/2021,4/23/2021,Myesha Hossain,Imported from Bank of America Visa,D108,HJ,9.21,,1351.02
6780,4/23/2021,4/23/2021,Myesha Hossain,Imported from Bank of America Visa,D108,HJ,9.21,,1360.23
6780,4/23/2021,4/23/2021,Myesha Hossain,Imported from Bank of America Visa,D108,HJ,14.95,,1375.18
6780,4/23/2021,4/23/2021,Myesha Hossain,Imported from Bank of America Visa,D108,HJ,35.4,,1410.58
6780,4/27/2021,4/27/2021,Mahaliah Sejour,Imported from Bank of America Visa,D108,HJ,90,,1500.58
6780,4/27/2021,4/27/2021,Myesha Hossain,Imported from Bank of America Visa,D108,HJ,9.21,,1509.79
6780,4/27/2021,4/27/2021,Myesha Hossain,Imported from Bank of America Visa,D108,HJ,9.21,,1519
6780,4/27/2021,4/27/2021,Myesha Hossain,Imported from Bank of America Visa,D108,HJ,9.21,,1528.21
6780,4/27/2021,4/27/2021,Myesha Hossain,Imported from Bank of America Visa,D108,HJ,9.21,,1537.42
6780,4/27/2021,4/27/2021,Myesha Hossain,Imported from Bank of America Visa,D108,HJ,19.4,,1556.82
6780,4/27/2021,4/27/2021,Myesha Hossain,Imported from Bank of America Visa,D108,HJ,44.97,,1601.79
6780,4/29/2021,4/29/2021,Maryellen Leneghan,Imported from Bank of America Visa,D108,HJ,9.99,,1611.78
6780,4/29/2021,4/29/2021,Maryellen Leneghan,Imported from Bank of America Visa,D108,HJ,10.99,,1622.77
6780,4/29/2021,4/29/2021,Myesha Hossain,Imported from Bank of America Visa,D108,HJ,7.95,,1630.72
6780,4/29/2021,4/29/2021,Myesha Hossain,Imported from Bank of America Visa,D108,HJ,7.95,,1638.67
6780,4/29/2021,4/29/2021,Myesha Hossain,Imported from Bank of America Visa,D108,HJ,7.95,,1646.62
6780,4/29/2021,4/29/2021,Myesha Hossain,Imported from Bank of America Visa,D108,HJ,7.95,,1654.57
6780,4/29/2021,4/29/2021,Myesha Hossain,Imported from Bank of America Visa,D108,HJ,7.95,,1662.52
6780,5/1/2021,5/1/2021,Myesha Hossain,Imported from Bank of America Visa,D108,HJ,6.99,,1669.51
6780,5/3/2021,5/3/2021,Maryellen Leneghan,Imported from Bank of America Visa,D108,HJ,7.99,,1677.5
6780,5/4/2021,5/4/2021,Maryellen Leneghan,Imported from Bank of America Visa,D108,HJ,9.97,,1687.47
6780,5/5/2021,5/5/2021,Mahaliah Sejour,Imported from Bank of America Visa,D108,HJ,16.75,,1704.22
6780,5/5/2021,5/5/2021,Myesha Hossain,Imported from Bank of America Visa,D108,HJ,4.89,,1709.11
6780,5/5/2021,5/5/2021,Myesha Hossain,Imported from Bank of America Visa,D108,HJ,5.54,,1714.65
6780,5/5/2021,5/5/2021,Myesha Hossain,Imported from Bank of America Visa,D108,HJ,10.98,,1725.63
6780,5/6/2021,5/6/2021,Myesha Hossain,Imported from Bank of America Visa,D108,HJ,13.47,,1739.1
6780,5/6/2021,5/6/2021,Myesha Hossain,Imported from Bank of America Visa,D108,HJ,19.42,,1758.52
6780,5/7/2021,5/7/2021,Mahaliah Sejour,Imported from Bank of America Visa,D108,HJ,16.75,,1775.27
6780,5/7/2021,5/7/2021,Myesha Hossain,Imported from Bank of America Visa,D108,HJ,8.99,,1784.26
6780,5/7/2021,5/7/2021,Myesha Hossain,Imported from Bank of America Visa,D108,HJ,13.47,,1797.73
6780,5/11/2021,5/11/2021,Mahaliah Sejour,Imported from Bank of America Visa,D108,HJ,17.98,,1815.71
6780,5/11/2021,5/11/2021,Mahaliah Sejour,Imported from Bank of America Visa,D108,HJ,44.34,,1860.05
6780,5/11/2021,5/11/2021,Mahaliah Sejour,Imported from Bank of America Visa,D108,HJ,9.97,,1870.02
6780,5/11/2021,5/11/2021,Mahaliah Sejour,Imported from Bank of America Visa,D108,HJ,25.18,,1895.2
6780,5/11/2021,5/11/2021,Myesha Hossain,Imported from Bank of America Visa,D108,HJ,14.97,,1910.17
6780,5/11/2021,5/11/2021,Myesha Hossain,Imported from Bank of America Visa,D108,HJ,6.99,,1917.16
6780,5/17/2021,5/17/2021,Mahaliah Sejour,Imported from Bank of America Visa,D108,HJ,53.98,,1971.14
6780,5/18/2021,5/18/2021,Mahaliah Sejour,Imported from Bank of America Visa,D108,HJ,161.02,,2132.16
6780,5/19/2021,5/19/2021,Maryellen Leneghan,Imported from Bank of America Visa,D108,HJ,5.99,,2138.15
6780,5/19/2021,5/19/2021,Maryellen Leneghan,Imported from Bank of America Visa,D108,HJ,7.49,,2145.64
6780,5/19/2021,5/19/2021,Maryellen Leneghan,Imported from Bank of America Visa,D108,HJ,17.97,,2163.61
6780,5/19/2021,5/19/2021,Myesha Hossain,Imported from Bank of America Visa,D108,HJ,6.99,,2170.6
6780,5/20/2021,5/20/2021,Myesha Hossain,Imported from Bank of America Visa,D108,HJ,6.99,,2177.59
6780,5/21/2021,5/21/2021,Mahaliah Sejour,Imported from Bank of America Visa,D108,HJ,16.98,,2194.57
6780,5/21/2021,5/21/2021,Mahaliah Sejour,Imported from Bank of America Visa,D108,HJ,25.53,,2220.1
6780,5/21/2021,5/21/2021,Mahaliah Sejour,Imported from Bank of America Visa,D108,HJ,19.4,,2239.5
6780,5/21/2021,5/21/2021,Mahaliah Sejour,Imported from Bank of America Visa,D108,HJ,119.15,,2358.65
6780,5/21/2021,5/21/2021,Maryellen Leneghan,Imported from Bank of America Visa,D108,HJ,5.98,,2364.63
6780,5/21/2021,5/21/2021,Maryellen Leneghan,Imported from Bank of America Visa,D108,HJ,3.07,,2367.7
6780,5/26/2021,5/26/2021,Maryellen Leneghan,Imported from Bank of America Visa,D108,HJ,11.49,,2379.19
6780,5/26/2021,5/26/2021,Maryellen Leneghan,Imported from Bank of America Visa,D108,HJ,13.99,,2393.18
6780,5/26/2021,5/26/2021,Myesha Hossain,Imported from Bank of America Visa,D108,HJ,8.49,,2401.67
6780,5/28/2021,5/28/2021,Myesha Hossain,Imported from Bank of America Visa,D108,HJ,8.49,,2410.16
6780,6/2/2021,6/2/2021,Myesha Hossain,Imported from Bank of America Visa,D108,HJ,8.62,,2418.78
6780,6/2/2021,6/2/2021,Myesha Hossain,Imported from Bank of America Visa,D108,HJ,9.3,,2428.08
6780,6/2/2021,6/2/2021,Myesha Hossain,Imported from Bank of America Visa,D108,HJ,9.3,,2437.38
6780,6/2/2021,6/2/2021,Myesha Hossain,Imported from Bank of America Visa,D108,HJ,14.99,,2452.37
6780,6/4/2021,6/4/2021,Myesha Hossain,Imported from Bank of America Visa,D108,HJ,14.97,,2467.34
6780,6/8/2021,6/8/2021,Mahaliah Sejour,Imported from Bank of America Visa,D108,HJ,25.95,,2493.29
6780,6/10/2021,6/10/2021,Mahaliah Sejour,Imported from Bank of America Visa,D108,HJ,34.04,,2527.33
6780,6/10/2021,6/10/2021,Myesha Hossain,Imported from Bank of America Visa,D108,HJ,4.63,,2531.96
6780,6/10/2021,6/10/2021,Myesha Hossain,Imported from Bank of America Visa,D108,HJ,8.99,,2540.95
6780,6/11/2021,6/11/2021,Myesha Hossain,Imported from Bank of America Visa,D108,HJ,4.63,,2545.58
6780,6/14/2021,6/14/2021,Myesha Hossain,Imported from Bank of America Visa,D108,HJ,9.3,,2554.88
6780,6/14/2021,6/14/2021,Myesha Hossain,Imported from Bank of America Visa,D108,HJ,9.3,,2564.18
6780,6/15/2021,6/15/2021,Myesha Hossain,Imported from Bank of America Visa,D108,HJ,9.3,,2573.48
6780,6/15/2021,6/15/2021,Myesha Hossain,Imported from Bank of America Visa,D108,HJ,9.3,,2582.78
6780,6/16/2021,6/16/2021,Myesha Hossain,Imported from Bank of America Visa,D108,HJ,7.49,,2590.27
6780,6/16/2021,6/16/2021,Myesha Hossain,Imported from Bank of America Visa,D108,HJ,8.99,,2599.26
6780,6/16/2021,6/16/2021,Myesha Hossain,Imported from Bank of America Visa,D108,HJ,8.99,,2608.25
6780,6/16/2021,6/16/2021,Myesha Hossain,Imported from Bank of America Visa,D108,HJ,8.99,,2617.24
6780,6/17/2021,6/17/2021,Myesha Hossain,Imported from Bank of America Visa,D108,HJ,7.49,,2624.73
6780,6/22/2021,6/22/2021,Myesha Hossain,Imported from Bank of America Visa,D108,HJ,9.3,,2634.03
6780,6/22/2021,6/22/2021,Myesha Hossain,Imported from Bank of America Visa,D108,HJ,12.99,,2647.02
6780,6/23/2021,6/23/2021,Leslie Guthrie,Imported from reimbursements,D108,HJ,75.04,,2722.06
6780,6/23/2021,6/23/2021,Mahaliah Sejour,Imported from Bank of America Visa,D108,HJ,12.3,,2734.36
6780,6/24/2021,6/24/2021,Myesha Hossain,Imported from Bank of America Visa,D108,HJ,,11.99,2722.37
6780,6/24/2021,6/24/2021,Myesha Hossain,Imported from Bank of America Visa,D108,HJ,11.99,,2734.36
6780,6/24/2021,6/24/2021,Myesha Hossain,Imported from Bank of America Visa,D108,HJ,24.99,,2759.35
6780,6/28/2021,6/28/2021,Mahaliah Sejour,Imported from Bank of America Visa,D108,HJ,11.88,,2771.23
6780,6/28/2021,6/28/2021,Myesha Hossain,Imported from Bank of America Visa,D108,HJ,8.75,,2779.98
6780, Totals for 6780 - Student Incentives,,,,,,2878.97,98.99,2779.98
6790,6790 - Tutor/Staff Incentive/Appreciation (Balance forward As of 07/01/2020) ,,,,,,,,0
6790,7/2/2020,7/2/2020,Maryellen Leneghan,Imported from Bank of America Visa-Staff appreciation mailing EOY presents to fellows and staff,D108,HJ,18.85,,18.85
6790,7/6/2020,7/6/2020,Halley Bowman,Imported from Bank of America Visa-Thank you gift for helping with curriculum,D101,HJ,26.84,,45.69
6790,7/6/2020,7/6/2020,Halley Bowman,Imported from Bank of America Visa-Thank you gift for helping with curriculum,D101,HJ,28.61,,74.3
6790,7/22/2020,7/22/2020,Monivett Acevedo,Imported from Bank of America Visa-Retreat Supplies,D103,HJ,103.35,,177.65
6790,7/23/2020,7/23/2020,Chris D PLACEHOLDER,Imported from Bank of America Visa-Book prize sent to employee,D107,HJ,11.16,,188.81
6790,7/23/2020,7/23/2020,Chris D PLACEHOLDER,Imported from Bank of America Visa-Book prize sent to employee,D107,HJ,11.16,,199.97
6790,7/23/2020,7/23/2020,Chris D PLACEHOLDER,Imported from Bank of America Visa-Book prize sent to employee,D107,HJ,11.24,,211.21
6790,7/23/2020,7/23/2020,Chris D PLACEHOLDER,Imported from Bank of America Visa-Book prize sent to employee,D107,HJ,11.93,,223.14
6790,7/23/2020,7/23/2020,Chris D PLACEHOLDER,Imported from Bank of America Visa-Book prize sent to employee,D107,HJ,13.78,,236.92
6790,7/24/2020,7/24/2020,Chris D PLACEHOLDER,Imported from Bank of America Visa-Book prize sent to employee,D107,HJ,11.34,,248.26
6790,7/24/2020,7/24/2020,Chris D PLACEHOLDER,Imported from Bank of America Visa-Book prize sent to employee,D107,HJ,11.34,,259.6
6790,7/27/2020,7/27/2020,Monivett Acevedo,Concur Payment Bambora-Concur Payment Bambora,D103,HJ,7.32,,266.92
6790,7/27/2020,7/27/2020,Monivett Acevedo,Concur Payment Bambora-Concur Payment Bambora,D103,HJ,25.3,,292.22
6790,7/27/2020,7/27/2020,Monivett Acevedo,Concur Payment Bambora-Concur Payment Bambora,D103,HJ,40.66,,332.88
6790,7/27/2020,7/27/2020,Monivett Acevedo,Concur Payment Bambora-Concur Payment Bambora,D103,HJ,43.6,,376.48
6790,8/1/2020,8/1/2020,Halley Bowman,Imported from Bank of America Visa-Thank Ashlee for extra work,D101,HJ,3.2,,379.68
6790,8/1/2020,8/1/2020,Halley Bowman,Imported from Bank of America Visa-Thank Ashlee for extra work,D101,HJ,4.94,,384.62
6790,8/1/2020,8/1/2020,Halley Bowman,Imported from Bank of America Visa-Thank Ashlee for extra work,D101,HJ,4.94,,389.56
6790,8/1/2020,8/1/2020,Halley Bowman,Imported from Bank of America Visa-Thank Ashlee for extra work,D101,HJ,16,,405.56
6790,8/1/2020,8/1/2020,Mahaliah Sejour,Imported from Bank of America Visa-Fellows gifts,D108,HJ,15.96,,421.52
6790,8/2/2020,8/2/2020,Mahaliah Sejour,Imported from Bank of America Visa-Fellows gifts,D108,HJ,21.09,,442.61
6790,8/5/2020,8/5/2020,Mahaliah Sejour,Imported from Bank of America Visa-book,D108,HJ,11.39,,454
6790,8/8/2020,8/8/2020,Chris D PLACEHOLDER,Imported from Bank of America Visa-Book prize sent to employee,D107,HJ,15.65,,469.65
6790,8/8/2020,8/8/2020,Mahaliah Sejour,Imported from Bank of America Visa-Fellows gifts,D108,HJ,19.49,,489.14
6790,8/9/2020,8/9/2020,Chris D PLACEHOLDER,Imported from Bank of America Visa-Book prize sent to employee,D107,HJ,18.35,,507.49
6790,8/9/2020,8/9/2020,Maryellen Leneghan,Imported from Bank of America Visa-BC fellow appreciation during training,D108,HJ,6.35,,513.84
6790,8/11/2020,8/11/2020,Chris D PLACEHOLDER,Imported from Bank of America Visa-Book prize sent to employee,D107,HJ,6.92,,520.76
6790,8/12/2020,8/12/2020,Chris D PLACEHOLDER,Imported from Bank of America Visa-Book prize sent to AmeriCorps member,D107,HJ,12.07,,532.83
6790,8/12/2020,8/12/2020,Chris D PLACEHOLDER,Imported from Bank of America Visa-Book prize sent to AmeriCorps member,D107,HJ,12.07,,544.9
6790,8/12/2020,8/12/2020,Lisa Kapusta,Imported from Bank of America Visa-Staff Challenge PRIZE,D108,HJ,16.97,,561.87
6790,8/12/2020,8/12/2020,Lisa Kapusta,Imported from Bank of America Visa-Staff competition PRIZE,D108,HJ,16.97,,578.84
6790,8/12/2020,8/12/2020,Lisa Kapusta,Imported from Bank of America Visa-Staff competition Prize,D108,HJ,16.97,,595.81
6790,8/12/2020,8/12/2020,Lisa Kapusta,Imported from Bank of America Visa-Staff competition prize,D108,HJ,16.97,,612.78
6790,8/12/2020,8/12/2020,Lisa Kapusta,Imported from Bank of America Visa-Staff competition prize,D108,HJ,16.97,,629.75
6790,8/13/2020,8/13/2020,Chris D PLACEHOLDER,Imported from Bank of America Visa-Book prize sent to employee,D107,HJ,15.7,,645.45
6790,8/14/2020,8/14/2020,Maryellen Leneghan,Imported from Bank of America Visa-Fellow Appreciation during training,D108,HJ,14.08,,659.53
6790,8/17/2020,8/17/2020,BA8BDBABF6A048FD8056,Imported from Bank of America Visa-Mailing Welcome Packages,D111,HJ,39.55,,699.08
6790,8/17/2020,8/17/2020,Maryellen Leneghan,Imported from Bank of America Visa-Fellow Appreciation during training,D108,HJ,10.59,,709.67
6790,8/18/2020,8/18/2020,Mahaliah Sejour,Imported from Bank of America Visa-Fellows jeopardy gift,D108,HJ,14.79,,724.46
6790,8/19/2020,8/19/2020,Mahaliah Sejour,Imported from Bank of America Visa-Fellows jeopardy gift,D108,HJ,14.99,,739.45
6790,8/19/2020,8/19/2020,Mahaliah Sejour,Imported from Bank of America Visa-Fellows jeopardy gift,D108,HJ,15.98,,755.43
6790,8/19/2020,8/19/2020,Mahaliah Sejour,Imported from Bank of America Visa-Fellows jeopardy gift,D108,HJ,19.99,,775.42
6790,8/19/2020,8/19/2020,Myesha Hossain,Imported from Bank of America Visa-Fellow Social Raffle Prize,D108,HJ,15.72,,791.14
6790,8/19/2020,8/19/2020,Myesha Hossain,Imported from Bank of America Visa-Fellow Social Raffle Prize,D108,HJ,22.98,,814.12
6790,8/19/2020,8/19/2020,Myesha Hossain,Imported from Bank of America Visa-Fellow Social Raffle Prize,D108,HJ,22.98,,837.1
6790,8/20/2020,8/20/2020,Chris D PLACEHOLDER,Imported from Bank of America Visa-Book prize sent to AmeriCorps Member,D107,HJ,12.1,,849.2
6790,8/20/2020,8/20/2020,Chris D PLACEHOLDER,Imported from Bank of America Visa-Book prize sent to AmeriCorps Member,D107,HJ,12.19,,861.39
6790,8/20/2020,8/20/2020,Chris D PLACEHOLDER,Imported from Bank of America Visa-Book prize sent to AmeriCorps Member,D107,HJ,20.43,,881.82
6790,8/20/2020,8/20/2020,Chris D PLACEHOLDER,Imported from Bank of America Visa-Book prize sent to AmeriCorps member,D107,HJ,12.3,,894.12
6790,8/20/2020,8/20/2020,Chris D PLACEHOLDER,Imported from Bank of America Visa-Book prize sent to employee,D107,HJ,12.4,,906.52
6790,8/20/2020,8/20/2020,Chris D PLACEHOLDER,Imported from Bank of America Visa-Book prize sent to employee,D107,HJ,16.52,,923.04
6790,8/20/2020,8/20/2020,Chris D PLACEHOLDER,Imported from Bank of America Visa-Book prize sent to employee,D107,HJ,44.74,,967.78
6790,8/20/2020,8/20/2020,Maryellen Leneghan,Imported from Bank of America Visa-DoP Appreciation for the summer. BC specific,D108,HJ,38.51,,1006.29
6790,8/21/2020,8/21/2020,3BF0E5FAC6964956886C,Imported from Bank of America Visa-Mailing Welcome Packages,D111,HJ,31.9,,1038.19
6790,8/21/2020,8/21/2020,Chris D PLACEHOLDER,Imported from Bank of America Visa-Book prize sent to AmeriCorps member,D107,HJ,17.73,,1055.92
6790,8/21/2020,8/21/2020,Chris D PLACEHOLDER,Imported from Bank of America Visa-Book prize sent to employee,D107,HJ,12.3,,1068.22
6790,8/22/2020,8/22/2020,Chris D PLACEHOLDER,Imported from Bank of America Visa-Book prize sent to AmeriCorps member,D107,HJ,24.3,,1092.52
6790,8/25/2020,8/25/2020,Maryellen Leneghan,Imported from Bank of America Visa-Appreciation for DC DoP,D108,HJ,49.5,,1142.02
6790,8/27/2020,8/27/2020,Myesha Hossain,Imported from Bank of America Visa-Fellow Social Raffle Prize,D108,HJ,14.99,,1157.01
6790,8/27/2020,8/27/2020,Myesha Hossain,Imported from Bank of America Visa-Staff Appreciation,D108,HJ,10.64,,1167.65
6790,8/27/2020,8/27/2020,Myesha Hossain,Imported from Bank of America Visa-Staff Appreciation,D108,HJ,15.44,,1183.09
6790,8/27/2020,8/27/2020,Myesha Hossain,Imported from Bank of America Visa-Staff Appreciation,D108,HJ,17,,1200.09
6790,8/27/2020,8/27/2020,Myesha Hossain,Imported from Bank of America Visa-Staff Appreciation,D108,HJ,44.94,,1245.03
6790,9/1/2020,9/1/2020,Lisa Kapusta,Imported from Bank of America Visa-Care package item,D108,HJ,232.05,,1477.08
6790,9/1/2020,9/1/2020,Myesha Hossain,Imported from Bank of America Visa-Fellow Training,D108,HJ,9.99,,1487.07
6790,9/2/2020,9/2/2020,iaklestad,Imported from Bank of America Visa-Mailing Welcome Packages,D111,HJ,13.95,,1501.02
6790,9/2/2020,9/2/2020,Myesha Hossain,Imported from Bank of America Visa-Training,D108,HJ,18.24,,1519.26
6790,9/3/2020,9/3/2020,Mahaliah Sejour,Imported from Bank of America Visa-Fellows gifts,D108,HJ,39.95,,1559.21
6790,9/3/2020,9/3/2020,Mahaliah Sejour,Imported from Bank of America Visa-SD gifts,D108,HJ,197.82,,1757.03
6790,9/4/2020,9/4/2020,Maryellen Leneghan,Imported from Bank of America Visa-SD and DoP appreciation,D108,HJ,17.11,,1774.14
6790,9/4/2020,9/4/2020,Maryellen Leneghan,Imported from Bank of America Visa-SD and DoP appreciation,D108,HJ,17.11,,1791.25
6790,9/4/2020,9/4/2020,Maryellen Leneghan,Imported from Bank of America Visa-SD and DoP appreciation,D108,HJ,18.18,,1809.43
6790,9/4/2020,9/4/2020,Maryellen Leneghan,Imported from Bank of America Visa-X Co.  shirts for SDs in BC postage,D108,HJ,15.75,,1825.18
6790,9/5/2020,9/5/2020,Maryellen Leneghan,Imported from Bank of America Visa-SD and DoP appreciation,D108,HJ,17.11,,1842.29
6790,9/5/2020,9/5/2020,Maryellen Leneghan,Imported from Bank of America Visa-SD and DoP appreciation,D108,HJ,17.11,,1859.4
6790,9/5/2020,9/5/2020,Maryellen Leneghan,Imported from Bank of America Visa-SD and DoP appreciation,D108,HJ,17.11,,1876.51
6790,9/5/2020,9/5/2020,Maryellen Leneghan,Imported from Bank of America Visa-SD and DoP appreciation,D108,HJ,18.09,,1894.6
6790,9/5/2020,9/5/2020,Maryellen Leneghan,Imported from Bank of America Visa-SD and DoP appreciation,D108,HJ,18.01,,1912.61
6790,9/8/2020,9/8/2020,Maryellen Leneghan,Imported from Bank of America Visa-SD and DoP appreciation,D108,HJ,17.11,,1929.72
6790,9/8/2020,9/8/2020,Maryellen Leneghan,Imported from Bank of America Visa-SD and DoP appreciation,D108,HJ,18.01,,1947.73
6790,9/8/2020,9/8/2020,Maryellen Leneghan,Imported from Bank of America Visa-SD and DoP appreciation,D108,HJ,18.01,,1965.74
6790,9/8/2020,9/8/2020,Maryellen Leneghan,Imported from Bank of America Visa-SD and DoP appreciation,D108,HJ,18.01,,1983.75
6790,9/9/2020,9/9/2020,claice Jackson,Imported from Bank of America Visa-Staff Appreciation,D108,HJ,11.3,,1995.05
6790,9/13/2020,9/13/2020,Denise Parham-Gantt,Imported from Bank of America Visa-woot puzzle prize,D112,HJ,13.55,,2008.6
6790,9/13/2020,9/13/2020,Denise Parham-Gantt,Imported from Bank of America Visa-woot puzzle prize,D112,HJ,14.43,,2023.03
6790,9/13/2020,9/13/2020,Denise Parham-Gantt,Imported from Bank of America Visa-woot puzzle prize,D112,HJ,14.55,,2037.58
6790,9/15/2020,9/15/2020,Denise Parham-Gantt,Imported from Bank of America Visa-woot puzzle prize,D112,HJ,13.55,,2051.13
6790,9/15/2020,9/15/2020,Mahaliah Sejour,Imported from Bank of America Visa-Schurz Team Appreciation,D108,HJ,66.82,,2117.95
6790,9/24/2020,9/24/2020,iaklestad,Imported from Bank of America Visa-Mailing Welcome Packages,D111,HJ,79.9,,2197.85
6790,10/1/2020,10/1/2020,Maryellen Leneghan,Imported from reimbursements-RBHS Fellow Appreciation,D108,HJ,10.48,,2208.33
6790,10/1/2020,10/1/2020,Maryellen Leneghan,Imported from reimbursements-RBHS Fellow Appreciation,D108,HJ,15.37,,2223.7
6790,10/1/2020,10/1/2020,Maryellen Leneghan,Imported from reimbursements-RBHS Fellow Appreciation,D108,HJ,18.01,,2241.71
6790,10/1/2020,10/1/2020,Maryellen Leneghan,Imported from reimbursements-RBHS Fellow Appreciation,D108,HJ,26.94,,2268.65
6790,10/1/2020,10/1/2020,Myesha Hossain,Imported from reimbursements-Tutor incentives,D108,HJ,15.87,,2284.52
6790,10/2/2020,10/2/2020,Myesha Hossain,Imported from reimbursements-Tutor incentives,D108,HJ,9.78,,2294.3
6790,10/2/2020,10/2/2020,Myesha Hossain,Imported from reimbursements-Tutor incentives,D108,HJ,11.55,,2305.85
6790,10/2/2020,10/2/2020,Myesha Hossain,Imported from reimbursements-Tutor incentives,D108,HJ,11.94,,2317.79
6790,10/2/2020,10/2/2020,Myesha Hossain,Imported from reimbursements-Tutor incentives,D108,HJ,14.99,,2332.78
6790,10/2/2020,10/2/2020,Myesha Hossain,Imported from reimbursements-Tutor incentives,D108,HJ,17.94,,2350.72
6790,10/4/2020,10/4/2020,Maryellen Leneghan,Imported from reimbursements-Fellow appreciation,D108,HJ,2.43,,2353.15
6790,10/6/2020,10/6/2020,Maryellen Leneghan,Imported from reimbursements-DC fellow appreciation,D108,HJ,10.59,,2363.74
6790,10/7/2020,10/7/2020,Mahaliah Sejour,Imported from reimbursements-Fellows gifts,D108,HJ,21.38,,2385.12
6790,10/7/2020,10/7/2020,Maryellen Leneghan,Imported from reimbursements-Winning prize for fellow social game in BC,D108,HJ,11.33,,2396.45
6790,10/7/2020,10/7/2020,Monivett Acevedo,Imported from reimbursements-Meals with KDT in Boston,D103,HJ,15.24,,2411.69
6790,10/8/2020,10/8/2020,Mahaliah Sejour,Imported from reimbursements-Fellows gifts,D108,HJ,31.81,,2443.5
6790,10/8/2020,10/8/2020,Mahaliah Sejour,Imported from reimbursements-Fellows gifts,D108,HJ,31.81,,2475.31
6790,10/8/2020,10/8/2020,Mahaliah Sejour,Imported from reimbursements-Fellows gifts,D108,HJ,31.81,,2507.12
6790,10/8/2020,10/8/2020,Mahaliah Sejour,Imported from reimbursements-Fellows gifts,D108,HJ,31.81,,2538.93
6790,10/8/2020,10/8/2020,Mahaliah Sejour,Imported from reimbursements-Fellows gifts,D108,HJ,31.81,,2570.74
6790,10/8/2020,10/8/2020,Mahaliah Sejour,Imported from reimbursements-Fellows gifts,D108,HJ,73.27,,2644.01
6790,10/8/2020,10/8/2020,Myesha Hossain,Imported from reimbursements-Refund,D108,HJ,,15.87,2628.14
6790,10/9/2020,10/9/2020,Antonio Gutierrez,Imported from reimbursements-X Co.  6 year anniversary celebration,D107,HJ,3000,,5628.14
6790,10/9/2020,10/9/2020,Mahaliah Sejour,Imported from reimbursements-Fellows gifts,D108,HJ,13.8,,5641.94
6790,10/9/2020,10/9/2020,Myesha Hossain,Imported from reimbursements-Tutor incentives,D108,HJ,15.33,,5657.27
6790,10/10/2020,10/10/2020,Mahaliah Sejour,Imported from reimbursements-Fellows gifts,D108,HJ,10.99,,5668.26
6790,10/10/2020,10/10/2020,Mahaliah Sejour,Imported from reimbursements-Fellows gifts,D108,HJ,10.99,,5679.25
6790,10/10/2020,10/10/2020,Mahaliah Sejour,Imported from reimbursements-Fellows gifts,D108,HJ,13.21,,5692.46
6790,10/10/2020,10/10/2020,Mahaliah Sejour,Imported from reimbursements-Fellows gifts,D108,HJ,16.98,,5709.44
6790,10/10/2020,10/10/2020,Mahaliah Sejour,Imported from reimbursements-Fellows gifts,D108,HJ,16.98,,5726.42
6790,10/11/2020,10/11/2020,Mahaliah Sejour,Imported from reimbursements-Fellows gifts,D108,HJ,10.99,,5737.41
6790,10/11/2020,10/11/2020,Mahaliah Sejour,Imported from reimbursements-Fellows gifts,D108,HJ,10.99,,5748.4
6790,10/11/2020,10/11/2020,Mahaliah Sejour,Imported from reimbursements-Fellows gifts,D108,HJ,10.99,,5759.39
6790,10/11/2020,10/11/2020,Mahaliah Sejour,Imported from reimbursements-Fellows gifts,D108,HJ,11.99,,5771.38
6790,10/11/2020,10/11/2020,Mahaliah Sejour,Imported from reimbursements-Fellows gifts,D108,HJ,24.97,,5796.35
6790,10/11/2020,10/11/2020,Mahaliah Sejour,Imported from reimbursements-Fellows gifts,D108,HJ,24.97,,5821.32
6790,10/11/2020,10/11/2020,Mahaliah Sejour,Imported from reimbursements-Fellows gifts,D108,HJ,27.79,,5849.11
6790,10/12/2020,10/12/2020,Mahaliah Sejour,Imported from reimbursements-Fellows gifts,D108,HJ,26.79,,5875.9
6790,10/13/2020,10/13/2020,Mahaliah Sejour,Imported from reimbursements-Fellows gifts refund,D108,HJ,,10.99,5864.91
6790,10/14/2020,10/14/2020,Mahaliah Sejour,Imported from reimbursements-Fellows gifts,D108,HJ,15.19,,5880.1
6790,10/15/2020,10/15/2020,Mahaliah Sejour,Imported from reimbursements-Fellows gifts,D108,HJ,10.99,,5891.09
6790,10/15/2020,10/15/2020,Maryellen Leneghan,Imported from reimbursements-pumpkin carving kit for DC fellow for challenge,D108,HJ,15.09,,5906.18
6790,10/18/2020,10/18/2020,Mahaliah Sejour,Imported from reimbursements-Fellows gifts,D108,HJ,17.09,,5923.27
6790,10/19/2020,10/19/2020,Maryellen Leneghan,Imported from reimbursements-pumpkin carving kit for DC fellow for challenge,D108,HJ,10.95,,5934.22
6790,10/20/2020,10/20/2020,Maryellen Leneghan,Imported from reimbursements-Fellow appreciation fellow team time winner,D108,HJ,11.64,,5945.86
6790,10/21/2020,10/21/2020,iaklestad,Imported from reimbursements-Welcome Packages Print Flyers,D111,HJ,65.34,,6011.2
6790,10/22/2020,10/22/2020,Mahaliah Sejour,Imported from reimbursements-Fellows gifts,D108,HJ,13.92,,6025.12
6790,10/25/2020,10/25/2020,Mahaliah Sejour,Imported from reimbursements-Fellows gifts,D108,HJ,12.99,,6038.11
6790,10/25/2020,10/25/2020,Mahaliah Sejour,Imported from reimbursements-Fellows gifts,D108,HJ,19.68,,6057.79
6790,10/26/2020,10/26/2020,Mahaliah Sejour,Imported from reimbursements-Fellows gifts,D108,HJ,2.78,,6060.57
6790,10/27/2020,10/27/2020,Grubhub,Bill.Com Import-Meal Purchases for CHI-Program,D108,HJ,253.45,,6314.02
6790,10/27/2020,10/27/2020,Grubhub,Bill.Com Import-Meal Purchases for NYC-Program,D108,HJ,111.3,,6425.32
6790,10/27/2020,10/27/2020,Grubhub,Bill.Com Import-Meal Purchases for DC-Program,D108,HJ,302.49,,6727.81
6790,10/27/2020,10/27/2020,Myesha Hossain,Imported from reimbursements-PPE,D108,HJ,,118.9,6608.91
6790,10/28/2020,10/28/2020,Mahaliah Sejour,Imported from reimbursements-Fellows virtual social,D108,HJ,120,,6728.91
6790,10/29/2020,10/29/2020,Myesha Hossain,Imported from reimbursements-Fellow Challenge Prize,D108,HJ,16.99,,6745.9
6790,10/29/2020,10/29/2020,Myesha Hossain,Imported from reimbursements-PPE Return,D108,HJ,,118.9,6627
6790,11/1/2020,11/1/2020,Mahaliah Sejour,Imported from Bank of America Visa-Fellows gifts,D108,HJ,6.87,,6633.87
6790,11/1/2020,11/1/2020,Mahaliah Sejour,Imported from Bank of America Visa-Fellows gifts,D108,HJ,6.87,,6640.74
6790,11/1/2020,11/1/2020,Mahaliah Sejour,Imported from Bank of America Visa-Fellows gifts,D108,HJ,26.9,,6667.64
6790,11/1/2020,11/1/2020,Mahaliah Sejour,Imported from Bank of America Visa-Fellows gifts,D108,HJ,26.9,,6694.54
6790,11/1/2020,11/1/2020,Mahaliah Sejour,Imported from Bank of America Visa-Fellows gifts,D108,HJ,28.82,,6723.36
6790,11/1/2020,11/1/2020,Mahaliah Sejour,Imported from Bank of America Visa-Fellows gifts,D108,HJ,28.82,,6752.18
6790,11/1/2020,11/1/2020,Mahaliah Sejour,Imported from Bank of America Visa-Fellows gifts,D108,HJ,28.82,,6781
6790,11/1/2020,11/1/2020,Mahaliah Sejour,Imported from Bank of America Visa-Fellows gifts,D108,HJ,28.82,,6809.82
6790,11/2/2020,11/2/2020,Denise Parham-Gantt,Imported from Bank of America Visa-prize for woot training activity for option schools,D112,HJ,13.77,,6823.59
6790,11/2/2020,11/2/2020,Lisa Kapusta,Imported from Bank of America Visa-Appreciation for SD,D108,HJ,20.81,,6844.4
6790,11/2/2020,11/2/2020,Lisa Kapusta,Imported from Bank of America Visa-Gratuity for SD appreciation meal,D108,HJ,3.92,,6848.32
6790,11/2/2020,11/2/2020,Mahaliah Sejour,Imported from Bank of America Visa-Fellows gifts,D108,HJ,12.83,,6861.15
6790,11/3/2020,11/3/2020,Mahaliah Sejour,Imported from Bank of America Visa-Fellows gifts,D108,HJ,11.88,,6873.03
6790,11/3/2020,11/3/2020,Mahaliah Sejour,Imported from Bank of America Visa-Fellows gifts,D108,HJ,12.99,,6886.02
6790,11/3/2020,11/3/2020,Mahaliah Sejour,Imported from Bank of America Visa-Fellows gifts,D108,HJ,13.99,,6900.01
6790,11/3/2020,11/3/2020,Mahaliah Sejour,Imported from Bank of America Visa-Fellows gifts,D108,HJ,14.99,,6915
6790,11/3/2020,11/3/2020,Mahaliah Sejour,Imported from Bank of America Visa-Fellows gifts,D108,HJ,17.99,,6932.99
6790,11/4/2020,11/4/2020,claice Jackson,Imported from Bank of America Visa-Staff Appreciation,D108,HJ,42.17,,6975.16
6790,11/4/2020,11/4/2020,Myesha Hossain,Imported from Bank of America Visa-Staff Appreciation,D108,HJ,15.95,,6991.11
6790,11/4/2020,11/4/2020,Myesha Hossain,Imported from Bank of America Visa-Virtual Social Event,D108,HJ,14.99,,7006.1
6790,11/5/2020,11/5/2020,Antonio Gutierrez,Imported from Bank of America Visa-Alan Safran Appreciation,D107,HJ,192.94,,7199.04
6790,11/5/2020,11/5/2020,Myesha Hossain,Imported from Bank of America Visa-Fellow Appreciation,D108,HJ,16.64,,7215.68
6790,11/5/2020,11/5/2020,Myesha Hossain,Imported from Bank of America Visa-Staff Appreciation,D108,HJ,10.91,,7226.59
6790,11/5/2020,11/5/2020,Myesha Hossain,Imported from Bank of America Visa-Staff Appreciation,D108,HJ,14.96,,7241.55
6790,11/5/2020,11/5/2020,Myesha Hossain,Imported from Bank of America Visa-Staff Appreciation,D108,HJ,14.96,,7256.51
6790,11/5/2020,11/5/2020,Myesha Hossain,Imported from Bank of America Visa-Team Time,D108,HJ,14.96,,7271.47
6790,11/5/2020,11/5/2020,Myesha Hossain,Imported from Bank of America Visa-Virtual Social Event,D108,HJ,7.95,,7279.42
6790,11/6/2020,11/6/2020,Maryellen Leneghan,Imported from Bank of America Visa-Fellow appreciation,D108,HJ,9.99,,7289.41
6790,11/6/2020,11/6/2020,Myesha Hossain,Imported from Bank of America Visa-SD Appreciation,D108,HJ,14.96,,7304.37
6790,11/6/2020,11/6/2020,Myesha Hossain,Imported from Bank of America Visa-Staff Appreciation,D108,HJ,14.96,,7319.33
6790,11/6/2020,11/6/2020,Myesha Hossain,Imported from Bank of America Visa-Staff Appreciation,D108,HJ,14.96,,7334.29
6790,11/6/2020,11/6/2020,Myesha Hossain,Imported from Bank of America Visa-Team Time,D108,HJ,8.76,,7343.05
6790,11/6/2020,11/6/2020,Myesha Hossain,Imported from Bank of America Visa-Team Time,D108,HJ,15.7,,7358.75
6790,11/7/2020,11/7/2020,Myesha Hossain,Imported from Bank of America Visa-ASD Appreciation,D108,HJ,14.96,,7373.71
6790,11/7/2020,11/7/2020,Myesha Hossain,Imported from Bank of America Visa-SD Appreciation,D108,HJ,14.96,,7388.67
6790,11/7/2020,11/7/2020,Myesha Hossain,Imported from Bank of America Visa-SD Appreciation,D108,HJ,14.96,,7403.63
6790,11/7/2020,11/7/2020,Myesha Hossain,Imported from Bank of America Visa-SD Appreciation,D108,HJ,14.96,,7418.59
6790,11/7/2020,11/7/2020,Myesha Hossain,Imported from Bank of America Visa-Virtual Social Event,D108,HJ,19.54,,7438.13
6790,11/9/2020,11/9/2020,Maryellen Leneghan,Imported from Bank of America Visa-Staff appreciation,D108,HJ,19.99,,7458.12
6790,11/9/2020,11/9/2020,Maryellen Leneghan,Imported from Bank of America Visa-Staff appreciation,D108,HJ,21.95,,7480.07
6790,11/9/2020,11/9/2020,Maryellen Leneghan,Imported from Bank of America Visa-Staff appreciation,D108,HJ,24.95,,7505.02
6790,11/9/2020,11/9/2020,Maryellen Leneghan,Imported from Bank of America Visa-Fellow appreciation,D108,HJ,2.64,,7507.66
6790,11/9/2020,11/9/2020,Maryellen Leneghan,Imported from Bank of America Visa-Fellow appreciation,D108,HJ,2.64,,7510.3
6790,11/9/2020,11/9/2020,Maryellen Leneghan,Imported from Bank of America Visa-Fellow appreciation,D108,HJ,2.64,,7512.94
6790,11/9/2020,11/9/2020,Maryellen Leneghan,Imported from Bank of America Visa-Fellow appreciation,D108,HJ,2.64,,7515.58
6790,11/9/2020,11/9/2020,Maryellen Leneghan,Imported from Bank of America Visa-Fellow appreciation,D108,HJ,14.88,,7530.46
6790,11/9/2020,11/9/2020,Maryellen Leneghan,Imported from Bank of America Visa-Fellow appreciation,D108,HJ,15.77,,7546.23
6790,11/9/2020,11/9/2020,Maryellen Leneghan,Imported from Bank of America Visa-Fellow appreciation,D108,HJ,15.77,,7562
6790,11/9/2020,11/9/2020,Maryellen Leneghan,Imported from Bank of America Visa-Fellow appreciation,D108,HJ,15.77,,7577.77
6790,11/9/2020,11/9/2020,Myesha Hossain,Imported from Bank of America Visa-ASD Appreciation,D108,HJ,14,,7591.77
6790,11/9/2020,11/9/2020,Myesha Hossain,Imported from Bank of America Visa-ASD Appreciation,D108,HJ,14.96,,7606.73
6790,11/9/2020,11/9/2020,Myesha Hossain,Imported from Bank of America Visa-Refund,D108,HJ,,10.91,7595.82
6790,11/9/2020,11/9/2020,Myesha Hossain,Imported from Bank of America Visa-SD Appreciation,D108,HJ,130.12,,7725.94
6790,11/9/2020,11/9/2020,Myesha Hossain,Imported from Bank of America Visa-Team Time,D108,HJ,15,,7740.94
6790,11/10/2020,11/10/2020,Maryellen Leneghan,Imported from Bank of America Visa-Staff appreciation,D108,HJ,9.97,,7750.91
6790,11/10/2020,11/10/2020,Maryellen Leneghan,Imported from Bank of America Visa-Staff appreciation,D108,HJ,29.95,,7780.86
6790,11/10/2020,11/10/2020,Maryellen Leneghan,Imported from Bank of America Visa-Fellow appreciation,D108,HJ,2.71,,7783.57
6790,11/10/2020,11/10/2020,Maryellen Leneghan,Imported from Bank of America Visa-Fellow appreciation,D108,HJ,15.77,,7799.34
6790,11/10/2020,11/10/2020,Maryellen Leneghan,Imported from Bank of America Visa-Staff appreciation,D108,HJ,9.72,,7809.06
6790,11/10/2020,11/10/2020,Myesha Hossain,Imported from Bank of America Visa-SD Appreciation,D108,HJ,14.96,,7824.02
6790,11/10/2020,11/10/2020,Myesha Hossain,Imported from Bank of America Visa-Team Time,D108,HJ,12.87,,7836.89
6790,11/11/2020,11/11/2020,Mahaliah Sejour,Imported from Bank of America Visa-Fellows gifts,D108,HJ,,12.83,7824.06
6790,11/11/2020,11/11/2020,Maryellen Leneghan,Imported from Bank of America Visa-Fellow appreciation,D108,HJ,18.59,,7842.65
6790,11/11/2020,11/11/2020,Maryellen Leneghan,Imported from Bank of America Visa-Fellow appreciation,D108,HJ,24.76,,7867.41
6790,11/11/2020,11/11/2020,Maryellen Leneghan,Imported from Bank of America Visa-Fellow appreciation,D108,HJ,24.98,,7892.39
6790,11/11/2020,11/11/2020,Maryellen Leneghan,Imported from Bank of America Visa-Fellow appreciation,D108,HJ,25.13,,7917.52
6790,11/11/2020,11/11/2020,Myesha Hossain,Imported from Bank of America Visa-ASD Appreciation,D108,HJ,15.44,,7932.96
6790,11/11/2020,11/11/2020,Myesha Hossain,Imported from Bank of America Visa-SD Appreciation,D108,HJ,5.69,,7938.65
6790,11/12/2020,11/12/2020,Mahaliah Sejour,Imported from Bank of America Visa-Fellows gifts,D108,HJ,14.1,,7952.75
6790,11/12/2020,11/12/2020,Mahaliah Sejour,Imported from Bank of America Visa-Fellows gifts,D108,HJ,15.31,,7968.06
6790,11/12/2020,11/12/2020,Mahaliah Sejour,Imported from Bank of America Visa-Fellows gifts,D108,HJ,23.99,,7992.05
6790,11/12/2020,11/12/2020,Maryellen Leneghan,Imported from Bank of America Visa-Refund for amazon item,D108,HJ,,9.99,7982.06
6790,11/12/2020,11/12/2020,Myesha Hossain,Imported from Bank of America Visa-ASD Appreciation,D108,HJ,13.68,,7995.74
6790,11/12/2020,11/12/2020,Myesha Hossain,Imported from Bank of America Visa-Fellow Appreciation,D108,HJ,13.85,,8009.59
6790,11/13/2020,11/13/2020,Mahaliah Sejour,Imported from Bank of America Visa-Fellows gifts,D108,HJ,19.99,,8029.58
6790,11/13/2020,11/13/2020,Mahaliah Sejour,Imported from Bank of America Visa-Fellows gifts,D108,HJ,60.37,,8089.95
6790,11/13/2020,11/13/2020,Myesha Hossain,Imported from Bank of America Visa-ASD Appreciation,D108,HJ,12.99,,8102.94
6790,11/13/2020,11/13/2020,Myesha Hossain,Imported from Bank of America Visa-Fellow Appreciation,D108,HJ,7.69,,8110.63
6790,11/13/2020,11/13/2020,Myesha Hossain,Imported from Bank of America Visa-Fellow Appreciation,D108,HJ,10.88,,8121.51
6790,11/14/2020,11/14/2020,Mahaliah Sejour,Imported from Bank of America Visa-Fellows gifts,D108,HJ,19.07,,8140.58
6790,11/14/2020,11/14/2020,Myesha Hossain,Imported from Bank of America Visa-Fellow Appreciation,D108,HJ,16.85,,8157.43
6790,11/15/2020,11/15/2020,Myesha Hossain,Imported from Bank of America Visa-Fellow Appreciation,D108,HJ,14.79,,8172.22
6790,11/16/2020,11/16/2020,Maryellen Leneghan,Imported from Bank of America Visa-Fellow appreciation,D108,HJ,17.51,,8189.73
6790,11/16/2020,11/16/2020,Maryellen Leneghan,Imported from Bank of America Visa-Fellow appreciation,D108,HJ,18.5,,8208.23
6790,11/16/2020,11/16/2020,Maryellen Leneghan,Imported from Bank of America Visa-Fellow appreciation,D108,HJ,18.97,,8227.2
6790,11/16/2020,11/16/2020,Maryellen Leneghan,Imported from Bank of America Visa-Fellow appreciation,D108,HJ,26.15,,8253.35
6790,11/16/2020,11/16/2020,Maryellen Leneghan,Imported from Bank of America Visa-Fellow appreciation,D108,HJ,26.15,,8279.5
6790,11/16/2020,11/16/2020,Maryellen Leneghan,Imported from Bank of America Visa-Fellow appreciation,D108,HJ,26.45,,8305.95
6790,11/16/2020,11/16/2020,Maryellen Leneghan,Imported from Bank of America Visa-Fellow appreciation,D108,HJ,26.7,,8332.65
6790,11/17/2020,11/17/2020,Maryellen Leneghan,Imported from Bank of America Visa-Fellow appreciation,D108,HJ,4.97,,8337.62
6790,11/17/2020,11/17/2020,Maryellen Leneghan,Imported from Bank of America Visa-Fellow appreciation,D108,HJ,16.99,,8354.61
6790,11/17/2020,11/17/2020,Maryellen Leneghan,Imported from Bank of America Visa-Fellow appreciation,D108,HJ,17,,8371.61
6790,11/17/2020,11/17/2020,Maryellen Leneghan,Imported from Bank of America Visa-Fellow appreciation,D108,HJ,22.78,,8394.39
6790,11/18/2020,11/18/2020,Mahaliah Sejour,Imported from Bank of America Visa-Fellows gifts,D108,HJ,23.53,,8417.92
6790,11/19/2020,11/19/2020,Mahaliah Sejour,Imported from Bank of America Visa-Fellows gifts,D108,HJ,19.99,,8437.91
6790,11/19/2020,11/19/2020,Mahaliah Sejour,Imported from Bank of America Visa-Fellows gifts,D108,HJ,23.53,,8461.44
6790,11/19/2020,11/19/2020,Mahaliah Sejour,Imported from Bank of America Visa-Fellows gifts,D108,HJ,23.53,,8484.97
6790,11/19/2020,11/19/2020,Mahaliah Sejour,Imported from Bank of America Visa-Fellows gifts,D108,HJ,23.53,,8508.5
6790,11/19/2020,11/19/2020,Mahaliah Sejour,Imported from Bank of America Visa-Fellows gifts,D108,HJ,23.53,,8532.03
6790,11/19/2020,11/19/2020,Mahaliah Sejour,Imported from Bank of America Visa-Fellows gifts,D108,HJ,25.76,,8557.79
6790,11/19/2020,11/19/2020,Mahaliah Sejour,Imported from Bank of America Visa-Fellows gifts,D108,HJ,27.53,,8585.32
6790,11/20/2020,11/20/2020,Alan Safran,Imported from Bank of America Visa-receipt for Staff appreciation. Broward County,D108,HJ,98.98,,8684.3
6790,11/20/2020,11/20/2020,Mahaliah Sejour,Imported from Bank of America Visa-Fellows gifts,D108,HJ,6.29,,8690.59
6790,11/20/2020,11/20/2020,Maryellen Leneghan,Imported from Bank of America Visa-Fellow appreciation,D108,HJ,22.14,,8712.73
6790,11/20/2020,11/20/2020,Nicole Prahin,Imported from Bank of America Visa-Get Well Gifts for DoP out on FMLA,D108,HJ,32.75,,8745.48
6790,11/20/2020,11/20/2020,Nicole Prahin,Imported from Bank of America Visa-Get Well Gifts for DoP out on FMLA,D108,HJ,32.9,,8778.38
6790,11/21/2020,11/21/2020,Mahaliah Sejour,Imported from Bank of America Visa-Fellows gifts,D108,HJ,17.04,,8795.42
6790,11/21/2020,11/21/2020,Mahaliah Sejour,Imported from Bank of America Visa-Fellows gifts,D108,HJ,19.49,,8814.91
6790,11/21/2020,11/21/2020,Mahaliah Sejour,Imported from Bank of America Visa-Fellows gifts,D108,HJ,27.88,,8842.79
6790,11/21/2020,11/21/2020,Nicole Prahin,Imported from Bank of America Visa-Get Well Gifts for DoP out on FMLA,D108,HJ,28.23,,8871.02
6790,11/22/2020,11/22/2020,Mahaliah Sejour,Imported from Bank of America Visa-Fellows gifts,D108,HJ,19.14,,8890.16
6790,11/23/2020,11/23/2020,Mahaliah Sejour,Imported from Bank of America Visa-Fellows gifts,D108,HJ,19.05,,8909.21
6790,11/23/2020,11/23/2020,Mahaliah Sejour,Imported from Bank of America Visa-Fellows gifts,D108,HJ,44.79,,8954
6790,11/24/2020,11/24/2020,Grubhub,Bill.Com Import-Meal Purchases for BC-Programs,D108,HJ,501.79,,9455.79
6790,11/24/2020,11/24/2020,Grubhub,Bill.Com Import-Meal Purchases for CHI-Program,D108,HJ,15.9,,9471.69
6790,11/24/2020,11/24/2020,Grubhub,Bill.Com Import-Meal Purchases for CHI-Programs,D108,HJ,862.51,,10334.2
6790,11/24/2020,11/24/2020,Grubhub,Bill.Com Import-Meal Purchases for Finance Department,D103,HJ,80.96,,10415.16
6790,11/24/2020,11/24/2020,Grubhub,Bill.Com Import-Meal Purchases for DC-Programs,D108,HJ,145.77,,10560.93
6790,11/24/2020,11/24/2020,Mahaliah Sejour,Imported from Bank of America Visa-Fellows gifts,D108,HJ,0.9,,10561.83
6790,11/24/2020,11/24/2020,Myesha Hossain,Imported from Bank of America Visa-Fellow Appreciation,D108,HJ,13.93,,10575.76
6790,11/25/2020,11/25/2020,Amazon Business,Bill.Com Import-Bibliophilia. 100 Literary Postcards and costume Halloween,D108,HJ,33.97,,10609.73
6790,11/26/2020,11/26/2020,Alan Safran,Imported from Bank of America Visa-Staff appreciation -refund,D108,HJ,,18.99,10590.74
6790,11/26/2020,11/26/2020,Myesha Hossain,Imported from Bank of America Visa-Fellow Appreciation,D108,HJ,4.95,,10595.69
6790,11/26/2020,11/26/2020,Myesha Hossain,Imported from Bank of America Visa-Fellow Appreciation,D108,HJ,12.21,,10607.9
6790,11/27/2020,11/27/2020,Myesha Hossain,Imported from Bank of America Visa-Fellow Appreciation,D108,HJ,12.2,,10620.1
6790,11/27/2020,11/27/2020,Myesha Hossain,Imported from Bank of America Visa-Fellow Appreciation,D108,HJ,12.2,,10632.3
6790,11/27/2020,11/27/2020,Myesha Hossain,Imported from Bank of America Visa-Fellow Appreciation,D108,HJ,12.2,,10644.5
6790,11/27/2020,11/27/2020,Myesha Hossain,Imported from Bank of America Visa-Fellow Appreciation,D108,HJ,12.2,,10656.7
6790,11/27/2020,11/27/2020,Myesha Hossain,Imported from Bank of America Visa-Fellow Appreciation,D108,HJ,12.2,,10668.9
6790,11/27/2020,11/27/2020,Myesha Hossain,Imported from Bank of America Visa-Fellow Appreciation,D108,HJ,12.2,,10681.1
6790,11/27/2020,11/27/2020,Myesha Hossain,Imported from Bank of America Visa-Fellow Appreciation,D108,HJ,12.2,,10693.3
6790,11/27/2020,11/27/2020,Myesha Hossain,Imported from Bank of America Visa-Fellow Appreciation,D108,HJ,14.96,,10708.26
6790,11/27/2020,11/27/2020,Myesha Hossain,Imported from Bank of America Visa-Fellow Appreciation,D108,HJ,19.86,,10728.12
6790,11/27/2020,11/27/2020,Myesha Hossain,Imported from Bank of America Visa-Fellow Appreciation,D108,HJ,19.91,,10748.03
6790,11/27/2020,11/27/2020,Myesha Hossain,Imported from Bank of America Visa-Fellow Appreciation,D108,HJ,20.9,,10768.93
6790,11/28/2020,11/28/2020,Myesha Hossain,Imported from Bank of America Visa-Fellow Appreciation,D108,HJ,4.95,,10773.88
6790,11/28/2020,11/28/2020,Myesha Hossain,Imported from Bank of America Visa-Fellow Appreciation,D108,HJ,14.96,,10788.84
6790,11/28/2020,11/28/2020,Myesha Hossain,Imported from Bank of America Visa-Fellow Appreciation,D108,HJ,19.91,,10808.75
6790,12/1/2020,12/1/2020,Grubhub,Bill.Com Import-Meal Purchases for NYC-Programs,D108,HJ,609.5,,11418.25
6790,12/4/2020,12/4/2020,Halley Bowman,Imported from Bank of America Visa-Thank you gift for helping with curriculum,D101,HJ,19.99,,11438.24
6790,12/4/2020,12/4/2020,Maryellen Leneghan,Imported from Bank of America Visa-Staff Fellow Appreciation,D108,HJ,13.78,,11452.02
6790,12/4/2020,12/4/2020,Maryellen Leneghan,Imported from Bank of America Visa-Staff Fellow Appreciation,D108,HJ,19.89,,11471.91
6790,12/5/2020,12/5/2020,Halley Bowman,Imported from Bank of America Visa-Thank you gift for helping with curriculum,D101,HJ,13.84,,11485.75
6790,12/5/2020,12/5/2020,Mahaliah Sejour,Imported from Bank of America Visa-Fellows gifts,D108,HJ,29.99,,11515.74
6790,12/5/2020,12/5/2020,Maryellen Leneghan,Imported from Bank of America Visa-Staff Fellow Appreciation,D108,HJ,10.57,,11526.31
6790,12/6/2020,12/6/2020,Mahaliah Sejour,Imported from Bank of America Visa-Awards trophy,D108,HJ,32.22,,11558.53
6790,12/6/2020,12/6/2020,Mahaliah Sejour,Imported from Bank of America Visa-Awards trophy,D108,HJ,33.97,,11592.5
6790,12/6/2020,12/6/2020,Mahaliah Sejour,Imported from Bank of America Visa-Awards trophy,D108,HJ,34.11,,11626.61
6790,12/6/2020,12/6/2020,Mahaliah Sejour,Imported from Bank of America Visa-Awards trophy,D108,HJ,34.11,,11660.72
6790,12/6/2020,12/6/2020,Mahaliah Sejour,Imported from Bank of America Visa-Awards trophy,D108,HJ,34.11,,11694.83
6790,12/6/2020,12/6/2020,Mahaliah Sejour,Imported from Bank of America Visa-Awards trophy,D108,HJ,34.11,,11728.94
6790,12/6/2020,12/6/2020,Mahaliah Sejour,Imported from Bank of America Visa-Awards trophy,D108,HJ,34.11,,11763.05
6790,12/6/2020,12/6/2020,Mahaliah Sejour,Imported from Bank of America Visa-Awards trophy,D108,HJ,34.11,,11797.16
6790,12/6/2020,12/6/2020,Mahaliah Sejour,Imported from Bank of America Visa-Awards trophy,D108,HJ,34.11,,11831.27
6790,12/6/2020,12/6/2020,Mahaliah Sejour,Imported from Bank of America Visa-Awards trophy,D108,HJ,34.11,,11865.38
6790,12/6/2020,12/6/2020,Mahaliah Sejour,Imported from Bank of America Visa-Awards trophy,D108,HJ,34.11,,11899.49
6790,12/6/2020,12/6/2020,Mahaliah Sejour,Imported from Bank of America Visa-Fellows gifts,D108,HJ,29.99,,11929.48
6790,12/6/2020,12/6/2020,Mahaliah Sejour,Imported from Bank of America Visa-Fellows gifts,D108,HJ,29.99,,11959.47
6790,12/6/2020,12/6/2020,Mahaliah Sejour,Imported from Bank of America Visa-Fellows gifts,D108,HJ,29.99,,11989.46
6790,12/6/2020,12/6/2020,Mahaliah Sejour,Imported from Bank of America Visa-Fellows gifts,D108,HJ,29.99,,12019.45
6790,12/6/2020,12/6/2020,Mahaliah Sejour,Imported from Bank of America Visa-Fellows gifts,D108,HJ,29.99,,12049.44
6790,12/6/2020,12/6/2020,Maryellen Leneghan,Imported from Bank of America Visa-Staff Fellow Appreciation,D108,HJ,25.43,,12074.87
6790,12/6/2020,12/6/2020,Maryellen Leneghan,Imported from Bank of America Visa-Staff Fellow Appreciation,D108,HJ,25.43,,12100.3
6790,12/6/2020,12/6/2020,Maryellen Leneghan,Imported from Bank of America Visa-Staff Fellow Appreciation,D108,HJ,25.43,,12125.73
6790,12/6/2020,12/6/2020,Maryellen Leneghan,Imported from Bank of America Visa-Staff Fellow Appreciation,D108,HJ,25.43,,12151.16
6790,12/6/2020,12/6/2020,Maryellen Leneghan,Imported from Bank of America Visa-Staff Fellow Appreciation,D108,HJ,25.43,,12176.59
6790,12/6/2020,12/6/2020,Maryellen Leneghan,Imported from Bank of America Visa-Staff Fellow Appreciation,D108,HJ,40.23,,12216.82
6790,12/7/2020,12/7/2020,Mahaliah Sejour,Imported from Bank of America Visa-Awards trophy,D108,HJ,33.88,,12250.7
6790,12/7/2020,12/7/2020,Mahaliah Sejour,Imported from Bank of America Visa-Awards trophy,D108,HJ,33.88,,12284.58
6790,12/7/2020,12/7/2020,Mahaliah Sejour,Imported from Bank of America Visa-Awards trophy,D108,HJ,33.88,,12318.46
6790,12/7/2020,12/7/2020,Mahaliah Sejour,Imported from Bank of America Visa-Fellows gifts,D108,HJ,16.99,,12335.45
6790,12/7/2020,12/7/2020,Mahaliah Sejour,Imported from Bank of America Visa-Fellows gifts,D108,HJ,16.99,,12352.44
6790,12/7/2020,12/7/2020,Mahaliah Sejour,Imported from Bank of America Visa-Fellows gifts,D108,HJ,16.99,,12369.43
6790,12/7/2020,12/7/2020,Mahaliah Sejour,Imported from Bank of America Visa-Fellows gifts,D108,HJ,16.99,,12386.42
6790,12/7/2020,12/7/2020,Mahaliah Sejour,Imported from Bank of America Visa-Fellows gifts,D108,HJ,18.52,,12404.94
6790,12/7/2020,12/7/2020,Maryellen Leneghan,Imported from Bank of America Visa-Staff Fellow Appreciation,D108,HJ,10.57,,12415.51
6790,12/7/2020,12/7/2020,Maryellen Leneghan,Imported from Bank of America Visa-Staff Fellow Appreciation,D108,HJ,10.57,,12426.08
6790,12/7/2020,12/7/2020,Maryellen Leneghan,Imported from Bank of America Visa-Staff Fellow Appreciation,D108,HJ,10.57,,12436.65
6790,12/8/2020,12/8/2020,claice Jackson,Imported from Bank of America Visa-Appreciation,D108,HJ,24.19,,12460.84
6790,12/8/2020,12/8/2020,Mahaliah Sejour,Imported from Bank of America Visa-Fellows gifts,D108,HJ,16.77,,12477.61
6790,12/8/2020,12/8/2020,Mahaliah Sejour,Imported from Bank of America Visa-Fellows gifts,D108,HJ,16.77,,12494.38
6790,12/8/2020,12/8/2020,Mahaliah Sejour,Imported from Bank of America Visa-Fellows gifts,D108,HJ,16.77,,12511.15
6790,12/8/2020,12/8/2020,Mahaliah Sejour,Imported from Bank of America Visa-Fellows gifts,D108,HJ,16.77,,12527.92
6790,12/8/2020,12/8/2020,Mahaliah Sejour,Imported from Bank of America Visa-Fellows gifts,D108,HJ,16.99,,12544.91
6790,12/8/2020,12/8/2020,Mahaliah Sejour,Imported from Bank of America Visa-Fellows gifts,D108,HJ,16.99,,12561.9
6790,12/8/2020,12/8/2020,Mahaliah Sejour,Imported from Bank of America Visa-Fellows gifts,D108,HJ,22.93,,12584.83
6790,12/8/2020,12/8/2020,Mahaliah Sejour,Imported from Bank of America Visa-Fellows gifts,D108,HJ,22.93,,12607.76
6790,12/8/2020,12/8/2020,Mahaliah Sejour,Imported from Bank of America Visa-Fellows gifts,D108,HJ,22.93,,12630.69
6790,12/8/2020,12/8/2020,Mahaliah Sejour,Imported from Bank of America Visa-Fellows gifts,D108,HJ,46.98,,12677.67
6790,12/8/2020,12/8/2020,Maryellen Leneghan,Imported from Bank of America Visa-Staff Fellow Appreciation,D108,HJ,13.95,,12691.62
6790,12/8/2020,12/8/2020,Maryellen Leneghan,Imported from Bank of America Visa-Staff Fellow Appreciation,D108,HJ,16.24,,12707.86
6790,12/8/2020,12/8/2020,Maryellen Leneghan,Imported from Bank of America Visa-Staff Fellow Appreciation,D108,HJ,19.38,,12727.24
6790,12/8/2020,12/8/2020,Maryellen Leneghan,Imported from Bank of America Visa-Staff Fellow Appreciation,D108,HJ,19.94,,12747.18
6790,12/8/2020,12/8/2020,Maryellen Leneghan,Imported from Bank of America Visa-Staff Fellow Appreciation,D108,HJ,25.85,,12773.03
6790,12/8/2020,12/8/2020,Maryellen Leneghan,Imported from Bank of America Visa-Staff Fellow Appreciation,D108,HJ,10.57,,12783.6
6790,12/9/2020,12/9/2020,Halley Bowman,Imported from Bank of America Visa-Thank you gift for helping with curriculum,D101,HJ,21.14,,12804.74
6790,12/9/2020,12/9/2020,Mahaliah Sejour,Imported from Bank of America Visa-Fellows gifts,D108,HJ,4.99,,12809.73
6790,12/9/2020,12/9/2020,Mahaliah Sejour,Imported from Bank of America Visa-Fellows gifts,D108,HJ,4.99,,12814.72
6790,12/9/2020,12/9/2020,Mahaliah Sejour,Imported from Bank of America Visa-Fellows gifts,D108,HJ,4.99,,12819.71
6790,12/9/2020,12/9/2020,Mahaliah Sejour,Imported from Bank of America Visa-Fellows gifts,D108,HJ,4.99,,12824.7
6790,12/9/2020,12/9/2020,Mahaliah Sejour,Imported from Bank of America Visa-Fellows gifts,D108,HJ,4.99,,12829.69
6790,12/9/2020,12/9/2020,Mahaliah Sejour,Imported from Bank of America Visa-Fellows gifts,D108,HJ,16.77,,12846.46
6790,12/9/2020,12/9/2020,Mahaliah Sejour,Imported from Bank of America Visa-Fellows gifts,D108,HJ,16.77,,12863.23
6790,12/9/2020,12/9/2020,Mahaliah Sejour,Imported from Bank of America Visa-Fellows gifts,D108,HJ,22.93,,12886.16
6790,12/9/2020,12/9/2020,Mahaliah Sejour,Imported from Bank of America Visa-Fellows gifts,D108,HJ,22.93,,12909.09
6790,12/9/2020,12/9/2020,Mahaliah Sejour,Imported from Bank of America Visa-Fellows gifts,D108,HJ,22.93,,12932.02
6790,12/9/2020,12/9/2020,Mahaliah Sejour,Imported from Bank of America Visa-Fellows gifts,D108,HJ,41.84,,12973.86
6790,12/9/2020,12/9/2020,Mahaliah Sejour,Imported from Bank of America Visa-Fellows gifts,D108,HJ,41.84,,13015.7
6790,12/9/2020,12/9/2020,Mahaliah Sejour,Imported from Bank of America Visa-Fellows gifts,D108,HJ,41.84,,13057.54
6790,12/9/2020,12/9/2020,Mahaliah Sejour,Imported from Bank of America Visa-Fellows gifts,D108,HJ,41.84,,13099.38
6790,12/9/2020,12/9/2020,Myesha Hossain,Imported from Bank of America Visa-Dewey Team Time,D108,HJ,19.99,,13119.37
6790,12/9/2020,12/9/2020,Myesha Hossain,Imported from Bank of America Visa-Dewey Team Time,D108,HJ,19.99,,13139.36
6790,12/9/2020,12/9/2020,Myesha Hossain,Imported from Bank of America Visa-Dewey Team Time,D108,HJ,19.99,,13159.35
6790,12/9/2020,12/9/2020,Myesha Hossain,Imported from Bank of America Visa-Dewey Team Time,D108,HJ,19.99,,13179.34
6790,12/9/2020,12/9/2020,Myesha Hossain,Imported from Bank of America Visa-Dewey Team Time,D108,HJ,19.99,,13199.33
6790,12/9/2020,12/9/2020,Myesha Hossain,Imported from Bank of America Visa-Dewey Team Time,D108,HJ,21.26,,13220.59
6790,12/10/2020,12/10/2020,Mahaliah Sejour,Imported from Bank of America Visa-Fellows gifts,D108,HJ,4.99,,13225.58
6790,12/10/2020,12/10/2020,Mahaliah Sejour,Imported from Bank of America Visa-Fellows gifts,D108,HJ,11.85,,13237.43
6790,12/10/2020,12/10/2020,Mahaliah Sejour,Imported from Bank of America Visa-Fellows gifts,D108,HJ,16.77,,13254.2
6790,12/10/2020,12/10/2020,Mahaliah Sejour,Imported from Bank of America Visa-Fellows gifts,D108,HJ,16.77,,13270.97
6790,12/10/2020,12/10/2020,Mahaliah Sejour,Imported from Bank of America Visa-Fellows gifts,D108,HJ,17.16,,13288.13
6790,12/10/2020,12/10/2020,Mahaliah Sejour,Imported from Bank of America Visa-Fellows gifts,D108,HJ,17.16,,13305.29
6790,12/10/2020,12/10/2020,Mahaliah Sejour,Imported from Bank of America Visa-Fellows gifts,D108,HJ,17.16,,13322.45
6790,12/10/2020,12/10/2020,Mahaliah Sejour,Imported from Bank of America Visa-Fellows gifts,D108,HJ,17.16,,13339.61
6790,12/10/2020,12/10/2020,Mahaliah Sejour,Imported from Bank of America Visa-Fellows gifts,D108,HJ,22.87,,13362.48
6790,12/10/2020,12/10/2020,Mahaliah Sejour,Imported from Bank of America Visa-Fellows gifts,D108,HJ,29.88,,13392.36
6790,12/10/2020,12/10/2020,Mahaliah Sejour,Imported from Bank of America Visa-Fellows gifts,D108,HJ,41.84,,13434.2
6790,12/10/2020,12/10/2020,Mahaliah Sejour,Imported from Bank of America Visa-Fellows gifts,D108,HJ,42.22,,13476.42
6790,12/10/2020,12/10/2020,Maryellen Leneghan,Imported from Bank of America Visa-Staff Fellow Appreciation,D108,HJ,28.61,,13505.03
6790,12/10/2020,12/10/2020,Myesha Hossain,Imported from Bank of America Visa-Dewey Team Time,D108,HJ,19.99,,13525.02
6790,12/10/2020,12/10/2020,Myesha Hossain,Imported from Bank of America Visa-Lincoln Appreciation,D108,HJ,15,,13540.02
6790,12/11/2020,12/11/2020,Mahaliah Sejour,Imported from Bank of America Visa-Fellows gifts,D108,HJ,41.84,,13581.86
6790,12/11/2020,12/11/2020,Maryellen Leneghan,Imported from Bank of America Visa-Staff Fellow Appreciation,D108,HJ,9.99,,13591.85
6790,12/11/2020,12/11/2020,Maryellen Leneghan,Imported from Bank of America Visa-Staff Fellow Appreciation,D108,HJ,11.76,,13603.61
6790,12/11/2020,12/11/2020,Maryellen Leneghan,Imported from Bank of America Visa-Staff Fellow Appreciation,D108,HJ,21.54,,13625.15
6790,12/12/2020,12/12/2020,Mahaliah Sejour,Imported from Bank of America Visa-Fellows gifts,D108,HJ,29.87,,13655.02
6790,12/12/2020,12/12/2020,Mahaliah Sejour,Imported from Bank of America Visa-Fellows gifts,D108,HJ,40.74,,13695.76
6790,12/12/2020,12/12/2020,Mahaliah Sejour,Imported from Bank of America Visa-Fellows gifts,D108,HJ,51.73,,13747.49
6790,12/13/2020,12/13/2020,Mahaliah Sejour,Imported from Bank of America Visa-Fellows gifts,D108,HJ,6.98,,13754.47
6790,12/13/2020,12/13/2020,Mahaliah Sejour,Imported from Bank of America Visa-Fellows gifts,D108,HJ,21.45,,13775.92
6790,12/13/2020,12/13/2020,Mahaliah Sejour,Imported from Bank of America Visa-Fellows gifts,D108,HJ,50.84,,13826.76
6790,12/13/2020,12/13/2020,Mahaliah Sejour,Imported from Bank of America Visa-Fellows gifts,D108,HJ,61.11,,13887.87
6790,12/13/2020,12/13/2020,Myesha Hossain,Imported from Bank of America Visa-Dewey Team Time,D108,HJ,5.59,,13893.46
6790,12/14/2020,12/14/2020,Mahaliah Sejour,Imported from Bank of America Visa-Fellows gifts,D108,HJ,11.33,,13904.79
6790,12/14/2020,12/14/2020,Mahaliah Sejour,Imported from Bank of America Visa-Fellows gifts,D108,HJ,12.95,,13917.74
6790,12/14/2020,12/14/2020,Mahaliah Sejour,Imported from Bank of America Visa-Fellows gifts,D108,HJ,12.99,,13930.73
6790,12/14/2020,12/14/2020,Mahaliah Sejour,Imported from Bank of America Visa-Fellows gifts,D108,HJ,16.61,,13947.34
6790,12/14/2020,12/14/2020,Mahaliah Sejour,Imported from Bank of America Visa-Fellows gifts,D108,HJ,24.57,,13971.91
6790,12/14/2020,12/14/2020,Mahaliah Sejour,Imported from Bank of America Visa-Fellows gifts,D108,HJ,24.59,,13996.5
6790,12/14/2020,12/14/2020,Mahaliah Sejour,Imported from Bank of America Visa-Fellows gifts,D108,HJ,24.6,,14021.1
6790,12/14/2020,12/14/2020,Mahaliah Sejour,Imported from Bank of America Visa-Fellows gifts,D108,HJ,35.88,,14056.98
6790,12/14/2020,12/14/2020,Maryellen Leneghan,Imported from Bank of America Visa-Staff Fellow Appreciation,D108,HJ,18.98,,14075.96
6790,12/14/2020,12/14/2020,Maryellen Leneghan,Imported from Bank of America Visa-Staff Fellow Appreciation,D108,HJ,19.95,,14095.91
6790,12/14/2020,12/14/2020,Maryellen Leneghan,Imported from Bank of America Visa-Staff Fellow Appreciation,D108,HJ,26.78,,14122.69
6790,12/14/2020,12/14/2020,Maryellen Leneghan,Imported from Bank of America Visa-Staff Fellow Appreciation,D108,HJ,27.98,,14150.67
6790,12/14/2020,12/14/2020,Maryellen Leneghan,Imported from Bank of America Visa-Staff Fellow Appreciation,D108,HJ,52.98,,14203.65
6790,12/14/2020,12/14/2020,Myesha Hossain,Imported from Bank of America Visa-Dewey Team Time,D108,HJ,5.59,,14209.24
6790,12/14/2020,12/14/2020,Nicole Prahin,Imported from Bank of America Visa-Student Testimonial laminated postcards for CPS district leaders,D108,HJ,82.69,,14291.93
6790,12/15/2020,12/15/2020,Mahaliah Sejour,Imported from Bank of America Visa-Fellows gifts,D108,HJ,7.99,,14299.92
6790,12/15/2020,12/15/2020,Mahaliah Sejour,Imported from Bank of America Visa-Fellows gifts,D108,HJ,7.99,,14307.91
6790,12/15/2020,12/15/2020,Mahaliah Sejour,Imported from Bank of America Visa-Fellows gifts,D108,HJ,7.99,,14315.9
6790,12/15/2020,12/15/2020,Mahaliah Sejour,Imported from Bank of America Visa-Fellows gifts,D108,HJ,7.99,,14323.89
6790,12/15/2020,12/15/2020,Mahaliah Sejour,Imported from Bank of America Visa-Fellows gifts,D108,HJ,12.95,,14336.84
6790,12/15/2020,12/15/2020,Mahaliah Sejour,Imported from Bank of America Visa-Fellows gifts,D108,HJ,13.73,,14350.57
6790,12/15/2020,12/15/2020,Mahaliah Sejour,Imported from Bank of America Visa-Fellows gifts,D108,HJ,13.8,,14364.37
6790,12/15/2020,12/15/2020,Mahaliah Sejour,Imported from Bank of America Visa-Fellows gifts,D108,HJ,13.86,,14378.23
6790,12/15/2020,12/15/2020,Mahaliah Sejour,Imported from Bank of America Visa-Fellows gifts,D108,HJ,25.9,,14404.13
6790,12/15/2020,12/15/2020,Maryellen Leneghan,Imported from Bank of America Visa-Staff Fellow Appreciation,D108,HJ,14.09,,14418.22
6790,12/15/2020,12/15/2020,Maryellen Leneghan,Imported from Bank of America Visa-Staff Fellow Appreciation,D108,HJ,14.97,,14433.19
6790,12/15/2020,12/15/2020,Maryellen Leneghan,Imported from Bank of America Visa-Staff Fellow Appreciation,D108,HJ,18.99,,14452.18
6790,12/15/2020,12/15/2020,Maryellen Leneghan,Imported from Bank of America Visa-Staff Fellow Appreciation,D108,HJ,21.99,,14474.17
6790,12/15/2020,12/15/2020,Maryellen Leneghan,Imported from Bank of America Visa-Staff Fellow Appreciation,D108,HJ,22.97,,14497.14
6790,12/15/2020,12/15/2020,Myesha Hossain,Imported from Bank of America Visa-Dewey Team Time,D108,HJ,5.59,,14502.73
6790,12/15/2020,12/15/2020,Myesha Hossain,Imported from Bank of America Visa-Dewey Team Time,D108,HJ,5.59,,14508.32
6790,12/15/2020,12/15/2020,Myesha Hossain,Imported from Bank of America Visa-Dewey Team Time,D108,HJ,5.59,,14513.91
6790,12/15/2020,12/15/2020,Myesha Hossain,Imported from Bank of America Visa-Dewey Team Time,D108,HJ,5.59,,14519.5
6790,12/15/2020,12/15/2020,Myesha Hossain,Imported from Bank of America Visa-Dewey Team Time,D108,HJ,5.94,,14525.44
6790,12/15/2020,12/15/2020,Myesha Hossain,Imported from Bank of America Visa-Lincoln Appreciation,D108,HJ,32.23,,14557.67
6790,12/15/2020,12/15/2020,Myesha Hossain,Imported from Bank of America Visa-Lincoln Team Time,D108,HJ,31.43,,14589.1
6790,12/15/2020,12/15/2020,Myesha Hossain,Imported from Bank of America Visa-Randolph Team Time,D108,HJ,16.96,,14606.06
6790,12/15/2020,12/15/2020,Myesha Hossain,Imported from Bank of America Visa-Randolph Team Time,D108,HJ,16.96,,14623.02
6790,12/15/2020,12/15/2020,Nicole Prahin,Imported from Bank of America Visa-Mailed Student Testimonial cards to CPS district leaders,D108,HJ,17.57,,14640.59
6790,12/16/2020,12/16/2020,Mahaliah Sejour,Imported from Bank of America Visa-Fellows gifts,D108,HJ,10.81,,14651.4
6790,12/16/2020,12/16/2020,Mahaliah Sejour,Imported from Bank of America Visa-Fellows gifts,D108,HJ,16.11,,14667.51
6790,12/16/2020,12/16/2020,Mahaliah Sejour,Imported from Bank of America Visa-Fellows gifts,D108,HJ,16.95,,14684.46
6790,12/16/2020,12/16/2020,Maryellen Leneghan,Imported from Bank of America Visa-Staff Fellow Appreciation,D108,HJ,9.86,,14694.32
6790,12/16/2020,12/16/2020,Maryellen Leneghan,Imported from Bank of America Visa-Staff Fellow Appreciation,D108,HJ,13.89,,14708.21
6790,12/16/2020,12/16/2020,Maryellen Leneghan,Imported from Bank of America Visa-Staff Fellow Appreciation,D108,HJ,13.95,,14722.16
6790,12/16/2020,12/16/2020,Maryellen Leneghan,Imported from Bank of America Visa-Staff Fellow Appreciation,D108,HJ,14.22,,14736.38
6790,12/16/2020,12/16/2020,Maryellen Leneghan,Imported from Bank of America Visa-Staff Fellow Appreciation,D108,HJ,15.89,,14752.27
6790,12/16/2020,12/16/2020,Maryellen Leneghan,Imported from Bank of America Visa-Staff Fellow Appreciation,D108,HJ,15.95,,14768.22
6790,12/16/2020,12/16/2020,Maryellen Leneghan,Imported from Bank of America Visa-Staff Fellow Appreciation,D108,HJ,21.91,,14790.13
6790,12/16/2020,12/16/2020,Maryellen Leneghan,Imported from Bank of America Visa-Staff Fellow Appreciation,D108,HJ,21.99,,14812.12
6790,12/16/2020,12/16/2020,Maryellen Leneghan,Imported from Bank of America Visa-Staff Fellow Appreciation,D108,HJ,23.96,,14836.08
6790,12/16/2020,12/16/2020,Myesha Hossain,Imported from Bank of America Visa-Lincoln Appreciation,D108,HJ,16.5,,14852.58
6790,12/16/2020,12/16/2020,Myesha Hossain,Imported from Bank of America Visa-Lincoln Team Time,D108,HJ,31.43,,14884.01
6790,12/16/2020,12/16/2020,Myesha Hossain,Imported from Bank of America Visa-Lincoln Team Time,D108,HJ,33.71,,14917.72
6790,12/17/2020,12/17/2020,Mahaliah Sejour,Imported from Bank of America Visa-Fellows gifts,D108,HJ,12.4,,14930.12
6790,12/17/2020,12/17/2020,Mahaliah Sejour,Imported from Bank of America Visa-Fellows gifts,D108,HJ,15.89,,14946.01
6790,12/17/2020,12/17/2020,Mahaliah Sejour,Imported from Bank of America Visa-Fellows gifts,D108,HJ,34.92,,14980.93
6790,12/17/2020,12/17/2020,Mahaliah Sejour,Imported from Bank of America Visa-Fellows gifts,D108,HJ,34.92,,15015.85
6790,12/17/2020,12/17/2020,Mahaliah Sejour,Imported from Bank of America Visa-Fellows gifts,D108,HJ,34.92,,15050.77
6790,12/17/2020,12/17/2020,Mahaliah Sejour,Imported from Bank of America Visa-Fellows gifts,D108,HJ,34.92,,15085.69
6790,12/17/2020,12/17/2020,Mahaliah Sejour,Imported from Bank of America Visa-holiday dinner,D108,HJ,3.31,,15089
6790,12/17/2020,12/17/2020,Mahaliah Sejour,Imported from Bank of America Visa-holiday dinner,D108,HJ,27.89,,15116.89
6790,12/17/2020,12/17/2020,Maryellen Leneghan,Imported from Bank of America Visa-Staff Fellow Appreciation,D108,HJ,14.3,,15131.19
6790,12/17/2020,12/17/2020,Maryellen Leneghan,Imported from Bank of America Visa-Staff Fellow Appreciation,D108,HJ,14.98,,15146.17
6790,12/17/2020,12/17/2020,Maryellen Leneghan,Imported from Bank of America Visa-Staff Fellow Appreciation,D108,HJ,14.99,,15161.16
6790,12/17/2020,12/17/2020,Maryellen Leneghan,Imported from Bank of America Visa-Staff Fellow Appreciation,D108,HJ,18.56,,15179.72
6790,12/17/2020,12/17/2020,Maryellen Leneghan,Imported from Bank of America Visa-Staff Fellow Appreciation,D108,HJ,18.78,,15198.5
6790,12/17/2020,12/17/2020,Maryellen Leneghan,Imported from Bank of America Visa-Staff Fellow Appreciation,D108,HJ,21.09,,15219.59
6790,12/17/2020,12/17/2020,Maryellen Leneghan,Imported from Bank of America Visa-Staff Fellow Appreciation,D108,HJ,23.69,,15243.28
6790,12/17/2020,12/17/2020,Maryellen Leneghan,Imported from Bank of America Visa-Staff Fellow Appreciation,D108,HJ,20,,15263.28
6790,12/17/2020,12/17/2020,Myesha Hossain,Imported from Bank of America Visa-Lincoln Team Time,D108,HJ,31.43,,15294.71
6790,12/17/2020,12/17/2020,Myesha Hossain,Imported from Bank of America Visa-Lincoln Team Time,D108,HJ,31.43,,15326.14
6790,12/17/2020,12/17/2020,Myesha Hossain,Imported from Bank of America Visa-Lincoln Team Time,D108,HJ,33.52,,15359.66
6790,12/17/2020,12/17/2020,Myesha Hossain,Imported from Bank of America Visa-Randolph Team Time,D108,HJ,16.96,,15376.62
6790,12/18/2020,12/18/2020,Lisa Kapusta,Imported from Bank of America Visa-Staff appreciation gift,D108,HJ,36.1,,15412.72
6790,12/18/2020,12/18/2020,Mahaliah Sejour,Imported from Bank of America Visa-Fellows gifts,D108,HJ,13.49,,15426.21
6790,12/18/2020,12/18/2020,Maryellen Leneghan,Imported from Bank of America Visa-Staff Fellow Appreciation,D108,HJ,19.5,,15445.71
6790,12/18/2020,12/18/2020,Maryellen Leneghan,Imported from Bank of America Visa-Staff Fellow Appreciation,D108,HJ,19.99,,15465.7
6790,12/18/2020,12/18/2020,Maryellen Leneghan,Imported from Bank of America Visa-Staff Fellow Appreciation,D108,HJ,27.99,,15493.69
6790,12/18/2020,12/18/2020,Maryellen Leneghan,Imported from Bank of America Visa-Staff Fellow Appreciation,D108,HJ,33.91,,15527.6
6790,12/18/2020,12/18/2020,Myesha Hossain,Imported from Bank of America Visa-Dewey Key Player Appreciation,D108,HJ,18.99,,15546.59
6790,12/18/2020,12/18/2020,Myesha Hossain,Imported from Bank of America Visa-Dewey Key Player Appreciation,D108,HJ,18.99,,15565.58
6790,12/19/2020,12/19/2020,Maryellen Leneghan,Imported from Bank of America Visa-Staff Fellow Appreciation,D108,HJ,10.99,,15576.57
6790,12/19/2020,12/19/2020,Maryellen Leneghan,Imported from Bank of America Visa-Staff Fellow Appreciation,D108,HJ,19.96,,15596.53
6790,12/19/2020,12/19/2020,Myesha Hossain,Imported from Bank of America Visa-Dewey Key Player Appreciation,D108,HJ,14.95,,15611.48
6790,12/19/2020,12/19/2020,Myesha Hossain,Imported from Bank of America Visa-Dewey Key Player Appreciation,D108,HJ,14.95,,15626.43
6790,12/19/2020,12/19/2020,Myesha Hossain,Imported from Bank of America Visa-Randolph Team Time,D108,HJ,16.96,,15643.39
6790,12/19/2020,12/19/2020,Myesha Hossain,Imported from Bank of America Visa-Team Time,D108,HJ,16.96,,15660.35
6790,12/20/2020,12/20/2020,Mahaliah Sejour,Imported from Bank of America Visa-Fellows gifts,D108,HJ,10.95,,15671.3
6790,12/20/2020,12/20/2020,Mahaliah Sejour,Imported from Bank of America Visa-Fellows gifts,D108,HJ,21.95,,15693.25
6790,12/20/2020,12/20/2020,Maryellen Leneghan,Imported from Bank of America Visa-Staff Fellow Appreciation,D108,HJ,14.95,,15708.2
6790,12/20/2020,12/20/2020,Maryellen Leneghan,Imported from Bank of America Visa-Staff Fellow Appreciation,D108,HJ,21.99,,15730.19
6790,12/20/2020,12/20/2020,Maryellen Leneghan,Imported from Bank of America Visa-Staff Fellow Appreciation,D108,HJ,19.99,,15750.18
6790,12/21/2020,12/21/2020,Grubhub,Bill.Com Import-Meal Purchases for BC-Programs,D108,HJ,66.78,,15816.96
6790,12/21/2020,12/21/2020,Grubhub,Bill.Com Import-Meal Purchases for CHI-Programs,D108,HJ,642.18,,16459.14
6790,12/21/2020,12/21/2020,Grubhub,Bill.Com Import-Meal Purchases for Academic Department,D101,HJ,221.58,,16680.72
6790,12/21/2020,12/21/2020,Grubhub,Bill.Com Import-Meal Purchases for Finance Department,D103,HJ,73.77,,16754.49
6790,12/21/2020,12/21/2020,Grubhub,Bill.Com Import-Meal Purchases for Human Resources Department,D104,HJ,75.95,,16830.44
6790,12/21/2020,12/21/2020,Grubhub,Bill.Com Import-Meal Purchases for Recruitment,D111,HJ,96.21,,16926.65
6790,12/21/2020,12/21/2020,Grubhub,Bill.Com Import-Meal Purchases for NYC-Programs,D108,HJ,991.37,,17918.02
6790,12/21/2020,12/21/2020,Grubhub,Bill.Com Import-Meal Purchases for DC-Programs,D108,HJ,31.8,,17949.82
6790,12/21/2020,12/21/2020,Mahaliah Sejour,Imported from Bank of America Visa-Fellows gifts,D108,HJ,18.97,,17968.79
6790,12/21/2020,12/21/2020,Maryellen Leneghan,Imported from Bank of America Visa-Staff Fellow Appreciation,D108,HJ,18.35,,17987.14
6790,12/21/2020,12/21/2020,Maryellen Leneghan,Imported from Bank of America Visa-Staff Fellow Appreciation,D108,HJ,14.99,,18002.13
6790,12/21/2020,12/21/2020,Myesha Hossain,Imported from Bank of America Visa-Dewey Key Player Appreciation,D108,HJ,33.94,,18036.07
6790,12/22/2020,12/22/2020,Maryellen Leneghan,Imported from Bank of America Visa-Staff Fellow Appreciation,D108,HJ,18.9,,18054.97
6790,12/22/2020,12/22/2020,Maryellen Leneghan,Imported from Bank of America Visa-Staff Fellow Appreciation,D108,HJ,22.99,,18077.96
6790,12/22/2020,12/22/2020,Maryellen Leneghan,Imported from Bank of America Visa-Staff Fellow Appreciation,D108,HJ,27.99,,18105.95
6790,12/22/2020,12/22/2020,Maryellen Leneghan,Imported from Bank of America Visa-Staff Fellow Appreciation,D108,HJ,28.99,,18134.94
6790,12/22/2020,12/22/2020,Maryellen Leneghan,Imported from Bank of America Visa-Staff Fellow Appreciation,D108,HJ,69.85,,18204.79
6790,12/22/2020,12/22/2020,Maryellen Leneghan,Imported from Bank of America Visa-Staff Fellow Appreciation,D108,HJ,39.89,,18244.68
6790,12/22/2020,12/22/2020,Myesha Hossain,Imported from Bank of America Visa-SD Appreciation,D108,HJ,14.95,,18259.63
6790,12/22/2020,12/22/2020,Myesha Hossain,Imported from Bank of America Visa-SD Appreciation,D108,HJ,24.95,,18284.58
6790,12/23/2020,12/23/2020,Maryellen Leneghan,Imported from Bank of America Visa-Staff Fellow Appreciation,D108,HJ,28.6,,18313.18
6790,12/23/2020,12/23/2020,Myesha Hossain,Imported from Bank of America Visa-SD Appreciation,D108,HJ,17.95,,18331.13
6790,12/23/2020,12/23/2020,Myesha Hossain,Imported from Bank of America Visa-SD Appreciation,D108,HJ,17.95,,18349.08
6790,12/23/2020,12/23/2020,Myesha Hossain,Imported from Bank of America Visa-Staff Appreciation,D108,HJ,18.95,,18368.03
6790,12/24/2020,12/24/2020,Maryellen Leneghan,Imported from Bank of America Visa-Staff Fellow Appreciation,D108,HJ,28.6,,18396.63
6790,12/24/2020,12/24/2020,Maryellen Leneghan,Imported from Bank of America Visa-Staff Fellow Appreciation,D108,HJ,28.6,,18425.23
6790,12/24/2020,12/24/2020,Myesha Hossain,Imported from Bank of America Visa-SD Appreciation,D108,HJ,14.95,,18440.18
6790,12/27/2020,12/27/2020,Myesha Hossain,Imported from Bank of America Visa-Holiday Social,D108,HJ,18.99,,18459.17
6790,12/28/2020,12/28/2020,Mahaliah Sejour,Imported from Bank of America Visa-Fellows gifts,D108,HJ,5.99,,18465.16
6790,12/31/2020,12/31/2020,20201231,Actual vs Budget Reclass as of 12/31/2020-Actual vs Budget Reclass as of 12/31/2020,D107,HJ,,282.55,18182.61
6790,12/31/2020,12/31/2020,20201231,Actual vs Budget Reclass as of 12/31/2020-Actual vs Budget Reclass as of 12/31/2020,D107,HJ,282.55,,18465.16
6790,12/31/2020,12/31/2020,Myesha Hossain,Imported from Bank of America Visa-Lincoln ASD Appreciation,D108,HJ,22.99,,18488.15
6790,1/4/2021,1/4/2021,Antonio Gutierrez,Imported from Bank of America Visa-tutor appreciation-books,D107,HJ,26.97,,18515.12
6790,1/6/2021,1/6/2021,Halley Bowman,Imported from Bank of America Visa-book club book as reward for attending first book club,D101,HJ,14.86,,18529.98
6790,1/6/2021,1/6/2021,Maryellen Leneghan,Imported from Bank of America Visa-Staff.Fellow Appreciation,D108,HJ,14.83,,18544.81
6790,1/6/2021,1/6/2021,Maryellen Leneghan,Imported from Bank of America Visa-Staff.Fellow Appreciation,D108,HJ,24.06,,18568.87
6790,1/7/2021,1/7/2021,Alan Safran,Imported from Bank of America Visa-Gift for Monivett,D107,HJ,19.24,,18588.11
6790,1/10/2021,1/10/2021,Alan Safran,Imported from Bank of America Visa-Gift for Monivett,D107,HJ,10.99,,18599.1
6790,1/10/2021,1/10/2021,Halley Bowman,Imported from Bank of America Visa-book club book as reward for attending first book club,D101,HJ,15.75,,18614.85
6790,1/10/2021,1/10/2021,Maryellen Leneghan,Imported from Bank of America Visa-Staff.Fellow Appreciation,D108,HJ,73.98,,18688.83
6790,1/13/2021,1/13/2021,Antonio Gutierrez,Imported from Bank of America Visa-Jeff Ward Appreciation,D107,HJ,79,,18767.83
6790,1/13/2021,1/13/2021,Maryellen Leneghan,Imported from Bank of America Visa-Staff.Fellow Appreciation,D108,HJ,65.98,,18833.81
6790,1/20/2021,1/20/2021,Myesha Hossain,Imported from Bank of America Visa-HSFI Team Time,D108,HJ,22.1,,18855.91
6790,1/22/2021,1/22/2021,Grubhub,Bill.Com Import-Meal Purchases for BC PROGRAM department,D108,HJ,286.42,,19142.33
6790,1/22/2021,1/22/2021,Grubhub,Bill.Com Import-Meal Purchases for CHI PROGRAM department,D108,HJ,1135.51,,20277.84
6790,1/22/2021,1/22/2021,Grubhub,Bill.Com Import-Meal Purchases for Academics department,D101,HJ,47.7,,20325.54
6790,1/22/2021,1/22/2021,Grubhub,Bill.Com Import-Meal Purchases for Finance Department,D103,HJ,162.82,,20488.36
6790,1/22/2021,1/22/2021,Grubhub,Bill.Com Import-Meal Purchases for Infosystech department,D105,HJ,15.9,,20504.26
6790,1/22/2021,1/22/2021,Grubhub,Bill.Com Import-Meal Purchases for Recruitment department,D111,HJ,58.3,,20562.56
6790,1/22/2021,1/22/2021,Grubhub,Bill.Com Import-Meal Purchases for NYC PROGRAM department,D108,HJ,527.03,,21089.59
6790,1/22/2021,1/22/2021,Grubhub,Bill.Com Import-Meal Purchases for DC PROGRAM department,D108,HJ,158.78,,21248.37
6790,1/22/2021,1/22/2021,Maryellen Leneghan,Imported from Bank of America Visa-Staff.Fellow Appreciation,D108,HJ,8.76,,21257.13
6790,1/23/2021,1/23/2021,Maryellen Leneghan,Imported from Bank of America Visa-Staff.Fellow Appreciation,D108,HJ,8.68,,21265.81
6790,1/23/2021,1/23/2021,Maryellen Leneghan,Imported from Bank of America Visa-Staff.Fellow Appreciation,D108,HJ,8.68,,21274.49
6790,1/23/2021,1/23/2021,Maryellen Leneghan,Imported from Bank of America Visa-Staff.Fellow Appreciation,D108,HJ,8.68,,21283.17
6790,1/23/2021,1/23/2021,Maryellen Leneghan,Imported from Bank of America Visa-Staff.Fellow Appreciation,D108,HJ,8.68,,21291.85
6790,1/24/2021,1/24/2021,Maryellen Leneghan,Imported from Bank of America Visa-Staff.Fellow Appreciation,D108,HJ,21.95,,21313.8
6790,1/24/2021,1/24/2021,Maryellen Leneghan,Imported from Bank of America Visa-Staff.Fellow Appreciation,D108,HJ,21.95,,21335.75
6790,1/24/2021,1/24/2021,Maryellen Leneghan,Imported from Bank of America Visa-Staff.Fellow Appreciation,D108,HJ,21.95,,21357.7
6790,1/24/2021,1/24/2021,Maryellen Leneghan,Imported from Bank of America Visa-Staff.Fellow Appreciation,D108,HJ,21.95,,21379.65
6790,1/24/2021,1/24/2021,Maryellen Leneghan,Imported from Bank of America Visa-Staff.Fellow Appreciation,D108,HJ,8.68,,21388.33
6790,1/24/2021,1/24/2021,Maryellen Leneghan,Imported from Bank of America Visa-Staff.Fellow Appreciation,D108,HJ,8.68,,21397.01
6790,1/24/2021,1/24/2021,Maryellen Leneghan,Imported from Bank of America Visa-Staff.Fellow Appreciation,D108,HJ,8.68,,21405.69
6790,1/25/2021,1/25/2021,Maryellen Leneghan,Imported from Bank of America Visa-Staff.Fellow Appreciation,D108,HJ,8.19,,21413.88
6790,1/25/2021,1/25/2021,Maryellen Leneghan,Imported from Bank of America Visa-Staff.Fellow Appreciation,D108,HJ,8.68,,21422.56
6790,1/25/2021,1/25/2021,Maryellen Leneghan,Imported from Bank of America Visa-Staff.Fellow Appreciation,D108,HJ,8.68,,21431.24
6790,1/25/2021,1/25/2021,Maryellen Leneghan,Imported from Bank of America Visa-Staff.Fellow Appreciation,D108,HJ,8.68,,21439.92
6790,1/25/2021,1/25/2021,Myesha Hossain,Imported from Bank of America Visa-Birthday Card,D108,HJ,4.99,,21444.91
6790,1/25/2021,1/25/2021,Myesha Hossain,Imported from Bank of America Visa-Fellow Bday,D108,HJ,8.47,,21453.38
6790,1/25/2021,1/25/2021,Myesha Hossain,Imported from Bank of America Visa-HPHS Fellow Bday,D108,HJ,4.99,,21458.37
6790,1/26/2021,1/26/2021,Halley Bowman,Imported from Bank of America Visa-appreciation gift for Julie Dziedzic,D101,HJ,7.99,,21466.36
6790,1/26/2021,1/26/2021,Maryellen Leneghan,Imported from Bank of America Visa-Staff.Fellow Appreciation,D108,HJ,8.68,,21475.04
6790,1/26/2021,1/26/2021,Maryellen Leneghan,Imported from Bank of America Visa-Staff.Fellow Appreciation,D108,HJ,8.68,,21483.72
6790,1/26/2021,1/26/2021,Maryellen Leneghan,Imported from Bank of America Visa-Staff.Fellow Appreciation,D108,HJ,8.74,,21492.46
6790,1/26/2021,1/26/2021,Maryellen Leneghan,Imported from Bank of America Visa-Staff.Fellow Appreciation,D108,HJ,8.85,,21501.31
6790,1/26/2021,1/26/2021,Myesha Hossain,Imported from Bank of America Visa-HPHS Fellow Bday,D108,HJ,20.06,,21521.37
6790,1/27/2021,1/27/2021,Maryellen Leneghan,Imported from Bank of America Visa-Staff.Fellow Appreciation,D108,HJ,21.04,,21542.41
6790,1/27/2021,1/27/2021,Myesha Hossain,Imported from Bank of America Visa-Cleveland Team Time,D108,HJ,14.99,,21557.4
6790,1/27/2021,1/27/2021,Myesha Hossain,Imported from Bank of America Visa-Cleveland Team Time,D108,HJ,14.99,,21572.39
6790,1/28/2021,1/28/2021,Maryellen Leneghan,Imported from Bank of America Visa-Staff.Fellow Appreciation,D108,HJ,17.89,,21590.28
6790,1/28/2021,1/28/2021,Maryellen Leneghan,Imported from Bank of America Visa-Staff.Fellow Appreciation,D108,HJ,21.11,,21611.39
6790,1/28/2021,1/28/2021,Maryellen Leneghan,Imported from Bank of America Visa-Staff.Fellow Appreciation,D108,HJ,24.99,,21636.38
6790,1/28/2021,1/28/2021,Monivett Acevedo,Imported from Bank of America Visa-Spartan Race for Finance Team,D103,HJ,41.89,,21678.27
6790,1/28/2021,1/28/2021,Monivett Acevedo,Imported from Bank of America Visa-Spartan Race for Finance Team,D103,HJ,142.21,,21820.48
6790,1/28/2021,1/28/2021,Monivett Acevedo,Imported from Bank of America Visa-Spartan Race for Finance Team,D103,HJ,143.3,,21963.78
6790,1/28/2021,1/28/2021,Monivett Acevedo,Imported from Bank of America Visa-Spartan Race for Finance Team,D103,HJ,143.3,,22107.08
6790,1/28/2021,1/28/2021,Myesha Hossain,Imported from Bank of America Visa-Cleveland Team Time,D108,HJ,14.99,,22122.07
6790,1/28/2021,1/28/2021,Myesha Hossain,Imported from Bank of America Visa-Cleveland Team Time,D108,HJ,15.89,,22137.96
6790,1/28/2021,1/28/2021,Myesha Hossain,Imported from Bank of America Visa-Fellow Birthday,D108,HJ,26.75,,22164.71
6790,1/29/2021,1/29/2021,Nicole Prahin,Imported from Bank of America Visa-Options School Student Gift for New Baby,D108,HJ,23.32,,22188.03
6790,2/4/2021,2/4/2021,Mahaliah Sejour,Imported from Bank of America Visa-YCSS,D108,HJ,5.9,,22193.93
6790,2/4/2021,2/4/2021,Monivett Acevedo,Imported from reimbursements-Farewell gift for Grace,D107,HJ,40.54,,22234.47
6790,2/4/2021,2/4/2021,Monivett Acevedo,Imported from reimbursements-Farewell gift for Grace,D107,HJ,65.85,,22300.32
6790,2/4/2021,2/4/2021,Myesha Hossain,Imported from Bank of America Visa-HSFI Team Time,D108,HJ,16.96,,22317.28
6790,2/5/2021,2/5/2021,Maryellen Leneghan,Imported from Bank of America Visa-Staff.Fellow Appreciation,D108,HJ,9.9,,22327.18
6790,2/5/2021,2/5/2021,Maryellen Leneghan,Imported from Bank of America Visa-Staff.Fellow Appreciation,D108,HJ,10.59,,22337.77
6790,2/5/2021,2/5/2021,Maryellen Leneghan,Imported from Bank of America Visa-Staff.Fellow Appreciation,D108,HJ,11.95,,22349.72
6790,2/5/2021,2/5/2021,Myesha Hossain,Imported from Bank of America Visa-hphs team time,D108,HJ,16.31,,22366.03
6790,2/5/2021,2/5/2021,Myesha Hossain,Imported from Bank of America Visa-hphs team time,D108,HJ,16.62,,22382.65
6790,2/5/2021,2/5/2021,Myesha Hossain,Imported from Bank of America Visa-hphs team time,D108,HJ,16.66,,22399.31
6790,2/5/2021,2/5/2021,Myesha Hossain,Imported from Bank of America Visa-hphs team time,D108,HJ,16.66,,22415.97
6790,2/5/2021,2/5/2021,Myesha Hossain,Imported from Bank of America Visa-hphs team time,D108,HJ,16.66,,22432.63
6790,2/5/2021,2/5/2021,Myesha Hossain,Imported from Bank of America Visa-hphs team time,D108,HJ,16.66,,22449.29
6790,2/5/2021,2/5/2021,Myesha Hossain,Imported from Bank of America Visa-hphs team time,D108,HJ,16.66,,22465.95
6790,2/8/2021,2/8/2021,Mahaliah Sejour,Imported from Bank of America Visa-Fellows gifts,D108,HJ,21.82,,22487.77
6790,2/8/2021,2/8/2021,Mahaliah Sejour,Imported from Bank of America Visa-Fellows gifts,D108,HJ,22.82,,22510.59
6790,2/8/2021,2/8/2021,Mahaliah Sejour,Imported from Bank of America Visa-Fellows gifts,D108,HJ,22.82,,22533.41
6790,2/8/2021,2/8/2021,Mahaliah Sejour,Imported from Bank of America Visa-Fellows gifts,D108,HJ,22.82,,22556.23
6790,2/8/2021,2/8/2021,Mahaliah Sejour,Imported from Bank of America Visa-Fellows gifts,D108,HJ,22.82,,22579.05
6790,2/8/2021,2/8/2021,Mahaliah Sejour,Imported from Bank of America Visa-Fellows gifts,D108,HJ,22.82,,22601.87
6790,2/8/2021,2/8/2021,Mahaliah Sejour,Imported from Bank of America Visa-Fellows gifts,D108,HJ,22.88,,22624.75
6790,2/8/2021,2/8/2021,Mahaliah Sejour,Imported from Bank of America Visa-Fellows gifts,D108,HJ,24.97,,22649.72
6790,2/8/2021,2/8/2021,Maryellen Leneghan,Imported from Bank of America Visa-Staff.Fellow Appreciation,D108,HJ,7.55,,22657.27
6790,2/9/2021,2/9/2021,Maryellen Leneghan,Imported from Bank of America Visa-Staff.Fellow Appreciation,D108,HJ,5.99,,22663.26
6790,2/9/2021,2/9/2021,Monivett Acevedo,Imported from Bank of America Visa-CFA and Birthday Gift for Staff Accountant,D107,HJ,98.98,,22762.24
6790,2/10/2021,2/10/2021,Mahaliah Sejour,Imported from Bank of America Visa-fellow social,D108,HJ,34.99,,22797.23
6790,2/11/2021,2/11/2021,Elizabeth Peinado,Imported from Bank of America Visa-Work-anniversary token of appreciate,D111,HJ,2.75,,22799.98
6790,2/11/2021,2/11/2021,Elizabeth Peinado,Imported from Bank of America Visa-Work-anniversary token of appreciate,D111,HJ,4.25,,22804.23
6790,2/11/2021,2/11/2021,Elizabeth Peinado,Imported from Bank of America Visa-Work-anniversary token of appreciate,D111,HJ,4.25,,22808.48
6790,2/11/2021,2/11/2021,Elizabeth Peinado,Imported from Bank of America Visa-Work-anniversary token of appreciate,D111,HJ,13.75,,22822.23
6790,2/11/2021,2/11/2021,Mahaliah Sejour,Imported from Bank of America Visa-Fellows gifts,D108,HJ,9.99,,22832.22
6790,2/11/2021,2/11/2021,Mahaliah Sejour,Imported from Bank of America Visa-red herring purchase for fellow social,D108,HJ,0.7,,22832.92
6790,2/11/2021,2/11/2021,Myesha Hossain,Imported from Bank of America Visa-Cleveland ASD appreciation,D108,HJ,15.43,,22848.35
6790,2/11/2021,2/11/2021,Myesha Hossain,Imported from Bank of America Visa-Cleveland Fellow Appreciation,D108,HJ,9.12,,22857.47
6790,2/11/2021,2/11/2021,Myesha Hossain,Imported from Bank of America Visa-Cleveland Fellow Appreciation,D108,HJ,9.12,,22866.59
6790,2/11/2021,2/11/2021,Myesha Hossain,Imported from Bank of America Visa-Cleveland Fellow Appreciation,D108,HJ,11.49,,22878.08
6790,2/11/2021,2/11/2021,Myesha Hossain,Imported from Bank of America Visa-HPHS Appreciation,D108,HJ,60,,22938.08
6790,2/12/2021,2/12/2021,Mahaliah Sejour,Imported from Bank of America Visa-Fellows gifts,D108,HJ,9.99,,22948.07
6790,2/12/2021,2/12/2021,Mahaliah Sejour,Imported from Bank of America Visa-Fellows gifts,D108,HJ,29.98,,22978.05
6790,2/12/2021,2/12/2021,Myesha Hossain,Imported from Bank of America Visa-Cleveland Fellow Appreciation,D108,HJ,9.12,,22987.17
6790,2/12/2021,2/12/2021,Myesha Hossain,Imported from Bank of America Visa-Cleveland SD appreciation,D108,HJ,34.41,,23021.58
6790,2/15/2021,2/15/2021,Mahaliah Sejour,Imported from Bank of America Visa-Fellows gifts,D108,HJ,9.99,,23031.57
6790,2/15/2021,2/15/2021,Mahaliah Sejour,Imported from Bank of America Visa-Fellows gifts,D108,HJ,9.99,,23041.56
6790,2/17/2021,2/17/2021,Mahaliah Sejour,Imported from Bank of America Visa-amazon refund,D108,HJ,,9.99,23031.57
6790,2/19/2021,2/19/2021,Lisa Kapusta,Imported from Bank of America Visa-FLORAL PRODUCTS,D108,HJ,89.76,,23121.33
6790,2/21/2021,2/21/2021,Mahaliah Sejour,Imported from Bank of America Visa-Fellows gifts,D108,HJ,30.58,,23151.91
6790,2/21/2021,2/21/2021,Mahaliah Sejour,Imported from Bank of America Visa-Lanigan baby shower,D108,HJ,100.5,,23252.41
6790,2/22/2021,2/22/2021,Grubhub,Bill.Com Import-Meal Purchases for DC Program department,D108,HJ,151.72,,23404.13
6790,2/22/2021,2/22/2021,Grubhub,Bill.Com Import-Meal Purchases for CHI Program department,D108,HJ,282.29,,23686.42
6790,2/22/2021,2/22/2021,Grubhub,Bill.Com Import-Meal Purchases for Academics department,D101,HJ,126.52,,23812.94
6790,2/22/2021,2/22/2021,Grubhub,Bill.Com Import-Meal Purchases for Finance department,D103,HJ,105.52,,23918.46
6790,2/22/2021,2/22/2021,Grubhub,Bill.Com Import-Meal Purchases for Human Resources Program department,D104,HJ,21.2,,23939.66
6790,2/22/2021,2/22/2021,Grubhub,Bill.Com Import-Meal Purchases for Recruitment department,D111,HJ,186.24,,24125.9
6790,2/22/2021,2/22/2021,Grubhub,Bill.Com Import-Meal Purchases for DC Program department,D108,HJ,332.73,,24458.63
6790,2/22/2021,2/22/2021,Maryellen Leneghan,Imported from Bank of America Visa-Staff Social,D108,HJ,26.48,,24485.11
6790,2/22/2021,2/22/2021,Myesha Hossain,Imported from Bank of America Visa-tax exempt refund,D108,HJ,,1.32,24483.79
6790,2/22/2021,2/22/2021,Myesha Hossain,Imported from Bank of America Visa-tax exempt refund,D108,HJ,,1.36,24482.43
6790,2/22/2021,2/22/2021,Myesha Hossain,Imported from Bank of America Visa-tax exempt refund,D108,HJ,,1.36,24481.07
6790,2/22/2021,2/22/2021,Myesha Hossain,Imported from Bank of America Visa-tax exempt refund,D108,HJ,,1.36,24479.71
6790,2/22/2021,2/22/2021,Myesha Hossain,Imported from Bank of America Visa-tax exempt refund,D108,HJ,,1.36,24478.35
6790,2/22/2021,2/22/2021,Myesha Hossain,Imported from Bank of America Visa-tax exempt refund,D108,HJ,,1.36,24476.99
6790,2/23/2021,2/23/2021,Mahaliah Sejour,Imported from Bank of America Visa-Lanigan baby shower,D108,HJ,17.89,,24494.88
6790,2/23/2021,2/23/2021,Mahaliah Sejour,Imported from Bank of America Visa-SD social,D108,HJ,27.55,,24522.43
6790,2/23/2021,2/23/2021,Mahaliah Sejour,Imported from Bank of America Visa-SD social,D108,HJ,27.55,,24549.98
6790,2/23/2021,2/23/2021,Mahaliah Sejour,Imported from Bank of America Visa-SD social,D108,HJ,27.55,,24577.53
6790,2/23/2021,2/23/2021,Mahaliah Sejour,Imported from Bank of America Visa-SD social,D108,HJ,27.55,,24605.08
6790,2/23/2021,2/23/2021,Mahaliah Sejour,Imported from Bank of America Visa-SD social,D108,HJ,27.68,,24632.76
6790,2/23/2021,2/23/2021,Mahaliah Sejour,Imported from Bank of America Visa-SD social,D108,HJ,33.56,,24666.32
6790,2/23/2021,2/23/2021,Mahaliah Sejour,Imported from Bank of America Visa-SD social,D108,HJ,47.84,,24714.16
6790,2/23/2021,2/23/2021,Myesha Hossain,Imported from Bank of America Visa-HPHS Fellow Bday,D108,HJ,4.99,,24719.15
6790,2/23/2021,2/23/2021,Myesha Hossain,Imported from Bank of America Visa-HPHS Fellow Bday,D108,HJ,19.99,,24739.14
6790,2/23/2021,2/23/2021,Myesha Hossain,Imported from Bank of America Visa-SD Appreciation,D108,HJ,,27.2,24711.94
6790,2/23/2021,2/23/2021,Myesha Hossain,Imported from Bank of America Visa-SD social,D108,HJ,27.2,,24739.14
6790,2/23/2021,2/23/2021,Myesha Hossain,Imported from Bank of America Visa-SD social,D108,HJ,27.2,,24766.34
6790,2/23/2021,2/23/2021,Myesha Hossain,Imported from Bank of America Visa-sd social,D108,HJ,,27.2,24739.14
6790,2/23/2021,2/23/2021,Myesha Hossain,Imported from Bank of America Visa-sd social,D108,HJ,27.2,,24766.34
6790,2/23/2021,2/23/2021,Myesha Hossain,Imported from Bank of America Visa-sd social,D108,HJ,27.2,,24793.54
6790,2/24/2021,2/24/2021,Mahaliah Sejour,Imported from Bank of America Visa-Fellows gifts,D108,HJ,18.83,,24812.37
6790,2/24/2021,2/24/2021,Mahaliah Sejour,Imported from Bank of America Visa-Fellows gifts,D108,HJ,33.95,,24846.32
6790,2/24/2021,2/24/2021,Maryellen Leneghan,Imported from Bank of America Visa-Staff.Fellow Appreciation,D108,HJ,1.99,,24848.31
6790,2/24/2021,2/24/2021,Maryellen Leneghan,Imported from Bank of America Visa-Staff.Fellow Appreciation,D108,HJ,3,,24851.31
6790,2/24/2021,2/24/2021,Maryellen Leneghan,Imported from Bank of America Visa-Staff.Fellow Appreciation,D108,HJ,3.07,,24854.38
6790,2/24/2021,2/24/2021,Maryellen Leneghan,Imported from Bank of America Visa-Staff.Fellow Appreciation,D108,HJ,4.29,,24858.67
6790,2/24/2021,2/24/2021,Maryellen Leneghan,Imported from Bank of America Visa-Staff.Fellow Appreciation,D108,HJ,6.99,,24865.66
6790,2/24/2021,2/24/2021,Maryellen Leneghan,Imported from Bank of America Visa-Staff.Fellow Appreciation,D108,HJ,6.99,,24872.65
6790,2/24/2021,2/24/2021,Maryellen Leneghan,Imported from Bank of America Visa-Staff.Fellow Appreciation,D108,HJ,7.99,,24880.64
6790,2/24/2021,2/24/2021,Maryellen Leneghan,Imported from Bank of America Visa-Staff.Fellow Appreciation,D108,HJ,7.99,,24888.63
6790,2/24/2021,2/24/2021,Tiffani Bibb,Imported from Bank of America Visa-Working Lunch,D104,HJ,15.51,,24904.14
6790,2/25/2021,2/25/2021,Maryellen Leneghan,Imported from Bank of America Visa-Staff.Fellow Appreciation,D108,HJ,4.84,,24908.98
6790,2/25/2021,2/25/2021,Maryellen Leneghan,Imported from Bank of America Visa-Staff.Fellow Appreciation,D108,HJ,4.99,,24913.97
6790,2/25/2021,2/25/2021,Maryellen Leneghan,Imported from Bank of America Visa-Staff.Fellow Appreciation,D108,HJ,5.99,,24919.96
6790,2/25/2021,2/25/2021,Maryellen Leneghan,Imported from Bank of America Visa-Staff.Fellow Appreciation,D108,HJ,6.82,,24926.78
6790,2/25/2021,2/25/2021,Maryellen Leneghan,Imported from Bank of America Visa-Staff.Fellow Appreciation,D108,HJ,6.98,,24933.76
6790,2/25/2021,2/25/2021,Maryellen Leneghan,Imported from Bank of America Visa-Staff.Fellow Appreciation,D108,HJ,6.99,,24940.75
6790,2/25/2021,2/25/2021,Maryellen Leneghan,Imported from Bank of America Visa-Staff.Fellow Appreciation,D108,HJ,7.98,,24948.73
6790,2/25/2021,2/25/2021,Maryellen Leneghan,Imported from Bank of America Visa-Staff.Fellow Appreciation,D108,HJ,7.99,,24956.72
6790,2/25/2021,2/25/2021,Maryellen Leneghan,Imported from Bank of America Visa-Staff.Fellow Appreciation,D108,HJ,7.99,,24964.71
6790,2/25/2021,2/25/2021,Maryellen Leneghan,Imported from Bank of America Visa-Staff.Fellow Appreciation,D108,HJ,7.99,,24972.7
6790,2/25/2021,2/25/2021,Maryellen Leneghan,Imported from Bank of America Visa-Staff.Fellow Appreciation,D108,HJ,7.99,,24980.69
6790,2/25/2021,2/25/2021,Maryellen Leneghan,Imported from Bank of America Visa-Staff.Fellow Appreciation,D108,HJ,8.66,,24989.35
6790,2/25/2021,2/25/2021,Myesha Hossain,Imported from Bank of America Visa-Cleveland Fellow Appreciation from Dewey,D108,HJ,14.95,,25004.3
6790,3/1/2021,3/1/2021,Mahaliah Sejour,Imported from Bank of America Visa,D108,HJ,22.25,,25026.55
6790,3/1/2021,3/1/2021,Myesha Hossain,Imported from Bank of America Visa,D108,HJ,15.99,,25042.54
6790,3/1/2021,3/1/2021,Tiffani Bibb,Imported from Bank of America Visa,D104,HJ,13.4,,25055.94
6790,3/2/2021,3/2/2021,Grubhub,Bill.Com Import,D108,HJ,215.81,,25271.75
6790,3/2/2021,3/2/2021,Mahaliah Sejour,Imported from Bank of America Visa,D108,HJ,19.99,,25291.74
6790,3/2/2021,3/2/2021,Mahaliah Sejour,Imported from Bank of America Visa,D108,HJ,23.11,,25314.85
6790,3/5/2021,3/5/2021,claice Jackson,Imported from Bank of America Visa,D108,HJ,,24.45,25290.4
6790,3/5/2021,3/5/2021,claice Jackson,Imported from Bank of America Visa,D108,HJ,24.45,,25314.85
6790,3/5/2021,3/5/2021,Mahaliah Sejour,Imported from Bank of America Visa,D108,HJ,18.94,,25333.79
6790,3/5/2021,3/5/2021,Myesha Hossain,Imported from Bank of America Visa,D108,HJ,,2.21,25331.58
6790,3/5/2021,3/5/2021,Myesha Hossain,Imported from Bank of America Visa,D108,HJ,6.49,,25338.07
6790,3/8/2021,3/8/2021,Halley Bowman,Imported from Bank of America Visa,D101,HJ,2.75,,25340.82
6790,3/8/2021,3/8/2021,Halley Bowman,Imported from Bank of America Visa,D101,HJ,2.92,,25343.74
6790,3/8/2021,3/8/2021,Halley Bowman,Imported from Bank of America Visa,D101,HJ,2.94,,25346.68
6790,3/8/2021,3/8/2021,Halley Bowman,Imported from Bank of America Visa,D101,HJ,2.94,,25349.62
6790,3/8/2021,3/8/2021,Halley Bowman,Imported from Bank of America Visa,D101,HJ,2.99,,25352.61
6790,3/8/2021,3/8/2021,Halley Bowman,Imported from Bank of America Visa,D101,HJ,2.99,,25355.6
6790,3/8/2021,3/8/2021,Halley Bowman,Imported from Bank of America Visa,D101,HJ,3.03,,25358.63
6790,3/8/2021,3/8/2021,Halley Bowman,Imported from Bank of America Visa,D101,HJ,3.03,,25361.66
6790,3/8/2021,3/8/2021,Halley Bowman,Imported from Bank of America Visa,D101,HJ,4.25,,25365.91
6790,3/8/2021,3/8/2021,Halley Bowman,Imported from Bank of America Visa,D101,HJ,4.25,,25370.16
6790,3/8/2021,3/8/2021,Halley Bowman,Imported from Bank of America Visa,D101,HJ,4.51,,25374.67
6790,3/8/2021,3/8/2021,Halley Bowman,Imported from Bank of America Visa,D101,HJ,4.51,,25379.18
6790,3/8/2021,3/8/2021,Halley Bowman,Imported from Bank of America Visa,D101,HJ,4.55,,25383.73
6790,3/8/2021,3/8/2021,Halley Bowman,Imported from Bank of America Visa,D101,HJ,4.55,,25388.28
6790,3/8/2021,3/8/2021,Halley Bowman,Imported from Bank of America Visa,D101,HJ,4.55,,25392.83
6790,3/8/2021,3/8/2021,Halley Bowman,Imported from Bank of America Visa,D101,HJ,4.55,,25397.38
6790,3/8/2021,3/8/2021,Halley Bowman,Imported from Bank of America Visa,D101,HJ,4.61,,25401.99
6790,3/8/2021,3/8/2021,Halley Bowman,Imported from Bank of America Visa,D101,HJ,4.61,,25406.6
6790,3/8/2021,3/8/2021,Halley Bowman,Imported from Bank of America Visa,D101,HJ,4.62,,25411.22
6790,3/8/2021,3/8/2021,Halley Bowman,Imported from Bank of America Visa,D101,HJ,4.62,,25415.84
6790,3/8/2021,3/8/2021,Halley Bowman,Imported from Bank of America Visa,D101,HJ,4.68,,25420.52
6790,3/8/2021,3/8/2021,Halley Bowman,Imported from Bank of America Visa,D101,HJ,4.68,,25425.2
6790,3/8/2021,3/8/2021,Halley Bowman,Imported from Bank of America Visa,D101,HJ,4.68,,25429.88
6790,3/8/2021,3/8/2021,Halley Bowman,Imported from Bank of America Visa,D101,HJ,4.68,,25434.56
6790,3/8/2021,3/8/2021,Halley Bowman,Imported from Bank of America Visa,D101,HJ,13.74,,25448.3
6790,3/8/2021,3/8/2021,Halley Bowman,Imported from Bank of America Visa,D101,HJ,14.61,,25462.91
6790,3/8/2021,3/8/2021,Halley Bowman,Imported from Bank of America Visa,D101,HJ,14.7,,25477.61
6790,3/8/2021,3/8/2021,Halley Bowman,Imported from Bank of America Visa,D101,HJ,14.7,,25492.31
6790,3/8/2021,3/8/2021,Halley Bowman,Imported from Bank of America Visa,D101,HJ,14.93,,25507.24
6790,3/8/2021,3/8/2021,Halley Bowman,Imported from Bank of America Visa,D101,HJ,14.97,,25522.21
6790,3/8/2021,3/8/2021,Halley Bowman,Imported from Bank of America Visa,D101,HJ,15.16,,25537.37
6790,3/8/2021,3/8/2021,Halley Bowman,Imported from Bank of America Visa,D101,HJ,15.16,,25552.53
6790,3/8/2021,3/8/2021,Halley Bowman,Imported from Bank of America Visa,D101,HJ,26.49,,25579.02
6790,3/8/2021,3/8/2021,Halley Bowman,Imported from Bank of America Visa,D101,HJ,26.55,,25605.57
6790,3/8/2021,3/8/2021,Myesha Hossain,Imported from Bank of America Visa,D108,HJ,6.99,,25612.56
6790,3/8/2021,3/8/2021,Myesha Hossain,Imported from Bank of America Visa,D108,HJ,7.56,,25620.12
6790,3/8/2021,3/8/2021,Myesha Hossain,Imported from Bank of America Visa,D108,HJ,8.99,,25629.11
6790,3/8/2021,3/8/2021,Myesha Hossain,Imported from Bank of America Visa,D108,HJ,19.76,,25648.87
6790,3/8/2021,3/8/2021,Tiffani Bibb,Imported from Bank of America Visa,D104,HJ,16.14,,25665.01
6790,3/8/2021,3/8/2021,Tiffani Bibb,Imported from Bank of America Visa,D104,HJ,69.42,,25734.43
6790,3/9/2021,3/9/2021,Myesha Hossain,Imported from Bank of America Visa,D108,HJ,6.99,,25741.42
6790,3/9/2021,3/9/2021,Myesha Hossain,Imported from Bank of America Visa,D108,HJ,6.99,,25748.41
6790,3/9/2021,3/9/2021,Myesha Hossain,Imported from Bank of America Visa,D108,HJ,7.45,,25755.86
6790,3/10/2021,3/10/2021,Myesha Hossain,Imported from Bank of America Visa,D108,HJ,21,,25776.86
6790,3/10/2021,3/10/2021,Myesha Hossain,Imported from Bank of America Visa,D108,HJ,24.37,,25801.23
6790,3/12/2021,3/12/2021,Myesha Hossain,Imported from Bank of America Visa,D108,HJ,4.99,,25806.22
6790,3/12/2021,3/12/2021,Nicole Prahin,Imported from Bank of America Visa,D108,HJ,44.39,,25850.61
6790,3/13/2021,3/13/2021,Mahaliah Sejour,Imported from Bank of America Visa,D108,HJ,12.07,,25862.68
6790,3/13/2021,3/13/2021,Mahaliah Sejour,Imported from Bank of America Visa,D108,HJ,12.07,,25874.75
6790,3/13/2021,3/13/2021,Mahaliah Sejour,Imported from Bank of America Visa,D108,HJ,12.07,,25886.82
6790,3/13/2021,3/13/2021,Mahaliah Sejour,Imported from Bank of America Visa,D108,HJ,12.07,,25898.89
6790,3/13/2021,3/13/2021,Mahaliah Sejour,Imported from Bank of America Visa,D108,HJ,12.07,,25910.96
6790,3/15/2021,3/15/2021,Monivett Acevedo,Imported from Bank of America Visa,D107,HJ,51.38,,25962.34
6790,3/15/2021,3/15/2021,Monivett Acevedo,Imported from Bank of America Visa,D107,HJ,51.38,,26013.72
6790,3/16/2021,3/16/2021,Mahaliah Sejour,Imported from Bank of America Visa,D108,HJ,11.99,,26025.71
6790,3/17/2021,3/17/2021,Mahaliah Sejour,Imported from Bank of America Visa,D108,HJ,,9.99,26015.72
6790,3/17/2021,3/17/2021,Mahaliah Sejour,Imported from Bank of America Visa,D108,HJ,13.97,,26029.69
6790,3/17/2021,3/17/2021,Mahaliah Sejour,Imported from Bank of America Visa,D108,HJ,21.35,,26051.04
6790,3/17/2021,3/17/2021,Myesha Hossain,Imported from Bank of America Visa,D108,HJ,9,,26060.04
6790,3/17/2021,3/17/2021,Myesha Hossain,Imported from Bank of America Visa,D108,HJ,15,,26075.04
6790,3/18/2021,3/18/2021,Mahaliah Sejour,Imported from Bank of America Visa,D108,HJ,15.24,,26090.28
6790,3/18/2021,3/18/2021,Mahaliah Sejour,Imported from Bank of America Visa,D108,HJ,15.99,,26106.27
6790,3/18/2021,3/18/2021,Myesha Hossain,Imported from Bank of America Visa,D108,HJ,11,,26117.27
6790,3/18/2021,3/18/2021,Myesha Hossain,Imported from Bank of America Visa,D108,HJ,12,,26129.27
6790,3/18/2021,3/18/2021,Myesha Hossain,Imported from Bank of America Visa,D108,HJ,12,,26141.27
6790,3/18/2021,3/18/2021,Myesha Hossain,Imported from Bank of America Visa,D108,HJ,12,,26153.27
6790,3/18/2021,3/18/2021,Myesha Hossain,Imported from Bank of America Visa,D108,HJ,12.8,,26166.07
6790,3/19/2021,3/19/2021,Mahaliah Sejour,Imported from Bank of America Visa,D108,HJ,,10.99,26155.08
6790,3/19/2021,3/19/2021,Tiffany Jordan,Imported from Bank of America Visa,D108,HJ,111.01,,26266.09
6790,3/22/2021,3/22/2021,Grubhub,Bill.Com Import,D108,HJ,95.09,,26361.18
6790,3/22/2021,3/22/2021,Grubhub,Bill.Com Import,D108,HJ,708.08,,27069.26
6790,3/22/2021,3/22/2021,Grubhub,Bill.Com Import,D101,HJ,147.3,,27216.56
6790,3/22/2021,3/22/2021,Grubhub,Bill.Com Import,D104,HJ,42.4,,27258.96
6790,3/22/2021,3/22/2021,Grubhub,Bill.Com Import,D111,HJ,200.46,,27459.42
6790,3/22/2021,3/22/2021,Grubhub,Bill.Com Import,D108,HJ,47.7,,27507.12
6790,3/22/2021,3/22/2021,Mahaliah Sejour,Imported from Bank of America Visa,D108,HJ,16.97,,27524.09
6790,3/22/2021,3/22/2021,Mahaliah Sejour,Imported from Bank of America Visa,D108,HJ,16.97,,27541.06
6790,3/22/2021,3/22/2021,Mahaliah Sejour,Imported from Bank of America Visa,D108,HJ,16.97,,27558.03
6790,3/22/2021,3/22/2021,Mahaliah Sejour,Imported from Bank of America Visa,D108,HJ,16.97,,27575
6790,3/22/2021,3/22/2021,Mahaliah Sejour,Imported from Bank of America Visa,D108,HJ,16.97,,27591.97
6790,3/22/2021,3/22/2021,Mahaliah Sejour,Imported from Bank of America Visa,D108,HJ,16.97,,27608.94
6790,3/22/2021,3/22/2021,Mahaliah Sejour,Imported from Bank of America Visa,D108,HJ,24.99,,27633.93
6790,3/22/2021,3/22/2021,Mahaliah Sejour,Imported from Bank of America Visa,D108,HJ,26.49,,27660.42
6790,3/22/2021,3/22/2021,Mahaliah Sejour,Imported from Bank of America Visa,D108,HJ,26.55,,27686.97
6790,3/22/2021,3/22/2021,Mahaliah Sejour,Imported from Bank of America Visa,D108,HJ,,26.98,27659.99
6790,3/22/2021,3/22/2021,Mahaliah Sejour,Imported from Bank of America Visa,D108,HJ,26.98,,27686.97
6790,3/22/2021,3/22/2021,Mahaliah Sejour,Imported from Bank of America Visa,D108,HJ,27.24,,27714.21
6790,3/22/2021,3/22/2021,Mahaliah Sejour,Imported from Bank of America Visa,D108,HJ,27.3,,27741.51
6790,3/22/2021,3/22/2021,Mahaliah Sejour,Imported from Bank of America Visa,D108,HJ,27.36,,27768.87
6790,3/22/2021,3/22/2021,Mahaliah Sejour,Imported from Bank of America Visa,D108,HJ,27.55,,27796.42
6790,3/22/2021,3/22/2021,Mahaliah Sejour,Imported from Bank of America Visa,D108,HJ,27.55,,27823.97
6790,3/22/2021,3/22/2021,Mahaliah Sejour,Imported from Bank of America Visa,D108,HJ,27.55,,27851.52
6790,3/22/2021,3/22/2021,Mahaliah Sejour,Imported from Bank of America Visa,D108,HJ,27.55,,27879.07
6790,3/22/2021,3/22/2021,Mahaliah Sejour,Imported from Bank of America Visa,D108,HJ,27.55,,27906.62
6790,3/22/2021,3/22/2021,Mahaliah Sejour,Imported from Bank of America Visa,D108,HJ,27.55,,27934.17
6790,3/22/2021,3/22/2021,Mahaliah Sejour,Imported from Bank of America Visa,D108,HJ,27.55,,27961.72
6790,3/22/2021,3/22/2021,Nicole Prahin,Imported from Bank of America Visa,D108,HJ,,139.93,27821.79
6790,3/22/2021,3/22/2021,Nicole Prahin,Imported from Bank of America Visa,D108,HJ,139.93,,27961.72
6790,3/22/2021,3/22/2021,Nicole Prahin,Imported from Bank of America Visa,D108,HJ,139.93,,28101.65
6790,3/24/2021,3/24/2021,Mahaliah Sejour,Imported from Bank of America Visa,D108,HJ,16.97,,28118.62
6790,3/24/2021,3/24/2021,Mahaliah Sejour,Imported from Bank of America Visa,D108,HJ,16.97,,28135.59
6790,3/24/2021,3/24/2021,Mahaliah Sejour,Imported from Bank of America Visa,D108,HJ,16.97,,28152.56
6790,3/24/2021,3/24/2021,Mahaliah Sejour,Imported from Bank of America Visa,D108,HJ,16.97,,28169.53
6790,3/24/2021,3/24/2021,Mahaliah Sejour,Imported from Bank of America Visa,D108,HJ,16.97,,28186.5
6790,3/24/2021,3/24/2021,Mahaliah Sejour,Imported from Bank of America Visa,D108,HJ,16.97,,28203.47
6790,3/24/2021,3/24/2021,Mahaliah Sejour,Imported from Bank of America Visa,D108,HJ,42.94,,28246.41
6790,3/24/2021,3/24/2021,Mahaliah Sejour,Imported from Bank of America Visa,D108,HJ,42.94,,28289.35
6790,3/24/2021,3/24/2021,Mahaliah Sejour,Imported from Bank of America Visa,D108,HJ,42.94,,28332.29
6790,3/24/2021,3/24/2021,Mahaliah Sejour,Imported from Bank of America Visa,D108,HJ,42.94,,28375.23
6790,3/24/2021,3/24/2021,Mahaliah Sejour,Imported from Bank of America Visa,D108,HJ,42.94,,28418.17
6790,3/24/2021,3/24/2021,Mahaliah Sejour,Imported from Bank of America Visa,D108,HJ,42.94,,28461.11
6790,3/24/2021,3/24/2021,Mahaliah Sejour,Imported from Bank of America Visa,D108,HJ,42.94,,28504.05
6790,3/24/2021,3/24/2021,Mahaliah Sejour,Imported from Bank of America Visa,D108,HJ,42.94,,28546.99
6790,3/24/2021,3/24/2021,Mahaliah Sejour,Imported from Bank of America Visa,D108,HJ,42.94,,28589.93
6790,3/24/2021,3/24/2021,Mahaliah Sejour,Imported from Bank of America Visa,D108,HJ,42.94,,28632.87
6790,3/24/2021,3/24/2021,Mahaliah Sejour,Imported from Bank of America Visa,D108,HJ,42.94,,28675.81
6790,3/24/2021,3/24/2021,Mahaliah Sejour,Imported from Bank of America Visa,D108,HJ,42.94,,28718.75
6790,3/24/2021,3/24/2021,Mahaliah Sejour,Imported from Bank of America Visa,D108,HJ,42.94,,28761.69
6790,3/24/2021,3/24/2021,Mahaliah Sejour,Imported from Bank of America Visa,D108,HJ,42.94,,28804.63
6790,3/24/2021,3/24/2021,Mahaliah Sejour,Imported from Bank of America Visa,D108,HJ,42.94,,28847.57
6790,3/24/2021,3/24/2021,Mahaliah Sejour,Imported from Bank of America Visa,D108,HJ,42.94,,28890.51
6790,3/24/2021,3/24/2021,Mahaliah Sejour,Imported from Bank of America Visa,D108,HJ,42.94,,28933.45
6790,3/24/2021,3/24/2021,Mahaliah Sejour,Imported from Bank of America Visa,D108,HJ,99.06,,29032.51
6790,3/24/2021,3/24/2021,Myesha Hossain,Imported from Bank of America Visa,D108,HJ,15.99,,29048.5
6790,3/24/2021,3/24/2021,Nicole Prahin,Imported from Bank of America Visa,D108,HJ,80,,29128.5
6790,3/31/2021,3/31/2021,Myesha Hossain,Imported from Bank of America Visa,D108,HJ,20.4,,29148.9
6790,4/1/2021,4/1/2021,Antonio Gutierrez,Imported from Bank of America Visa,D107,HJ,183.58,,29332.48
6790,4/1/2021,4/1/2021,Grubhub,Bill.Com Import,D108,HJ,807.46,,30139.94
6790,4/1/2021,4/1/2021,Mahaliah Sejour,Imported from Bank of America Visa,D108,HJ,42.94,,30182.88
6790,4/5/2021,4/5/2021,Mahaliah Sejour,Imported from Bank of America Visa,D108,HJ,23.95,,30206.83
6790,4/5/2021,4/5/2021,Mahaliah Sejour,Imported from Bank of America Visa,D108,HJ,24.34,,30231.17
6790,4/5/2021,4/5/2021,Myesha Hossain,Imported from Bank of America Visa,D108,HJ,43.18,,30274.35
6790,4/9/2021,4/9/2021,Mahaliah Sejour,Imported from Bank of America Visa,D108,HJ,196.71,,30471.06
6790,4/15/2021,4/15/2021,Mahaliah Sejour,Imported from Bank of America Visa,D108,HJ,66.13,,30537.19
6790,4/16/2021,4/16/2021,Mahaliah Sejour,Imported from Bank of America Visa,D108,HJ,,55.46,30481.73
6790,4/16/2021,4/16/2021,Myesha Hossain,Imported from Bank of America Visa,D108,HJ,9.83,,30491.56
6790,4/16/2021,4/16/2021,Myesha Hossain,Imported from Bank of America Visa,D108,HJ,9.83,,30501.39
6790,4/16/2021,4/16/2021,Myesha Hossain,Imported from Bank of America Visa,D108,HJ,12,,30513.39
6790,4/16/2021,4/16/2021,Myesha Hossain,Imported from Bank of America Visa,D108,HJ,12,,30525.39
6790,4/19/2021,4/19/2021,Maryellen Leneghan,Imported from Bank of America Visa,D108,HJ,17.98,,30543.37
6790,4/19/2021,4/19/2021,Myesha Hossain,Imported from Bank of America Visa,D108,HJ,9.6,,30552.97
6790,4/19/2021,4/19/2021,Myesha Hossain,Imported from Bank of America Visa,D108,HJ,11,,30563.97
6790,4/19/2021,4/19/2021,Myesha Hossain,Imported from Bank of America Visa,D108,HJ,12,,30575.97
6790,4/21/2021,4/21/2021,Grubhub,Bill.Com Import,D108,HJ,90.29,,30666.26
6790,4/21/2021,4/21/2021,Grubhub,Bill.Com Import,D101,HJ,168.25,,30834.51
6790,4/21/2021,4/21/2021,Grubhub,Bill.Com Import,D104,HJ,243.67,,31078.18
6790,4/21/2021,4/21/2021,Grubhub,Bill.Com Import,D111,HJ,183.1,,31261.28
6790,4/21/2021,4/21/2021,Grubhub,Bill.Com Import,D108,HJ,167.48,,31428.76
6790,4/21/2021,4/21/2021,Nicole Horton,Imported from Bank of America Visa,D108,HJ,11.94,,31440.7
6790,4/23/2021,4/23/2021,Grubhub,Bill.Com Import,D108,HJ,537.45,,31978.15
6790,4/23/2021,4/23/2021,Maryellen Leneghan,Imported from Bank of America Visa,D108,HJ,6.97,,31985.12
6790,4/23/2021,4/23/2021,Maryellen Leneghan,Imported from Bank of America Visa,D108,HJ,6.97,,31992.09
6790,4/23/2021,4/23/2021,Maryellen Leneghan,Imported from Bank of America Visa,D108,HJ,6.97,,31999.06
6790,4/23/2021,4/23/2021,Maryellen Leneghan,Imported from Bank of America Visa,D108,HJ,6.97,,32006.03
6790,4/23/2021,4/23/2021,Maryellen Leneghan,Imported from Bank of America Visa,D108,HJ,6.97,,32013
6790,4/23/2021,4/23/2021,Maryellen Leneghan,Imported from Bank of America Visa,D108,HJ,6.97,,32019.97
6790,4/23/2021,4/23/2021,Maryellen Leneghan,Imported from Bank of America Visa,D108,HJ,6.97,,32026.94
6790,4/23/2021,4/23/2021,Maryellen Leneghan,Imported from Bank of America Visa,D108,HJ,7.7,,32034.64
6790,4/23/2021,4/23/2021,Nicole Horton,Imported from Bank of America Visa,D108,HJ,28.45,,32063.09
6790,4/27/2021,4/27/2021,Mahaliah Sejour,Imported from Bank of America Visa,D108,HJ,91.5,,32154.59
6790,4/27/2021,4/27/2021,Myesha Hossain,Imported from Bank of America Visa,D108,HJ,14.75,,32169.34
6790,4/27/2021,4/27/2021,Myesha Hossain,Imported from Bank of America Visa,D108,HJ,35.48,,32204.82
6790,4/27/2021,4/27/2021,Myesha Hossain,Imported from Bank of America Visa,D108,HJ,35.93,,32240.75
6790,4/29/2021,4/29/2021,Myesha Hossain,Imported from Bank of America Visa,D108,HJ,7.44,,32248.19
6790,4/29/2021,4/29/2021,Myesha Hossain,Imported from Bank of America Visa,D108,HJ,9.99,,32258.18
6790,5/1/2021,5/1/2021,Maryellen Leneghan,Imported from Bank of America Visa,D108,HJ,20.39,,32278.57
6790,5/1/2021,5/1/2021,Maryellen Leneghan,Imported from Bank of America Visa,D108,HJ,20.46,,32299.03
6790,5/1/2021,5/1/2021,Maryellen Leneghan,Imported from Bank of America Visa,D108,HJ,30.62,,32329.65
6790,5/1/2021,5/1/2021,Monivett Acevedo,Imported from Bank of America Visa,D107,HJ,,41.89,32287.76
6790,5/1/2021,5/1/2021,Myesha Hossain,Imported from Bank of America Visa,D108,HJ,13.72,,32301.48
6790,5/1/2021,5/1/2021,Myesha Hossain,Imported from Bank of America Visa,D108,HJ,16.97,,32318.45
6790,5/1/2021,5/1/2021,Myesha Hossain,Imported from Bank of America Visa,D108,HJ,21.05,,32339.5
6790,5/1/2021,5/1/2021,Myesha Hossain,Imported from Bank of America Visa,D108,HJ,23.99,,32363.49
6790,5/3/2021,5/3/2021,Myesha Hossain,Imported from Bank of America Visa,D108,HJ,10.95,,32374.44
6790,5/4/2021,5/4/2021,Kyra Detone,Imported from Bank of America Visa,D102,HJ,102.99,,32477.43
6790,5/4/2021,5/4/2021,Mahaliah Sejour,Imported from Bank of America Visa,D108,HJ,13.12,,32490.55
6790,5/4/2021,5/4/2021,Mahaliah Sejour,Imported from Bank of America Visa,D108,HJ,14.89,,32505.44
6790,5/4/2021,5/4/2021,Mahaliah Sejour,Imported from Bank of America Visa,D108,HJ,18.48,,32523.92
6790,5/4/2021,5/4/2021,Myesha Hossain,Imported from Bank of America Visa,D108,HJ,,1.94,32521.98
6790,5/4/2021,5/4/2021,Myesha Hossain,Imported from Bank of America Visa,D108,HJ,4.99,,32526.97
6790,5/4/2021,5/4/2021,Myesha Hossain,Imported from Bank of America Visa,D108,HJ,22.99,,32549.96
6790,5/4/2021,5/4/2021,Myesha Hossain,Imported from Bank of America Visa,D108,HJ,24.99,,32574.95
6790,5/4/2021,5/4/2021,Myesha Hossain,Imported from Bank of America Visa,D108,HJ,26.99,,32601.94
6790,5/4/2021,5/4/2021,Myesha Hossain,Imported from Bank of America Visa,D108,HJ,26.99,,32628.93
6790,5/4/2021,5/4/2021,Myesha Hossain,Imported from Bank of America Visa,D108,HJ,26.99,,32655.92
6790,5/4/2021,5/4/2021,Myesha Hossain,Imported from Bank of America Visa,D108,HJ,26.99,,32682.91
6790,5/4/2021,5/4/2021,Myesha Hossain,Imported from Bank of America Visa,D108,HJ,34,,32716.91
6790,5/4/2021,5/4/2021,Myesha Hossain,Imported from Bank of America Visa,D108,HJ,34,,32750.91
6790,5/4/2021,5/4/2021,Myesha Hossain,Imported from Bank of America Visa,D108,HJ,34,,32784.91
6790,5/5/2021,5/5/2021,Mahaliah Sejour,Imported from Bank of America Visa,D108,HJ,14.84,,32799.75
6790,5/5/2021,5/5/2021,Mahaliah Sejour,Imported from Bank of America Visa,D108,HJ,17.99,,32817.74
6790,5/5/2021,5/5/2021,Maryellen Leneghan,Imported from Bank of America Visa,D108,HJ,23.98,,32841.72
6790,5/5/2021,5/5/2021,Maryellen Leneghan,Imported from Bank of America Visa,D108,HJ,25.42,,32867.14
6790,5/5/2021,5/5/2021,Maryellen Leneghan,Imported from Bank of America Visa,D108,HJ,25.42,,32892.56
6790,5/5/2021,5/5/2021,Maryellen Leneghan,Imported from Bank of America Visa,D108,HJ,25.42,,32917.98
6790,5/5/2021,5/5/2021,Maryellen Leneghan,Imported from Bank of America Visa,D108,HJ,25.42,,32943.4
6790,5/5/2021,5/5/2021,Myesha Hossain,Imported from Bank of America Visa,D108,HJ,24.98,,32968.38
6790,5/6/2021,5/6/2021,Melissa McElwee,Imported from reimbursements,D108,HJ,5.99,,32974.37
6790,5/6/2021,5/6/2021,Melissa McElwee,Imported from reimbursements,D108,HJ,18.9,,32993.27
6790,5/7/2021,5/7/2021,Maryellen Leneghan,Imported from Bank of America Visa,D108,HJ,30.62,,33023.89
6790,5/11/2021,5/11/2021,Mahaliah Sejour,Imported from Bank of America Visa,D108,HJ,15.87,,33039.76
6790,5/11/2021,5/11/2021,Mahaliah Sejour,Imported from Bank of America Visa,D108,HJ,1087.65,,34127.41
6790,5/12/2021,5/12/2021,Nicole Prahin,Imported from Bank of America Visa,D108,HJ,67.52,,34194.93
6790,5/14/2021,5/14/2021,Mahaliah Sejour,Imported from Bank of America Visa,D108,HJ,27.99,,34222.92
6790,5/14/2021,5/14/2021,Myesha Hossain,Imported from Bank of America Visa,D108,HJ,,13.72,34209.2
6790,5/17/2021,5/17/2021,Mahaliah Sejour,Imported from Bank of America Visa,D108,HJ,36.98,,34246.18
6790,5/17/2021,5/17/2021,Mahaliah Sejour,Imported from Bank of America Visa,D108,HJ,36.98,,34283.16
6790,5/17/2021,5/17/2021,Mahaliah Sejour,Imported from Bank of America Visa,D108,HJ,36.98,,34320.14
6790,5/18/2021,5/18/2021,Nicole Horton,Imported from Bank of America Visa,D108,HJ,311.37,,34631.51
6790,5/19/2021,5/19/2021,Maryellen Leneghan,Imported from Bank of America Visa,D108,HJ,18.99,,34650.5
6790,5/19/2021,5/19/2021,Maryellen Leneghan,Imported from Bank of America Visa,D108,HJ,18.99,,34669.49
6790,5/19/2021,5/19/2021,Maryellen Leneghan,Imported from Bank of America Visa,D108,HJ,33.8,,34703.29
6790,5/19/2021,5/19/2021,Maryellen Leneghan,Imported from Bank of America Visa,D108,HJ,20.13,,34723.42
6790,5/19/2021,5/19/2021,Maryellen Leneghan,Imported from Bank of America Visa,D108,HJ,20.46,,34743.88
6790,5/19/2021,5/19/2021,Maryellen Leneghan,Imported from Bank of America Visa,D108,HJ,20.46,,34764.34
6790,5/19/2021,5/19/2021,Maryellen Leneghan,Imported from Bank of America Visa,D108,HJ,30.62,,34794.96
6790,5/19/2021,5/19/2021,Maryellen Leneghan,Imported from Bank of America Visa,D108,HJ,30.62,,34825.58
6790,5/19/2021,5/19/2021,Maryellen Leneghan,Imported from Bank of America Visa,D108,HJ,30.62,,34856.2
6790,5/19/2021,5/19/2021,Myesha Hossain,Imported from Bank of America Visa,D108,HJ,8.47,,34864.67
6790,5/19/2021,5/19/2021,Myesha Hossain,Imported from Bank of America Visa,D108,HJ,9.5,,34874.17
6790,5/19/2021,5/19/2021,Myesha Hossain,Imported from Bank of America Visa,D108,HJ,10.95,,34885.12
6790,5/19/2021,5/19/2021,Myesha Hossain,Imported from Bank of America Visa,D108,HJ,10.99,,34896.11
6790,5/19/2021,5/19/2021,Myesha Hossain,Imported from Bank of America Visa,D108,HJ,22.99,,34919.1
6790,5/20/2021,5/20/2021,Mahaliah Sejour,Imported from Bank of America Visa,D108,HJ,20,,34939.1
6790,5/20/2021,5/20/2021,Mahaliah Sejour,Imported from Bank of America Visa,D108,HJ,124.68,,35063.78
6790,5/21/2021,5/21/2021,Grubhub,Bill.Com Import,D108,HJ,633.3,,35697.08
6790,5/21/2021,5/21/2021,Grubhub,Bill.Com Import,D108,HJ,820.26,,36517.34
6790,5/21/2021,5/21/2021,Grubhub,Bill.Com Import,D101,HJ,63.6,,36580.94
6790,5/21/2021,5/21/2021,Grubhub,Bill.Com Import,D103,HJ,148.38,,36729.32
6790,5/21/2021,5/21/2021,Grubhub,Bill.Com Import,D111,HJ,31.8,,36761.12
6790,5/21/2021,5/21/2021,Grubhub,Bill.Com Import,D108,HJ,398.35,,37159.47
6790,5/21/2021,5/21/2021,Grubhub,Bill.Com Import,D108,HJ,328.9,,37488.37
6790,5/21/2021,5/21/2021,Mahaliah Sejour,Imported from Bank of America Visa,D108,HJ,206.15,,37694.52
6790,5/21/2021,5/21/2021,Maryellen Leneghan,Imported from Bank of America Visa,D108,HJ,41,,37735.52
6790,5/21/2021,5/21/2021,Maryellen Leneghan,Imported from Bank of America Visa,D108,HJ,57.85,,37793.37
6790,5/24/2021,5/24/2021,Denise Parham-Gantt,Imported from Bank of America Visa,D109,HJ,2.37,,37795.74
6790,5/24/2021,5/24/2021,Denise Parham-Gantt,Imported from Bank of America Visa,D109,HJ,957.78,,38753.52
6790,5/24/2021,5/24/2021,Denise Parham-Gantt,Imported from Bank of America Visa,D109,HJ,118.3,,38871.82
6790,5/26/2021,5/26/2021,Maryellen Leneghan,Imported from Bank of America Visa,D108,HJ,17.88,,38889.7
6790,5/26/2021,5/26/2021,Maryellen Leneghan,Imported from Bank of America Visa,D108,HJ,279,,39168.7
6790,5/26/2021,5/26/2021,Maryellen Leneghan,Imported from Bank of America Visa,D108,HJ,15.94,,39184.64
6790,5/26/2021,5/26/2021,Maryellen Leneghan,Imported from Bank of America Visa,D108,HJ,16.9,,39201.54
6790,5/26/2021,5/26/2021,Maryellen Leneghan,Imported from Bank of America Visa,D108,HJ,16.9,,39218.44
6790,5/26/2021,5/26/2021,Maryellen Leneghan,Imported from Bank of America Visa,D108,HJ,16.9,,39235.34
6790,5/26/2021,5/26/2021,Maryellen Leneghan,Imported from Bank of America Visa,D108,HJ,16.9,,39252.24
6790,5/26/2021,5/26/2021,Maryellen Leneghan,Imported from Bank of America Visa,D108,HJ,17.1,,39269.34
6790,5/26/2021,5/26/2021,Maryellen Leneghan,Imported from Bank of America Visa,D108,HJ,17.22,,39286.56
6790,5/26/2021,5/26/2021,Nicole Prahin,Imported from Bank of America Visa,D108,HJ,45.54,,39332.1
6790,5/28/2021,5/28/2021,Anthony Onica,Imported from reimbursements,D108,HJ,80,,39412.1
6790,5/28/2021,5/28/2021,Maryellen Leneghan,Imported from Bank of America Visa,D108,HJ,14.95,,39427.05
6790,5/30/2021,5/30/2021,Maryellen Leneghan,Imported from Bank of America Visa,D108,HJ,16.56,,39443.61
6790,6/1/2021,6/1/2021,Denise Parham-Gantt,Imported from Bank of America Visa,D112,HJ,138.4,,39582.01
6790,6/1/2021,6/1/2021,Maryellen Leneghan,Imported from Bank of America Visa,D108,HJ,35.96,,39617.97
6790,6/2/2021,6/2/2021,Mahaliah Sejour,Imported from Bank of America Visa,D108,HJ,11.99,,39629.96
6790,6/2/2021,6/2/2021,Mahaliah Sejour,Imported from Bank of America Visa,D108,HJ,22.47,,39652.43
6790,6/2/2021,6/2/2021,Mahaliah Sejour,Imported from Bank of America Visa,D108,HJ,35.96,,39688.39
6790,6/2/2021,6/2/2021,Maryellen Leneghan,Imported from Bank of America Visa,D108,HJ,8.99,,39697.38
6790,6/2/2021,6/2/2021,Maryellen Leneghan,Imported from Bank of America Visa,D108,HJ,8.99,,39706.37
6790,6/2/2021,6/2/2021,Maryellen Leneghan,Imported from Bank of America Visa,D108,HJ,8.99,,39715.36
6790,6/2/2021,6/2/2021,Maryellen Leneghan,Imported from Bank of America Visa,D108,HJ,8.99,,39724.35
6790,6/2/2021,6/2/2021,Maryellen Leneghan,Imported from Bank of America Visa,D108,HJ,13.49,,39737.84
6790,6/2/2021,6/2/2021,Myesha Hossain,Imported from Bank of America Visa,D108,HJ,14.97,,39752.81
6790,6/2/2021,6/2/2021,Myesha Hossain,Imported from Bank of America Visa,D108,HJ,14.97,,39767.78
6790,6/2/2021,6/2/2021,Myesha Hossain,Imported from Bank of America Visa,D108,HJ,16.99,,39784.77
6790,6/2/2021,6/2/2021,Myesha Hossain,Imported from Bank of America Visa,D108,HJ,16.99,,39801.76
6790,6/2/2021,6/2/2021,Myesha Hossain,Imported from Bank of America Visa,D108,HJ,17.95,,39819.71
6790,6/2/2021,6/2/2021,Myesha Hossain,Imported from Bank of America Visa,D108,HJ,18.48,,39838.19
6790,6/2/2021,6/2/2021,Myesha Hossain,Imported from Bank of America Visa,D108,HJ,28.17,,39866.36
6790,6/2/2021,6/2/2021,Myesha Hossain,Imported from Bank of America Visa,D108,HJ,28.45,,39894.81
6790,6/2/2021,6/2/2021,Myesha Hossain,Imported from Bank of America Visa,D108,HJ,28.45,,39923.26
6790,6/2/2021,6/2/2021,Myesha Hossain,Imported from Bank of America Visa,D108,HJ,28.45,,39951.71
6790,6/2/2021,6/2/2021,Myesha Hossain,Imported from Bank of America Visa,D108,HJ,28.47,,39980.18
6790,6/2/2021,6/2/2021,Myesha Hossain,Imported from Bank of America Visa,D108,HJ,61.72,,40041.9
6790,6/4/2021,6/4/2021,Antonio Gutierrez,Imported from Bank of America Visa,D108,HJ,33.48,,40075.38
6790,6/4/2021,6/4/2021,Antonio Gutierrez,Imported from Bank of America Visa,D108,HJ,329.96,,40405.34
6790,6/4/2021,6/4/2021,Denise Parham-Gantt,Imported from Bank of America Visa,D112,HJ,,31.99,40373.35
6790,6/4/2021,6/4/2021,Denise Parham-Gantt,Imported from Bank of America Visa,D112,HJ,12.92,,40386.27
6790,6/4/2021,6/4/2021,Mahaliah Sejour,Imported from Bank of America Visa,D108,HJ,8.98,,40395.25
6790,6/4/2021,6/4/2021,Mahaliah Sejour,Imported from Bank of America Visa,D108,HJ,8.99,,40404.24
6790,6/4/2021,6/4/2021,Mahaliah Sejour,Imported from Bank of America Visa,D108,HJ,14,,40418.24
6790,6/4/2021,6/4/2021,Mahaliah Sejour,Imported from Bank of America Visa,D108,HJ,18.5,,40436.74
6790,6/4/2021,6/4/2021,Mahaliah Sejour,Imported from Bank of America Visa,D108,HJ,22.53,,40459.27
6790,6/4/2021,6/4/2021,Mahaliah Sejour,Imported from Bank of America Visa,D108,HJ,22.89,,40482.16
6790,6/4/2021,6/4/2021,Mahaliah Sejour,Imported from Bank of America Visa,D108,HJ,26.5,,40508.66
6790,6/4/2021,6/4/2021,Mahaliah Sejour,Imported from Bank of America Visa,D108,HJ,26.5,,40535.16
6790,6/4/2021,6/4/2021,Mahaliah Sejour,Imported from Bank of America Visa,D108,HJ,30,,40565.16
6790,6/4/2021,6/4/2021,Mahaliah Sejour,Imported from Bank of America Visa,D108,HJ,36.69,,40601.85
6790,6/4/2021,6/4/2021,Mahaliah Sejour,Imported from Bank of America Visa,D108,HJ,36.94,,40638.79
6790,6/4/2021,6/4/2021,Mahaliah Sejour,Imported from Bank of America Visa,D108,HJ,47.4,,40686.19
6790,6/4/2021,6/4/2021,Mahaliah Sejour,Imported from Bank of America Visa,D108,HJ,47.4,,40733.59
6790,6/4/2021,6/4/2021,Mahaliah Sejour,Imported from Bank of America Visa,D108,HJ,70.86,,40804.45
6790,6/4/2021,6/4/2021,Mahaliah Sejour,Imported from Bank of America Visa,D108,HJ,70.86,,40875.31
6790,6/4/2021,6/4/2021,Mahaliah Sejour,Imported from Bank of America Visa,D108,HJ,83.26,,40958.57
6790,6/4/2021,6/4/2021,Mahaliah Sejour,Imported from Bank of America Visa,D108,HJ,83.26,,41041.83
6790,6/4/2021,6/4/2021,Mahaliah Sejour,Imported from Bank of America Visa,D108,HJ,269.5,,41311.33
6790,6/4/2021,6/4/2021,Mahaliah Sejour,Imported from Bank of America Visa,D104,HJ,45.95,,41357.28
6790,6/4/2021,6/4/2021,Mahaliah Sejour,Imported from Bank of America Visa,D104,HJ,52.55,,41409.83
6790,6/4/2021,6/4/2021,Maryellen Leneghan,Imported from Bank of America Visa,D108,HJ,5.99,,41415.82
6790,6/4/2021,6/4/2021,Maryellen Leneghan,Imported from Bank of America Visa,D108,HJ,9.19,,41425.01
6790,6/4/2021,6/4/2021,Maryellen Leneghan,Imported from Bank of America Visa,D108,HJ,9.99,,41435
6790,6/4/2021,6/4/2021,Maryellen Leneghan,Imported from Bank of America Visa,D108,HJ,12.49,,41447.49
6790,6/4/2021,6/4/2021,Maryellen Leneghan,Imported from Bank of America Visa,D108,HJ,13.51,,41461
6790,6/4/2021,6/4/2021,Maryellen Leneghan,Imported from Bank of America Visa,D108,HJ,9.65,,41470.65
6790,6/4/2021,6/4/2021,Maryellen Leneghan,Imported from Bank of America Visa,D108,HJ,39.26,,41509.91
6790,6/7/2021,6/7/2021,Mahaliah Sejour,Imported from Bank of America Visa,D108,HJ,6.98,,41516.89
6790,6/7/2021,6/7/2021,Mahaliah Sejour,Imported from Bank of America Visa,D108,HJ,10.95,,41527.84
6790,6/7/2021,6/7/2021,Mahaliah Sejour,Imported from Bank of America Visa,D108,HJ,32.59,,41560.43
6790,6/7/2021,6/7/2021,Mahaliah Sejour,Imported from Bank of America Visa,D108,HJ,33.1,,41593.53
6790,6/7/2021,6/7/2021,Mahaliah Sejour,Imported from Bank of America Visa,D108,HJ,36.47,,41630
6790,6/7/2021,6/7/2021,Mahaliah Sejour,Imported from Bank of America Visa,D108,HJ,46.08,,41676.08
6790,6/7/2021,6/7/2021,Mahaliah Sejour,Imported from Bank of America Visa,D108,HJ,83.26,,41759.34
6790,6/7/2021,6/7/2021,Mahaliah Sejour,Imported from Bank of America Visa,D108,HJ,91.87,,41851.21
6790,6/7/2021,6/7/2021,Maryellen Leneghan,Imported from Bank of America Visa,D108,HJ,5.9,,41857.11
6790,6/7/2021,6/7/2021,Maryellen Leneghan,Imported from Bank of America Visa,D108,HJ,9.66,,41866.77
6790,6/7/2021,6/7/2021,Maryellen Leneghan,Imported from Bank of America Visa,D108,HJ,22.21,,41888.98
6790,6/8/2021,6/8/2021,Mahaliah Sejour,Imported from Bank of America Visa,D108,HJ,11.12,,41900.1
6790,6/8/2021,6/8/2021,Mahaliah Sejour,Imported from Bank of America Visa,D108,HJ,15.41,,41915.51
6790,6/8/2021,6/8/2021,Mahaliah Sejour,Imported from Bank of America Visa,D108,HJ,22.94,,41938.45
6790,6/8/2021,6/8/2021,Mahaliah Sejour,Imported from Bank of America Visa,D108,HJ,33.98,,41972.43
6790,6/8/2021,6/8/2021,Mahaliah Sejour,Imported from Bank of America Visa,D108,HJ,395,,42367.43
6790,6/8/2021,6/8/2021,Mahaliah Sejour,Imported from Bank of America Visa,D108,HJ,408.7,,42776.13
6790,6/8/2021,6/8/2021,Maryellen Leneghan,Imported from Bank of America Visa,D108,HJ,8.99,,42785.12
6790,6/8/2021,6/8/2021,Maryellen Leneghan,Imported from Bank of America Visa,D108,HJ,12.49,,42797.61
6790,6/8/2021,6/8/2021,Myesha Hossain,Imported from Bank of America Visa,D108,HJ,18.52,,42816.13
6790,6/10/2021,6/10/2021,Mahaliah Sejour,Imported from Bank of America Visa,D108,HJ,15.47,,42831.6
6790,6/10/2021,6/10/2021,Mahaliah Sejour,Imported from Bank of America Visa,D108,HJ,15.99,,42847.59
6790,6/10/2021,6/10/2021,Mahaliah Sejour,Imported from Bank of America Visa,D108,HJ,25.28,,42872.87
6790,6/10/2021,6/10/2021,Mahaliah Sejour,Imported from Bank of America Visa,D108,HJ,32.08,,42904.95
6790,6/10/2021,6/10/2021,Mahaliah Sejour,Imported from Bank of America Visa,D108,HJ,235.6,,43140.55
6790,6/10/2021,6/10/2021,Mahaliah Sejour,Imported from Bank of America Visa,D108,HJ,1305.18,,44445.73
6790,6/10/2021,6/10/2021,Mahaliah Sejour,Imported from Bank of America Visa,D108,HJ,14.99,,44460.72
6790,6/10/2021,6/10/2021,Mahaliah Sejour,Imported from Bank of America Visa,D108,HJ,14.99,,44475.71
6790,6/10/2021,6/10/2021,Mahaliah Sejour,Imported from Bank of America Visa,D108,HJ,24.22,,44499.93
6790,6/10/2021,6/10/2021,Mahaliah Sejour,Imported from Bank of America Visa,D108,HJ,33.98,,44533.91
6790,6/10/2021,6/10/2021,Mahaliah Sejour,Imported from Bank of America Visa,D108,HJ,135,,44668.91
6790,6/10/2021,6/10/2021,Maryellen Leneghan,Imported from Bank of America Visa,D108,HJ,,16.56,44652.35
6790,6/10/2021,6/10/2021,Melissa McElwee,Imported from reimbursements,D108,HJ,133.1,,44785.45
6790,6/10/2021,6/10/2021,Monivett Acevedo,Imported from reimbursements,D107,HJ,28.94,,44814.39
6790,6/10/2021,6/10/2021,Myesha Hossain,Imported from Bank of America Visa,D108,HJ,11.99,,44826.38
6790,6/10/2021,6/10/2021,Myesha Hossain,Imported from Bank of America Visa,D108,HJ,13.9,,44840.28
6790,6/11/2021,6/11/2021,Mahaliah Sejour,Imported from Bank of America Visa,D108,HJ,16.99,,44857.27
6790,6/11/2021,6/11/2021,Mahaliah Sejour,Imported from Bank of America Visa,D108,HJ,16.99,,44874.26
6790,6/11/2021,6/11/2021,Mahaliah Sejour,Imported from Bank of America Visa,D108,HJ,16.99,,44891.25
6790,6/11/2021,6/11/2021,Mahaliah Sejour,Imported from Bank of America Visa,D108,HJ,16.99,,44908.24
6790,6/11/2021,6/11/2021,Myesha Hossain,Imported from Bank of America Visa,D108,HJ,15.99,,44924.23
6790,6/11/2021,6/11/2021,Nicole Horton,Imported from Bank of America Visa,D108,HJ,17.12,,44941.35
6790,6/11/2021,6/11/2021,Nicole Horton,Imported from Bank of America Visa,D108,HJ,21.39,,44962.74
6790,6/11/2021,6/11/2021,Nicole Horton,Imported from Bank of America Visa,D108,HJ,42.88,,45005.62
6790,6/14/2021,6/14/2021,Myesha Hossain,Imported from Bank of America Visa,D108,HJ,10.79,,45016.41
6790,6/14/2021,6/14/2021,Myesha Hossain,Imported from Bank of America Visa,D108,HJ,13.98,,45030.39
6790,6/15/2021,6/15/2021,Mahaliah Sejour,Imported from Bank of America Visa,D108,HJ,20.39,,45050.78
6790,6/15/2021,6/15/2021,Maryellen Leneghan,Imported from Bank of America Visa,D108,HJ,21.59,,45072.37
6790,6/15/2021,6/15/2021,Maryellen Leneghan,Imported from Bank of America Visa,D108,HJ,29.99,,45102.36
6790,6/15/2021,6/15/2021,Myesha Hossain,Imported from Bank of America Visa,D108,HJ,,2.93,45099.43
6790,6/15/2021,6/15/2021,Myesha Hossain,Imported from Bank of America Visa,D108,HJ,9.34,,45108.77
6790,6/15/2021,6/15/2021,Myesha Hossain,Imported from Bank of America Visa,D108,HJ,10,,45118.77
6790,6/15/2021,6/15/2021,Myesha Hossain,Imported from Bank of America Visa,D108,HJ,16.12,,45134.89
6790,6/16/2021,6/16/2021,Mahaliah Sejour,Imported from Bank of America Visa,D108,HJ,60.99,,45195.88
6790,6/16/2021,6/16/2021,Mahaliah Sejour,Imported from Bank of America Visa,D108,HJ,65.71,,45261.59
6790,6/16/2021,6/16/2021,Mahaliah Sejour,Imported from Bank of America Visa,D108,HJ,11.75,,45273.34
6790,6/16/2021,6/16/2021,Mahaliah Sejour,Imported from Bank of America Visa,D108,HJ,11.99,,45285.33
6790,6/16/2021,6/16/2021,Mahaliah Sejour,Imported from Bank of America Visa,D108,HJ,11.99,,45297.32
6790,6/16/2021,6/16/2021,Mahaliah Sejour,Imported from Bank of America Visa,D108,HJ,12.59,,45309.91
6790,6/16/2021,6/16/2021,Mahaliah Sejour,Imported from Bank of America Visa,D108,HJ,13.99,,45323.9
6790,6/16/2021,6/16/2021,Mahaliah Sejour,Imported from Bank of America Visa,D108,HJ,29.94,,45353.84
6790,6/16/2021,6/16/2021,Mahaliah Sejour,Imported from Bank of America Visa,D108,HJ,59.99,,45413.83
6790,6/16/2021,6/16/2021,Maryellen Leneghan,Imported from Bank of America Visa,D108,HJ,7.64,,45421.47
6790,6/16/2021,6/16/2021,Maryellen Leneghan,Imported from Bank of America Visa,D108,HJ,7.64,,45429.11
6790,6/16/2021,6/16/2021,Maryellen Leneghan,Imported from Bank of America Visa,D108,HJ,7.64,,45436.75
6790,6/16/2021,6/16/2021,Maryellen Leneghan,Imported from Bank of America Visa,D108,HJ,7.71,,45444.46
6790,6/16/2021,6/16/2021,Myesha Hossain,Imported from Bank of America Visa,D108,HJ,5.99,,45450.45
6790,6/16/2021,6/16/2021,Myesha Hossain,Imported from Bank of America Visa,D108,HJ,28.32,,45478.77
6790,6/16/2021,6/16/2021,Myesha Hossain,Imported from Bank of America Visa,D108,HJ,28.89,,45507.66
6790,6/16/2021,6/16/2021,Myesha Hossain,Imported from Bank of America Visa,D108,HJ,29.97,,45537.63
6790,6/16/2021,6/16/2021,Myesha Hossain,Imported from Bank of America Visa,D108,HJ,33.16,,45570.79
6790,6/16/2021,6/16/2021,Myesha Hossain,Imported from Bank of America Visa,D108,HJ,34.29,,45605.08
6790,6/16/2021,6/16/2021,Myesha Hossain,Imported from Bank of America Visa,D108,HJ,35.39,,45640.47
6790,6/16/2021,6/16/2021,Myesha Hossain,Imported from Bank of America Visa,D108,HJ,35.98,,45676.45
6790,6/16/2021,6/16/2021,Myesha Hossain,Imported from Bank of America Visa,D108,HJ,36.13,,45712.58
6790,6/16/2021,6/16/2021,Myesha Hossain,Imported from Bank of America Visa,D108,HJ,37.29,,45749.87
6790,6/16/2021,6/16/2021,Myesha Hossain,Imported from Bank of America Visa,D108,HJ,39.02,,45788.89
6790,6/16/2021,6/16/2021,Myesha Hossain,Imported from Bank of America Visa,D108,HJ,59.32,,45848.21
6790,6/16/2021,6/16/2021,Myesha Hossain,Imported from Bank of America Visa,D108,HJ,5,,45853.21
6790,6/16/2021,6/16/2021,Myesha Hossain,Imported from Bank of America Visa,D108,HJ,5,,45858.21
6790,6/16/2021,6/16/2021,Myesha Hossain,Imported from Bank of America Visa,D108,HJ,5,,45863.21
6790,6/16/2021,6/16/2021,Myesha Hossain,Imported from Bank of America Visa,D108,HJ,5,,45868.21
6790,6/16/2021,6/16/2021,Myesha Hossain,Imported from Bank of America Visa,D108,HJ,5,,45873.21
6790,6/16/2021,6/16/2021,Myesha Hossain,Imported from Bank of America Visa,D108,HJ,5,,45878.21
6790,6/16/2021,6/16/2021,Myesha Hossain,Imported from Bank of America Visa,D108,HJ,5,,45883.21
6790,6/16/2021,6/16/2021,Myesha Hossain,Imported from Bank of America Visa,D108,HJ,5,,45888.21
6790,6/16/2021,6/16/2021,Myesha Hossain,Imported from Bank of America Visa,D108,HJ,5,,45893.21
6790,6/16/2021,6/16/2021,Myesha Hossain,Imported from Bank of America Visa,D108,HJ,5,,45898.21
6790,6/17/2021,6/17/2021,Mahaliah Sejour,Imported from Bank of America Visa,D108,HJ,,7.67,45890.54
6790,6/17/2021,6/17/2021,Mahaliah Sejour,Imported from Bank of America Visa,D108,HJ,11.99,,45902.53
6790,6/17/2021,6/17/2021,Mahaliah Sejour,Imported from Bank of America Visa,D108,HJ,18.99,,45921.52
6790,6/17/2021,6/17/2021,Mahaliah Sejour,Imported from Bank of America Visa,D108,HJ,,29.95,45891.57
6790,6/17/2021,6/17/2021,Mahaliah Sejour,Imported from Bank of America Visa,D108,HJ,37.62,,45929.19
6790,6/17/2021,6/17/2021,Maryellen Leneghan,Imported from Bank of America Visa,D108,HJ,16.98,,45946.17
6790,6/18/2021,6/18/2021,claice Jackson,Imported from Bank of America Visa,D108,HJ,10.07,,45956.24
6790,6/18/2021,6/18/2021,Mahaliah Sejour,Imported from Bank of America Visa,D108,HJ,5.61,,45961.85
6790,6/18/2021,6/18/2021,Mahaliah Sejour,Imported from Bank of America Visa,D108,HJ,11.88,,45973.73
6790,6/18/2021,6/18/2021,Mahaliah Sejour,Imported from Bank of America Visa,D108,HJ,17.81,,45991.54
6790,6/18/2021,6/18/2021,Mahaliah Sejour,Imported from Bank of America Visa,D108,HJ,17.99,,46009.53
6790,6/18/2021,6/18/2021,Mahaliah Sejour,Imported from Bank of America Visa,D108,HJ,22.95,,46032.48
6790,6/18/2021,6/18/2021,Mahaliah Sejour,Imported from Bank of America Visa,D108,HJ,25.88,,46058.36
6790,6/18/2021,6/18/2021,Myesha Hossain,Imported from Bank of America Visa,D108,HJ,11.49,,46069.85
6790,6/18/2021,6/18/2021,Myesha Hossain,Imported from Bank of America Visa,D108,HJ,21.49,,46091.34
6790,6/21/2021,6/21/2021,Mahaliah Sejour,Imported from Bank of America Visa,D108,HJ,6.99,,46098.33
6790,6/21/2021,6/21/2021,Mahaliah Sejour,Imported from Bank of America Visa,D108,HJ,10.68,,46109.01
6790,6/21/2021,6/21/2021,Mahaliah Sejour,Imported from Bank of America Visa,D108,HJ,11.6,,46120.61
6790,6/21/2021,6/21/2021,Mahaliah Sejour,Imported from Bank of America Visa,D108,HJ,,30,46090.61
6790,6/21/2021,6/21/2021,Nicole Prahin,Imported from Bank of America Visa,D108,HJ,170.62,,46261.23
6790,6/22/2021,6/22/2021,claice Jackson,Imported from Bank of America Visa,D108,HJ,66.08,,46327.31
6790,6/22/2021,6/22/2021,Myesha Hossain,Imported from Bank of America Visa,D108,HJ,11.35,,46338.66
6790,6/22/2021,6/22/2021,Myesha Hossain,Imported from Bank of America Visa,D108,HJ,16.99,,46355.65
6790,6/22/2021,6/22/2021,Myesha Hossain,Imported from Bank of America Visa,D108,HJ,16.99,,46372.64
6790,6/22/2021,6/22/2021,Myesha Hossain,Imported from Bank of America Visa,D108,HJ,18.12,,46390.76
6790,6/22/2021,6/22/2021,Myesha Hossain,Imported from Bank of America Visa,D108,HJ,18.88,,46409.64
6790,6/22/2021,6/22/2021,Myesha Hossain,Imported from Bank of America Visa,D108,HJ,21.63,,46431.27
6790,6/23/2021,6/23/2021,Leslie Guthrie,Imported from reimbursements,D108,HJ,254.43,,46685.7
6790,6/23/2021,6/23/2021,Mahaliah Sejour,Imported from Bank of America Visa,D108,HJ,14.99,,46700.69
6790,6/23/2021,6/23/2021,Mahaliah Sejour,Imported from Bank of America Visa,D108,HJ,14.99,,46715.68
6790,6/23/2021,6/23/2021,Mahaliah Sejour,Imported from Bank of America Visa,D108,HJ,18.39,,46734.07
6790,6/23/2021,6/23/2021,Mahaliah Sejour,Imported from Bank of America Visa,D108,HJ,18.66,,46752.73
6790,6/23/2021,6/23/2021,Mahaliah Sejour,Imported from Bank of America Visa,D108,HJ,19.96,,46772.69
6790,6/23/2021,6/23/2021,Mahaliah Sejour,Imported from Bank of America Visa,D108,HJ,24.95,,46797.64
6790,6/23/2021,6/23/2021,Mahaliah Sejour,Imported from Bank of America Visa,D108,HJ,24.95,,46822.59
6790,6/23/2021,6/23/2021,Mahaliah Sejour,Imported from Bank of America Visa,D108,HJ,25.02,,46847.61
6790,6/23/2021,6/23/2021,Mahaliah Sejour,Imported from Bank of America Visa,D108,HJ,25.76,,46873.37
6790,6/23/2021,6/23/2021,Mahaliah Sejour,Imported from Bank of America Visa,D108,HJ,27.67,,46901.04
6790,6/23/2021,6/23/2021,Mahaliah Sejour,Imported from Bank of America Visa,D108,HJ,29.79,,46930.83
6790,6/23/2021,6/23/2021,Mahaliah Sejour,Imported from Bank of America Visa,D108,HJ,36.65,,46967.48
6790,6/23/2021,6/23/2021,Mahaliah Sejour,Imported from Bank of America Visa,D108,HJ,36.65,,47004.13
6790,6/23/2021,6/23/2021,Mahaliah Sejour,Imported from Bank of America Visa,D108,HJ,124.29,,47128.42
6790,6/23/2021,6/23/2021,Mahaliah Sejour,Imported from Bank of America Visa,D108,HJ,124.29,,47252.71
6790,6/23/2021,6/23/2021,Mahaliah Sejour,Imported from Bank of America Visa,D108,HJ,124.57,,47377.28
6790,6/23/2021,6/23/2021,Mahaliah Sejour,Imported from Bank of America Visa,D108,HJ,124.57,,47501.85
6790,6/23/2021,6/23/2021,Maryellen Leneghan,Imported from Bank of America Visa,D108,HJ,10.45,,47512.3
6790,6/23/2021,6/23/2021,Maryellen Leneghan,Imported from Bank of America Visa,D108,HJ,42.35,,47554.65
6790,6/23/2021,6/23/2021,Maryellen Leneghan,Imported from Bank of America Visa,D108,HJ,42.35,,47597
6790,6/23/2021,6/23/2021,Maryellen Leneghan,Imported from Bank of America Visa,D108,HJ,42.39,,47639.39
6790,6/23/2021,6/23/2021,Melissa McElwee,Imported from reimbursements,D108,HJ,136,,47775.39
6790,6/23/2021,6/23/2021,Monivett Acevedo,Imported from Bank of America Visa,D107,HJ,225,,48000.39
6790,6/23/2021,6/23/2021,Sharanya Balasubrama,Imported from reimbursements,D108,HJ,21.16,,48021.55
6790,6/23/2021,6/23/2021,Sharanya Balasubrama,Imported from reimbursements,D108,HJ,23.7,,48045.25
6790,6/24/2021,6/24/2021,Mahaliah Sejour,Imported from Bank of America Visa,D108,HJ,16.99,,48062.24
6790,6/24/2021,6/24/2021,Mahaliah Sejour,Imported from Bank of America Visa,D108,HJ,18.66,,48080.9
6790,6/24/2021,6/24/2021,Mahaliah Sejour,Imported from Bank of America Visa,D108,HJ,26.44,,48107.34
6790,6/24/2021,6/24/2021,Mahaliah Sejour,Imported from Bank of America Visa,D108,HJ,27.67,,48135.01
6790,6/24/2021,6/24/2021,Mahaliah Sejour,Imported from Bank of America Visa,D108,HJ,27.67,,48162.68
6790,6/24/2021,6/24/2021,Mahaliah Sejour,Imported from Bank of America Visa,D108,HJ,29.33,,48192.01
6790,6/24/2021,6/24/2021,Mahaliah Sejour,Imported from Bank of America Visa,D108,HJ,38.38,,48230.39
6790,6/24/2021,6/24/2021,Myesha Hossain,Imported from Bank of America Visa,D108,HJ,29.14,,48259.53
6790,6/28/2021,6/28/2021,Denise Parham-Gantt,Imported from Bank of America Visa,D112,HJ,9.73,,48269.26
6790,6/28/2021,6/28/2021,Mahaliah Sejour,Imported from Bank of America Visa,D108,HJ,43.43,,48312.69
6790,6/28/2021,6/28/2021,Maryellen Leneghan,Imported from Bank of America Visa,D108,HJ,5.99,,48318.68
6790,6/28/2021,6/28/2021,Maryellen Leneghan,Imported from Bank of America Visa,D108,HJ,6.99,,48325.67
6790,6/28/2021,6/28/2021,Maryellen Leneghan,Imported from Bank of America Visa,D108,HJ,9.99,,48335.66
6790,6/28/2021,6/28/2021,Maryellen Leneghan,Imported from Bank of America Visa,D108,HJ,9.99,,48345.65
6790,6/28/2021,6/28/2021,Maryellen Leneghan,Imported from Bank of America Visa,D108,HJ,9.99,,48355.64
6790,6/28/2021,6/28/2021,Maryellen Leneghan,Imported from Bank of America Visa,D108,HJ,9.99,,48365.63
6790,6/28/2021,6/28/2021,Maryellen Leneghan,Imported from Bank of America Visa,D108,HJ,9.99,,48375.62
6790,6/28/2021,6/28/2021,Maryellen Leneghan,Imported from Bank of America Visa,D108,HJ,9.99,,48385.61
6790,6/28/2021,6/28/2021,Maryellen Leneghan,Imported from Bank of America Visa,D108,HJ,10.62,,48396.23
6790,6/28/2021,6/28/2021,Maryellen Leneghan,Imported from Bank of America Visa,D108,HJ,10.69,,48406.92
6790,6/28/2021,6/28/2021,Maryellen Leneghan,Imported from Bank of America Visa,D108,HJ,10.84,,48417.76
6790,6/28/2021,6/28/2021,Maryellen Leneghan,Imported from Bank of America Visa,D108,HJ,10.94,,48428.7
6790,6/28/2021,6/28/2021,Monivett Acevedo,Imported from Bank of America Visa,D107,HJ,22.46,,48451.16
6790,6/30/2021,6/30/2021,Mahaliah Sejour,Imported from Bank of America Visa,D108,HJ,25.3,,48476.46
6790,6/30/2021,6/30/2021,Mahaliah Sejour,Imported from Bank of America Visa,D108,HJ,25.37,,48501.83
6790,6/30/2021,6/30/2021,Mahaliah Sejour,Imported from Bank of America Visa,D108,HJ,25.67,,48527.5
6790,6/30/2021,6/30/2021,Mahaliah Sejour,Imported from Bank of America Visa,D108,HJ,25.67,,48553.17
6790,6/30/2021,6/30/2021,Mahaliah Sejour,Imported from Bank of America Visa,D108,HJ,25.67,,48578.84
6790,6/30/2021,6/30/2021,Mahaliah Sejour,Imported from Bank of America Visa,D108,HJ,25.67,,48604.51
6790,6/30/2021,6/30/2021,Mahaliah Sejour,Imported from Bank of America Visa,D108,HJ,25.7,,48630.21
6790,6/30/2021,6/30/2021,Mahaliah Sejour,Imported from Bank of America Visa,D108,HJ,25.7,,48655.91
6790,6/30/2021,6/30/2021,Mahaliah Sejour,Imported from Bank of America Visa,D108,HJ,26.5,,48682.41
6790,6/30/2021,6/30/2021,Mahaliah Sejour,Imported from Bank of America Visa,D108,HJ,26.5,,48708.91
6790,6/30/2021,6/30/2021,Mahaliah Sejour,Imported from Bank of America Visa,D108,HJ,26.5,,48735.41
6790,6/30/2021,6/30/2021,Mahaliah Sejour,Imported from Bank of America Visa,D108,HJ,26.5,,48761.91
6790,6/30/2021,6/30/2021,Mahaliah Sejour,Imported from Bank of America Visa,D108,HJ,26.5,,48788.41
6790,6/30/2021,6/30/2021,Mahaliah Sejour,Imported from Bank of America Visa,D108,HJ,70.86,,48859.27
6790,6/30/2021,6/30/2021,Mahaliah Sejour,Imported from Bank of America Visa,D108,HJ,70.86,,48930.13
6790,6/30/2021,6/30/2021,Mahaliah Sejour,Imported from Bank of America Visa,D104,HJ,7.65,,48937.78
6790,6/30/2021,6/30/2021,Mahaliah Sejour,Imported from Bank of America Visa,D104,HJ,36.29,,48974.07
6790,6/30/2021,6/30/2021,Mahaliah Sejour,Imported from Bank of America Visa,D104,HJ,36.47,,49010.54
6790,6/30/2021,6/30/2021,Mahaliah Sejour,Imported from Bank of America Visa,D104,HJ,36.94,,49047.48
6790,6/30/2021,6/30/2021,Mahaliah Sejour,Imported from Bank of America Visa,D104,HJ,37.15,,49084.63
6790,6/30/2021,6/30/2021,Mahaliah Sejour,Imported from Bank of America Visa,D104,HJ,,38.02,49046.61
6790,6/30/2021,6/30/2021,Mahaliah Sejour,Imported from Bank of America Visa,D104,HJ,38.02,,49084.63
6790,6/30/2021,6/30/2021,Mahaliah Sejour,Imported from Bank of America Visa,D104,HJ,43.43,,49128.06
6790,6/30/2021,6/30/2021,Mahaliah Sejour,Imported from Bank of America Visa,D104,HJ,43.98,,49172.04
6790, Totals for 6790 - Tutor/Staff Incentive/Appreciation,,,,,,50329.16,1157.12,49172.04
6810,6810 - Travel (Balance forward As of 07/01/2020) ,,,,,,,,0
6810,7/1/2020,7/1/2020,Stephen O'Donnell,Imported from reimbursements-Flight to Dallas,D102,HJ,426.81,,426.81
6810,7/1/2020,7/1/2020,Stephen O'Donnell,Imported from reimbursements-Flight to NYC,D102,HJ,784.8,,1211.61
6810,7/1/2020,7/1/2020,Stephen O'Donnell,Imported from reimbursements-Lyft to airport,D102,HJ,14.26,,1225.87
6810,7/1/2020,7/1/2020,Stephen O'Donnell,Imported from reimbursements-Lyft to airport,D102,HJ,20.65,,1246.52
6810,7/1/2020,7/1/2020,Stephen O'Donnell,Imported from reimbursements-Lyft to airport,D102,HJ,21.26,,1267.78
6810,7/1/2020,7/1/2020,Stephen O'Donnell,Imported from reimbursements-Lyft to airport,D102,HJ,22.19,,1289.97
6810,7/1/2020,7/1/2020,Stephen O'Donnell,Imported from reimbursements-Lyft to airport,D102,HJ,26.84,,1316.81
6810,7/1/2020,7/1/2020,Stephen O'Donnell,Imported from reimbursements-Lyft to airport,D102,HJ,27.24,,1344.05
6810,7/1/2020,7/1/2020,Stephen O'Donnell,Imported from reimbursements-NYC public transit card,D102,HJ,12,,1356.05
6810,7/1/2020,7/1/2020,Stephen O'Donnell,Imported from reimbursements-parking for CB pickup,D102,HJ,66,,1422.05
6810,7/1/2020,7/1/2020,Stephen O'Donnell,Imported from reimbursements-Lyft to library to meet with Kyra,D102,HJ,11.82,,1433.87
6810,7/2/2020,7/2/2020,Odalis Polanco,Imported from reimbursements-Finance retreat in Boston,D103,HJ,63.1,,1496.97
6810,7/10/2020,7/10/2020,Odalis Polanco,Imported from reimbursements-Finance retreat in Boston,D103,HJ,26.16,,1523.13
6810,7/21/2020,7/21/2020,Monivett Acevedo,Imported from Bank of America Visa-Staff Retreat in Boston,D103,HJ,612.66,,2135.79
6810,7/23/2020,7/23/2020,Monivett Acevedo,Imported from Bank of America Visa-Travel to and from Boston for Staff Retreat,D103,HJ,130,,2265.79
6810,7/29/2020,7/29/2020,Myesha Hossain,Imported from Bank of America Visa-Site Clean out,D108,HJ,20.76,,2286.55
6810,7/30/2020,7/30/2020,Myesha Hossain,Imported from Bank of America Visa-Site Transportation,D108,HJ,47.11,,2333.66
6810,7/30/2020,7/30/2020,Myesha Hossain,Imported from Bank of America Visa-Site Transportation,D108,HJ,54.48,,2388.14
6810,8/1/2020,8/1/2020,Myesha Hossain,Imported from Bank of America Visa-Clinton cleanout,D108,HJ,,20.76,2367.38
6810,8/1/2020,8/1/2020,Myesha Hossain,Imported from Bank of America Visa-Clinton cleanout,D108,HJ,22.18,,2389.56
6810,8/1/2020,8/1/2020,Myesha Hossain,Imported from Bank of America Visa-Clinton cleanout,D108,HJ,102.09,,2491.65
6810,9/10/2020,9/10/2020,Monivett Acevedo,Imported from reimbursements-Gates meeting with Director of Grants for EOY report,D107,HJ,505.07,,2996.72
6810,9/15/2020,9/15/2020,Monivett Acevedo,Imported from Bank of America Visa-Hotel for trip to Boston,D103,HJ,486.49,,3483.21
6810,9/15/2020,9/15/2020,Myesha Hossain,Imported from Bank of America Visa-Site move in,D108,HJ,79.47,,3562.68
6810,9/18/2020,9/18/2020,Myesha Hossain,Imported from Bank of America Visa-Parking for site supply drop off,D108,HJ,0.75,,3563.43
6810,9/29/2020,9/29/2020,Harper Kerkhoff,Imported from reimbursements-Fingerprinting,D108,HJ,118,,3681.43
6810,10/1/2020,10/1/2020,20201001,To write off GL 1210-Old QB GL12002 Richard Hines related-To write off GL 1210-Old QB GL12002 Richard Hines related,D107,HJ,12964.23,,16645.66
6810,10/1/2020,10/1/2020,20201001-rev,To reverse and correct the GL coding-To write off GL 1210-Old QB GL12002 Richard Hines related,D107,HJ,,12964.23,3681.43
6810,10/1/2020,10/1/2020,Myesha Hossain,Imported from reimbursements-HPHS site set up,D108,HJ,124.67,,3806.1
6810,10/3/2020,10/3/2020,Monivett Acevedo,Imported from reimbursements-Travel Exp,D103,HJ,,486.49,3319.61
6810,10/9/2020,10/9/2020,Monivett Acevedo,Imported from reimbursements-Overnight parking while staying in Boston,D103,HJ,75.95,,3395.56
6810,10/11/2020,10/11/2020,Monivett Acevedo,Imported from reimbursements-Orbitz Payment,D103,HJ,105.96,,3501.52
6810,10/14/2020,10/14/2020,Monivett Acevedo,Imported from reimbursements-Travel Exp,D103,HJ,10.99,,3512.51
6810,10/22/2020,10/22/2020,Myesha Hossain,Imported from reimbursements-HPHS site set up,D108,HJ,24.12,,3536.63
6810,10/23/2020,10/23/2020,Monivett Acevedo,Imported from reimbursements-Carry on bag,D107,HJ,65,,3601.63
6810,10/23/2020,10/23/2020,Monivett Acevedo,Imported from reimbursements-Seat adjustment,D107,HJ,44,,3645.63
6810,10/23/2020,10/23/2020,Monivett Acevedo,Imported from reimbursements-Week in Boston to complete AC SC MD and other meetings,D107,HJ,1210.79,,4856.42
6810,12/16/2020,12/16/2020,Monivett Acevedo,Imported from Bank of America Visa-Boston trip,D107,HJ,493.22,,5349.64
6810,12/19/2020,12/19/2020,Maryellen Leneghan,Imported from Bank of America Visa-Wrong payment charged .refund on another transaction,D108,HJ,10.11,,5359.75
6810,12/20/2020,12/20/2020,Maryellen Leneghan,Imported from Bank of America Visa-Refund for wrong payment,D108,HJ,,10.11,5349.64
6810,12/25/2020,12/25/2020,Monivett Acevedo,Imported from Bank of America Visa-Airport to the house,D107,HJ,24.8,,5374.44
6810,3/9/2021,3/9/2021,Joseph Zarate,Imported from Bank of America Visa,D105,HJ,29.94,,5404.38
6810,3/10/2021,3/10/2021,Joseph Zarate,Imported from Bank of America Visa,D105,HJ,10.33,,5414.71
6810,3/16/2021,3/16/2021,Joseph Zarate,Imported from Bank of America Visa,D105,HJ,10.19,,5424.9
6810,3/17/2021,3/17/2021,Joseph Zarate,Imported from Bank of America Visa,D105,HJ,,13.39,5411.51
6810,3/17/2021,3/17/2021,Joseph Zarate,Imported from Bank of America Visa,D105,HJ,26.69,,5438.2
6810,3/18/2021,3/18/2021,Joseph Zarate,Imported from Bank of America Visa,D105,HJ,,7.99,5430.21
6810,3/18/2021,3/18/2021,Joseph Zarate,Imported from Bank of America Visa,D105,HJ,7.99,,5438.2
6810,3/18/2021,3/18/2021,Joseph Zarate,Imported from Bank of America Visa,D105,HJ,,10.33,5427.87
6810,3/18/2021,3/18/2021,Joseph Zarate,Imported from Bank of America Visa,D105,HJ,,29.31,5398.56
6810,3/18/2021,3/18/2021,Joseph Zarate,Imported from Bank of America Visa,D105,HJ,29.31,,5427.87
6810,3/18/2021,3/18/2021,Joseph Zarate,Imported from Bank of America Visa,D105,HJ,,31.84,5396.03
6810,3/18/2021,3/18/2021,Joseph Zarate,Imported from Bank of America Visa,D105,HJ,31.84,,5427.87
6810,3/19/2021,3/19/2021,Alan Safran,Imported from Bank of America Visa,D107,HJ,240.4,,5668.27
6810,3/19/2021,3/19/2021,Antonio Gutierrez,Imported from Bank of America Visa,D107,HJ,97.66,,5765.93
6810,3/19/2021,3/19/2021,Antonio Gutierrez,Imported from Bank of America Visa,D107,HJ,1446.8,,7212.73
6810,3/19/2021,3/19/2021,Joseph Zarate,Imported from Bank of America Visa,D105,HJ,,10.97,7201.76
6810,3/19/2021,3/19/2021,Joseph Zarate,Imported from Bank of America Visa,D105,HJ,10.97,,7212.73
6810,3/24/2021,3/24/2021,Joseph Zarate,Imported from Bank of America Visa,D105,HJ,13.9,,7226.63
6810,4/5/2021,4/5/2021,Joseph Zarate,Imported from Bank of America Visa,D105,HJ,,13.9,7212.73
6810,4/7/2021,4/7/2021,Monivett Acevedo,Imported from Bank of America Visa,D107,HJ,489.3,,7702.03
6810,4/13/2021,4/13/2021,Maryellen Leneghan,Imported from reimbursements,D107,HJ,129.98,,7832.01
6810,4/16/2021,4/16/2021,Kyra Detone,Imported from Bank of America Visa,D102,HJ,798.17,,8630.18
6810,4/27/2021,4/27/2021,Kyra Detone,Imported from reimbursements,D102,HJ,411.4,,9041.58
6810,4/27/2021,4/27/2021,Monivett Acevedo,Imported from reimbursements,D107,HJ,280.8,,9322.38
6810,5/1/2021,5/1/2021,Kyra Detone,Imported from Bank of America Visa,D102,HJ,7,,9329.38
6810,5/4/2021,5/4/2021,Alan Safran,Imported from Bank of America Visa,D107,HJ,1277.6,,10606.98
6810,5/4/2021,5/4/2021,Kyra Detone,Imported from Bank of America Visa,D102,HJ,1.75,,10608.73
6810,5/4/2021,5/4/2021,Kyra Detone,Imported from Bank of America Visa,D102,HJ,1.97,,10610.7
6810,5/5/2021,5/5/2021,Monivett Acevedo,Imported from Bank of America Visa,D107,HJ,126.98,,10737.68
6810,5/5/2021,5/5/2021,Monivett Acevedo,Imported from Bank of America Visa,D107,HJ,166.11,,10903.79
6810,5/5/2021,5/5/2021,Monivett Acevedo,Imported from Bank of America Visa,D107,HJ,218.98,,11122.77
6810,5/10/2021,5/10/2021,Monivett Acevedo,Imported from reimbursements,D107,HJ,168.4,,11291.17
6810,5/11/2021,5/11/2021,Alan Safran,Imported from Bank of America Visa,D107,HJ,105.97,,11397.14
6810,5/13/2021,5/13/2021,Alan Safran,Imported from Bank of America Visa,D107,HJ,10,,11407.14
6810,5/13/2021,5/13/2021,Alan Safran,Imported from Bank of America Visa,D107,HJ,11,,11418.14
6810,5/13/2021,5/13/2021,Alan Safran,Imported from Bank of America Visa,D107,HJ,,14.99,11403.15
6810,5/13/2021,5/13/2021,Alan Safran,Imported from Bank of America Visa,D107,HJ,37.99,,11441.14
6810,5/13/2021,5/13/2021,Alan Safran,Imported from Bank of America Visa,D107,HJ,161.12,,11602.26
6810,5/13/2021,5/13/2021,Alan Safran,Imported from Bank of America Visa,D107,HJ,216.36,,11818.62
6810,5/13/2021,5/13/2021,Antonio Gutierrez,Imported from Bank of America Visa,D107,HJ,76,,11894.62
6810,5/14/2021,5/14/2021,Mahaliah Sejour,Imported from Bank of America Visa,D108,HJ,78.28,,11972.9
6810,5/14/2021,5/14/2021,Mahaliah Sejour,Imported from Bank of America Visa,D108,HJ,444.8,,12417.7
6810,5/14/2021,5/14/2021,Tiffani Bibb,Imported from Bank of America Visa,D104,HJ,314.79,,12732.49
6810,5/14/2021,5/14/2021,Tiffani Bibb,Imported from Bank of America Visa,D104,HJ,314.79,,13047.28
6810,5/17/2021,5/17/2021,Kyra Detone,Imported from Bank of America Visa,D102,HJ,411.4,,13458.68
6810,5/17/2021,5/17/2021,Monivett Acevedo,Imported from Bank of America Visa,D107,HJ,433.62,,13892.3
6810,5/17/2021,5/17/2021,Tiffani Bibb,Imported from Bank of America Visa,D104,HJ,664.19,,14556.49
6810,5/18/2021,5/18/2021,Alan Safran,Imported from Bank of America Visa,D107,HJ,552.8,,15109.29
6810,5/18/2021,5/18/2021,Mahaliah Sejour,Imported from Bank of America Visa,D108,HJ,37.56,,15146.85
6810,5/18/2021,5/18/2021,Maryellen Leneghan,Imported from Bank of America Visa,D108,HJ,92.98,,15239.83
6810,5/21/2021,5/21/2021,Mahaliah Sejour,Imported from Bank of America Visa,D108,HJ,163.01,,15402.84
6810,5/21/2021,5/21/2021,Maryellen Leneghan,Imported from Bank of America Visa,D108,HJ,30.65,,15433.49
6810,5/24/2021,5/24/2021,Adam Hernan,Imported from reimbursements,D102,HJ,35,,15468.49
6810,5/24/2021,5/24/2021,Adam Hernan,Imported from reimbursements,D102,HJ,56.21,,15524.7
6810,5/24/2021,5/24/2021,Adam Hernan,Imported from reimbursements,D102,HJ,65.99,,15590.69
6810,5/24/2021,5/24/2021,Adam Hernan,Imported from reimbursements,D102,HJ,70.99,,15661.68
6810,5/24/2021,5/24/2021,Adam Hernan,Imported from reimbursements,D102,HJ,108.4,,15770.08
6810,5/24/2021,5/24/2021,Adam Hernan,Imported from reimbursements,D102,HJ,108.4,,15878.48
6810,5/24/2021,5/24/2021,Alan Safran,Imported from Bank of America Visa,D107,HJ,14.59,,15893.07
6810,5/24/2021,5/24/2021,Alan Safran,Imported from Bank of America Visa,D107,HJ,17.21,,15910.28
6810,5/24/2021,5/24/2021,Alan Safran,Imported from Bank of America Visa,D107,HJ,30.3,,15940.58
6810,5/24/2021,5/24/2021,Alan Safran,Imported from Bank of America Visa,D107,HJ,76,,16016.58
6810,5/24/2021,5/24/2021,Alan Safran,Imported from Bank of America Visa,D107,HJ,206.27,,16222.85
6810,5/24/2021,5/24/2021,Mahaliah Sejour,Imported from Bank of America Visa,D108,HJ,56.25,,16279.1
6810,5/24/2021,5/24/2021,Maryellen Leneghan,Imported from Bank of America Visa,D108,HJ,15.94,,16295.04
6810,5/24/2021,5/24/2021,Maryellen Leneghan,Imported from Bank of America Visa,D108,HJ,254.28,,16549.32
6810,5/24/2021,5/24/2021,Monivett Acevedo,Imported from reimbursements,D107,HJ,1,,16550.32
6810,5/24/2021,5/24/2021,Monivett Acevedo,Imported from reimbursements,D107,HJ,8.41,,16558.73
6810,5/24/2021,5/24/2021,Monivett Acevedo,Imported from reimbursements,D107,HJ,19.15,,16577.88
6810,5/28/2021,5/28/2021,Darnell Melvin,Imported from reimbursements,D109,HJ,35,,16612.88
6810,5/28/2021,5/28/2021,Darnell Melvin,Imported from reimbursements,D109,HJ,90.4,,16703.28
6810,5/28/2021,5/28/2021,Darnell Melvin,Imported from reimbursements,D109,HJ,128.49,,16831.77
6810,5/28/2021,5/28/2021,Darnell Melvin,Imported from reimbursements,D109,HJ,162.4,,16994.17
6810,5/28/2021,5/28/2021,Darnell Melvin,Imported from reimbursements,D109,HJ,188.53,,17182.7
6810,5/28/2021,5/28/2021,iaklestad,Imported from Bank of America Visa,D111,HJ,28.99,,17211.69
6810,5/28/2021,5/28/2021,iaklestad,Imported from Bank of America Visa,D111,HJ,34.92,,17246.61
6810,5/28/2021,5/28/2021,iaklestad,Imported from Bank of America Visa,D111,HJ,18.92,,17265.53
6810,5/28/2021,5/28/2021,Jeffrey Pernia,Imported from reimbursements,D109,HJ,128.49,,17394.02
6810,5/28/2021,5/28/2021,Jeffrey Pernia,Imported from reimbursements,D109,HJ,554.8,,17948.82
6810,6/2/2021,6/2/2021,Monivett Acevedo,Imported from Bank of America Visa,D107,HJ,11.99,,17960.81
6810,6/2/2021,6/2/2021,Monivett Acevedo,Imported from Bank of America Visa,D107,HJ,12.8,,17973.61
6810,6/2/2021,6/2/2021,Myesha Hossain,Imported from Bank of America Visa,D108,HJ,50,,18023.61
6810,6/4/2021,6/4/2021,Tiffany Jordan,Imported from Bank of America Visa,D108,HJ,49.5,,18073.11
6810,6/7/2021,6/7/2021,Tiffani Bibb,Imported from Bank of America Visa,D104,HJ,30,,18103.11
6810,6/7/2021,6/7/2021,Tiffani Bibb,Imported from Bank of America Visa,D104,HJ,35,,18138.11
6810,6/7/2021,6/7/2021,Tiffani Bibb,Imported from Bank of America Visa,D104,HJ,35,,18173.11
6810,6/7/2021,6/7/2021,Tiffany Jordan,Imported from Bank of America Visa,D108,HJ,3,,18176.11
6810,6/7/2021,6/7/2021,Tiffany Jordan,Imported from Bank of America Visa,D108,HJ,8.83,,18184.94
6810,6/7/2021,6/7/2021,Tiffany Jordan,Imported from Bank of America Visa,D108,HJ,13.11,,18198.05
6810,6/8/2021,6/8/2021,Mahaliah Sejour,Imported from Bank of America Visa,D108,HJ,53.37,,18251.42
6810,6/10/2021,6/10/2021,Kyra Detone,Imported from reimbursements,D102,HJ,258.4,,18509.82
6810,6/10/2021,6/10/2021,Maryellen Leneghan,Imported from reimbursements,D108,HJ,189.39,,18699.21
6810,6/10/2021,6/10/2021,Monivett Acevedo,Imported from reimbursements,D107,HJ,11.99,,18711.2
6810,6/10/2021,6/10/2021,Monivett Acevedo,Imported from reimbursements,D107,HJ,53,,18764.2
6810,6/10/2021,6/10/2021,Tiffani Bibb,Imported from Bank of America Visa,D104,HJ,38.65,,18802.85
6810,6/10/2021,6/10/2021,Tiffani Bibb,Imported from Bank of America Visa,D104,HJ,69.91,,18872.76
6810,6/10/2021,6/10/2021,Tiffani Bibb,Imported from Bank of America Visa,D104,HJ,35,,18907.76
6810,6/10/2021,6/10/2021,Tiffani Bibb,Imported from Bank of America Visa,D104,HJ,35,,18942.76
6810,6/11/2021,6/11/2021,Alan Safran,Imported from Bank of America Visa,D107,HJ,298,,19240.76
6810,6/11/2021,6/11/2021,Antonio Gutierrez,Imported from Bank of America Visa,D107,HJ,298,,19538.76
6810,6/11/2021,6/11/2021,Elizabeth Peinado,Imported from Bank of America Visa,D111,HJ,18.38,,19557.14
6810,6/11/2021,6/11/2021,Elizabeth Peinado,Imported from Bank of America Visa,D111,HJ,22.92,,19580.06
6810,6/11/2021,6/11/2021,Tiffani Bibb,Imported from Bank of America Visa,D104,HJ,37.96,,19618.02
6810,6/14/2021,6/14/2021,Joseph Zarate,Imported from reimbursements,D105,HJ,44.07,,19662.09
6810,6/14/2021,6/14/2021,Joseph Zarate,Imported from reimbursements,D105,HJ,156.36,,19818.45
6810,6/14/2021,6/14/2021,Joseph Zarate,Imported from reimbursements,D105,HJ,303.96,,20122.41
6810,6/21/2021,6/21/2021,Alan Safran,Imported from Bank of America Visa,D107,HJ,1.67,,20124.08
6810,6/21/2021,6/21/2021,Monivett Acevedo,Imported from Bank of America Visa,D107,HJ,555.66,,20679.74
6810,6/21/2021,6/21/2021,Tiffani Bibb,Imported from Bank of America Visa,D104,HJ,219.7,,20899.44
6810,6/21/2021,6/21/2021,Tiffani Bibb,Imported from Bank of America Visa,D104,HJ,219.7,,21119.14
6810,6/22/2021,6/22/2021,claice Jackson,Imported from Bank of America Visa,D108,HJ,26.1,,21145.24
6810,6/22/2021,6/22/2021,claice Jackson,Imported from Bank of America Visa,D108,HJ,37.23,,21182.47
6810,6/23/2021,6/23/2021,Alan Safran,Imported from Bank of America Visa,D107,HJ,357,,21539.47
6810,6/23/2021,6/23/2021,Melissa McElwee,Imported from reimbursements,D108,HJ,9,,21548.47
6810,6/23/2021,6/23/2021,Tiffani Bibb,Imported from Bank of America Visa,D104,HJ,292.2,,21840.67
6810,6/23/2021,6/23/2021,Tiffani Bibb,Imported from Bank of America Visa,D104,HJ,,322.2,21518.47
6810,6/23/2021,6/23/2021,Tiffani Bibb,Imported from Bank of America Visa,D104,HJ,322.2,,21840.67
6810,6/24/2021,6/24/2021,Alan Safran,Imported from Bank of America Visa,D107,HJ,,319.75,21520.92
6810,6/24/2021,6/24/2021,Antonio Gutierrez,Imported from Bank of America Visa,D107,HJ,169.11,,21690.03
6810,6/24/2021,6/24/2021,Myesha Hossain,Imported from Bank of America Visa,D108,HJ,438,,22128.03
6810,6/24/2021,6/24/2021,Nicole Prahin,Imported from Bank of America Visa,D108,HJ,404.8,,22532.83
6810,6/24/2021,6/24/2021,Tiffani Bibb,Imported from Bank of America Visa,D104,HJ,322.2,,22855.03
6810,6/28/2021,6/28/2021,Alan Safran,Imported from Bank of America Visa,D107,HJ,8,,22863.03
6810,6/28/2021,6/28/2021,Alan Safran,Imported from Bank of America Visa,D107,HJ,26,,22889.03
6810,6/28/2021,6/28/2021,Alan Safran,Imported from Bank of America Visa,D107,HJ,42,,22931.03
6810,6/28/2021,6/28/2021,Kyra Detone,Imported from Bank of America Visa,D102,HJ,0.5,,22931.53
6810,6/28/2021,6/28/2021,Kyra Detone,Imported from Bank of America Visa,D102,HJ,2,,22933.53
6810,6/28/2021,6/28/2021,Monivett Acevedo,Imported from Bank of America Visa,D107,HJ,12.03,,22945.56
6810,6/28/2021,6/28/2021,Monivett Acevedo,Imported from Bank of America Visa,D107,HJ,14.9,,22960.46
6810,6/30/2021,6/30/2021,Monivett Acevedo,Imported from Bank of America Visa,D107,HJ,34.89,,22995.35
6810,6/30/2021,6/30/2021,Monivett Acevedo,Imported from Bank of America Visa,D107,HJ,26.43,,23021.78
6810, Totals for 6810 - Travel,,,,,,37278.04,14256.26,23021.78
6820,6820 - Background Checks for Staff (Balance forward As of 07/01/2020) ,,,,,,,,0
6820,8/17/2020,8/17/2020,Myesha Hossain,Imported from Bank of America Visa-Fingerprinting,D108,HJ,135,,135
6820,9/1/2020,9/1/2020,Myesha Hossain,Imported from Bank of America Visa-Fingerprinting,D108,HJ,135,,270
6820,9/1/2020,9/1/2020,Myesha Hossain,Imported from Bank of America Visa-Fingerprinting,D108,HJ,135,,405
6820,9/1/2020,9/1/2020,Myesha Hossain,Imported from Bank of America Visa-Fingerprinting,D108,HJ,135,,540
6820,9/2/2020,9/2/2020,Myesha Hossain,Imported from Bank of America Visa-Fingerprinting,D108,HJ,135,,675
6820,9/4/2020,9/4/2020,Myesha Hossain,Imported from Bank of America Visa-Fingerprinting,D108,HJ,135,,810
6820,9/4/2020,9/4/2020,Myesha Hossain,Imported from Bank of America Visa-Fingerprinting,D108,HJ,135,,945
6820,9/4/2020,9/4/2020,Myesha Hossain,Imported from Bank of America Visa-Fingerprinting,D108,HJ,135,,1080
6820,9/8/2020,9/8/2020,Myesha Hossain,Imported from Bank of America Visa-Fingerprinting,D108,HJ,135,,1215
6820,9/9/2020,9/9/2020,Myesha Hossain,Imported from Bank of America Visa-Fingerprinting,D108,HJ,135,,1350
6820,9/11/2020,9/11/2020,Myesha Hossain,Imported from Bank of America Visa-DOE incorrect transaction,D108,HJ,60,,1410
6820,9/14/2020,9/14/2020,Myesha Hossain,Imported from Bank of America Visa-DOE incorrect transaction,D108,HJ,60,,1470
6820,9/16/2020,9/16/2020,Myesha Hossain,Imported from Bank of America Visa-DOE incorrect transaction,D108,HJ,60,,1530
6820,9/21/2020,9/21/2020,Myesha Hossain,Imported from Bank of America Visa-DOE incorrect transaction,D108,HJ,60,,1590
6820,9/21/2020,9/21/2020,Myesha Hossain,Imported from Bank of America Visa-DOE incorrect transaction,D108,HJ,60,,1650
6820,9/21/2020,9/21/2020,Myesha Hossain,Imported from Bank of America Visa-Fingerprinting,D108,HJ,135,,1785
6820,9/29/2020,9/29/2020,Myesha Hossain,Imported from Bank of America Visa-Incorrect transaction,D108,HJ,60,,1845
6820,10/7/2020,10/7/2020,Myesha Hossain,Imported from reimbursements-Fingerprinting,D108,HJ,135,,1980
6820,10/7/2020,10/7/2020,Myesha Hossain,Imported from reimbursements-Fingerprinting,D108,HJ,135,,2115
6820,10/8/2020,10/8/2020,Myesha Hossain,Imported from reimbursements-Fingerprinting,D108,HJ,135,,2250
6820,10/9/2020,10/9/2020,Myesha Hossain,Imported from reimbursements-Fingerprinting,D108,HJ,135,,2385
6820,10/16/2020,10/16/2020,Myesha Hossain,Imported from reimbursements-Refund,D108,HJ,,360,2025
6820,11/12/2020,11/12/2020,Funmilayo Ikunika,Bill.Com Import-Fieldprint scheduling fee,D104,HJ,73.5,,2098.5
6820,11/24/2020,11/24/2020,Stephen Lipscomb,Bill.Com Import-FingerPrints for Broward County Schools,D104,HJ,73.5,,2172
6820,12/18/2020,12/18/2020,Alan Safran,Imported from Bank of America Visa-Background Checks for fellows,D104,HJ,70,,2242
6820,12/18/2020,12/18/2020,Alan Safran,Imported from Bank of America Visa-Background Checks for fellowsBackground Checks for fellows,D104,HJ,41.5,,2283.5
6820,12/21/2020,12/21/2020,Alan Safran,Imported from Bank of America Visa-Background Checks for fellows,D104,HJ,36.5,,2320
6820,12/30/2020,12/30/2020,Alan Safran,Imported from Bank of America Visa-Background Checks for fellows,D104,HJ,36.5,,2356.5
6820,12/31/2020,12/31/2020,20201231,Actual vs Budget Reclass as of 12/31/2020-Actual vs Budget Reclass as of 12/31/2020,D104,HJ,2025,,4381.5
6820,12/31/2020,12/31/2020,20201231,Actual vs Budget Reclass as of 12/31/2020-Actual vs Budget Reclass as of 12/31/2020,D108,HJ,,2025,2356.5
6820,1/7/2021,1/7/2021,Alan Safran,Imported from Bank of America Visa-Background Check for Sunaina Vyas,D104,HJ,36.5,,2393
6820,1/8/2021,1/8/2021,Alan Safran,Imported from Bank of America Visa-Background Check for Grady Lai,D104,HJ,50.5,,2443.5
6820,1/20/2021,1/20/2021,Alan Safran,Imported from Bank of America Visa-Background Check for Samuel Briante,D104,HJ,50.5,,2494
6820,2/8/2021,2/8/2021,Alan Safran,Imported from Bank of America Visa-Background Check for Fernanda Calvo,D104,HJ,122.5,,2616.5
6820,2/23/2021,2/23/2021,Alan Safran,Imported from Bank of America Visa-Background Check for Alison Kerins,D104,HJ,50.5,,2667
6820,2/25/2021,2/25/2021,Alan Safran,Imported from Bank of America Visa-Background Check for Nicole Horton,D104,HJ,50.5,,2717.5
6820,3/31/2021,3/31/2021,Alan Safran,Imported from Bank of America Visa,D104,HJ,36.5,,2754
6820,4/5/2021,4/5/2021,Alan Safran,Imported from Bank of America Visa,D104,HJ,51.5,,2805.5
6820,4/27/2021,4/27/2021,Alan Safran,Imported from Bank of America Visa,D104,HJ,51.5,,2857
6820,4/28/2021,4/28/2021,JE-21-0257,Correct City on transaction,D104,HJ,51.5,,2908.5
6820,4/28/2021,4/28/2021,JE-21-0257,Correct City on transaction,D104,HJ,,51.5,2857
6820,5/17/2021,5/17/2021,Alan Safran,Imported from Bank of America Visa,D104,HJ,29.65,,2886.65
6820,5/20/2021,5/20/2021,Alan Safran,Imported from Bank of America Visa,D107,HJ,26.5,,2913.15
6820,5/20/2021,5/20/2021,Mahaliah Sejour,Imported from Bank of America Visa,D104,HJ,135,,3048.15
6820,5/26/2021,5/26/2021,Alan Safran,Imported from Bank of America Visa,D104,HJ,27.75,,3075.9
6820,5/26/2021,5/26/2021,Alan Safran,Imported from Bank of America Visa,D104,HJ,36.5,,3112.4
6820,6/1/2021,6/1/2021,Alan Safran,Imported from Bank of America Visa,D104,HJ,36.5,,3148.9
6820,6/4/2021,6/4/2021,Alan Safran,Imported from Bank of America Visa,D104,HJ,27.75,,3176.65
6820,6/7/2021,6/7/2021,Alan Safran,Imported from Bank of America Visa,D104,HJ,36.5,,3213.15
6820,6/8/2021,6/8/2021,Alan Safran,Imported from Bank of America Visa,D104,HJ,27.75,,3240.9
6820,6/8/2021,6/8/2021,Alan Safran,Imported from Bank of America Visa,D104,HJ,36.5,,3277.4
6820,6/11/2021,6/11/2021,Alan Safran,Imported from Bank of America Visa,D104,HJ,36.5,,3313.9
6820,6/11/2021,6/11/2021,Alan Safran,Imported from Bank of America Visa,D104,HJ,7.5,,3321.4
6820,6/15/2021,6/15/2021,Alan Safran,Imported from Bank of America Visa,D104,HJ,27.75,,3349.15
6820,6/18/2021,6/18/2021,Alan Safran,Imported from Bank of America Visa,D104,HJ,27.75,,3376.9
6820,6/21/2021,6/21/2021,ACCURATE BIOMETRICS,Bill.Com Import,D104,HJ,60.25,,3437.15
6820,6/21/2021,6/21/2021,Alan Safran,Imported from Bank of America Visa,D104,HJ,27.75,,3464.9
6820,6/21/2021,6/21/2021,Alan Safran,Imported from Bank of America Visa,D104,HJ,36.5,,3501.4
6820,6/21/2021,6/21/2021,Alan Safran,Imported from Bank of America Visa,D104,HJ,36.5,,3537.9
6820,6/22/2021,6/22/2021,Alan Safran,Imported from Bank of America Visa,D104,HJ,27.75,,3565.65
6820,6/22/2021,6/22/2021,Alan Safran,Imported from Bank of America Visa,D104,HJ,36.5,,3602.15
6820,6/23/2021,6/23/2021,Alan Safran,Imported from Bank of America Visa,D104,HJ,27.75,,3629.9
6820,6/23/2021,6/23/2021,Alan Safran,Imported from Bank of America Visa,D104,HJ,27.75,,3657.65
6820,6/23/2021,6/23/2021,Alan Safran,Imported from Bank of America Visa,D104,HJ,51.5,,3709.15
6820,6/24/2021,6/24/2021,Alan Safran,Imported from Bank of America Visa,D104,HJ,50.5,,3759.65
6820,6/24/2021,6/24/2021,Alan Safran,Imported from Bank of America Visa,D104,HJ,27.75,,3787.4
6820,6/24/2021,6/24/2021,Alan Safran,Imported from Bank of America Visa,D104,HJ,36.5,,3823.9
6820,6/24/2021,6/24/2021,Alan Safran,Imported from Bank of America Visa,D104,HJ,51.5,,3875.4
6820,6/28/2021,6/28/2021,Alan Safran,Imported from Bank of America Visa,D104,HJ,7.5,,3882.9
6820, Totals for 6820 - Background Checks for Staff,,,,,,6319.4,2436.5,3882.9
6830,6830 - Background Checks for AmeriCorps Fellows (Balance forward As of 07/01/2020) ,,,,,,,,0
6830,7/1/2020,7/1/2020,Alan Safran,Imported from Bank of America Visa-Background checks for fellows,D102,HJ,2.15,,2.15
6830,7/1/2020,7/1/2020,Alan Safran,Imported from Bank of America Visa-Background checks for fellows,D102,HJ,3.31,,5.46
6830,7/1/2020,7/1/2020,Alan Safran,Imported from Bank of America Visa-Background checks for fellows,D102,HJ,3.32,,8.78
6830,7/1/2020,7/1/2020,Alan Safran,Imported from Bank of America Visa-Background checks for fellows,D102,HJ,10.72,,19.5
6830,7/3/2020,7/3/2020,Alan Safran,Imported from Bank of America Visa-Background checks for fellows,D102,HJ,4.02,,23.52
6830,7/3/2020,7/3/2020,Alan Safran,Imported from Bank of America Visa-Background checks for fellows,D102,HJ,5.56,,29.08
6830,7/3/2020,7/3/2020,Alan Safran,Imported from Bank of America Visa-Background checks for fellows,D102,HJ,6.2,,35.28
6830,7/3/2020,7/3/2020,Alan Safran,Imported from Bank of America Visa-Background checks for fellows,D102,HJ,6.21,,41.49
6830,7/3/2020,7/3/2020,Alan Safran,Imported from Bank of America Visa-Background checks for fellows,D102,HJ,8.58,,50.07
6830,7/3/2020,7/3/2020,Alan Safran,Imported from Bank of America Visa-Background checks for fellows,D102,HJ,8.59,,58.66
6830,7/3/2020,7/3/2020,Alan Safran,Imported from Bank of America Visa-Background checks for fellows,D102,HJ,20.07,,78.73
6830,7/3/2020,7/3/2020,Alan Safran,Imported from Bank of America Visa-Background checks for fellows,D102,HJ,27.77,,106.5
6830,7/4/2020,7/4/2020,Alan Safran,Imported from Bank of America Visa-Background checks for fellows,D102,HJ,3.16,,109.66
6830,7/4/2020,7/4/2020,Alan Safran,Imported from Bank of America Visa-Background checks for fellows,D102,HJ,4.89,,114.55
6830,7/4/2020,7/4/2020,Alan Safran,Imported from Bank of America Visa-Background checks for fellows,D102,HJ,4.89,,119.44
6830,7/4/2020,7/4/2020,Alan Safran,Imported from Bank of America Visa-Background checks for fellows,D102,HJ,15.81,,135.25
6830,7/5/2020,7/5/2020,Alan Safran,Imported from Bank of America Visa-Background checks for fellows,D102,HJ,5.56,,140.81
6830,7/5/2020,7/5/2020,Alan Safran,Imported from Bank of America Visa-Background checks for fellows,D102,HJ,8.58,,149.39
6830,7/5/2020,7/5/2020,Alan Safran,Imported from Bank of America Visa-Background checks for fellows,D102,HJ,8.59,,157.98
6830,7/5/2020,7/5/2020,Alan Safran,Imported from Bank of America Visa-Background checks for fellows,D102,HJ,27.77,,185.75
6830,7/7/2020,7/7/2020,Alan Safran,Imported from Bank of America Visa-Background checks for fellows,D102,HJ,3.16,,188.91
6830,7/7/2020,7/7/2020,Alan Safran,Imported from Bank of America Visa-Background checks for fellows,D102,HJ,4.02,,192.93
6830,7/7/2020,7/7/2020,Alan Safran,Imported from Bank of America Visa-Background checks for fellows,D102,HJ,4.02,,196.95
6830,7/7/2020,7/7/2020,Alan Safran,Imported from Bank of America Visa-Background checks for fellows,D102,HJ,4.02,,200.97
6830,7/7/2020,7/7/2020,Alan Safran,Imported from Bank of America Visa-Background checks for fellows,D102,HJ,4.89,,205.86
6830,7/7/2020,7/7/2020,Alan Safran,Imported from Bank of America Visa-Background checks for fellows,D102,HJ,4.89,,210.75
6830,7/7/2020,7/7/2020,Alan Safran,Imported from Bank of America Visa-Background checks for fellows,D102,HJ,6.2,,216.95
6830,7/7/2020,7/7/2020,Alan Safran,Imported from Bank of America Visa-Background checks for fellows,D102,HJ,6.2,,223.15
6830,7/7/2020,7/7/2020,Alan Safran,Imported from Bank of America Visa-Background checks for fellows,D102,HJ,6.2,,229.35
6830,7/7/2020,7/7/2020,Alan Safran,Imported from Bank of America Visa-Background checks for fellows,D102,HJ,6.21,,235.56
6830,7/7/2020,7/7/2020,Alan Safran,Imported from Bank of America Visa-Background checks for fellows,D102,HJ,6.21,,241.77
6830,7/7/2020,7/7/2020,Alan Safran,Imported from Bank of America Visa-Background checks for fellows,D102,HJ,6.21,,247.98
6830,7/7/2020,7/7/2020,Alan Safran,Imported from Bank of America Visa-Background checks for fellows,D102,HJ,13.48,,261.46
6830,7/7/2020,7/7/2020,Alan Safran,Imported from Bank of America Visa-Background checks for fellows,D102,HJ,15.81,,277.27
6830,7/7/2020,7/7/2020,Alan Safran,Imported from Bank of America Visa-Background checks for fellows,D102,HJ,20.07,,297.34
6830,7/7/2020,7/7/2020,Alan Safran,Imported from Bank of America Visa-Background checks for fellows,D102,HJ,20.07,,317.41
6830,7/7/2020,7/7/2020,Alan Safran,Imported from Bank of America Visa-Background checks for fellows,D102,HJ,20.07,,337.48
6830,7/7/2020,7/7/2020,Alan Safran,Imported from Bank of America Visa-Background checks for fellows,D102,HJ,20.82,,358.3
6830,7/7/2020,7/7/2020,Alan Safran,Imported from Bank of America Visa-Background checks for fellows,D102,HJ,20.83,,379.13
6830,7/7/2020,7/7/2020,Alan Safran,Imported from Bank of America Visa-Background checks for fellows,D102,HJ,67.37,,446.5
6830,7/8/2020,7/8/2020,Alan Safran,Imported from Bank of America Visa-Background checks for fellows,D102,HJ,3.16,,449.66
6830,7/8/2020,7/8/2020,Alan Safran,Imported from Bank of America Visa-Background checks for fellows,D102,HJ,3.16,,452.82
6830,7/8/2020,7/8/2020,Alan Safran,Imported from Bank of America Visa-Background checks for fellows,D102,HJ,3.16,,455.98
6830,7/8/2020,7/8/2020,Alan Safran,Imported from Bank of America Visa-Background checks for fellows,D102,HJ,3.16,,459.14
6830,7/8/2020,7/8/2020,Alan Safran,Imported from Bank of America Visa-Background checks for fellows,D102,HJ,3.16,,462.3
6830,7/8/2020,7/8/2020,Alan Safran,Imported from Bank of America Visa-Background checks for fellows,D102,HJ,3.16,,465.46
6830,7/8/2020,7/8/2020,Alan Safran,Imported from Bank of America Visa-Background checks for fellows,D102,HJ,3.16,,468.62
6830,7/8/2020,7/8/2020,Alan Safran,Imported from Bank of America Visa-Background checks for fellows,D102,HJ,3.16,,471.78
6830,7/8/2020,7/8/2020,Alan Safran,Imported from Bank of America Visa-Background checks for fellows,D102,HJ,4.02,,475.8
6830,7/8/2020,7/8/2020,Alan Safran,Imported from Bank of America Visa-Background checks for fellows,D102,HJ,4.02,,479.82
6830,7/8/2020,7/8/2020,Alan Safran,Imported from Bank of America Visa-Background checks for fellows,D102,HJ,4.89,,484.71
6830,7/8/2020,7/8/2020,Alan Safran,Imported from Bank of America Visa-Background checks for fellows,D102,HJ,4.89,,489.6
6830,7/8/2020,7/8/2020,Alan Safran,Imported from Bank of America Visa-Background checks for fellows,D102,HJ,4.89,,494.49
6830,7/8/2020,7/8/2020,Alan Safran,Imported from Bank of America Visa-Background checks for fellows,D102,HJ,4.89,,499.38
6830,7/8/2020,7/8/2020,Alan Safran,Imported from Bank of America Visa-Background checks for fellows,D102,HJ,4.89,,504.27
6830,7/8/2020,7/8/2020,Alan Safran,Imported from Bank of America Visa-Background checks for fellows,D102,HJ,4.89,,509.16
6830,7/8/2020,7/8/2020,Alan Safran,Imported from Bank of America Visa-Background checks for fellows,D102,HJ,4.89,,514.05
6830,7/8/2020,7/8/2020,Alan Safran,Imported from Bank of America Visa-Background checks for fellows,D102,HJ,4.89,,518.94
6830,7/8/2020,7/8/2020,Alan Safran,Imported from Bank of America Visa-Background checks for fellows,D102,HJ,4.89,,523.83
6830,7/8/2020,7/8/2020,Alan Safran,Imported from Bank of America Visa-Background checks for fellows,D102,HJ,4.89,,528.72
6830,7/8/2020,7/8/2020,Alan Safran,Imported from Bank of America Visa-Background checks for fellows,D102,HJ,4.89,,533.61
6830,7/8/2020,7/8/2020,Alan Safran,Imported from Bank of America Visa-Background checks for fellows,D102,HJ,4.89,,538.5
6830,7/8/2020,7/8/2020,Alan Safran,Imported from Bank of America Visa-Background checks for fellows,D102,HJ,4.89,,543.39
6830,7/8/2020,7/8/2020,Alan Safran,Imported from Bank of America Visa-Background checks for fellows,D102,HJ,4.89,,548.28
6830,7/8/2020,7/8/2020,Alan Safran,Imported from Bank of America Visa-Background checks for fellows,D102,HJ,4.89,,553.17
6830,7/8/2020,7/8/2020,Alan Safran,Imported from Bank of America Visa-Background checks for fellows,D102,HJ,4.89,,558.06
6830,7/8/2020,7/8/2020,Alan Safran,Imported from Bank of America Visa-Background checks for fellows,D102,HJ,6.2,,564.26
6830,7/8/2020,7/8/2020,Alan Safran,Imported from Bank of America Visa-Background checks for fellows,D102,HJ,6.2,,570.46
6830,7/8/2020,7/8/2020,Alan Safran,Imported from Bank of America Visa-Background checks for fellows,D102,HJ,6.21,,576.67
6830,7/8/2020,7/8/2020,Alan Safran,Imported from Bank of America Visa-Background checks for fellows,D102,HJ,6.21,,582.88
6830,7/8/2020,7/8/2020,Alan Safran,Imported from Bank of America Visa-Background checks for fellows,D102,HJ,6.93,,589.81
6830,7/8/2020,7/8/2020,Alan Safran,Imported from Bank of America Visa-Background checks for fellows,D102,HJ,10.71,,600.52
6830,7/8/2020,7/8/2020,Alan Safran,Imported from Bank of America Visa-Background checks for fellows,D102,HJ,10.71,,611.23
6830,7/8/2020,7/8/2020,Alan Safran,Imported from Bank of America Visa-Background checks for fellows,D102,HJ,15.81,,627.04
6830,7/8/2020,7/8/2020,Alan Safran,Imported from Bank of America Visa-Background checks for fellows,D102,HJ,15.81,,642.85
6830,7/8/2020,7/8/2020,Alan Safran,Imported from Bank of America Visa-Background checks for fellows,D102,HJ,15.81,,658.66
6830,7/8/2020,7/8/2020,Alan Safran,Imported from Bank of America Visa-Background checks for fellows,D102,HJ,15.81,,674.47
6830,7/8/2020,7/8/2020,Alan Safran,Imported from Bank of America Visa-Background checks for fellows,D102,HJ,15.81,,690.28
6830,7/8/2020,7/8/2020,Alan Safran,Imported from Bank of America Visa-Background checks for fellows,D102,HJ,15.81,,706.09
6830,7/8/2020,7/8/2020,Alan Safran,Imported from Bank of America Visa-Background checks for fellows,D102,HJ,15.81,,721.9
6830,7/8/2020,7/8/2020,Alan Safran,Imported from Bank of America Visa-Background checks for fellows,D102,HJ,15.81,,737.71
6830,7/8/2020,7/8/2020,Alan Safran,Imported from Bank of America Visa-Background checks for fellows,D102,HJ,20.07,,757.78
6830,7/8/2020,7/8/2020,Alan Safran,Imported from Bank of America Visa-Background checks for fellows,D102,HJ,20.07,,777.85
6830,7/8/2020,7/8/2020,Alan Safran,Imported from Bank of America Visa-Background checks for fellows,D102,HJ,34.65,,812.5
6830,7/9/2020,7/9/2020,Alan Safran,Imported from Bank of America Visa-Background checks for fellows,D102,HJ,3.16,,815.66
6830,7/9/2020,7/9/2020,Alan Safran,Imported from Bank of America Visa-Background checks for fellows,D102,HJ,3.16,,818.82
6830,7/9/2020,7/9/2020,Alan Safran,Imported from Bank of America Visa-Background checks for fellows,D102,HJ,4.02,,822.84
6830,7/9/2020,7/9/2020,Alan Safran,Imported from Bank of America Visa-Background checks for fellows,D102,HJ,4.02,,826.86
6830,7/9/2020,7/9/2020,Alan Safran,Imported from Bank of America Visa-Background checks for fellows,D102,HJ,4.89,,831.75
6830,7/9/2020,7/9/2020,Alan Safran,Imported from Bank of America Visa-Background checks for fellows,D102,HJ,4.89,,836.64
6830,7/9/2020,7/9/2020,Alan Safran,Imported from Bank of America Visa-Background checks for fellows,D102,HJ,4.89,,841.53
6830,7/9/2020,7/9/2020,Alan Safran,Imported from Bank of America Visa-Background checks for fellows,D102,HJ,4.89,,846.42
6830,7/9/2020,7/9/2020,Alan Safran,Imported from Bank of America Visa-Background checks for fellows,D102,HJ,5.06,,851.48
6830,7/9/2020,7/9/2020,Alan Safran,Imported from Bank of America Visa-Background checks for fellows,D102,HJ,5.06,,856.54
6830,7/9/2020,7/9/2020,Alan Safran,Imported from Bank of America Visa-Background checks for fellows,D102,HJ,6.2,,862.74
6830,7/9/2020,7/9/2020,Alan Safran,Imported from Bank of America Visa-Background checks for fellows,D102,HJ,6.2,,868.94
6830,7/9/2020,7/9/2020,Alan Safran,Imported from Bank of America Visa-Background checks for fellows,D102,HJ,6.21,,875.15
6830,7/9/2020,7/9/2020,Alan Safran,Imported from Bank of America Visa-Background checks for fellows,D102,HJ,6.21,,881.36
6830,7/9/2020,7/9/2020,Alan Safran,Imported from Bank of America Visa-Background checks for fellows,D102,HJ,6.38,,887.74
6830,7/9/2020,7/9/2020,Alan Safran,Imported from Bank of America Visa-Background checks for fellows,D102,HJ,7.81,,895.55
6830,7/9/2020,7/9/2020,Alan Safran,Imported from Bank of America Visa-Background checks for fellows,D102,HJ,7.82,,903.37
6830,7/9/2020,7/9/2020,Alan Safran,Imported from Bank of America Visa-Background checks for fellows,D102,HJ,7.82,,911.19
6830,7/9/2020,7/9/2020,Alan Safran,Imported from Bank of America Visa-Background checks for fellows,D102,HJ,7.82,,919.01
6830,7/9/2020,7/9/2020,Alan Safran,Imported from Bank of America Visa-Background checks for fellows,D102,HJ,7.82,,926.83
6830,7/9/2020,7/9/2020,Alan Safran,Imported from Bank of America Visa-Background checks for fellows,D102,HJ,9.86,,936.69
6830,7/9/2020,7/9/2020,Alan Safran,Imported from Bank of America Visa-Background checks for fellows,D102,HJ,9.86,,946.55
6830,7/9/2020,7/9/2020,Alan Safran,Imported from Bank of America Visa-Background checks for fellows,D102,HJ,12.07,,958.62
6830,7/9/2020,7/9/2020,Alan Safran,Imported from Bank of America Visa-Background checks for fellows,D102,HJ,12.07,,970.69
6830,7/9/2020,7/9/2020,Alan Safran,Imported from Bank of America Visa-Background checks for fellows,D102,HJ,15.81,,986.5
6830,7/9/2020,7/9/2020,Alan Safran,Imported from Bank of America Visa-Background checks for fellows,D102,HJ,15.81,,1002.31
6830,7/9/2020,7/9/2020,Alan Safran,Imported from Bank of America Visa-Background checks for fellows,D102,HJ,20.07,,1022.38
6830,7/9/2020,7/9/2020,Alan Safran,Imported from Bank of America Visa-Background checks for fellows,D102,HJ,20.07,,1042.45
6830,7/9/2020,7/9/2020,Alan Safran,Imported from Bank of America Visa-Background checks for fellows,D102,HJ,25.3,,1067.75
6830,7/9/2020,7/9/2020,Alan Safran,Imported from Bank of America Visa-Background checks for fellows,D102,HJ,25.3,,1093.05
6830,7/9/2020,7/9/2020,Alan Safran,Imported from Bank of America Visa-Background checks for fellows,D102,HJ,31.9,,1124.95
6830,7/9/2020,7/9/2020,Alan Safran,Imported from Bank of America Visa-Background checks for fellows,D102,HJ,39.05,,1164
6830,7/10/2020,7/10/2020,Alan Safran,Imported from Bank of America Visa-Background checks for fellows,D102,HJ,2.92,,1166.92
6830,7/10/2020,7/10/2020,Alan Safran,Imported from Bank of America Visa-Background checks for fellows,D102,HJ,3.16,,1170.08
6830,7/10/2020,7/10/2020,Alan Safran,Imported from Bank of America Visa-Background checks for fellows,D102,HJ,3.16,,1173.24
6830,7/10/2020,7/10/2020,Alan Safran,Imported from Bank of America Visa-Background checks for fellows,D102,HJ,3.16,,1176.4
6830,7/10/2020,7/10/2020,Alan Safran,Imported from Bank of America Visa-Background checks for fellows,D102,HJ,4.5,,1180.9
6830,7/10/2020,7/10/2020,Alan Safran,Imported from Bank of America Visa-Background checks for fellows,D102,HJ,4.51,,1185.41
6830,7/10/2020,7/10/2020,Alan Safran,Imported from Bank of America Visa-Background checks for fellows,D102,HJ,4.89,,1190.3
6830,7/10/2020,7/10/2020,Alan Safran,Imported from Bank of America Visa-Background checks for fellows,D102,HJ,4.89,,1195.19
6830,7/10/2020,7/10/2020,Alan Safran,Imported from Bank of America Visa-Background checks for fellows,D102,HJ,4.89,,1200.08
6830,7/10/2020,7/10/2020,Alan Safran,Imported from Bank of America Visa-Background checks for fellows,D102,HJ,4.89,,1204.97
6830,7/10/2020,7/10/2020,Alan Safran,Imported from Bank of America Visa-Background checks for fellows,D102,HJ,4.89,,1209.86
6830,7/10/2020,7/10/2020,Alan Safran,Imported from Bank of America Visa-Background checks for fellows,D102,HJ,4.89,,1214.75
6830,7/10/2020,7/10/2020,Alan Safran,Imported from Bank of America Visa-Background checks for fellows,D102,HJ,6.71,,1221.46
6830,7/10/2020,7/10/2020,Alan Safran,Imported from Bank of America Visa-Background checks for fellows,D102,HJ,10.37,,1231.83
6830,7/10/2020,7/10/2020,Alan Safran,Imported from Bank of America Visa-Background checks for fellows,D102,HJ,10.37,,1242.2
6830,7/10/2020,7/10/2020,Alan Safran,Imported from Bank of America Visa-Background checks for fellows,D102,HJ,14.57,,1256.77
6830,7/10/2020,7/10/2020,Alan Safran,Imported from Bank of America Visa-Background checks for fellows,D102,HJ,15.81,,1272.58
6830,7/10/2020,7/10/2020,Alan Safran,Imported from Bank of America Visa-Background checks for fellows,D102,HJ,15.81,,1288.39
6830,7/10/2020,7/10/2020,Alan Safran,Imported from Bank of America Visa-Background checks for fellows,D102,HJ,15.81,,1304.2
6830,7/10/2020,7/10/2020,Alan Safran,Imported from Bank of America Visa-Background checks for fellows,D102,HJ,33.55,,1337.75
6830,7/11/2020,7/11/2020,Alan Safran,Imported from Bank of America Visa-Background checks for fellows,D102,HJ,3.16,,1340.91
6830,7/11/2020,7/11/2020,Alan Safran,Imported from Bank of America Visa-Background checks for fellows,D102,HJ,3.16,,1344.07
6830,7/11/2020,7/11/2020,Alan Safran,Imported from Bank of America Visa-Background checks for fellows,D102,HJ,3.16,,1347.23
6830,7/11/2020,7/11/2020,Alan Safran,Imported from Bank of America Visa-Background checks for fellows,D102,HJ,4.02,,1351.25
6830,7/11/2020,7/11/2020,Alan Safran,Imported from Bank of America Visa-Background checks for fellows,D102,HJ,4.02,,1355.27
6830,7/11/2020,7/11/2020,Alan Safran,Imported from Bank of America Visa-Background checks for fellows,D102,HJ,4.89,,1360.16
6830,7/11/2020,7/11/2020,Alan Safran,Imported from Bank of America Visa-Background checks for fellows,D102,HJ,4.89,,1365.05
6830,7/11/2020,7/11/2020,Alan Safran,Imported from Bank of America Visa-Background checks for fellows,D102,HJ,4.89,,1369.94
6830,7/11/2020,7/11/2020,Alan Safran,Imported from Bank of America Visa-Background checks for fellows,D102,HJ,4.89,,1374.83
6830,7/11/2020,7/11/2020,Alan Safran,Imported from Bank of America Visa-Background checks for fellows,D102,HJ,4.89,,1379.72
6830,7/11/2020,7/11/2020,Alan Safran,Imported from Bank of America Visa-Background checks for fellows,D102,HJ,4.89,,1384.61
6830,7/11/2020,7/11/2020,Alan Safran,Imported from Bank of America Visa-Background checks for fellows,D102,HJ,6.2,,1390.81
6830,7/11/2020,7/11/2020,Alan Safran,Imported from Bank of America Visa-Background checks for fellows,D102,HJ,6.2,,1397.01
6830,7/11/2020,7/11/2020,Alan Safran,Imported from Bank of America Visa-Background checks for fellows,D102,HJ,6.21,,1403.22
6830,7/11/2020,7/11/2020,Alan Safran,Imported from Bank of America Visa-Background checks for fellows,D102,HJ,6.21,,1409.43
6830,7/11/2020,7/11/2020,Alan Safran,Imported from Bank of America Visa-Background checks for fellows,D102,HJ,15.81,,1425.24
6830,7/11/2020,7/11/2020,Alan Safran,Imported from Bank of America Visa-Background checks for fellows,D102,HJ,15.81,,1441.05
6830,7/11/2020,7/11/2020,Alan Safran,Imported from Bank of America Visa-Background checks for fellows,D102,HJ,15.81,,1456.86
6830,7/11/2020,7/11/2020,Alan Safran,Imported from Bank of America Visa-Background checks for fellows,D102,HJ,20.07,,1476.93
6830,7/11/2020,7/11/2020,Alan Safran,Imported from Bank of America Visa-Background checks for fellows,D102,HJ,20.07,,1497
6830,7/13/2020,7/13/2020,Alan Safran,Imported from Bank of America Visa-Background checks for fellows,D102,HJ,4.02,,1501.02
6830,7/13/2020,7/13/2020,Alan Safran,Imported from Bank of America Visa-Background checks for fellows,D102,HJ,6.2,,1507.22
6830,7/13/2020,7/13/2020,Alan Safran,Imported from Bank of America Visa-Background checks for fellows,D102,HJ,6.21,,1513.43
6830,7/13/2020,7/13/2020,Alan Safran,Imported from Bank of America Visa-Background checks for fellows,D102,HJ,14.85,,1528.28
6830,7/13/2020,7/13/2020,Alan Safran,Imported from Bank of America Visa-Background checks for fellows,D102,HJ,20.07,,1548.35
6830,7/13/2020,7/13/2020,Alan Safran,Imported from Bank of America Visa-Background checks for fellows,D102,HJ,22.95,,1571.3
6830,7/13/2020,7/13/2020,Alan Safran,Imported from Bank of America Visa-Background checks for fellows,D102,HJ,22.95,,1594.25
6830,7/13/2020,7/13/2020,Alan Safran,Imported from Bank of America Visa-Background checks for fellows,D102,HJ,74.25,,1668.5
6830,7/14/2020,7/14/2020,Alan Safran,Imported from Bank of America Visa-Background checks for fellows,D102,HJ,3.16,,1671.66
6830,7/14/2020,7/14/2020,Alan Safran,Imported from Bank of America Visa-Background checks for fellows,D102,HJ,3.16,,1674.82
6830,7/14/2020,7/14/2020,Alan Safran,Imported from Bank of America Visa-Background checks for fellows,D102,HJ,3.16,,1677.98
6830,7/14/2020,7/14/2020,Alan Safran,Imported from Bank of America Visa-Background checks for fellows,D102,HJ,3.16,,1681.14
6830,7/14/2020,7/14/2020,Alan Safran,Imported from Bank of America Visa-Background checks for fellows,D102,HJ,3.16,,1684.3
6830,7/14/2020,7/14/2020,Alan Safran,Imported from Bank of America Visa-Background checks for fellows,D102,HJ,3.16,,1687.46
6830,7/14/2020,7/14/2020,Alan Safran,Imported from Bank of America Visa-Background checks for fellows,D102,HJ,3.16,,1690.62
6830,7/14/2020,7/14/2020,Alan Safran,Imported from Bank of America Visa-Background checks for fellows,D102,HJ,4.89,,1695.51
6830,7/14/2020,7/14/2020,Alan Safran,Imported from Bank of America Visa-Background checks for fellows,D102,HJ,4.89,,1700.4
6830,7/14/2020,7/14/2020,Alan Safran,Imported from Bank of America Visa-Background checks for fellows,D102,HJ,4.89,,1705.29
6830,7/14/2020,7/14/2020,Alan Safran,Imported from Bank of America Visa-Background checks for fellows,D102,HJ,4.89,,1710.18
6830,7/14/2020,7/14/2020,Alan Safran,Imported from Bank of America Visa-Background checks for fellows,D102,HJ,4.89,,1715.07
6830,7/14/2020,7/14/2020,Alan Safran,Imported from Bank of America Visa-Background checks for fellows,D102,HJ,4.89,,1719.96
6830,7/14/2020,7/14/2020,Alan Safran,Imported from Bank of America Visa-Background checks for fellows,D102,HJ,4.89,,1724.85
6830,7/14/2020,7/14/2020,Alan Safran,Imported from Bank of America Visa-Background checks for fellows,D102,HJ,4.89,,1729.74
6830,7/14/2020,7/14/2020,Alan Safran,Imported from Bank of America Visa-Background checks for fellows,D102,HJ,4.89,,1734.63
6830,7/14/2020,7/14/2020,Alan Safran,Imported from Bank of America Visa-Background checks for fellows,D102,HJ,4.89,,1739.52
6830,7/14/2020,7/14/2020,Alan Safran,Imported from Bank of America Visa-Background checks for fellows,D102,HJ,4.89,,1744.41
6830,7/14/2020,7/14/2020,Alan Safran,Imported from Bank of America Visa-Background checks for fellows,D102,HJ,4.89,,1749.3
6830,7/14/2020,7/14/2020,Alan Safran,Imported from Bank of America Visa-Background checks for fellows,D102,HJ,4.89,,1754.19
6830,7/14/2020,7/14/2020,Alan Safran,Imported from Bank of America Visa-Background checks for fellows,D102,HJ,4.89,,1759.08
6830,7/14/2020,7/14/2020,Alan Safran,Imported from Bank of America Visa-Background checks for fellows,D102,HJ,6.16,,1765.24
6830,7/14/2020,7/14/2020,Alan Safran,Imported from Bank of America Visa-Background checks for fellows,D102,HJ,7.81,,1773.05
6830,7/14/2020,7/14/2020,Alan Safran,Imported from Bank of America Visa-Background checks for fellows,D102,HJ,8.8,,1781.85
6830,7/14/2020,7/14/2020,Alan Safran,Imported from Bank of America Visa-Background checks for fellows,D102,HJ,9.52,,1791.37
6830,7/14/2020,7/14/2020,Alan Safran,Imported from Bank of America Visa-Background checks for fellows,D102,HJ,9.52,,1800.89
6830,7/14/2020,7/14/2020,Alan Safran,Imported from Bank of America Visa-Background checks for fellows,D102,HJ,12.07,,1812.96
6830,7/14/2020,7/14/2020,Alan Safran,Imported from Bank of America Visa-Background checks for fellows,D102,HJ,12.07,,1825.03
6830,7/14/2020,7/14/2020,Alan Safran,Imported from Bank of America Visa-Background checks for fellows,D102,HJ,13.6,,1838.63
6830,7/14/2020,7/14/2020,Alan Safran,Imported from Bank of America Visa-Background checks for fellows,D102,HJ,13.6,,1852.23
6830,7/14/2020,7/14/2020,Alan Safran,Imported from Bank of America Visa-Background checks for fellows,D102,HJ,15.81,,1868.04
6830,7/14/2020,7/14/2020,Alan Safran,Imported from Bank of America Visa-Background checks for fellows,D102,HJ,15.81,,1883.85
6830,7/14/2020,7/14/2020,Alan Safran,Imported from Bank of America Visa-Background checks for fellows,D102,HJ,15.81,,1899.66
6830,7/14/2020,7/14/2020,Alan Safran,Imported from Bank of America Visa-Background checks for fellows,D102,HJ,15.81,,1915.47
6830,7/14/2020,7/14/2020,Alan Safran,Imported from Bank of America Visa-Background checks for fellows,D102,HJ,15.81,,1931.28
6830,7/14/2020,7/14/2020,Alan Safran,Imported from Bank of America Visa-Background checks for fellows,D102,HJ,15.81,,1947.09
6830,7/14/2020,7/14/2020,Alan Safran,Imported from Bank of America Visa-Background checks for fellows,D102,HJ,15.81,,1962.9
6830,7/14/2020,7/14/2020,Alan Safran,Imported from Bank of America Visa-Background checks for fellows,D102,HJ,30.8,,1993.7
6830,7/14/2020,7/14/2020,Alan Safran,Imported from Bank of America Visa-Background checks for fellows,D102,HJ,39.05,,2032.75
6830,7/14/2020,7/14/2020,Alan Safran,Imported from Bank of America Visa-Background checks for fellows,D102,HJ,44,,2076.75
6830,7/14/2020,7/14/2020,Alan Safran,Imported from Bank of America Visa-FL business expenses,D102,HJ,3.16,,2079.91
6830,7/14/2020,7/14/2020,Alan Safran,Imported from Bank of America Visa-FL business expenses,D102,HJ,4.89,,2084.8
6830,7/14/2020,7/14/2020,Alan Safran,Imported from Bank of America Visa-FL business expenses,D102,HJ,4.89,,2089.69
6830,7/14/2020,7/14/2020,Alan Safran,Imported from Bank of America Visa-FL business expenses,D102,HJ,15.81,,2105.5
6830,7/15/2020,7/15/2020,Alan Safran,Imported from Bank of America Visa-Background checks for fellows,D102,HJ,2.92,,2108.42
6830,7/15/2020,7/15/2020,Alan Safran,Imported from Bank of America Visa-Background checks for fellows,D102,HJ,2.92,,2111.34
6830,7/15/2020,7/15/2020,Alan Safran,Imported from Bank of America Visa-Background checks for fellows,D102,HJ,3.16,,2114.5
6830,7/15/2020,7/15/2020,Alan Safran,Imported from Bank of America Visa-Background checks for fellows,D102,HJ,3.16,,2117.66
6830,7/15/2020,7/15/2020,Alan Safran,Imported from Bank of America Visa-Background checks for fellows,D102,HJ,3.16,,2120.82
6830,7/15/2020,7/15/2020,Alan Safran,Imported from Bank of America Visa-Background checks for fellows,D102,HJ,3.16,,2123.98
6830,7/15/2020,7/15/2020,Alan Safran,Imported from Bank of America Visa-Background checks for fellows,D102,HJ,4.02,,2128
6830,7/15/2020,7/15/2020,Alan Safran,Imported from Bank of America Visa-Background checks for fellows,D102,HJ,4.02,,2132.02
6830,7/15/2020,7/15/2020,Alan Safran,Imported from Bank of America Visa-Background checks for fellows,D102,HJ,4.02,,2136.04
6830,7/15/2020,7/15/2020,Alan Safran,Imported from Bank of America Visa-Background checks for fellows,D102,HJ,4.5,,2140.54
6830,7/15/2020,7/15/2020,Alan Safran,Imported from Bank of America Visa-Background checks for fellows,D102,HJ,4.5,,2145.04
6830,7/15/2020,7/15/2020,Alan Safran,Imported from Bank of America Visa-Background checks for fellows,D102,HJ,4.51,,2149.55
6830,7/15/2020,7/15/2020,Alan Safran,Imported from Bank of America Visa-Background checks for fellows,D102,HJ,4.51,,2154.06
6830,7/15/2020,7/15/2020,Alan Safran,Imported from Bank of America Visa-Background checks for fellows,D102,HJ,4.89,,2158.95
6830,7/15/2020,7/15/2020,Alan Safran,Imported from Bank of America Visa-Background checks for fellows,D102,HJ,4.89,,2163.84
6830,7/15/2020,7/15/2020,Alan Safran,Imported from Bank of America Visa-Background checks for fellows,D102,HJ,4.89,,2168.73
6830,7/15/2020,7/15/2020,Alan Safran,Imported from Bank of America Visa-Background checks for fellows,D102,HJ,4.89,,2173.62
6830,7/15/2020,7/15/2020,Alan Safran,Imported from Bank of America Visa-Background checks for fellows,D102,HJ,4.89,,2178.51
6830,7/15/2020,7/15/2020,Alan Safran,Imported from Bank of America Visa-Background checks for fellows,D102,HJ,4.89,,2183.4
6830,7/15/2020,7/15/2020,Alan Safran,Imported from Bank of America Visa-Background checks for fellows,D102,HJ,4.89,,2188.29
6830,7/15/2020,7/15/2020,Alan Safran,Imported from Bank of America Visa-Background checks for fellows,D102,HJ,4.89,,2193.18
6830,7/15/2020,7/15/2020,Alan Safran,Imported from Bank of America Visa-Background checks for fellows,D102,HJ,6.2,,2199.38
6830,7/15/2020,7/15/2020,Alan Safran,Imported from Bank of America Visa-Background checks for fellows,D102,HJ,6.2,,2205.58
6830,7/15/2020,7/15/2020,Alan Safran,Imported from Bank of America Visa-Background checks for fellows,D102,HJ,6.2,,2211.78
6830,7/15/2020,7/15/2020,Alan Safran,Imported from Bank of America Visa-Background checks for fellows,D102,HJ,6.21,,2217.99
6830,7/15/2020,7/15/2020,Alan Safran,Imported from Bank of America Visa-Background checks for fellows,D102,HJ,6.21,,2224.2
6830,7/15/2020,7/15/2020,Alan Safran,Imported from Bank of America Visa-Background checks for fellows,D102,HJ,6.21,,2230.41
6830,7/15/2020,7/15/2020,Alan Safran,Imported from Bank of America Visa-Background checks for fellows,D102,HJ,14.57,,2244.98
6830,7/15/2020,7/15/2020,Alan Safran,Imported from Bank of America Visa-Background checks for fellows,D102,HJ,14.57,,2259.55
6830,7/15/2020,7/15/2020,Alan Safran,Imported from Bank of America Visa-Background checks for fellows,D102,HJ,15.81,,2275.36
6830,7/15/2020,7/15/2020,Alan Safran,Imported from Bank of America Visa-Background checks for fellows,D102,HJ,15.81,,2291.17
6830,7/15/2020,7/15/2020,Alan Safran,Imported from Bank of America Visa-Background checks for fellows,D102,HJ,15.81,,2306.98
6830,7/15/2020,7/15/2020,Alan Safran,Imported from Bank of America Visa-Background checks for fellows,D102,HJ,15.81,,2322.79
6830,7/15/2020,7/15/2020,Alan Safran,Imported from Bank of America Visa-Background checks for fellows,D102,HJ,20.07,,2342.86
6830,7/15/2020,7/15/2020,Alan Safran,Imported from Bank of America Visa-Background checks for fellows,D102,HJ,20.07,,2362.93
6830,7/15/2020,7/15/2020,Alan Safran,Imported from Bank of America Visa-Background checks for fellows,D102,HJ,20.07,,2383
6830,7/16/2020,7/16/2020,Alan Safran,Imported from Bank of America Visa-Background checks for fellows,D102,HJ,4.02,,2387.02
6830,7/16/2020,7/16/2020,Alan Safran,Imported from Bank of America Visa-Background checks for fellows,D102,HJ,4.02,,2391.04
6830,7/16/2020,7/16/2020,Alan Safran,Imported from Bank of America Visa-Background checks for fellows,D102,HJ,4.02,,2395.06
6830,7/16/2020,7/16/2020,Alan Safran,Imported from Bank of America Visa-Background checks for fellows,D102,HJ,4.02,,2399.08
6830,7/16/2020,7/16/2020,Alan Safran,Imported from Bank of America Visa-Background checks for fellows,D102,HJ,6.16,,2405.24
6830,7/16/2020,7/16/2020,Alan Safran,Imported from Bank of America Visa-Background checks for fellows,D102,HJ,6.2,,2411.44
6830,7/16/2020,7/16/2020,Alan Safran,Imported from Bank of America Visa-Background checks for fellows,D102,HJ,6.2,,2417.64
6830,7/16/2020,7/16/2020,Alan Safran,Imported from Bank of America Visa-Background checks for fellows,D102,HJ,6.2,,2423.84
6830,7/16/2020,7/16/2020,Alan Safran,Imported from Bank of America Visa-Background checks for fellows,D102,HJ,6.2,,2430.04
6830,7/16/2020,7/16/2020,Alan Safran,Imported from Bank of America Visa-Background checks for fellows,D102,HJ,6.21,,2436.25
6830,7/16/2020,7/16/2020,Alan Safran,Imported from Bank of America Visa-Background checks for fellows,D102,HJ,6.21,,2442.46
6830,7/16/2020,7/16/2020,Alan Safran,Imported from Bank of America Visa-Background checks for fellows,D102,HJ,6.21,,2448.67
6830,7/16/2020,7/16/2020,Alan Safran,Imported from Bank of America Visa-Background checks for fellows,D102,HJ,6.21,,2454.88
6830,7/16/2020,7/16/2020,Alan Safran,Imported from Bank of America Visa-Background checks for fellows,D102,HJ,9.52,,2464.4
6830,7/16/2020,7/16/2020,Alan Safran,Imported from Bank of America Visa-Background checks for fellows,D102,HJ,9.52,,2473.92
6830,7/16/2020,7/16/2020,Alan Safran,Imported from Bank of America Visa-Background checks for fellows,D102,HJ,13.48,,2487.4
6830,7/16/2020,7/16/2020,Alan Safran,Imported from Bank of America Visa-Background checks for fellows,D102,HJ,20.07,,2507.47
6830,7/16/2020,7/16/2020,Alan Safran,Imported from Bank of America Visa-Background checks for fellows,D102,HJ,20.07,,2527.54
6830,7/16/2020,7/16/2020,Alan Safran,Imported from Bank of America Visa-Background checks for fellows,D102,HJ,20.07,,2547.61
6830,7/16/2020,7/16/2020,Alan Safran,Imported from Bank of America Visa-Background checks for fellows,D102,HJ,20.07,,2567.68
6830,7/16/2020,7/16/2020,Alan Safran,Imported from Bank of America Visa-Background checks for fellows,D102,HJ,20.82,,2588.5
6830,7/16/2020,7/16/2020,Alan Safran,Imported from Bank of America Visa-Background checks for fellows,D102,HJ,20.83,,2609.33
6830,7/16/2020,7/16/2020,Alan Safran,Imported from Bank of America Visa-Background checks for fellows,D102,HJ,30.8,,2640.13
6830,7/16/2020,7/16/2020,Alan Safran,Imported from Bank of America Visa-Background checks for fellows,D102,HJ,67.37,,2707.5
6830,7/17/2020,7/17/2020,Alan Safran,Imported from Bank of America Visa-Background checks for fellows,D102,HJ,5.56,,2713.06
6830,7/17/2020,7/17/2020,Alan Safran,Imported from Bank of America Visa-Background checks for fellows,D102,HJ,8.58,,2721.64
6830,7/17/2020,7/17/2020,Alan Safran,Imported from Bank of America Visa-Background checks for fellows,D102,HJ,8.59,,2730.23
6830,7/17/2020,7/17/2020,Alan Safran,Imported from Bank of America Visa-Background checks for fellows,D102,HJ,27.77,,2758
6830,7/18/2020,7/18/2020,Alan Safran,Imported from Bank of America Visa-Background checks for fellows,D102,HJ,2.92,,2760.92
6830,7/18/2020,7/18/2020,Alan Safran,Imported from Bank of America Visa-Background checks for fellows,D102,HJ,3.16,,2764.08
6830,7/18/2020,7/18/2020,Alan Safran,Imported from Bank of America Visa-Background checks for fellows,D102,HJ,3.16,,2767.24
6830,7/18/2020,7/18/2020,Alan Safran,Imported from Bank of America Visa-Background checks for fellows,D102,HJ,4.5,,2771.74
6830,7/18/2020,7/18/2020,Alan Safran,Imported from Bank of America Visa-Background checks for fellows,D102,HJ,4.51,,2776.25
6830,7/18/2020,7/18/2020,Alan Safran,Imported from Bank of America Visa-Background checks for fellows,D102,HJ,4.89,,2781.14
6830,7/18/2020,7/18/2020,Alan Safran,Imported from Bank of America Visa-Background checks for fellows,D102,HJ,4.89,,2786.03
6830,7/18/2020,7/18/2020,Alan Safran,Imported from Bank of America Visa-Background checks for fellows,D102,HJ,4.89,,2790.92
6830,7/18/2020,7/18/2020,Alan Safran,Imported from Bank of America Visa-Background checks for fellows,D102,HJ,4.89,,2795.81
6830,7/18/2020,7/18/2020,Alan Safran,Imported from Bank of America Visa-Background checks for fellows,D102,HJ,13.48,,2809.29
6830,7/18/2020,7/18/2020,Alan Safran,Imported from Bank of America Visa-Background checks for fellows,D102,HJ,14.57,,2823.86
6830,7/18/2020,7/18/2020,Alan Safran,Imported from Bank of America Visa-Background checks for fellows,D102,HJ,15.81,,2839.67
6830,7/18/2020,7/18/2020,Alan Safran,Imported from Bank of America Visa-Background checks for fellows,D102,HJ,15.81,,2855.48
6830,7/18/2020,7/18/2020,Alan Safran,Imported from Bank of America Visa-Background checks for fellows,D102,HJ,20.82,,2876.3
6830,7/18/2020,7/18/2020,Alan Safran,Imported from Bank of America Visa-Background checks for fellows,D102,HJ,20.83,,2897.13
6830,7/18/2020,7/18/2020,Alan Safran,Imported from Bank of America Visa-Background checks for fellows,D102,HJ,67.37,,2964.5
6830,7/19/2020,7/19/2020,Alan Safran,Imported from Bank of America Visa-Background checks for fellows,D102,HJ,3.16,,2967.66
6830,7/19/2020,7/19/2020,Alan Safran,Imported from Bank of America Visa-Background checks for fellows,D102,HJ,3.16,,2970.82
6830,7/19/2020,7/19/2020,Alan Safran,Imported from Bank of America Visa-Background checks for fellows,D102,HJ,4.89,,2975.71
6830,7/19/2020,7/19/2020,Alan Safran,Imported from Bank of America Visa-Background checks for fellows,D102,HJ,4.89,,2980.6
6830,7/19/2020,7/19/2020,Alan Safran,Imported from Bank of America Visa-Background checks for fellows,D102,HJ,4.89,,2985.49
6830,7/19/2020,7/19/2020,Alan Safran,Imported from Bank of America Visa-Background checks for fellows,D102,HJ,4.89,,2990.38
6830,7/19/2020,7/19/2020,Alan Safran,Imported from Bank of America Visa-Background checks for fellows,D102,HJ,15.81,,3006.19
6830,7/19/2020,7/19/2020,Alan Safran,Imported from Bank of America Visa-Background checks for fellows,D102,HJ,15.81,,3022
6830,7/20/2020,7/20/2020,Alan Safran,Imported from Bank of America Visa-Background checks for fellows,D102,HJ,3.16,,3025.16
6830,7/20/2020,7/20/2020,Alan Safran,Imported from Bank of America Visa-Background checks for fellows,D102,HJ,3.16,,3028.32
6830,7/20/2020,7/20/2020,Alan Safran,Imported from Bank of America Visa-Background checks for fellows,D102,HJ,4.89,,3033.21
6830,7/20/2020,7/20/2020,Alan Safran,Imported from Bank of America Visa-Background checks for fellows,D102,HJ,4.89,,3038.1
6830,7/20/2020,7/20/2020,Alan Safran,Imported from Bank of America Visa-Background checks for fellows,D102,HJ,4.89,,3042.99
6830,7/20/2020,7/20/2020,Alan Safran,Imported from Bank of America Visa-Background checks for fellows,D102,HJ,4.89,,3047.88
6830,7/20/2020,7/20/2020,Alan Safran,Imported from Bank of America Visa-Background checks for fellows,D102,HJ,9.13,,3057.01
6830,7/20/2020,7/20/2020,Alan Safran,Imported from Bank of America Visa-Background checks for fellows,D102,HJ,14.11,,3071.12
6830,7/20/2020,7/20/2020,Alan Safran,Imported from Bank of America Visa-Background checks for fellows,D102,HJ,14.11,,3085.23
6830,7/20/2020,7/20/2020,Alan Safran,Imported from Bank of America Visa-Background checks for fellows,D102,HJ,15.81,,3101.04
6830,7/20/2020,7/20/2020,Alan Safran,Imported from Bank of America Visa-Background checks for fellows,D102,HJ,15.81,,3116.85
6830,7/20/2020,7/20/2020,Alan Safran,Imported from Bank of America Visa-Background checks for fellows,D102,HJ,45.65,,3162.5
6830,7/21/2020,7/21/2020,Alan Safran,Imported from Bank of America Visa-Background checks for fellows,D102,HJ,2.92,,3165.42
6830,7/21/2020,7/21/2020,Alan Safran,Imported from Bank of America Visa-Background checks for fellows,D102,HJ,3.16,,3168.58
6830,7/21/2020,7/21/2020,Alan Safran,Imported from Bank of America Visa-Background checks for fellows,D102,HJ,3.16,,3171.74
6830,7/21/2020,7/21/2020,Alan Safran,Imported from Bank of America Visa-Background checks for fellows,D102,HJ,4.02,,3175.76
6830,7/21/2020,7/21/2020,Alan Safran,Imported from Bank of America Visa-Background checks for fellows,D102,HJ,4.02,,3179.78
6830,7/21/2020,7/21/2020,Alan Safran,Imported from Bank of America Visa-Background checks for fellows,D102,HJ,4.02,,3183.8
6830,7/21/2020,7/21/2020,Alan Safran,Imported from Bank of America Visa-Background checks for fellows,D102,HJ,4.5,,3188.3
6830,7/21/2020,7/21/2020,Alan Safran,Imported from Bank of America Visa-Background checks for fellows,D102,HJ,4.51,,3192.81
6830,7/21/2020,7/21/2020,Alan Safran,Imported from Bank of America Visa-Background checks for fellows,D102,HJ,4.89,,3197.7
6830,7/21/2020,7/21/2020,Alan Safran,Imported from Bank of America Visa-Background checks for fellows,D102,HJ,4.89,,3202.59
6830,7/21/2020,7/21/2020,Alan Safran,Imported from Bank of America Visa-Background checks for fellows,D102,HJ,4.89,,3207.48
6830,7/21/2020,7/21/2020,Alan Safran,Imported from Bank of America Visa-Background checks for fellows,D102,HJ,4.89,,3212.37
6830,7/21/2020,7/21/2020,Alan Safran,Imported from Bank of America Visa-Background checks for fellows,D102,HJ,6.2,,3218.57
6830,7/21/2020,7/21/2020,Alan Safran,Imported from Bank of America Visa-Background checks for fellows,D102,HJ,6.2,,3224.77
6830,7/21/2020,7/21/2020,Alan Safran,Imported from Bank of America Visa-Background checks for fellows,D102,HJ,6.2,,3230.97
6830,7/21/2020,7/21/2020,Alan Safran,Imported from Bank of America Visa-Background checks for fellows,D102,HJ,6.21,,3237.18
6830,7/21/2020,7/21/2020,Alan Safran,Imported from Bank of America Visa-Background checks for fellows,D102,HJ,6.21,,3243.39
6830,7/21/2020,7/21/2020,Alan Safran,Imported from Bank of America Visa-Background checks for fellows,D102,HJ,6.21,,3249.6
6830,7/21/2020,7/21/2020,Alan Safran,Imported from Bank of America Visa-Background checks for fellows,D102,HJ,13.48,,3263.08
6830,7/21/2020,7/21/2020,Alan Safran,Imported from Bank of America Visa-Background checks for fellows,D102,HJ,14.57,,3277.65
6830,7/21/2020,7/21/2020,Alan Safran,Imported from Bank of America Visa-Background checks for fellows,D102,HJ,15.81,,3293.46
6830,7/21/2020,7/21/2020,Alan Safran,Imported from Bank of America Visa-Background checks for fellows,D102,HJ,15.81,,3309.27
6830,7/21/2020,7/21/2020,Alan Safran,Imported from Bank of America Visa-Background checks for fellows,D102,HJ,20.07,,3329.34
6830,7/21/2020,7/21/2020,Alan Safran,Imported from Bank of America Visa-Background checks for fellows,D102,HJ,20.07,,3349.41
6830,7/21/2020,7/21/2020,Alan Safran,Imported from Bank of America Visa-Background checks for fellows,D102,HJ,20.07,,3369.48
6830,7/21/2020,7/21/2020,Alan Safran,Imported from Bank of America Visa-Background checks for fellows,D102,HJ,20.82,,3390.3
6830,7/21/2020,7/21/2020,Alan Safran,Imported from Bank of America Visa-Background checks for fellows,D102,HJ,20.83,,3411.13
6830,7/21/2020,7/21/2020,Alan Safran,Imported from Bank of America Visa-Background checks for fellows,D102,HJ,67.37,,3478.5
6830,7/22/2020,7/22/2020,Alan Safran,Imported from Bank of America Visa-Background checks for fellows,D102,HJ,3.16,,3481.66
6830,7/22/2020,7/22/2020,Alan Safran,Imported from Bank of America Visa-Background checks for fellows,D102,HJ,3.16,,3484.82
6830,7/22/2020,7/22/2020,Alan Safran,Imported from Bank of America Visa-Background checks for fellows,D102,HJ,3.16,,3487.98
6830,7/22/2020,7/22/2020,Alan Safran,Imported from Bank of America Visa-Background checks for fellows,D102,HJ,4.02,,3492
6830,7/22/2020,7/22/2020,Alan Safran,Imported from Bank of America Visa-Background checks for fellows,D102,HJ,4.89,,3496.89
6830,7/22/2020,7/22/2020,Alan Safran,Imported from Bank of America Visa-Background checks for fellows,D102,HJ,4.89,,3501.78
6830,7/22/2020,7/22/2020,Alan Safran,Imported from Bank of America Visa-Background checks for fellows,D102,HJ,4.89,,3506.67
6830,7/22/2020,7/22/2020,Alan Safran,Imported from Bank of America Visa-Background checks for fellows,D102,HJ,4.89,,3511.56
6830,7/22/2020,7/22/2020,Alan Safran,Imported from Bank of America Visa-Background checks for fellows,D102,HJ,4.89,,3516.45
6830,7/22/2020,7/22/2020,Alan Safran,Imported from Bank of America Visa-Background checks for fellows,D102,HJ,4.89,,3521.34
6830,7/22/2020,7/22/2020,Alan Safran,Imported from Bank of America Visa-Background checks for fellows,D102,HJ,5.56,,3526.9
6830,7/22/2020,7/22/2020,Alan Safran,Imported from Bank of America Visa-Background checks for fellows,D102,HJ,5.56,,3532.46
6830,7/22/2020,7/22/2020,Alan Safran,Imported from Bank of America Visa-Background checks for fellows,D102,HJ,5.56,,3538.02
6830,7/22/2020,7/22/2020,Alan Safran,Imported from Bank of America Visa-Background checks for fellows,D102,HJ,6.16,,3544.18
6830,7/22/2020,7/22/2020,Alan Safran,Imported from Bank of America Visa-Background checks for fellows,D102,HJ,6.2,,3550.38
6830,7/22/2020,7/22/2020,Alan Safran,Imported from Bank of America Visa-Background checks for fellows,D102,HJ,6.21,,3556.59
6830,7/22/2020,7/22/2020,Alan Safran,Imported from Bank of America Visa-Background checks for fellows,D102,HJ,8.58,,3565.17
6830,7/22/2020,7/22/2020,Alan Safran,Imported from Bank of America Visa-Background checks for fellows,D102,HJ,8.58,,3573.75
6830,7/22/2020,7/22/2020,Alan Safran,Imported from Bank of America Visa-Background checks for fellows,D102,HJ,8.58,,3582.33
6830,7/22/2020,7/22/2020,Alan Safran,Imported from Bank of America Visa-Background checks for fellows,D102,HJ,8.59,,3590.92
6830,7/22/2020,7/22/2020,Alan Safran,Imported from Bank of America Visa-Background checks for fellows,D102,HJ,8.59,,3599.51
6830,7/22/2020,7/22/2020,Alan Safran,Imported from Bank of America Visa-Background checks for fellows,D102,HJ,8.59,,3608.1
6830,7/22/2020,7/22/2020,Alan Safran,Imported from Bank of America Visa-Background checks for fellows,D102,HJ,9.52,,3617.62
6830,7/22/2020,7/22/2020,Alan Safran,Imported from Bank of America Visa-Background checks for fellows,D102,HJ,9.52,,3627.14
6830,7/22/2020,7/22/2020,Alan Safran,Imported from Bank of America Visa-Background checks for fellows,D102,HJ,15.81,,3642.95
6830,7/22/2020,7/22/2020,Alan Safran,Imported from Bank of America Visa-Background checks for fellows,D102,HJ,15.81,,3658.76
6830,7/22/2020,7/22/2020,Alan Safran,Imported from Bank of America Visa-Background checks for fellows,D102,HJ,15.81,,3674.57
6830,7/22/2020,7/22/2020,Alan Safran,Imported from Bank of America Visa-Background checks for fellows,D102,HJ,16.72,,3691.29
6830,7/22/2020,7/22/2020,Alan Safran,Imported from Bank of America Visa-Background checks for fellows,D102,HJ,20.07,,3711.36
6830,7/22/2020,7/22/2020,Alan Safran,Imported from Bank of America Visa-Background checks for fellows,D102,HJ,25.84,,3737.2
6830,7/22/2020,7/22/2020,Alan Safran,Imported from Bank of America Visa-Background checks for fellows,D102,HJ,25.84,,3763.04
6830,7/22/2020,7/22/2020,Alan Safran,Imported from Bank of America Visa-Background checks for fellows,D102,HJ,27.77,,3790.81
6830,7/22/2020,7/22/2020,Alan Safran,Imported from Bank of America Visa-Background checks for fellows,D102,HJ,27.77,,3818.58
6830,7/22/2020,7/22/2020,Alan Safran,Imported from Bank of America Visa-Background checks for fellows,D102,HJ,27.77,,3846.35
6830,7/22/2020,7/22/2020,Alan Safran,Imported from Bank of America Visa-Background checks for fellows,D102,HJ,30.8,,3877.15
6830,7/22/2020,7/22/2020,Alan Safran,Imported from Bank of America Visa-Background checks for fellows,D102,HJ,83.6,,3960.75
6830,7/23/2020,7/23/2020,Alan Safran,Imported from Bank of America Visa-Background checks for fellows,D102,HJ,3.16,,3963.91
6830,7/23/2020,7/23/2020,Alan Safran,Imported from Bank of America Visa-Background checks for fellows,D102,HJ,3.16,,3967.07
6830,7/23/2020,7/23/2020,Alan Safran,Imported from Bank of America Visa-Background checks for fellows,D102,HJ,4.89,,3971.96
6830,7/23/2020,7/23/2020,Alan Safran,Imported from Bank of America Visa-Background checks for fellows,D102,HJ,4.89,,3976.85
6830,7/23/2020,7/23/2020,Alan Safran,Imported from Bank of America Visa-Background checks for fellows,D102,HJ,4.89,,3981.74
6830,7/23/2020,7/23/2020,Alan Safran,Imported from Bank of America Visa-Background checks for fellows,D102,HJ,4.89,,3986.63
6830,7/23/2020,7/23/2020,Alan Safran,Imported from Bank of America Visa-Background checks for fellows,D102,HJ,5.56,,3992.19
6830,7/23/2020,7/23/2020,Alan Safran,Imported from Bank of America Visa-Background checks for fellows,D102,HJ,5.56,,3997.75
6830,7/23/2020,7/23/2020,Alan Safran,Imported from Bank of America Visa-Background checks for fellows,D102,HJ,8.58,,4006.33
6830,7/23/2020,7/23/2020,Alan Safran,Imported from Bank of America Visa-Background checks for fellows,D102,HJ,8.58,,4014.91
6830,7/23/2020,7/23/2020,Alan Safran,Imported from Bank of America Visa-Background checks for fellows,D102,HJ,8.59,,4023.5
6830,7/23/2020,7/23/2020,Alan Safran,Imported from Bank of America Visa-Background checks for fellows,D102,HJ,8.59,,4032.09
6830,7/23/2020,7/23/2020,Alan Safran,Imported from Bank of America Visa-Background checks for fellows,D102,HJ,13.48,,4045.57
6830,7/23/2020,7/23/2020,Alan Safran,Imported from Bank of America Visa-Background checks for fellows,D102,HJ,13.48,,4059.05
6830,7/23/2020,7/23/2020,Alan Safran,Imported from Bank of America Visa-Background checks for fellows,D102,HJ,15.81,,4074.86
6830,7/23/2020,7/23/2020,Alan Safran,Imported from Bank of America Visa-Background checks for fellows,D102,HJ,15.81,,4090.67
6830,7/23/2020,7/23/2020,Alan Safran,Imported from Bank of America Visa-Background checks for fellows,D102,HJ,20.82,,4111.49
6830,7/23/2020,7/23/2020,Alan Safran,Imported from Bank of America Visa-Background checks for fellows,D102,HJ,20.82,,4132.31
6830,7/23/2020,7/23/2020,Alan Safran,Imported from Bank of America Visa-Background checks for fellows,D102,HJ,20.83,,4153.14
6830,7/23/2020,7/23/2020,Alan Safran,Imported from Bank of America Visa-Background checks for fellows,D102,HJ,20.83,,4173.97
6830,7/23/2020,7/23/2020,Alan Safran,Imported from Bank of America Visa-Background checks for fellows,D102,HJ,27.77,,4201.74
6830,7/23/2020,7/23/2020,Alan Safran,Imported from Bank of America Visa-Background checks for fellows,D102,HJ,27.77,,4229.51
6830,7/23/2020,7/23/2020,Alan Safran,Imported from Bank of America Visa-Background checks for fellows,D102,HJ,67.37,,4296.88
6830,7/23/2020,7/23/2020,Alan Safran,Imported from Bank of America Visa-Background checks for fellows,D102,HJ,67.37,,4364.25
6830,7/24/2020,7/24/2020,Alan Safran,Imported from Bank of America Visa-Background checks for fellows,D102,HJ,3.16,,4367.41
6830,7/24/2020,7/24/2020,Alan Safran,Imported from Bank of America Visa-Background checks for fellows,D102,HJ,4.89,,4372.3
6830,7/24/2020,7/24/2020,Alan Safran,Imported from Bank of America Visa-Background checks for fellows,D102,HJ,4.89,,4377.19
6830,7/24/2020,7/24/2020,Alan Safran,Imported from Bank of America Visa-Background checks for fellows,D102,HJ,15.81,,4393
6830,7/26/2020,7/26/2020,Alan Safran,Imported from Bank of America Visa-Background checks for fellows,D102,HJ,3.16,,4396.16
6830,7/26/2020,7/26/2020,Alan Safran,Imported from Bank of America Visa-Background checks for fellows,D102,HJ,4.89,,4401.05
6830,7/26/2020,7/26/2020,Alan Safran,Imported from Bank of America Visa-Background checks for fellows,D102,HJ,4.89,,4405.94
6830,7/26/2020,7/26/2020,Alan Safran,Imported from Bank of America Visa-Background checks for fellows,D102,HJ,15.81,,4421.75
6830,7/27/2020,7/27/2020,Alan Safran,Imported from Bank of America Visa-Background checks for fellows,D102,HJ,3.16,,4424.91
6830,7/27/2020,7/27/2020,Alan Safran,Imported from Bank of America Visa-Background checks for fellows,D102,HJ,4.02,,4428.93
6830,7/27/2020,7/27/2020,Alan Safran,Imported from Bank of America Visa-Background checks for fellows,D102,HJ,4.02,,4432.95
6830,7/27/2020,7/27/2020,Alan Safran,Imported from Bank of America Visa-Background checks for fellows,D102,HJ,4.02,,4436.97
6830,7/27/2020,7/27/2020,Alan Safran,Imported from Bank of America Visa-Background checks for fellows,D102,HJ,4.02,,4440.99
6830,7/27/2020,7/27/2020,Alan Safran,Imported from Bank of America Visa-Background checks for fellows,D102,HJ,4.02,,4445.01
6830,7/27/2020,7/27/2020,Alan Safran,Imported from Bank of America Visa-Background checks for fellows,D102,HJ,4.02,,4449.03
6830,7/27/2020,7/27/2020,Alan Safran,Imported from Bank of America Visa-Background checks for fellows,D102,HJ,4.02,,4453.05
6830,7/27/2020,7/27/2020,Alan Safran,Imported from Bank of America Visa-Background checks for fellows,D102,HJ,4.02,,4457.07
6830,7/27/2020,7/27/2020,Alan Safran,Imported from Bank of America Visa-Background checks for fellows,D102,HJ,4.02,,4461.09
6830,7/27/2020,7/27/2020,Alan Safran,Imported from Bank of America Visa-Background checks for fellows,D102,HJ,4.02,,4465.11
6830,7/27/2020,7/27/2020,Alan Safran,Imported from Bank of America Visa-Background checks for fellows,D102,HJ,4.89,,4470
6830,7/27/2020,7/27/2020,Alan Safran,Imported from Bank of America Visa-Background checks for fellows,D102,HJ,4.89,,4474.89
6830,7/27/2020,7/27/2020,Alan Safran,Imported from Bank of America Visa-Background checks for fellows,D102,HJ,5.56,,4480.45
6830,7/27/2020,7/27/2020,Alan Safran,Imported from Bank of America Visa-Background checks for fellows,D102,HJ,6.2,,4486.65
6830,7/27/2020,7/27/2020,Alan Safran,Imported from Bank of America Visa-Background checks for fellows,D102,HJ,6.2,,4492.85
6830,7/27/2020,7/27/2020,Alan Safran,Imported from Bank of America Visa-Background checks for fellows,D102,HJ,6.2,,4499.05
6830,7/27/2020,7/27/2020,Alan Safran,Imported from Bank of America Visa-Background checks for fellows,D102,HJ,6.2,,4505.25
6830,7/27/2020,7/27/2020,Alan Safran,Imported from Bank of America Visa-Background checks for fellows,D102,HJ,6.2,,4511.45
6830,7/27/2020,7/27/2020,Alan Safran,Imported from Bank of America Visa-Background checks for fellows,D102,HJ,6.2,,4517.65
6830,7/27/2020,7/27/2020,Alan Safran,Imported from Bank of America Visa-Background checks for fellows,D102,HJ,6.2,,4523.85
6830,7/27/2020,7/27/2020,Alan Safran,Imported from Bank of America Visa-Background checks for fellows,D102,HJ,6.2,,4530.05
6830,7/27/2020,7/27/2020,Alan Safran,Imported from Bank of America Visa-Background checks for fellows,D102,HJ,6.2,,4536.25
6830,7/27/2020,7/27/2020,Alan Safran,Imported from Bank of America Visa-Background checks for fellows,D102,HJ,6.2,,4542.45
6830,7/27/2020,7/27/2020,Alan Safran,Imported from Bank of America Visa-Background checks for fellows,D102,HJ,6.21,,4548.66
6830,7/27/2020,7/27/2020,Alan Safran,Imported from Bank of America Visa-Background checks for fellows,D102,HJ,6.21,,4554.87
6830,7/27/2020,7/27/2020,Alan Safran,Imported from Bank of America Visa-Background checks for fellows,D102,HJ,6.21,,4561.08
6830,7/27/2020,7/27/2020,Alan Safran,Imported from Bank of America Visa-Background checks for fellows,D102,HJ,6.21,,4567.29
6830,7/27/2020,7/27/2020,Alan Safran,Imported from Bank of America Visa-Background checks for fellows,D102,HJ,6.21,,4573.5
6830,7/27/2020,7/27/2020,Alan Safran,Imported from Bank of America Visa-Background checks for fellows,D102,HJ,6.21,,4579.71
6830,7/27/2020,7/27/2020,Alan Safran,Imported from Bank of America Visa-Background checks for fellows,D102,HJ,6.21,,4585.92
6830,7/27/2020,7/27/2020,Alan Safran,Imported from Bank of America Visa-Background checks for fellows,D102,HJ,6.21,,4592.13
6830,7/27/2020,7/27/2020,Alan Safran,Imported from Bank of America Visa-Background checks for fellows,D102,HJ,6.21,,4598.34
6830,7/27/2020,7/27/2020,Alan Safran,Imported from Bank of America Visa-Background checks for fellows,D102,HJ,6.21,,4604.55
6830,7/27/2020,7/27/2020,Alan Safran,Imported from Bank of America Visa-Background checks for fellows,D102,HJ,7.26,,4611.81
6830,7/27/2020,7/27/2020,Alan Safran,Imported from Bank of America Visa-Background checks for fellows,D102,HJ,8.58,,4620.39
6830,7/27/2020,7/27/2020,Alan Safran,Imported from Bank of America Visa-Background checks for fellows,D102,HJ,8.59,,4628.98
6830,7/27/2020,7/27/2020,Alan Safran,Imported from Bank of America Visa-Background checks for fellows,D102,HJ,11.22,,4640.2
6830,7/27/2020,7/27/2020,Alan Safran,Imported from Bank of America Visa-Background checks for fellows,D102,HJ,11.22,,4651.42
6830,7/27/2020,7/27/2020,Alan Safran,Imported from Bank of America Visa-Background checks for fellows,D102,HJ,13.48,,4664.9
6830,7/27/2020,7/27/2020,Alan Safran,Imported from Bank of America Visa-Background checks for fellows,D102,HJ,13.48,,4678.38
6830,7/27/2020,7/27/2020,Alan Safran,Imported from Bank of America Visa-Background checks for fellows,D102,HJ,13.48,,4691.86
6830,7/27/2020,7/27/2020,Alan Safran,Imported from Bank of America Visa-Background checks for fellows,D102,HJ,13.48,,4705.34
6830,7/27/2020,7/27/2020,Alan Safran,Imported from Bank of America Visa-Background checks for fellows,D102,HJ,15.81,,4721.15
6830,7/27/2020,7/27/2020,Alan Safran,Imported from Bank of America Visa-Background checks for fellows,D102,HJ,16.72,,4737.87
6830,7/27/2020,7/27/2020,Alan Safran,Imported from Bank of America Visa-Background checks for fellows,D102,HJ,20.07,,4757.94
6830,7/27/2020,7/27/2020,Alan Safran,Imported from Bank of America Visa-Background checks for fellows,D102,HJ,20.07,,4778.01
6830,7/27/2020,7/27/2020,Alan Safran,Imported from Bank of America Visa-Background checks for fellows,D102,HJ,20.07,,4798.08
6830,7/27/2020,7/27/2020,Alan Safran,Imported from Bank of America Visa-Background checks for fellows,D102,HJ,20.07,,4818.15
6830,7/27/2020,7/27/2020,Alan Safran,Imported from Bank of America Visa-Background checks for fellows,D102,HJ,20.07,,4838.22
6830,7/27/2020,7/27/2020,Alan Safran,Imported from Bank of America Visa-Background checks for fellows,D102,HJ,20.07,,4858.29
6830,7/27/2020,7/27/2020,Alan Safran,Imported from Bank of America Visa-Background checks for fellows,D102,HJ,20.07,,4878.36
6830,7/27/2020,7/27/2020,Alan Safran,Imported from Bank of America Visa-Background checks for fellows,D102,HJ,20.07,,4898.43
6830,7/27/2020,7/27/2020,Alan Safran,Imported from Bank of America Visa-Background checks for fellows,D102,HJ,20.07,,4918.5
6830,7/27/2020,7/27/2020,Alan Safran,Imported from Bank of America Visa-Background checks for fellows,D102,HJ,20.07,,4938.57
6830,7/27/2020,7/27/2020,Alan Safran,Imported from Bank of America Visa-Background checks for fellows,D102,HJ,20.82,,4959.39
6830,7/27/2020,7/27/2020,Alan Safran,Imported from Bank of America Visa-Background checks for fellows,D102,HJ,20.82,,4980.21
6830,7/27/2020,7/27/2020,Alan Safran,Imported from Bank of America Visa-Background checks for fellows,D102,HJ,20.82,,5001.03
6830,7/27/2020,7/27/2020,Alan Safran,Imported from Bank of America Visa-Background checks for fellows,D102,HJ,20.82,,5021.85
6830,7/27/2020,7/27/2020,Alan Safran,Imported from Bank of America Visa-Background checks for fellows,D102,HJ,20.83,,5042.68
6830,7/27/2020,7/27/2020,Alan Safran,Imported from Bank of America Visa-Background checks for fellows,D102,HJ,20.83,,5063.51
6830,7/27/2020,7/27/2020,Alan Safran,Imported from Bank of America Visa-Background checks for fellows,D102,HJ,20.83,,5084.34
6830,7/27/2020,7/27/2020,Alan Safran,Imported from Bank of America Visa-Background checks for fellows,D102,HJ,20.83,,5105.17
6830,7/27/2020,7/27/2020,Alan Safran,Imported from Bank of America Visa-Background checks for fellows,D102,HJ,25.84,,5131.01
6830,7/27/2020,7/27/2020,Alan Safran,Imported from Bank of America Visa-Background checks for fellows,D102,HJ,25.84,,5156.85
6830,7/27/2020,7/27/2020,Alan Safran,Imported from Bank of America Visa-Background checks for fellows,D102,HJ,27.77,,5184.62
6830,7/27/2020,7/27/2020,Alan Safran,Imported from Bank of America Visa-Background checks for fellows,D102,HJ,36.3,,5220.92
6830,7/27/2020,7/27/2020,Alan Safran,Imported from Bank of America Visa-Background checks for fellows,D102,HJ,67.37,,5288.29
6830,7/27/2020,7/27/2020,Alan Safran,Imported from Bank of America Visa-Background checks for fellows,D102,HJ,67.37,,5355.66
6830,7/27/2020,7/27/2020,Alan Safran,Imported from Bank of America Visa-Background checks for fellows,D102,HJ,67.37,,5423.03
6830,7/27/2020,7/27/2020,Alan Safran,Imported from Bank of America Visa-Background checks for fellows,D102,HJ,67.37,,5490.4
6830,7/27/2020,7/27/2020,Alan Safran,Imported from Bank of America Visa-Background checks for fellows,D102,HJ,83.6,,5574
6830,7/28/2020,7/28/2020,Alan Safran,Imported from Bank of America Visa-Background checks for fellows,D102,HJ,3.16,,5577.16
6830,7/28/2020,7/28/2020,Alan Safran,Imported from Bank of America Visa-Background checks for fellows,D102,HJ,4.02,,5581.18
6830,7/28/2020,7/28/2020,Alan Safran,Imported from Bank of America Visa-Background checks for fellows,D102,HJ,4.02,,5585.2
6830,7/28/2020,7/28/2020,Alan Safran,Imported from Bank of America Visa-Background checks for fellows,D102,HJ,4.89,,5590.09
6830,7/28/2020,7/28/2020,Alan Safran,Imported from Bank of America Visa-Background checks for fellows,D102,HJ,4.89,,5594.98
6830,7/28/2020,7/28/2020,Alan Safran,Imported from Bank of America Visa-Background checks for fellows,D102,HJ,5.56,,5600.54
6830,7/28/2020,7/28/2020,Alan Safran,Imported from Bank of America Visa-Background checks for fellows,D102,HJ,5.56,,5606.1
6830,7/28/2020,7/28/2020,Alan Safran,Imported from Bank of America Visa-Background checks for fellows,D102,HJ,6.2,,5612.3
6830,7/28/2020,7/28/2020,Alan Safran,Imported from Bank of America Visa-Background checks for fellows,D102,HJ,6.2,,5618.5
6830,7/28/2020,7/28/2020,Alan Safran,Imported from Bank of America Visa-Background checks for fellows,D102,HJ,6.21,,5624.71
6830,7/28/2020,7/28/2020,Alan Safran,Imported from Bank of America Visa-Background checks for fellows,D102,HJ,6.21,,5630.92
6830,7/28/2020,7/28/2020,Alan Safran,Imported from Bank of America Visa-Background checks for fellows,D102,HJ,8.58,,5639.5
6830,7/28/2020,7/28/2020,Alan Safran,Imported from Bank of America Visa-Background checks for fellows,D102,HJ,8.58,,5648.08
6830,7/28/2020,7/28/2020,Alan Safran,Imported from Bank of America Visa-Background checks for fellows,D102,HJ,8.59,,5656.67
6830,7/28/2020,7/28/2020,Alan Safran,Imported from Bank of America Visa-Background checks for fellows,D102,HJ,8.59,,5665.26
6830,7/28/2020,7/28/2020,Alan Safran,Imported from Bank of America Visa-Background checks for fellows,D102,HJ,13.48,,5678.74
6830,7/28/2020,7/28/2020,Alan Safran,Imported from Bank of America Visa-Background checks for fellows,D102,HJ,15.81,,5694.55
6830,7/28/2020,7/28/2020,Alan Safran,Imported from Bank of America Visa-Background checks for fellows,D102,HJ,20.07,,5714.62
6830,7/28/2020,7/28/2020,Alan Safran,Imported from Bank of America Visa-Background checks for fellows,D102,HJ,20.07,,5734.69
6830,7/28/2020,7/28/2020,Alan Safran,Imported from Bank of America Visa-Background checks for fellows,D102,HJ,20.82,,5755.51
6830,7/28/2020,7/28/2020,Alan Safran,Imported from Bank of America Visa-Background checks for fellows,D102,HJ,20.83,,5776.34
6830,7/28/2020,7/28/2020,Alan Safran,Imported from Bank of America Visa-Background checks for fellows,D102,HJ,27.77,,5804.11
6830,7/28/2020,7/28/2020,Alan Safran,Imported from Bank of America Visa-Background checks for fellows,D102,HJ,27.77,,5831.88
6830,7/28/2020,7/28/2020,Alan Safran,Imported from Bank of America Visa-Background checks for fellows,D102,HJ,67.37,,5899.25
6830,7/29/2020,7/29/2020,Alan Safran,Imported from Bank of America Visa-Background checks for fellows,D102,HJ,4.02,,5903.27
6830,7/29/2020,7/29/2020,Alan Safran,Imported from Bank of America Visa-Background checks for fellows,D102,HJ,6.2,,5909.47
6830,7/29/2020,7/29/2020,Alan Safran,Imported from Bank of America Visa-Background checks for fellows,D102,HJ,6.21,,5915.68
6830,7/29/2020,7/29/2020,Alan Safran,Imported from Bank of America Visa-Background checks for fellows,D102,HJ,20.07,,5935.75
6830,7/30/2020,7/30/2020,Alan Safran,Imported from Bank of America Visa-Background checks for fellows,D102,HJ,3.16,,5938.91
6830,7/30/2020,7/30/2020,Alan Safran,Imported from Bank of America Visa-Background checks for fellows,D102,HJ,3.16,,5942.07
6830,7/30/2020,7/30/2020,Alan Safran,Imported from Bank of America Visa-Background checks for fellows,D102,HJ,4.02,,5946.09
6830,7/30/2020,7/30/2020,Alan Safran,Imported from Bank of America Visa-Background checks for fellows,D102,HJ,4.89,,5950.98
6830,7/30/2020,7/30/2020,Alan Safran,Imported from Bank of America Visa-Background checks for fellows,D102,HJ,4.89,,5955.87
6830,7/30/2020,7/30/2020,Alan Safran,Imported from Bank of America Visa-Background checks for fellows,D102,HJ,4.89,,5960.76
6830,7/30/2020,7/30/2020,Alan Safran,Imported from Bank of America Visa-Background checks for fellows,D102,HJ,4.89,,5965.65
6830,7/30/2020,7/30/2020,Alan Safran,Imported from Bank of America Visa-Background checks for fellows,D102,HJ,5.56,,5971.21
6830,7/30/2020,7/30/2020,Alan Safran,Imported from Bank of America Visa-Background checks for fellows,D102,HJ,6.2,,5977.41
6830,7/30/2020,7/30/2020,Alan Safran,Imported from Bank of America Visa-Background checks for fellows,D102,HJ,6.21,,5983.62
6830,7/30/2020,7/30/2020,Alan Safran,Imported from Bank of America Visa-Background checks for fellows,D102,HJ,8.58,,5992.2
6830,7/30/2020,7/30/2020,Alan Safran,Imported from Bank of America Visa-Background checks for fellows,D102,HJ,8.59,,6000.79
6830,7/30/2020,7/30/2020,Alan Safran,Imported from Bank of America Visa-Background checks for fellows,D102,HJ,15.81,,6016.6
6830,7/30/2020,7/30/2020,Alan Safran,Imported from Bank of America Visa-Background checks for fellows,D102,HJ,15.81,,6032.41
6830,7/30/2020,7/30/2020,Alan Safran,Imported from Bank of America Visa-Background checks for fellows,D102,HJ,20.07,,6052.48
6830,7/30/2020,7/30/2020,Alan Safran,Imported from Bank of America Visa-Background checks for fellows,D102,HJ,27.77,,6080.25
6830,7/31/2020,7/31/2020,Alan Safran,Imported from Bank of America Visa-Background checks for fellows,D102,HJ,3.16,,6083.41
6830,7/31/2020,7/31/2020,Alan Safran,Imported from Bank of America Visa-Background checks for fellows,D102,HJ,3.16,,6086.57
6830,7/31/2020,7/31/2020,Alan Safran,Imported from Bank of America Visa-Background checks for fellows,D102,HJ,4.89,,6091.46
6830,7/31/2020,7/31/2020,Alan Safran,Imported from Bank of America Visa-Background checks for fellows,D102,HJ,4.89,,6096.35
6830,7/31/2020,7/31/2020,Alan Safran,Imported from Bank of America Visa-Background checks for fellows,D102,HJ,4.89,,6101.24
6830,7/31/2020,7/31/2020,Alan Safran,Imported from Bank of America Visa-Background checks for fellows,D102,HJ,4.89,,6106.13
6830,7/31/2020,7/31/2020,Alan Safran,Imported from Bank of America Visa-Background checks for fellows,D102,HJ,15.81,,6121.94
6830,7/31/2020,7/31/2020,Alan Safran,Imported from Bank of America Visa-Background checks for fellows,D102,HJ,15.81,,6137.75
6830,8/1/2020,8/1/2020,Alan Safran,Imported from Bank of America Visa-Background checks for fellows,D102,HJ,3.16,,6140.91
6830,8/1/2020,8/1/2020,Alan Safran,Imported from Bank of America Visa-Background checks for fellows,D102,HJ,3.16,,6144.07
6830,8/1/2020,8/1/2020,Alan Safran,Imported from Bank of America Visa-Background checks for fellows,D102,HJ,3.16,,6147.23
6830,8/1/2020,8/1/2020,Alan Safran,Imported from Bank of America Visa-Background checks for fellows,D102,HJ,4.89,,6152.12
6830,8/1/2020,8/1/2020,Alan Safran,Imported from Bank of America Visa-Background checks for fellows,D102,HJ,4.89,,6157.01
6830,8/1/2020,8/1/2020,Alan Safran,Imported from Bank of America Visa-Background checks for fellows,D102,HJ,4.89,,6161.9
6830,8/1/2020,8/1/2020,Alan Safran,Imported from Bank of America Visa-Background checks for fellows,D102,HJ,4.89,,6166.79
6830,8/1/2020,8/1/2020,Alan Safran,Imported from Bank of America Visa-Background checks for fellows,D102,HJ,4.89,,6171.68
6830,8/1/2020,8/1/2020,Alan Safran,Imported from Bank of America Visa-Background checks for fellows,D102,HJ,4.89,,6176.57
6830,8/1/2020,8/1/2020,Alan Safran,Imported from Bank of America Visa-Background checks for fellows,D102,HJ,5.56,,6182.13
6830,8/1/2020,8/1/2020,Alan Safran,Imported from Bank of America Visa-Background checks for fellows,D102,HJ,8.58,,6190.71
6830,8/1/2020,8/1/2020,Alan Safran,Imported from Bank of America Visa-Background checks for fellows,D102,HJ,8.59,,6199.3
6830,8/1/2020,8/1/2020,Alan Safran,Imported from Bank of America Visa-Background checks for fellows,D102,HJ,13.48,,6212.78
6830,8/1/2020,8/1/2020,Alan Safran,Imported from Bank of America Visa-Background checks for fellows,D102,HJ,15.81,,6228.59
6830,8/1/2020,8/1/2020,Alan Safran,Imported from Bank of America Visa-Background checks for fellows,D102,HJ,15.81,,6244.4
6830,8/1/2020,8/1/2020,Alan Safran,Imported from Bank of America Visa-Background checks for fellows,D102,HJ,15.81,,6260.21
6830,8/1/2020,8/1/2020,Alan Safran,Imported from Bank of America Visa-Background checks for fellows,D102,HJ,20.82,,6281.03
6830,8/1/2020,8/1/2020,Alan Safran,Imported from Bank of America Visa-Background checks for fellows,D102,HJ,20.83,,6301.86
6830,8/1/2020,8/1/2020,Alan Safran,Imported from Bank of America Visa-Background checks for fellows,D102,HJ,27.77,,6329.63
6830,8/1/2020,8/1/2020,Alan Safran,Imported from Bank of America Visa-Background checks for fellows,D102,HJ,67.37,,6397
6830,8/2/2020,8/2/2020,Alan Safran,Imported from Bank of America Visa-Background checks for fellows,D102,HJ,3.16,,6400.16
6830,8/2/2020,8/2/2020,Alan Safran,Imported from Bank of America Visa-Background checks for fellows,D102,HJ,3.16,,6403.32
6830,8/2/2020,8/2/2020,Alan Safran,Imported from Bank of America Visa-Background checks for fellows,D102,HJ,3.16,,6406.48
6830,8/2/2020,8/2/2020,Alan Safran,Imported from Bank of America Visa-Background checks for fellows,D102,HJ,4.02,,6410.5
6830,8/2/2020,8/2/2020,Alan Safran,Imported from Bank of America Visa-Background checks for fellows,D102,HJ,4.89,,6415.39
6830,8/2/2020,8/2/2020,Alan Safran,Imported from Bank of America Visa-Background checks for fellows,D102,HJ,4.89,,6420.28
6830,8/2/2020,8/2/2020,Alan Safran,Imported from Bank of America Visa-Background checks for fellows,D102,HJ,4.89,,6425.17
6830,8/2/2020,8/2/2020,Alan Safran,Imported from Bank of America Visa-Background checks for fellows,D102,HJ,4.89,,6430.06
6830,8/2/2020,8/2/2020,Alan Safran,Imported from Bank of America Visa-Background checks for fellows,D102,HJ,4.89,,6434.95
6830,8/2/2020,8/2/2020,Alan Safran,Imported from Bank of America Visa-Background checks for fellows,D102,HJ,4.89,,6439.84
6830,8/2/2020,8/2/2020,Alan Safran,Imported from Bank of America Visa-Background checks for fellows,D102,HJ,6.2,,6446.04
6830,8/2/2020,8/2/2020,Alan Safran,Imported from Bank of America Visa-Background checks for fellows,D102,HJ,6.21,,6452.25
6830,8/2/2020,8/2/2020,Alan Safran,Imported from Bank of America Visa-Background checks for fellows,D102,HJ,15.81,,6468.06
6830,8/2/2020,8/2/2020,Alan Safran,Imported from Bank of America Visa-Background checks for fellows,D102,HJ,15.81,,6483.87
6830,8/2/2020,8/2/2020,Alan Safran,Imported from Bank of America Visa-Background checks for fellows,D102,HJ,15.81,,6499.68
6830,8/2/2020,8/2/2020,Alan Safran,Imported from Bank of America Visa-Background checks for fellows,D102,HJ,20.07,,6519.75
6830,8/3/2020,8/3/2020,Alan Safran,Imported from Bank of America Visa-Background checks for fellows,D102,HJ,2.92,,6522.67
6830,8/3/2020,8/3/2020,Alan Safran,Imported from Bank of America Visa-Background checks for fellows,D102,HJ,4.02,,6526.69
6830,8/3/2020,8/3/2020,Alan Safran,Imported from Bank of America Visa-Background checks for fellows,D102,HJ,4.02,,6530.71
6830,8/3/2020,8/3/2020,Alan Safran,Imported from Bank of America Visa-Background checks for fellows,D102,HJ,4.02,,6534.73
6830,8/3/2020,8/3/2020,Alan Safran,Imported from Bank of America Visa-Background checks for fellows,D102,HJ,4.02,,6538.75
6830,8/3/2020,8/3/2020,Alan Safran,Imported from Bank of America Visa-Background checks for fellows,D102,HJ,4.02,,6542.77
6830,8/3/2020,8/3/2020,Alan Safran,Imported from Bank of America Visa-Background checks for fellows,D102,HJ,4.5,,6547.27
6830,8/3/2020,8/3/2020,Alan Safran,Imported from Bank of America Visa-Background checks for fellows,D102,HJ,4.51,,6551.78
6830,8/3/2020,8/3/2020,Alan Safran,Imported from Bank of America Visa-Background checks for fellows,D102,HJ,5.56,,6557.34
6830,8/3/2020,8/3/2020,Alan Safran,Imported from Bank of America Visa-Background checks for fellows,D102,HJ,5.56,,6562.9
6830,8/3/2020,8/3/2020,Alan Safran,Imported from Bank of America Visa-Background checks for fellows,D102,HJ,5.56,,6568.46
6830,8/3/2020,8/3/2020,Alan Safran,Imported from Bank of America Visa-Background checks for fellows,D102,HJ,5.56,,6574.02
6830,8/3/2020,8/3/2020,Alan Safran,Imported from Bank of America Visa-Background checks for fellows,D102,HJ,5.56,,6579.58
6830,8/3/2020,8/3/2020,Alan Safran,Imported from Bank of America Visa-Background checks for fellows,D102,HJ,6.2,,6585.78
6830,8/3/2020,8/3/2020,Alan Safran,Imported from Bank of America Visa-Background checks for fellows,D102,HJ,6.2,,6591.98
6830,8/3/2020,8/3/2020,Alan Safran,Imported from Bank of America Visa-Background checks for fellows,D102,HJ,6.2,,6598.18
6830,8/3/2020,8/3/2020,Alan Safran,Imported from Bank of America Visa-Background checks for fellows,D102,HJ,6.2,,6604.38
6830,8/3/2020,8/3/2020,Alan Safran,Imported from Bank of America Visa-Background checks for fellows,D102,HJ,6.2,,6610.58
6830,8/3/2020,8/3/2020,Alan Safran,Imported from Bank of America Visa-Background checks for fellows,D102,HJ,6.21,,6616.79
6830,8/3/2020,8/3/2020,Alan Safran,Imported from Bank of America Visa-Background checks for fellows,D102,HJ,6.21,,6623
6830,8/3/2020,8/3/2020,Alan Safran,Imported from Bank of America Visa-Background checks for fellows,D102,HJ,6.21,,6629.21
6830,8/3/2020,8/3/2020,Alan Safran,Imported from Bank of America Visa-Background checks for fellows,D102,HJ,6.21,,6635.42
6830,8/3/2020,8/3/2020,Alan Safran,Imported from Bank of America Visa-Background checks for fellows,D102,HJ,6.21,,6641.63
6830,8/3/2020,8/3/2020,Alan Safran,Imported from Bank of America Visa-Background checks for fellows,D102,HJ,8.58,,6650.21
6830,8/3/2020,8/3/2020,Alan Safran,Imported from Bank of America Visa-Background checks for fellows,D102,HJ,8.58,,6658.79
6830,8/3/2020,8/3/2020,Alan Safran,Imported from Bank of America Visa-Background checks for fellows,D102,HJ,8.58,,6667.37
6830,8/3/2020,8/3/2020,Alan Safran,Imported from Bank of America Visa-Background checks for fellows,D102,HJ,8.58,,6675.95
6830,8/3/2020,8/3/2020,Alan Safran,Imported from Bank of America Visa-Background checks for fellows,D102,HJ,8.58,,6684.53
6830,8/3/2020,8/3/2020,Alan Safran,Imported from Bank of America Visa-Background checks for fellows,D102,HJ,8.59,,6693.12
6830,8/3/2020,8/3/2020,Alan Safran,Imported from Bank of America Visa-Background checks for fellows,D102,HJ,8.59,,6701.71
6830,8/3/2020,8/3/2020,Alan Safran,Imported from Bank of America Visa-Background checks for fellows,D102,HJ,8.59,,6710.3
6830,8/3/2020,8/3/2020,Alan Safran,Imported from Bank of America Visa-Background checks for fellows,D102,HJ,8.59,,6718.89
6830,8/3/2020,8/3/2020,Alan Safran,Imported from Bank of America Visa-Background checks for fellows,D102,HJ,8.59,,6727.48
6830,8/3/2020,8/3/2020,Alan Safran,Imported from Bank of America Visa-Background checks for fellows,D102,HJ,13.48,,6740.96
6830,8/3/2020,8/3/2020,Alan Safran,Imported from Bank of America Visa-Background checks for fellows,D102,HJ,13.48,,6754.44
6830,8/3/2020,8/3/2020,Alan Safran,Imported from Bank of America Visa-Background checks for fellows,D102,HJ,14.57,,6769.01
6830,8/3/2020,8/3/2020,Alan Safran,Imported from Bank of America Visa-Background checks for fellows,D102,HJ,15.62,,6784.63
6830,8/3/2020,8/3/2020,Alan Safran,Imported from Bank of America Visa-Background checks for fellows,D102,HJ,20.07,,6804.7
6830,8/3/2020,8/3/2020,Alan Safran,Imported from Bank of America Visa-Background checks for fellows,D102,HJ,20.07,,6824.77
6830,8/3/2020,8/3/2020,Alan Safran,Imported from Bank of America Visa-Background checks for fellows,D102,HJ,20.07,,6844.84
6830,8/3/2020,8/3/2020,Alan Safran,Imported from Bank of America Visa-Background checks for fellows,D102,HJ,20.07,,6864.91
6830,8/3/2020,8/3/2020,Alan Safran,Imported from Bank of America Visa-Background checks for fellows,D102,HJ,20.07,,6884.98
6830,8/3/2020,8/3/2020,Alan Safran,Imported from Bank of America Visa-Background checks for fellows,D102,HJ,20.82,,6905.8
6830,8/3/2020,8/3/2020,Alan Safran,Imported from Bank of America Visa-Background checks for fellows,D102,HJ,20.82,,6926.62
6830,8/3/2020,8/3/2020,Alan Safran,Imported from Bank of America Visa-Background checks for fellows,D102,HJ,20.83,,6947.45
6830,8/3/2020,8/3/2020,Alan Safran,Imported from Bank of America Visa-Background checks for fellows,D102,HJ,20.83,,6968.28
6830,8/3/2020,8/3/2020,Alan Safran,Imported from Bank of America Visa-Background checks for fellows,D102,HJ,24.14,,6992.42
6830,8/3/2020,8/3/2020,Alan Safran,Imported from Bank of America Visa-Background checks for fellows,D102,HJ,24.14,,7016.56
6830,8/3/2020,8/3/2020,Alan Safran,Imported from Bank of America Visa-Background checks for fellows,D102,HJ,27.77,,7044.33
6830,8/3/2020,8/3/2020,Alan Safran,Imported from Bank of America Visa-Background checks for fellows,D102,HJ,27.77,,7072.1
6830,8/3/2020,8/3/2020,Alan Safran,Imported from Bank of America Visa-Background checks for fellows,D102,HJ,27.77,,7099.87
6830,8/3/2020,8/3/2020,Alan Safran,Imported from Bank of America Visa-Background checks for fellows,D102,HJ,27.77,,7127.64
6830,8/3/2020,8/3/2020,Alan Safran,Imported from Bank of America Visa-Background checks for fellows,D102,HJ,27.77,,7155.41
6830,8/3/2020,8/3/2020,Alan Safran,Imported from Bank of America Visa-Background checks for fellows,D102,HJ,67.37,,7222.78
6830,8/3/2020,8/3/2020,Alan Safran,Imported from Bank of America Visa-Background checks for fellows,D102,HJ,67.37,,7290.15
6830,8/3/2020,8/3/2020,Alan Safran,Imported from Bank of America Visa-Background checks for fellows,D102,HJ,78.1,,7368.25
6830,8/4/2020,8/4/2020,Alan Safran,Imported from Bank of America Visa-Background checks for fellows,D102,HJ,3.16,,7371.41
6830,8/4/2020,8/4/2020,Alan Safran,Imported from Bank of America Visa-Background checks for fellows,D102,HJ,3.16,,7374.57
6830,8/4/2020,8/4/2020,Alan Safran,Imported from Bank of America Visa-Background checks for fellows,D102,HJ,3.16,,7377.73
6830,8/4/2020,8/4/2020,Alan Safran,Imported from Bank of America Visa-Background checks for fellows,D102,HJ,3.16,,7380.89
6830,8/4/2020,8/4/2020,Alan Safran,Imported from Bank of America Visa-Background checks for fellows,D102,HJ,3.16,,7384.05
6830,8/4/2020,8/4/2020,Alan Safran,Imported from Bank of America Visa-Background checks for fellows,D102,HJ,3.16,,7387.21
6830,8/4/2020,8/4/2020,Alan Safran,Imported from Bank of America Visa-Background checks for fellows,D102,HJ,3.16,,7390.37
6830,8/4/2020,8/4/2020,Alan Safran,Imported from Bank of America Visa-Background checks for fellows,D102,HJ,3.16,,7393.53
6830,8/4/2020,8/4/2020,Alan Safran,Imported from Bank of America Visa-Background checks for fellows,D102,HJ,4.02,,7397.55
6830,8/4/2020,8/4/2020,Alan Safran,Imported from Bank of America Visa-Background checks for fellows,D102,HJ,4.89,,7402.44
6830,8/4/2020,8/4/2020,Alan Safran,Imported from Bank of America Visa-Background checks for fellows,D102,HJ,4.89,,7407.33
6830,8/4/2020,8/4/2020,Alan Safran,Imported from Bank of America Visa-Background checks for fellows,D102,HJ,4.89,,7412.22
6830,8/4/2020,8/4/2020,Alan Safran,Imported from Bank of America Visa-Background checks for fellows,D102,HJ,4.89,,7417.11
6830,8/4/2020,8/4/2020,Alan Safran,Imported from Bank of America Visa-Background checks for fellows,D102,HJ,4.89,,7422
6830,8/4/2020,8/4/2020,Alan Safran,Imported from Bank of America Visa-Background checks for fellows,D102,HJ,4.89,,7426.89
6830,8/4/2020,8/4/2020,Alan Safran,Imported from Bank of America Visa-Background checks for fellows,D102,HJ,4.89,,7431.78
6830,8/4/2020,8/4/2020,Alan Safran,Imported from Bank of America Visa-Background checks for fellows,D102,HJ,4.89,,7436.67
6830,8/4/2020,8/4/2020,Alan Safran,Imported from Bank of America Visa-Background checks for fellows,D102,HJ,4.89,,7441.56
6830,8/4/2020,8/4/2020,Alan Safran,Imported from Bank of America Visa-Background checks for fellows,D102,HJ,4.89,,7446.45
6830,8/4/2020,8/4/2020,Alan Safran,Imported from Bank of America Visa-Background checks for fellows,D102,HJ,4.89,,7451.34
6830,8/4/2020,8/4/2020,Alan Safran,Imported from Bank of America Visa-Background checks for fellows,D102,HJ,4.89,,7456.23
6830,8/4/2020,8/4/2020,Alan Safran,Imported from Bank of America Visa-Background checks for fellows,D102,HJ,4.89,,7461.12
6830,8/4/2020,8/4/2020,Alan Safran,Imported from Bank of America Visa-Background checks for fellows,D102,HJ,4.89,,7466.01
6830,8/4/2020,8/4/2020,Alan Safran,Imported from Bank of America Visa-Background checks for fellows,D102,HJ,4.89,,7470.9
6830,8/4/2020,8/4/2020,Alan Safran,Imported from Bank of America Visa-Background checks for fellows,D102,HJ,4.89,,7475.79
6830,8/4/2020,8/4/2020,Alan Safran,Imported from Bank of America Visa-Background checks for fellows,D102,HJ,5.41,,7481.2
6830,8/4/2020,8/4/2020,Alan Safran,Imported from Bank of America Visa-Background checks for fellows,D102,HJ,5.56,,7486.76
6830,8/4/2020,8/4/2020,Alan Safran,Imported from Bank of America Visa-Background checks for fellows,D102,HJ,5.56,,7492.32
6830,8/4/2020,8/4/2020,Alan Safran,Imported from Bank of America Visa-Background checks for fellows,D102,HJ,6.2,,7498.52
6830,8/4/2020,8/4/2020,Alan Safran,Imported from Bank of America Visa-Background checks for fellows,D102,HJ,6.21,,7504.73
6830,8/4/2020,8/4/2020,Alan Safran,Imported from Bank of America Visa-Background checks for fellows,D102,HJ,8.36,,7513.09
6830,8/4/2020,8/4/2020,Alan Safran,Imported from Bank of America Visa-Background checks for fellows,D102,HJ,8.36,,7521.45
6830,8/4/2020,8/4/2020,Alan Safran,Imported from Bank of America Visa-Background checks for fellows,D102,HJ,8.58,,7530.03
6830,8/4/2020,8/4/2020,Alan Safran,Imported from Bank of America Visa-Background checks for fellows,D102,HJ,8.58,,7538.61
6830,8/4/2020,8/4/2020,Alan Safran,Imported from Bank of America Visa-Background checks for fellows,D102,HJ,8.59,,7547.2
6830,8/4/2020,8/4/2020,Alan Safran,Imported from Bank of America Visa-Background checks for fellows,D102,HJ,8.59,,7555.79
6830,8/4/2020,8/4/2020,Alan Safran,Imported from Bank of America Visa-Background checks for fellows,D102,HJ,13.48,,7569.27
6830,8/4/2020,8/4/2020,Alan Safran,Imported from Bank of America Visa-Background checks for fellows,D102,HJ,13.48,,7582.75
6830,8/4/2020,8/4/2020,Alan Safran,Imported from Bank of America Visa-Background checks for fellows,D102,HJ,15.81,,7598.56
6830,8/4/2020,8/4/2020,Alan Safran,Imported from Bank of America Visa-Background checks for fellows,D102,HJ,15.81,,7614.37
6830,8/4/2020,8/4/2020,Alan Safran,Imported from Bank of America Visa-Background checks for fellows,D102,HJ,15.81,,7630.18
6830,8/4/2020,8/4/2020,Alan Safran,Imported from Bank of America Visa-Background checks for fellows,D102,HJ,15.81,,7645.99
6830,8/4/2020,8/4/2020,Alan Safran,Imported from Bank of America Visa-Background checks for fellows,D102,HJ,15.81,,7661.8
6830,8/4/2020,8/4/2020,Alan Safran,Imported from Bank of America Visa-Background checks for fellows,D102,HJ,15.81,,7677.61
6830,8/4/2020,8/4/2020,Alan Safran,Imported from Bank of America Visa-Background checks for fellows,D102,HJ,15.81,,7693.42
6830,8/4/2020,8/4/2020,Alan Safran,Imported from Bank of America Visa-Background checks for fellows,D102,HJ,15.81,,7709.23
6830,8/4/2020,8/4/2020,Alan Safran,Imported from Bank of America Visa-Background checks for fellows,D102,HJ,16.72,,7725.95
6830,8/4/2020,8/4/2020,Alan Safran,Imported from Bank of America Visa-Background checks for fellows,D102,HJ,20.07,,7746.02
6830,8/4/2020,8/4/2020,Alan Safran,Imported from Bank of America Visa-Background checks for fellows,D102,HJ,20.82,,7766.84
6830,8/4/2020,8/4/2020,Alan Safran,Imported from Bank of America Visa-Background checks for fellows,D102,HJ,20.82,,7787.66
6830,8/4/2020,8/4/2020,Alan Safran,Imported from Bank of America Visa-Background checks for fellows,D102,HJ,20.83,,7808.49
6830,8/4/2020,8/4/2020,Alan Safran,Imported from Bank of America Visa-Background checks for fellows,D102,HJ,20.83,,7829.32
6830,8/4/2020,8/4/2020,Alan Safran,Imported from Bank of America Visa-Background checks for fellows,D102,HJ,25.84,,7855.16
6830,8/4/2020,8/4/2020,Alan Safran,Imported from Bank of America Visa-Background checks for fellows,D102,HJ,25.84,,7881
6830,8/4/2020,8/4/2020,Alan Safran,Imported from Bank of America Visa-Background checks for fellows,D102,HJ,27.02,,7908.02
6830,8/4/2020,8/4/2020,Alan Safran,Imported from Bank of America Visa-Background checks for fellows,D102,HJ,27.77,,7935.79
6830,8/4/2020,8/4/2020,Alan Safran,Imported from Bank of America Visa-Background checks for fellows,D102,HJ,27.77,,7963.56
6830,8/4/2020,8/4/2020,Alan Safran,Imported from Bank of America Visa-Background checks for fellows,D102,HJ,67.37,,8030.93
6830,8/4/2020,8/4/2020,Alan Safran,Imported from Bank of America Visa-Background checks for fellows,D102,HJ,67.37,,8098.3
6830,8/4/2020,8/4/2020,Alan Safran,Imported from Bank of America Visa-Background checks for fellows,D102,HJ,83.6,,8181.9
6830,8/5/2020,8/5/2020,Alan Safran,Imported from Bank of America Visa-Background checks for fellows,D102,HJ,2.92,,8184.82
6830,8/5/2020,8/5/2020,Alan Safran,Imported from Bank of America Visa-Background checks for fellows,D102,HJ,3.16,,8187.98
6830,8/5/2020,8/5/2020,Alan Safran,Imported from Bank of America Visa-Background checks for fellows,D102,HJ,3.16,,8191.14
6830,8/5/2020,8/5/2020,Alan Safran,Imported from Bank of America Visa-Background checks for fellows,D102,HJ,3.16,,8194.3
6830,8/5/2020,8/5/2020,Alan Safran,Imported from Bank of America Visa-Background checks for fellows,D102,HJ,3.16,,8197.46
6830,8/5/2020,8/5/2020,Alan Safran,Imported from Bank of America Visa-Background checks for fellows,D102,HJ,3.16,,8200.62
6830,8/5/2020,8/5/2020,Alan Safran,Imported from Bank of America Visa-Background checks for fellows,D102,HJ,3.16,,8203.78
6830,8/5/2020,8/5/2020,Alan Safran,Imported from Bank of America Visa-Background checks for fellows,D102,HJ,4.02,,8207.8
6830,8/5/2020,8/5/2020,Alan Safran,Imported from Bank of America Visa-Background checks for fellows,D102,HJ,4.5,,8212.3
6830,8/5/2020,8/5/2020,Alan Safran,Imported from Bank of America Visa-Background checks for fellows,D102,HJ,4.51,,8216.81
6830,8/5/2020,8/5/2020,Alan Safran,Imported from Bank of America Visa-Background checks for fellows,D102,HJ,4.89,,8221.7
6830,8/5/2020,8/5/2020,Alan Safran,Imported from Bank of America Visa-Background checks for fellows,D102,HJ,4.89,,8226.59
6830,8/5/2020,8/5/2020,Alan Safran,Imported from Bank of America Visa-Background checks for fellows,D102,HJ,4.89,,8231.48
6830,8/5/2020,8/5/2020,Alan Safran,Imported from Bank of America Visa-Background checks for fellows,D102,HJ,4.89,,8236.37
6830,8/5/2020,8/5/2020,Alan Safran,Imported from Bank of America Visa-Background checks for fellows,D102,HJ,4.89,,8241.26
6830,8/5/2020,8/5/2020,Alan Safran,Imported from Bank of America Visa-Background checks for fellows,D102,HJ,4.89,,8246.15
6830,8/5/2020,8/5/2020,Alan Safran,Imported from Bank of America Visa-Background checks for fellows,D102,HJ,4.89,,8251.04
6830,8/5/2020,8/5/2020,Alan Safran,Imported from Bank of America Visa-Background checks for fellows,D102,HJ,4.89,,8255.93
6830,8/5/2020,8/5/2020,Alan Safran,Imported from Bank of America Visa-Background checks for fellows,D102,HJ,4.89,,8260.82
6830,8/5/2020,8/5/2020,Alan Safran,Imported from Bank of America Visa-Background checks for fellows,D102,HJ,4.89,,8265.71
6830,8/5/2020,8/5/2020,Alan Safran,Imported from Bank of America Visa-Background checks for fellows,D102,HJ,4.89,,8270.6
6830,8/5/2020,8/5/2020,Alan Safran,Imported from Bank of America Visa-Background checks for fellows,D102,HJ,4.89,,8275.49
6830,8/5/2020,8/5/2020,Alan Safran,Imported from Bank of America Visa-Background checks for fellows,D102,HJ,6.2,,8281.69
6830,8/5/2020,8/5/2020,Alan Safran,Imported from Bank of America Visa-Background checks for fellows,D102,HJ,6.21,,8287.9
6830,8/5/2020,8/5/2020,Alan Safran,Imported from Bank of America Visa-Background checks for fellows,D102,HJ,14.57,,8302.47
6830,8/5/2020,8/5/2020,Alan Safran,Imported from Bank of America Visa-Background checks for fellows,D102,HJ,15.62,,8318.09
6830,8/5/2020,8/5/2020,Alan Safran,Imported from Bank of America Visa-Background checks for fellows,D102,HJ,15.81,,8333.9
6830,8/5/2020,8/5/2020,Alan Safran,Imported from Bank of America Visa-Background checks for fellows,D102,HJ,15.81,,8349.71
6830,8/5/2020,8/5/2020,Alan Safran,Imported from Bank of America Visa-Background checks for fellows,D102,HJ,15.81,,8365.52
6830,8/5/2020,8/5/2020,Alan Safran,Imported from Bank of America Visa-Background checks for fellows,D102,HJ,15.81,,8381.33
6830,8/5/2020,8/5/2020,Alan Safran,Imported from Bank of America Visa-Background checks for fellows,D102,HJ,15.81,,8397.14
6830,8/5/2020,8/5/2020,Alan Safran,Imported from Bank of America Visa-Background checks for fellows,D102,HJ,15.81,,8412.95
6830,8/5/2020,8/5/2020,Alan Safran,Imported from Bank of America Visa-Background checks for fellows,D102,HJ,20.07,,8433.02
6830,8/5/2020,8/5/2020,Alan Safran,Imported from Bank of America Visa-Background checks for fellows,D102,HJ,24.14,,8457.16
6830,8/5/2020,8/5/2020,Alan Safran,Imported from Bank of America Visa-Background checks for fellows,D102,HJ,24.14,,8481.3
6830,8/5/2020,8/5/2020,Alan Safran,Imported from Bank of America Visa-Background checks for fellows,D102,HJ,78.1,,8559.4
6830,8/6/2020,8/6/2020,Alan Safran,Imported from Bank of America Visa-Background checks for fellows,D102,HJ,3.16,,8562.56
6830,8/6/2020,8/6/2020,Alan Safran,Imported from Bank of America Visa-Background checks for fellows,D102,HJ,3.16,,8565.72
6830,8/6/2020,8/6/2020,Alan Safran,Imported from Bank of America Visa-Background checks for fellows,D102,HJ,4.02,,8569.74
6830,8/6/2020,8/6/2020,Alan Safran,Imported from Bank of America Visa-Background checks for fellows,D102,HJ,4.02,,8573.76
6830,8/6/2020,8/6/2020,Alan Safran,Imported from Bank of America Visa-Background checks for fellows,D102,HJ,4.89,,8578.65
6830,8/6/2020,8/6/2020,Alan Safran,Imported from Bank of America Visa-Background checks for fellows,D102,HJ,4.89,,8583.54
6830,8/6/2020,8/6/2020,Alan Safran,Imported from Bank of America Visa-Background checks for fellows,D102,HJ,4.89,,8588.43
6830,8/6/2020,8/6/2020,Alan Safran,Imported from Bank of America Visa-Background checks for fellows,D102,HJ,4.89,,8593.32
6830,8/6/2020,8/6/2020,Alan Safran,Imported from Bank of America Visa-Background checks for fellows,D102,HJ,5.56,,8598.88
6830,8/6/2020,8/6/2020,Alan Safran,Imported from Bank of America Visa-Background checks for fellows,D102,HJ,5.56,,8604.44
6830,8/6/2020,8/6/2020,Alan Safran,Imported from Bank of America Visa-Background checks for fellows,D102,HJ,6.2,,8610.64
6830,8/6/2020,8/6/2020,Alan Safran,Imported from Bank of America Visa-Background checks for fellows,D102,HJ,6.2,,8616.84
6830,8/6/2020,8/6/2020,Alan Safran,Imported from Bank of America Visa-Background checks for fellows,D102,HJ,6.21,,8623.05
6830,8/6/2020,8/6/2020,Alan Safran,Imported from Bank of America Visa-Background checks for fellows,D102,HJ,6.21,,8629.26
6830,8/6/2020,8/6/2020,Alan Safran,Imported from Bank of America Visa-Background checks for fellows,D102,HJ,7.81,,8637.07
6830,8/6/2020,8/6/2020,Alan Safran,Imported from Bank of America Visa-Background checks for fellows,D102,HJ,8.58,,8645.65
6830,8/6/2020,8/6/2020,Alan Safran,Imported from Bank of America Visa-Background checks for fellows,D102,HJ,8.58,,8654.23
6830,8/6/2020,8/6/2020,Alan Safran,Imported from Bank of America Visa-Background checks for fellows,D102,HJ,8.59,,8662.82
6830,8/6/2020,8/6/2020,Alan Safran,Imported from Bank of America Visa-Background checks for fellows,D102,HJ,8.59,,8671.41
6830,8/6/2020,8/6/2020,Alan Safran,Imported from Bank of America Visa-Background checks for fellows,D102,HJ,12.07,,8683.48
6830,8/6/2020,8/6/2020,Alan Safran,Imported from Bank of America Visa-Background checks for fellows,D102,HJ,12.07,,8695.55
6830,8/6/2020,8/6/2020,Alan Safran,Imported from Bank of America Visa-Background checks for fellows,D102,HJ,13.48,,8709.03
6830,8/6/2020,8/6/2020,Alan Safran,Imported from Bank of America Visa-Background checks for fellows,D102,HJ,15.81,,8724.84
6830,8/6/2020,8/6/2020,Alan Safran,Imported from Bank of America Visa-Background checks for fellows,D102,HJ,15.81,,8740.65
6830,8/6/2020,8/6/2020,Alan Safran,Imported from Bank of America Visa-Background checks for fellows,D102,HJ,20.07,,8760.72
6830,8/6/2020,8/6/2020,Alan Safran,Imported from Bank of America Visa-Background checks for fellows,D102,HJ,20.07,,8780.79
6830,8/6/2020,8/6/2020,Alan Safran,Imported from Bank of America Visa-Background checks for fellows,D102,HJ,20.82,,8801.61
6830,8/6/2020,8/6/2020,Alan Safran,Imported from Bank of America Visa-Background checks for fellows,D102,HJ,20.83,,8822.44
6830,8/6/2020,8/6/2020,Alan Safran,Imported from Bank of America Visa-Background checks for fellows,D102,HJ,27.77,,8850.21
6830,8/6/2020,8/6/2020,Alan Safran,Imported from Bank of America Visa-Background checks for fellows,D102,HJ,27.77,,8877.98
6830,8/6/2020,8/6/2020,Alan Safran,Imported from Bank of America Visa-Background checks for fellows,D102,HJ,39.05,,8917.03
6830,8/6/2020,8/6/2020,Alan Safran,Imported from Bank of America Visa-Background checks for fellows,D102,HJ,67.37,,8984.4
6830,8/7/2020,8/7/2020,Alan Safran,Imported from Bank of America Visa-Background checks for fellows,D102,HJ,3.16,,8987.56
6830,8/7/2020,8/7/2020,Alan Safran,Imported from Bank of America Visa-Background checks for fellows,D102,HJ,3.16,,8990.72
6830,8/7/2020,8/7/2020,Alan Safran,Imported from Bank of America Visa-Background checks for fellows,D102,HJ,3.16,,8993.88
6830,8/7/2020,8/7/2020,Alan Safran,Imported from Bank of America Visa-Background checks for fellows,D102,HJ,4.02,,8997.9
6830,8/7/2020,8/7/2020,Alan Safran,Imported from Bank of America Visa-Background checks for fellows,D102,HJ,4.02,,9001.92
6830,8/7/2020,8/7/2020,Alan Safran,Imported from Bank of America Visa-Background checks for fellows,D102,HJ,4.02,,9005.94
6830,8/7/2020,8/7/2020,Alan Safran,Imported from Bank of America Visa-Background checks for fellows,D102,HJ,4.02,,9009.96
6830,8/7/2020,8/7/2020,Alan Safran,Imported from Bank of America Visa-Background checks for fellows,D102,HJ,4.02,,9013.98
6830,8/7/2020,8/7/2020,Alan Safran,Imported from Bank of America Visa-Background checks for fellows,D102,HJ,4.89,,9018.87
6830,8/7/2020,8/7/2020,Alan Safran,Imported from Bank of America Visa-Background checks for fellows,D102,HJ,4.89,,9023.76
6830,8/7/2020,8/7/2020,Alan Safran,Imported from Bank of America Visa-Background checks for fellows,D102,HJ,4.89,,9028.65
6830,8/7/2020,8/7/2020,Alan Safran,Imported from Bank of America Visa-Background checks for fellows,D102,HJ,4.89,,9033.54
6830,8/7/2020,8/7/2020,Alan Safran,Imported from Bank of America Visa-Background checks for fellows,D102,HJ,4.89,,9038.43
6830,8/7/2020,8/7/2020,Alan Safran,Imported from Bank of America Visa-Background checks for fellows,D102,HJ,4.89,,9043.32
6830,8/7/2020,8/7/2020,Alan Safran,Imported from Bank of America Visa-Background checks for fellows,D102,HJ,6.2,,9049.52
6830,8/7/2020,8/7/2020,Alan Safran,Imported from Bank of America Visa-Background checks for fellows,D102,HJ,6.2,,9055.72
6830,8/7/2020,8/7/2020,Alan Safran,Imported from Bank of America Visa-Background checks for fellows,D102,HJ,6.2,,9061.92
6830,8/7/2020,8/7/2020,Alan Safran,Imported from Bank of America Visa-Background checks for fellows,D102,HJ,6.2,,9068.12
6830,8/7/2020,8/7/2020,Alan Safran,Imported from Bank of America Visa-Background checks for fellows,D102,HJ,6.2,,9074.32
6830,8/7/2020,8/7/2020,Alan Safran,Imported from Bank of America Visa-Background checks for fellows,D102,HJ,6.21,,9080.53
6830,8/7/2020,8/7/2020,Alan Safran,Imported from Bank of America Visa-Background checks for fellows,D102,HJ,6.21,,9086.74
6830,8/7/2020,8/7/2020,Alan Safran,Imported from Bank of America Visa-Background checks for fellows,D102,HJ,6.21,,9092.95
6830,8/7/2020,8/7/2020,Alan Safran,Imported from Bank of America Visa-Background checks for fellows,D102,HJ,6.21,,9099.16
6830,8/7/2020,8/7/2020,Alan Safran,Imported from Bank of America Visa-Background checks for fellows,D102,HJ,6.21,,9105.37
6830,8/7/2020,8/7/2020,Alan Safran,Imported from Bank of America Visa-Background checks for fellows,D102,HJ,6.38,,9111.75
6830,8/7/2020,8/7/2020,Alan Safran,Imported from Bank of America Visa-Background checks for fellows,D102,HJ,9.86,,9121.61
6830,8/7/2020,8/7/2020,Alan Safran,Imported from Bank of America Visa-Background checks for fellows,D102,HJ,9.86,,9131.47
6830,8/7/2020,8/7/2020,Alan Safran,Imported from Bank of America Visa-Background checks for fellows,D102,HJ,15.81,,9147.28
6830,8/7/2020,8/7/2020,Alan Safran,Imported from Bank of America Visa-Background checks for fellows,D102,HJ,15.81,,9163.09
6830,8/7/2020,8/7/2020,Alan Safran,Imported from Bank of America Visa-Background checks for fellows,D102,HJ,15.81,,9178.9
6830,8/7/2020,8/7/2020,Alan Safran,Imported from Bank of America Visa-Background checks for fellows,D102,HJ,20.07,,9198.97
6830,8/7/2020,8/7/2020,Alan Safran,Imported from Bank of America Visa-Background checks for fellows,D102,HJ,20.07,,9219.04
6830,8/7/2020,8/7/2020,Alan Safran,Imported from Bank of America Visa-Background checks for fellows,D102,HJ,20.07,,9239.11
6830,8/7/2020,8/7/2020,Alan Safran,Imported from Bank of America Visa-Background checks for fellows,D102,HJ,20.07,,9259.18
6830,8/7/2020,8/7/2020,Alan Safran,Imported from Bank of America Visa-Background checks for fellows,D102,HJ,20.07,,9279.25
6830,8/7/2020,8/7/2020,Alan Safran,Imported from Bank of America Visa-Background checks for fellows,D102,HJ,31.9,,9311.15
6830,8/8/2020,8/8/2020,Alan Safran,Imported from Bank of America Visa-Background checks for fellows,D102,HJ,3.16,,9314.31
6830,8/8/2020,8/8/2020,Alan Safran,Imported from Bank of America Visa-Background checks for fellows,D102,HJ,3.16,,9317.47
6830,8/8/2020,8/8/2020,Alan Safran,Imported from Bank of America Visa-Background checks for fellows,D102,HJ,4.89,,9322.36
6830,8/8/2020,8/8/2020,Alan Safran,Imported from Bank of America Visa-Background checks for fellows,D102,HJ,4.89,,9327.25
6830,8/8/2020,8/8/2020,Alan Safran,Imported from Bank of America Visa-Background checks for fellows,D102,HJ,4.89,,9332.14
6830,8/8/2020,8/8/2020,Alan Safran,Imported from Bank of America Visa-Background checks for fellows,D102,HJ,4.89,,9337.03
6830,8/8/2020,8/8/2020,Alan Safran,Imported from Bank of America Visa-Background checks for fellows,D102,HJ,13.48,,9350.51
6830,8/8/2020,8/8/2020,Alan Safran,Imported from Bank of America Visa-Background checks for fellows,D102,HJ,15.62,,9366.13
6830,8/8/2020,8/8/2020,Alan Safran,Imported from Bank of America Visa-Background checks for fellows,D102,HJ,15.81,,9381.94
6830,8/8/2020,8/8/2020,Alan Safran,Imported from Bank of America Visa-Background checks for fellows,D102,HJ,15.81,,9397.75
6830,8/8/2020,8/8/2020,Alan Safran,Imported from Bank of America Visa-Background checks for fellows,D102,HJ,20.82,,9418.57
6830,8/8/2020,8/8/2020,Alan Safran,Imported from Bank of America Visa-Background checks for fellows,D102,HJ,20.83,,9439.4
6830,8/8/2020,8/8/2020,Alan Safran,Imported from Bank of America Visa-Background checks for fellows,D102,HJ,24.14,,9463.54
6830,8/8/2020,8/8/2020,Alan Safran,Imported from Bank of America Visa-Background checks for fellows,D102,HJ,24.14,,9487.68
6830,8/8/2020,8/8/2020,Alan Safran,Imported from Bank of America Visa-Background checks for fellows,D102,HJ,67.37,,9555.05
6830,8/8/2020,8/8/2020,Alan Safran,Imported from Bank of America Visa-Background checks for fellows,D102,HJ,78.1,,9633.15
6830,8/9/2020,8/9/2020,Alan Safran,Imported from Bank of America Visa-Background checks for fellows,D102,HJ,3.16,,9636.31
6830,8/9/2020,8/9/2020,Alan Safran,Imported from Bank of America Visa-Background checks for fellows,D102,HJ,3.16,,9639.47
6830,8/9/2020,8/9/2020,Alan Safran,Imported from Bank of America Visa-Background checks for fellows,D102,HJ,3.16,,9642.63
6830,8/9/2020,8/9/2020,Alan Safran,Imported from Bank of America Visa-Background checks for fellows,D102,HJ,4.89,,9647.52
6830,8/9/2020,8/9/2020,Alan Safran,Imported from Bank of America Visa-Background checks for fellows,D102,HJ,4.89,,9652.41
6830,8/9/2020,8/9/2020,Alan Safran,Imported from Bank of America Visa-Background checks for fellows,D102,HJ,4.89,,9657.3
6830,8/9/2020,8/9/2020,Alan Safran,Imported from Bank of America Visa-Background checks for fellows,D102,HJ,4.89,,9662.19
6830,8/9/2020,8/9/2020,Alan Safran,Imported from Bank of America Visa-Background checks for fellows,D102,HJ,4.89,,9667.08
6830,8/9/2020,8/9/2020,Alan Safran,Imported from Bank of America Visa-Background checks for fellows,D102,HJ,4.89,,9671.97
6830,8/9/2020,8/9/2020,Alan Safran,Imported from Bank of America Visa-Background checks for fellows,D102,HJ,5.56,,9677.53
6830,8/9/2020,8/9/2020,Alan Safran,Imported from Bank of America Visa-Background checks for fellows,D102,HJ,8.58,,9686.11
6830,8/9/2020,8/9/2020,Alan Safran,Imported from Bank of America Visa-Background checks for fellows,D102,HJ,8.59,,9694.7
6830,8/9/2020,8/9/2020,Alan Safran,Imported from Bank of America Visa-Background checks for fellows,D102,HJ,13.48,,9708.18
6830,8/9/2020,8/9/2020,Alan Safran,Imported from Bank of America Visa-Background checks for fellows,D102,HJ,15.81,,9723.99
6830,8/9/2020,8/9/2020,Alan Safran,Imported from Bank of America Visa-Background checks for fellows,D102,HJ,15.81,,9739.8
6830,8/9/2020,8/9/2020,Alan Safran,Imported from Bank of America Visa-Background checks for fellows,D102,HJ,15.81,,9755.61
6830,8/9/2020,8/9/2020,Alan Safran,Imported from Bank of America Visa-Background checks for fellows,D102,HJ,20.82,,9776.43
6830,8/9/2020,8/9/2020,Alan Safran,Imported from Bank of America Visa-Background checks for fellows,D102,HJ,20.83,,9797.26
6830,8/9/2020,8/9/2020,Alan Safran,Imported from Bank of America Visa-Background checks for fellows,D102,HJ,27.77,,9825.03
6830,8/9/2020,8/9/2020,Alan Safran,Imported from Bank of America Visa-Background checks for fellows,D102,HJ,67.37,,9892.4
6830,8/10/2020,8/10/2020,Alan Safran,Imported from Bank of America Visa-Background checks for fellows,D102,HJ,3.16,,9895.56
6830,8/10/2020,8/10/2020,Alan Safran,Imported from Bank of America Visa-Background checks for fellows,D102,HJ,3.16,,9898.72
6830,8/10/2020,8/10/2020,Alan Safran,Imported from Bank of America Visa-Background checks for fellows,D102,HJ,3.16,,9901.88
6830,8/10/2020,8/10/2020,Alan Safran,Imported from Bank of America Visa-Background checks for fellows,D102,HJ,3.16,,9905.04
6830,8/10/2020,8/10/2020,Alan Safran,Imported from Bank of America Visa-Background checks for fellows,D102,HJ,4.02,,9909.06
6830,8/10/2020,8/10/2020,Alan Safran,Imported from Bank of America Visa-Background checks for fellows,D102,HJ,4.89,,9913.95
6830,8/10/2020,8/10/2020,Alan Safran,Imported from Bank of America Visa-Background checks for fellows,D102,HJ,4.89,,9918.84
6830,8/10/2020,8/10/2020,Alan Safran,Imported from Bank of America Visa-Background checks for fellows,D102,HJ,4.89,,9923.73
6830,8/10/2020,8/10/2020,Alan Safran,Imported from Bank of America Visa-Background checks for fellows,D102,HJ,4.89,,9928.62
6830,8/10/2020,8/10/2020,Alan Safran,Imported from Bank of America Visa-Background checks for fellows,D102,HJ,4.89,,9933.51
6830,8/10/2020,8/10/2020,Alan Safran,Imported from Bank of America Visa-Background checks for fellows,D102,HJ,4.89,,9938.4
6830,8/10/2020,8/10/2020,Alan Safran,Imported from Bank of America Visa-Background checks for fellows,D102,HJ,4.89,,9943.29
6830,8/10/2020,8/10/2020,Alan Safran,Imported from Bank of America Visa-Background checks for fellows,D102,HJ,4.89,,9948.18
6830,8/10/2020,8/10/2020,Alan Safran,Imported from Bank of America Visa-Background checks for fellows,D102,HJ,5.56,,9953.74
6830,8/10/2020,8/10/2020,Alan Safran,Imported from Bank of America Visa-Background checks for fellows,D102,HJ,5.56,,9959.3
6830,8/10/2020,8/10/2020,Alan Safran,Imported from Bank of America Visa-Background checks for fellows,D102,HJ,6.2,,9965.5
6830,8/10/2020,8/10/2020,Alan Safran,Imported from Bank of America Visa-Background checks for fellows,D102,HJ,6.21,,9971.71
6830,8/10/2020,8/10/2020,Alan Safran,Imported from Bank of America Visa-Background checks for fellows,D102,HJ,7.7,,9979.41
6830,8/10/2020,8/10/2020,Alan Safran,Imported from Bank of America Visa-Background checks for fellows,D102,HJ,7.92,,9987.33
6830,8/10/2020,8/10/2020,Alan Safran,Imported from Bank of America Visa-Background checks for fellows,D102,HJ,8.05,,9995.38
6830,8/10/2020,8/10/2020,Alan Safran,Imported from Bank of America Visa-Background checks for fellows,D102,HJ,8.58,,10003.96
6830,8/10/2020,8/10/2020,Alan Safran,Imported from Bank of America Visa-Background checks for fellows,D102,HJ,8.58,,10012.54
6830,8/10/2020,8/10/2020,Alan Safran,Imported from Bank of America Visa-Background checks for fellows,D102,HJ,8.59,,10021.13
6830,8/10/2020,8/10/2020,Alan Safran,Imported from Bank of America Visa-Background checks for fellows,D102,HJ,8.59,,10029.72
6830,8/10/2020,8/10/2020,Alan Safran,Imported from Bank of America Visa-Background checks for fellows,D102,HJ,8.8,,10038.52
6830,8/10/2020,8/10/2020,Alan Safran,Imported from Bank of America Visa-Background checks for fellows,D102,HJ,11.9,,10050.42
6830,8/10/2020,8/10/2020,Alan Safran,Imported from Bank of America Visa-Background checks for fellows,D102,HJ,11.9,,10062.32
6830,8/10/2020,8/10/2020,Alan Safran,Imported from Bank of America Visa-Background checks for fellows,D102,HJ,12.24,,10074.56
6830,8/10/2020,8/10/2020,Alan Safran,Imported from Bank of America Visa-Background checks for fellows,D102,HJ,12.24,,10086.8
6830,8/10/2020,8/10/2020,Alan Safran,Imported from Bank of America Visa-Background checks for fellows,D102,HJ,12.44,,10099.24
6830,8/10/2020,8/10/2020,Alan Safran,Imported from Bank of America Visa-Background checks for fellows,D102,HJ,12.44,,10111.68
6830,8/10/2020,8/10/2020,Alan Safran,Imported from Bank of America Visa-Background checks for fellows,D102,HJ,13.48,,10125.16
6830,8/10/2020,8/10/2020,Alan Safran,Imported from Bank of America Visa-Background checks for fellows,D102,HJ,13.6,,10138.76
6830,8/10/2020,8/10/2020,Alan Safran,Imported from Bank of America Visa-Background checks for fellows,D102,HJ,13.6,,10152.36
6830,8/10/2020,8/10/2020,Alan Safran,Imported from Bank of America Visa-Background checks for fellows,D102,HJ,15.81,,10168.17
6830,8/10/2020,8/10/2020,Alan Safran,Imported from Bank of America Visa-Background checks for fellows,D102,HJ,15.81,,10183.98
6830,8/10/2020,8/10/2020,Alan Safran,Imported from Bank of America Visa-Background checks for fellows,D102,HJ,15.81,,10199.79
6830,8/10/2020,8/10/2020,Alan Safran,Imported from Bank of America Visa-Background checks for fellows,D102,HJ,15.81,,10215.6
6830,8/10/2020,8/10/2020,Alan Safran,Imported from Bank of America Visa-Background checks for fellows,D102,HJ,16.94,,10232.54
6830,8/10/2020,8/10/2020,Alan Safran,Imported from Bank of America Visa-Background checks for fellows,D102,HJ,20.07,,10252.61
6830,8/10/2020,8/10/2020,Alan Safran,Imported from Bank of America Visa-Background checks for fellows,D102,HJ,20.82,,10273.43
6830,8/10/2020,8/10/2020,Alan Safran,Imported from Bank of America Visa-Background checks for fellows,D102,HJ,20.83,,10294.26
6830,8/10/2020,8/10/2020,Alan Safran,Imported from Bank of America Visa-Background checks for fellows,D102,HJ,26.18,,10320.44
6830,8/10/2020,8/10/2020,Alan Safran,Imported from Bank of America Visa-Background checks for fellows,D102,HJ,26.18,,10346.62
6830,8/10/2020,8/10/2020,Alan Safran,Imported from Bank of America Visa-Background checks for fellows,D102,HJ,27.77,,10374.39
6830,8/10/2020,8/10/2020,Alan Safran,Imported from Bank of America Visa-Background checks for fellows,D102,HJ,27.77,,10402.16
6830,8/10/2020,8/10/2020,Alan Safran,Imported from Bank of America Visa-Background checks for fellows,D102,HJ,38.5,,10440.66
6830,8/10/2020,8/10/2020,Alan Safran,Imported from Bank of America Visa-Background checks for fellows,D102,HJ,39.6,,10480.26
6830,8/10/2020,8/10/2020,Alan Safran,Imported from Bank of America Visa-Background checks for fellows,D102,HJ,40.22,,10520.48
6830,8/10/2020,8/10/2020,Alan Safran,Imported from Bank of America Visa-Background checks for fellows,D102,HJ,44,,10564.48
6830,8/10/2020,8/10/2020,Alan Safran,Imported from Bank of America Visa-Background checks for fellows,D102,HJ,67.37,,10631.85
6830,8/10/2020,8/10/2020,Alan Safran,Imported from Bank of America Visa-Background checks for fellows,D102,HJ,84.7,,10716.55
6830,8/11/2020,8/11/2020,Alan Safran,Imported from Bank of America Visa-Background checks for fellows,D102,HJ,3.16,,10719.71
6830,8/11/2020,8/11/2020,Alan Safran,Imported from Bank of America Visa-Background checks for fellows,D102,HJ,3.16,,10722.87
6830,8/11/2020,8/11/2020,Alan Safran,Imported from Bank of America Visa-Background checks for fellows,D102,HJ,3.16,,10726.03
6830,8/11/2020,8/11/2020,Alan Safran,Imported from Bank of America Visa-Background checks for fellows,D102,HJ,3.16,,10729.19
6830,8/11/2020,8/11/2020,Alan Safran,Imported from Bank of America Visa-Background checks for fellows,D102,HJ,3.16,,10732.35
6830,8/11/2020,8/11/2020,Alan Safran,Imported from Bank of America Visa-Background checks for fellows,D102,HJ,3.16,,10735.51
6830,8/11/2020,8/11/2020,Alan Safran,Imported from Bank of America Visa-Background checks for fellows,D102,HJ,3.16,,10738.67
6830,8/11/2020,8/11/2020,Alan Safran,Imported from Bank of America Visa-Background checks for fellows,D102,HJ,4.02,,10742.69
6830,8/11/2020,8/11/2020,Alan Safran,Imported from Bank of America Visa-Background checks for fellows,D102,HJ,4.02,,10746.71
6830,8/11/2020,8/11/2020,Alan Safran,Imported from Bank of America Visa-Background checks for fellows,D102,HJ,4.02,,10750.73
6830,8/11/2020,8/11/2020,Alan Safran,Imported from Bank of America Visa-Background checks for fellows,D102,HJ,4.02,,10754.75
6830,8/11/2020,8/11/2020,Alan Safran,Imported from Bank of America Visa-Background checks for fellows,D102,HJ,4.02,,10758.77
6830,8/11/2020,8/11/2020,Alan Safran,Imported from Bank of America Visa-Background checks for fellows,D102,HJ,4.02,,10762.79
6830,8/11/2020,8/11/2020,Alan Safran,Imported from Bank of America Visa-Background checks for fellows,D102,HJ,4.02,,10766.81
6830,8/11/2020,8/11/2020,Alan Safran,Imported from Bank of America Visa-Background checks for fellows,D102,HJ,4.02,,10770.83
6830,8/11/2020,8/11/2020,Alan Safran,Imported from Bank of America Visa-Background checks for fellows,D102,HJ,4.02,,10774.85
6830,8/11/2020,8/11/2020,Alan Safran,Imported from Bank of America Visa-Background checks for fellows,D102,HJ,4.02,,10778.87
6830,8/11/2020,8/11/2020,Alan Safran,Imported from Bank of America Visa-Background checks for fellows,D102,HJ,4.02,,10782.89
6830,8/11/2020,8/11/2020,Alan Safran,Imported from Bank of America Visa-Background checks for fellows,D102,HJ,4.02,,10786.91
6830,8/11/2020,8/11/2020,Alan Safran,Imported from Bank of America Visa-Background checks for fellows,D102,HJ,4.89,,10791.8
6830,8/11/2020,8/11/2020,Alan Safran,Imported from Bank of America Visa-Background checks for fellows,D102,HJ,4.89,,10796.69
6830,8/11/2020,8/11/2020,Alan Safran,Imported from Bank of America Visa-Background checks for fellows,D102,HJ,4.89,,10801.58
6830,8/11/2020,8/11/2020,Alan Safran,Imported from Bank of America Visa-Background checks for fellows,D102,HJ,4.89,,10806.47
6830,8/11/2020,8/11/2020,Alan Safran,Imported from Bank of America Visa-Background checks for fellows,D102,HJ,4.89,,10811.36
6830,8/11/2020,8/11/2020,Alan Safran,Imported from Bank of America Visa-Background checks for fellows,D102,HJ,4.89,,10816.25
6830,8/11/2020,8/11/2020,Alan Safran,Imported from Bank of America Visa-Background checks for fellows,D102,HJ,4.89,,10821.14
6830,8/11/2020,8/11/2020,Alan Safran,Imported from Bank of America Visa-Background checks for fellows,D102,HJ,4.89,,10826.03
6830,8/11/2020,8/11/2020,Alan Safran,Imported from Bank of America Visa-Background checks for fellows,D102,HJ,4.89,,10830.92
6830,8/11/2020,8/11/2020,Alan Safran,Imported from Bank of America Visa-Background checks for fellows,D102,HJ,4.89,,10835.81
6830,8/11/2020,8/11/2020,Alan Safran,Imported from Bank of America Visa-Background checks for fellows,D102,HJ,4.89,,10840.7
6830,8/11/2020,8/11/2020,Alan Safran,Imported from Bank of America Visa-Background checks for fellows,D102,HJ,4.89,,10845.59
6830,8/11/2020,8/11/2020,Alan Safran,Imported from Bank of America Visa-Background checks for fellows,D102,HJ,4.89,,10850.48
6830,8/11/2020,8/11/2020,Alan Safran,Imported from Bank of America Visa-Background checks for fellows,D102,HJ,4.89,,10855.37
6830,8/11/2020,8/11/2020,Alan Safran,Imported from Bank of America Visa-Background checks for fellows,D102,HJ,5.06,,10860.43
6830,8/11/2020,8/11/2020,Alan Safran,Imported from Bank of America Visa-Background checks for fellows,D102,HJ,6.2,,10866.63
6830,8/11/2020,8/11/2020,Alan Safran,Imported from Bank of America Visa-Background checks for fellows,D102,HJ,6.2,,10872.83
6830,8/11/2020,8/11/2020,Alan Safran,Imported from Bank of America Visa-Background checks for fellows,D102,HJ,6.2,,10879.03
6830,8/11/2020,8/11/2020,Alan Safran,Imported from Bank of America Visa-Background checks for fellows,D102,HJ,6.2,,10885.23
6830,8/11/2020,8/11/2020,Alan Safran,Imported from Bank of America Visa-Background checks for fellows,D102,HJ,6.2,,10891.43
6830,8/11/2020,8/11/2020,Alan Safran,Imported from Bank of America Visa-Background checks for fellows,D102,HJ,6.2,,10897.63
6830,8/11/2020,8/11/2020,Alan Safran,Imported from Bank of America Visa-Background checks for fellows,D102,HJ,6.2,,10903.83
6830,8/11/2020,8/11/2020,Alan Safran,Imported from Bank of America Visa-Background checks for fellows,D102,HJ,6.2,,10910.03
6830,8/11/2020,8/11/2020,Alan Safran,Imported from Bank of America Visa-Background checks for fellows,D102,HJ,6.2,,10916.23
6830,8/11/2020,8/11/2020,Alan Safran,Imported from Bank of America Visa-Background checks for fellows,D102,HJ,6.2,,10922.43
6830,8/11/2020,8/11/2020,Alan Safran,Imported from Bank of America Visa-Background checks for fellows,D102,HJ,6.2,,10928.63
6830,8/11/2020,8/11/2020,Alan Safran,Imported from Bank of America Visa-Background checks for fellows,D102,HJ,6.2,,10934.83
6830,8/11/2020,8/11/2020,Alan Safran,Imported from Bank of America Visa-Background checks for fellows,D102,HJ,6.21,,10941.04
6830,8/11/2020,8/11/2020,Alan Safran,Imported from Bank of America Visa-Background checks for fellows,D102,HJ,6.21,,10947.25
6830,8/11/2020,8/11/2020,Alan Safran,Imported from Bank of America Visa-Background checks for fellows,D102,HJ,6.21,,10953.46
6830,8/11/2020,8/11/2020,Alan Safran,Imported from Bank of America Visa-Background checks for fellows,D102,HJ,6.21,,10959.67
6830,8/11/2020,8/11/2020,Alan Safran,Imported from Bank of America Visa-Background checks for fellows,D102,HJ,6.21,,10965.88
6830,8/11/2020,8/11/2020,Alan Safran,Imported from Bank of America Visa-Background checks for fellows,D102,HJ,6.21,,10972.09
6830,8/11/2020,8/11/2020,Alan Safran,Imported from Bank of America Visa-Background checks for fellows,D102,HJ,6.21,,10978.3
6830,8/11/2020,8/11/2020,Alan Safran,Imported from Bank of America Visa-Background checks for fellows,D102,HJ,6.21,,10984.51
6830,8/11/2020,8/11/2020,Alan Safran,Imported from Bank of America Visa-Background checks for fellows,D102,HJ,6.21,,10990.72
6830,8/11/2020,8/11/2020,Alan Safran,Imported from Bank of America Visa-Background checks for fellows,D102,HJ,6.21,,10996.93
6830,8/11/2020,8/11/2020,Alan Safran,Imported from Bank of America Visa-Background checks for fellows,D102,HJ,6.21,,11003.14
6830,8/11/2020,8/11/2020,Alan Safran,Imported from Bank of America Visa-Background checks for fellows,D102,HJ,6.21,,11009.35
6830,8/11/2020,8/11/2020,Alan Safran,Imported from Bank of America Visa-Background checks for fellows,D102,HJ,6.51,,11015.86
6830,8/11/2020,8/11/2020,Alan Safran,Imported from Bank of America Visa-Background checks for fellows,D102,HJ,7.82,,11023.68
6830,8/11/2020,8/11/2020,Alan Safran,Imported from Bank of America Visa-Background checks for fellows,D102,HJ,7.82,,11031.5
6830,8/11/2020,8/11/2020,Alan Safran,Imported from Bank of America Visa-Background checks for fellows,D102,HJ,10.06,,11041.56
6830,8/11/2020,8/11/2020,Alan Safran,Imported from Bank of America Visa-Background checks for fellows,D102,HJ,10.06,,11051.62
6830,8/11/2020,8/11/2020,Alan Safran,Imported from Bank of America Visa-Background checks for fellows,D102,HJ,15.81,,11067.43
6830,8/11/2020,8/11/2020,Alan Safran,Imported from Bank of America Visa-Background checks for fellows,D102,HJ,15.81,,11083.24
6830,8/11/2020,8/11/2020,Alan Safran,Imported from Bank of America Visa-Background checks for fellows,D102,HJ,15.81,,11099.05
6830,8/11/2020,8/11/2020,Alan Safran,Imported from Bank of America Visa-Background checks for fellows,D102,HJ,15.81,,11114.86
6830,8/11/2020,8/11/2020,Alan Safran,Imported from Bank of America Visa-Background checks for fellows,D102,HJ,15.81,,11130.67
6830,8/11/2020,8/11/2020,Alan Safran,Imported from Bank of America Visa-Background checks for fellows,D102,HJ,15.81,,11146.48
6830,8/11/2020,8/11/2020,Alan Safran,Imported from Bank of America Visa-Background checks for fellows,D102,HJ,15.81,,11162.29
6830,8/11/2020,8/11/2020,Alan Safran,Imported from Bank of America Visa-Background checks for fellows,D102,HJ,16.72,,11179.01
6830,8/11/2020,8/11/2020,Alan Safran,Imported from Bank of America Visa-Background checks for fellows,D102,HJ,20.07,,11199.08
6830,8/11/2020,8/11/2020,Alan Safran,Imported from Bank of America Visa-Background checks for fellows,D102,HJ,20.07,,11219.15
6830,8/11/2020,8/11/2020,Alan Safran,Imported from Bank of America Visa-Background checks for fellows,D102,HJ,20.07,,11239.22
6830,8/11/2020,8/11/2020,Alan Safran,Imported from Bank of America Visa-Background checks for fellows,D102,HJ,20.07,,11259.29
6830,8/11/2020,8/11/2020,Alan Safran,Imported from Bank of America Visa-Background checks for fellows,D102,HJ,20.07,,11279.36
6830,8/11/2020,8/11/2020,Alan Safran,Imported from Bank of America Visa-Background checks for fellows,D102,HJ,20.07,,11299.43
6830,8/11/2020,8/11/2020,Alan Safran,Imported from Bank of America Visa-Background checks for fellows,D102,HJ,20.07,,11319.5
6830,8/11/2020,8/11/2020,Alan Safran,Imported from Bank of America Visa-Background checks for fellows,D102,HJ,20.07,,11339.57
6830,8/11/2020,8/11/2020,Alan Safran,Imported from Bank of America Visa-Background checks for fellows,D102,HJ,20.07,,11359.64
6830,8/11/2020,8/11/2020,Alan Safran,Imported from Bank of America Visa-Background checks for fellows,D102,HJ,20.07,,11379.71
6830,8/11/2020,8/11/2020,Alan Safran,Imported from Bank of America Visa-Background checks for fellows,D102,HJ,20.07,,11399.78
6830,8/11/2020,8/11/2020,Alan Safran,Imported from Bank of America Visa-Background checks for fellows,D102,HJ,20.07,,11419.85
6830,8/11/2020,8/11/2020,Alan Safran,Imported from Bank of America Visa-Background checks for fellows,D102,HJ,25.3,,11445.15
6830,8/11/2020,8/11/2020,Alan Safran,Imported from Bank of America Visa-Background checks for fellows,D102,HJ,25.84,,11470.99
6830,8/11/2020,8/11/2020,Alan Safran,Imported from Bank of America Visa-Background checks for fellows,D102,HJ,25.84,,11496.83
6830,8/11/2020,8/11/2020,Alan Safran,Imported from Bank of America Visa-Background checks for fellows,D102,HJ,32.52,,11529.35
6830,8/11/2020,8/11/2020,Alan Safran,Imported from Bank of America Visa-Background checks for fellows,D102,HJ,83.6,,11612.95
6830,8/12/2020,8/12/2020,Alan Safran,Imported from Bank of America Visa-Background checks for fellows,D102,HJ,5.56,,11618.51
6830,8/12/2020,8/12/2020,Alan Safran,Imported from Bank of America Visa-Background checks for fellows,D102,HJ,5.56,,11624.07
6830,8/12/2020,8/12/2020,Alan Safran,Imported from Bank of America Visa-Background checks for fellows,D102,HJ,8.58,,11632.65
6830,8/12/2020,8/12/2020,Alan Safran,Imported from Bank of America Visa-Background checks for fellows,D102,HJ,8.58,,11641.23
6830,8/12/2020,8/12/2020,Alan Safran,Imported from Bank of America Visa-Background checks for fellows,D102,HJ,8.59,,11649.82
6830,8/12/2020,8/12/2020,Alan Safran,Imported from Bank of America Visa-Background checks for fellows,D102,HJ,8.59,,11658.41
6830,8/12/2020,8/12/2020,Alan Safran,Imported from Bank of America Visa-Background checks for fellows,D102,HJ,10.12,,11668.53
6830,8/12/2020,8/12/2020,Alan Safran,Imported from Bank of America Visa-Background checks for fellows,D102,HJ,15.64,,11684.17
6830,8/12/2020,8/12/2020,Alan Safran,Imported from Bank of America Visa-Background checks for fellows,D102,HJ,15.64,,11699.81
6830,8/12/2020,8/12/2020,Alan Safran,Imported from Bank of America Visa-Background checks for fellows,D102,HJ,27.77,,11727.58
6830,8/12/2020,8/12/2020,Alan Safran,Imported from Bank of America Visa-Background checks for fellows,D102,HJ,27.77,,11755.35
6830,8/12/2020,8/12/2020,Alan Safran,Imported from Bank of America Visa-Background checks for fellows,D102,HJ,50.6,,11805.95
6830,8/13/2020,8/13/2020,Alan Safran,Imported from Bank of America Visa-Background checks for fellows,D102,HJ,3.16,,11809.11
6830,8/13/2020,8/13/2020,Alan Safran,Imported from Bank of America Visa-Background checks for fellows,D102,HJ,3.16,,11812.27
6830,8/13/2020,8/13/2020,Alan Safran,Imported from Bank of America Visa-Background checks for fellows,D102,HJ,3.16,,11815.43
6830,8/13/2020,8/13/2020,Alan Safran,Imported from Bank of America Visa-Background checks for fellows,D102,HJ,4.02,,11819.45
6830,8/13/2020,8/13/2020,Alan Safran,Imported from Bank of America Visa-Background checks for fellows,D102,HJ,4.89,,11824.34
6830,8/13/2020,8/13/2020,Alan Safran,Imported from Bank of America Visa-Background checks for fellows,D102,HJ,4.89,,11829.23
6830,8/13/2020,8/13/2020,Alan Safran,Imported from Bank of America Visa-Background checks for fellows,D102,HJ,4.89,,11834.12
6830,8/13/2020,8/13/2020,Alan Safran,Imported from Bank of America Visa-Background checks for fellows,D102,HJ,4.89,,11839.01
6830,8/13/2020,8/13/2020,Alan Safran,Imported from Bank of America Visa-Background checks for fellows,D102,HJ,4.89,,11843.9
6830,8/13/2020,8/13/2020,Alan Safran,Imported from Bank of America Visa-Background checks for fellows,D102,HJ,4.89,,11848.79
6830,8/13/2020,8/13/2020,Alan Safran,Imported from Bank of America Visa-Background checks for fellows,D102,HJ,5.56,,11854.35
6830,8/13/2020,8/13/2020,Alan Safran,Imported from Bank of America Visa-Background checks for fellows,D102,HJ,6.2,,11860.55
6830,8/13/2020,8/13/2020,Alan Safran,Imported from Bank of America Visa-Background checks for fellows,D102,HJ,6.21,,11866.76
6830,8/13/2020,8/13/2020,Alan Safran,Imported from Bank of America Visa-Background checks for fellows,D102,HJ,6.71,,11873.47
6830,8/13/2020,8/13/2020,Alan Safran,Imported from Bank of America Visa-Background checks for fellows,D102,HJ,7.81,,11881.28
6830,8/13/2020,8/13/2020,Alan Safran,Imported from Bank of America Visa-Background checks for fellows,D102,HJ,8.09,,11889.37
6830,8/13/2020,8/13/2020,Alan Safran,Imported from Bank of America Visa-Background checks for fellows,D102,HJ,8.58,,11897.95
6830,8/13/2020,8/13/2020,Alan Safran,Imported from Bank of America Visa-Background checks for fellows,D102,HJ,8.59,,11906.54
6830,8/13/2020,8/13/2020,Alan Safran,Imported from Bank of America Visa-Background checks for fellows,D102,HJ,10.37,,11916.91
6830,8/13/2020,8/13/2020,Alan Safran,Imported from Bank of America Visa-Background checks for fellows,D102,HJ,10.37,,11927.28
6830,8/13/2020,8/13/2020,Alan Safran,Imported from Bank of America Visa-Background checks for fellows,D102,HJ,12.07,,11939.35
6830,8/13/2020,8/13/2020,Alan Safran,Imported from Bank of America Visa-Background checks for fellows,D102,HJ,12.07,,11951.42
6830,8/13/2020,8/13/2020,Alan Safran,Imported from Bank of America Visa-Background checks for fellows,D102,HJ,12.49,,11963.91
6830,8/13/2020,8/13/2020,Alan Safran,Imported from Bank of America Visa-Background checks for fellows,D102,HJ,12.5,,11976.41
6830,8/13/2020,8/13/2020,Alan Safran,Imported from Bank of America Visa-Background checks for fellows,D102,HJ,15.81,,11992.22
6830,8/13/2020,8/13/2020,Alan Safran,Imported from Bank of America Visa-Background checks for fellows,D102,HJ,15.81,,12008.03
6830,8/13/2020,8/13/2020,Alan Safran,Imported from Bank of America Visa-Background checks for fellows,D102,HJ,15.81,,12023.84
6830,8/13/2020,8/13/2020,Alan Safran,Imported from Bank of America Visa-Background checks for fellows,D102,HJ,20.07,,12043.91
6830,8/13/2020,8/13/2020,Alan Safran,Imported from Bank of America Visa-Background checks for fellows,D102,HJ,27.77,,12071.68
6830,8/13/2020,8/13/2020,Alan Safran,Imported from Bank of America Visa-Background checks for fellows,D102,HJ,33.55,,12105.23
6830,8/13/2020,8/13/2020,Alan Safran,Imported from Bank of America Visa-Background checks for fellows,D102,HJ,39.05,,12144.28
6830,8/13/2020,8/13/2020,Alan Safran,Imported from Bank of America Visa-Background checks for fellows,D102,HJ,40.42,,12184.7
6830,8/14/2020,8/14/2020,Alan Safran,Imported from Bank of America Visa-Background checks for fellows,D102,HJ,3.16,,12187.86
6830,8/14/2020,8/14/2020,Alan Safran,Imported from Bank of America Visa-Background checks for fellows,D102,HJ,3.16,,12191.02
6830,8/14/2020,8/14/2020,Alan Safran,Imported from Bank of America Visa-Background checks for fellows,D102,HJ,3.16,,12194.18
6830,8/14/2020,8/14/2020,Alan Safran,Imported from Bank of America Visa-Background checks for fellows,D102,HJ,4.02,,12198.2
6830,8/14/2020,8/14/2020,Alan Safran,Imported from Bank of America Visa-Background checks for fellows,D102,HJ,4.89,,12203.09
6830,8/14/2020,8/14/2020,Alan Safran,Imported from Bank of America Visa-Background checks for fellows,D102,HJ,4.89,,12207.98
6830,8/14/2020,8/14/2020,Alan Safran,Imported from Bank of America Visa-Background checks for fellows,D102,HJ,4.89,,12212.87
6830,8/14/2020,8/14/2020,Alan Safran,Imported from Bank of America Visa-Background checks for fellows,D102,HJ,4.89,,12217.76
6830,8/14/2020,8/14/2020,Alan Safran,Imported from Bank of America Visa-Background checks for fellows,D102,HJ,4.89,,12222.65
6830,8/14/2020,8/14/2020,Alan Safran,Imported from Bank of America Visa-Background checks for fellows,D102,HJ,4.89,,12227.54
6830,8/14/2020,8/14/2020,Alan Safran,Imported from Bank of America Visa-Background checks for fellows,D102,HJ,6.2,,12233.74
6830,8/14/2020,8/14/2020,Alan Safran,Imported from Bank of America Visa-Background checks for fellows,D102,HJ,6.21,,12239.95
6830,8/14/2020,8/14/2020,Alan Safran,Imported from Bank of America Visa-Background checks for fellows,D102,HJ,13.48,,12253.43
6830,8/14/2020,8/14/2020,Alan Safran,Imported from Bank of America Visa-Background checks for fellows,D102,HJ,13.48,,12266.91
6830,8/14/2020,8/14/2020,Alan Safran,Imported from Bank of America Visa-Background checks for fellows,D102,HJ,15.81,,12282.72
6830,8/14/2020,8/14/2020,Alan Safran,Imported from Bank of America Visa-Background checks for fellows,D102,HJ,15.81,,12298.53
6830,8/14/2020,8/14/2020,Alan Safran,Imported from Bank of America Visa-Background checks for fellows,D102,HJ,15.81,,12314.34
6830,8/14/2020,8/14/2020,Alan Safran,Imported from Bank of America Visa-Background checks for fellows,D102,HJ,20.07,,12334.41
6830,8/14/2020,8/14/2020,Alan Safran,Imported from Bank of America Visa-Background checks for fellows,D102,HJ,20.82,,12355.23
6830,8/14/2020,8/14/2020,Alan Safran,Imported from Bank of America Visa-Background checks for fellows,D102,HJ,20.82,,12376.05
6830,8/14/2020,8/14/2020,Alan Safran,Imported from Bank of America Visa-Background checks for fellows,D102,HJ,20.83,,12396.88
6830,8/14/2020,8/14/2020,Alan Safran,Imported from Bank of America Visa-Background checks for fellows,D102,HJ,20.83,,12417.71
6830,8/14/2020,8/14/2020,Alan Safran,Imported from Bank of America Visa-Background checks for fellows,D102,HJ,67.37,,12485.08
6830,8/14/2020,8/14/2020,Alan Safran,Imported from Bank of America Visa-Background checks for fellows,D102,HJ,67.37,,12552.45
6830,8/15/2020,8/15/2020,Alan Safran,Imported from Bank of America Visa-Background checks for fellows,D102,HJ,3.16,,12555.61
6830,8/15/2020,8/15/2020,Alan Safran,Imported from Bank of America Visa-Background checks for fellows,D102,HJ,3.16,,12558.77
6830,8/15/2020,8/15/2020,Alan Safran,Imported from Bank of America Visa-Background checks for fellows,D102,HJ,4.89,,12563.66
6830,8/15/2020,8/15/2020,Alan Safran,Imported from Bank of America Visa-Background checks for fellows,D102,HJ,4.89,,12568.55
6830,8/15/2020,8/15/2020,Alan Safran,Imported from Bank of America Visa-Background checks for fellows,D102,HJ,4.89,,12573.44
6830,8/15/2020,8/15/2020,Alan Safran,Imported from Bank of America Visa-Background checks for fellows,D102,HJ,4.89,,12578.33
6830,8/15/2020,8/15/2020,Alan Safran,Imported from Bank of America Visa-Background checks for fellows,D102,HJ,13.48,,12591.81
6830,8/15/2020,8/15/2020,Alan Safran,Imported from Bank of America Visa-Background checks for fellows,D102,HJ,15.81,,12607.62
6830,8/15/2020,8/15/2020,Alan Safran,Imported from Bank of America Visa-Background checks for fellows,D102,HJ,15.81,,12623.43
6830,8/15/2020,8/15/2020,Alan Safran,Imported from Bank of America Visa-Background checks for fellows,D102,HJ,20.82,,12644.25
6830,8/15/2020,8/15/2020,Alan Safran,Imported from Bank of America Visa-Background checks for fellows,D102,HJ,20.83,,12665.08
6830,8/15/2020,8/15/2020,Alan Safran,Imported from Bank of America Visa-Background checks for fellows,D102,HJ,67.37,,12732.45
6830,8/16/2020,8/16/2020,Alan Safran,Imported from Bank of America Visa-Background checks for fellows,D102,HJ,3.16,,12735.61
6830,8/16/2020,8/16/2020,Alan Safran,Imported from Bank of America Visa-Background checks for fellows,D102,HJ,4.02,,12739.63
6830,8/16/2020,8/16/2020,Alan Safran,Imported from Bank of America Visa-Background checks for fellows,D102,HJ,4.89,,12744.52
6830,8/16/2020,8/16/2020,Alan Safran,Imported from Bank of America Visa-Background checks for fellows,D102,HJ,4.89,,12749.41
6830,8/16/2020,8/16/2020,Alan Safran,Imported from Bank of America Visa-Background checks for fellows,D102,HJ,6.2,,12755.61
6830,8/16/2020,8/16/2020,Alan Safran,Imported from Bank of America Visa-Background checks for fellows,D102,HJ,6.21,,12761.82
6830,8/16/2020,8/16/2020,Alan Safran,Imported from Bank of America Visa-Background checks for fellows,D102,HJ,13.48,,12775.3
6830,8/16/2020,8/16/2020,Alan Safran,Imported from Bank of America Visa-Background checks for fellows,D102,HJ,13.48,,12788.78
6830,8/16/2020,8/16/2020,Alan Safran,Imported from Bank of America Visa-Background checks for fellows,D102,HJ,15.81,,12804.59
6830,8/16/2020,8/16/2020,Alan Safran,Imported from Bank of America Visa-Background checks for fellows,D102,HJ,20.07,,12824.66
6830,8/16/2020,8/16/2020,Alan Safran,Imported from Bank of America Visa-Background checks for fellows,D102,HJ,20.82,,12845.48
6830,8/16/2020,8/16/2020,Alan Safran,Imported from Bank of America Visa-Background checks for fellows,D102,HJ,20.82,,12866.3
6830,8/16/2020,8/16/2020,Alan Safran,Imported from Bank of America Visa-Background checks for fellows,D102,HJ,20.83,,12887.13
6830,8/16/2020,8/16/2020,Alan Safran,Imported from Bank of America Visa-Background checks for fellows,D102,HJ,20.83,,12907.96
6830,8/16/2020,8/16/2020,Alan Safran,Imported from Bank of America Visa-Background checks for fellows,D102,HJ,67.37,,12975.33
6830,8/16/2020,8/16/2020,Alan Safran,Imported from Bank of America Visa-Background checks for fellows,D102,HJ,67.37,,13042.7
6830,8/17/2020,8/17/2020,Alan Safran,Imported from Bank of America Visa-Background checks for fellows,D102,HJ,0.83,,13043.53
6830,8/17/2020,8/17/2020,Alan Safran,Imported from Bank of America Visa-Background checks for fellows,D102,HJ,1.27,,13044.8
6830,8/17/2020,8/17/2020,Alan Safran,Imported from Bank of America Visa-Background checks for fellows,D102,HJ,1.28,,13046.08
6830,8/17/2020,8/17/2020,Alan Safran,Imported from Bank of America Visa-Background checks for fellows,D102,HJ,3.16,,13049.24
6830,8/17/2020,8/17/2020,Alan Safran,Imported from Bank of America Visa-Background checks for fellows,D102,HJ,3.16,,13052.4
6830,8/17/2020,8/17/2020,Alan Safran,Imported from Bank of America Visa-Background checks for fellows,D102,HJ,4.02,,13056.42
6830,8/17/2020,8/17/2020,Alan Safran,Imported from Bank of America Visa-Background checks for fellows,D102,HJ,4.02,,13060.44
6830,8/17/2020,8/17/2020,Alan Safran,Imported from Bank of America Visa-Background checks for fellows,D102,HJ,4.12,,13064.56
6830,8/17/2020,8/17/2020,Alan Safran,Imported from Bank of America Visa-Background checks for fellows,D102,HJ,4.89,,13069.45
6830,8/17/2020,8/17/2020,Alan Safran,Imported from Bank of America Visa-Background checks for fellows,D102,HJ,4.89,,13074.34
6830,8/17/2020,8/17/2020,Alan Safran,Imported from Bank of America Visa-Background checks for fellows,D102,HJ,4.89,,13079.23
6830,8/17/2020,8/17/2020,Alan Safran,Imported from Bank of America Visa-Background checks for fellows,D102,HJ,4.89,,13084.12
6830,8/17/2020,8/17/2020,Alan Safran,Imported from Bank of America Visa-Background checks for fellows,D102,HJ,6.2,,13090.32
6830,8/17/2020,8/17/2020,Alan Safran,Imported from Bank of America Visa-Background checks for fellows,D102,HJ,6.2,,13096.52
6830,8/17/2020,8/17/2020,Alan Safran,Imported from Bank of America Visa-Background checks for fellows,D102,HJ,6.21,,13102.73
6830,8/17/2020,8/17/2020,Alan Safran,Imported from Bank of America Visa-Background checks for fellows,D102,HJ,6.21,,13108.94
6830,8/17/2020,8/17/2020,Alan Safran,Imported from Bank of America Visa-Background checks for fellows,D102,HJ,6.51,,13115.45
6830,8/17/2020,8/17/2020,Alan Safran,Imported from Bank of America Visa-Background checks for fellows,D102,HJ,10.06,,13125.51
6830,8/17/2020,8/17/2020,Alan Safran,Imported from Bank of America Visa-Background checks for fellows,D102,HJ,10.06,,13135.57
6830,8/17/2020,8/17/2020,Alan Safran,Imported from Bank of America Visa-Background checks for fellows,D102,HJ,15.81,,13151.38
6830,8/17/2020,8/17/2020,Alan Safran,Imported from Bank of America Visa-Background checks for fellows,D102,HJ,15.81,,13167.19
6830,8/17/2020,8/17/2020,Alan Safran,Imported from Bank of America Visa-Background checks for fellows,D102,HJ,19.03,,13186.22
6830,8/17/2020,8/17/2020,Alan Safran,Imported from Bank of America Visa-Background checks for fellows,D102,HJ,20.07,,13206.29
6830,8/17/2020,8/17/2020,Alan Safran,Imported from Bank of America Visa-Background checks for fellows,D102,HJ,20.07,,13226.36
6830,8/17/2020,8/17/2020,Alan Safran,Imported from Bank of America Visa-Background checks for fellows,D102,HJ,29.41,,13255.77
6830,8/17/2020,8/17/2020,Alan Safran,Imported from Bank of America Visa-Background checks for fellows,D102,HJ,29.41,,13285.18
6830,8/17/2020,8/17/2020,Alan Safran,Imported from Bank of America Visa-Background checks for fellows,D102,HJ,32.52,,13317.7
6830,8/17/2020,8/17/2020,Alan Safran,Imported from Bank of America Visa-Background checks for fellows,D102,HJ,95.15,,13412.85
6830,8/18/2020,8/18/2020,Alan Safran,Imported from Bank of America Visa-Background checks for fellows,D102,HJ,3.16,,13416.01
6830,8/18/2020,8/18/2020,Alan Safran,Imported from Bank of America Visa-Background checks for fellows,D102,HJ,4.89,,13420.9
6830,8/18/2020,8/18/2020,Alan Safran,Imported from Bank of America Visa-Background checks for fellows,D102,HJ,4.89,,13425.79
6830,8/18/2020,8/18/2020,Alan Safran,Imported from Bank of America Visa-Background checks for fellows,D102,HJ,10.45,,13436.24
6830,8/18/2020,8/18/2020,Alan Safran,Imported from Bank of America Visa-Background checks for fellows,D102,HJ,15.81,,13452.05
6830,8/18/2020,8/18/2020,Alan Safran,Imported from Bank of America Visa-Background checks for fellows,D102,HJ,16.15,,13468.2
6830,8/18/2020,8/18/2020,Alan Safran,Imported from Bank of America Visa-Background checks for fellows,D102,HJ,16.15,,13484.35
6830,8/18/2020,8/18/2020,Alan Safran,Imported from Bank of America Visa-Background checks for fellows,D102,HJ,52.25,,13536.6
6830,8/20/2020,8/20/2020,Alan Safran,Imported from Bank of America Visa-Background checks for fellows,D102,HJ,3.16,,13539.76
6830,8/20/2020,8/20/2020,Alan Safran,Imported from Bank of America Visa-Background checks for fellows,D102,HJ,4.89,,13544.65
6830,8/20/2020,8/20/2020,Alan Safran,Imported from Bank of America Visa-Background checks for fellows,D102,HJ,4.89,,13549.54
6830,8/20/2020,8/20/2020,Alan Safran,Imported from Bank of America Visa-Background checks for fellows,D102,HJ,15.81,,13565.35
6830,8/21/2020,8/21/2020,ACCURATE BIOMETRICS,Bill.Com Import-Fingerprinting services for fellows London Suber from Chicago,D111,HJ,1566.5,,15131.85
6830,8/22/2020,8/22/2020,Alan Safran,Imported from Bank of America Visa-Background checks for fellows,D102,HJ,3.16,,15135.01
6830,8/22/2020,8/22/2020,Alan Safran,Imported from Bank of America Visa-Background checks for fellows,D102,HJ,4.89,,15139.9
6830,8/22/2020,8/22/2020,Alan Safran,Imported from Bank of America Visa-Background checks for fellows,D102,HJ,4.89,,15144.79
6830,8/22/2020,8/22/2020,Alan Safran,Imported from Bank of America Visa-Background checks for fellows,D102,HJ,15.81,,15160.6
6830,8/25/2020,8/25/2020,Alan Safran,Imported from Bank of America Visa-Background checks for fellows,D102,HJ,0.83,,15161.43
6830,8/25/2020,8/25/2020,Alan Safran,Imported from Bank of America Visa-Background checks for fellows,D102,HJ,1.27,,15162.7
6830,8/25/2020,8/25/2020,Alan Safran,Imported from Bank of America Visa-Background checks for fellows,D102,HJ,1.28,,15163.98
6830,8/25/2020,8/25/2020,Alan Safran,Imported from Bank of America Visa-Background checks for fellows,D102,HJ,3.16,,15167.14
6830,8/25/2020,8/25/2020,Alan Safran,Imported from Bank of America Visa-Background checks for fellows,D102,HJ,4.02,,15171.16
6830,8/25/2020,8/25/2020,Alan Safran,Imported from Bank of America Visa-Background checks for fellows,D102,HJ,4.02,,15175.18
6830,8/25/2020,8/25/2020,Alan Safran,Imported from Bank of America Visa-Background checks for fellows,D102,HJ,4.12,,15179.3
6830,8/25/2020,8/25/2020,Alan Safran,Imported from Bank of America Visa-Background checks for fellows,D102,HJ,4.89,,15184.19
6830,8/25/2020,8/25/2020,Alan Safran,Imported from Bank of America Visa-Background checks for fellows,D102,HJ,4.89,,15189.08
6830,8/25/2020,8/25/2020,Alan Safran,Imported from Bank of America Visa-Background checks for fellows,D102,HJ,5.56,,15194.64
6830,8/25/2020,8/25/2020,Alan Safran,Imported from Bank of America Visa-Background checks for fellows,D102,HJ,6.2,,15200.84
6830,8/25/2020,8/25/2020,Alan Safran,Imported from Bank of America Visa-Background checks for fellows,D102,HJ,6.2,,15207.04
6830,8/25/2020,8/25/2020,Alan Safran,Imported from Bank of America Visa-Background checks for fellows,D102,HJ,6.21,,15213.25
6830,8/25/2020,8/25/2020,Alan Safran,Imported from Bank of America Visa-Background checks for fellows,D102,HJ,6.21,,15219.46
6830,8/25/2020,8/25/2020,Alan Safran,Imported from Bank of America Visa-Background checks for fellows,D102,HJ,8.58,,15228.04
6830,8/25/2020,8/25/2020,Alan Safran,Imported from Bank of America Visa-Background checks for fellows,D102,HJ,8.59,,15236.63
6830,8/25/2020,8/25/2020,Alan Safran,Imported from Bank of America Visa-Background checks for fellows,D102,HJ,13.48,,15250.11
6830,8/25/2020,8/25/2020,Alan Safran,Imported from Bank of America Visa-Background checks for fellows,D102,HJ,13.48,,15263.59
6830,8/25/2020,8/25/2020,Alan Safran,Imported from Bank of America Visa-Background checks for fellows,D102,HJ,15.81,,15279.4
6830,8/25/2020,8/25/2020,Alan Safran,Imported from Bank of America Visa-Background checks for fellows,D102,HJ,20.07,,15299.47
6830,8/25/2020,8/25/2020,Alan Safran,Imported from Bank of America Visa-Background checks for fellows,D102,HJ,20.07,,15319.54
6830,8/25/2020,8/25/2020,Alan Safran,Imported from Bank of America Visa-Background checks for fellows,D102,HJ,20.82,,15340.36
6830,8/25/2020,8/25/2020,Alan Safran,Imported from Bank of America Visa-Background checks for fellows,D102,HJ,20.82,,15361.18
6830,8/25/2020,8/25/2020,Alan Safran,Imported from Bank of America Visa-Background checks for fellows,D102,HJ,20.83,,15382.01
6830,8/25/2020,8/25/2020,Alan Safran,Imported from Bank of America Visa-Background checks for fellows,D102,HJ,20.83,,15402.84
6830,8/25/2020,8/25/2020,Alan Safran,Imported from Bank of America Visa-Background checks for fellows,D102,HJ,27.77,,15430.61
6830,8/25/2020,8/25/2020,Alan Safran,Imported from Bank of America Visa-Background checks for fellows,D102,HJ,67.37,,15497.98
6830,8/25/2020,8/25/2020,Alan Safran,Imported from Bank of America Visa-Background checks for fellows,D102,HJ,67.37,,15565.35
6830,8/26/2020,8/26/2020,Alan Safran,Imported from Bank of America Visa-Background checks for fellows,D102,HJ,5.56,,15570.91
6830,8/26/2020,8/26/2020,Alan Safran,Imported from Bank of America Visa-Background checks for fellows,D102,HJ,8.58,,15579.49
6830,8/26/2020,8/26/2020,Alan Safran,Imported from Bank of America Visa-Background checks for fellows,D102,HJ,8.59,,15588.08
6830,8/26/2020,8/26/2020,Alan Safran,Imported from Bank of America Visa-Background checks for fellows,D102,HJ,13.48,,15601.56
6830,8/26/2020,8/26/2020,Alan Safran,Imported from Bank of America Visa-Background checks for fellows,D102,HJ,20.82,,15622.38
6830,8/26/2020,8/26/2020,Alan Safran,Imported from Bank of America Visa-Background checks for fellows,D102,HJ,20.83,,15643.21
6830,8/26/2020,8/26/2020,Alan Safran,Imported from Bank of America Visa-Background checks for fellows,D102,HJ,27.77,,15670.98
6830,8/26/2020,8/26/2020,Alan Safran,Imported from Bank of America Visa-Background checks for fellows,D102,HJ,67.37,,15738.35
6830,8/28/2020,8/28/2020,Alan Safran,Imported from Bank of America Visa-Background checks for fellows,D102,HJ,3.16,,15741.51
6830,8/28/2020,8/28/2020,Alan Safran,Imported from Bank of America Visa-Background checks for fellows,D102,HJ,4.02,,15745.53
6830,8/28/2020,8/28/2020,Alan Safran,Imported from Bank of America Visa-Background checks for fellows,D102,HJ,4.02,,15749.55
6830,8/28/2020,8/28/2020,Alan Safran,Imported from Bank of America Visa-Background checks for fellows,D102,HJ,4.89,,15754.44
6830,8/28/2020,8/28/2020,Alan Safran,Imported from Bank of America Visa-Background checks for fellows,D102,HJ,4.89,,15759.33
6830,8/28/2020,8/28/2020,Alan Safran,Imported from Bank of America Visa-Background checks for fellows,D102,HJ,6.2,,15765.53
6830,8/28/2020,8/28/2020,Alan Safran,Imported from Bank of America Visa-Background checks for fellows,D102,HJ,6.2,,15771.73
6830,8/28/2020,8/28/2020,Alan Safran,Imported from Bank of America Visa-Background checks for fellows,D102,HJ,6.21,,15777.94
6830,8/28/2020,8/28/2020,Alan Safran,Imported from Bank of America Visa-Background checks for fellows,D102,HJ,6.21,,15784.15
6830,8/28/2020,8/28/2020,Alan Safran,Imported from Bank of America Visa-Background checks for fellows,D102,HJ,15.81,,15799.96
6830,8/28/2020,8/28/2020,Alan Safran,Imported from Bank of America Visa-Background checks for fellows,D102,HJ,20.07,,15820.03
6830,8/28/2020,8/28/2020,Alan Safran,Imported from Bank of America Visa-Background checks for fellows,D102,HJ,20.07,,15840.1
6830,9/2/2020,9/2/2020,Alan Safran,Imported from Bank of America Visa-Background Checks for Fellows,D102,HJ,4.02,,15844.12
6830,9/2/2020,9/2/2020,Alan Safran,Imported from Bank of America Visa-Background Checks for Fellows,D102,HJ,6.2,,15850.32
6830,9/2/2020,9/2/2020,Alan Safran,Imported from Bank of America Visa-Background Checks for Fellows,D102,HJ,6.21,,15856.53
6830,9/2/2020,9/2/2020,Alan Safran,Imported from Bank of America Visa-Background Checks for Fellows,D102,HJ,20.07,,15876.6
6830,9/8/2020,9/8/2020,Alan Safran,Imported from Bank of America Visa-Background Checks for Fellows,D102,HJ,5.56,,15882.16
6830,9/8/2020,9/8/2020,Alan Safran,Imported from Bank of America Visa-Background Checks for Fellows,D102,HJ,8.58,,15890.74
6830,9/8/2020,9/8/2020,Alan Safran,Imported from Bank of America Visa-Background Checks for Fellows,D102,HJ,8.59,,15899.33
6830,9/8/2020,9/8/2020,Alan Safran,Imported from Bank of America Visa-Background Checks for Fellows,D102,HJ,27.77,,15927.1
6830,9/9/2020,9/9/2020,Antonio Gutierrez,Imported from Bank of America Visa-background check,D111,HJ,7.5,,15934.6
6830,9/9/2020,9/9/2020,Antonio Gutierrez,Imported from Bank of America Visa-background check,D111,HJ,122.5,,16057.1
6830,9/9/2020,9/9/2020,Hannah Gibbs,Bill.Com Import-Physical fingerprints fees and delivery expense. Reimbursement to the Fellow,D108,HJ,51.63,,16108.73
6830,9/9/2020,9/9/2020,Kalli Ann Hale,Bill.Com Import-Physical fingerprints fees and delivery expense. Reimbursement to the Fellow.,D108,HJ,45.52,,16154.25
6830,9/9/2020,9/9/2020,Michael Westphal,Bill.Com Import-Physical fingerprints fees and delivery expense. Reimbursement to the Fellow.,D108,HJ,46.6,,16200.85
6830,9/10/2020,9/10/2020,Alan Safran,Imported from Bank of America Visa-Background Checks for Fellows,D102,HJ,5.56,,16206.41
6830,9/10/2020,9/10/2020,Alan Safran,Imported from Bank of America Visa-Background Checks for Fellows,D102,HJ,8.58,,16214.99
6830,9/10/2020,9/10/2020,Alan Safran,Imported from Bank of America Visa-Background Checks for Fellows,D102,HJ,8.59,,16223.58
6830,9/10/2020,9/10/2020,Alan Safran,Imported from Bank of America Visa-Background Checks for Fellows,D102,HJ,27.77,,16251.35
6830,9/15/2020,9/15/2020,Alan Safran,Imported from Bank of America Visa-Background Checks for Fellows,D102,HJ,2.92,,16254.27
6830,9/15/2020,9/15/2020,Alan Safran,Imported from Bank of America Visa-Background Checks for Fellows,D102,HJ,2.92,,16257.19
6830,9/15/2020,9/15/2020,Alan Safran,Imported from Bank of America Visa-Background Checks for Fellows,D102,HJ,4.5,,16261.69
6830,9/15/2020,9/15/2020,Alan Safran,Imported from Bank of America Visa-Background Checks for Fellows,D102,HJ,4.5,,16266.19
6830,9/15/2020,9/15/2020,Alan Safran,Imported from Bank of America Visa-Background Checks for Fellows,D102,HJ,4.51,,16270.7
6830,9/15/2020,9/15/2020,Alan Safran,Imported from Bank of America Visa-Background Checks for Fellows,D102,HJ,4.51,,16275.21
6830,9/15/2020,9/15/2020,Alan Safran,Imported from Bank of America Visa-Background Checks for Fellows,D102,HJ,14.57,,16289.78
6830,9/15/2020,9/15/2020,Alan Safran,Imported from Bank of America Visa-Background Checks for Fellows,D102,HJ,14.57,,16304.35
6830,9/22/2020,9/22/2020,ACCURATE BIOMETRICS,Bill.Com Import-Fingerprinting services for fellows - Chicago,D111,HJ,3253.5,,19557.85
6830,9/22/2020,9/22/2020,Alan Safran,Imported from Bank of America Visa-Background Checks for Fellows,D102,HJ,5.56,,19563.41
6830,9/22/2020,9/22/2020,Alan Safran,Imported from Bank of America Visa-Background Checks for Fellows,D102,HJ,8.58,,19571.99
6830,9/22/2020,9/22/2020,Alan Safran,Imported from Bank of America Visa-Background Checks for Fellows,D102,HJ,8.59,,19580.58
6830,9/22/2020,9/22/2020,Alan Safran,Imported from Bank of America Visa-Background Checks for Fellows,D102,HJ,27.77,,19608.35
6830,9/23/2020,9/23/2020,Alan Safran,Imported from Bank of America Visa-Background Checks for Fellows,D102,HJ,3.16,,19611.51
6830,9/23/2020,9/23/2020,Alan Safran,Imported from Bank of America Visa-Background Checks for Fellows,D102,HJ,3.16,,19614.67
6830,9/23/2020,9/23/2020,Alan Safran,Imported from Bank of America Visa-Background Checks for Fellows,D102,HJ,3.16,,19617.83
6830,9/23/2020,9/23/2020,Alan Safran,Imported from Bank of America Visa-Background Checks for Fellows,D102,HJ,3.16,,19620.99
6830,9/23/2020,9/23/2020,Alan Safran,Imported from Bank of America Visa-Background Checks for Fellows,D102,HJ,3.16,,19624.15
6830,9/23/2020,9/23/2020,Alan Safran,Imported from Bank of America Visa-Background Checks for Fellows,D102,HJ,3.16,,19627.31
6830,9/23/2020,9/23/2020,Alan Safran,Imported from Bank of America Visa-Background Checks for Fellows,D102,HJ,3.16,,19630.47
6830,9/23/2020,9/23/2020,Alan Safran,Imported from Bank of America Visa-Background Checks for Fellows,D102,HJ,4.89,,19635.36
6830,9/23/2020,9/23/2020,Alan Safran,Imported from Bank of America Visa-Background Checks for Fellows,D102,HJ,4.89,,19640.25
6830,9/23/2020,9/23/2020,Alan Safran,Imported from Bank of America Visa-Background Checks for Fellows,D102,HJ,4.89,,19645.14
6830,9/23/2020,9/23/2020,Alan Safran,Imported from Bank of America Visa-Background Checks for Fellows,D102,HJ,4.89,,19650.03
6830,9/23/2020,9/23/2020,Alan Safran,Imported from Bank of America Visa-Background Checks for Fellows,D102,HJ,4.89,,19654.92
6830,9/23/2020,9/23/2020,Alan Safran,Imported from Bank of America Visa-Background Checks for Fellows,D102,HJ,4.89,,19659.81
6830,9/23/2020,9/23/2020,Alan Safran,Imported from Bank of America Visa-Background Checks for Fellows,D102,HJ,4.89,,19664.7
6830,9/23/2020,9/23/2020,Alan Safran,Imported from Bank of America Visa-Background Checks for Fellows,D102,HJ,4.89,,19669.59
6830,9/23/2020,9/23/2020,Alan Safran,Imported from Bank of America Visa-Background Checks for Fellows,D102,HJ,4.89,,19674.48
6830,9/23/2020,9/23/2020,Alan Safran,Imported from Bank of America Visa-Background Checks for Fellows,D102,HJ,4.89,,19679.37
6830,9/23/2020,9/23/2020,Alan Safran,Imported from Bank of America Visa-Background Checks for Fellows,D102,HJ,4.89,,19684.26
6830,9/23/2020,9/23/2020,Alan Safran,Imported from Bank of America Visa-Background Checks for Fellows,D102,HJ,4.89,,19689.15
6830,9/23/2020,9/23/2020,Alan Safran,Imported from Bank of America Visa-Background Checks for Fellows,D102,HJ,4.89,,19694.04
6830,9/23/2020,9/23/2020,Alan Safran,Imported from Bank of America Visa-Background Checks for Fellows,D102,HJ,4.89,,19698.93
6830,9/23/2020,9/23/2020,Alan Safran,Imported from Bank of America Visa-Background Checks for Fellows,D102,HJ,15.81,,19714.74
6830,9/23/2020,9/23/2020,Alan Safran,Imported from Bank of America Visa-Background Checks for Fellows,D102,HJ,15.81,,19730.55
6830,9/23/2020,9/23/2020,Alan Safran,Imported from Bank of America Visa-Background Checks for Fellows,D102,HJ,15.81,,19746.36
6830,9/23/2020,9/23/2020,Alan Safran,Imported from Bank of America Visa-Background Checks for Fellows,D102,HJ,15.81,,19762.17
6830,9/23/2020,9/23/2020,Alan Safran,Imported from Bank of America Visa-Background Checks for Fellows,D102,HJ,15.81,,19777.98
6830,9/23/2020,9/23/2020,Alan Safran,Imported from Bank of America Visa-Background Checks for Fellows,D102,HJ,15.81,,19793.79
6830,9/23/2020,9/23/2020,Alan Safran,Imported from Bank of America Visa-Background Checks for Fellows,D102,HJ,15.81,,19809.6
6830,9/24/2020,9/24/2020,Alan Safran,Imported from Bank of America Visa-Background Checks for Fellows,D102,HJ,4.02,,19813.62
6830,9/24/2020,9/24/2020,Alan Safran,Imported from Bank of America Visa-Background Checks for Fellows,D102,HJ,6.2,,19819.82
6830,9/24/2020,9/24/2020,Alan Safran,Imported from Bank of America Visa-Background Checks for Fellows,D102,HJ,6.21,,19826.03
6830,9/24/2020,9/24/2020,Alan Safran,Imported from Bank of America Visa-Background Checks for Fellows,D102,HJ,7.26,,19833.29
6830,9/24/2020,9/24/2020,Alan Safran,Imported from Bank of America Visa-Background Checks for Fellows,D102,HJ,11.22,,19844.51
6830,9/24/2020,9/24/2020,Alan Safran,Imported from Bank of America Visa-Background Checks for Fellows,D102,HJ,11.22,,19855.73
6830,9/24/2020,9/24/2020,Alan Safran,Imported from Bank of America Visa-Background Checks for Fellows,D102,HJ,20.07,,19875.8
6830,9/24/2020,9/24/2020,Alan Safran,Imported from Bank of America Visa-Background Checks for Fellows,D102,HJ,36.3,,19912.1
6830,9/25/2020,9/25/2020,Alan Safran,Imported from Bank of America Visa-Background Checks for Fellows,D102,HJ,4.02,,19916.12
6830,9/25/2020,9/25/2020,Alan Safran,Imported from Bank of America Visa-Background Checks for Fellows,D102,HJ,4.02,,19920.14
6830,9/25/2020,9/25/2020,Alan Safran,Imported from Bank of America Visa-Background Checks for Fellows,D102,HJ,6.2,,19926.34
6830,9/25/2020,9/25/2020,Alan Safran,Imported from Bank of America Visa-Background Checks for Fellows,D102,HJ,6.2,,19932.54
6830,9/25/2020,9/25/2020,Alan Safran,Imported from Bank of America Visa-Background Checks for Fellows,D102,HJ,6.21,,19938.75
6830,9/25/2020,9/25/2020,Alan Safran,Imported from Bank of America Visa-Background Checks for Fellows,D102,HJ,6.21,,19944.96
6830,9/25/2020,9/25/2020,Alan Safran,Imported from Bank of America Visa-Background Checks for Fellows,D102,HJ,6.51,,19951.47
6830,9/25/2020,9/25/2020,Alan Safran,Imported from Bank of America Visa-Background Checks for Fellows,D102,HJ,10.06,,19961.53
6830,9/25/2020,9/25/2020,Alan Safran,Imported from Bank of America Visa-Background Checks for Fellows,D102,HJ,10.06,,19971.59
6830,9/25/2020,9/25/2020,Alan Safran,Imported from Bank of America Visa-Background Checks for Fellows,D102,HJ,20.07,,19991.66
6830,9/25/2020,9/25/2020,Alan Safran,Imported from Bank of America Visa-Background Checks for Fellows,D102,HJ,20.07,,20011.73
6830,9/25/2020,9/25/2020,Alan Safran,Imported from Bank of America Visa-Background Checks for Fellows,D102,HJ,32.52,,20044.25
6830,9/26/2020,9/26/2020,Alan Safran,Imported from Bank of America Visa-Background Checks for Fellows,D102,HJ,3.16,,20047.41
6830,9/26/2020,9/26/2020,Alan Safran,Imported from Bank of America Visa-Background Checks for Fellows,D102,HJ,4.02,,20051.43
6830,9/26/2020,9/26/2020,Alan Safran,Imported from Bank of America Visa-Background Checks for Fellows,D102,HJ,4.89,,20056.32
6830,9/26/2020,9/26/2020,Alan Safran,Imported from Bank of America Visa-Background Checks for Fellows,D102,HJ,4.89,,20061.21
6830,9/26/2020,9/26/2020,Alan Safran,Imported from Bank of America Visa-Background Checks for Fellows,D102,HJ,6.2,,20067.41
6830,9/26/2020,9/26/2020,Alan Safran,Imported from Bank of America Visa-Background Checks for Fellows,D102,HJ,6.21,,20073.62
6830,9/26/2020,9/26/2020,Alan Safran,Imported from Bank of America Visa-Background Checks for Fellows,D102,HJ,15.81,,20089.43
6830,9/26/2020,9/26/2020,Alan Safran,Imported from Bank of America Visa-Background Checks for Fellows,D102,HJ,20.07,,20109.5
6830,9/28/2020,9/28/2020,Alan Safran,Imported from Bank of America Visa-Background Checks for Fellows,D102,HJ,13.48,,20122.98
6830,9/28/2020,9/28/2020,Alan Safran,Imported from Bank of America Visa-Background Checks for Fellows,D102,HJ,20.82,,20143.8
6830,9/28/2020,9/28/2020,Alan Safran,Imported from Bank of America Visa-Background Checks for Fellows,D102,HJ,20.83,,20164.63
6830,9/28/2020,9/28/2020,Alan Safran,Imported from Bank of America Visa-Background Checks for Fellows,D102,HJ,67.37,,20232
6830,9/29/2020,9/29/2020,Alan Safran,Imported from Bank of America Visa-Background Checks for Fellows,D102,HJ,3.16,,20235.16
6830,9/29/2020,9/29/2020,Alan Safran,Imported from Bank of America Visa-Background Checks for Fellows,D102,HJ,4.02,,20239.18
6830,9/29/2020,9/29/2020,Alan Safran,Imported from Bank of America Visa-Background Checks for Fellows,D102,HJ,4.02,,20243.2
6830,9/29/2020,9/29/2020,Alan Safran,Imported from Bank of America Visa-Background Checks for Fellows,D102,HJ,4.89,,20248.09
6830,9/29/2020,9/29/2020,Alan Safran,Imported from Bank of America Visa-Background Checks for Fellows,D102,HJ,4.89,,20252.98
6830,9/29/2020,9/29/2020,Alan Safran,Imported from Bank of America Visa-Background Checks for Fellows,D102,HJ,6.2,,20259.18
6830,9/29/2020,9/29/2020,Alan Safran,Imported from Bank of America Visa-Background Checks for Fellows,D102,HJ,6.2,,20265.38
6830,9/29/2020,9/29/2020,Alan Safran,Imported from Bank of America Visa-Background Checks for Fellows,D102,HJ,6.21,,20271.59
6830,9/29/2020,9/29/2020,Alan Safran,Imported from Bank of America Visa-Background Checks for Fellows,D102,HJ,6.21,,20277.8
6830,9/29/2020,9/29/2020,Alan Safran,Imported from Bank of America Visa-Background Checks for Fellows,D102,HJ,15.81,,20293.61
6830,9/29/2020,9/29/2020,Alan Safran,Imported from Bank of America Visa-Background Checks for Fellows,D102,HJ,20.07,,20313.68
6830,9/29/2020,9/29/2020,Alan Safran,Imported from Bank of America Visa-Background Checks for Fellows,D102,HJ,20.07,,20333.75
6830,10/1/2020,10/1/2020,Alan Safran,Imported from reimbursements-Background checks for fellows,D102,HJ,5.56,,20339.31
6830,10/1/2020,10/1/2020,Alan Safran,Imported from reimbursements-Background checks for fellows,D102,HJ,8.58,,20347.89
6830,10/1/2020,10/1/2020,Alan Safran,Imported from reimbursements-Background checks for fellows,D102,HJ,8.59,,20356.48
6830,10/1/2020,10/1/2020,Alan Safran,Imported from reimbursements-Background checks for fellows,D102,HJ,27.77,,20384.25
6830,10/3/2020,10/3/2020,Alan Safran,Imported from reimbursements-Background checks for fellows,D102,HJ,3.16,,20387.41
6830,10/3/2020,10/3/2020,Alan Safran,Imported from reimbursements-Background checks for fellows,D102,HJ,4.89,,20392.3
6830,10/3/2020,10/3/2020,Alan Safran,Imported from reimbursements-Background checks for fellows,D102,HJ,4.89,,20397.19
6830,10/3/2020,10/3/2020,Alan Safran,Imported from reimbursements-Background checks for fellows,D102,HJ,15.81,,20413
6830,10/6/2020,10/6/2020,Alan Safran,Imported from reimbursements-Background checks for fellows,D102,HJ,8.8,,20421.8
6830,10/6/2020,10/6/2020,Alan Safran,Imported from reimbursements-Background checks for fellows,D102,HJ,13.6,,20435.4
6830,10/6/2020,10/6/2020,Alan Safran,Imported from reimbursements-Background checks for fellows,D102,HJ,13.6,,20449
6830,10/6/2020,10/6/2020,Alan Safran,Imported from reimbursements-Background checks for fellows,D102,HJ,44,,20493
6830,10/7/2020,10/7/2020,Antonio Gutierrez,Imported from reimbursements-Refund,D111,HJ,,7.5,20485.5
6830,10/7/2020,10/7/2020,Antonio Gutierrez,Imported from reimbursements-Refund,D111,HJ,,122.5,20363
6830,10/10/2020,10/10/2020,Alan Safran,Imported from reimbursements-Background checks for fellows,D102,HJ,3.16,,20366.16
6830,10/10/2020,10/10/2020,Alan Safran,Imported from reimbursements-Background checks for fellows,D102,HJ,4.89,,20371.05
6830,10/10/2020,10/10/2020,Alan Safran,Imported from reimbursements-Background checks for fellows,D102,HJ,4.89,,20375.94
6830,10/10/2020,10/10/2020,Alan Safran,Imported from reimbursements-Background checks for fellows,D102,HJ,15.81,,20391.75
6830,10/11/2020,10/11/2020,Alan Safran,Imported from reimbursements-Background checks for fellows,D102,HJ,3.36,,20395.11
6830,10/11/2020,10/11/2020,Alan Safran,Imported from reimbursements-Background checks for fellows,D102,HJ,4.02,,20399.13
6830,10/11/2020,10/11/2020,Alan Safran,Imported from reimbursements-Background checks for fellows,D102,HJ,5.18,,20404.31
6830,10/11/2020,10/11/2020,Alan Safran,Imported from reimbursements-Background checks for fellows,D102,HJ,5.19,,20409.5
6830,10/11/2020,10/11/2020,Alan Safran,Imported from reimbursements-Background checks for fellows,D102,HJ,6.2,,20415.7
6830,10/11/2020,10/11/2020,Alan Safran,Imported from reimbursements-Background checks for fellows,D102,HJ,6.21,,20421.91
6830,10/11/2020,10/11/2020,Alan Safran,Imported from reimbursements-Background checks for fellows,D102,HJ,16.77,,20438.68
6830,10/11/2020,10/11/2020,Alan Safran,Imported from reimbursements-Background checks for fellows,D102,HJ,20.07,,20458.75
6830,10/12/2020,10/12/2020,Alan Safran,Imported from reimbursements-Background checks for fellows,D102,HJ,3.36,,20462.11
6830,10/12/2020,10/12/2020,Alan Safran,Imported from reimbursements-Background checks for fellows,D102,HJ,3.36,,20465.47
6830,10/12/2020,10/12/2020,Alan Safran,Imported from reimbursements-Background checks for fellows,D102,HJ,4.02,,20469.49
6830,10/12/2020,10/12/2020,Alan Safran,Imported from reimbursements-Background checks for fellows,D102,HJ,5.18,,20474.67
6830,10/12/2020,10/12/2020,Alan Safran,Imported from reimbursements-Background checks for fellows,D102,HJ,5.18,,20479.85
6830,10/12/2020,10/12/2020,Alan Safran,Imported from reimbursements-Background checks for fellows,D102,HJ,5.19,,20485.04
6830,10/12/2020,10/12/2020,Alan Safran,Imported from reimbursements-Background checks for fellows,D102,HJ,5.19,,20490.23
6830,10/12/2020,10/12/2020,Alan Safran,Imported from reimbursements-Background checks for fellows,D102,HJ,6.2,,20496.43
6830,10/12/2020,10/12/2020,Alan Safran,Imported from reimbursements-Background checks for fellows,D102,HJ,6.21,,20502.64
6830,10/12/2020,10/12/2020,Alan Safran,Imported from reimbursements-Background checks for fellows,D102,HJ,16.77,,20519.41
6830,10/12/2020,10/12/2020,Alan Safran,Imported from reimbursements-Background checks for fellows,D102,HJ,16.77,,20536.18
6830,10/12/2020,10/12/2020,Alan Safran,Imported from reimbursements-Background checks for fellows,D102,HJ,20.07,,20556.25
6830,10/13/2020,10/13/2020,Alan Safran,Imported from reimbursements-Background checks for fellows,D102,HJ,3.36,,20559.61
6830,10/13/2020,10/13/2020,Alan Safran,Imported from reimbursements-Background checks for fellows,D102,HJ,4.35,,20563.96
6830,10/13/2020,10/13/2020,Alan Safran,Imported from reimbursements-Background checks for fellows,D102,HJ,5.18,,20569.14
6830,10/13/2020,10/13/2020,Alan Safran,Imported from reimbursements-Background checks for fellows,D102,HJ,5.19,,20574.33
6830,10/13/2020,10/13/2020,Alan Safran,Imported from reimbursements-Background checks for fellows,D102,HJ,5.56,,20579.89
6830,10/13/2020,10/13/2020,Alan Safran,Imported from reimbursements-Background checks for fellows,D102,HJ,6.71,,20586.6
6830,10/13/2020,10/13/2020,Alan Safran,Imported from reimbursements-Background checks for fellows,D102,HJ,6.72,,20593.32
6830,10/13/2020,10/13/2020,Alan Safran,Imported from reimbursements-Background checks for fellows,D102,HJ,8.58,,20601.9
6830,10/13/2020,10/13/2020,Alan Safran,Imported from reimbursements-Background checks for fellows,D102,HJ,8.59,,20610.49
6830,10/13/2020,10/13/2020,Alan Safran,Imported from reimbursements-Background checks for fellows,D102,HJ,16.77,,20627.26
6830,10/13/2020,10/13/2020,Alan Safran,Imported from reimbursements-Background checks for fellows,D102,HJ,21.72,,20648.98
6830,10/13/2020,10/13/2020,Alan Safran,Imported from reimbursements-Background checks for fellows,D102,HJ,27.77,,20676.75
6830,10/14/2020,10/14/2020,Alan Safran,Imported from reimbursements-Background checks for fellows,D102,HJ,3.36,,20680.11
6830,10/14/2020,10/14/2020,Alan Safran,Imported from reimbursements-Background checks for fellows,D102,HJ,5.18,,20685.29
6830,10/14/2020,10/14/2020,Alan Safran,Imported from reimbursements-Background checks for fellows,D102,HJ,5.19,,20690.48
6830,10/14/2020,10/14/2020,Alan Safran,Imported from reimbursements-Background checks for fellows,D102,HJ,5.85,,20696.33
6830,10/14/2020,10/14/2020,Alan Safran,Imported from reimbursements-Background checks for fellows,D102,HJ,9.04,,20705.37
6830,10/14/2020,10/14/2020,Alan Safran,Imported from reimbursements-Background checks for fellows,D102,HJ,9.04,,20714.41
6830,10/14/2020,10/14/2020,Alan Safran,Imported from reimbursements-Background checks for fellows,D102,HJ,16.77,,20731.18
6830,10/14/2020,10/14/2020,Alan Safran,Imported from reimbursements-Background checks for fellows,D102,HJ,29.22,,20760.4
6830,10/15/2020,10/15/2020,Alan Safran,Imported from reimbursements-Background checks for fellows,D102,HJ,3.36,,20763.76
6830,10/15/2020,10/15/2020,Alan Safran,Imported from reimbursements-Background checks for fellows,D102,HJ,5.18,,20768.94
6830,10/15/2020,10/15/2020,Alan Safran,Imported from reimbursements-Background checks for fellows,D102,HJ,5.19,,20774.13
6830,10/15/2020,10/15/2020,Alan Safran,Imported from reimbursements-Background checks for fellows,D102,HJ,16.77,,20790.9
6830,10/16/2020,10/16/2020,Alan Safran,Imported from reimbursements-Background checks for fellows,D102,HJ,3.36,,20794.26
6830,10/16/2020,10/16/2020,Alan Safran,Imported from reimbursements-Background checks for fellows,D102,HJ,3.36,,20797.62
6830,10/16/2020,10/16/2020,Alan Safran,Imported from reimbursements-Background checks for fellows,D102,HJ,5.18,,20802.8
6830,10/16/2020,10/16/2020,Alan Safran,Imported from reimbursements-Background checks for fellows,D102,HJ,5.18,,20807.98
6830,10/16/2020,10/16/2020,Alan Safran,Imported from reimbursements-Background checks for fellows,D102,HJ,5.19,,20813.17
6830,10/16/2020,10/16/2020,Alan Safran,Imported from reimbursements-Background checks for fellows,D102,HJ,5.19,,20818.36
6830,10/16/2020,10/16/2020,Alan Safran,Imported from reimbursements-Background checks for fellows,D102,HJ,16.77,,20835.13
6830,10/16/2020,10/16/2020,Alan Safran,Imported from reimbursements-Background checks for fellows,D102,HJ,16.77,,20851.9
6830,10/16/2020,10/16/2020,Alexander Kiley,Bill.Com Import-Reimbursement Request form,D104,HJ,62.31,,20914.21
6830,10/22/2020,10/22/2020,ACCURATE BIOMETRICS,Bill.Com Import-Fingerprinting services for fellows - Chicago,D104,HJ,903.75,,21817.96
6830,10/27/2020,10/27/2020,Alan Safran,Imported from reimbursements-Background checks for fellows,D102,HJ,3.36,,21821.32
6830,10/27/2020,10/27/2020,Alan Safran,Imported from reimbursements-Background checks for fellows,D102,HJ,5.18,,21826.5
6830,10/27/2020,10/27/2020,Alan Safran,Imported from reimbursements-Background checks for fellows,D102,HJ,5.19,,21831.69
6830,10/27/2020,10/27/2020,Alan Safran,Imported from reimbursements-Background checks for fellows,D102,HJ,16.77,,21848.46
6830,10/27/2020,10/27/2020,Kennaisiya Miller,Bill.Com Import-Background Checks,D104,HJ,10.99,,21859.45
6830,10/28/2020,10/28/2020,Alan Safran,Imported from reimbursements-Background checks for fellows,D102,HJ,4.62,,21864.07
6830,10/28/2020,10/28/2020,Alan Safran,Imported from reimbursements-Background checks for fellows,D102,HJ,7.14,,21871.21
6830,10/28/2020,10/28/2020,Alan Safran,Imported from reimbursements-Background checks for fellows,D102,HJ,7.14,,21878.35
6830,10/28/2020,10/28/2020,Alan Safran,Imported from reimbursements-Background checks for fellows,D102,HJ,23.1,,21901.45
6830,11/4/2020,11/4/2020,Kelly Silver,Bill.Com Import-Fieldprint Fingerprinting for Broward County Public School,D104,HJ,73.5,,21974.95
6830,11/19/2020,11/19/2020,ACCURATE BIOMETRICS,Bill.Com Import-Fingerprinting services for fellows CHI,D104,HJ,241,,22215.95
6830,12/31/2020,12/31/2020,20201231,Statement of Functional Activities Reclass-Statement of Functional Activities Reclass,D108,HJ,,15960.65,6255.3
6830,12/31/2020,12/31/2020,20201231,Statement of Functional Activities Reclass-Statement of Functional Activities Reclass,D108,HJ,15960.65,,22215.95
6830,12/31/2020,12/31/2020,20201231,Actual vs Budget Reclass as of 12/31/2020-Actual vs Budget Reclass as of 12/31/2020,D102,HJ,,15960.65,6255.3
6830,12/31/2020,12/31/2020,20201231,Actual vs Budget Reclass as of 12/31/2020-Actual vs Budget Reclass as of 12/31/2020,D104,HJ,143.75,,6399.05
6830,12/31/2020,12/31/2020,20201231,Actual vs Budget Reclass as of 12/31/2020-Actual vs Budget Reclass as of 12/31/2020,D104,HJ,4820,,11219.05
6830,12/31/2020,12/31/2020,20201231,Actual vs Budget Reclass as of 12/31/2020-Actual vs Budget Reclass as of 12/31/2020,D104,HJ,15960.65,,27179.7
6830,12/31/2020,12/31/2020,20201231,Actual vs Budget Reclass as of 12/31/2020-Actual vs Budget Reclass as of 12/31/2020,D108,HJ,,143.75,27035.95
6830,12/31/2020,12/31/2020,20201231,Actual vs Budget Reclass as of 12/31/2020-Actual vs Budget Reclass as of 12/31/2020,D111,HJ,,4820,22215.95
6830,1/4/2021,1/4/2021,Alan Safran,Imported from Bank of America Visa-Background Check for fellow Chicago,D104,HJ,7.5,,22223.45
6830,1/12/2021,1/12/2021,Alan Safran,Imported from Bank of America Visa-Background Check Field Print for Christian Kibingwa,D104,HJ,28.75,,22252.2
6830,1/18/2021,1/18/2021,Alan Safran,Imported from Bank of America Visa-Background Check for Christian Kibingwa,D104,HJ,36.5,,22288.7
6830,1/27/2021,1/27/2021,Alan Safran,Imported from Bank of America Visa-Background Check Field Print for Bao Khanh Cu,D104,HJ,28.75,,22317.45
6830,1/27/2021,1/27/2021,Alan Safran,Imported from Bank of America Visa-Background Check Field Print for Ethan Purcell,D104,HJ,28.75,,22346.2
6830,1/27/2021,1/27/2021,Alan Safran,Imported from Bank of America Visa-Background Check Field Print for Rangai Elena,D104,HJ,28.75,,22374.95
6830,1/28/2021,1/28/2021,Alan Safran,Imported from Bank of America Visa-Background Check for Elena Rangai,D104,HJ,36.5,,22411.45
6830,1/29/2021,1/29/2021,Alan Safran,Imported from Bank of America Visa-Background Check Field Print for Victoria Warren,D104,HJ,28.75,,22440.2
6830,2/1/2021,2/1/2021,Alan Safran,Imported from Bank of America Visa-Background Check for Bao Khanh Cu,D104,HJ,36.5,,22476.7
6830,2/2/2021,2/2/2021,Alan Safran,Imported from Bank of America Visa-Background Check for Ethan Purcell,D104,HJ,36.5,,22513.2
6830,2/4/2021,2/4/2021,Alan Safran,Imported from Bank of America Visa-Background Check for Victoria Warren,D104,HJ,36.5,,22549.7
6830,2/8/2021,2/8/2021,Alan Safran,Imported from Bank of America Visa-Background Check for Baljit Saini,D104,HJ,50.5,,22600.2
6830,2/22/2021,2/22/2021,ACCURATE BIOMETRICS,Bill.Com Import-Fingerprinting services for fellows CHI,D104,HJ,120.5,,22720.7
6830,2/25/2021,2/25/2021,Alan Safran,Imported from Bank of America Visa-Background Check for Marta Sidorek,D104,HJ,50.5,,22771.2
6830,3/1/2021,3/1/2021,Alan Safran,Imported from Bank of America Visa,D104,HJ,166,,22937.2
6830,3/2/2021,3/2/2021,ACCURATE BIOMETRICS,Bill.Com Import,D104,HJ,180.75,,23117.95
6830,3/10/2021,3/10/2021,Alan Safran,Imported from Bank of America Visa,D104,HJ,70,,23187.95
6830,3/24/2021,3/24/2021,Alan Safran,Imported from Bank of America Visa,D104,HJ,50.5,,23238.45
6830,5/4/2021,5/4/2021,Alan Safran,Imported from Bank of America Visa,D104,HJ,27.75,,23266.2
6830,5/5/2021,5/5/2021,Alan Safran,Imported from Bank of America Visa,D104,HJ,36.5,,23302.7
6830,5/25/2021,5/25/2021,Alan Safran,Imported from Bank of America Visa,D104,HJ,27.75,,23330.45
6830,5/26/2021,5/26/2021,Alan Safran,Imported from Bank of America Visa,D104,HJ,27.75,,23358.2
6830,5/26/2021,5/26/2021,Alan Safran,Imported from Bank of America Visa,D104,HJ,27.75,,23385.95
6830,5/26/2021,5/26/2021,Alan Safran,Imported from Bank of America Visa,D104,HJ,27.75,,23413.7
6830,5/26/2021,5/26/2021,Alan Safran,Imported from Bank of America Visa,D104,HJ,36.5,,23450.2
6830,5/26/2021,5/26/2021,Alan Safran,Imported from Bank of America Visa,D104,HJ,27.75,,23477.95
6830,5/28/2021,5/28/2021,Alan Safran,Imported from Bank of America Visa,D104,HJ,27.75,,23505.7
6830,5/28/2021,5/28/2021,Alan Safran,Imported from Bank of America Visa,D104,HJ,27.75,,23533.45
6830,5/28/2021,5/28/2021,Alan Safran,Imported from Bank of America Visa,D104,HJ,78,,23611.45
6830,5/28/2021,5/28/2021,Alan Safran,Imported from Bank of America Visa,D104,HJ,36.5,,23647.95
6830,5/30/2021,5/30/2021,Alan Safran,Imported from Bank of America Visa,D104,HJ,27.75,,23675.7
6830,6/1/2021,6/1/2021,Alan Safran,Imported from Bank of America Visa,D104,HJ,61,,23736.7
6830,6/2/2021,6/2/2021,Alan Safran,Imported from Bank of America Visa,D104,HJ,27.75,,23764.45
6830,6/2/2021,6/2/2021,Alan Safran,Imported from Bank of America Visa,D104,HJ,27.75,,23792.2
6830,6/2/2021,6/2/2021,Alan Safran,Imported from Bank of America Visa,D104,HJ,27.75,,23819.95
6830,6/2/2021,6/2/2021,Alan Safran,Imported from Bank of America Visa,D104,HJ,58,,23877.95
6830,6/2/2021,6/2/2021,Alan Safran,Imported from Bank of America Visa,D104,HJ,66,,23943.95
6830,6/2/2021,6/2/2021,Alan Safran,Imported from Bank of America Visa,D104,HJ,26.5,,23970.45
6830,6/4/2021,6/4/2021,Alan Safran,Imported from Bank of America Visa,D104,HJ,27.75,,23998.2
6830,6/4/2021,6/4/2021,Alan Safran,Imported from Bank of America Visa,D104,HJ,27.75,,24025.95
6830,6/4/2021,6/4/2021,Alan Safran,Imported from Bank of America Visa,D104,HJ,27.75,,24053.7
6830,6/4/2021,6/4/2021,Alan Safran,Imported from Bank of America Visa,D104,HJ,27.75,,24081.45
6830,6/4/2021,6/4/2021,Alan Safran,Imported from Bank of America Visa,D104,HJ,27.75,,24109.2
6830,6/4/2021,6/4/2021,Alan Safran,Imported from Bank of America Visa,D104,HJ,27.75,,24136.95
6830,6/4/2021,6/4/2021,Alan Safran,Imported from Bank of America Visa,D108,HJ,51.5,,24188.45
6830,6/7/2021,6/7/2021,Alan Safran,Imported from Bank of America Visa,D104,HJ,36.5,,24224.95
6830,6/7/2021,6/7/2021,Alan Safran,Imported from Bank of America Visa,D104,HJ,36.5,,24261.45
6830,6/7/2021,6/7/2021,Alan Safran,Imported from Bank of America Visa,D104,HJ,46,,24307.45
6830,6/8/2021,6/8/2021,Alan Safran,Imported from Bank of America Visa,D104,HJ,27.75,,24335.2
6830,6/8/2021,6/8/2021,Alan Safran,Imported from Bank of America Visa,D104,HJ,36.5,,24371.7
6830,6/8/2021,6/8/2021,Alan Safran,Imported from Bank of America Visa,D104,HJ,36.5,,24408.2
6830,6/8/2021,6/8/2021,Alan Safran,Imported from Bank of America Visa,D104,HJ,51.5,,24459.7
6830,6/8/2021,6/8/2021,Alan Safran,Imported from Bank of America Visa,D104,HJ,27.75,,24487.45
6830,6/8/2021,6/8/2021,Alan Safran,Imported from Bank of America Visa,D104,HJ,27.75,,24515.2
6830,6/10/2021,6/10/2021,Alan Safran,Imported from Bank of America Visa,D104,HJ,27.75,,24542.95
6830,6/10/2021,6/10/2021,Alan Safran,Imported from Bank of America Visa,D104,HJ,27.75,,24570.7
6830,6/10/2021,6/10/2021,Alan Safran,Imported from Bank of America Visa,D104,HJ,27.75,,24598.45
6830,6/10/2021,6/10/2021,Alan Safran,Imported from Bank of America Visa,D104,HJ,36.5,,24634.95
6830,6/10/2021,6/10/2021,Alan Safran,Imported from Bank of America Visa,D104,HJ,36.5,,24671.45
6830,6/10/2021,6/10/2021,Alan Safran,Imported from Bank of America Visa,D104,HJ,36.5,,24707.95
6830,6/10/2021,6/10/2021,Alan Safran,Imported from Bank of America Visa,D104,HJ,51.5,,24759.45
6830,6/10/2021,6/10/2021,Alan Safran,Imported from Bank of America Visa,D104,HJ,56,,24815.45
6830,6/10/2021,6/10/2021,Alan Safran,Imported from Bank of America Visa,D104,HJ,152,,24967.45
6830,6/11/2021,6/11/2021,Alan Safran,Imported from Bank of America Visa,D104,HJ,27.75,,24995.2
6830,6/14/2021,6/14/2021,Alan Safran,Imported from Bank of America Visa,D104,HJ,36.5,,25031.7
6830,6/14/2021,6/14/2021,Alan Safran,Imported from Bank of America Visa,D104,HJ,36.5,,25068.2
6830,6/14/2021,6/14/2021,Alan Safran,Imported from Bank of America Visa,D104,HJ,36.5,,25104.7
6830,6/14/2021,6/14/2021,Alan Safran,Imported from Bank of America Visa,D104,HJ,66,,25170.7
6830,6/14/2021,6/14/2021,Alan Safran,Imported from Bank of America Visa,D104,HJ,49.15,,25219.85
6830,6/15/2021,6/15/2021,Alan Safran,Imported from Bank of America Visa,D104,HJ,27.75,,25247.6
6830,6/15/2021,6/15/2021,Alan Safran,Imported from Bank of America Visa,D104,HJ,36.5,,25284.1
6830,6/16/2021,6/16/2021,Alan Safran,Imported from Bank of America Visa,D104,HJ,27.75,,25311.85
6830,6/16/2021,6/16/2021,Alan Safran,Imported from Bank of America Visa,D104,HJ,27.75,,25339.6
6830,6/16/2021,6/16/2021,Alan Safran,Imported from Bank of America Visa,D104,HJ,27.75,,25367.35
6830,6/16/2021,6/16/2021,Alan Safran,Imported from Bank of America Visa,D104,HJ,36.5,,25403.85
6830,6/16/2021,6/16/2021,Alan Safran,Imported from Bank of America Visa,D104,HJ,36.5,,25440.35
6830,6/16/2021,6/16/2021,Alan Safran,Imported from Bank of America Visa,D104,HJ,36.5,,25476.85
6830,6/16/2021,6/16/2021,Alan Safran,Imported from Bank of America Visa,D104,HJ,26.5,,25503.35
6830,6/17/2021,6/17/2021,Alan Safran,Imported from Bank of America Visa,D104,HJ,27.75,,25531.1
6830,6/17/2021,6/17/2021,Alan Safran,Imported from Bank of America Visa,D104,HJ,36.5,,25567.6
6830,6/17/2021,6/17/2021,Alan Safran,Imported from Bank of America Visa,D104,HJ,48,,25615.6
6830,6/18/2021,6/18/2021,Alan Safran,Imported from Bank of America Visa,D104,HJ,27.75,,25643.35
6830,6/18/2021,6/18/2021,Alan Safran,Imported from Bank of America Visa,D104,HJ,36.5,,25679.85
6830,6/18/2021,6/18/2021,Alan Safran,Imported from Bank of America Visa,D104,HJ,36.5,,25716.35
6830,6/18/2021,6/18/2021,Alan Safran,Imported from Bank of America Visa,D104,HJ,26.5,,25742.85
6830,6/21/2021,6/21/2021,ACCURATE BIOMETRICS,Bill.Com Import,D104,HJ,120.5,,25863.35
6830,6/21/2021,6/21/2021,Alan Safran,Imported from Bank of America Visa,D104,HJ,78,,25941.35
6830,6/22/2021,6/22/2021,Alan Safran,Imported from Bank of America Visa,D104,HJ,71,,26012.35
6830,6/22/2021,6/22/2021,Alan Safran,Imported from Bank of America Visa,D104,HJ,78,,26090.35
6830,6/23/2021,6/23/2021,Alan Safran,Imported from Bank of America Visa,D104,HJ,68,,26158.35
6830,6/24/2021,6/24/2021,Alan Safran,Imported from Bank of America Visa,D104,HJ,36.5,,26194.85
6830,6/28/2021,6/28/2021,Alan Safran,Imported from Bank of America Visa,D104,HJ,27.75,,26222.6
6830,6/28/2021,6/28/2021,Alan Safran,Imported from Bank of America Visa,D104,HJ,27.75,,26250.35
6830,6/28/2021,6/28/2021,Alan Safran,Imported from Bank of America Visa,D104,HJ,27.75,,26278.1
6830,6/28/2021,6/28/2021,Alan Safran,Imported from Bank of America Visa,D104,HJ,36.5,,26314.6
6830,6/30/2021,6/30/2021,ACCURATE BIOMETRICS,Bill.Com Import,D104,HJ,1385.75,,27700.35
6830,6/30/2021,6/30/2021,Alan Safran,Imported from Bank of America Visa,D104,HJ,27.75,,27728.1
6830,6/30/2021,6/30/2021,Alan Safran,Imported from Bank of America Visa,D104,HJ,27.75,,27755.85
6830,6/30/2021,6/30/2021,Alan Safran,Imported from Bank of America Visa,D104,HJ,27.75,,27783.6
6830, Totals for 6830 - Background Checks for AmeriCorps Fellows,,,,,,64798.65,37015.05,27783.6
6840,"6840 - Insurances -Commercial, package, Cyber Liability, Directors, Officer's, etc. (Balance forward As of 07/01/2020) ",,,,,,,,0
6840,7/31/2020,7/31/2020,Amortization,To expense prepaid X Co.  Cyber Insurance-To expense prepaid X Co.  Cyber insurance,D107,HJ,783.47,,783.47
6840,8/31/2020,8/31/2020,Amortization,To expense prepaid X Co.  Cyber Insurance-To expense prepaid X Co.  Cyber insurance,D107,HJ,783.47,,1566.94
6840,9/30/2020,9/30/2020,Amortization,To expense prepaid X Co.  Cyber Insurance-To expense prepaid X Co.  Cyber insurance,D107,HJ,783.47,,2350.41
6840,10/9/2020,10/9/2020,Banner Life Ins,Bill.Com Import-Life Insurance for Chris Dupis Policy 181327064,D107,HJ,479.99,,2830.4
6840,10/31/2020,10/31/2020,Ins amortization,To expense prepaid X Co.  Cyber & Commercial Umbrella insurance-To expense prepaid X Co.  Commercial Umbrella insurance,D107,HJ,1954.75,,4785.15
6840,10/31/2020,10/31/2020,Ins amortization,To expense prepaid X Co.  Cyber & Commercial Umbrella insurance-To expense prepaid X Co.  Cyber insurance,D107,HJ,783.47,,5568.62
6840,11/30/2020,11/30/2020,Ins amortization,To expense prepaid X Co.  Cyber & Commercial Umbrella insurance-To expense prepaid X Co.  Commercial Umbrella insurance,D107,HJ,1954.75,,7523.37
6840,11/30/2020,11/30/2020,Ins amortization,To expense prepaid X Co.  Cyber & Commercial Umbrella insurance-To expense prepaid X Co.  Cyber insurance,D107,HJ,783.47,,8306.84
6840,12/31/2020,12/31/2020,Ins amortization,To expense prepaid X Co.  Cyber & Commercial Umbrella insurance-To expense prepaid X Co.  Commercial Umbrella insurance,D107,HJ,1954.75,,10261.59
6840,12/31/2020,12/31/2020,Ins amortization,To expense prepaid X Co.  Cyber & Commercial Umbrella insurance-To expense prepaid X Co.  Cyber insurance,D107,HJ,783.47,,11045.06
6840,1/12/2021,1/12/2021,3JB-156 2021,Bill.Com Import-A. Gutierrez and A. Safran life insurance annul premiums,D107,HJ,2188,,13233.06
6840,1/31/2021,1/31/2021,3Q Expense,To expense prepaid Commercial Umbrella insurance-To expense prepaid Commercial Umbrella insurance,D107,HJ,1954.75,,15187.81
6840,1/31/2021,1/31/2021,Ins amortization,To expense prepaid X Co.  Cyber & Commercial Umbrella insurance-To expense prepaid X Co.  Cyber insurance,D107,HJ,783.47,,15971.28
6840,2/28/2021,2/28/2021,3Q Expense,To expense prepaid Commercial Umbrella insurance-To expense prepaid Commercial Umbrella insurance,D107,HJ,1954.75,,17926.03
6840,2/28/2021,2/28/2021,Ins amortization,To expense prepaid X Co.  Cyber & Commercial Umbrella insurance-To expense prepaid X Co.  Cyber insurance,D107,HJ,783.47,,18709.5
6840,3/31/2021,3/31/2021,3Q Expense,To expense prepaid Commercial Umbrella insurance,D107,HJ,1954.75,,20664.25
6840,3/31/2021,3/31/2021,Ins amortization,To expense prepaid X Co.  Cyber & Commercial Umbrella insurance,D107,HJ,783.47,,21447.72
6840,4/23/2021,4/23/2021,The Hanover Ins,Bill.Com Import,D107,HJ,194,,21641.72
6840,4/30/2021,4/30/2021,4Q Expense,To expense prepaid commercial umbrella insurance,D107,HJ,1954.75,,23596.47
6840,4/30/2021,4/30/2021,CPS-OPSCH006,To expense prepaid X Co.  Cyber & Commercial Umbrella insurance,D107,HJ,783.47,,24379.94
6840,5/31/2021,5/31/2021,20210531,To expense prepaid commercial umbrella insurance,D107,HJ,1954.75,,26334.69
6840,5/31/2021,5/31/2021,ARIF-20210602,To expense prepaid X Co.  Cyber & Commercial Umbrella insurance,D107,HJ,783.47,,27118.16
6840,6/30/2021,6/30/2021,63021,To expense prepaid X Co.  Cyber & Commercial Umbrella insurance,D107,HJ,783.47,,27901.63
6840,6/30/2021,6/30/2021,20210630,To expense prepaid commercial umbrella insurance,D107,HJ,1954.75,,29856.38
6840," Totals for 6840 - Insurances -Commercial, package, Cyber Liability, Directors, Officer's, etc.",,,,,,29856.38,0,29856.38
6850,6850 - AmeriCorps Fellows Payroll Processing Fees (Balance forward As of 07/01/2020) ,,,,,,,,0
6850,7/6/2020,7/6/2020,HRKnowledge,To record HR Outsourcing Admin fee-To record HR Outsourcing Admin fee for fellows,D108,HJ,200.6,,200.6
6850,7/6/2020,7/6/2020,HRKnowledge,To record HR Outsourcing Admin fee-To record HR Outsourcing Admin fee for fellows,D108,HJ,649,,849.6
6850,7/6/2020,7/6/2020,HRKnowledge,To record HR Outsourcing Admin fee-To record HR Outsourcing Admin fee for fellows,D108,HJ,200.6,,1050.2
6850,7/6/2020,7/6/2020,HRKnowledge,To record HR Outsourcing Admin fee-To record HR Outsourcing Admin fee for fellows,D108,HJ,129.8,,1180
6850,7/10/2020,7/10/2020,ADP,To record PR expenses for staff and fellows-To record PR expenses for staff and fellows,D108,HJ,93.34,,1273.34
6850,7/10/2020,7/10/2020,ADP,To record PR expenses for staff and fellows-To record PR expenses for staff and fellows,D108,HJ,301.98,,1575.32
6850,7/10/2020,7/10/2020,ADP,To record PR expenses for staff and fellows-To record PR expenses for staff and fellows,D108,HJ,93.34,,1668.66
6850,7/10/2020,7/10/2020,ADP,To record PR expenses for staff and fellows-To record PR expenses for staff and fellows,D108,HJ,60.39,,1729.05
6850,7/31/2020,7/31/2020,July,To correct the department coding for July August September-To correct the department coding for July,D104,HJ,293.94,,2022.99
6850,7/31/2020,7/31/2020,July,To correct the department coding for July August September-To correct the department coding for July,D108,HJ,,293.94,1729.05
6850,7/31/2020,7/31/2020,July,To correct the department coding for July August September-To correct the department coding for July,D104,HJ,950.98,,2680.03
6850,7/31/2020,7/31/2020,July,To correct the department coding for July August September-To correct the department coding for July,D108,HJ,,950.98,1729.05
6850,7/31/2020,7/31/2020,July,To correct the department coding for July August September-To correct the department coding for July,D104,HJ,293.94,,2022.99
6850,7/31/2020,7/31/2020,July,To correct the department coding for July August September-To correct the department coding for July,D108,HJ,,293.94,1729.05
6850,7/31/2020,7/31/2020,July,To correct the department coding for July August September-To correct the department coding for July,D104,HJ,190.19,,1919.24
6850,7/31/2020,7/31/2020,July,To correct the department coding for July August September-To correct the department coding for July,D108,HJ,,190.19,1729.05
6850,8/18/2020,8/18/2020,HRKnowledge,HR Outsourcing admin fee-HR Outsourcing admin fee,D108,HJ,181.9,,1910.95
6850,8/18/2020,8/18/2020,HRKnowledge,HRK Admin fee PD8/14-HRK Admin fee PD8/14,D108,HJ,27.2,,1938.15
6850,8/18/2020,8/18/2020,HRKnowledge,HR Outsourcing admin fee-HR Outsourcing admin fee,D108,HJ,588.5,,2526.65
6850,8/18/2020,8/18/2020,HRKnowledge,HRK Admin fee PD8/14-HRK Admin fee PD8/14,D108,HJ,88,,2614.65
6850,8/18/2020,8/18/2020,HRKnowledge,HR Outsourcing admin fee-HR Outsourcing admin fee,D108,HJ,181.9,,2796.55
6850,8/18/2020,8/18/2020,HRKnowledge,HRK Admin fee PD8/14-HRK Admin fee PD8/14,D108,HJ,27.2,,2823.75
6850,8/18/2020,8/18/2020,HRKnowledge,HR Outsourcing admin fee-HR Outsourcing admin fee,D108,HJ,117.7,,2941.45
6850,8/18/2020,8/18/2020,HRKnowledge,HRK Admin fee PD8/14-HRK Admin fee PD8/14,D108,HJ,17.6,,2959.05
6850,8/29/2020,8/29/2020,HRKnowledge,Setup of onboarding expenses for fellows and staffs-Setup of onboarding expenses for fellows,D104,HJ,1695.75,,4654.8
6850,8/29/2020,8/29/2020,HRKnowledge,Setup of onboarding expenses for fellows and staffs-Setup of onboarding expenses for fellows,D104,HJ,5486.25,,10141.05
6850,8/29/2020,8/29/2020,HRKnowledge,Setup of onboarding expenses for fellows and staffs-Setup of onboarding expenses for fellows and staffs,D104,HJ,3325,,13466.05
6850,8/29/2020,8/29/2020,HRKnowledge,Setup of onboarding expenses for fellows and staffs-Setup of onboarding expenses for fellows and staffs,D104,HJ,3325,,16791.05
6850,8/29/2020,8/29/2020,HRKnowledge,Setup of onboarding expenses for fellows and staffs-Setup of onboarding expenses for fellows,D104,HJ,1695.75,,18486.8
6850,8/29/2020,8/29/2020,HRKnowledge,Setup of onboarding expenses for fellows and staffs-Setup of onboarding expenses for fellows,D104,HJ,1097.25,,19584.05
6850,8/31/2020,8/31/2020,August,To correct the department coding for July August September-To correct the department coding for July August September,D104,HJ,209.1,,19793.15
6850,8/31/2020,8/31/2020,August,To correct the department coding for July August September-To correct the department coding for July August September,D108,HJ,,209.1,19584.05
6850,8/31/2020,8/31/2020,August,To correct the department coding for July August September-To correct the department coding for July August September,D104,HJ,676.5,,20260.55
6850,8/31/2020,8/31/2020,August,To correct the department coding for July August September-To correct the department coding for July August September,D108,HJ,,676.5,19584.05
6850,8/31/2020,8/31/2020,August,To correct the department coding for July August September-To correct the department coding for July August September,D104,HJ,209.1,,19793.15
6850,8/31/2020,8/31/2020,August,To correct the department coding for July August September-To correct the department coding for July August September,D108,HJ,,209.1,19584.05
6850,8/31/2020,8/31/2020,August,To correct the department coding for July August September-To correct the department coding for July August September,D104,HJ,135.3,,19719.35
6850,8/31/2020,8/31/2020,August,To correct the department coding for July August September-To correct the department coding for July August September,D108,HJ,,135.3,19584.05
6850,9/2/2020,9/2/2020,HRKnowledge,HR Outsourcing admin fee-HR Outsourcing admin fee for fellows-pd 8/31,D108,HJ,212.5,,19796.55
6850,9/2/2020,9/2/2020,HRKnowledge,HR Outsourcing admin fee-HR Outsourcing admin fee for fellows-pd 8/31,D108,HJ,687.5,,20484.05
6850,9/2/2020,9/2/2020,HRKnowledge,HR Outsourcing admin fee-HR Outsourcing admin fee for fellows-pd 8/31,D108,HJ,212.5,,20696.55
6850,9/2/2020,9/2/2020,HRKnowledge,HR Outsourcing admin fee-HR Outsourcing admin fee for fellows-pd 8/31,D108,HJ,137.5,,20834.05
6850,9/11/2020,9/11/2020,ADP,ADP PR process fees for fellows-ADP PR process fees for fellows,D108,HJ,85.84,,20919.89
6850,9/11/2020,9/11/2020,ADP,ADP PR process fees for fellows-ADP PR process fees for fellows,D108,HJ,277.73,,21197.62
6850,9/11/2020,9/11/2020,ADP,ADP PR process fees for fellows-ADP PR process fees for fellows,D108,HJ,85.84,,21283.46
6850,9/11/2020,9/11/2020,ADP,ADP PR process fees for fellows-ADP PR process fees for fellows,D108,HJ,55.54,,21339
6850,9/22/2020,9/22/2020,HRKnowledge,Setup of ADP pre-hire onboarding-Setup of ADP pre-hire onboarding,D108,HJ,637.93,,21976.93
6850,9/22/2020,9/22/2020,HRKnowledge,HRK admin fee for fellows-HRK admin fee for fellows,D108,HJ,209.1,,22186.03
6850,9/22/2020,9/22/2020,HRKnowledge,Setup of ADP pre-hire onboarding-Setup of ADP pre-hire onboarding,D108,HJ,2063.88,,24249.91
6850,9/22/2020,9/22/2020,HRKnowledge,HRK admin fee for fellows-HRK admin fee for fellows,D108,HJ,676.5,,24926.41
6850,9/22/2020,9/22/2020,HRKnowledge,Setup of ADP pre-hire onboarding-Setup of ADP pre-hire onboarding,D108,HJ,637.93,,25564.34
6850,9/22/2020,9/22/2020,HRKnowledge,HRK admin fee for fellows-HRK admin fee for fellows,D108,HJ,209.1,,25773.44
6850,9/22/2020,9/22/2020,HRKnowledge,Setup of ADP pre-hire onboarding-Setup of ADP pre-hire onboarding,D108,HJ,412.76,,26186.2
6850,9/22/2020,9/22/2020,HRKnowledge,HRK admin fee for fellows-HRK admin fee for fellows,D108,HJ,135.3,,26321.5
6850,9/30/2020,9/30/2020,September,To correct the department coding for July August September-To correct the department coding for July August September,D104,HJ,1145.37,,27466.87
6850,9/30/2020,9/30/2020,September,To correct the department coding for July August September-To correct the department coding for July August September,D108,HJ,,1145.37,26321.5
6850,9/30/2020,9/30/2020,September,To correct the department coding for July August September-To correct the department coding for July August September,D104,HJ,3705.61,,30027.11
6850,9/30/2020,9/30/2020,September,To correct the department coding for July August September-To correct the department coding for July August September,D108,HJ,,3705.61,26321.5
6850,9/30/2020,9/30/2020,September,To correct the department coding for July August September-To correct the department coding for July August September,D104,HJ,1145.37,,27466.87
6850,9/30/2020,9/30/2020,September,To correct the department coding for July August September-To correct the department coding for July August September,D108,HJ,,1145.37,26321.5
6850,9/30/2020,9/30/2020,September,To correct the department coding for July August September-To correct the department coding for July August September,D104,HJ,741.1,,27062.6
6850,9/30/2020,9/30/2020,September,To correct the department coding for July August September-To correct the department coding for July August September,D108,HJ,,741.1,26321.5
6850,10/5/2020,10/5/2020,HRKnowledge,HR Outsourcing admin fee for fellows-HR Outsourcing admin fee for fellows PD9/30,D104,HJ,207.4,,26528.9
6850,10/5/2020,10/5/2020,HRKnowledge,HR Outsourcing admin fee for fellows-HR Outsourcing admin fee for fellows PD9/30,D104,HJ,671,,27199.9
6850,10/5/2020,10/5/2020,HRKnowledge,HR Outsourcing admin fee for fellows-HR Outsourcing admin fee for fellows PD9/30,D104,HJ,207.4,,27407.3
6850,10/5/2020,10/5/2020,HRKnowledge,HR Outsourcing admin fee for fellows-HR Outsourcing admin fee for fellows PD9/30,D104,HJ,134.2,,27541.5
6850,10/9/2020,10/9/2020,ADP,ADP payroll services fee for fellows-ADP payroll services fee for fellows,D104,HJ,121.01,,27662.51
6850,10/9/2020,10/9/2020,ADP,ADP payroll services fee for fellows-ADP payroll services fee for fellows,D104,HJ,391.53,,28054.04
6850,10/9/2020,10/9/2020,ADP,ADP payroll services fee for fellows-ADP payroll services fee for fellows,D104,HJ,121.01,,28175.05
6850,10/9/2020,10/9/2020,ADP,ADP payroll services fee for fellows-ADP payroll services fee for fellows,D104,HJ,78.3,,28253.35
6850,10/26/2020,10/26/2020,HRKnowledge,HR outsourcing admin fee for fellows PD10/15-HR outsourcing admin fee for fellows PD10/15,D104,HJ,205.7,,28459.05
6850,10/26/2020,10/26/2020,HRKnowledge,HR outsourcing admin fee for fellows PD10/15-HR outsourcing admin fee for fellows PD10/15,D104,HJ,665.5,,29124.55
6850,10/26/2020,10/26/2020,HRKnowledge,HR outsourcing admin fee for fellows PD10/15-HR outsourcing admin fee for fellows PD10/15,D104,HJ,205.7,,29330.25
6850,10/26/2020,10/26/2020,HRKnowledge,HR outsourcing admin fee for fellows PD10/15-HR outsourcing admin fee for fellows PD10/15,D104,HJ,133.1,,29463.35
6850,11/6/2020,11/6/2020,ADP,ADP PR process fees for fellows-ADP PR process fees for fellows,D104,HJ,147.13,,29610.48
6850,11/6/2020,11/6/2020,ADP,ADP PR process fees for fellows-ADP PR process fees for fellows,D104,HJ,476,,30086.48
6850,11/6/2020,11/6/2020,ADP,ADP PR process fees for fellows-ADP PR process fees for fellows,D104,HJ,147.13,,30233.61
6850,11/6/2020,11/6/2020,ADP,ADP PR process fees for fellows-ADP PR process fees for fellows,D104,HJ,95.19,,30328.8
6850,11/9/2020,11/9/2020,HRKnowledge,HR admin fee for fellows PD10-30-HR admin fee for fellows PD10-30,D104,HJ,215.9,,30544.7
6850,11/9/2020,11/9/2020,HRKnowledge,HR admin fee for fellows PD10-30-HR admin fee for fellows PD10-30,D104,HJ,698.5,,31243.2
6850,11/9/2020,11/9/2020,HRKnowledge,HR admin fee for fellows PD10-30-HR admin fee for fellows PD10-30,D104,HJ,215.9,,31459.1
6850,11/9/2020,11/9/2020,HRKnowledge,HR admin fee for fellows PD10-30-HR admin fee for fellows PD10-30,D104,HJ,139.7,,31598.8
6850,11/18/2020,11/18/2020,HRKnowledge,HR Outsourcing admin fee-HR Outsourcing admin fee for fellows PD11/15,D104,HJ,212.5,,31811.3
6850,11/18/2020,11/18/2020,HRKnowledge,HR Outsourcing admin fee-HR Outsourcing admin fee for fellows PD11/15,D104,HJ,687.5,,32498.8
6850,11/18/2020,11/18/2020,HRKnowledge,HR Outsourcing admin fee-HR Outsourcing admin fee for fellows PD11/15,D104,HJ,212.5,,32711.3
6850,11/18/2020,11/18/2020,HRKnowledge,HR Outsourcing admin fee-HR Outsourcing admin fee for fellows PD11/15,D104,HJ,137.5,,32848.8
6850,12/1/2020,12/1/2020,20201201,To move revenue and expenses from discontinued grants-To move expenses from NYDOE to G-OM,D108,HJ,,200.6,32648.2
6850,12/1/2020,12/1/2020,20201201,To move revenue and expenses from discontinued grants-To move expenses from NYDOE to G-OM,D108,HJ,200.6,,32848.8
6850,12/7/2020,12/7/2020,HRKnowledge,To record HR admin fee for fellows PD11/30-To record HR admin fee for fellows PD11/30,D104,HJ,212.5,,33061.3
6850,12/7/2020,12/7/2020,HRKnowledge,To record HR admin fee for fellows PD11/30-To record HR admin fee for fellows PD11/30,D104,HJ,687.5,,33748.8
6850,12/7/2020,12/7/2020,HRKnowledge,To record HR admin fee for fellows PD11/30-To record HR admin fee for fellows PD11/30,D104,HJ,212.5,,33961.3
6850,12/7/2020,12/7/2020,HRKnowledge,To record HR admin fee for fellows PD11/30-To record HR admin fee for fellows PD11/30,D104,HJ,137.5,,34098.8
6850,12/11/2020,12/11/2020,ADP,ADP invoices for December-ADP invoices for staff for December,D104,HJ,117.99,,34216.79
6850,12/11/2020,12/11/2020,ADP,ADP invoices for December-ADP invoices for staff for December,D104,HJ,381.73,,34598.52
6850,12/11/2020,12/11/2020,ADP,ADP invoices for December-ADP invoices for staff for December,D104,HJ,117.99,,34716.51
6850,12/11/2020,12/11/2020,ADP,ADP invoices for December-ADP invoices for staff for December,D104,HJ,76.34,,34792.85
6850,12/18/2020,12/18/2020,HRKnowledge,HR Outsourcing admin fee for staff and fellows-HR Outsourcing admin fee for fellows PD12/15,D104,HJ,212.5,,35005.35
6850,12/18/2020,12/18/2020,HRKnowledge,HR Outsourcing admin fee for staff and fellows-HR Outsourcing admin fee for fellows PD12/15,D104,HJ,687.5,,35692.85
6850,12/18/2020,12/18/2020,HRKnowledge,HR Outsourcing admin fee for staff and fellows-HR Outsourcing admin fee for fellows PD12/15,D104,HJ,212.5,,35905.35
6850,12/18/2020,12/18/2020,HRKnowledge,HR Outsourcing admin fee for staff and fellows-HR Outsourcing admin fee for fellows PD12/15,D104,HJ,137.5,,36042.85
6850,1/5/2021,1/5/2021,HRKnowledge,To Record HR Admin Fee for Fellow PD12/31-To Record HR Admin Fee for Fellow PD12/31,D104,HJ,212.5,,36255.35
6850,1/5/2021,1/5/2021,HRKnowledge,To Record HR Admin Fee for Fellow PD12/31-To Record HR Admin Fee for Fellow PD12/31,D104,HJ,687.5,,36942.85
6850,1/5/2021,1/5/2021,HRKnowledge,To Record HR Admin Fee for Fellow PD12/31-To Record HR Admin Fee for Fellow PD12/31,D104,HJ,212.5,,37155.35
6850,1/5/2021,1/5/2021,HRKnowledge,To Record HR Admin Fee for Fellow PD12/31-To Record HR Admin Fee for Fellow PD12/31,D104,HJ,137.5,,37292.85
6850,1/8/2021,1/8/2021,ADP,ADP invoices for staff and fellows for January-ADP invoices for staff for January,D104,HJ,114.66,,37407.51
6850,1/8/2021,1/8/2021,ADP,ADP invoices for staff and fellows for January-ADP invoices for staff for January,D104,HJ,370.95,,37778.46
6850,1/8/2021,1/8/2021,ADP,ADP invoices for staff and fellows for January-ADP invoices for staff for January,D104,HJ,114.66,,37893.12
6850,1/8/2021,1/8/2021,ADP,ADP invoices for staff and fellows for January-ADP invoices for staff for January,D104,HJ,74.18,,37967.3
6850,1/21/2021,1/21/2021,HRKnowledge,HR Outsourcing Admin fee for Staff and Fellows PD1/15-HR Outsourcing Admin fee for Fellows PD1/15,D104,HJ,209.1,,38176.4
6850,1/21/2021,1/21/2021,HRKnowledge,HR Outsourcing Admin fee for Staff and Fellows PD1/15-HR Outsourcing Admin fee for Fellows PD1/15,D104,HJ,676.5,,38852.9
6850,1/21/2021,1/21/2021,HRKnowledge,HR Outsourcing Admin fee for Staff and Fellows PD1/15-HR Outsourcing Admin fee for Fellows PD1/15,D104,HJ,209.1,,39062
6850,1/21/2021,1/21/2021,HRKnowledge,HR Outsourcing Admin fee for Staff and Fellows PD1/15-HR Outsourcing Admin fee for Fellows PD1/15,D104,HJ,135.3,,39197.3
6850,1/25/2021,1/25/2021,ADP,ADP invoices for staff and fellows for January-ADP tax filing invoices for fellows for January,D104,HJ,38.2,,39235.5
6850,1/25/2021,1/25/2021,ADP,ADP invoices for staff and fellows for January-ADP tax filing invoices for fellows for January,D104,HJ,123.58,,39359.08
6850,1/25/2021,1/25/2021,ADP,ADP invoices for staff and fellows for January-ADP tax filing invoices for fellows for January,D104,HJ,38.2,,39397.28
6850,1/25/2021,1/25/2021,ADP,ADP invoices for staff and fellows for January-ADP tax filing invoices for fellows for January,D104,HJ,24.71,,39421.99
6850,2/3/2021,2/3/2021,840548000,ADP MA State UHI Adjustment Reimbursement-ADP MA State UHI Adjustment Reimbursement,D104,HJ,,24.41,39397.58
6850,2/3/2021,2/3/2021,HRKnowledge,To Record HR Admin Fee for Fellow PD01/29-To Record HR Admin Fee for Fellow PD01/29,D104,HJ,200.6,,39598.18
6850,2/3/2021,2/3/2021,HRKnowledge,To Record HR Admin Fee for Fellow PD01/29-To Record HR Admin Fee for Fellow PD01/29,D104,HJ,649,,40247.18
6850,2/3/2021,2/3/2021,HRKnowledge,To Record HR Admin Fee for Fellow PD01/29-To Record HR Admin Fee for Fellow PD01/29,D104,HJ,200.6,,40447.78
6850,2/3/2021,2/3/2021,HRKnowledge,To Record HR Admin Fee for Fellow PD01/29-To Record HR Admin Fee for Fellow PD01/29,D104,HJ,129.8,,40577.58
6850,2/5/2021,2/5/2021,ADP,ADP Invoices-ADP invoices for Fellows for February,D104,HJ,135.27,,40712.85
6850,2/5/2021,2/5/2021,ADP,ADP Invoices-ADP invoices for Fellows for February,D104,HJ,437.66,,41150.51
6850,2/5/2021,2/5/2021,ADP,ADP Invoices-ADP invoices for Fellows for February,D104,HJ,135.27,,41285.78
6850,2/5/2021,2/5/2021,ADP,ADP Invoices-ADP invoices for Fellows for February,D104,HJ,87.55,,41373.33
6850,2/18/2021,2/18/2021,HRKnowledge,To Record HR Admin Fee for Fellow PD02/12-To Record HR Admin Fee for Fellow PD02/12,D104,HJ,207.4,,41580.73
6850,2/18/2021,2/18/2021,HRKnowledge,To Record HR Admin Fee for Fellow PD02/12-To Record HR Admin Fee for Fellow PD02/12,D104,HJ,671,,42251.73
6850,2/18/2021,2/18/2021,HRKnowledge,To Record HR Admin Fee for Fellow PD02/12-To Record HR Admin Fee for Fellow PD02/12,D104,HJ,207.4,,42459.13
6850,2/18/2021,2/18/2021,HRKnowledge,To Record HR Admin Fee for Fellow PD02/12-To Record HR Admin Fee for Fellow PD02/12,D104,HJ,134.2,,42593.33
6850,2/24/2021,2/24/2021,ADP,ADP Invoices-ADP tax filing invoices for fellows for February,D104,HJ,17.68,,42611.01
6850,2/24/2021,2/24/2021,ADP,ADP Invoices-ADP tax filing invoices for fellows for February,D104,HJ,57.21,,42668.22
6850,2/24/2021,2/24/2021,ADP,ADP Invoices-ADP tax filing invoices for fellows for February,D104,HJ,17.68,,42685.9
6850,2/24/2021,2/24/2021,ADP,ADP Invoices-ADP tax filing invoices for fellows for February,D104,HJ,11.44,,42697.34
6850,2/25/2021,2/25/2021,ADP,ADP invoices for staff and fellows for February-ADP invoices for fellows for February 2021,D104,HJ,359.64,,43056.98
6850,2/25/2021,2/25/2021,ADP,ADP invoices for staff and fellows for February-ADP invoices for fellows for February 2021,D104,HJ,1163.53,,44220.51
6850,2/25/2021,2/25/2021,ADP,ADP invoices for staff and fellows for February-ADP invoices for fellows for February 2021,D104,HJ,359.64,,44580.15
6850,2/25/2021,2/25/2021,ADP,ADP invoices for staff and fellows for February-ADP invoices for fellows for February 2021,D104,HJ,232.69,,44812.84
6850,3/2/2021,3/2/2021,HRKnowledge,HR Outsourcing Admin fee for Staff and Fellows PD02/26,D104,HJ,204,,45016.84
6850,3/2/2021,3/2/2021,HRKnowledge,HR Outsourcing Admin fee for Staff and Fellows PD02/26,D104,HJ,660,,45676.84
6850,3/2/2021,3/2/2021,HRKnowledge,HR Outsourcing Admin fee for Staff and Fellows PD02/26,D104,HJ,204,,45880.84
6850,3/2/2021,3/2/2021,HRKnowledge,HR Outsourcing Admin fee for Staff and Fellows PD02/26,D104,HJ,132,,46012.84
6850,3/12/2021,3/12/2021,ADP,ADP invoices for fellows for due date 3.12.21,D104,HJ,77.1,,46089.94
6850,3/12/2021,3/12/2021,ADP,ADP invoices for fellows for due date 3.12.21,D104,HJ,249.43,,46339.37
6850,3/12/2021,3/12/2021,ADP,ADP invoices for fellows for due date 3.12.21,D104,HJ,77.1,,46416.47
6850,3/12/2021,3/12/2021,ADP,ADP invoices for fellows for due date 3.12.21,D104,HJ,49.87,,46466.34
6850,3/13/2021,3/13/2021,ADP,Payroll processing fee,D104,HJ,41.8,,46508.14
6850,3/13/2021,3/13/2021,ADP,Payroll processing fee,D104,HJ,135.25,,46643.39
6850,3/13/2021,3/13/2021,ADP,Payroll processing fee,D104,HJ,41.8,,46685.19
6850,3/13/2021,3/13/2021,ADP,Payroll processing fee,D104,HJ,27.05,,46712.24
6850,3/18/2021,3/18/2021,HRKnowledge,HR Outsourcing Admin fee for Staff and Fellows PD03/15,D104,HJ,200.6,,46912.84
6850,3/18/2021,3/18/2021,HRKnowledge,HR Outsourcing Admin fee for Staff and Fellows PD03/15,D104,HJ,649,,47561.84
6850,3/18/2021,3/18/2021,HRKnowledge,HR Outsourcing Admin fee for Staff and Fellows PD03/15,D104,HJ,200.6,,47762.44
6850,3/18/2021,3/18/2021,HRKnowledge,HR Outsourcing Admin fee for Staff and Fellows PD03/15,D104,HJ,129.8,,47892.24
6850,4/2/2021,4/2/2021,HRKnowledge,HR Outsourcing Admin fee for Staff and Fellows PD03.31,D104,HJ,200.6,,48092.84
6850,4/2/2021,4/2/2021,HRKnowledge,HR Outsourcing Admin fee for Staff and Fellows PD03.31,D104,HJ,649,,48741.84
6850,4/2/2021,4/2/2021,HRKnowledge,HR Outsourcing Admin fee for Staff and Fellows PD03.31,D104,HJ,200.6,,48942.44
6850,4/2/2021,4/2/2021,HRKnowledge,HR Outsourcing Admin fee for Staff and Fellows PD03.31,D104,HJ,129.8,,49072.24
6850,4/9/2021,4/9/2021,ADP,ADP Invoice April 2021,D104,HJ,115.86,,49188.1
6850,4/9/2021,4/9/2021,ADP,ADP Invoice April 2021,D104,HJ,374.82,,49562.92
6850,4/9/2021,4/9/2021,ADP,ADP Invoice April 2021,D104,HJ,115.86,,49678.78
6850,4/9/2021,4/9/2021,ADP,ADP Invoice April 2021,D104,HJ,74.96,,49753.74
6850,4/15/2021,4/15/2021,HRKnowledge,HRK Outsourcing Fee Fellows,D104,HJ,198.9,,49952.64
6850,4/15/2021,4/15/2021,HRKnowledge,HRK Outsourcing Fee Fellows,D104,HJ,643.5,,50596.14
6850,4/15/2021,4/15/2021,HRKnowledge,HRK Outsourcing Fee Fellows,D104,HJ,198.9,,50795.04
6850,4/15/2021,4/15/2021,HRKnowledge,HRK Outsourcing Fee Fellows,D104,HJ,128.7,,50923.74
6850,5/5/2021,5/5/2021,HRKnowledge,HR Outsourcing Admin fee for Staff and Fellows PD04.30,D104,HJ,197.2,,51120.94
6850,5/5/2021,5/5/2021,HRKnowledge,HR Outsourcing Admin fee for Staff and Fellows PD04.30,D104,HJ,638,,51758.94
6850,5/5/2021,5/5/2021,HRKnowledge,HR Outsourcing Admin fee for Staff and Fellows PD04.30,D104,HJ,197.2,,51956.14
6850,5/5/2021,5/5/2021,HRKnowledge,HR Outsourcing Admin fee for Staff and Fellows PD04.30,D104,HJ,127.6,,52083.74
6850,5/7/2021,5/7/2021,ADP,ADP Payroll fee invoice for Fellows and Staff Period End 4.30.21,D104,HJ,121.13,,52204.87
6850,5/7/2021,5/7/2021,ADP,ADP Payroll fee invoice for Fellows and Staff Period End 4.30.21,D104,HJ,391.91,,52596.78
6850,5/7/2021,5/7/2021,ADP,ADP Payroll fee invoice for Fellows and Staff Period End 4.30.21,D104,HJ,121.13,,52717.91
6850,5/7/2021,5/7/2021,ADP,ADP Payroll fee invoice for Fellows and Staff Period End 4.30.21,D104,HJ,78.38,,52796.29
6850,5/19/2021,5/19/2021,HRKnowledge,HRKnowledge Outsourcing Fee Fellows PD0514,D104,HJ,197.2,,52993.49
6850,5/19/2021,5/19/2021,HRKnowledge,HRKnowledge Outsourcing Fee Fellows PD0514,D104,HJ,638,,53631.49
6850,5/19/2021,5/19/2021,HRKnowledge,HRKnowledge Outsourcing Fee Fellows PD0514,D104,HJ,197.2,,53828.69
6850,5/19/2021,5/19/2021,HRKnowledge,HRKnowledge Outsourcing Fee Fellows PD0514,D104,HJ,127.6,,53956.29
6850,6/4/2021,6/4/2021,HRKnowledge,HR Outsourcing Admin fee for Staff and Fellows PD,D104,HJ,195.5,,54151.79
6850,6/4/2021,6/4/2021,HRKnowledge,HR Outsourcing Admin fee for Staff and Fellows PD,D104,HJ,632.5,,54784.29
6850,6/4/2021,6/4/2021,HRKnowledge,HR Outsourcing Admin fee for Staff and Fellows PD,D104,HJ,195.5,,54979.79
6850,6/4/2021,6/4/2021,HRKnowledge,HR Outsourcing Admin fee for Staff and Fellows PD,D104,HJ,126.5,,55106.29
6850,6/11/2021,6/11/2021,ADP,ADP Payroll Fee for PD.0611,D104,HJ,416.81,,55523.1
6850,6/11/2021,6/11/2021,ADP,ADP Payroll Fee for PD.0611,D104,HJ,1348.53,,56871.63
6850,6/11/2021,6/11/2021,ADP,ADP Payroll Fee for PD.0611,D104,HJ,416.81,,57288.44
6850,6/11/2021,6/11/2021,ADP,ADP Payroll Fee for PD.0611,D104,HJ,269.7,,57558.14
6850,6/21/2021,6/21/2021,HRKnowledge,HRKnowledge Outsourcing Fee Fellows,D104,HJ,193.8,,57751.94
6850,6/21/2021,6/21/2021,HRKnowledge,HRKnowledge Outsourcing Fee Fellows,D104,HJ,255,,58006.94
6850,6/21/2021,6/21/2021,HRKnowledge,HRKnowledge Outsourcing Fee Fellows,D104,HJ,627,,58633.94
6850,6/21/2021,6/21/2021,HRKnowledge,HRKnowledge Outsourcing Fee Fellows,D104,HJ,825,,59458.94
6850,6/21/2021,6/21/2021,HRKnowledge,HRKnowledge Outsourcing Fee Fellows,D104,HJ,193.8,,59652.74
6850,6/21/2021,6/21/2021,HRKnowledge,HRKnowledge Outsourcing Fee Fellows,D104,HJ,255,,59907.74
6850,6/21/2021,6/21/2021,HRKnowledge,HRKnowledge Outsourcing Fee Fellows,D104,HJ,125.4,,60033.14
6850,6/21/2021,6/21/2021,HRKnowledge,HRKnowledge Outsourcing Fee Fellows,D104,HJ,165,,60198.14
6850, Totals for 6850 - AmeriCorps Fellows Payroll Processing Fees,,,,,,70119.65,9921.51,60198.14
6860,6860 - Staff Payroll Processing Fees (Balance forward As of 07/01/2020) ,,,,,,,,0
6860,7/6/2020,7/6/2020,HRKnowledge,HR Outsourcing admin fee for staff PD6/30-HR Outsourcing admin fee for staff PD6/30,D107,HJ,520,,520
6860,7/10/2020,7/10/2020,ADP,To record PR expenses for staff and fellows-To record PR expenses for staff and fellows,D107,HJ,2948.15,,3468.15
6860,7/24/2020,7/24/2020,HRKnowledge,HR Outsourcing Admin fee-HR Outsourcing Admin fee for staff,D107,HJ,780,,4248.15
6860,7/31/2020,7/31/2020,July,To correct the department coding for July August September-To correct the department coding for July,D104,HJ,4248.15,,8496.3
6860,7/31/2020,7/31/2020,July,To correct the department coding for July August September-To correct the department coding for July,D107,HJ,,4248.15,4248.15
6860,8/7/2020,8/7/2020,ADP,PR Process fee for staff ADP-PR Process fee for staff ADP,D104,HJ,3544.7,,7792.85
6860,8/7/2020,8/7/2020,HRKnowledge,HR Outsourcing Admin fee-HR Outsourcing Admin fee,D104,HJ,850,,8642.85
6860,8/29/2020,8/29/2020,HRKnowledge,Setup of onboarding expenses for fellows and staffs-Setup of onboarding expenses for fellows and staffs,D104,HJ,3325,,11967.85
6860,9/2/2020,9/2/2020,HRKnowledge,HRK Admin fee and 401K loss earnings-HRK Admin fee and 401K loss earnings for staffs,D107,HJ,1643.83,,13611.68
6860,9/10/2020,9/10/2020,HRKnowledge,Virtual HR: Essentials Q4-Oct-Dec 2020-Virtual HR: Essentials Q4-Oct-Dec 2020,D104,HJ,3000,,16611.68
6860,9/11/2020,9/11/2020,ADP,ADP PR time and attendance fees-ADP PR time and attendance fees,D107,HJ,3327.07,,19938.75
6860,9/23/2020,9/23/2020,HRKnowledge,HR Outsourcing admin fee for staff PD9/15-HR Outsourcing admin fee for staff PD9/15,D104,HJ,1420,,21358.75
6860,9/30/2020,9/30/2020,September,To correct the department coding for July August September-To correct the department coding for July August September,D104,HJ,4970.9,,26329.65
6860,9/30/2020,9/30/2020,September,To correct the department coding for July August September-To correct the department coding for July August September,D107,HJ,,4970.9,21358.75
6860,10/5/2020,10/5/2020,HRKnowledge,HR outsourcing admin fee for staff pd 9-30-HR outsourcing admin fee for staff pd 9-30,D104,HJ,1430,,22788.75
6860,10/9/2020,10/9/2020,ADP,ADP payroll services for staffs-ADP payroll services for staffs,D104,HJ,5708.2,,28496.95
6860,10/26/2020,10/26/2020,HRKnowledge,HR Outsourcing admin fee staff PD 10/15-HR Outsourcing admin fee,D104,HJ,1460,,29956.95
6860,11/5/2020,11/5/2020,HRKnowledge,Affirmative Action plan-Date Range TBD-Affirmative Action plan-Date Range TBD,D104,HJ,5500,,35456.95
6860,11/6/2020,11/6/2020,ADP,ADP PR services fee for staff-ADP PR services fee for staff,D104,HJ,5881.5,,41338.45
6860,11/9/2020,11/9/2020,HRKnowledge,HRK Admin fee for staff PD10/30-HRK Admin fee for staff PD10/30,D104,HJ,1560,,42898.45
6860,11/18/2020,11/18/2020,HRKnowledge,HR Outsourcing admin fee-HR Outsourcing admin fee for staff PD11/15,D104,HJ,1550,,44448.45
6860,12/7/2020,12/7/2020,HRKnowledge,To record HR admin fee for staff PD11/30-To record HR admin fee for staff PD11/30,D104,HJ,1540,,45988.45
6860,12/11/2020,12/11/2020,ADP,ADP invoices for December-ADP invoices for staff for December,D104,HJ,6094.77,,52083.22
6860,12/14/2020,12/14/2020,HRKnowledge,Fed&State labor law poster update service-Fed&State labor law poster update service,D104,HJ,125,,52208.22
6860,12/18/2020,12/18/2020,HRKnowledge,Virtual HR: Essentials (Q1Jan-Mar 2021)-Virtual HR: Essentials (Q1Jan-Mar 2021),D104,HJ,3000,,55208.22
6860,12/18/2020,12/18/2020,HRKnowledge,HR Outsourcing admin fee for staff and fellows-HR Outsourcing admin fee for staff PD12/15,D104,HJ,1540,,56748.22
6860,1/5/2021,1/5/2021,HRKnowledge,To record HR Admin fee for staff PD 12/31-To record HR Admin fee for staff PD 12/31,D104,HJ,1540,,58288.22
6860,1/8/2021,1/8/2021,ADP,ADP invoices for staff and fellows for January-ADP invoices for Staff for January,D104,HJ,235.77,,58523.99
6860,1/8/2021,1/8/2021,ADP,ADP invoices for staff and fellows for January-ADP invoices for Staff for January,D104,HJ,766.27,,59290.26
6860,1/8/2021,1/8/2021,ADP,ADP invoices for staff and fellows for January-ADP invoices for Staff for January,D104,HJ,4892.31,,64182.57
6860,1/21/2021,1/21/2021,HRKnowledge,HR Outsourcing Admin fee for Staff and Fellows PD1/15-HR Outsourcing Admin fee for Staff PD1/15,D104,HJ,1600,,65782.57
6860,1/25/2021,1/25/2021,ADP,ADP invoices for staff and fellows for January-ADP tax filing invoices for Staff for January,D104,HJ,407.41,,66189.98
6860,2/2/2021,2/2/2021,HRKnowledge,HRKnowledge Virtual HR Partner PD.0106-HRKnowledge Virtual HR Partner PD.0106,D104,HJ,2000,,68189.98
6860,2/3/2021,2/3/2021,HRKnowledge,To record HR Admin fee for staff PD 1/31-To record HR Admin fee for staff PD 1/31,D104,HJ,1560,,69749.98
6860,2/5/2021,2/5/2021,ADP,ADP Invoices-ADP invoices for Staff for February,D104,HJ,227.2,,69977.18
6860,2/5/2021,2/5/2021,ADP,ADP Invoices-ADP invoices for Staff for February,D104,HJ,738.36,,70715.54
6860,2/5/2021,2/5/2021,ADP,ADP Invoices-ADP invoices for Staff for February,D104,HJ,4714.19,,75429.73
6860,2/8/2021,2/8/2021,HRKnowledge,HRK ePostersService January 2021 PD01.28-HRK ePostersService January 2021 PD01.28,D104,HJ,336,,75765.73
6860,2/9/2021,2/9/2021,HRKnowledge,HRKnowledge EEO.1 Reporting 2019.20 PD.0203-HRKnowledge EEO.1 Reporting 2019.20 PD.0203,D104,HJ,3000,,78765.73
6860,2/9/2021,2/9/2021,HRKnowledge,HRKnowledge Virtual HR Partner Mar 2021 PD02.03-HRKnowledge Virtual HR Partner Mar 2021 PD02.03,D104,HJ,2500,,81265.73
6860,2/11/2021,2/11/2021,HRKnowledge,HRKnowledge ePoster Service PD01.20-HRKnowledge ePoster Service PD01.20,D104,HJ,1000,,82265.73
6860,2/11/2021,2/11/2021,HRKnowledge,HRK ePosters Service February 2021-HRK ePosters Service February 2021,D104,HJ,336,,82601.73
6860,2/19/2021,2/19/2021,HRKnowledge,To record HR Admin fee for staff PD 02/12-To record HR Admin fee for staff PD 02/12,D104,HJ,1570,,84171.73
6860,2/22/2021,2/22/2021,ADP,ADP tax filling invoices for Staff for February-ADP tax filling invoices for Staff for February,D104,HJ,964.48,,85136.21
6860,2/24/2021,2/24/2021,ADP,ADP Invoices-ADP tax filing invoices for Staff for February,D104,HJ,2045.09,,87181.3
6860,2/25/2021,2/25/2021,ADP,ADP invoices for staff and fellows for February-ADP invoices for staff for February,D104,HJ,73.43,,87254.73
6860,2/25/2021,2/25/2021,ADP,ADP invoices for staff and fellows for February-ADP invoices for staff for February,D104,HJ,238.65,,87493.38
6860,2/25/2021,2/25/2021,ADP,ADP invoices for staff and fellows for February-ADP invoices for staff for February,D104,HJ,1523.72,,89017.1
6860,3/2/2021,3/2/2021,HRKnowledge,HR Outsourcing Admin fee for Staff and Fellows PD02/26,D104,HJ,4410,,93427.1
6860,3/12/2021,3/12/2021,ADP,ADP Payroll fees,D104,HJ,181.45,,93608.55
6860,3/12/2021,3/12/2021,ADP,ADP Payroll fees,D104,HJ,589.7,,94198.25
6860,3/12/2021,3/12/2021,ADP,ADP Payroll fees,D104,HJ,3765.04,,97963.29
6860,3/13/2021,3/13/2021,ADP,Payroll processing fee,D104,HJ,34.25,,97997.54
6860,3/13/2021,3/13/2021,ADP,Payroll processing fee,D104,HJ,111.29,,98108.83
6860,3/13/2021,3/13/2021,ADP,Payroll processing fee,D104,HJ,710.56,,98819.39
6860,3/16/2021,3/16/2021,HRKnowledge,HRKnowledge Virtual HR Partner PD03.09,D104,HJ,2500,,101319.39
6860,3/18/2021,3/18/2021,ADP,ADP tax filing invoices or Staff in March,D104,HJ,196.26,,101515.65
6860,3/18/2021,3/18/2021,HRKnowledge,HR Outsourcing Admin fee for Staff and Fellows PD03/15,D104,HJ,1600,,103115.65
6860,4/2/2021,4/2/2021,HRKnowledge,HR Outsourcing Admin fee for Staff and Fellows PD03.31,D104,HJ,1960,,105075.65
6860,4/9/2021,4/9/2021,ADP,ADP Invoice April 2021,D104,HJ,221.94,,105297.59
6860,4/9/2021,4/9/2021,ADP,ADP Invoice April 2021,D104,HJ,721.31,,106018.9
6860,4/9/2021,4/9/2021,ADP,ADP Invoice April 2021,D104,HJ,4605.25,,110624.15
6860,4/15/2021,4/15/2021,HRKnowledge,HRK Outsourcing Fee,D104,HJ,1580,,112204.15
6860,4/16/2021,4/16/2021,HRKnowledge,HRKnowledge Virtual HR Partner PD04.06,D104,HJ,2500,,114704.15
6860,4/23/2021,4/23/2021,HRKnowledge,HRK Supplemental Payroll Fee PD0423,D104,HJ,100,,114804.15
6860,5/1/2021,5/1/2021,202007-202104,To reclass the Function for GL6860 FY21 Expenses,D104,HJ,3027.39,,117831.54
6860,5/1/2021,5/1/2021,202007-202104,To reclass the Function for GL6860 FY21 Expenses,D104,HJ,13118.7,,130950.24
6860,5/1/2021,5/1/2021,202007-202104,To reclass the Function for GL6860 FY21 Expenses,D104,HJ,84766.95,,215717.19
6860,5/1/2021,5/1/2021,202007-202104,To reclass the Function for GL6860 FY21 Expenses,D104,HJ,,100913.04,114804.15
6860,5/5/2021,5/5/2021,HRKnowledge,HR Outsourcing Admin fee for Staff and Fellows PD04.30,D104,HJ,57.9,,114862.05
6860,5/5/2021,5/5/2021,HRKnowledge,HR Outsourcing Admin fee for Staff and Fellows PD04.30,D104,HJ,250.9,,115112.95
6860,5/5/2021,5/5/2021,HRKnowledge,HR Outsourcing Admin fee for Staff and Fellows PD04.30,D104,HJ,1621.2,,116734.15
6860,5/7/2021,5/7/2021,ADP,ADP Payroll fee invoice for Fellows and Staff Period End 4.30.21,D104,HJ,174.64,,116908.79
6860,5/7/2021,5/7/2021,ADP,ADP Payroll fee invoice for Fellows and Staff Period End 4.30.21,D104,HJ,756.78,,117665.57
6860,5/7/2021,5/7/2021,ADP,ADP Payroll fee invoice for Fellows and Staff Period End 4.30.21,D104,HJ,4889.95,,122555.52
6860,5/18/2021,5/18/2021,HRKnowledge,HRKnowlegde Virtual Partner,D104,HJ,75,,122630.52
6860,5/18/2021,5/18/2021,HRKnowledge,HRKnowlegde Virtual Partner,D104,HJ,325,,122955.52
6860,5/18/2021,5/18/2021,HRKnowledge,HRKnowlegde Virtual Partner,D104,HJ,2100,,125055.52
6860,5/19/2021,5/19/2021,HRKnowledge,HRKnowlegde Outsourcing Fee,D104,HJ,47.4,,125102.92
6860,5/19/2021,5/19/2021,HRKnowledge,HRKnowlegde Outsourcing Fee,D104,HJ,205.4,,125308.32
6860,5/19/2021,5/19/2021,HRKnowledge,HRKnowlegde Outsourcing Fee,D104,HJ,1327.2,,126635.52
6860,6/4/2021,6/4/2021,HRKnowledge,HR Outsourcing Admin fee for Staff and Fellows PD,D104,HJ,4082.4,,130717.92
6860,6/4/2021,6/4/2021,HRKnowledge,HR Outsourcing Admin fee for Staff and Fellows PD,D104,HJ,145.8,,130863.72
6860,6/4/2021,6/4/2021,HRKnowledge,HR Outsourcing Admin fee for Staff and Fellows PD,D104,HJ,631.8,,131495.52
6860,6/11/2021,6/11/2021,ADP,ADP Payroll Fee for PD.0611,D104,HJ,208.96,,131704.48
6860,6/11/2021,6/11/2021,ADP,ADP Payroll Fee for PD.0611,D104,HJ,905.51,,132609.99
6860,6/11/2021,6/11/2021,ADP,ADP Payroll Fee for PD.0611,D104,HJ,5850.96,,138460.95
6860,6/21/2021,6/21/2021,HRKnowledge,HRKK Virtual Partner Fee June 2021,D104,HJ,2500,,140960.95
6860,6/21/2021,6/21/2021,HRKnowledge,HRK Admin Outsourcing Fee,D104,HJ,1500,,142460.95
6860,6/21/2021,6/21/2021,HRKnowledge,HRK Admin Outsourcing Fee,D104,HJ,1610,,144070.95
6860, Totals for 6860 - Staff Payroll Processing Fees,,,,,,254203.04,110132.09,144070.95
6870,6870 - Misc Expenses & WM Ops Expenses (Balance forward As of 07/01/2020) ,,,,,,,,0
6870,7/24/2020,7/24/2020,CD-20200706-5,To reclass Woot Math operating expenses-Woot Math Reimb for May 16 to May 31 and June 1 to June 30 2020. Op Cost for 3.9 Months,D109,HJ,24858.59,,24858.59
6870,9/22/2020,9/22/2020,CD-21-0067,To reclass Woot Math operating expenses-Woot Math Reimbursement for August 1st to August 31st Operating Cost,D109,HJ,85324.32,,110182.91
6870,9/22/2020,9/22/2020,CD-21-0067,To reclass Woot Math operating expenses-Woot Math Reimbursement for July 1st to July 31st. Operating Cost,D109,HJ,52437.74,,162620.65
6870,6/30/2021,6/30/2021,Adj.01,"To adjust AP other account proper balance June 30, 2021. Adjusting entry requested by the auditors.",D107,GJ,57215,,219835.65
6870, Totals for 6870 - Misc Expenses & WM Ops Expenses,,,,,,219835.65,0,219835.65
6950,6950 - Disallowances (Balance forward As of 07/01/2020) ,,,,,,,,0
6950,7/1/2020,7/1/2020,AC,To record the Americorps disallowance-To record the Americorps disallowance,D107,HJ,,120692,-120692
6950,7/1/2020,7/1/2020,AC-R&C,To reverse and correct the GL coding-Reverse: To record the Americorps disallowance,D107,HJ,120692,,0
6950, Totals for 6950 - Disallowances,,,,,,120692,120692,0
,Grand total,,,,,,95691938.14,95691938.14,0
